v_hit,j_hit,cdr3,S1-10ng_S6,S1-10ng_S18,freq,count_sum
TRBV5-1,TRBJ1-2,CASSLVGGGSGYTF,23,15,2,38
TRBV3-1,TRBJ2-7,CASPHSKSTRDRGRSFYEQYF,23,11,2,34
TRBV28,TRBJ1-2,CASGYAYNYGYTF,16,18,2,34
TRBV19,TRBJ1-1,CASSIGWGTEAFF,14,7,2,21
TRBV3-1,TRBJ2-6,CASSQGAAGGANVLTF,11,16,2,27
TRBV19,TRBJ1-1,CASSIWGSLNTEAFF,2,0,1,2
TRBV10-2,TRBJ2-3,CASMMTASTDTQYF,5,5,2,10
TRBV29-1,TRBJ2-1,CSVDRGQDKYNEQFF,1,0,1,1
TRBV18,TRBJ2-3,CASSPDSSTDTQYF,3,0,1,3
TRBV2,TRBJ2-7,CASSERDRAYEQYF,2,0,1,2
TRBV6-2/3/5/6,TRBJ2-1,CASWVAGNNEQFF,6,8,2,14
TRBV28,TRBJ2-7,CASSLENRLGTYEQYF,7,0,1,7
TRBV29-1,TRBJ2-3,CSVAGTSGEADTQYF,6,0,1,6
TRBV7-8,TRBJ1-1,CASSSTSQAYTEAFF,5,3,2,8
TRBV28,TRBJ2-1,CASSPPGLAGVYEQFF,5,2,2,7
TRBV11-2,TRBJ2-3,CASSSGTDTQYF,2,0,1,2
TRBV3-1,TRBJ2-3,CASSPLELGGADTQYF,7,7,2,14
TRBV30,TRBJ2-2,CALTKRPSENTGELFF,8,1,2,9
TRBV20-1,TRBJ2-7,CSAKFYEQYF,1,0,1,1
TRBV12-3/4,TRBJ2-5,CATVAGEDETQYF,5,2,2,7
TRBV20-1,TRBJ2-7,CSARGSQGASSSYEQYF,4,0,1,4
TRBV28,TRBJ2-2,CASSLGRDPTGELFF,2,2,2,4
TRBV28,TRBJ1-5,CASSLRDTNQPQHF,1,0,1,1
TRBV7-8,TRBJ1-5,CASSGSPLGPRDQPQHF,6,2,2,8
TRBV3-1,TRBJ1-1,CASSQGGTGLTGAFF,1,0,1,1
TRBV28,TRBJ2-3,CASSFSRVADTQYF,1,0,1,1
TRBV28,TRBJ2-2,CASGLRLAGITGELFF,5,4,2,9
TRBV6-2/3/5/6,TRBJ1-1,CASSPSANTEAFF,2,0,1,2
TRBV19,TRBJ2-3,CATSGGEVTQYF,1,0,1,1
TRBV11-2,TRBJ1-4,CASSPFAPYAHEKLFF,5,4,2,9
TRBV5-1,TRBJ1-2,CASSLDTGKGYTF,1,0,1,1
TRBV7-9,TRBJ1-1,CASSLDRVKAFF,2,0,1,2
TRBV13,TRBJ2-7,CASSLRTSGEWEQYF,4,2,2,6
TRBV5-1,TRBJ2-2,CASSLSGQSNTGELFF,1,0,1,1
TRBV19,TRBJ2-7,CASSMGGHSYEQYF,4,3,2,7
TRBV20-1,TRBJ2-3,CSARGTGLTDTQYF,4,2,2,6
TRBV11-2,TRBJ2-5,CASSLPGAGEREF,1,0,1,1
TRBV4-1,TRBJ1-1,CASSGKFTAEAFF,1,0,1,1
TRBV3-1,TRBJ2-5,CASSQDPGLAGGQETQYF,1,0,1,1
TRBV2,TRBJ1-4,CASRVYEGAVEKLFF,1,0,1,1
TRBV5-1,TRBJ2-3,CASSLAGRAADTQYF,1,0,1,1
TRBV19,TRBJ1-5,CASSIVGAFQPQHF,1,0,1,1
TRBV5-1,TRBJ1-3,CASSSSGSGNTIYF,1,0,1,1
TRBV18,TRBJ2-1,CASSPPMEQGEFF,4,0,1,4
TRBV7-3,TRBJ2-1,CASSLSGDEQFF,1,0,1,1
TRBV18,TRBJ2-1,CASSTTGYYNEQFF,2,0,1,2
TRBV5-1,TRBJ2-1,CASSLGQGAYNEQFF,1,0,1,1
TRBV3-1,TRBJ2-1,CASSQKLGAGGGYNEQFF,2,0,1,2
TRBV5-4,TRBJ1-1,CASSLGQGFDTEAFF,1,0,1,1
TRBV5-1,TRBJ2-2,CASSFSGQDGELFF,1,0,1,1
TRBV20-1,TRBJ2-2,CSAESGSWTGELFF,2,0,1,2
TRBV2,TRBJ1-1,CASSQGFGTEAFF,1,0,1,1
TRBV12-3/4,TRBJ1-1,CASSLIRGEAFF,2,0,1,2
TRBV28,TRBJ1-1,CASRTGGPEAFF,1,0,1,1
TRBV5-1,TRBJ2-1,CASSSKREAGGNSEQFF,4,1,2,5
TRBV29-1,TRBJ2-1,CSVEGLAGVYNEQFF,1,0,1,1
TRBV20-1,TRBJ2-4,CSARVPGGASKNIQYF,3,0,1,3
TRBV5-5,TRBJ1-1,CASSLVSGGYTEAFF,1,0,1,1
TRBV3-1,TRBJ2-1,CASSQVRNNEQFF,1,0,1,1
TRBV12-3/4,TRBJ1-2,CASSSSPFGYTF,3,0,1,3
TRBV28,TRBJ1-2,CASSPGSDRVSGYTF,2,0,1,2
TRBV20-1,TRBJ2-4,CSARAGTGGSNIQYF,1,0,1,1
TRBV5-1,TRBJ1-6,CASSWTGGDSPLHF,2,0,1,2
TRBV2,TRBJ2-1,CASRPLSHNSEQFF,1,0,1,1
TRBV5-6,TRBJ2-1,CASSSGQSSYNEQFF,2,0,1,2
TRBV19,TRBJ1-1,CASSISRENTEAFF,1,0,1,1
TRBV12-3/4,TRBJ2-1,CASSIDRGDGNEQFF,2,0,1,2
TRBV20-1,TRBJ2-5,CSANSRGLGETQYF,1,0,1,1
TRBV20-1,TRBJ2-3,CSVRHTDTQYF,2,0,1,2
TRBV7-8,TRBJ2-3,CASSSRRWSTDTQYF,1,0,1,1
TRBV10-1,TRBJ1-1,CASSEVGRTEAFF,1,0,1,1
TRBV12-3/4,TRBJ2-1,CASSFLGGSLSYNEQFF,2,0,1,2
TRBV3-1,TRBJ2-1,CASSPLAGGQGEQFF,2,0,1,2
TRBV29-1,TRBJ1-5,CSVAQGANNQPRHF,1,0,1,1
TRBV28,TRBJ1-1,CASSLAGSMAHETEAFF,1,0,1,1
TRBV19,TRBJ1-1,CASSIRQDSLNTEAFF,1,0,1,1
TRBV5-6,TRBJ2-6,CASSLRGSGANVLTF,1,0,1,1
TRBV19,TRBJ2-4,CASSMLGVLNIQYF,1,0,1,1
TRBV18,TRBJ1-2,CASSPPVRTYGYTF,2,0,1,2
TRBV12-3/4,TRBJ2-3,CASSAGGPTDTQYF,1,0,1,1
TRBV28,TRBJ1-5,CASSALGVQPQHF,2,0,1,2
TRBV7-3,TRBJ2-3,CASSLVATDTQYF,4,0,1,4
TRBV13,TRBJ2-4,CASSQGTANIQYF,3,2,2,5
TRBV29-1,TRBJ2-1,CSVGSGEGYEQFF,4,3,2,7
TRBV12-3/4,TRBJ2-3,CASSLLNTQYF,1,0,1,1
TRBV2,TRBJ2-2,CASSANRLAGGTGELFF,2,0,1,2
TRBV3-1,TRBJ2-3,CASSQDVGIDTDTQYF,1,0,1,1
TRBV28,TRBJ2-1,CASSQDGGAFNEQFF,1,0,1,1
TRBV6-4,TRBJ2-3,CASSGQTSGGGTQYF,1,0,1,1
TRBV7-9,TRBJ2-1,CASSLSRGRDNEQFF,5,2,2,7
TRBV11-1,TRBJ2-3,CASSRGQGTPDTQYF,1,0,1,1
TRBV11-3,TRBJ2-3,CASSPTGGADTQYF,1,0,1,1
TRBV2,TRBJ1-2,CARSGQVGYGYTF,1,0,1,1
TRBV5-1,TRBJ2-7,CASSLGTHEQYF,1,0,1,1
TRBV29-1,TRBJ2-1,CSVQEENEQFF,2,0,1,2
TRBV5-1,TRBJ2-3,CASSSLTGTVTDTQYF,1,0,1,1
TRBV2,TRBJ1-3,CASGTGGVNTIYF,2,5,2,7
TRBV5-1,TRBJ1-2,CASSGDGSYGYTF,1,0,1,1
TRBV12-3/4,TRBJ2-1,CASSLVPPGANEQFF,3,1,2,4
TRBV27,TRBJ1-1,CASSDPAYGNTEAFF,3,2,2,5
TRBV29-1,TRBJ1-1,CSVERTGAGTEAFF,2,0,1,2
TRBV20-1,TRBJ2-5,CSANRDNQETQYF,1,0,1,1
TRBV5-4,TRBJ2-7,CASSLGFGGLGSYEQYF,2,2,2,4
TRBV4-2,TRBJ2-1,CASSQDLAGGRNEQFF,1,0,1,1
TRBV2,TRBJ1-2,CASSELGGINYGYTF,1,0,1,1
TRBV30,TRBJ2-3,CAWTGVGTDTQYF,3,0,1,3
TRBV7-3,TRBJ2-3,CASSFSGGAADTQYF,1,0,1,1
TRBV3-1,TRBJ1-6,CASGQGGGGSPLHF,1,0,1,1
TRBV11-2,TRBJ1-1,CASSLDGAGAEAFF,2,0,1,2
TRBV12-3/4,TRBJ1-1,CASSHSQGWTEAFF,1,0,1,1
TRBV5-1,TRBJ2-3,CASSLEVYTDTQYF,2,0,1,2
TRBV7-8,TRBJ2-1,CASRLGAGGWYEQFF,3,0,1,3
TRBV4-1,TRBJ2-7,CASSPGTGEGYEQYF,2,1,2,3
TRBV20-1,TRBJ2-1,CSARLLAGDYNEQFF,4,0,1,4
TRBV5-1,TRBJ1-2,CASSTEQGLRGYTF,1,0,1,1
TRBV20-1,TRBJ1-3,CSARDLEGNSGNTIYF,1,0,1,1
TRBV7-8,TRBJ1-2,CASTNLGAVGYGYTF,2,2,2,4
TRBV2,TRBJ1-4,CASSEQGATNEKLFF,1,0,1,1
TRBV12-3/4,TRBJ1-2,CASRSRQYRNYGYTF,1,0,1,1
TRBV29-1,TRBJ2-5,CSVEGATPGGAAQYF,2,0,1,2
TRBV12-5,TRBJ2-2,CASGPWQLTGELFF,1,0,1,1
TRBV10-3,TRBJ1-1,CAISGEPLNTEAFF,2,0,1,2
TRBV2,TRBJ2-3,CASGGQGLGDTQYF,2,0,1,2
TRBV13,TRBJ2-5,CASSLGRQGETQYF,1,0,1,1
TRBV19,TRBJ1-2,CASMPRTPYGYTF,1,0,1,1
TRBV12-3/4,TRBJ2-7,CASSLAQGSEQYF,1,0,1,1
TRBV5-1,TRBJ2-3,CASSLGNTDTQYF,1,0,1,1
TRBV5-1,TRBJ1-1,CASSEDANTEAFF,1,0,1,1
TRBV6-2/3/5/6,TRBJ2-7,CASSSVGGEQYF,1,0,1,1
TRBV2,TRBJ2-3,CASGTGVRTGTDTQYF,3,0,1,3
TRBV10-1,TRBJ1-6,CASSDKGLSSSYNSPLHF,1,0,1,1
TRBV5-6,TRBJ2-2,CASSLFGGMSTGELFF,1,0,1,1
TRBV12-3/4,TRBJ2-3,CASSQSSGGSTDTQYF,2,0,1,2
TRBV19,TRBJ1-5,CASTINRGPNQPQHF,1,0,1,1
TRBV18,TRBJ2-6,CASSPTNSGANVLTF,2,0,1,2
TRBV12-3/4,TRBJ1-5,CASSSSDRVDQPQHF,1,0,1,1
TRBV11-2,TRBJ2-1,CASSRSGVSYNEQFF,1,0,1,1
TRBV5-5,TRBJ2-7,CASSRPGSAVDEQYF,2,1,2,3
TRBV20-1,TRBJ2-3,CSARAYTGGADTQYF,1,0,1,1
TRBV18,TRBJ2-7,CASSLNKQGNEQYF,1,0,1,1
TRBV2,TRBJ1-5,CASDQGQGGQPQHF,1,0,1,1
TRBV7-9,TRBJ1-5,CASSLGQMHQPQHF,2,1,2,3
TRBV7-3,TRBJ1-1,CASSRRQGGTEAFF,2,0,1,2
TRBV28,TRBJ2-1,CASSISGGQDEQFF,1,0,1,1
TRBV5-1,TRBJ2-3,CASKGHASTDTQYF,1,0,1,1
TRBV18,TRBJ2-3,CASSRGHTDTQYF,1,0,1,1
TRBV28,TRBJ1-2,CASSPSPHYGYTF,4,0,1,4
TRBV12-3/4,TRBJ1-3,CASRRGSGNTIYF,1,0,1,1
TRBV7-6,TRBJ2-3,CASSWGHDTQYF,3,2,2,5
TRBV5-1,TRBJ1-6,CASSSVGSPLHF,1,0,1,1
TRBV5-1,TRBJ2-7,CASRGSTYEQYF,2,0,1,2
TRBV29-1,TRBJ1-1,CSVRTGRTEAFF,2,0,1,2
TRBV29-1,TRBJ1-1,CSVGQGPTEAFF,2,0,1,2
TRBV6-2/3/5/6,TRBJ1-2,CASSPGRLYGYTF,1,0,1,1
TRBV20-1,TRBJ1-1,RSARGKINTEAFF,1,0,1,1
TRBV7-2,TRBJ1-4,CARAPPGQGVTNEKLFF,1,0,1,1
TRBV19,TRBJ1-1,CASSNLYQGVNTEAFF,1,0,1,1
TRBV2,TRBJ2-1,CASSDPPDGGAPDEQFF,1,0,1,1
TRBV6-1,TRBJ2-7,CASSEALNRGRNYEQYF,1,0,1,1
TRBV5-1,TRBJ1-1,CASSADETLEAFF,1,0,1,1
TRBV3-1,TRBJ2-3,CASSQVVVGADTQYF,2,0,1,2
TRBV19,TRBJ2-1,CASSIQGKSAQFF,1,0,1,1
TRBV11-3,TRBJ2-2,CSSSFGGELFF,1,0,1,1
TRBV28,TRBJ1-2,CASSLERGWYGYTF,1,0,1,1
TRBV29-1,TRBJ2-3,CSVAGRGGQYTQYF,1,0,1,1
TRBV5-1,TRBJ1-1,CASSPGVRGEAFF,1,0,1,1
TRBV19,TRBJ1-1,CASSIFLGRGLKGTEAFF,1,0,1,1
TRBV12-5,TRBJ2-1,CASGLASTSGTYNEQFF,2,0,1,2
TRBV19,TRBJ2-7,CASSPLGTGFSYEQYF,1,0,1,1
TRBV12-3/4,TRBJ2-7,CASSTPGTSGEYEQYF,1,0,1,1
TRBV12-3/4,TRBJ1-5,CASSLSFRGRNQPQHF,1,0,1,1
TRBV3-1,TRBJ2-5,CASSQNTGTAQETQYF,1,0,1,1
TRBV29-1,TRBJ2-3,CSVSVGLAEGTDTQYF,2,0,1,2
TRBV18,TRBJ1-1,CASSPPASRGTEAFF,1,0,1,1
TRBV5-5,TRBJ2-1,CASSAELQSYNEQFF,1,0,1,1
TRBV4-1,TRBJ1-5,CASSQGQGGNQPQHF,1,0,1,1
TRBV29-1,TRBJ2-7,CSVEAAGTGAMGQYF,3,0,1,3
TRBV19,TRBJ2-3,CATTDTSSTDTQYF,2,0,1,2
TRBV19,TRBJ1-1,CASSTADYNTEAFF,1,0,1,1
TRBV19,TRBJ2-1,CASRGTAAYNEQFF,1,0,1,1
TRBV19,TRBJ1-4,CASNQGLTNEKLFF,1,0,1,1
TRBV18,TRBJ1-1,CASSPPLGNTEAFF,1,0,1,1
TRBV5-6,TRBJ1-4,CASTVGSEGEKLFF,1,0,1,1
TRBV5-1,TRBJ1-4,CASSSTGGPEKLFF,1,0,1,1
TRBV5-1,TRBJ1-1,CASSYAGRNTEAFF,2,0,1,2
TRBV29-1,TRBJ2-5,CSLLGLAGQETQYF,1,0,1,1
TRBV12-3/4,TRBJ1-5,CASSTGYGQPQHF,1,0,1,1
TRBV18,TRBJ2-2,CASRQGNTGELFF,1,0,1,1
TRBV7-3,TRBJ1-2,CASSSGQSYGYTF,1,0,1,1
TRBV29-1,TRBJ2-5,CSVRQGAQETQYF,2,2,2,4
TRBV7-2,TRBJ1-2,CASSPLPYGYTF,1,0,1,1
TRBV20-1,TRBJ2-3,CSARASTDTQYF,1,0,1,1
TRBV18,TRBJ1-4,CASSPYPAPATNEKLFF,1,0,1,1
TRBV12-3/4,TRBJ2-2,CASSLDRGENTGELFF,2,0,1,2
TRBV7-3,TRBJ1-1,CASRRDRVNTEAFF,1,0,1,1
TRBV18,TRBJ1-1,CASSLPRAGVNTEAFF,1,0,1,1
TRBV12-3/4,TRBJ1-1,CASLKRDANTGAFF,1,0,1,1
TRBV6-2/3/5/6,TRBJ2-7,CASSYSEPADQKTGYEQYF,3,0,1,3
TRBV7-3,TRBJ1-1,CASSLKGIHGGGTEAFF,2,4,2,6
TRBV4-2,TRBJ2-1,CASSQDPGSGGNEQFF,3,0,1,3
TRBV20-1,TRBJ1-4,CSARDSGTGREKLFF,1,0,1,1
TRBV3-1,TRBJ2-5,CASSFSTSEETQYF,2,1,2,3
TRBV5-1,TRBJ1-2,CASSLAETDYGYTF,2,0,1,2
TRBV11-2,TRBJ2-1,CASSQGTNLKQFF,4,0,1,4
TRBV7-2,TRBJ2-1,CASSFVIQLAAGVEQFF,1,0,1,1
TRBV10-1,TRBJ2-3,CASSDDTGTGRADTQYF,2,0,1,2
TRBV12-3/4,TRBJ2-2,CASSPTRRSNTGELFF,1,0,1,1
TRBV4-2,TRBJ2-2,CASSQDGLTRAGELFF,1,1,2,2
TRBV18,TRBJ1-2,CASSPGTGSDDGYTF,1,0,1,1
TRBV2,TRBJ2-7,CASIPIRGAVDEQYF,1,0,1,1
TRBV3-1,TRBJ2-2,CASTFRQGDTGELFF,1,0,1,1
TRBV6-2/3/5/6,TRBJ2-3,CASSYGTGIPDTQYF,2,0,1,2
TRBV2,TRBJ2-7,CASSGVQGSAYEQYF,3,0,1,3
TRBV6-2/3/5/6,TRBJ1-2,CASSPTELTGRGYTF,3,1,2,4
TRBV3-1,TRBJ1-5,CASSQDGVRNQPQHF,1,0,1,1
TRBV5-1,TRBJ2-1,CASSTYKSSYNEQFF,1,0,1,1
TRBV20-1,TRBJ2-4,CSASAPRDIKNIQYF,2,0,1,2
TRBV19,TRBJ1-2,CASSGTGLSRGYTF,1,0,1,1
TRBV19,TRBJ1-1,CASKGTGGNTEAFF,1,0,1,1
TRBV18,TRBJ1-1,CASSPRQSNTEAFF,2,0,1,2
TRBV18,TRBJ2-1,CASVGTHRDIEQFF,1,0,1,1
TRBV12-3/4,TRBJ1-1,CASSLAQGSTEAFF,1,0,1,1
TRBV28,TRBJ1-2,CASSYTGAGYGYTF,1,0,1,1
TRBV12-3/4,TRBJ2-5,CASSPRDGQETQYF,1,0,1,1
TRBV5-5,TRBJ1-6,CASSLEDRGSPLHF,1,0,1,1
TRBV6-2/3/5/6,TRBJ2-7,CASSSFLVSYEQYF,1,0,1,1
TRBV3-1,TRBJ1-3,CASSQVDSGNTIYF,2,0,1,2
TRBV2,TRBJ2-3,CASRRDRSTDTQYF,1,0,1,1
TRBV5-1,TRBJ2-7,CASSLRAGGDEQYF,1,0,1,1
TRBV5-1,TRBJ1-1,CASSWQAMNTEAFF,1,0,1,1
TRBV5-1,TRBJ1-2,CASSYTGANYGYTF,1,0,1,1
TRBV29-1,TRBJ1-1,CSVAGTALNTEAFF,2,0,1,2
TRBV29-1,TRBJ1-4,CSAEVAGGNENLFF,1,0,1,1
TRBV24-1,TRBJ2-2,YATSGTENTGELFF,1,0,1,1
TRBV28,TRBJ1-2,CATPSGGVYGYTF,2,0,1,2
TRBV19,TRBJ1-6,CASIGQYNSPLHF,1,0,1,1
TRBV19,TRBJ1-2,CASNRDKMHGYTF,1,0,1,1
TRBV28,TRBJ2-5,CASGGTGVETQYF,1,0,1,1
TRBV28,TRBJ2-5,CASSFTALETQYF,3,0,1,3
TRBV27,TRBJ1-1,CASSIGENTEAFF,1,0,1,1
TRBV7-2,TRBJ1-5,CASSLGSYQPQHF,1,0,1,1
TRBV7-3,TRBJ2-5,CASSSGPQETQYF,1,0,1,1
TRBV9,TRBJ2-7,CASSGTGRYEQYF,2,0,1,2
TRBV2,TRBJ2-3,CASRAERTDTQYF,1,0,1,1
TRBV20-1,TRBJ2-5,CSVVAGSPETQYF,1,0,1,1
TRBV29-1,TRBJ1-1,CSVDRGLNTEAFF,1,0,1,1
TRBV12-3/4,TRBJ2-1,CASSLQVGEQFF,1,0,1,1
TRBV12-3/4,TRBJ1-3,CASSRGGNTIYF,1,0,1,1
TRBV29-1,TRBJ2-3,CSVRGAADTQYF,1,0,1,1
TRBV19,TRBJ1-5,CASILKQPQHF,3,2,2,5
TRBV6-2/3/5/6,TRBJ2-3,CASSRDTQYF,1,0,1,1
TRBV18,TRBJ2-7,CASSPPGGILYEQYF,2,0,1,2
TRBV6-1,TRBJ2-3,CASRNIAGGTDTQYF,2,0,1,2
TRBV5-1,TRBJ2-3,CASSLPLAGADTQYF,1,0,1,1
TRBV5-1,TRBJ1-1,CASSPGNPGQMGAFF,2,0,1,2
TRBV6-1,TRBJ1-3,CASTGRWGGNTIYF,1,0,1,1
TRBV29-1,TRBJ1-1,CSVVQGPEAFF,1,0,1,1
TRBV5-1,TRBJ1-6,CASSIQTGTPNSPLHF,1,0,1,1
TRBV12-3/4,TRBJ2-3,CASSFRQYTDTQYF,2,0,1,2
TRBV7-2,TRBJ2-1,CASSLWGAINEQFF,1,0,1,1
TRBV7-8,TRBJ2-6,CASSLATGANVLTF,1,0,1,1
TRBV7-6,TRBJ2-2,CASSFEASGRWTGELFF,3,0,1,3
TRBV20-1,TRBJ2-3,CSAPAGGYTDTQYF,1,0,1,1
TRBV5-4,TRBJ2-3,CASSRTSGGPKDTQYF,2,0,1,2
TRBV5-1,TRBJ2-7,CASSPDHYEQYF,1,0,1,1
TRBV6-2/3/5/6,TRBJ2-3,CASSYWSHLEPTDTQYF,2,0,1,2
TRBV7-2,TRBJ2-3,CASSLEGRGGTDTQYF,2,1,2,3
TRBV5-1,TRBJ1-6,CASSRSESSYNSPLHF,1,0,1,1
TRBV11-2,TRBJ1-1,CASSLIGEERAEAFF,1,0,1,1
TRBV4-1,TRBJ2-1,CASSRPGQGYNEQFF,1,0,1,1
TRBV3-1,TRBJ2-1,CASSQGTTSNEQFF,2,1,2,3
TRBV5-1,TRBJ2-6,CASSDGSGANVLTF,1,0,1,1
TRBV20-1,TRBJ2-5,CSARRLGGQETQYF,1,0,1,1
TRBV12-3/4,TRBJ1-6,CASSHWRFDGRNSPLHHHLHF,1,0,1,1
TRBV30,TRBJ1-5,CAWSGGPHQPQHF,2,1,2,3
TRBV6-2/3/5/6,TRBJ2-3,CASSQDSDTQYF,1,0,1,1
TRBV19,TRBJ1-2,CASSMGGHGDNNYGYTF,1,0,1,1
TRBV19,TRBJ1-5,CASRRQGGGWGNQPQHF,1,0,1,1
TRBV28,TRBJ1-2,CASQHGRGRGANYGYTF,1,0,1,1
TRBV28,TRBJ2-3,CASSLLLAGTDTDTQYF,1,0,1,1
TRBV6-2/3/5/6,TRBJ1-5,CASSRSADRAGGQPQHF,1,0,1,1
TRBV7-9,TRBJ2-6,CASSLLGAVSGANVLTF,1,0,1,1
TRBV11-2,TRBJ1-2,CASSLPRGGRSNYGYTF,2,0,1,2
TRBV3-1,TRBJ2-3,CASSPKTGQDPWDTQYF,1,0,1,1
TRBV28,TRBJ1-1,CASSRIQGAISGTEAFF,1,0,1,1
TRBV28,TRBJ2-1,CASSLIWGSSYNEQFF,2,2,2,4
TRBV6-2/3/5/6,TRBJ1-2,CASSSGTGVPGGGYTF,1,0,1,1
TRBV28,TRBJ2-6,CASSSGQLSGANVLTF,1,0,1,1
TRBV11-2,TRBJ2-3,CASSLDTSGVTDTQYF,2,0,1,2
TRBV7-3,TRBJ2-1,CASSLKGLGLRNEQFF,1,0,1,1
TRBV11-2,TRBJ1-1,CASSSQFGDLNTEAFF,1,0,1,1
TRBV5-6,TRBJ1-4,CASSRIDRATNEKLFF,1,0,1,1
TRBV3-1,TRBJ2-1,CASSHFTGSSYNEQFF,1,0,1,1
TRBV3-1,TRBJ2-1,CASSQAGGDAYNEQFF,1,0,1,1
TRBV7-9,TRBJ2-1,CASSDKGRGPYNEQFF,1,0,1,1
TRBV5-1,TRBJ2-3,CASSLGGGPRADTQYF,2,0,1,2
TRBV20-1,TRBJ1-6,CSATGTGGDTNSPLHF,1,0,1,1
TRBV20-1,TRBJ2-3,CSARLSKRGARDTQYF,1,0,1,1
TRBV29-1,TRBJ2-1,CSVERLAGAPYNEQFF,1,0,1,1
TRBV18,TRBJ2-1,CASSPGQGAYNEQFF,2,0,1,2
TRBV2,TRBJ2-7,CASTNRGGGGYEQYF,1,0,1,1
TRBV2,TRBJ1-5,CASSNRVGRYQPQHF,1,0,1,1
TRBV3-1,TRBJ1-2,CASSPTGARNYGYTF,1,0,1,1
TRBV5-4,TRBJ2-3,CASSRGKYFTDTQYF,1,0,1,1
TRBV19,TRBJ2-7,CARRPKGGFSYEQYF,1,0,1,1
TRBV4-1,TRBJ1-4,CASSQPDREREKLFF,3,0,1,3
TRBV4-1,TRBJ1-2,CASSQDLDRNYGYTF,1,0,1,1
TRBV5-1,TRBJ2-1,CASSKLAGEHDEQFF,2,1,2,3
TRBV10-1,TRBJ1-2,CASRAGGGGADGYTF,1,0,1,1
TRBV29-1,TRBJ2-1,CSVGTRLSVYNEQFF,1,0,1,1
TRBV3-1,TRBJ1-3,CAGRPTGSGNTIYF,1,0,1,1
TRBV18,TRBJ1-1,CASSPSMVNTEAFF,1,0,1,1
TRBV12-3/4,TRBJ2-3,CASTWGLAGDTQYF,2,0,1,2
TRBV27,TRBJ2-5,CASSFQGAGETQYF,1,0,1,1
TRBV12-3/4,TRBJ1-2,CASSLQGLNYGYTF,2,0,1,2
TRBV12-3/4,TRBJ2-1,CASSLGGAVNEQFF,1,0,1,1
TRBV12-3/4,TRBJ2-3,CASSVGGASDTQYF,2,0,1,2
TRBV7-2,TRBJ1-3,CASSLGTVGNTIYF,2,0,1,2
TRBV7-2,TRBJ2-7,CASSPGTQSYEQYF,2,0,1,2
TRBV3-1,TRBJ1-1,CASSQEGRVGPAFF,1,0,1,1
TRBV9,TRBJ1-2,CASSVEPNDYGYTF,1,0,1,1
TRBV7-9,TRBJ1-6,CASSRGQEISPLHF,1,0,1,1
TRBV10-2,TRBJ2-1,CASRLAGGGNEQFF,1,0,1,1
TRBV20-1,TRBJ2-7,CSARRGHLGDEQYF,1,0,1,1
TRBV29-1,TRBJ2-5,CSRRLAGIQETQYF,1,0,1,1
TRBV29-1,TRBJ2-3,CSVLGTIHTDTQYF,1,0,1,1
TRBV29-1,TRBJ2-4,CSVAQGGAKNIQYF,1,0,1,1
TRBV29-1,TRBJ1-5,CSVEEGRRNQPQHF,1,0,1,1
TRBV29-1,TRBJ2-7,CSVAQGLGSREQYF,3,0,1,3
TRBV5-6,TRBJ1-2,YASTRDYRGYGYTF,1,0,1,1
TRBV12-3/4,TRBJ1-1,CASLLTQGSEAFF,1,0,1,1
TRBV19,TRBJ1-1,CASRGQGVTEAFF,1,0,1,1
TRBV18,TRBJ2-1,CASSPYSDNEQFF,1,0,1,1
TRBV28,TRBJ2-4,CASSSVAKNIQYF,1,0,1,1
TRBV2,TRBJ2-1,CASSEEQYNEQFF,1,0,1,1
TRBV7-9,TRBJ2-1,CASSLLGVNEQFF,1,0,1,1
TRBV7-9,TRBJ2-5,CASSSPGGETQYF,3,1,2,4
TRBV12-3/4,TRBJ1-1,CASSWGRHTEAFF,1,0,1,1
TRBV3-1,TRBJ2-7,CASSRHLDYEQYF,1,0,1,1
TRBV5-6,TRBJ2-3,CASSGLVADTQYF,1,0,1,1
TRBV11-3,TRBJ2-2,CASSTRDPGELFF,3,1,2,4
TRBV12-3/4,TRBJ2-5,CASRQQGQETQYF,1,0,1,1
TRBV5-1,TRBJ2-2,CASSFGSTGELFF,1,0,1,1
TRBV5-1,TRBJ2-2,CASSLRGTGELFF,1,0,1,1
TRBV29-1,TRBJ1-1,CSVQGRGHTEAFF,1,0,1,1
TRBV29-1,TRBJ1-1,CSGSTGGRTEAFF,1,0,1,1
TRBV6-2/3/5/6,TRBJ1-2,CASYGGNYGYTF,1,0,1,1
TRBV12-3/4,TRBJ1-1,CASSYDLREAFF,1,0,1,1
TRBV2,TRBJ2-2,CASSEVGGELFF,2,0,1,2
TRBV28,TRBJ2-7,CASRTTSYEQYF,1,0,1,1
TRBV20-1,TRBJ1-5,CSAFKTPWPQHF,1,0,1,1
TRBV19,TRBJ2-7,CASSTGQLQYF,1,0,1,1
TRBV29-1,TRBJ1-1,CSVGVDRAFF,1,0,1,1
TRBV18,TRBJ1-5,CASSPPGGYSNQPQHF,1,0,1,1
TRBV2,TRBJ1-6,CASREVQLQGSSPLHF,2,0,1,2
TRBV29-1,TRBJ2-3,CSVPGNSGGGADTQYF,3,1,2,4
TRBV11-2,TRBJ2-5,CASSGQGSEETQYF,1,0,1,1
TRBV18,TRBJ2-6,CASSPNPDGSLEGANVLTF,1,0,1,1
TRBV11-2,TRBJ1-6,CASSFNPQGGSSLHF,1,0,1,1
TRBV5-1,TRBJ1-1,CASSFRTGNTEAFF,3,0,1,3
TRBV7-2,TRBJ2-3,CASSLIGGRTDTQYF,3,0,1,3
TRBV25-1,TRBJ2-3,CASSQSGTGITDTQYF,2,0,1,2
TRBV5-4,TRBJ1-2,CASSRGDRWLNYGYTF,1,0,1,1
TRBV28,TRBJ1-5,CASRPAGVGNQPQHF,1,0,1,1
TRBV11-2,TRBJ2-1,CASSLDIVGDKDGIF,2,0,1,2
TRBV29-1,TRBJ1-1,CSVELGTEAFF,2,0,1,2
TRBV28,TRBJ2-5,CASSLSLLAGVPPQETQYF,1,0,1,1
TRBV12-5,TRBJ1-1,CASGPDQRGPLNTEAFF,1,0,1,1
TRBV18,TRBJ2-5,CASSPPLAGDRKETQYF,2,1,2,3
TRBV12-3/4,TRBJ1-4,CASSLENKPGRNEKLFF,1,0,1,1
TRBV27,TRBJ2-6,CASSSPQGAGGANVLTF,2,3,2,5
TRBV11-2,TRBJ2-3,CASSFFTGGASTDTQYF,2,0,1,2
TRBV5-4,TRBJ2-5,CASRQGGRGGIQETQYF,1,0,1,1
TRBV5-1,TRBJ1-3,CASSPGDESYSGNTIYF,3,2,2,5
TRBV18,TRBJ1-6,CASSPSQGGNNSPLHF,1,0,1,1
TRBV6-2/3/5/6,TRBJ2-6,CASSSQGRSGANVLTF,1,0,1,1
TRBV6-1,TRBJ2-3,CASSGIGLTIADTQYF,2,0,1,2
TRBV5-6,TRBJ2-7,CASSLDRGVFSYEQYF,1,0,1,1
TRBV11-1,TRBJ1-1,CASSYITGGASTEAFF,1,0,1,1
TRBV5-6,TRBJ1-5,CASSYTGRGSDQPQHF,1,0,1,1
TRBV28,TRBJ2-7,CASSLSGGTGGYEQYF,1,0,1,1
TRBV7-2,TRBJ2-3,CASSLRRRASTDTQYF,1,0,1,1
TRBV7-9,TRBJ2-7,CASSHTPGTGGYEQYF,2,2,2,4
TRBV5-6,TRBJ2-7,CASSEPALGGTPEQYF,1,0,1,1
TRBV30,TRBJ2-1,CAWSPDYRGNNEQFF,3,0,1,3
TRBV18,TRBJ2-7,CASLLGGAVSYEQYF,1,0,1,1
TRBV18,TRBJ1-6,CASSLTGTANSPLHF,1,0,1,1
TRBV2,TRBJ2-5,CASDEGSDRGETQYF,1,0,1,1
TRBV28,TRBJ1-6,CASSFLQLFHSPLHF,1,0,1,1
TRBV2,TRBJ2-5,CASSFARGRGETQYF,1,0,1,1
TRBV12-3/4,TRBJ2-6,CASSLFGPGANVLTF,1,0,1,1
TRBV28,TRBJ1-2,CASSLGTSGFNGYTF,1,0,1,1
TRBV6-2/3/5/6,TRBJ1-1,CASSLNRGMNTEAFF,1,0,1,1
TRBV28,TRBJ2-3,CASSPYMVSADTQYF,3,0,1,3
TRBV2,TRBJ1-5,CASSVEGGTNQPQHF,1,0,1,1
TRBV2,TRBJ1-2,CASSEVQGADYGYTF,1,0,1,1
TRBV2,TRBJ1-6,CASSEFYGGNSPLHF,1,0,1,1
TRBV28,TRBJ1-5,CASSTGVNSNQPQHF,1,0,1,1
TRBV7-8,TRBJ1-2,CASSLARTGAGGYTF,1,0,1,1
TRBV7-2,TRBJ2-3,CASSSDRLSTDTQYF,1,0,1,1
TRBV14,TRBJ2-7,CASSLVRDPPDEQYF,1,0,1,1
TRBV3-1,TRBJ2-1,CASSPLAGASIEQFF,1,0,1,1
TRBV3-1,TRBJ2-5,CASSQWDSSSETQYF,2,0,1,2
TRBV5-1,TRBJ2-2,CASTTGAANTGELFF,2,0,1,2
TRBV10-2,TRBJ2-5,CASSERGFGQETQYF,2,0,1,2
TRBV5-1,TRBJ2-6,CASSFSGTGANVLTF,1,0,1,1
TRBV5-1,TRBJ2-5,CASSLAGGEQETQYF,2,0,1,2
TRBV5-1,TRBJ2-1,CASSLGGNTYNEQFF,2,0,1,2
TRBV20-1,TRBJ2-5,CSAGITGGAGETQYF,2,0,1,2
TRBV20-1,TRBJ2-7,CSASSGTVDSYEQYF,1,0,1,1
TRBV20-1,TRBJ1-6,CSARPETRTNSPLHF,3,1,2,4
TRBV20-1,TRBJ1-6,CSARDFGQLNSPLHF,1,1,2,2
TRBV20-1,TRBJ2-3,CSARDGTSPTDTQYF,1,0,1,1
TRBV20-1,TRBJ2-1,CSAHGGRQNYNEQFF,2,0,1,2
TRBV20-1,TRBJ2-7,CSAIRLGGGSYEQYF,3,2,2,5
TRBV29-1,TRBJ1-2,CSVEVLKRGLYRYTF,1,0,1,1
TRBV28,TRBJ1-6,CATAAPGGDSPLHF,1,0,1,1
TRBV19,TRBJ2-1,CASSDMIPYNEQFF,1,0,1,1
TRBV19,TRBJ2-3,CASSTGTSADTQYF,2,0,1,2
TRBV18,TRBJ2-3,CASSPLGGTDTQYF,1,0,1,1
TRBV18,TRBJ2-5,CASSPQQGRETQYF,1,0,1,1
TRBV7-9,TRBJ1-6,CASAGNGLNSPLHF,1,0,1,1
TRBV2,TRBJ2-2,CASTGGPTTGELFF,1,0,1,1
TRBV2,TRBJ2-7,CASSSGTDNYEQYF,1,0,1,1
TRBV2,TRBJ2-1,CASSEARSGGLGFF,1,0,1,1
TRBV2,TRBJ2-2,CASSRETNTGELFF,1,0,1,1
TRBV7-9,TRBJ2-7,CASSFVARTYEQYF,1,0,1,1
TRBV7-2,TRBJ2-3,CASSLTGGLDTQYF,1,0,1,1
TRBV12-3/4,TRBJ2-7,CASSPLGLSYEQYF,1,0,1,1
TRBV28,TRBJ1-5,CASSPGQGRQPQHF,1,0,1,1
TRBV7-2,TRBJ2-3,CASSPEPSTDTQYF,1,0,1,1
TRBV11-2,TRBJ2-7,CASSRAWRVGEQYF,1,0,1,1
TRBV3-1,TRBJ2-7,CASSQGGRSYEQYF,1,0,1,1
TRBV7-9,TRBJ2-7,CASRDGTGTQRQYF,1,0,1,1
TRBV5-1,TRBJ1-1,CASSLLEGLTEAFF,1,0,1,1
TRBV5-1,TRBJ2-3,CASSLAQGTDTQYF,1,0,1,1
TRBV20-1,TRBJ2-3,CSVKSGTTQDTQYF,1,1,2,2
TRBV20-1,TRBJ2-1,CSARIAGGNNEQFF,1,0,1,1
TRBV20-1,TRBJ2-1,CSAIRGSSYNEQFF,1,0,1,1
TRBV29-1,TRBJ1-1,CSVGQGASDTEAFF,1,0,1,1
TRBV29-1,TRBJ1-2,CSVDGAGAPFGYTF,1,0,1,1
TRBV15,TRBJ2-3,CATSRKSTDTQYF,2,0,1,2
TRBV18,TRBJ1-2,CASSPPQGFGYTF,1,0,1,1
TRBV12-3/4,TRBJ2-2,CASSFRATGELFF,2,0,1,2
TRBV28,TRBJ2-7,CASSLGGGYEQYF,3,0,1,3
TRBV28,TRBJ2-1,CASSSHDTMGMFF,1,0,1,1
TRBV6-2/3/5/6,TRBJ1-6,CASSYYYNSPLHF,1,0,1,1
TRBV12-3/4,TRBJ1-1,CASSLLDQAEAFF,2,0,1,2
TRBV11-2,TRBJ1-1,CASSFGAAGRAFF,2,0,1,2
TRBV5-6,TRBJ1-2,CASSLVAVGGYTF,2,0,1,2
TRBV12-3/4,TRBJ2-7,CASSSGPRDEQYF,1,0,1,1
TRBV3-1,TRBJ1-5,CASSPNPISPQHF,1,0,1,1
TRBV11-1,TRBJ1-6,CASSDGWDSPLHF,1,0,1,1
TRBV5-1,TRBJ1-5,CASTGQGDQPQHF,1,0,1,1
TRBV5-1,TRBJ2-1,CASSLVKYNEQFF,1,0,1,1
TRBV5-1,TRBJ2-1,CASSQGNYNEQFF,1,0,1,1
TRBV20-1,TRBJ1-5,CSVDTGGGQPQHF,1,0,1,1
TRBV20-1,TRBJ2-7,CSARQGALNEQYF,2,0,1,2
TRBV20-1,TRBJ2-5,CSATPGQRETQYF,1,0,1,1
TRBV29-1,TRBJ1-2,CSVTEGGDYGYTF,1,0,1,1
TRBV29-1,TRBJ2-7,CSAGTSGGIEQYF,1,0,1,1
TRBV30,TRBJ2-5,CAWKIAGETQYF,1,0,1,1
TRBV12-3/4,TRBJ2-1,CASSSRDNEQFF,1,0,1,1
TRBV5-5,TRBJ2-3,CASSGTSDTQYF,1,1,2,2
TRBV20-1,TRBJ1-5,CSALDLSGPQHF,1,0,1,1
TRBV20-1,TRBJ2-3,CSASGGAWTQYF,1,0,1,1
TRBV6-2/3/5/6,TRBJ2-7,CASSNPGTEYF,1,0,1,1
TRBV7-9,TRBJ2-1,CASSPYNEQFF,2,0,1,2
TRBV29-1,TRBJ2-4,CSVFRENIQYF,1,1,2,2
TRBV29-1,TRBJ1-1,CSVGNTEAFF,1,0,1,1
TRBV29-1,TRBJ2-5,CSVSVETQYF,2,1,2,3
TRBV19,TRBJ1-4,PGSENEKLFF,1,0,1,1
TRBV11-2,TRBJ1-1,CASSLRITTGNAYMNTEAFF,2,0,1,2
TRBV15,TRBJ2-3,CATSRDPRAEDTQYF,1,0,1,1
TRBV3-1,TRBJ2-7,CASSPELAASYEQYF,1,0,1,1
TRBV5-1,TRBJ1-1,CASSLAGTGETEAFF,1,0,1,1
TRBV4-1,TRBJ2-1,CASSPTSGEYNEQFF,1,1,2,2
TRBV7-2,TRBJ2-1,CASSLASGGGEQFF,1,0,1,1
TRBV4-1,TRBJ2-7,CASSPRDGAPEQYF,1,0,1,1
TRBV6-2/3/5/6,TRBJ2-3,CASSSGQGPQYF,2,0,1,2
TRBV2,TRBJ1-1,CASFKEMNTEAFF,1,0,1,1
TRBV5-6,TRBJ2-1,CASSSPTGTSGTPWNEQFF,1,0,1,1
TRBV3-1,TRBJ1-5,CASSQDRPGGGQPQHF,1,0,1,1
TRBV28,TRBJ1-4,CASAQPGQGIEKLFF,1,0,1,1
TRBV7-9,TRBJ2-2,CASSLGRDREVELFF,2,0,1,2
TRBV20-1,TRBJ2-3,CSASLPGAATDTQYF,2,0,1,2
TRBV29-1,TRBJ1-1,CSVVRGTGGEPAFF,1,0,1,1
TRBV7-3,TRBJ2-7,CASSRGEAYEQYF,2,0,1,2
TRBV5-1,TRBJ2-2,CASSKLQGIGELFF,1,0,1,1
TRBV7-9,TRBJ1-2,CASSFPGFAGYTF,2,0,1,2
TRBV6-4,TRBJ2-3,CASSELGGPTSGGHTDTQYF,3,1,2,4
TRBV12-5,TRBJ2-2,CASGFFRDTGLFNTGELFF,1,0,1,1
TRBV7-3,TRBJ1-2,CASSLREPGQKYFNYGYTF,1,0,1,1
TRBV4-2,TRBJ1-5,CASSQGLGTGPYSNQPQHF,2,1,2,3
TRBV19,TRBJ1-5,CASTPFPQGLRGNQPQHF,1,0,1,1
TRBV3-1,TRBJ1-1,CASSQDPRKTLMNTEAFF,1,0,1,1
TRBV3-1,TRBJ2-2,CASSQGVGLATYTGELFF,1,0,1,1
TRBV9,TRBJ1-6,CASSGHPDRGVYNSPLHF,1,0,1,1
TRBV6-2/3/5/6,TRBJ2-3,CASSYGHRVRDTDTQYF,1,0,1,1
TRBV12-3/4,TRBJ2-3,CASSPEGAGALTDTQYF,1,0,1,1
TRBV27,TRBJ1-1,CASSPRQGALINTEAFF,1,0,1,1
TRBV12-3/4,TRBJ1-5,CASSTLRQLLSNQPQHF,1,0,1,1
TRBV5-6,TRBJ2-4,CASSSPGGRGAKNIQYF,1,0,1,1
TRBV9,TRBJ2-1,CASSGTSGTNSYNEQFF,1,0,1,1
TRBV6-2/3/5/6,TRBJ2-5,CASRAILIQRGRETQYF,1,0,1,1
TRBV5-1,TRBJ2-5,CASSLGTSGGHQETQYF,1,0,1,1
TRBV29-1,TRBJ2-1,CSVAHRDRGTPYNEQFF,1,0,1,1
TRBV30,TRBJ2-6,CAWSRVRSSGANVLTF,1,0,1,1
TRBV15,TRBJ2-1,CATSRDLAGGYNEQFF,1,0,1,1
TRBV7-3,TRBJ2-2,CASSPPGGRQSGELFF,1,0,1,1
TRBV28,TRBJ2-6,CASIPVGSSGANVLTF,1,0,1,1
TRBV28,TRBJ2-6,CASSFGRFSGANVLTF,1,0,1,1
TRBV12-3/4,TRBJ2-7,CASSLWVGQGSYEQYF,1,0,1,1
TRBV2,TRBJ2-2,CASSDWRLAGTGELFF,1,0,1,1
TRBV5-6,TRBJ2-1,CASSLAQGEAYNEQFF,2,0,1,2
TRBV5-4,TRBJ1-2,CASSLAGNRANYGYTF,1,0,1,1
TRBV5-4,TRBJ2-1,CASSLTTGPRGNEQFF,1,0,1,1
TRBV13,TRBJ2-3,CASSLGSASVADTQYF,1,0,1,1
TRBV7-3,TRBJ2-1,CASSPSPAGGPYEQFF,1,0,1,1
TRBV7-3,TRBJ2-5,CASSPRTSGAQETQYF,1,0,1,1
TRBV2,TRBJ2-3,CASRLQLAGPTDTQYF,1,0,1,1
TRBV5-1,TRBJ2-7,CASSLGTNIPPYEQYF,1,0,1,1
TRBV4-1,TRBJ2-7,CASSPAGDHPFYEQYF,1,0,1,1
TRBV20-1,TRBJ2-7,CSARGSSTGSSYEQYF,2,2,2,4
TRBV29-1,TRBJ2-2,CSVAAPTGVDTGELFF,1,0,1,1
TRBV10-3,TRBJ1-1,CAIRRQGDMNTEAFF,1,0,1,1
TRBV19,TRBJ1-1,CASSDRSAGNTEAFF,1,0,1,1
TRBV19,TRBJ1-5,CASSMGHISNQPQHF,1,0,1,1
TRBV18,TRBJ2-7,CASSSNRDQTYEQYF,2,0,1,2
TRBV28,TRBJ1-6,CASWGGQGRNSPLHF,1,0,1,1
TRBV12-3/4,TRBJ2-5,CASTPIGTDKETQYF,2,0,1,2
TRBV2,TRBJ1-2,CASTNPYGGPYGYTF,1,0,1,1
TRBV3-1,TRBJ2-3,CASSSRDRGTDTQYF,1,0,1,1
TRBV6-2/3/5/6,TRBJ1-3,CASSYDGRSGNTIYF,1,0,1,1
TRBV11-3,TRBJ2-1,CASSQRQDDYNEQFF,1,0,1,1
TRBV2,TRBJ2-2,CASSVYRQTTGELFF,1,0,1,1
TRBV6-1,TRBJ2-5,CASSEFRGGRETQYF,1,0,1,1
TRBV7-9,TRBJ1-4,CASSLDRGADEKLFF,1,0,1,1
TRBV11-2,TRBJ2-7,CASSSLTGTPREQYF,1,0,1,1
TRBV11-1,TRBJ2-7,CASSSGTGLSYEQYF,1,0,1,1
TRBV7-3,TRBJ2-7,CASSYGELRPYEQYF,1,0,1,1
TRBV12-3/4,TRBJ1-2,CASSLGREVNYGYTF,2,0,1,2
TRBV28,TRBJ1-1,CASSLTLRRNTEAFF,1,0,1,1
TRBV7-6,TRBJ1-4,CASSPGGTGNEKLFF,1,0,1,1
TRBV28,TRBJ2-5,CASSRDGTGKETQYF,1,0,1,1
TRBV7-3,TRBJ2-3,CASSRTGLSTDTQYF,1,0,1,1
TRBV3-1,TRBJ2-1,CASSHATRSYNEQFF,1,0,1,1
TRBV3-1,TRBJ2-2,CASSQQQGSNGELFF,1,0,1,1
TRBV3-1,TRBJ2-1,CASSQGTGPRNEQFF,1,0,1,1
TRBV3-1,TRBJ2-3,CASSQDLGPPDTQYF,1,0,1,1
TRBV10-2,TRBJ2-1,CASSEVVASYNEQFF,1,0,1,1
TRBV5-1,TRBJ1-5,CASSLHTGVDQPQHF,1,0,1,1
TRBV20-1,TRBJ2-7,CSASSPGLARYEQYF,1,0,1,1
TRBV20-1,TRBJ2-2,CSARASSLDTGELFF,1,0,1,1
TRBV29-1,TRBJ2-5,CSVALGTGGGETQYF,1,0,1,1
TRBV29-1,TRBJ1-1,CSVGGSLRGNTEAFF,3,0,1,3
TRBV29-1,TRBJ1-1,CSVDITGATYTEAFF,1,0,1,1
TRBV29-1,TRBJ1-3,CSVTGAGNGGNTIYF,1,0,1,1
TRBV10-3,TRBJ2-1,CAISAFATENEQFF,1,0,1,1
TRBV19,TRBJ2-7,CASSLQGDLYEQYF,2,0,1,2
TRBV19,TRBJ1-2,CASSPQVTNYGYTF,1,0,1,1
TRBV18,TRBJ2-3,CASSPLDKVDAQYF,1,0,1,1
TRBV18,TRBJ2-3,CASSPARSTDTQYF,1,0,1,1
TRBV2,TRBJ2-5,CASGDYRVGETQYF,1,0,1,1
TRBV12-3/4,TRBJ1-5,CASGTQGGNQPQHF,1,0,1,1
TRBV12-3/4,TRBJ1-6,CASSFTGGDSPLHF,1,0,1,1
TRBV28,TRBJ1-5,CASSFSRVAQPQHF,1,0,1,1
TRBV28,TRBJ2-5,CASSRLAGRETQYF,1,0,1,1
TRBV2,TRBJ1-5,CASSARNLNQPQHF,2,0,1,2
TRBV5-4,TRBJ2-3,CASSLQGSTDTQYF,1,0,1,1
TRBV5-5,TRBJ1-5,CASSLDQVLQPQHF,2,0,1,2
TRBV13,TRBJ2-7,CASSLAGDPPEQYF,1,0,1,1
TRBV7-9,TRBJ1-1,CASSWEAGNTEAFF,1,0,1,1
TRBV5-6,TRBJ2-1,CASSPKVSYNEQFF,1,0,1,1
TRBV3-1,TRBJ2-3,CASSRSGRTDTQYF,1,0,1,1
TRBV14,TRBJ2-5,CASSQVKGQETQYF,1,0,1,1
TRBV14,TRBJ2-5,CASSQDSGEETQYF,1,0,1,1
TRBV28,TRBJ1-2,CASSDREAGYGYTF,1,0,1,1
TRBV7-3,TRBJ2-3,CASSKGQVTDTQYF,1,0,1,1
TRBV12-3/4,TRBJ1-1,CASRRTGGLTEAFF,1,0,1,1
TRBV6-2/3/5/6,TRBJ2-2,CASRRGGITGELFF,1,0,1,1
TRBV7-3,TRBJ1-3,CASSRTGTGNTIYF,2,0,1,2
TRBV5-1,TRBJ1-1,CASSFTGTNTEAFF,1,0,1,1
TRBV5-1,TRBJ1-1,CASSLGQGAQVAFF,1,0,1,1
TRBV5-1,TRBJ1-6,CASSLTGINSPLHF,1,0,1,1
TRBV5-1,TRBJ1-4,CASRRRGGNEKLFF,1,0,1,1
TRBV20-1,TRBJ2-5,CSALTYRGKETQYF,1,0,1,1
TRBV20-1,TRBJ2-1,CSAIRQGAGNEQFF,1,0,1,1
TRBV20-1,TRBJ2-3,CSARGGLAGLRLYF,1,0,1,1
TRBV20-1,TRBJ2-2,CSAREGLGTGELFF,1,0,1,1
TRBV20-1,TRBJ1-5,CSAKGTDSNQPQHF,1,0,1,1
TRBV29-1,TRBJ2-1,CSVLTSGGHNEQFF,1,0,1,1
TRBV29-1,TRBJ2-3,CSVDRLAGGNTQYF,1,0,1,1
TRBV29-1,TRBJ2-2,CSVEHLANTGELFF,1,0,1,1
TRBV29-1,TRBJ2-7,CSVEDRQGNYEQYF,1,0,1,1
TRBV30,TRBJ1-1,CAWSGQGTTEAFF,1,0,1,1
TRBV2,TRBJ2-7,CATERDSTYEQYF,1,0,1,1
TRBV12-3/4,TRBJ1-1,CASMGDRVSEAFF,2,0,1,2
TRBV12-3/4,TRBJ1-5,CASSFSEDQPQHF,1,0,1,1
TRBV6-2/3/5/6,TRBJ2-5,CASSLDYQETQYF,1,0,1,1
TRBV12-3/4,TRBJ1-6,CASSPTVGSPLHF,1,0,1,1
TRBV6-4,TRBJ1-2,CASSDYRSYGYTF,1,0,1,1
TRBV27,TRBJ1-1,CASSEKGKLRAFF,1,0,1,1
TRBV7-8,TRBJ1-1,CASSLQGAREAFF,1,0,1,1
TRBV11-2,TRBJ1-5,CASSYTYNQPQHF,1,0,1,1
TRBV5-6,TRBJ1-1,CASSPTGQGLAFF,1,0,1,1
TRBV14,TRBJ1-4,CASSRWIGEKLVF,1,0,1,1
TRBV11-2,TRBJ1-1,CASSQWRNGEAFF,1,0,1,1
TRBV3-1,TRBJ2-5,CASSQELQETQYF,1,0,1,1
TRBV2,TRBJ1-2,CASRPGQVDGYTF,1,0,1,1
TRBV5-6,TRBJ2-4,CASKDSDKNIQYF,1,0,1,1
TRBV5-1,TRBJ2-5,CASTGTGQETQYF,1,0,1,1
TRBV10-2,TRBJ2-7,CASSPTGVYEQYF,1,0,1,1
TRBV5-1,TRBJ1-1,CASSLLGNTEAFF,1,0,1,1
TRBV5-1,TRBJ1-4,CASSLGPGEKLFF,1,0,1,1
TRBV5-1,TRBJ2-7,CASSPWDSYEQYF,1,0,1,1
TRBV5-1,TRBJ2-3,CASRLQGGDTQYF,1,0,1,1
TRBV20-1,TRBJ2-3,CSVGGTGDGTQYF,2,0,1,2
TRBV20-1,TRBJ1-2,CSADTDRVAGYTF,1,0,1,1
TRBV29-1,TRBJ2-5,CSALQGQGETQYF,1,0,1,1
TRBV18,TRBJ1-1,CASSLDGGATEF,1,0,1,1
TRBV12-3/4,TRBJ2-5,CASSFVQQTQYF,1,0,1,1
TRBV2,TRBJ1-2,CASSVVWGSYTF,2,0,1,2
TRBV7-9,TRBJ2-2,CASSFAAGELFF,1,0,1,1
TRBV5-6,TRBJ2-1,CASSLQGHEQFF,1,0,1,1
TRBV11-1,TRBJ2-7,CASSPRAYEQYF,1,0,1,1
TRBV3-1,TRBJ2-1,CASSQVSDEQFF,1,0,1,1
TRBV4-1,TRBJ1-2,CASSQEVGGYTF,1,0,1,1
TRBV29-1,TRBJ2-5,CSVEVIKETQYF,1,0,1,1
TRBV29-1,TRBJ2-3,CSALTTTDTQYF,2,0,1,2
TRBV29-1,TRBJ2-7,SSAASESYEQYF,1,0,1,1
TRBV12-3/4,TRBJ1-3,CASSLGTTIYF,1,0,1,1
TRBV6-2/3/5/6,TRBJ1-1,CASSLNTEAFF,1,0,1,1
TRBV2,TRBJ1-1,CASRQQLEASF,1,0,1,1
TRBV20-1,TRBJ1-2,CSARDNYGYTF,1,0,1,1
TRBV29-1,TRBJ2-5,CSVENRGTQYF,1,0,1,1
TRBV5-1,TRBJ2-1,CASAGPEQFF,1,0,1,1
TRBV7-9,TRBJ1-1,CASSPSRRRGAYTEAFF,1,0,1,1
TRBV5-1,TRBJ2-3,CASSLGASGGSTDTQYF,1,0,1,1
TRBV12-3/4,TRBJ1-5,CASSLDRGEGNQPQHF,2,0,1,2
TRBV2,TRBJ2-1,CASNSGGSSYNEQFF,1,0,1,1
TRBV20-1,TRBJ1-6,CSARGTGIENSPLHF,1,0,1,1
TRBV11-2,TRBJ2-5,CASSFRGVQETQYF,1,0,1,1
TRBV7-2,TRBJ1-2,CASSLAMPFYGYTF,1,0,1,1
TRBV7-3,TRBJ2-5,CASSPMGTFETQYF,2,0,1,2
TRBV5-6,TRBJ1-1,RASSKGRSGTEAFF,1,0,1,1
TRBV28,TRBJ2-5,CATSTTAQETQYF,1,0,1,1
TRBV20-1,TRBJ2-1,CSASGGGYNEQFF,2,0,1,2
TRBV28,TRBJ2-3,CASGGDTDMQYF,1,0,1,1
TRBV3-1,TRBJ2-2,CASSQISGELFF,2,0,1,2
TRBV6-2/3/5/6,TRBJ2-2,CASSYMGVTSGTGELFF,1,0,1,1
TRBV19,TRBJ1-5,CASSTLDGDRQPQHF,1,0,1,1
TRBV7-3,TRBJ2-3,CASSLQGGNTDTQYF,1,0,1,1
TRBV3-1,TRBJ2-7,CASSPTPTASYEQYF,1,0,1,1
TRBV18,TRBJ2-5,CASSRDRDQETQYF,1,0,1,1
TRBV7-9,TRBJ2-7,CASSFDRTSYEQYF,2,0,1,2
TRBV7-3,TRBJ2-3,CASSLAGGSDTQYF,1,0,1,1
TRBV25-1,TRBJ2-4,CASSDYPKNIQYF,1,0,1,1
TRBV5-6,TRBJ2-3,CASSRRGQDTQYF,1,0,1,1
TRBV7-8,TRBJ2-1,CASRLSPTGGQFF,1,0,1,1
TRBV28,TRBJ1-4,CASRRQRNEKLFF,1,0,1,1
TRBV2,TRBJ2-7,CARSVFYEQYF,1,0,1,1
TRBV7-2,TRBJ2-1,CASSFQPGLAGIIYNEQFF,1,0,1,1
TRBV20-1,TRBJ2-4,CSARDPPGGEGKNIQYF,3,1,2,4
TRBV5-1,TRBJ2-7,CVSSLAPSGGPYEQYF,1,0,1,1
TRBV29-1,TRBJ2-1,CSVEGTDLSAYNEQFF,1,0,1,1
TRBV29-1,TRBJ2-6,CSVGTTSGANVLTF,2,1,2,3
TRBV29-1,TRBJ2-3,CKVGTSTDTQYF,1,0,1,1
TRBV3-1,TRBJ1-1,CASSQDLGFSTVGGNTEAFF,1,0,1,1
TRBV27,TRBJ2-6,CTSSYDVRAPSSGANVLTF,1,0,1,1
TRBV3-1,TRBJ2-3,CASSQLAGGSTDKQYF,1,0,1,1
TRBV30,TRBJ2-7,CAWSHRTSGVYEQYF,1,0,1,1
TRBV5-8,TRBJ2-1,CASSDYRVTYNEQFF,1,0,1,1
TRBV24-1,TRBJ2-1,SATSDRQGVFNEQFF,1,0,1,1
TRBV28,TRBJ2-1,CASGPPTEDNEQFF,1,0,1,1
TRBV12-3/4,TRBJ2-4,CASSFRTGSNIQDF,1,0,1,1
TRBV7-2,TRBJ2-7,CASSLGRDYYEQYF,1,0,1,1
TRBV5-1,TRBJ2-3,CASSVGLVTDTQHF,1,0,1,1
TRBV5-6,TRBJ2-1,CASSLDIGEQFF,1,1,2,2
TRBV20-1,TRBJ1-5,CSAVRGLAPQHF,2,0,1,2
TRBV5-1,TRBJ2-3,CASRMTDTQYF,1,0,1,1
TRBV7-9,TRBJ2-1,CASSLEGVRGRSYNEQFF,1,0,1,1
TRBV20-1,TRBJ1-5,RSARASRRGQYLNQPQHF,1,0,1,1
TRBV5-1,TRBJ1-4,CASSFRAASTNEKLFF,2,0,1,2
TRBV6-2/3/5/6,TRBJ2-1,CASSYSGTSFNEQFF,1,0,1,1
TRBV5-4,TRBJ2-3,CASSLNRGRFANQYF,1,0,1,1
TRBV20-1,TRBJ2-5,CSAREISLAGGSQYF,1,0,1,1
TRBV12-5,TRBJ2-1,CASLRGSSYNEQFF,1,0,1,1
TRBV18,TRBJ2-5,CASSPPPAGETQYF,1,0,1,1
TRBV11-2,TRBJ1-1,CASISPRVITEAFF,1,0,1,1
TRBV11-1,TRBJ2-3,CASSLQVSTDTQYF,1,0,1,1
TRBV20-1,TRBJ2-7,RSARLQGASYEQYF,1,0,1,1
TRBV20-1,TRBJ2-1,CSARPPSYNEQFF,1,0,1,1
TRBV29-1,TRBJ1-1,CSAVQAGTEAFF,1,0,1,1
TRBV28,TRBJ1-2,CASSPPRLFPGNFNYGYTF,1,0,1,1
TRBV14,TRBJ2-1,CASKGGTSGAPSSYNEQFF,1,0,1,1
TRBV19,TRBJ1-2,CASSLTAGSGAFNYGYTF,1,0,1,1
TRBV6-2/3/5/6,TRBJ2-3,CASSSLYPTSGGGDTQYF,1,0,1,1
TRBV28,TRBJ2-3,CASSSPYHLAGRTDTQYF,2,0,1,2
TRBV7-9,TRBJ1-2,CASSFGAGTEPSYYGYTF,1,0,1,1
TRBV3-1,TRBJ2-7,CASSQEAKLAGAAYEQYF,2,0,1,2
TRBV5-4,TRBJ2-1,CASSIRGRGPNRYNEQFF,1,0,1,1
TRBV5-1,TRBJ2-3,CASSFRLAELSSTDTQYF,1,0,1,1
TRBV7-2,TRBJ1-5,CVSSLDLRTGGNQPQHF,1,0,1,1
TRBV5-4,TRBJ2-2,CASSLAGTGGYTGELFF,1,0,1,1
TRBV13,TRBJ2-5,CASSLGWSSGEQETQYF,1,0,1,1
TRBV9,TRBJ2-3,CASSSSGGIPFTDTQYF,1,0,1,1
TRBV14,TRBJ2-5,CASSPRTAGTIQETQYF,2,0,1,2
TRBV3-1,TRBJ2-5,CASSHYGLAGGQETQYF,2,0,1,2
TRBV10-3,TRBJ2-3,CAISEWASGGTDTQYF,1,0,1,1
TRBV19,TRBJ1-2,CASSRRPGHGANGYTF,1,0,1,1
TRBV19,TRBJ2-5,CASSRGLAGGRETQYF,1,0,1,1
TRBV18,TRBJ1-1,CASSRPGGAEGTEAFF,2,0,1,2
TRBV18,TRBJ1-2,CASSRFGQGNNYGYTF,1,0,1,1
TRBV28,TRBJ1-1,CASSSHGGGVNTEAFF,1,0,1,1
TRBV6-2/3/5/6,TRBJ2-2,CASSYSFSVYTGELFF,1,0,1,1
TRBV27,TRBJ1-4,CASSRIGSARKEKLFF,1,0,1,1
TRBV5-4,TRBJ2-1,CASSLGGGADYNEQFF,1,0,1,1
TRBV7-3,TRBJ2-1,CASSLMLAGPHNEQFF,1,0,1,1
TRBV7-8,TRBJ1-1,CASSSSPRASNTEAFF,1,0,1,1
TRBV28,TRBJ1-2,CASSRPRTGINYGYTF,1,0,1,1
TRBV3-1,TRBJ1-1,CASSHYTSGSRTEAFF,1,0,1,1
TRBV3-1,TRBJ2-1,CASSHTGTGSYNEQFF,1,0,1,1
TRBV14,TRBJ1-2,CASSQGFTPTEHGYTF,1,0,1,1
TRBV3-1,TRBJ2-7,CASSQTRGLAGREQYF,1,0,1,1
TRBV28,TRBJ2-5,CASRPSGGALRETQHF,1,0,1,1
TRBV5-1,TRBJ1-1,CASSLGDLGVNTEAFF,1,0,1,1
TRBV4-1,TRBJ2-1,CASSQDPRSSYNEQFF,1,0,1,1
TRBV5-1,TRBJ1-4,CASRMEPHRGSGKLFF,1,0,1,1
TRBV20-1,TRBJ2-7,CSARDWSWTGIYEQYF,1,0,1,1
TRBV20-1,TRBJ1-2,CSARDYAGVFGYGYTF,1,0,1,1
TRBV19,TRBJ2-3,CASTKLGGGTDTQYF,1,0,1,1
TRBV19,TRBJ2-7,CASSQSLAGGREQYF,1,0,1,1
TRBV19,TRBJ1-1,CASSIGTLKGPEAFF,1,0,1,1
TRBV2,TRBJ2-3,CASSHGDFSTDTQYF,1,0,1,1
TRBV18,TRBJ1-2,CASSPPPGPNYGYTF,2,0,1,2
TRBV11-2,TRBJ1-5,CASAAGGIGNQPQHF,1,0,1,1
TRBV7-9,TRBJ2-5,CASTPPRAAQETQYF,1,1,2,2
TRBV28,TRBJ2-1,CASSLYLARHNEQFF,1,0,1,1
TRBV28,TRBJ1-5,CASSLVGGDNQPQHF,1,0,1,1
TRBV12-3/4,TRBJ2-2,CASSLRSLNTGELFF,1,0,1,1
TRBV12-3/4,TRBJ2-3,CASSSRTSGVDTQYF,1,0,1,1
TRBV28,TRBJ2-7,CASSSRAGGAYEQYF,1,0,1,1
TRBV2,TRBJ2-5,CASSSPPPGGETQYF,1,0,1,1
TRBV28,TRBJ2-3,CASSYSEPSTDTQYF,1,0,1,1
TRBV6-2/3/5/6,TRBJ1-6,CASSLQGQNNSPLHF,1,0,1,1
TRBV12-3/4,TRBJ2-1,CASSRSGGNYNEQFF,1,0,1,1
TRBV5-6,TRBJ2-1,CASSFRDSAYNEQFF,1,0,1,1
TRBV7-9,TRBJ1-1,CASSFATGTNTEAFF,1,0,1,1
TRBV7-6,TRBJ1-1,CASSLSSGEATEAFF,1,0,1,1
TRBV11-2,TRBJ2-5,CASSLGPGGQETQYF,1,0,1,1
TRBV7-9,TRBJ2-4,CASSLGRDSKNIQYF,1,0,1,1
TRBV7-9,TRBJ2-7,CASSLGDAGGYEQYF,1,0,1,1
TRBV7-2,TRBJ2-3,CASSSGRGSTDTQYF,1,0,1,1
TRBV11-2,TRBJ2-3,CASSLAGRGTDTQYF,1,0,1,1
TRBV14,TRBJ2-2,CASSPRTRNTGELFF,1,0,1,1
TRBV7-3,TRBJ2-7,CASSPSGQGTSEQYF,1,0,1,1
TRBV12-3/4,TRBJ2-2,CASSPGQGYTGELFF,1,0,1,1
TRBV11-2,TRBJ1-6,CASSPQQGMGSPLHF,1,0,1,1
TRBV3-1,TRBJ2-6,CASSQAGAGANVLTF,1,0,1,1
TRBV3-1,TRBJ2-4,CASSQETGGKNIQYF,1,0,1,1
TRBV3-1,TRBJ1-6,CASSQKGSQNSPLHF,1,0,1,1
TRBV7-9,TRBJ1-1,CASSGGQGAKTEAFF,1,0,1,1
TRBV2,TRBJ2-1,CASRVGSGPYNEQFF,1,0,1,1
TRBV2,TRBJ2-1,CASRAIAGGNNEQFF,1,0,1,1
TRBV5-1,TRBJ2-2,CASLPGGSNTGELFF,1,0,1,1
TRBV5-1,TRBJ2-2,CASTSGAGNTGELFF,1,0,1,1
TRBV5-1,TRBJ1-2,CASSLVPDPNYGYTF,1,0,1,1
TRBV5-1,TRBJ1-3,CASSLVGSPGNTIYF,1,0,1,1
TRBV5-1,TRBJ2-5,CASSLARDRQETQYF,1,0,1,1
TRBV5-1,TRBJ1-1,CASSLGQGARTEAFF,1,0,1,1
TRBV5-1,TRBJ2-5,CASSSGPSGGETQYF,2,0,1,2
TRBV5-1,TRBJ1-5,CASSLWGASNQPQHF,1,0,1,1
TRBV4-1,TRBJ1-2,CASSQLAKGRWGYTF,1,0,1,1
TRBV5-1,TRBJ1-2,CASSNTGQGAFGYTF,1,0,1,1
TRBV20-1,TRBJ2-7,CSARKPASGGHEQYF,1,0,1,1
TRBV20-1,TRBJ2-5,CSATRLAGGGETQYF,1,0,1,1
TRBV20-1,TRBJ1-1,CSASTGGGFYLEAFF,1,0,1,1
TRBV20-1,TRBJ1-2,CSARAPDSSNYGYTF,1,0,1,1
TRBV20-1,TRBJ1-5,CSARDKGRAYQPQHF,1,0,1,1
TRBV20-1,TRBJ1-1,CSARNLYSENTEAFF,1,0,1,1
TRBV29-1,TRBJ1-2,CSVDPAGTPENGYTF,1,0,1,1
TRBV7-7,TRBJ2-3,CASSRGGSTDTQYF,1,0,1,1
TRBV24-1,TRBJ1-3,CATRDNEIGNTIYF,1,0,1,1
TRBV19,TRBJ1-1,CASSSSSGRTEAFF,1,0,1,1
TRBV19,TRBJ2-2,CASSPGRYTGELFF,1,0,1,1
TRBV12-3/4,TRBJ1-1,CASRPWAINTEAFF,1,0,1,1
TRBV11-2,TRBJ1-1,CASGFNRGGTEAFF,1,0,1,1
TRBV12-3/4,TRBJ1-5,CASSFQGSAQPQHF,1,0,1,1
TRBV6-2/3/5/6,TRBJ2-3,CASSLEAITDTQYF,1,0,1,1
TRBV12-3/4,TRBJ1-2,CASSLRTGKNGYTF,1,0,1,1
TRBV27,TRBJ2-1,CASSSPGRSNEQFF,1,0,1,1
TRBV27,TRBJ2-7,CASSPSPRDYEQYF,1,0,1,1
TRBV6-2/3/5/6,TRBJ1-3,CASSPQGAGNTIYF,1,0,1,1
TRBV12-3/4,TRBJ2-5,CASSRRDKQETQYF,1,0,1,1
TRBV6-1,TRBJ1-5,CASSVDRGNQPQHF,1,0,1,1
TRBV6-1,TRBJ2-2,CASSALRNTGELFF,1,0,1,1
TRBV6-1,TRBJ1-1,CASSASGTDTEAFF,1,0,1,1
TRBV2,TRBJ2-1,CASSALAAYNEQFF,1,0,1,1
TRBV6-1,TRBJ1-4,CASSEVLIGEKLFF,1,0,1,1
TRBV7-9,TRBJ1-1,CASSMVQGRTEAFF,1,0,1,1
TRBV7-9,TRBJ1-1,CASSFTNLNTEAFF,1,0,1,1
TRBV7-2,TRBJ1-4,CASSLGLNNEKLFF,1,0,1,1
TRBV7-2,TRBJ1-5,CASSLLFSNQPQHF,1,0,1,1
TRBV11-2,TRBJ1-4,CASSLVGTDEKLFF,1,0,1,1
TRBV11-1,TRBJ2-1,CASSSGGLYNEQFF,2,0,1,2
TRBV7-9,TRBJ1-1,CASSWGQGMPEAFF,1,0,1,1
TRBV3-1,TRBJ1-1,CASSQTGGWNEAFF,1,0,1,1
TRBV3-1,TRBJ2-2,CASSQAPDTGELFF,1,2,2,3
TRBV3-1,TRBJ1-5,CASSQGTRNQPQHF,1,0,1,1
TRBV7-2,TRBJ2-7,CASSEGTGYYEQYF,1,0,1,1
TRBV7-2,TRBJ2-7,CASSNYGTSYEQYF,1,0,1,1
TRBV2,TRBJ2-3,CASRALWGTDTQYF,1,0,1,1
TRBV12-3/4,TRBJ2-6,CASNTGSGANVLTF,1,1,2,2
TRBV20-1,TRBJ2-5,CSALYQGYAETQYF,1,0,1,1
TRBV5-1,TRBJ2-3,CASTMGGDTDTQYF,1,0,1,1
TRBV4-1,TRBJ2-7,CASSFVGRSYEQYF,1,0,1,1
TRBV5-1,TRBJ1-3,CASSLQYPGNTIYF,2,0,1,2
TRBV20-1,TRBJ2-2,CSARDQGNTGELLF,1,0,1,1
TRBV20-1,TRBJ2-1,CSAPGAVPGHEQFF,2,0,1,2
TRBV20-1,TRBJ2-5,CSAHLLGGLETQYF,1,0,1,1
TRBV20-1,TRBJ2-5,CSGGAGGNRETQYF,1,0,1,1
TRBV29-1,TRBJ2-4,CSVLKNEAKNIQYF,1,0,1,1
TRBV29-1,TRBJ2-1,CSVLGWGGDNEQFF,1,0,1,1
TRBV29-1,TRBJ2-5,CSVEEDSGVETQYF,1,0,1,1
TRBV29-1,TRBJ2-1,CSVKGISAYNEQFF,1,0,1,1
TRBV29-1,TRBJ2-1,CSVAGVRSYNEQFF,1,0,1,1
TRBV29-1,TRBJ2-1,CSVYGTSSRNEQFF,1,0,1,1
TRBV29-1,TRBJ1-4,CSAAVGQANEKLFF,1,0,1,1
TRBV30,TRBJ1-1,CAWTRQGAAEAFF,2,0,1,2
TRBV18,TRBJ1-6,CAGKGQLNSPLHF,1,0,1,1
TRBV10-3,TRBJ1-5,CAISISSNQPQHF,1,0,1,1
TRBV24-1,TRBJ1-1,CATSERQGARAFF,1,0,1,1
TRBV15,TRBJ1-1,CATSRVKVPGAFF,1,0,1,1
TRBV15,TRBJ1-1,CATSRIGGTEAFF,1,0,1,1
TRBV19,TRBJ2-1,CASSVAGANEQFF,1,0,1,1
TRBV18,TRBJ2-7,CASSPAQAYEQYF,1,0,1,1
TRBV2,TRBJ1-4,CASGRGINEKLFF,1,0,1,1
TRBV27,TRBJ2-1,CASSFGLSNEQFF,1,0,1,1
TRBV6-2/3/5/6,TRBJ1-5,CASSFKENQPQHF,1,0,1,1
TRBV28,TRBJ2-6,CASSLAGINVLTF,1,0,1,1
TRBV6-2/3/5/6,TRBJ1-2,CASSSYLHYGYTF,1,0,1,1
TRBV6-2/3/5/6,TRBJ1-1,CASSYSGTGNVFF,1,0,1,1
TRBV28,TRBJ1-5,CASSGGSNQPQHF,1,0,1,1
TRBV2,TRBJ1-1,CASSEDDWTEAFF,2,0,1,2
TRBV12-3/4,TRBJ2-5,CASSEDSRETQYF,1,0,1,1
TRBV7-9,TRBJ2-7,CASSFFTRHEQYF,1,0,1,1
TRBV7-9,TRBJ2-3,CASSLRVPDTQYF,1,0,1,1
TRBV7-2,TRBJ1-1,CASSLVLGTEAFF,1,0,1,1
TRBV11-2,TRBJ2-3,CASSLGATDTQYF,1,0,1,1
TRBV7-3,TRBJ2-7,CASSLEQGYEQYF,1,1,2,2
TRBV5-4,TRBJ2-7,CASSSRDSYEQYF,1,0,1,1
TRBV7-6,TRBJ1-1,CASSSQENTEAFF,2,0,1,2
TRBV7-9,TRBJ1-6,CASSSEYNSPLHF,1,0,1,1
TRBV3-1,TRBJ2-4,CASSLERGNIQYF,1,0,1,1
TRBV12-3/4,TRBJ1-1,CASSLTGGTEAFF,1,0,1,1
TRBV7-3,TRBJ2-1,CASSPTGDNEQFF,1,0,1,1
TRBV14,TRBJ1-2,CASSRDISYGYAF,1,0,1,1
TRBV7-9,TRBJ1-2,CASSVTGVYGYTF,1,0,1,1
TRBV5-6,TRBJ2-1,CASRSRGKDEQFF,1,0,1,1
TRBV10-1,TRBJ2-7,CASSERARGEQYF,1,0,1,1
TRBV5-1,TRBJ2-5,CASSFSGAETQYF,1,0,1,1
TRBV5-1,TRBJ1-2,CASSSTDRGGYTF,1,0,1,1
TRBV5-1,TRBJ2-5,CASSLQGEETQYF,1,0,1,1
TRBV20-1,TRBJ1-5,CSASAQGTQPQHF,1,0,1,1
TRBV20-1,TRBJ1-2,CSASLRTGYGYTF,1,0,1,1
TRBV20-1,TRBJ1-6,CSASRQEHSPLHF,1,0,1,1
TRBV20-1,TRBJ2-3,CSARVSGADTQYF,1,1,2,2
TRBV20-1,TRBJ1-5,CSALGQGGQPQHF,1,0,1,1
TRBV29-1,TRBJ2-5,CSVHSGARETQYF,1,0,1,1
TRBV29-1,TRBJ2-7,CSVGTATSYEQYF,1,0,1,1
TRBV29-1,TRBJ1-1,CSVDRGRNTEAFF,1,0,1,1
TRBV29-1,TRBJ1-4,CSVEITPGEKLSF,1,0,1,1
TRBV29-1,TRBJ2-7,CSVLGGTAYEQYF,1,0,1,1
TRBV29-1,TRBJ1-1,CSAHGGGGTEAFF,1,0,1,1
TRBV20-1,TRBJ2-3,RSALQGTTNTQYF,1,0,1,1
TRBV18,TRBJ1-1,CASSQGYSEAFF,1,0,1,1
TRBV2,TRBJ1-5,CASRDSNQPQHF,1,0,1,1
TRBV6-2/3/5/6,TRBJ1-5,CASATTGQPQHF,1,0,1,1
TRBV28,TRBJ1-5,CASSFFNQPQHF,1,0,1,1
TRBV12-3/4,TRBJ2-2,CASSLLQGKVFF,1,0,1,1
TRBV6-2/3/5/6,TRBJ2-5,CASSYRGETQYF,1,0,1,1
TRBV7-9,TRBJ1-1,CASSFGRVEAFF,1,0,1,1
TRBV7-2,TRBJ2-3,CASSLVADTQYF,1,1,2,2
TRBV28,TRBJ1-1,CASSLSGIEAFF,1,0,1,1
TRBV28,TRBJ1-2,CASSLTGLGYTF,1,0,1,1
TRBV3-1,TRBJ1-1,CASSLRRAEAFF,1,0,1,1
TRBV14,TRBJ2-1,CASSPAPGEQFF,1,0,1,1
TRBV3-1,TRBJ1-2,CASSPAWYGYTF,1,0,1,1
TRBV14,TRBJ2-5,CASSQQGETQYF,1,0,1,1
TRBV7-8,TRBJ2-7,CARKDRTYEQYF,1,0,1,1
TRBV29-1,TRBJ2-5,CLAGGPQETQYF,2,0,1,2
TRBV10-1,TRBJ2-2,CASSGYTGELFF,1,0,1,1
TRBV5-1,TRBJ1-2,CASSLLGDGYTF,1,0,1,1
TRBV29-1,TRBJ1-2,CSVVGTGNGYTF,1,0,1,1
TRBV29-1,TRBJ2-5,CSVREHQETQYF,1,0,1,1
TRBV29-1,TRBJ1-4,CSGRQGGEKLFF,1,0,1,1
TRBV30,TRBJ2-1,CAWSRRGEQFF,1,0,1,1
TRBV19,TRBJ2-6,CASSGANVLTF,2,0,1,2
TRBV28,TRBJ2-5,CASSTGRTQYF,1,0,1,1
TRBV5-6,TRBJ1-1,CASSFNTEAFF,1,0,1,1
TRBV29-1,TRBJ1-1,CSVEISTEAFF,1,3,2,4
TRBV29-1,TRBJ1-1,CSVSVGTEAFF,2,0,1,2
TRBV29-1,TRBJ2-7,CSAGVSYEQYF,1,0,1,1
TRBV19,TRBJ2-1,CASGGVEQFF,1,0,1,1
TRBV7-9,TRBJ1-1,CASSLIEAFF,1,0,1,1
TRBV10-3,TRBJ1-1,CAISGDGSGQYKGDTEAFF,1,0,1,1
TRBV18,TRBJ1-2,CASSPGPLGYIQGVDGYTF,1,0,1,1
TRBV11-2,TRBJ1-6,CASSLRGDRGRQLNSPLHF,2,0,1,2
TRBV20-1,TRBJ1-2,CSASRGGYQDIRTNYGYTF,1,0,1,1
TRBV10-3,TRBJ2-7,CAISDPEGWYSISYEQYF,1,0,1,1
TRBV19,TRBJ2-6,CASSIPGRLSSGANVLTF,2,0,1,2
TRBV5-4,TRBJ2-1,CASSLEVGLAGGYNEQFF,1,0,1,1
TRBV11-2,TRBJ2-1,CASSLWGTGGGSPVPQFF,1,0,1,1
TRBV5-5,TRBJ1-3,CASSSPRTGVWSGNTIYF,1,0,1,1
TRBV5-6,TRBJ2-1,CASSSTPGLAGTWNEQFF,1,0,1,1
TRBV3-1,TRBJ2-5,CASSHEGGRQLGQETQYF,1,0,1,1
TRBV7-2,TRBJ2-3,CASSHAGTSGASTDTQYF,1,0,1,1
TRBV2,TRBJ2-3,CASSASTSGGTITDTQYF,1,0,1,1
TRBV11-3,TRBJ2-1,CASSKILPGFGPYNEQFF,1,0,1,1
TRBV5-1,TRBJ1-1,CASSLLPETGPEGTEAFF,1,0,1,1
TRBV18,TRBJ1-2,CASSPYRDQATNYGYTF,1,0,1,1
TRBV18,TRBJ2-1,CASSPYRDSIAGDEQFF,1,0,1,1
TRBV18,TRBJ2-7,CASSPKAGAMSTYEQYF,1,0,1,1
TRBV12-3/4,TRBJ2-1,CASSLVSGEGSYNEQFF,1,0,1,1
TRBV6-2/3/5/6,TRBJ2-1,CASSYRTSGALYNEQFF,1,0,1,1
TRBV11-1,TRBJ2-1,CASSLGRGTSGVSEQFF,1,0,1,1
TRBV7-2,TRBJ2-1,CASSLGGYRVMGNEQFF,1,0,1,1
TRBV3-1,TRBJ2-3,CASSLRASSGGTDTQYF,1,0,1,1
TRBV7-9,TRBJ2-1,CASSPKGGGAFYNEQFF,1,0,1,1
TRBV3-1,TRBJ2-5,CASSQGTSGGAAETQYI,1,0,1,1
TRBV3-1,TRBJ2-3,CASSQEITRSSTDTQYF,1,0,1,1
TRBV5-6,TRBJ2-3,CASSGRTSDSRTDTQYF,1,0,1,1
TRBV6-2/3/5/6,TRBJ1-6,CASRPGWRSRYNSPLHF,1,0,1,1
TRBV6-4,TRBJ2-3,CASRQNWDRSSTDTQYF,1,0,1,1
TRBV12-3/4,TRBJ2-3,CASRGYSGTGGVDTQYF,1,0,1,1
TRBV19,TRBJ2-2,CASNQDLRTVNTGELFF,1,0,1,1
TRBV5-1,TRBJ1-2,CASTQSDGTGQNYGYTF,1,1,2,2
TRBV18,TRBJ2-3,CASSPKAGTGTDTQYF,1,0,1,1
TRBV7-2,TRBJ1-5,CASSILSGQINQPRHF,1,0,1,1
TRBV12-3/4,TRBJ2-2,CASTQRDRINTGELFF,1,0,1,1
TRBV27,TRBJ1-5,CASSFPGTGGNQPQHF,1,0,1,1
TRBV12-3/4,TRBJ1-4,CASSFGNGHLNEKLFF,2,0,1,2
TRBV27,TRBJ2-7,CASSLSYRDRVYEQYF,2,0,1,2
TRBV28,TRBJ1-2,CASSLGTSRSLNGYTF,1,0,1,1
TRBV27,TRBJ2-5,CASSLLAGTQPETQYF,1,0,1,1
TRBV12-3/4,TRBJ2-3,CASSLGQGVGTDTQYF,1,0,1,1
TRBV12-3/4,TRBJ1-5,CASSWGGTGSNQPQHF,1,0,1,1
TRBV11-2,TRBJ2-5,CASSQGSSGGMKTQYF,1,0,1,1
TRBV6-1,TRBJ2-3,CASSEGASGGSDTQYF,1,0,1,1
TRBV6-4,TRBJ2-5,CASSMDFGPLQETQYF,1,0,1,1
TRBV2,TRBJ1-1,CASSSTGGAGNTEAFF,1,0,1,1
TRBV28,TRBJ2-3,CASSRISGGYTDTQYF,1,0,1,1
TRBV5-4,TRBJ1-1,CASSLPGEGLDTEAFF,1,0,1,1
TRBV7-9,TRBJ2-1,CASSPSQGRTYNEQFF,1,0,1,1
TRBV5-8,TRBJ2-1,CASSPFRGAVYNEQFF,2,0,1,2
TRBV14,TRBJ2-1,CASSRTSSGGADEQFF,2,1,2,3
TRBV14,TRBJ2-7,CASSQRGFWERYEQYF,1,0,1,1
TRBV13,TRBJ2-3,CASSQNRELATDTQYF,1,0,1,1
TRBV7-9,TRBJ1-5,CASSEGGGTVSQPQHF,1,0,1,1
TRBV11-2,TRBJ1-4,CASSNRGLAANEKLFF,1,0,1,1
TRBV7-3,TRBJ2-2,CASSNTGQGNTGELFF,1,0,1,1
TRBV5-5,TRBJ2-3,CASRLWVNHDVDTQYF,1,0,1,1
TRBV6-2/3/5/6,TRBJ2-1,CASRPIPTSGGGKQFF,1,0,1,1
TRBV7-9,TRBJ2-3,CASRGNTGGGSDTQYF,1,0,1,1
TRBV5-1,TRBJ2-1,CASTQPSGGAEDEQFF,1,0,1,1
TRBV5-1,TRBJ1-2,CASSLLGPENYYGYTF,1,0,1,1
TRBV5-1,TRBJ2-3,CASSLAERGSTDTQYF,1,0,1,1
TRBV4-1,TRBJ2-1,CASSQVGRQHYDEQFF,1,0,1,1
TRBV5-1,TRBJ2-4,CASSGPGVRAKNIQYF,1,0,1,1
TRBV20-1,TRBJ2-3,CSARGKRKSATDTQYF,1,0,1,1
TRBV20-1,TRBJ2-7,CSARDLGLAAVYEQYF,1,0,1,1
TRBV20-1,TRBJ2-7,CSARESVGGRPYEQYF,1,0,1,1
TRBV7-2,TRBJ2-3,CASSYSGFSTDTQYF,1,0,1,1
TRBV7-7,TRBJ2-5,CASSRWTGRRETQYF,1,0,1,1
TRBV19,TRBJ2-1,CASTAGTSGYNEQFF,1,0,1,1
TRBV7-2,TRBJ2-3,CASTRQGLSTDTQYF,1,0,1,1
TRBV19,TRBJ1-5,CASSMFGFGNQPQHF,1,0,1,1
TRBV19,TRBJ1-5,CASSIDRTVNQPQHL,1,0,1,1
TRBV19,TRBJ2-1,CASRSGTGESNEQFF,1,0,1,1
TRBV18,TRBJ2-2,CASSLGQANTGELFF,1,0,1,1
TRBV12-3/4,TRBJ2-7,CASTTRAGGDSEQYF,1,0,1,1
TRBV12-3/4,TRBJ1-6,CASSFAGSYNSPLHF,1,0,1,1
TRBV27,TRBJ1-6,CASSFGPTYNSPLHF,1,0,1,1
TRBV28,TRBJ1-6,CASSLSGQGSSPLHF,1,0,1,1
TRBV12-3/4,TRBJ1-5,CASSLRQASNQPQHF,1,0,1,1
TRBV6-2/3/5/6,TRBJ2-3,CASSLKGISTDTQYF,1,0,1,1
TRBV6-2/3/5/6,TRBJ1-5,CASSWQSISNQPQHF,1,0,1,1
TRBV28,TRBJ2-3,CASSWVRGATDTQYF,1,0,1,1
TRBV6-2/3/5/6,TRBJ1-5,CASSYSAGGNQPQHF,1,0,1,1
TRBV28,TRBJ2-7,CASSPGQGSTYEQYF,1,0,1,1
TRBV2,TRBJ1-5,CASSRVRGIGQPQRF,1,0,1,1
TRBV2,TRBJ2-7,CASSVVGRHSYEQYF,1,0,1,1
TRBV2,TRBJ1-6,CASSDYNSYNSPLHF,1,0,1,1
TRBV6-1,TRBJ2-7,CASSEAQGQGYEQYF,1,0,1,1
TRBV6-1,TRBJ2-5,CASSEAQPRSETQYF,1,0,1,1
TRBV2,TRBJ2-1,CASSEAQSSYNEQFF,1,0,1,1
TRBV6-1,TRBJ1-1,CASSEGGTVNTEAFF,1,0,1,1
TRBV11-2,TRBJ2-5,CASSFEPDFQETQYF,2,0,1,2
TRBV7-6,TRBJ1-6,CASSFSGQGNSPLHF,1,0,1,1
TRBV7-6,TRBJ2-1,CASSFLAGPFHEQFF,1,0,1,1
TRBV2,TRBJ1-4,CASSFHRGFSEKLFF,1,0,1,1
TRBV11-3,TRBJ2-2,CASSFGGGASGELFF,1,0,1,1
TRBV5-6,TRBJ1-2,CASSLVGGENYGYTF,1,0,1,1
TRBV11-2,TRBJ2-5,CASSLGLLQQETQYF,1,0,1,1
TRBV7-9,TRBJ1-1,CASSLGGGMNTEAFF,2,0,1,2
TRBV7-3,TRBJ2-3,CASSLISGSSGAQYF,1,0,1,1
TRBV7-9,TRBJ2-2,CASSSGGGNTGELFF,1,0,1,1
TRBV11-2,TRBJ2-7,CASSSKDSRTYEQYF,1,0,1,1
TRBV12-3/4,TRBJ2-5,CASSPTTGLGETQYF,1,0,1,1
TRBV4-2,TRBJ2-3,CASSPLAGGTDTQYF,2,0,1,2
TRBV3-1,TRBJ2-5,CASSHGRGGLETQYF,1,0,1,1
TRBV3-1,TRBJ2-7,CASSQATDSAYEQYF,1,0,1,1
TRBV3-1,TRBJ2-5,CASSQDYGGAGAQYF,1,0,1,1
TRBV7-2,TRBJ2-1,CASSTLNYVGNEQFF,1,0,1,1
TRBV5-1,TRBJ2-3,CASIAGQGAPDTQYF,1,0,1,1
TRBV5-1,TRBJ2-3,CASSLFQKNTDTQYF,1,1,2,2
TRBV5-1,TRBJ2-7,CASSLAPRGSYEQYF,1,0,1,1
TRBV5-1,TRBJ1-1,CASSLGRQGDNEAFF,1,0,1,1
TRBV5-1,TRBJ2-1,CASSLEGWGDNEQFF,1,0,1,1
TRBV5-1,TRBJ1-4,CASSPLGGTNEKLFS,1,0,1,1
TRBV4-1,TRBJ2-4,CASSQVSGGKNIQYF,1,0,1,1
TRBV20-1,TRBJ2-3,CSASLAGDPTDTQYF,1,0,1,1
TRBV20-1,TRBJ2-5,CSARRTGRWQETQYF,1,0,1,1
TRBV20-1,TRBJ2-1,CSARDGKSSYNEQFF,1,0,1,1
TRBV29-1,TRBJ2-2,CSVGRRTANTGELFF,1,0,1,1
TRBV29-1,TRBJ2-3,CSVEGAGGSTDTQYF,1,0,1,1
TRBV30,TRBJ1-1,CAWNDPGGLPEAFF,1,0,1,1
TRBV28,TRBJ2-2,CAGSTGWAAGELFF,1,0,1,1
TRBV30,TRBJ1-1,CAGAAGTLNTEAFF,1,0,1,1
TRBV10-3,TRBJ1-1,CAISEGQMNTEAFF,2,0,1,2
TRBV15,TRBJ1-5,CATSRGQGNQPQHF,1,0,1,1
TRBV19,TRBJ1-5,CASIRTGGNQPQHF,1,0,1,1
TRBV19,TRBJ1-5,CASRQGAGNQPQHF,1,0,1,1
TRBV18,TRBJ1-1,CASSARDSNTEAFF,1,0,1,1
TRBV18,TRBJ2-7,CASSPDRDDYEQYF,2,1,2,3
TRBV18,TRBJ2-7,CASSPRGFTYEQYF,1,0,1,1
TRBV28,TRBJ2-2,CASGTGTNTGELFF,1,0,1,1
TRBV12-3/4,TRBJ1-2,CASGPGQGFYGYTF,1,0,1,1
TRBV12-3/4,TRBJ1-2,CASTFGGANYGYTF,1,1,2,2
TRBV5-6,TRBJ2-3,CASTPLGRQDTQYF,2,0,1,2
TRBV2,TRBJ1-2,CASTRIGTAYGYTF,1,0,1,1
TRBV12-3/4,TRBJ2-5,CASTRRGGQETQYF,2,0,1,2
TRBV6-2/3/5/6,TRBJ2-1,CASSLLRAGDEQFF,1,0,1,1
TRBV28,TRBJ2-2,CASSLQGATGELFF,1,0,1,1
TRBV28,TRBJ1-5,CASSLRGWGQPQHF,1,0,1,1
TRBV12-3/4,TRBJ1-2,CASSLNRGSYGYTF,1,2,2,3
TRBV27,TRBJ2-7,CASSSRQGGYEQYF,1,0,1,1
TRBV12-3/4,TRBJ2-7,CASSYSSGSYEQYF,1,0,1,1
TRBV6-2/3/5/6,TRBJ1-5,CASSYGGGNQPQHF,1,0,1,1
TRBV2,TRBJ1-6,CASSPPGEISPLHF,1,0,1,1
TRBV2,TRBJ2-5,CASSGPGGRETQYF,1,0,1,1
TRBV2,TRBJ1-1,CASSGRGLNTEAFL,1,0,1,1
TRBV2,TRBJ1-1,CASSGDGRQTEAFF,1,0,1,1
TRBV6-1,TRBJ1-2,CASSGTGDYYGYTF,1,0,1,1
TRBV6-1,TRBJ1-1,CASSESGVYTEAFF,1,0,1,1
TRBV13,TRBJ2-7,CASSLRGGRYEQYF,1,0,1,1
TRBV5-4,TRBJ2-7,CASSLKGGSNEQYF,1,0,1,1
TRBV7-3,TRBJ2-3,CASSLTHTTDTQYF,1,0,1,1
TRBV7-9,TRBJ1-2,CASSLNQVAYGYTF,1,0,1,1
TRBV6-2/3/5/6,TRBJ1-2,CASSSQVTNYGYTF,1,0,1,1
TRBV6-2/3/5/6,TRBJ1-4,CASSLGQLYEKLFF,1,0,1,1
TRBV12-3/4,TRBJ1-5,CASSPLESNQPQHF,1,0,1,1
TRBV7-6,TRBJ1-1,CASSPRTGNTEAFF,2,0,1,2
TRBV7-6,TRBJ1-1,CASSHRYMNTEAFF,1,0,1,1
TRBV12-3/4,TRBJ1-1,CASSHREQNTEAFF,1,3,2,4
TRBV3-1,TRBJ2-1,CASSQNRLADEQFC,1,0,1,1
TRBV12-3/4,TRBJ1-5,CASSGGTSNQPQHF,2,0,1,2
TRBV9,TRBJ1-1,CASSDGQGWTEAFF,1,0,1,1
TRBV7-9,TRBJ2-7,CASSTWRGSYEQYF,1,0,1,1
TRBV13,TRBJ2-5,CASSSPGGEETQYF,1,0,1,1
TRBV5-6,TRBJ2-7,CASRREGTGYEQYF,1,0,1,1
TRBV2,TRBJ1-5,CASKKGGGSQPQHF,1,0,1,1
TRBV5-1,TRBJ2-3,CAARLVPSTDTQYF,1,0,1,1
TRBV5-1,TRBJ1-1,CASTPQGPNTEAFF,1,0,1,1
TRBV10-1,TRBJ2-3,CASSEAGGTDTQYF,1,0,1,1
TRBV5-1,TRBJ2-7,CASSFSGRVDEQYF,2,0,1,2
TRBV5-1,TRBJ2-7,CASSLAGDVYEQYF,1,0,1,1
TRBV5-1,TRBJ2-1,CASSLDRVSNEQFF,1,0,1,1
TRBV5-1,TRBJ1-4,CASSLQGASEKLFF,1,0,1,1
TRBV5-1,TRBJ2-1,CASSLTSGGEEQFF,1,0,1,1
TRBV5-1,TRBJ1-2,CASSSGWANYGYTF,1,0,1,1
TRBV5-1,TRBJ2-1,CASSPREFYNEQFF,2,0,1,2
TRBV4-1,TRBJ1-2,CASSQNRGVYGYTF,1,0,1,1
TRBV5-1,TRBJ1-1,CASSRQGGDTEAFF,1,0,1,1
TRBV20-1,TRBJ2-5,CSAPLPSGEETQYF,1,0,1,1
TRBV20-1,TRBJ1-5,CSARDGTVNQPQHF,1,0,1,1
TRBV29-1,TRBJ2-3,CSVTWGRGTDTQYF,2,1,2,3
TRBV5-1,TRBJ2-7,WASSYGTSGYEQYF,1,0,1,1
TRBV30,TRBJ1-1,CAWSRGPNTEAFF,1,0,1,1
TRBV10-3,TRBJ2-3,CASLAGVTDTQYF,1,0,1,1
TRBV19,TRBJ2-5,CASSMWEKETQYF,1,0,1,1
TRBV19,TRBJ2-1,CASSTGLAGVQFF,1,0,1,1
TRBV19,TRBJ2-1,CASSTKVYNEQFF,1,0,1,1
TRBV18,TRBJ1-5,CASSPGEDQPQHF,1,0,1,1
TRBV18,TRBJ2-5,CASSPGLGETQYF,1,0,1,1
TRBV18,TRBJ2-5,CASSPDSGETQYF,1,0,1,1
TRBV12-3/4,TRBJ2-5,CASSFLTSQTQYF,1,0,1,1
TRBV12-3/4,TRBJ1-3,CASSLSAGNTIYF,1,1,2,2
TRBV12-3/4,TRBJ2-3,CASSLQDADTQYF,1,0,1,1
TRBV2,TRBJ1-5,CASSVFENQPQHF,1,0,1,1
TRBV2,TRBJ1-1,CASSDRGDTEAFF,1,0,1,1
TRBV7-9,TRBJ2-3,CASSLDPVDTQYF,1,0,1,1
TRBV11-2,TRBJ2-5,CASSLERQETQYF,1,0,1,1
TRBV7-2,TRBJ2-2,CASSLTGAGELFF,1,0,1,1
TRBV5-6,TRBJ2-5,CASSLSPGETQYF,1,0,1,1
TRBV3-1,TRBJ2-7,CASSSGGGSEQYF,1,0,1,1
TRBV10-3,TRBJ2-7,CASSSGGPYEQYF,1,0,1,1
TRBV7-3,TRBJ2-3,CASSSDPADTQYF,1,0,1,1
TRBV7-9,TRBJ1-5,CASSWGQNQPQHF,1,0,1,1
TRBV12-3/4,TRBJ1-2,CASSPQANYGYTF,1,0,1,1
TRBV28,TRBJ2-7,CASSPGGSYEQYF,1,0,1,1
TRBV7-3,TRBJ2-1,CASSPTGYNEQFF,1,0,1,1
TRBV5-4,TRBJ2-1,CASSPGLADEQFF,1,0,1,1
TRBV3-1,TRBJ1-6,CASSRDRATPLHF,1,0,1,1
TRBV3-1,TRBJ1-2,CASSQDGRQFSAF,1,0,1,1
TRBV3-1,TRBJ1-2,CASSQDDNHGYTF,1,0,1,1
TRBV14,TRBJ2-7,CASSQEVRSEQYF,1,0,1,1
TRBV6-2/3/5/6,TRBJ2-2,CASSIQGAGELFF,1,0,1,1
TRBV7-9,TRBJ2-3,CASSTRAGATQYF,1,0,1,1
TRBV13,TRBJ1-1,CASSTQGLGEAFF,1,0,1,1
TRBV27,TRBJ2-1,CASRRGVDNEQFF,1,0,1,1
TRBV9,TRBJ2-2,CASRGPNTGELFF,1,0,1,1
TRBV6-4,TRBJ2-7,CASRTDDSYEQYF,1,0,1,1
TRBV28,TRBJ1-2,CTTPSGGVYSYTF,1,0,1,1
TRBV5-1,TRBJ2-3,CASSLSGTDTQYF,1,0,1,1
TRBV5-1,TRBJ1-1,CASSSGRNTEAFF,1,0,1,1
TRBV5-1,TRBJ2-3,CASSSGVPDTQYF,1,0,1,1
TRBV4-1,TRBJ2-3,CASSLRLADTQYF,1,0,1,1
TRBV5-1,TRBJ2-7,CASSTGQGFEQYF,1,0,1,1
TRBV10-2,TRBJ2-7,CASRGQVGYEQYF,1,0,1,1
TRBV20-1,TRBJ2-7,CSASDSLLQEQYF,1,0,1,1
TRBV29-1,TRBJ2-1,CSVVQGVYNEQFF,1,0,1,1
TRBV29-1,TRBJ2-7,CSVAKGISYEQYF,1,0,1,1
TRBV29-1,TRBJ2-7,CSVADTISYEQYF,1,0,1,1
TRBV29-1,TRBJ1-2,CSVGQVLNYGYTF,1,0,1,1
TRBV29-1,TRBJ2-6,CSVDRAGANVLAF,1,0,1,1
TRBV29-1,TRBJ2-7,CSVEVGGNYEQYF,1,0,1,1
TRBV29-1,TRBJ2-5,CSVEDLITETQYF,1,0,1,1
TRBV29-1,TRBJ2-5,CSVEEVGTETQYF,1,0,1,1
TRBV29-1,TRBJ2-3,CSVRTRHTDTQYF,1,0,1,1
TRBV29-1,TRBJ2-4,CSVVRGAKNIQYF,1,0,1,1
TRBV29-1,TRBJ1-1,CSVGRGENTEAFF,1,0,1,1
TRBV29-1,TRBJ1-1,CSADDTLNTEAFF,1,0,1,1
TRBV30,TRBJ1-5,CAWAPDRGPQHF,1,0,1,1
TRBV30,TRBJ1-4,CAWSSAPEKLFF,1,0,1,1
TRBV24-1,TRBJ1-5,CATGQGDQPQHF,1,0,1,1
TRBV12-3/4,TRBJ1-5,CATRQGDQPQHF,1,0,1,1
TRBV19,TRBJ2-1,CASSLHVGEQFF,1,0,1,1
TRBV19,TRBJ2-3,CASSISTDTQYF,1,0,1,1
TRBV19,TRBJ1-2,CASSTGARGYTF,1,0,1,1
TRBV18,TRBJ2-3,CASSPNTDTQYF,1,1,2,2
TRBV2,TRBJ2-5,CASGGQGETQYF,1,0,1,1
TRBV25-1,TRBJ1-6,CASELGNSPLHF,1,0,1,1
TRBV27,TRBJ1-5,CASTRGDQPQHF,1,0,1,1
TRBV28,TRBJ2-1,CASSFWVNEQFF,1,0,1,1
TRBV28,TRBJ1-2,CASSFVGYGYTF,1,0,1,1
TRBV12-3/4,TRBJ2-1,CASSRGQNEQFF,1,0,1,1
TRBV2,TRBJ2-3,CASSEGSGTQYF,1,0,1,1
TRBV2,TRBJ1-3,CASSETRNTIYF,1,0,1,1
TRBV7-9,TRBJ1-2,CASSLPLYGYTF,1,0,1,1
TRBV7-9,TRBJ2-3,CASSLDPNTQYF,1,0,1,1
TRBV5-4,TRBJ1-2,CASSWSGAGYTF,1,0,1,1
TRBV2,TRBJ1-5,CASNEVGQPQHF,1,0,1,1
TRBV2,TRBJ2-3,CGEGPPPDTQYF,1,0,1,1
TRBV5-1,TRBJ2-7,CASSLPGREQYF,2,0,1,2
TRBV20-1,TRBJ2-5,CSAPTVQETQYF,1,0,1,1
TRBV29-1,TRBJ2-5,CSVTGSGETQYF,2,0,1,2
TRBV29-1,TRBJ2-7,CSVDWGAGEQYF,1,0,1,1
TRBV29-1,TRBJ2-5,CSVTRNEETQYF,1,0,1,1
TRBV29-1,TRBJ1-2,CSASGLNYGYTF,1,0,1,1
TRBV29-1,TRBJ2-7,RSGGQGPYEQYF,1,0,1,1
TRBV28,TRBJ2-5,CAVASLETQYF,1,0,1,1
TRBV10-3,TRBJ2-5,CAAGIGETQYF,1,0,1,1
TRBV19,TRBJ1-4,CASESREKLFF,1,0,1,1
TRBV18,TRBJ2-1,CASSPFNEQFF,1,0,1,1
TRBV2,TRBJ2-1,CASRYHNEQFF,1,0,1,1
TRBV11-2,TRBJ2-3,CASTDRDTQYF,1,0,1,1
TRBV11-2,TRBJ1-1,CASSLAGYAFF,1,0,1,1
TRBV11-2,TRBJ2-5,CASSLAETQYF,2,1,2,3
TRBV7-9,TRBJ2-5,CASSSIETQYF,1,0,1,1
TRBV3-1,TRBJ1-1,CASSQGGQENF,1,0,1,1
TRBV29-1,TRBJ1-2,CSVSIAWGYTF,1,1,2,2
TRBV29-1,TRBJ1-1,CSVGGSTEAFF,2,0,1,2
TRBV6-4,TRBJ1-2,CASRGSGYTF,1,0,1,1
TRBV29-1,TRBJ2-7,CSVVSYEQYF,1,0,1,1
TRBV19,TRBJ1-6,CASSTLGHTNYNSPLHY,1,0,1,1
TRBV29-1,TRBJ2-1,CSVAVGLSGGAYNEQFF,1,0,1,1
TRBV6-2/3/5/6,TRBJ2-3,CASSTRRELWTDTQYF,2,0,1,2
TRBV5-1,TRBJ1-3,CASSVGTSPSGNTIYF,1,0,1,1
TRBV30,TRBJ1-5,CAWSAPALSNQPQHF,1,0,1,1
TRBV10-3,TRBJ1-1,CAISRTGSGITEAFF,2,0,1,2
TRBV7-9,TRBJ2-2,CASSLAPSNTGELFF,1,2,2,3
TRBV9,TRBJ1-5,CASSVEGRSNQPQHF,1,0,1,1
TRBV4-1,TRBJ1-6,CASSLRTGENSPLHF,1,2,2,3
TRBV4-1,TRBJ2-1,CASSKLGGLGNEQFF,1,0,1,1
TRBV19,TRBJ2-2,CARRLGSNTGELFF,1,0,1,1
TRBV18,TRBJ2-3,CASSGVESTDTQYF,2,0,1,2
TRBV7-6,TRBJ2-5,CASSLGQGRETQYF,1,0,1,1
TRBV14,TRBJ1-1,CASSQGWVNTEAFF,1,0,1,1
TRBV5-1,TRBJ2-7,CASSLGDRVDEQYF,1,0,1,1
TRBV5-1,TRBJ1-6,CASSLPGDNSPLHF,1,0,1,1
TRBV28,TRBJ1-2,CASSFGTDNGYTF,1,0,1,1
TRBV2,TRBJ2-3,CASRAGVTDTQYF,1,0,1,1
TRBV4-1,TRBJ2-3,CASSQVPGTAMHF,1,0,1,1
TRBV29-1,TRBJ1-3,CSVASGAGNTTYF,1,0,1,1
TRBV29-1,TRBJ2-7,CSDRDYATYEQYF,1,0,1,1
TRBV7-9,TRBJ1-1,CVSMGLVRSAFF,1,0,1,1
TRBV5-1,TRBJ2-1,CASSLEGLPQFF,1,0,1,1
TRBV7-2,TRBJ2-3,CASSLIFPRGGPTDTQYF,1,0,1,1
TRBV10-3,TRBJ2-3,CAISGTGLITSTGTQYF,1,0,1,1
TRBV3-1,TRBJ2-7,CASSQDRGVGGTYEQYF,2,0,1,2
TRBV18,TRBJ1-4,CASSPHPPATNENLFF,1,0,1,1
TRBV7-6,TRBJ1-3,CASSPRGNLAGNTIYL,1,0,1,1
TRBV14,TRBJ2-1,CASSQDKGDSYNEQFF,1,0,1,1
TRBV28,TRBJ1-1,CASSLWVSMNTEASF,1,0,1,1
TRBV28,TRBJ2-1,CASSRLAGLYNGQFF,2,0,1,2
TRBV7-9,TRBJ1-1,CASSLGGTGGTEAFF,2,0,1,2
TRBV7-3,TRBJ2-2,CASSLNGADTGELFF,1,0,1,1
TRBV4-1,TRBJ1-5,CVSSQASGGNQPQHF,2,0,1,2
TRBV5-1,TRBJ2-7,CASRQDSSISYEQYF,2,0,1,2
TRBV20-1,TRBJ1-1,CSARRFEGGDAEAFF,1,0,1,1
TRBV19,TRBJ1-1,CASSTQGARTEAFF,1,0,1,1
TRBV7-9,TRBJ2-7,CASSLARTAYEQYF,1,0,1,1
TRBV29-1,TRBJ1-5,CSVVVSGPNHPQHF,1,0,1,1
TRBV2,TRBJ2-5,CASNRGGRETQYF,1,0,1,1
TRBV12-3/4,TRBJ2-1,CASSRRAFEQFF,1,0,1,1
TRBV11-2,TRBJ1-1,CASSPRPPGAFF,1,0,1,1
TRBV28,TRBJ1-2,CASSLSTDRPSFNLQANYGYTF,2,0,1,2
TRBV6-2/3/5/6,TRBJ1-1,CASSYKGPGQVYGANTEAFF,1,0,1,1
TRBV7-9,TRBJ2-1,CATRPLGLAGATSYNEQFF,1,0,1,1
TRBV2,TRBJ2-3,CASSDGTSGGVFRTDTQYF,1,0,1,1
TRBV28,TRBJ2-3,CASSNGLGTWSRASDTQYF,1,0,1,1
TRBV11-2,TRBJ2-7,CASSLPLSFDRAPYYEQYF,1,0,1,1
TRBV14,TRBJ2-7,CASSQDPSTGGFLAYEQYF,2,0,1,2
TRBV5-1,TRBJ2-1,CASKSDGVLVPYSYNEQFF,1,0,1,1
TRBV12-5,TRBJ1-2,CASGWYDIWQGINYGYTF,1,0,1,1
TRBV28,TRBJ1-1,CAGSFRLGGGNQNTEAFF,1,0,1,1
TRBV6-2/3/5/6,TRBJ2-1,CASSYTSPAGVFYNEQFF,1,0,1,1
TRBV28,TRBJ2-7,CASSPMFVAATGHYEQYF,1,0,1,1
TRBV7-2,TRBJ2-2,CASSLVIWAGGSAGELFF,1,0,1,1
TRBV7-3,TRBJ2-1,CASSLTLLAEGPYNEQFF,1,0,1,1
TRBV9,TRBJ2-2,CASSPSWGHPSYTGELFF,1,0,1,1
TRBV14,TRBJ1-3,CASSQDLWDPRGRNTIYF,1,1,2,2
TRBV3-1,TRBJ2-2,CASSQDLLRGGLTGELFF,1,0,1,1
TRBV3-1,TRBJ2-3,CASSQEASGGSVSGTQYF,1,0,1,1
TRBV7-9,TRBJ2-3,CASSGGRLAERSTDTQYF,1,0,1,1
TRBV4-1,TRBJ1-5,CASSQGVKAGASNQPQHF,1,0,1,1
TRBV19,TRBJ2-1,CASSMGSGAGSEYKQFF,1,0,1,1
TRBV19,TRBJ1-2,CASSIGSAGDRNYGYTL,1,0,1,1
TRBV19,TRBJ2-7,CASSIDWWQGVAYEQYF,1,0,1,1
TRBV28,TRBJ1-5,CASTRRGAGGNSQPQHF,1,0,1,1
TRBV28,TRBJ2-3,CASSLWGSGESTDTQYF,1,0,1,1
TRBV2,TRBJ2-1,CASSSRTSGGRYNEQFF,1,0,1,1
TRBV6-2/3/5/6,TRBJ2-3,CASSYSRLVTGTDTQYF,1,0,1,1
TRBV9,TRBJ1-2,CASSPLPSRGAGYGYTF,1,0,1,1
TRBV28,TRBJ2-7,CASSHRLAGGRIYEQYF,1,0,1,1
TRBV6-4,TRBJ1-6,CASSVSLIGGFNSPLHF,1,0,1,1
TRBV7-3,TRBJ1-4,CASSFERIPLPHEKLFF,1,0,1,1
TRBV7-9,TRBJ1-1,CASSLWGTGEINTEAFF,1,0,1,1
TRBV7-3,TRBJ2-1,CASSLLGQHSSYNEQFF,1,0,1,1
TRBV7-2,TRBJ2-7,CASSLGQTGVISYEQYF,1,0,1,1
TRBV5-6,TRBJ1-5,CASSSPGGKGGNQPQHF,1,0,1,1
TRBV11-2,TRBJ1-2,CASSSLRVGGSNYGYTF,1,0,1,1
TRBV11-2,TRBJ2-1,CASSSALLRGGRNEQFF,2,0,1,2
TRBV11-2,TRBJ1-1,CASSSTTLGQPNTEAFF,1,0,1,1
TRBV5-6,TRBJ2-2,CASSPQLAGEHTGELFF,1,0,1,1
TRBV3-1,TRBJ2-2,CASSQRDRGANTGELFF,1,0,1,1
TRBV3-1,TRBJ2-5,CASSQDAPRPLHETQYF,1,0,1,1
TRBV9,TRBJ2-1,CASSVEGGGRGSNEQFF,1,0,1,1
TRBV12-3/4,TRBJ2-1,CASSGLAGGPSYNEQFF,1,1,2,2
TRBV27,TRBJ2-1,CASRKLSVGRGSNEQFF,1,0,1,1
TRBV5-1,TRBJ2-1,CASSLVAGGSSYNEQFF,1,0,1,1
TRBV5-1,TRBJ2-2,CASSLDGSGDVTGELFF,1,0,1,1
TRBV5-1,TRBJ2-3,CASSRTSGGAPADTQYF,1,0,1,1
TRBV4-1,TRBJ2-1,CASSQVLAGGPLSEQFF,1,0,1,1
TRBV4-1,TRBJ1-2,CASSQGVGGLRHLGYTF,2,0,1,2
TRBV29-1,TRBJ2-3,CSVEFRSGGPFTDTQYF,1,0,1,1
TRBV7-7,TRBJ2-2,CASSERQASNTGELFF,1,0,1,1
TRBV10-3,TRBJ2-5,CAISDSEAGILETQYF,1,0,1,1
TRBV19,TRBJ1-1,CASTSFLGRLNTEAFF,1,0,1,1
TRBV12-3/4,TRBJ1-1,CASSFGTLVMSTEAFF,1,0,1,1
TRBV19,TRBJ2-1,CASRTSGPLSNNEQFF,1,0,1,1
TRBV18,TRBJ1-1,CASSPLGGHLNTEAFF,1,0,1,1
TRBV18,TRBJ1-5,CASSRSGRGSNQPQHF,1,0,1,1
TRBV18,TRBJ1-2,CASSRGPGPTNYGYTF,1,0,1,1
TRBV28,TRBJ1-4,CASGPRATGSNEKLFF,1,0,1,1
TRBV2,TRBJ2-1,CASTASRGGAYNEQFF,1,0,1,1
TRBV28,TRBJ1-1,CASSFRSGMGNAEAFF,1,0,1,1
TRBV12-3/4,TRBJ2-3,CASSLARDRGPDTQYF,1,0,1,1
TRBV28,TRBJ1-3,CASSLGRANSGNTIYF,1,0,1,1
TRBV6-2/3/5/6,TRBJ2-5,CASSYSTGVGQETQYF,1,0,1,1
TRBV28,TRBJ1-5,CASSPPPGGQRQPQHF,1,0,1,1
TRBV28,TRBJ1-4,CASSPDIYATNEKLFF,1,0,1,1
TRBV5-5,TRBJ2-3,CASSRGPSGGLDTQYF,1,0,1,1
TRBV12-3/4,TRBJ1-4,CASSVRGRASNEKLFF,1,0,1,1
TRBV6-2/3/5/6,TRBJ2-1,CASSALTSSGRYEQFF,1,0,1,1
TRBV6-1,TRBJ2-1,CASSDVSWDWYNEQFF,1,0,1,1
TRBV2,TRBJ2-7,CASSDPGHGTGYEQYF,1,0,1,1
TRBV2,TRBJ2-7,CASSEITTDLLHEQYF,1,0,1,1
TRBV28,TRBJ2-5,CASSMDFGPSQETQYF,1,0,1,1
TRBV6-2/3/5/6,TRBJ2-1,CASSTKTSGTFWRQFF,1,0,1,1
TRBV27,TRBJ2-1,CASSKGIGPSYNEQFF,1,0,1,1
TRBV5-6,TRBJ1-5,CASSFGRTGPSQPQHF,1,0,1,1
TRBV5-6,TRBJ2-3,CASSLRQPVTTDTQYF,1,0,1,1
TRBV5-5,TRBJ2-3,CASSLVHMGFTDTQYF,1,0,1,1
TRBV7-2,TRBJ2-5,CASSLAGSAGQETQYF,1,0,1,1
TRBV7-9,TRBJ1-1,CASSLARTGVNTEAFF,1,0,1,1
TRBV11-2,TRBJ2-1,CASSLGSGSSYNEQFF,1,0,1,1
TRBV7-2,TRBJ2-2,CASSLGGGASIGELFF,1,0,1,1
TRBV7-3,TRBJ2-6,CASSLSGGSGANVLTF,1,0,1,1
TRBV28,TRBJ2-3,CASSSPPGGRTDTQYF,1,0,1,1
TRBV12-3/4,TRBJ2-2,CASSWGTGQNTGELFF,1,0,1,1
TRBV6-2/3/5/6,TRBJ2-5,CASSPPGGGLQETQYF,1,0,1,1
TRBV7-9,TRBJ2-1,CASSPYTRQGYNEQFF,1,0,1,1
TRBV11-2,TRBJ1-2,CASSPAAATLNYGYTF,1,0,1,1
TRBV27,TRBJ1-4,CASSPGTGGTNEKLFF,1,0,1,1
TRBV7-3,TRBJ2-1,CASSPSSGGVRHEQFF,1,0,1,1
TRBV12-3/4,TRBJ1-5,CASSRLTRGSNQPQHF,1,0,1,1
TRBV28,TRBJ2-4,CASSRRQSVAKNIQYF,1,0,1,1
TRBV3-1,TRBJ2-3,CASSQAHSGGTDTQYF,1,0,1,1
TRBV6-2/3/5/6,TRBJ2-1,CASSQSGTREYNEQFF,1,0,1,1
TRBV5-4,TRBJ2-3,CASSQRLAGGTDTQYF,1,0,1,1
TRBV3-1,TRBJ2-3,CASSQASSGGRDTQYF,1,0,1,1
TRBV11-2,TRBJ2-2,CASSVLTGGSAGELFF,1,0,1,1
TRBV9,TRBJ1-2,CASSVGTGTYRDGYTF,1,0,1,1
TRBV7-9,TRBJ2-4,CASSKQGVIAKNIQYF,1,0,1,1
TRBV14,TRBJ1-5,CASRPSRGVSNQPQHF,1,1,2,2
TRBV28,TRBJ1-2,CASKSPRTQGGYGYTF,1,0,1,1
TRBV2,TRBJ2-2,CAREAFPGGGNGELFF,1,0,1,1
TRBV5-1,TRBJ2-1,CASSLGPSGDHNEQFF,1,0,1,1
TRBV5-1,TRBJ2-3,CASSLEGGTGHAPQYF,1,0,1,1
TRBV5-1,TRBJ2-5,CASSLSGGPSQETQYF,1,0,1,1
TRBV4-1,TRBJ1-1,CASSLLPAGTPKAAFF,1,2,2,3
TRBV5-1,TRBJ2-2,CASSPWTGLRTGELFF,1,0,1,1
TRBV5-1,TRBJ2-6,CASSRDTQSGANVLTF,1,0,1,1
TRBV4-1,TRBJ2-7,CASSQDANRRTYEQYF,1,0,1,1
TRBV4-1,TRBJ1-2,CASSQEQGRLNYGYTF,1,1,2,2
TRBV5-1,TRBJ2-5,CASSTGRLAGQETQYF,1,0,1,1
TRBV4-1,TRBJ2-7,CASSNELAGGSYEQYF,1,0,1,1
TRBV20-1,TRBJ2-1,CSARVWGLSSYNEQFF,1,0,1,1
TRBV20-1,TRBJ2-2,CSARVIQGANTGGLFF,1,0,1,1
TRBV20-1,TRBJ1-2,CSARTQGAKLNYGYTF,1,0,1,1
TRBV29-1,TRBJ2-6,CSVSLQGAVGANVLTF,1,0,1,1
TRBV29-1,TRBJ2-6,CSVEVDYNSGANVLTF,1,0,1,1
TRBV18,TRBJ1-6,YASSPRIGDRNSPLRF,1,0,1,1
TRBV12-5,TRBJ2-1,CASGLGGAPFDEQFF,2,0,1,2
TRBV30,TRBJ1-4,CAWSTQSATNEKLFF,1,0,1,1
TRBV30,TRBJ2-2,CAWSGTSGVTGELFF,1,0,1,1
TRBV10-3,TRBJ1-6,CAISEGTADNSPLHF,1,0,1,1
TRBV24-1,TRBJ2-3,CATSLPGASSDTQYF,1,0,1,1
TRBV24-1,TRBJ2-1,CATSEAGGIRNEQFF,1,0,1,1
TRBV19,TRBJ2-3,CASRDSPRSTDTQYF,1,0,1,1
TRBV19,TRBJ2-1,CASSIGGEPYNEQFF,1,0,1,1
TRBV19,TRBJ2-4,CASSMGPSGKNIQYF,1,1,2,2
TRBV19,TRBJ2-2,CASSIDPGRNRELFF,1,0,1,1
TRBV19,TRBJ2-1,CASNAGGNSYNEQFF,1,0,1,1
TRBV18,TRBJ1-4,CASSPGTGDVEKLFF,1,0,1,1
TRBV18,TRBJ1-4,CASSPRRFSNEKLFF,1,1,2,2
TRBV28,TRBJ2-5,CASREGGACEETQYF,1,0,1,1
TRBV2,TRBJ2-3,CASGEQGIQRDTQYF,1,0,1,1
TRBV28,TRBJ1-6,CASTRVVGQNSPLHF,1,0,1,1
TRBV2,TRBJ2-1,CASTHGEAIYNEQFF,1,0,1,1
TRBV2,TRBJ1-5,CASTPAMDSFQPQHF,1,0,1,1
TRBV12-3/4,TRBJ1-4,CASSFDGPVNEKLFF,1,0,1,1
TRBV6-2/3/5/6,TRBJ2-7,CASSFPPQGKYEQYF,1,0,1,1
TRBV28,TRBJ2-7,CASSFRGGAKHEQYF,1,0,1,1
TRBV6-2/3/5/6,TRBJ2-6,CASSFGGPGANVLTF,1,0,1,1
TRBV6-2/3/5/6,TRBJ1-2,CASSFDVGVSNGYTF,1,0,1,1
TRBV12-3/4,TRBJ1-2,CASSLRVGTDYGYTF,1,0,1,1
TRBV7-9,TRBJ2-3,CASSLRAGGTDTQYF,2,0,1,2
TRBV6-2/3/5/6,TRBJ2-1,CASSLQARGYNEQFF,1,0,1,1
TRBV28,TRBJ1-2,CASSLQGANYYGYTL,1,0,1,1
TRBV5-1,TRBJ2-5,CASSLGQGGGETQYF,2,0,1,2
TRBV12-3/4,TRBJ1-5,CASSLGGNSNQPQHF,1,0,1,1
TRBV28,TRBJ1-1,CASSLRRGLDTEAFF,1,0,1,1
TRBV28,TRBJ2-7,CASSSWTGTRYEQYF,1,1,2,2
TRBV12-3/4,TRBJ2-3,CASSSRTGWPDTQYF,1,0,1,1
TRBV12-3/4,TRBJ2-7,CASSSGQGAFDEQYF,1,0,1,1
TRBV28,TRBJ2-5,CASSYVGTRRGTQYF,1,0,1,1
TRBV6-2/3/5/6,TRBJ2-7,CASSYGQGSSYEQYF,1,0,1,1
TRBV6-2/3/5/6,TRBJ2-1,CASSLGGRGYNEQFF,1,0,1,1
TRBV6-2/3/5/6,TRBJ1-1,CASSPTGQGYTEAFF,1,0,1,1
TRBV28,TRBJ2-7,CASSRGHIARIGQYF,1,0,1,1
TRBV2,TRBJ1-2,CASSATGSANYGYTF,1,0,1,1
TRBV6-1,TRBJ2-3,CASSDGTALGDTQYF,1,0,1,1
TRBV6-1,TRBJ2-3,CASSDSGVSTDTQYF,1,0,1,1
TRBV6-2/3/5/6,TRBJ1-5,CASSTGGMGNQPQHF,1,0,1,1
TRBV6-2/3/5/6,TRBJ2-1,CASSFSPPGYNEQFF,1,0,1,1
TRBV5-5,TRBJ1-1,CASSFVTGANTEAFF,2,0,1,2
TRBV5-5,TRBJ1-5,CASSLQGYSNQPQHF,1,0,1,1
TRBV5-5,TRBJ2-3,CASSLARGGGDTQYF,1,0,1,1
TRBV5-8,TRBJ1-1,CASSLSIRGRPEAFF,1,0,1,1
TRBV11-2,TRBJ1-1,CASSLLVDSNTEAFF,1,0,1,1
TRBV7-9,TRBJ1-1,CASSLVRSTNTEAFF,1,0,1,1
TRBV7-9,TRBJ2-2,CASSLVRIFTGELFF,1,0,1,1
TRBV5-6,TRBJ1-6,CASSLAQWLNSPLHF,1,0,1,1
TRBV11-2,TRBJ1-5,CASSLGGQGNQPQHF,1,0,1,1
TRBV11-2,TRBJ1-1,CASSLEGGGLQKPFF,1,0,1,1
TRBV7-3,TRBJ2-1,CASSLTLLGDNEQFF,1,0,1,1
TRBV7-2,TRBJ1-4,CASSSAAGPNEKLFF,1,0,1,1
TRBV9,TRBJ2-3,CASSWGQGATDTQYF,1,0,1,1
TRBV11-2,TRBJ2-5,CASSPPRQFQETQYF,1,0,1,1
TRBV7-9,TRBJ2-1,CASSPPGVSYNEQFF,1,0,1,1
TRBV14,TRBJ1-2,CASSPSTGYGYGYTF,1,0,1,1
TRBV28,TRBJ2-5,CASSPAWDRQETQYF,1,0,1,1
TRBV7-3,TRBJ2-1,CASSRLAGGFDEQFF,1,0,1,1
TRBV3-1,TRBJ2-3,CASSHLGARTDTQYF,1,0,1,1
TRBV3-1,TRBJ2-3,CASSQFASGAYTQYF,1,0,1,1
TRBV7-3,TRBJ1-2,CASSQAGTGLDGYTF,1,0,1,1
TRBV3-1,TRBJ1-5,CASSQGGGSNQPQHF,1,0,1,1
TRBV3-1,TRBJ1-1,CASSQDPRRDTEAFF,1,0,1,1
TRBV4-2,TRBJ2-5,CASSQDQGRGETQYF,1,0,1,1
TRBV14,TRBJ1-1,CASSQDVGTYTEAFF,1,0,1,1
TRBV11-2,TRBJ1-4,CASSQDRIRGEKLFF,1,0,1,1
TRBV4-2,TRBJ2-1,CASSQERLSYNEQFF,1,0,1,1
TRBV3-1,TRBJ1-6,CASSQTTVANSPLHF,1,0,1,1
TRBV2,TRBJ1-4,CASSVLGGYNEKLFF,1,0,1,1
TRBV2,TRBJ2-3,CASSVLGPTADTQYF,1,0,1,1
TRBV9,TRBJ2-3,CASSVGVDRADTQYF,1,0,1,1
TRBV7-2,TRBJ2-3,CASSASSGGGGTQYF,1,0,1,1
TRBV9,TRBJ2-1,CASSAQGASYNEQFF,1,0,1,1
TRBV9,TRBJ2-2,CASSDQAGAIGELFF,1,0,1,1
TRBV12-3/4,TRBJ2-7,CASRGDARSSYEQYF,1,0,1,1
TRBV6-2/3/5/6,TRBJ1-5,CASRPGTISNQPQHF,1,0,1,1
TRBV14,TRBJ2-2,CASRRQGLNTGELFF,1,0,1,1
TRBV2,TRBJ1-3,CASRGVKSSRNTIYF,1,0,1,1
TRBV27,TRBJ2-7,CASRETGQVVNEQYF,1,0,1,1
TRBV5-4,TRBJ1-2,CASNPELSNPAGYTF,1,0,1,1
TRBV6-2/3/5/6,TRBJ2-7,CASKKLAASSYEQYF,1,0,1,1
TRBV28,TRBJ1-1,CTSSSPGQLNTEAFF,1,0,1,1
TRBV6-2/3/5/6,TRBJ1-2,CTSSYSPNMNYGYTF,1,0,1,1
TRBV10-3,TRBJ1-2,CAITAGTGDLYGYTF,1,0,1,1
TRBV5-1,TRBJ2-2,CASIIKKPNSGELFF,1,0,1,1
TRBV5-1,TRBJ1-1,CASSKTGGAYTEAFF,1,0,1,1
TRBV5-1,TRBJ2-1,CASSFSSSAANEQFF,1,0,1,1
TRBV5-1,TRBJ2-3,CASSFAGDSTDTQYF,1,0,1,1
TRBV5-1,TRBJ1-1,CASSLQAFGGTEAFF,1,0,1,1
TRBV5-1,TRBJ2-7,CASSLGGGTDYEQYF,1,0,1,1
TRBV5-1,TRBJ1-6,CASSLDQGKGSPLHF,1,0,1,1
TRBV5-1,TRBJ2-3,CASSLDRGAHDTQYF,1,0,1,1
TRBV5-1,TRBJ2-1,CASSLELASYNEQFF,1,0,1,1
TRBV5-1,TRBJ1-5,CASSSSGQVNQPQHF,1,0,1,1
TRBV5-1,TRBJ2-5,CASSSASGGFETQYF,1,0,1,1
TRBV4-1,TRBJ2-7,CASSPRAGGPPEQYF,1,0,1,1
TRBV5-1,TRBJ2-1,CASSPRQDNYNEQFF,1,0,1,1
TRBV5-1,TRBJ2-7,CASSPGTVLGFEQYF,1,0,1,1
TRBV5-1,TRBJ1-5,CASSPTGTEFQPQHF,1,0,1,1
TRBV5-1,TRBJ2-6,CASSREGTGANVLTF,1,0,1,1
TRBV5-1,TRBJ1-6,CASSRQQGRGSPLHF,1,0,1,1
TRBV4-1,TRBJ2-7,CASSRSALGDYEQYF,1,0,1,1
TRBV4-1,TRBJ1-1,CASSHGTGENTEAFF,1,0,1,1
TRBV5-1,TRBJ2-1,CASSQGTGFNNEQFF,1,0,1,1
TRBV4-1,TRBJ1-5,CASSQVVNSNQPQHF,1,0,1,1
TRBV4-1,TRBJ1-2,CASSQDSPGASGYTF,2,0,1,2
TRBV5-1,TRBJ1-2,CASSGGDPANYGYTF,1,0,1,1
TRBV5-1,TRBJ1-1,CASSGTGGRNTEAFF,1,0,1,1
TRBV5-1,TRBJ1-1,CASSKQGRMNTEAFF,1,0,1,1
TRBV20-1,TRBJ2-5,CSAISSGTGQETQYF,1,0,1,1
TRBV20-1,TRBJ2-1,CSARPPGRTGGEQFF,1,0,1,1
TRBV20-1,TRBJ1-1,CSARPRTGGSTEAFF,1,0,1,1
TRBV20-1,TRBJ2-1,CSARPLTGEYNEQFF,1,0,1,1
TRBV20-1,TRBJ1-1,CSARAPGTVNTEAFF,1,0,1,1
TRBV20-1,TRBJ2-1,CSARDLRQGNNELFF,1,0,1,1
TRBV20-1,TRBJ2-1,CSARRVGAYHNEQFF,1,0,1,1
TRBV20-1,TRBJ2-1,CSAPKRGGIYNEQFF,1,0,1,1
TRBV29-1,TRBJ2-3,CSVGGPGSITDTQYF,1,0,1,1
TRBV29-1,TRBJ1-3,CSVERTGSSGNTIYF,1,0,1,1
TRBV29-1,TRBJ1-6,CSVPMTRGKRSPLHF,1,0,1,1
TRBV29-1,TRBJ2-1,CSAPSGGRVGNEQFF,1,0,1,1
TRBV5-6,TRBJ2-1,SASSKSSALESEQFI,1,0,1,1
TRBV30,TRBJ1-4,CAWSIGGHAEKLFF,1,0,1,1
TRBV10-3,TRBJ1-1,CAISLDPVNTEAFF,1,0,1,1
TRBV10-3,TRBJ1-5,CAISELGDSQPQHF,1,0,1,1
TRBV19,TRBJ2-1,CATSIRQGPGEQFF,1,0,1,1
TRBV15,TRBJ1-5,CATGTSIGNQPQHF,1,0,1,1
TRBV24-1,TRBJ2-7,CATSDGTGRGEQYF,1,0,1,1
TRBV24-1,TRBJ2-2,CATSDHRDTGELFF,2,0,1,2
TRBV19,TRBJ1-5,CASGSQGSSQPQHF,1,0,1,1
TRBV19,TRBJ1-2,CASSSPGVGYGYTF,1,0,1,1
TRBV19,TRBJ1-4,CASSRRGGPEKLFF,1,0,1,1
TRBV19,TRBJ1-1,CASSIPNSNTEAFF,1,0,1,1
TRBV19,TRBJ1-5,CASSMLVGGQPQHF,1,0,1,1
TRBV19,TRBJ2-7,CASSNREAQAEQYF,1,0,1,1
TRBV19,TRBJ2-7,CASSQGRGVYEQYF,1,0,1,1
TRBV19,TRBJ2-6,CASRGSSGANVLTF,1,0,1,1
TRBV18,TRBJ1-1,CASSPGGGNTEAFF,1,0,1,1
TRBV18,TRBJ1-1,CASSHSDRVFEAFF,1,0,1,1
TRBV2,TRBJ1-1,CASRFKTTNTEAFF,1,0,1,1
TRBV5-4,TRBJ1-1,CASIDRNMNTEAFF,1,0,1,1
TRBV12-3/4,TRBJ1-2,CASSFLGQVYGYTF,1,0,1,1
TRBV6-2/3/5/6,TRBJ2-5,CASSFRGVEGTQYF,1,0,1,1
TRBV12-3/4,TRBJ1-1,CASSFTQGVGEAFF,1,0,1,1
TRBV12-3/4,TRBJ2-7,CASSLGRRTYEQYF,1,0,1,1
TRBV6-2/3/5/6,TRBJ2-3,CASSLRPLVNTQYF,1,0,1,1
TRBV6-2/3/5/6,TRBJ2-5,CASSSRQGQETQYF,1,0,1,1
TRBV2,TRBJ1-2,CASSRDRAGYGYTF,1,0,1,1
TRBV6-2/3/5/6,TRBJ1-1,CASSRGAVNAEALF,1,0,1,1
TRBV6-2/3/5/6,TRBJ2-3,CASSQRGIADTQYF,1,0,1,1
TRBV12-3/4,TRBJ1-6,CASSQNDRVSPLHF,1,0,1,1
TRBV6-1,TRBJ1-1,CASSEYRMNTEAFF,1,0,1,1
TRBV2,TRBJ2-5,CASSEQGVEETQYF,1,0,1,1
TRBV2,TRBJ2-7,CASSEVSSGYEQYF,1,0,1,1
TRBV27,TRBJ1-2,CASSIQGASDGYTF,1,0,1,1
TRBV5-6,TRBJ2-7,CASSFGGGSYEQYF,1,0,1,1
TRBV7-3,TRBJ2-1,CASSFTGSPNEQFF,1,0,1,1
TRBV7-3,TRBJ1-1,CASSFTGVDTEAFF,1,0,1,1
TRBV7-9,TRBJ2-1,CASSLSGQDNEQFF,1,0,1,1
TRBV5-6,TRBJ1-1,CASSLLTANTEAFF,1,0,1,1
TRBV5-4,TRBJ2-5,CASSLPGGRETQYF,1,0,1,1
TRBV11-2,TRBJ2-5,CASSLGSSVETQYF,1,0,1,1
TRBV7-9,TRBJ2-7,CASSLGTASNEQYF,1,0,1,1
TRBV7-9,TRBJ2-7,CASSLGQGTNEQYF,1,0,1,1
TRBV11-2,TRBJ2-7,CASSLNTGGYEQYF,1,0,1,1
TRBV7-6,TRBJ2-5,CASSLFRGKETQYF,1,0,1,1
TRBV7-2,TRBJ1-5,CASSLVREGQPQHF,1,0,1,1
TRBV7-2,TRBJ1-1,CASSLAQGLVRAFF,1,0,1,1
TRBV7-9,TRBJ1-5,CASSLADRGQPQHF,2,0,1,2
TRBV7-9,TRBJ1-1,CASSLGHLNTEAFF,1,0,1,1
TRBV11-2,TRBJ1-2,CASSLDVGPHGYTF,1,0,1,1
TRBV7-2,TRBJ2-7,CASSLSYRDHEQYF,2,0,1,2
TRBV7-9,TRBJ1-5,CASSSGTRNQPQHF,1,0,1,1
TRBV5-5,TRBJ1-4,CASSSRGSDEKLFF,1,0,1,1
TRBV5-4,TRBJ2-1,CASSSGLGYNEQFF,1,0,1,1
TRBV5-4,TRBJ1-6,CASSSDILTSPLHF,1,0,1,1
TRBV11-2,TRBJ2-2,CASSLSGGTGELFF,1,0,1,1
TRBV9,TRBJ2-7,CASSPRQVSGEQYF,1,0,1,1
TRBV6-2/3/5/6,TRBJ1-1,CASSPWTVNTEAFF,1,0,1,1
TRBV11-2,TRBJ2-3,CASSPRPLTDTQYF,1,0,1,1
TRBV5-4,TRBJ2-7,CASSPTAASYEQYF,1,0,1,1
TRBV12-3/4,TRBJ2-7,CASSPLGGIYEQYF,1,0,1,1
TRBV14,TRBJ1-1,CASSPVGRRTEAFF,1,0,1,1
TRBV7-9,TRBJ2-1,CASSPGGGYNEQFF,1,0,1,1
TRBV3-1,TRBJ1-1,CASSPNPDRFEAFF,1,0,1,1
TRBV11-1,TRBJ1-6,CASSRGSYNSPLHF,1,0,1,1
TRBV4-2,TRBJ1-2,CASSHPRDNYGYTF,1,0,1,1
TRBV7-9,TRBJ1-5,CASSHGGRGQPQHF,1,0,1,1
TRBV5-6,TRBJ1-2,CASSQTGFAYGYTF,1,0,1,1
TRBV7-3,TRBJ2-7,CASSQDSGDYEQYF,1,0,1,1
TRBV11-2,TRBJ2-7,CASSAPGQSYEQYF,1,0,1,1
TRBV3-1,TRBJ1-3,CASSIDRTGNTIYF,1,0,1,1
TRBV12-3/4,TRBJ1-1,CASRVLGTASEAFF,1,0,1,1
TRBV7-2,TRBJ2-3,CASRTTSTTDTQYF,1,0,1,1
TRBV28,TRBJ2-7,CASRLQDGAYEQYF,1,0,1,1
TRBV12-3/4,TRBJ1-2,CASRPTGTENGYTF,1,0,1,1
TRBV7-2,TRBJ2-1,CASRQGSSYNEQFF,1,0,1,1
TRBV28,TRBJ2-7,CASRQLPGLYEQYF,1,0,1,1
TRBV5-4,TRBJ2-5,CASRAGTSGDTQYF,1,0,1,1
TRBV7-2,TRBJ2-7,CASKGTLDFYEQYF,2,0,1,2
TRBV12-5,TRBJ2-7,CASDSGTGTYEQYF,1,0,1,1
TRBV10-1,TRBJ2-3,CACSSGGSTDTQYF,1,0,1,1
TRBV5-1,TRBJ1-4,CARSSRDQNEKLIF,1,0,1,1
TRBV5-1,TRBJ2-7,CASTWTGGFYEQYF,1,0,1,1
TRBV5-1,TRBJ2-7,CASSFYQGLYEQYF,1,0,1,1
TRBV5-1,TRBJ2-2,CASSLAGGTGELFF,1,0,1,1
TRBV5-1,TRBJ2-7,CASSLDFSRYEQYF,1,0,1,1
TRBV5-1,TRBJ2-7,CASSLDPSSYEQYF,1,0,1,1
TRBV5-1,TRBJ2-7,CASSLEANSYEQYF,1,0,1,1
TRBV5-1,TRBJ1-4,CASSSSQGAEKLFF,1,0,1,1
TRBV5-1,TRBJ1-5,CASSSGTGNQPQHF,1,0,1,1
TRBV5-1,TRBJ1-1,CASSQTGVNTEAFF,1,0,1,1
TRBV4-1,TRBJ2-2,CASSQVSNTGELFF,1,0,1,1
TRBV4-1,TRBJ1-1,CASSQGEWDTEAFF,1,0,1,1
TRBV5-1,TRBJ1-5,CASSTGQINQPQHF,1,0,1,1
TRBV20-1,TRBJ2-7,CSVLAGDFSYEQYF,1,0,1,1
TRBV20-1,TRBJ2-2,CSASAGRYTGELFF,1,0,1,1
TRBV20-1,TRBJ1-5,CSAQTGQSGQPQHF,1,0,1,1
TRBV20-1,TRBJ2-3,CSATPSGVTDTQYF,1,0,1,1
TRBV20-1,TRBJ2-3,CSASGGFKLDTQYF,1,1,2,2
TRBV20-1,TRBJ1-2,CSARASDRAIGYTF,1,0,1,1
TRBV20-1,TRBJ2-7,CSARDQLNSYEQYF,1,0,1,1
TRBV20-1,TRBJ2-1,CSASIGGRYNEQFF,1,0,1,1
TRBV20-1,TRBJ2-5,CSAPKGGGRETQYF,1,0,1,1
TRBV20-1,TRBJ2-1,CSAPGLAERHEQFF,1,0,1,1
TRBV20-1,TRBJ1-6,CSAPPHLRNSPLHF,1,0,1,1
TRBV29-1,TRBJ1-2,CSVPDRGFAHGYTF,1,0,1,1
TRBV29-1,TRBJ1-3,CSVEVPSSGNTIYF,1,0,1,1
TRBV29-1,TRBJ2-2,CSVETPTNTGELFF,1,0,1,1
TRBV29-1,TRBJ2-5,CSVERGRRGETQYF,1,0,1,1
TRBV29-1,TRBJ2-7,CSVIPGTGTYEQYF,1,0,1,1
TRBV29-1,TRBJ1-3,CSVTQGGSGNTIYF,1,0,1,1
TRBV29-1,TRBJ1-1,CSARTTGSNTEAFF,1,1,2,2
TRBV29-1,TRBJ2-7,CSATSGLRTGEQYI,1,0,1,1
TRBV29-1,TRBJ1-2,CSAEEGGGIYGYTF,1,0,1,1
TRBV29-1,TRBJ1-4,CSATPTGNYEKLFF,1,0,1,1
TRBV29-1,TRBJ2-1,CSGEGLAGAPGQFF,1,0,1,1
TRBV7-2,TRBJ1-1,WASSLQPTNTEAFF,1,0,1,1
TRBV11-2,TRBJ2-2,RASSWERGATEVFF,1,0,1,1
TRBV7-8,TRBJ2-2,CVSSRGGTGELFF,1,0,1,1
TRBV12-5,TRBJ2-7,CASGPDLGYEQYF,1,0,1,1
TRBV30,TRBJ2-1,CAWSSRRDSPPKI,1,0,1,1
TRBV7-9,TRBJ2-1,CAGIGGVYNEQFF,1,0,1,1
TRBV3-1,TRBJ1-2,CAGSQGQSGGYTF,1,0,1,1
TRBV7-2,TRBJ2-5,CAGSILPFQTQYF,1,0,1,1
TRBV2,TRBJ2-3,CAITSGGTDTQYF,1,0,1,1
TRBV10-3,TRBJ2-1,CAISEDTYNEQFF,1,0,1,1
TRBV2,TRBJ2-7,CATFLGTTYEQYF,1,0,1,1
TRBV24-1,TRBJ2-1,CATQGTIYNEQFF,1,0,1,1
TRBV24-1,TRBJ1-1,CATSDGMNTEAFF,1,0,1,1
TRBV28,TRBJ2-5,CASSPATQETQYF,1,0,1,1
TRBV19,TRBJ1-1,CASGLQANTEAFF,1,0,1,1
TRBV19,TRBJ1-6,CASSPGQNSPLHF,1,0,1,1
TRBV19,TRBJ2-1,CASSMVQGGEQFF,1,0,1,1
TRBV19,TRBJ2-1,CASSINPVGEQFF,1,0,1,1
TRBV19,TRBJ1-2,CASSTYRIPGYTF,1,0,1,1
TRBV18,TRBJ2-5,CASSSGTYGTQYF,1,0,1,1
TRBV25-1,TRBJ2-7,CASSQQNSYEQYF,1,0,1,1
TRBV25-1,TRBJ2-5,CASHRFSWETQYF,1,0,1,1
TRBV5-6,TRBJ2-2,CASGPGGFGELFF,1,0,1,1
TRBV7-9,TRBJ2-2,CASGRDFTGELFF,1,0,1,1
TRBV5-5,TRBJ2-3,CASGKTDTDTQYF,1,0,1,1
TRBV6-2/3/5/6,TRBJ2-7,CASGSTGSYEQYF,1,0,1,1
TRBV6-2/3/5/6,TRBJ2-5,CASSFSQQETQYF,1,0,1,1
TRBV12-3/4,TRBJ1-3,CASSFRGENTIYF,1,0,1,1
TRBV6-2/3/5/6,TRBJ2-3,CASSFAGVDTQYF,1,0,1,1
TRBV28,TRBJ1-6,CASSLEDASPLHF,1,0,1,1
TRBV12-3/4,TRBJ1-5,CASSLLGNQPQHF,1,0,1,1
TRBV12-3/4,TRBJ1-1,CASSLRGNGEAFF,1,1,2,2
TRBV7-8,TRBJ2-3,CASSLGPTDTQYF,1,1,2,2
TRBV6-2/3/5/6,TRBJ1-2,CASSYDQRYGYTF,1,0,1,1
TRBV12-3/4,TRBJ1-2,CASSPRPAYGYTF,1,0,1,1
TRBV12-3/4,TRBJ2-1,CASSPRGLGLQFF,1,0,1,1
TRBV2,TRBJ1-6,CASSRDLVSPLHF,1,0,1,1
TRBV6-2/3/5/6,TRBJ1-5,CASSQGWNQPQHF,1,0,1,1
TRBV2,TRBJ1-1,CASSVGGLTEAFF,1,0,1,1
TRBV6-1,TRBJ1-1,CASSVQGETEAFF,1,0,1,1
TRBV12-3/4,TRBJ2-5,CASSVEVRETQYF,1,0,1,1
TRBV6-1,TRBJ2-3,CASSDRWGDTQYF,1,0,1,1
TRBV2,TRBJ2-7,CASSEAGGYEQYF,1,0,1,1
TRBV6-1,TRBJ2-3,CASSKTGGDTQYF,1,0,1,1
TRBV11-2,TRBJ1-1,CASSFSENTEAFF,1,0,1,1
TRBV7-2,TRBJ1-1,CASSFSVNTEAFF,1,0,1,1
TRBV5-5,TRBJ1-2,CASSLGAGYGYTF,1,0,1,1
TRBV7-9,TRBJ2-2,CASSLARNGELFF,1,0,1,1
TRBV13,TRBJ2-1,CASSSDRPNEQFF,1,0,1,1
TRBV5-5,TRBJ2-2,CASSSSLAGGLFF,1,0,1,1
TRBV5-6,TRBJ2-5,CASSLARQETQYF,1,0,1,1
TRBV11-2,TRBJ1-1,CASSLEMGTEAFF,1,0,1,1
TRBV7-9,TRBJ1-1,CASSLESSLEAFF,1,0,1,1
TRBV11-2,TRBJ1-5,CASSLTSYQPQHF,1,0,1,1
TRBV3-1,TRBJ1-1,CASSPRVGTEAFF,1,0,1,1
TRBV11-3,TRBJ2-3,CASSPRRADTQYF,1,0,1,1
TRBV7-3,TRBJ2-1,CASSPRVLSEQFF,1,0,1,1
TRBV7-2,TRBJ2-5,CASSRRVQETQYF,2,0,1,2
TRBV3-1,TRBJ2-4,CASSQPISNIQYF,1,0,1,1
TRBV14,TRBJ2-1,CASSQQRVEEQFF,1,0,1,1
TRBV3-1,TRBJ1-1,CASSQALNTEAFF,1,0,1,1
TRBV3-1,TRBJ2-3,CASSQASTDTQYF,1,0,1,1
TRBV9,TRBJ1-1,CASSVGGNTEAFF,1,0,1,1
TRBV11-3,TRBJ1-1,CASSAQGNTEAFF,1,0,1,1
TRBV5-6,TRBJ2-1,CASSRYQRGQQFF,1,0,1,1
TRBV3-1,TRBJ2-3,CASRRTVQDTQYF,1,0,1,1
TRBV14,TRBJ2-1,CASRQQGYNEQFF,1,0,1,1
TRBV6-1,TRBJ2-3,CASRDRGSDTQYF,1,0,1,1
TRBV6-2/3/5/6,TRBJ1-2,CASRMGRNYGYTF,1,0,1,1
TRBV2,TRBJ1-1,CASRQDGNTEAFF,1,0,1,1
TRBV28,TRBJ2-5,CASNPGGQETQYF,1,0,1,1
TRBV2,TRBJ2-1,CASKELGYNEQFF,1,0,1,1
TRBV2,TRBJ2-3,CARGQTSTDTQYF,1,0,1,1
TRBV5-1,TRBJ1-2,CASGRDSNYGYTF,1,0,1,1
TRBV10-2,TRBJ2-5,CASSESEKETQYF,1,0,1,1
TRBV5-1,TRBJ1-1,CASSFRDTSEAFF,1,0,1,1
TRBV5-1,TRBJ1-1,CASSLAGTVGAFF,1,0,1,1
TRBV5-1,TRBJ2-1,CASSLDRGVEQFF,1,0,1,1
TRBV5-1,TRBJ2-2,CASSLGDTGELFF,1,0,1,1
TRBV5-1,TRBJ2-7,CASSSHRSVEQYF,1,0,1,1
TRBV4-1,TRBJ2-1,CASSQMGGNEQFF,1,0,1,1
TRBV5-1,TRBJ2-7,CASSQDQRRGQYF,1,0,1,1
TRBV4-1,TRBJ2-2,CASSQIDTGELFF,1,0,1,1
TRBV5-1,TRBJ2-5,CASSDLAQETQYF,1,0,1,1
TRBV5-1,TRBJ2-7,CASSIGQANEQYF,1,0,1,1
TRBV18,TRBJ1-1,CATTQGMNTEAFF,1,0,1,1
TRBV20-1,TRBJ2-1,CSPYDGVVHEQFF,1,0,1,1
TRBV20-1,TRBJ2-1,CSVIWGGYNEQFF,1,0,1,1
TRBV20-1,TRBJ1-5,CSAPGQGNQPQHF,1,0,1,1
TRBV20-1,TRBJ1-3,CSASRTGGNTIYF,1,0,1,1
TRBV20-1,TRBJ2-1,CSARPGGRVEQFF,1,0,1,1
TRBV20-1,TRBJ1-1,CSARFQGANEAFF,1,0,1,1
TRBV20-1,TRBJ1-1,CSARVTGGTEAFF,1,0,1,1
TRBV20-1,TRBJ2-1,CSARGGGFNEQFF,1,0,1,1
TRBV20-1,TRBJ2-7,CSAREPGGYEQYF,1,0,1,1
TRBV20-1,TRBJ1-4,CSAGATRSEKLFF,1,0,1,1
TRBV29-1,TRBJ2-1,CSVSRGAYNEQFF,1,0,1,1
TRBV29-1,TRBJ2-7,CSVRDRTSYEQYF,1,0,1,1
TRBV29-1,TRBJ1-5,CSVRDRGNQPQHF,1,0,1,1
TRBV29-1,TRBJ2-5,CSVVRGEGETQYF,1,0,1,1
TRBV29-1,TRBJ2-3,CSVVGAGGGTQYF,1,0,1,1
TRBV29-1,TRBJ2-5,CSVGLAGTETQYF,1,0,1,1
TRBV29-1,TRBJ1-1,CSVGQALNTEAFF,1,0,1,1
TRBV29-1,TRBJ1-1,CSVKRGGNTEAFF,1,0,1,1
TRBV29-1,TRBJ2-5,CSVQGTIGETQYF,1,0,1,1
TRBV29-1,TRBJ1-2,CSVTRGLDYGYTF,1,0,1,1
TRBV29-1,TRBJ1-1,CSVGGQPNTEAFF,1,0,1,1
TRBV29-1,TRBJ2-7,CSALGTANYEQYF,1,0,1,1
TRBV29-1,TRBJ1-4,CSGRQGASEKLFF,1,0,1,1
TRBV29-1,TRBJ1-1,CSGDQDLNTEAFF,1,0,1,1
TRBV30,TRBJ2-1,CAFAGLNNEQFF,1,0,1,1
TRBV30,TRBJ2-7,CAWSLQGNEQYF,1,0,1,1
TRBV28,TRBJ2-1,CAGGQAYNEQFF,1,0,1,1
TRBV2,TRBJ2-7,CATRDSPYEQYF,1,0,1,1
TRBV15,TRBJ2-1,CATTPDRHEQFF,1,0,1,1
TRBV3-1,TRBJ2-1,CASSILPHEQFF,1,0,1,1
TRBV18,TRBJ2-5,CASSTGSETQYF,1,0,1,1
TRBV18,TRBJ2-5,CASSPRPETQYF,1,0,1,1
TRBV5-4,TRBJ1-1,CASGTSGTEAFF,1,0,1,1
TRBV12-3/4,TRBJ2-5,CASSFVTETQYF,1,0,1,1
TRBV28,TRBJ2-7,CASSFIRNEQYF,1,0,1,1
TRBV28,TRBJ1-2,CASSLFGYGYTF,1,0,1,1
TRBV28,TRBJ1-2,CASSLRGHGYTF,1,0,1,1
TRBV6-2/3/5/6,TRBJ2-2,CASSSYTGELFF,1,0,1,1
TRBV12-3/4,TRBJ2-1,CASSSQGYEQFF,2,1,2,3
TRBV12-3/4,TRBJ1-5,CASSPGPAAQHF,1,0,1,1
TRBV7-3,TRBJ2-2,CASSHPAVELFF,1,0,1,1
TRBV2,TRBJ2-7,CASSDRVWEQYF,1,0,1,1
TRBV7-2,TRBJ2-1,CASSFQTGAQFF,1,0,1,1
TRBV5-6,TRBJ2-2,CASSFGSGELFF,1,0,1,1
TRBV11-2,TRBJ2-7,CASSLAGYEQYF,1,0,1,1
TRBV11-2,TRBJ1-1,CASSSSGVEAFF,1,0,1,1
TRBV5-6,TRBJ2-7,CASSSRTYEQYF,1,0,1,1
TRBV6-1,TRBJ2-1,CASSRLANEQFF,1,0,1,1
TRBV3-1,TRBJ1-1,CASSQPQGLAFF,1,0,1,1
TRBV3-1,TRBJ2-5,CASSQGIGTQYF,1,0,1,1
TRBV2,TRBJ1-6,CASRLDSRTPRF,1,0,1,1
TRBV5-4,TRBJ2-3,CASRTDSNTQYF,1,0,1,1
TRBV12-3/4,TRBJ1-5,CASSLLAQPQHF,1,0,1,1
TRBV5-1,TRBJ2-3,CASSSAGDTQYF,1,0,1,1
TRBV20-1,TRBJ1-1,CSVQRKNTEAFF,1,0,1,1
TRBV20-1,TRBJ1-2,CSARSGGKGYTF,1,0,1,1
TRBV20-1,TRBJ1-1,CSARTGVAEAFF,1,0,1,1
TRBV20-1,TRBJ2-1,CSARKGVDEQFF,1,0,1,1
TRBV29-1,TRBJ2-5,CSFYPPEETQYF,1,0,1,1
TRBV29-1,TRBJ2-5,CSVGYRGETQYF,1,0,1,1
TRBV29-1,TRBJ1-2,CSVGQGAMWHTF,1,0,1,1
TRBV29-1,TRBJ2-5,CSVEGGTETQYF,1,0,1,1
TRBV29-1,TRBJ1-1,CSVEKGGDEAFF,1,0,1,1
TRBV29-1,TRBJ1-2,CSVEAQGGGYTF,1,0,1,1
TRBV29-1,TRBJ2-7,CSVSSGGPGQYF,1,0,1,1
TRBV29-1,TRBJ1-5,CSVGDTNQPQHF,1,0,1,1
TRBV29-1,TRBJ1-1,CSALQGNTEAFF,1,0,1,1
TRBV30,TRBJ1-5,CASSVGDRQHF,1,0,1,1
TRBV30,TRBJ2-3,CAWASTDTQYF,1,0,1,1
TRBV30,TRBJ1-6,CAWGGDSSLHF,1,0,1,1
TRBV18,TRBJ2-1,CASSPGYEQFF,1,0,1,1
TRBV18,TRBJ1-1,CASSKSSEAFF,1,0,1,1
TRBV2,TRBJ2-7,CASTADYEQYF,1,0,1,1
TRBV12-3/4,TRBJ1-2,CASSPGYGYTF,1,1,2,2
TRBV12-3/4,TRBJ2-1,CASSHPHEQFF,1,0,1,1
TRBV12-3/4,TRBJ2-7,CASSDRDEQYF,1,0,1,1
TRBV7-9,TRBJ1-6,CASSLDSPLHF,1,0,1,1
TRBV10-2,TRBJ1-2,CASSTGAGYTF,1,0,1,1
TRBV5-1,TRBJ2-5,CASSLDETQYF,1,0,1,1
TRBV20-1,TRBJ2-5,CSASPQETQYF,1,0,1,1
TRBV20-1,TRBJ2-7,CSAKQDYEQYF,1,0,1,1
TRBV29-1,TRBJ1-1,CSVVRNTEAFF,1,0,1,1
TRBV29-1,TRBJ2-7,CSVSSLYEQYF,2,1,2,3
TRBV29-1,TRBJ1-4,CSVEEGLDLVF,1,0,1,1
TRBV29-1,TRBJ2-5,CSAGRTGSQYF,1,0,1,1
TRBV28,TRBJ1-2,CASSRYGYTF,1,0,1,1
TRBV19,TRBJ1-5,CARLYQPQHF,1,0,1,1
TRBV29-1,TRBJ1-1,CSAWNTEAFF,1,0,1,1
TRBV19,TRBJ2-7,CASSTRGQGATRTYEQYF,1,0,1,1
TRBV6-2/3/5/6,TRBJ2-1,CASNQLAGGQSSYNEQFF,1,0,1,1
TRBV5-1,TRBJ1-4,CASSLGWDEPGREKLFF,1,0,1,1
TRBV7-9,TRBJ2-1,CASSLGRTSGNNEQFF,1,0,1,1
TRBV7-6,TRBJ1-2,CANSRTLTGTAYGYTF,1,0,1,1
TRBV20-1,TRBJ2-7,CSARAGVRAQTHEQYF,1,0,1,1
TRBV7-9,TRBJ2-7,CASTNPDGYSYEQYF,2,0,1,2
TRBV5-4,TRBJ1-3,CASSLAGVAGNTIYF,1,0,1,1
TRBV7-9,TRBJ2-5,CASSLGDRGQETQYF,1,1,2,2
TRBV3-1,TRBJ2-4,CASSHGGSLADIQYF,1,0,1,1
TRBV4-2,TRBJ2-5,CASSQVGGGGETQYF,1,0,1,1
TRBV5-1,TRBJ1-2,CACSLEGSTNYGYTF,1,0,1,1
TRBV5-1,TRBJ1-6,CAGSLDQGRASPLHF,1,0,1,1
TRBV20-1,TRBJ2-5,CSARRPGQGLETQYF,1,0,1,1
TRBV7-9,TRBJ1-5,CASSLESSNQPQHF,1,0,1,1
TRBV11-3,TRBJ2-1,CASSPTPAHNEQVF,1,0,1,1
TRBV5-1,TRBJ1-5,CASSTTGGGQPQHF,1,0,1,1
TRBV29-1,TRBJ2-2,CSVHLESRPGELFF,1,0,1,1
TRBV7-3,TRBJ2-1,CASSLSGGLEQFF,2,3,2,5
TRBV12-3/4,TRBJ2-7,CASSWTGGYEQYF,1,0,1,1
TRBV7-9,TRBJ2-3,CASSPRDPDTLYF,1,0,1,1
TRBV7-6,TRBJ1-4,CASSPQGWEKLFF,1,0,1,1
TRBV2,TRBJ1-4,CATRADNEKLFF,2,0,1,2
TRBV19,TRBJ1-1,CASSRRGSEAFF,1,0,1,1
TRBV12-5,TRBJ1-5,CASGPRVGSTANPRRINQPQHF,1,0,1,1
TRBV14,TRBJ2-3,CASSQEIPPGLAGITSTDTQYF,1,0,1,1
TRBV28,TRBJ1-4,CASSFGQPYRAESGGEKLFF,1,0,1,1
TRBV27,TRBJ1-3,CARRTAGTGGVSPSGNTIYF,1,0,1,1
TRBV4-1,TRBJ2-5,CASSQDPVTSSLGRSETQYF,1,0,1,1
TRBV12-5,TRBJ2-1,CASGLVYLAGYSSYNEQFF,1,0,1,1
TRBV10-3,TRBJ2-7,CAISESRIVPGQKPYEQYF,1,0,1,1
TRBV28,TRBJ2-3,CASSFVPGPGQGFTDTQYF,1,0,1,1
TRBV27,TRBJ1-2,CASSSNFRLDGGPNYGYTF,1,0,1,1
TRBV28,TRBJ1-5,CASSHRGWGAEFGNQPQHF,1,0,1,1
TRBV6-4,TRBJ1-5,CASSDIMGQGISSNQPQHF,1,0,1,1
TRBV5-6,TRBJ2-5,CASSLAALAGAMYQETQYF,1,0,1,1
TRBV7-9,TRBJ2-3,CASSLAYSGGAVGTDTQYF,1,0,1,1
TRBV11-2,TRBJ1-1,CASSLRTEGEVMDFVEAFF,1,0,1,1
TRBV7-2,TRBJ1-6,CASSPHPQSLQGTNSPLHF,1,0,1,1
TRBV9,TRBJ2-1,CASSAGLAGGSPSYNEQFF,1,0,1,1
TRBV5-1,TRBJ2-1,CASSLAAASGGASYNEQFF,1,0,1,1
TRBV20-1,TRBJ1-6,CSARDDGQGINSYNSPLHF,1,0,1,1
TRBV12-5,TRBJ1-5,CASGLVYRGVDSNQPQHF,1,0,1,1
TRBV10-3,TRBJ2-6,CAISEGPLTASGANVLTF,1,0,1,1
TRBV28,TRBJ2-3,CASSFQLAGAYPTDTQYF,1,0,1,1
TRBV6-2/3/5/6,TRBJ2-7,CASSYSVDRAGGPYEQYF,1,0,1,1
TRBV11-2,TRBJ1-6,CASSFLVQGSSYNSPLHF,1,0,1,1
TRBV5-6,TRBJ2-3,CASSLMAAGTTSTDTQYF,1,0,1,1
TRBV7-2,TRBJ2-3,CASSLGGLTSGVTDTQYF,1,0,1,1
TRBV4-2,TRBJ2-3,CASSLQGVSDTSTDTQYF,1,0,1,1
TRBV7-9,TRBJ1-6,CASSPLTSRGRANSPLHF,1,0,1,1
TRBV14,TRBJ2-1,CASSRRTSGDSSYNEQFF,1,0,1,1
TRBV4-2,TRBJ2-3,CASSQAGLAGVAGDTQYF,1,0,1,1
TRBV3-1,TRBJ2-1,CASSQRVTGGALNDEQFF,1,0,1,1
TRBV14,TRBJ1-3,CASSQDPGTSSSGNTIYF,1,0,1,1
TRBV7-2,TRBJ1-2,CASSARPGTGTGGYGYTF,1,0,1,1
TRBV5-1,TRBJ2-3,CASSPGGSGGAGTDTQYF,1,0,1,1
TRBV4-1,TRBJ2-5,CASSQDRPDRAIQETQYF,1,0,1,1
TRBV5-1,TRBJ2-7,CASRPRDSPDPLGYEQYF,1,0,1,1
TRBV2,TRBJ2-5,CATLYLSGEGEKETQYF,1,0,1,1
TRBV19,TRBJ2-1,CASTPLSGGHPYNEQFF,1,0,1,1
TRBV19,TRBJ1-5,CASRSLPGQMSNQPQHF,1,0,1,1
TRBV19,TRBJ1-6,CASRRTGASSYNSPLHF,1,0,1,1
TRBV18,TRBJ2-6,CASSGITGSSGANVLTF,1,1,2,2
TRBV12-3/4,TRBJ1-6,CASPYRGGRMGNSPLHF,1,0,1,1
TRBV19,TRBJ1-5,CASPGQGWYGSNQPQHF,1,0,1,1
TRBV6-2/3/5/6,TRBJ1-1,CASSLTPPGWGGAEAFF,1,0,1,1
TRBV28,TRBJ2-7,CASSLNDLGTRNYEQYF,1,0,1,1
TRBV12-3/4,TRBJ1-1,CASSWGTGGPPVAEAFF,1,0,1,1
TRBV6-2/3/5/6,TRBJ2-1,CASSYNPGGPLVNEQFF,1,0,1,1
TRBV6-2/3/5/6,TRBJ1-3,CASSLIGQGFSGNTIYF,1,0,1,1
TRBV27,TRBJ2-3,CASSLAGGGIYTDTQYF,1,0,1,1
TRBV28,TRBJ2-7,CASSPPQGGQGTYEQYF,1,0,1,1
TRBV6-1,TRBJ2-1,CASSEGGTSGAYNEQFF,1,0,1,1
TRBV2,TRBJ2-4,CASSELRAGTYKNIQYF,1,0,1,1
TRBV6-1,TRBJ1-4,CASSEARGRDSSRKLFF,1,0,1,1
TRBV11-2,TRBJ2-5,CASSTSTGTGDQETQYF,1,0,1,1
TRBV5-6,TRBJ1-5,CASSLGLGRGSNQPQHF,1,0,1,1
TRBV7-8,TRBJ1-2,CASSLSVGGQGAHGYTF,1,0,1,1
TRBV7-2,TRBJ1-4,CASSSYFEGATNEKLFF,1,0,1,1
TRBV5-4,TRBJ2-1,CASSSSWASGIVDEQFF,1,0,1,1
TRBV7-8,TRBJ2-1,CASSSQSLAVSYNEQFF,1,0,1,1
TRBV11-2,TRBJ1-6,CASSSLDSTVYNSPLHF,1,0,1,1
TRBV5-5,TRBJ2-7,CASSWGLAGGPSYEQYF,2,0,1,2
TRBV7-9,TRBJ1-4,CASSPWVGTDVNEKLFF,1,0,1,1
TRBV7-3,TRBJ2-3,CASSPGRLAGRTDTQYF,1,0,1,1
TRBV3-1,TRBJ1-1,CASSRDPILRGSIEAFF,1,0,1,1
TRBV3-1,TRBJ2-7,CASSQRDRGPPPGEQNF,1,0,1,1
TRBV3-1,TRBJ2-5,CASSQDFMGTGRETQYF,1,0,1,1
TRBV9,TRBJ2-3,CASSVGARTSGGDTQYF,1,0,1,1
TRBV6-1,TRBJ1-5,CASREGQGVTINQPQHF,1,0,1,1
TRBV27,TRBJ1-6,CASRPLFLSGENSPLHF,1,0,1,1
TRBV5-1,TRBJ2-5,CASSRLAGGPYQETQYF,1,0,1,1
TRBV5-1,TRBJ2-7,CASSFPTSGGSSAEQYF,1,0,1,1
TRBV5-1,TRBJ2-3,CASSLAMGGGAKDTQYF,1,0,1,1
TRBV5-1,TRBJ2-1,CASSLGSGGASYNEQFF,1,0,1,1
TRBV5-1,TRBJ1-3,CASSLGLGVFAGNTIYF,1,0,1,1
TRBV5-1,TRBJ1-2,CASSLTTGRLGPIGYTF,1,0,1,1
TRBV5-1,TRBJ2-3,CASSSDGLAGGTDTQYF,1,0,1,1
TRBV4-1,TRBJ2-7,CASSWAGQGLIIYEQYF,1,0,1,1
TRBV5-1,TRBJ2-3,CASSLAGGVRSTDTQYF,1,0,1,1
TRBV4-1,TRBJ1-4,CASSRRQGWVRGEKLFF,1,0,1,1
TRBV4-1,TRBJ2-7,CASSQDTPDRGVDEQYF,2,0,1,2
TRBV4-1,TRBJ2-3,CASSQEGQGSSTDTQYF,1,0,1,1
TRBV5-1,TRBJ1-1,CASSALWLGGWNTEAFF,1,0,1,1
TRBV5-1,TRBJ1-5,CASSGGSTSGGNQPQHF,1,0,1,1
TRBV20-1,TRBJ2-1,CSARITSSGGLYNEQFF,1,1,2,2
TRBV20-1,TRBJ2-3,CSANQAGPTAGTDTQYF,1,0,1,1
TRBV20-1,TRBJ1-1,CSADPAAQGGTNTEAFF,1,0,1,1
TRBV29-1,TRBJ2-3,CSVEPLAGEMPTDTQYF,1,0,1,1
TRBV29-1,TRBJ2-3,CSVEGTRTGTYTDTQYF,1,0,1,1
TRBV28,TRBJ1-5,FASSFVEVGLNQPQYF,1,0,1,1
TRBV12-5,TRBJ2-6,CASGFTGGSGANVLTF,1,0,1,1
TRBV30,TRBJ1-1,CAWSRHPGQMNTEAFF,1,0,1,1
TRBV24-1,TRBJ2-2,CATQPQDRGQTGELFF,1,0,1,1
TRBV24-1,TRBJ1-5,CATPFPRDRNNQPLHF,1,0,1,1
TRBV24-1,TRBJ2-2,CATSTTGTANTGELFF,1,1,2,2
TRBV15,TRBJ1-5,CATSRAPGDSNQPQHF,1,0,1,1
TRBV19,TRBJ1-1,CASSLNRDTRNTEAFF,1,0,1,1
TRBV19,TRBJ2-1,CASSVNSGGKYNEQFF,1,0,1,1
TRBV19,TRBJ2-1,CASSIRGEGSYNEQFF,1,0,1,1
TRBV19,TRBJ1-3,CASSIQSGTSGNTIYF,1,0,1,1
TRBV19,TRBJ1-6,CASSIVADFPNSPLHF,1,0,1,1
TRBV28,TRBJ1-5,CASSTPDIYSNQPQHF,1,0,1,1
TRBV18,TRBJ2-2,CASSLQTSGNTGELFF,1,0,1,1
TRBV18,TRBJ2-2,CASSPTWSANTGELFF,1,0,1,1
TRBV18,TRBJ1-6,CASSPNTGGIRSPLHF,1,0,1,1
TRBV18,TRBJ1-2,CASSPPATGTNYGYTF,1,0,1,1
TRBV18,TRBJ2-2,CASSTRLFKNTGELFF,1,0,1,1
TRBV27,TRBJ1-1,CASWGQGIWKNTEAFF,1,0,1,1
TRBV7-3,TRBJ2-3,CASPATKPPSTDTQYF,1,0,1,1
TRBV6-4,TRBJ1-1,CASRKSPGTANTEAFF,1,0,1,1
TRBV2,TRBJ1-4,CASIRSMTADNEKLFF,1,0,1,1
TRBV28,TRBJ2-2,CASSFSGGRNTGELFF,1,0,1,1
TRBV6-2/3/5/6,TRBJ2-1,CASSFHTSGWDYEQFF,1,0,1,1
TRBV12-3/4,TRBJ2-2,CASSLSGPTNTGELFF,2,3,2,5
TRBV28,TRBJ1-1,CASSLHLGQVVTEAFF,1,0,1,1
TRBV12-3/4,TRBJ1-6,CASSLGLTSYNSPLHF,1,0,1,1
TRBV6-2/3/5/6,TRBJ2-3,CASSLGGGLSTDTQYF,1,0,1,1
TRBV6-2/3/5/6,TRBJ1-1,CASSLLGSGGEPEAFF,1,0,1,1
TRBV6-2/3/5/6,TRBJ1-4,CASSYSRRSTNEKLFF,1,0,1,1
TRBV28,TRBJ2-1,CASSPLTGQAYNEQFF,1,0,1,1
TRBV11-1,TRBJ2-1,CASSPGQGNSYNEQFW,1,0,1,1
TRBV12-3/4,TRBJ2-3,CASSHPRGGLADTQYF,1,0,1,1
TRBV7-9,TRBJ2-5,CASSVLAGAMGETQYF,1,0,1,1
TRBV6-1,TRBJ2-1,CASSALTGDSYNEQFF,1,0,1,1
TRBV10-3,TRBJ2-7,CASSAHTASGGNEQYF,1,0,1,1
TRBV6-1,TRBJ1-6,CASSEPYRGMNSPLHF,1,0,1,1
TRBV2,TRBJ2-6,CASSEAQGPGANVLTF,1,0,1,1
TRBV2,TRBJ2-6,CASSEAALFRANVLTF,1,0,1,1
TRBV28,TRBJ1-1,CASSIATGTGGTEAFF,1,0,1,1
TRBV6-1,TRBJ2-1,CASSRMGQGPQNEQFF,1,0,1,1
TRBV5-6,TRBJ2-1,CASSLGGTGGPNEQFF,1,0,1,1
TRBV5-6,TRBJ2-1,CASSLETGTIRGEQFF,1,0,1,1
TRBV7-9,TRBJ2-3,CASSLWDAGGRDTQYF,1,0,1,1
TRBV7-3,TRBJ2-2,CASSLPSKANTGELFF,1,0,1,1
TRBV7-9,TRBJ1-2,CASSLRGGTGGLGYTF,1,0,1,1
TRBV11-2,TRBJ2-5,CASSLGASGNQETQYF,1,0,1,1
TRBV7-9,TRBJ2-1,CASSLDGDWETNEQFF,1,0,1,1
TRBV7-8,TRBJ2-5,CASSLEGVGYQETQYF,1,0,1,1
TRBV7-2,TRBJ1-3,CASSLEYPSSGNTIYF,1,0,1,1
TRBV7-2,TRBJ2-3,CASSLMGASSTDTQYF,1,0,1,1
TRBV7-2,TRBJ2-1,CASSLTSGGPIIEQFF,1,0,1,1
TRBV7-9,TRBJ1-1,CASSLKYVTENTEAFF,1,0,1,1
TRBV5-4,TRBJ2-3,CASSSGLAGGSDTQYF,1,0,1,1
TRBV7-9,TRBJ1-2,CASSLPPTGVNYGYTF,1,0,1,1
TRBV7-2,TRBJ1-5,CASSPRGTAGNQPQHF,2,0,1,2
TRBV7-9,TRBJ2-1,CASSPPGSGGYNEQFF,1,0,1,1
TRBV11-2,TRBJ2-2,CASSPPGLAGAGELFF,1,0,1,1
TRBV3-1,TRBJ1-4,CASSPRTGNTNEELFF,1,0,1,1
TRBV14,TRBJ2-2,CASSPTWTGNTGELFF,1,0,1,1
TRBV3-1,TRBJ2-1,CASSHLKGQGSDEQFF,1,0,1,1
TRBV16,TRBJ2-1,CASSQLGSGGNNEQFF,1,0,1,1
TRBV3-1,TRBJ2-5,CASSQVLGQGTETQYF,1,0,1,1
TRBV3-1,TRBJ2-6,CASSQGGGLGANVLTF,1,0,1,1
TRBV4-2,TRBJ2-7,CASSQEPSGPTYEQYF,1,0,1,1
TRBV9,TRBJ1-2,CASSVGSQGVNYGYTF,1,0,1,1
TRBV3-1,TRBJ1-1,CASSGGGTALNTEAFF,1,0,1,1
TRBV3-1,TRBJ2-1,CASSGTTGVIGNEQFF,1,0,1,1
TRBV5-5,TRBJ2-7,CASSTIGQGHTYEQYF,1,0,1,1
TRBV7-2,TRBJ2-7,CASRGYLAGDLMKQYF,1,0,1,1
TRBV5-5,TRBJ2-1,CASNPVGSPRDDEQFF,1,0,1,1
TRBV28,TRBJ2-3,CASKGMRTGATDTQYF,1,0,1,1
TRBV6-2/3/5/6,TRBJ2-3,CASKLRQGQGPDTQYF,1,0,1,1
TRBV3-1,TRBJ1-1,CAKSDREVVVDTEAFF,1,0,1,1
TRBV5-1,TRBJ2-3,CASSFVTSGFSDTQYF,1,0,1,1
TRBV5-1,TRBJ1-3,CASSLDPIASGNTIYF,1,0,1,1
TRBV5-1,TRBJ1-4,CASSWAGTGRNEKLFF,1,2,2,3
TRBV4-1,TRBJ1-2,CASSQGYRDRGDGYTF,1,0,1,1
TRBV4-1,TRBJ1-6,CASSQDGGYGDTPLHF,1,0,1,1
TRBV5-1,TRBJ2-1,CASSGGLAGPSNEQFF,1,0,1,1
TRBV5-1,TRBJ2-3,CASSTGTSGSTDTQYF,1,0,1,1
TRBV5-1,TRBJ2-3,CASSNRDRGRTDTQYF,1,0,1,1
TRBV20-1,TRBJ2-3,CSAGKEPGGLTDTQYF,1,0,1,1
TRBV20-1,TRBJ2-7,CSASSLGQGISYEQYL,1,0,1,1
TRBV20-1,TRBJ2-6,CSASPGIASGANVLTF,1,0,1,1
TRBV20-1,TRBJ1-3,CSARAGTGGIGNTIYF,1,0,1,1
TRBV20-1,TRBJ1-5,CSARDLGFQGDQPQHF,1,1,2,2
TRBV20-1,TRBJ2-7,CSARDLTSGGEYEQYF,1,0,1,1
TRBV20-1,TRBJ2-3,CSARDRRLAVTDAQYF,1,0,1,1
TRBV29-1,TRBJ2-3,CSVAGTLAGATDTQYF,1,0,1,1
TRBV29-1,TRBJ2-1,CSVGNFGAASYNEQFF,1,0,1,1
TRBV29-1,TRBJ2-3,CSVDRGFSGRTDTQYF,1,0,1,1
TRBV29-1,TRBJ2-1,CSVEAGEIWAKIEQFF,1,0,1,1
TRBV29-1,TRBJ2-1,CSVEDQVPGFYNEQFF,1,0,1,1
TRBV29-1,TRBJ2-3,CSVTGLAGVWADTQYF,1,0,1,1
TRBV2,TRBJ2-6,CAGRDRASGANVLTF,1,0,1,1
TRBV12-5,TRBJ1-2,CASGRDRGLIYGYTF,1,0,1,1
TRBV30,TRBJ2-1,CAWTGRGTGYNEQFF,1,0,1,1
TRBV30,TRBJ1-2,CAWTTQGIYTYGYTF,1,0,1,1
TRBV30,TRBJ2-7,CAWSVPSQGQDEQYF,1,0,1,1
TRBV30,TRBJ2-7,CAWSVGGTGGYEQYF,1,0,1,1
TRBV30,TRBJ1-6,CAWSAIRSYNSPLHF,1,0,1,1
TRBV30,TRBJ2-1,CAWSGGLAGVYEQFF,2,0,1,2
TRBV30,TRBJ1-3,CAWRRDASSGNTIYF,1,0,1,1
TRBV2,TRBJ2-3,CAGGGGRGPTDTQYF,1,0,1,1
TRBV10-3,TRBJ2-3,CAISVGKGGTDTQYF,1,0,1,1
TRBV24-1,TRBJ2-5,CATSDQGQWGETQYF,1,0,1,1
TRBV24-1,TRBJ2-2,CATSPGPTNTGELFI,1,0,1,1
TRBV15,TRBJ1-1,CATSQDRGHATEAFF,1,0,1,1
TRBV15,TRBJ1-5,CATSRRGSGNQPQHF,1,0,1,1
TRBV19,TRBJ1-2,CASTGETVANYGYTF,1,0,1,1
TRBV19,TRBJ2-1,CASTRTGGIINEQFF,1,0,1,1
TRBV19,TRBJ1-5,CASSRLTDSNQPQHF,1,0,1,1
TRBV19,TRBJ1-1,CASSIGETGYTEAFF,1,0,1,1
TRBV19,TRBJ1-5,CASSIDAETNQPQHF,1,0,1,1
TRBV19,TRBJ2-1,CASSTPSGGKHEQFF,1,0,1,1
TRBV19,TRBJ2-7,CASSRGQGIPYEQYF,1,0,1,1
TRBV19,TRBJ2-2,CASRIQGRRTGELFF,1,0,1,1
TRBV19,TRBJ1-4,CASNLGTGSYEKLFF,1,0,1,1
TRBV18,TRBJ2-3,CASSPPGSSTDTQYF,1,0,1,1
TRBV5-4,TRBJ2-3,CASSNGGHTTDTQYF,1,0,1,1
TRBV18,TRBJ1-1,CASSPREPIETEAFF,1,0,1,1
TRBV18,TRBJ2-3,CASSPRVGGTDTQYF,1,0,1,1
TRBV18,TRBJ2-7,CASSPGQGDLYKQYF,1,0,1,1
TRBV18,TRBJ2-2,CASSPEGHFTGELFF,1,0,1,1
TRBV18,TRBJ1-5,CASSPTGASDRPQHF,1,0,1,1
TRBV27,TRBJ2-7,CASALAGSFSYEQYF,1,0,1,1
TRBV5-4,TRBJ2-1,CASGLDRAIYNEQFF,1,0,1,1
TRBV2,TRBJ2-6,CASIAGGVGANVLTF,1,0,1,1
TRBV5-6,TRBJ1-1,CASILRGAGNTEAFF,1,0,1,1
TRBV28,TRBJ2-2,CASTSTGYNTGELFF,1,0,1,1
TRBV7-2,TRBJ2-1,CASTLQRGGYNEQFF,2,0,1,2
TRBV12-3/4,TRBJ1-1,CASTLSTGRNTEAFF,1,0,1,1
TRBV6-2/3/5/6,TRBJ2-7,CASSFPQGVSYEQYF,1,0,1,1
TRBV12-3/4,TRBJ1-2,CASSFGPLAYYGYTF,1,0,1,1
TRBV28,TRBJ2-5,CASSFGRGLRETQYF,1,0,1,1
TRBV28,TRBJ1-4,CASSFIQGTNEKLFF,1,0,1,1
TRBV6-2/3/5/6,TRBJ1-6,CASSFPTWAEAPLHF,1,0,1,1
TRBV12-3/4,TRBJ1-2,CASSLWDSAGVGYTF,1,0,1,1
TRBV6-2/3/5/6,TRBJ2-3,CASSLGTGLGDTQYF,1,0,1,1
TRBV6-2/3/5/6,TRBJ1-3,CASSLDRGEGNTIYF,1,0,1,1
TRBV28,TRBJ1-3,CASSLERTSGNTLYF,1,0,1,1
TRBV12-3/4,TRBJ2-3,CASSLSGFGTDTQYF,1,0,1,1
TRBV28,TRBJ1-1,CASSLSGGRVTGAFF,1,0,1,1
TRBV6-2/3/5/6,TRBJ2-5,CASSLSNDLQETQYF,1,0,1,1
TRBV28,TRBJ2-1,CASSLGGFSYNEQFF,1,0,1,1
TRBV12-3/4,TRBJ1-1,CASSLDTTANTEAFF,1,0,1,1
TRBV12-3/4,TRBJ1-5,CASSSQGVGHEPQHF,1,0,1,1
TRBV28,TRBJ2-7,CASSSGGEGSYEQYF,1,0,1,1
TRBV6-2/3/5/6,TRBJ2-3,CASSSSGGSTDTQYF,1,0,1,1
TRBV28,TRBJ1-1,CASSSPPGRNTEAFF,1,0,1,1
TRBV6-2/3/5/6,TRBJ1-1,CASSLFGTVNTEAFF,1,0,1,1
TRBV28,TRBJ2-3,CASSLAGTRRDTQYF,1,0,1,1
TRBV28,TRBJ1-5,CASSLGWGESQPRHF,1,0,1,1
TRBV12-3/4,TRBJ1-2,CASSPLKGTNYGYTF,1,0,1,1
TRBV28,TRBJ2-5,CASSPGLAGTETQYF,1,0,1,1
TRBV11-2,TRBJ2-7,CASSPNGVSYYEQYF,1,0,1,1
TRBV28,TRBJ2-7,CASSPLPGRPYEQYF,1,0,1,1
TRBV6-2/3/5/6,TRBJ2-7,CASSPQRGTSYEQYF,1,0,1,1
TRBV2,TRBJ1-4,CASSRAGGEGEKLFF,1,0,1,1
TRBV28,TRBJ2-7,CASSASGFPTYEQYF,1,0,1,1
TRBV6-1,TRBJ2-2,CASSGAASGEGELFF,1,0,1,1
TRBV2,TRBJ2-3,CASSGGQFNTDTQYF,1,0,1,1
TRBV6-1,TRBJ2-7,CASSEETGGYYEQYF,1,0,1,1
TRBV6-1,TRBJ1-1,CASSEVELLNAEAFF,1,0,1,1
TRBV6-2/3/5/6,TRBJ2-5,CASSIGGFGGETQYF,1,0,1,1
TRBV6-2/3/5/6,TRBJ2-5,CASSTSGGTKETQYF,1,0,1,1
TRBV6-2/3/5/6,TRBJ1-6,CASSTGTPYNSPLHF,1,0,1,1
TRBV12-3/4,TRBJ2-5,CASSTTSGVRETQYF,1,0,1,1
TRBV7-2,TRBJ2-5,CASSFASGYQETQYF,1,0,1,1
TRBV7-2,TRBJ2-7,CASSFRGADTGEQYF,1,0,1,1
TRBV11-2,TRBJ2-7,CASSFRTGLTYEQYF,1,0,1,1
TRBV5-6,TRBJ2-5,CASSLYVGIGETQYF,1,0,1,1
TRBV11-2,TRBJ2-2,CASSLGQKNTGELFF,1,0,1,1
TRBV5-4,TRBJ2-1,CASSLGGQGYNEQFF,1,0,1,1
TRBV5-6,TRBJ1-5,CASSLGDRDGQPQHF,1,0,1,1
TRBV6-2/3/5/6,TRBJ2-2,CASSLDDSRTGELFF,1,0,1,1
TRBV5-6,TRBJ2-7,CASSLEGGHPYEQYF,1,0,1,1
TRBV5-8,TRBJ2-1,CASSLIAGGLNEQFF,1,0,1,1
TRBV7-2,TRBJ1-1,CASSLWGTGNTEAFF,1,0,1,1
TRBV7-9,TRBJ1-6,CASSLHPGDNSPLHF,1,0,1,1
TRBV7-9,TRBJ2-3,CASSLAGLITDTQYF,1,0,1,1
TRBV7-9,TRBJ1-4,CASSLAGQGSEKLFF,1,0,1,1
TRBV11-1,TRBJ2-1,CASSLAWGLANEQFF,1,0,1,1
TRBV7-8,TRBJ2-1,CASSLGFSPGNEQFF,1,0,1,1
TRBV7-2,TRBJ2-3,CASSLGGARTDTQYF,1,0,1,1
TRBV7-2,TRBJ1-3,CASSLGTGSGNTIYF,1,0,1,1
TRBV7-9,TRBJ2-1,CASSLDGGPYNEQFF,1,0,1,1
TRBV11-1,TRBJ2-1,CASSLMTGGDNEQFF,1,0,1,1
TRBV7-3,TRBJ2-1,CASSLTGGTANEQFF,1,0,1,1
TRBV5-8,TRBJ2-5,CASSSYGTLQETQYF,1,0,1,1
TRBV7-9,TRBJ2-7,CASSSGTGVGYEQYF,1,0,1,1
TRBV7-3,TRBJ2-2,CASSSGLGNTGELFF,1,0,1,1
TRBV7-2,TRBJ2-3,CASSSPGGRADTQYF,1,0,1,1
TRBV5-6,TRBJ1-3,CASSSLTGTGNTIYF,1,0,1,1
TRBV11-3,TRBJ2-5,CASSSGLAGDGTQYF,1,0,1,1
TRBV7-2,TRBJ1-2,CASSWKGQGNYGYTF,1,0,1,1
TRBV7-3,TRBJ2-1,CASSYLADAYNEQFF,1,0,1,1
TRBV28,TRBJ2-3,CASSLGTGGTDTQYF,1,0,1,1
TRBV7-6,TRBJ2-3,CASSPIRGGTDTQYF,1,0,1,1
TRBV7-9,TRBJ2-2,CASSPSGGNTGELFF,1,0,1,1
TRBV2,TRBJ2-5,CASSPPRGKEETQYF,1,0,1,1
TRBV28,TRBJ1-5,CASSPPTGGWQPQHF,1,0,1,1
TRBV5-5,TRBJ2-7,CASSPRDRGQNEQYF,1,0,1,1
TRBV7-3,TRBJ2-1,CASSPGGAGYNEQFF,1,0,1,1
TRBV12-3/4,TRBJ1-1,CASSPTGRMNTEAFF,1,0,1,1
TRBV16,TRBJ1-2,CASSPNSGTAGGYTF,1,0,1,1
TRBV5-6,TRBJ2-3,CASSRQGVSTDTQYF,1,0,1,1
TRBV7-9,TRBJ2-1,CASSRTSGARNEQFF,1,0,1,1
TRBV11-2,TRBJ2-1,CASSRTGARDISLVF,1,0,1,1
TRBV5-6,TRBJ2-1,CASSQLDGTYNEQFF,1,0,1,1
TRBV4-2,TRBJ2-1,CASSQDFTVAGEQFF,1,0,1,1
TRBV3-1,TRBJ2-7,CASSQLAGGPYEQYF,1,0,1,1
TRBV7-9,TRBJ2-1,CASSQRGQEYNEQFF,1,0,1,1
TRBV14,TRBJ1-1,CASSQQSTGITEAFF,1,0,1,1
TRBV4-2,TRBJ1-1,CASSQVLAENTEAFF,1,1,2,2
TRBV3-1,TRBJ2-3,CASSQVWQGTDTQYF,1,0,1,1
TRBV3-1,TRBJ1-2,CASSQAPLKGYGYTF,1,0,1,1
TRBV3-1,TRBJ2-1,CASSQGRGVYNEQFF,1,0,1,1
TRBV3-1,TRBJ2-1,CASSQGGGGAYEQFF,1,0,1,1
TRBV3-1,TRBJ2-3,CASSQEAVGMDTQYF,1,0,1,1
TRBV4-2,TRBJ2-5,CASSQEVNREETQYF,1,0,1,1
TRBV3-1,TRBJ2-7,CASSQSFREAYEQYF,1,0,1,1
TRBV9,TRBJ1-2,CASSVAPQGILDYTF,1,1,2,2
TRBV9,TRBJ1-2,CASSVDRGLSGGYTF,1,0,1,1
TRBV5-4,TRBJ2-7,CASSARLEQGPEQYF,1,0,1,1
TRBV9,TRBJ2-7,CASSAAAGGAYERYF,1,0,1,1
TRBV5-4,TRBJ1-2,CASSARGGSGVGYTF,1,0,1,1
TRBV7-2,TRBJ2-1,CASSENGGGYNEQFF,1,0,1,1
TRBV11-2,TRBJ2-1,CASSMSGGAYNEQFF,1,0,1,1
TRBV6-2/3/5/6,TRBJ2-5,CASSTPREGRETQYF,1,0,1,1
TRBV12-3/4,TRBJ2-5,CASSNTRLARETQYF,1,0,1,1
TRBV27,TRBJ1-6,CASRFGGSKWSPLHF,1,0,1,1
TRBV28,TRBJ2-5,CASRGSGTEKETQYF,1,0,1,1
TRBV6-2/3/5/6,TRBJ1-5,CASRGTRATFQPQHF,1,0,1,1
TRBV12-3/4,TRBJ2-7,CASRPPTGARYEQYF,1,1,2,2
TRBV7-9,TRBJ1-1,CASRRGQVRNTEAFF,2,0,1,2
TRBV6-2/3/5/6,TRBJ2-3,CASRQLAGGRDTQYF,1,0,1,1
TRBV28,TRBJ1-4,CASKTGQGRNEKLFF,1,0,1,1
TRBV27,TRBJ1-4,CASSLTAAAPAKLFF,1,0,1,1
TRBV10-2,TRBJ1-1,CASSDHSWGEGEAFF,1,0,1,1
TRBV10-1,TRBJ2-1,CASSESGGSYNEQFF,1,0,1,1
TRBV5-1,TRBJ1-1,CASSFQGAGNTEAFF,1,0,1,1
TRBV5-1,TRBJ1-6,CASSFMPSEDSPLHF,1,0,1,1
TRBV5-1,TRBJ2-1,CASSFQGEIYNEQFF,1,0,1,1
TRBV5-1,TRBJ2-3,CASSLFQASTDTQYF,1,0,1,1
TRBV5-1,TRBJ1-1,CASSLALGGNTEAFF,1,0,1,1
TRBV5-1,TRBJ1-5,CASSLAPGFNQPQHF,1,0,1,1
TRBV5-1,TRBJ1-1,CASSLGNQGSTEAFF,1,0,1,1
TRBV5-1,TRBJ2-7,CASSLGVAGRNERYF,1,0,1,1
TRBV5-1,TRBJ1-6,CASSLDTGSGSPLHF,1,0,1,1
TRBV5-1,TRBJ1-1,CASSLIGSENTEAFF,1,0,1,1
TRBV5-1,TRBJ1-4,CASSLGQTTNEKLFF,1,0,1,1
TRBV5-1,TRBJ1-2,CASSSSKGSNYGYTF,1,0,1,1
TRBV5-1,TRBJ1-1,CASSSLGQGNTEAFF,1,0,1,1
TRBV5-1,TRBJ2-1,CASSLSDPAGNEQFF,1,0,1,1
TRBV5-1,TRBJ2-7,CASSPTDRTYYEQYF,1,0,1,1
TRBV4-1,TRBJ1-3,CASSRTRGAGNTIYF,1,0,1,1
TRBV4-1,TRBJ2-7,CASSRKPGDITEQYF,1,0,1,1
TRBV4-1,TRBJ1-3,CASSQRVFSGNTIYF,1,0,1,1
TRBV4-1,TRBJ2-1,CASSQVKASYNEQFF,1,0,1,1
TRBV5-1,TRBJ1-1,CASSVGQGSGTEAFF,1,0,1,1
TRBV4-1,TRBJ2-5,CASSERQGISETQYF,1,0,1,1
TRBV5-1,TRBJ2-3,CASSMMDVRTDTQYF,1,0,1,1
TRBV5-1,TRBJ1-2,CASSTTGAPSYGYTF,1,0,1,1
TRBV5-1,TRBJ1-1,CASRPDRGLYTEAFF,1,0,1,1
TRBV20-1,TRBJ2-2,CSVWPGNRGTGELFF,1,0,1,1
TRBV20-1,TRBJ1-5,CSATTSEHSNQPQHF,1,0,1,1
TRBV20-1,TRBJ2-3,CSARLSTSGGDTQYF,1,0,1,1
TRBV20-1,TRBJ2-6,CSARTVNSGANVLTF,1,0,1,1
TRBV20-1,TRBJ2-1,CSARGLRGADHEQFF,1,0,1,1
TRBV20-1,TRBJ2-1,CSARDFKTENNEQFF,1,0,1,1
TRBV20-1,TRBJ2-5,CSARDLIQGEETQYF,1,0,1,1
TRBV20-1,TRBJ2-7,CSARDQAGSVYEQYF,1,0,1,1
TRBV20-1,TRBJ1-2,CSARDRTSANYGYTF,1,0,1,1
TRBV20-1,TRBJ2-3,CSAREEAGARDTQYF,1,0,1,1
TRBV20-1,TRBJ2-1,CSARERTGLYNEQFF,1,0,1,1
TRBV20-1,TRBJ2-1,CSPGQGYLVMDEQFF,1,0,1,1
TRBV29-1,TRBJ2-7,CSVASSSGGIYEQYF,1,0,1,1
TRBV29-1,TRBJ2-7,CSVEDIGTGWYEQYF,1,0,1,1
TRBV29-1,TRBJ2-3,CSAALAGDSTDTQYF,1,0,1,1
TRBV29-1,TRBJ2-3,CSGEGDRDAADTQYF,1,0,1,1
TRBV28,TRBJ2-3,YASSFNRGSTDTQYF,1,0,1,1
TRBV12-5,TRBJ2-3,CASGPDTGGDTQYF,1,0,1,1
TRBV7-7,TRBJ2-1,CASSLEGSANEQFF,1,0,1,1
TRBV30,TRBJ1-5,CAWSVGGSNQPQHF,1,0,1,1
TRBV30,TRBJ2-1,CAWSTGGSYNEQFF,1,0,1,1
TRBV30,TRBJ1-5,CAWSRDVSNQPQHF,1,0,1,1
TRBV30,TRBJ2-3,CAWKFPGTPNTQYF,1,0,1,1
TRBV10-3,TRBJ2-5,CAISDTSGARTQYF,1,0,1,1
TRBV10-3,TRBJ2-2,CAISENRGGGELFF,1,0,1,1
TRBV10-3,TRBJ2-5,CAISGGGEKETQYF,1,0,1,1
TRBV28,TRBJ2-4,CATLKGGAKNIQYF,1,0,1,1
TRBV28,TRBJ2-1,CATVTSGGAGEQFF,1,0,1,1
TRBV18,TRBJ1-2,CASSRERLNYGYTF,1,0,1,1
TRBV19,TRBJ2-1,CASSSGGGWHEQFF,1,0,1,1
TRBV19,TRBJ1-5,CASSLPEGNQPQHF,1,0,1,1
TRBV19,TRBJ1-1,CASSILGLDTEAFF,1,0,1,1
TRBV19,TRBJ1-1,CASSIGQGKTEAFF,1,0,1,1
TRBV19,TRBJ1-4,CASSMDPQSEKLFF,1,0,1,1
TRBV19,TRBJ1-6,CASRVGPSNSPLHF,2,1,2,3
TRBV19,TRBJ2-3,CASREQSSTDTQYF,1,0,1,1
TRBV5-4,TRBJ2-2,CASFEGSGTGELFF,1,0,1,1
TRBV18,TRBJ2-7,CASSTSGDYYEQYF,1,0,1,1
TRBV18,TRBJ1-1,CASSPLEGPTEAFF,1,0,1,1
TRBV18,TRBJ1-1,CASSPPSGFTEAFF,1,0,1,1
TRBV18,TRBJ1-1,CASSPPFGNTEAFF,1,0,1,1
TRBV18,TRBJ2-5,CASSPPIGQETQYF,1,0,1,1
TRBV18,TRBJ2-3,CASSPPTVTDTQYF,1,0,1,1
TRBV18,TRBJ2-1,CASSPHGVRNEQFF,1,0,1,1
TRBV28,TRBJ2-3,CASQAGGGADTQYF,1,0,1,1
TRBV7-9,TRBJ1-3,CASQGADFINTIYF,1,0,1,1
TRBV6-2/3/5/6,TRBJ1-4,CASVGGATNEKLFF,1,0,1,1
TRBV6-2/3/5/6,TRBJ2-7,CASGYSGASYEQYF,1,0,1,1
TRBV2,TRBJ1-5,CASGQANGNQPQHF,1,0,1,1
TRBV6-2/3/5/6,TRBJ2-1,CASGRGPQSEEQFF,1,0,1,1
TRBV2,TRBJ2-1,CASILWGAHNEQFF,1,0,1,1
TRBV28,TRBJ2-2,CASMLSLNTGGLFF,1,0,1,1
TRBV11-2,TRBJ2-7,CASTYERGPYEQYF,1,0,1,1
TRBV28,TRBJ2-7,CASTLGIRSYEQYF,1,0,1,1
TRBV28,TRBJ1-2,CASTPGGGLYGYTF,2,0,1,2
TRBV14,TRBJ2-1,CASTRGGGRNEQFF,1,0,1,1
TRBV12-3/4,TRBJ2-1,CASSFFWDPDEQFF,1,0,1,1
TRBV12-3/4,TRBJ1-1,CASSLGRFNTEAFF,1,0,1,1
TRBV6-2/3/5/6,TRBJ2-1,CASSLDTSYNEQFF,1,0,1,1
TRBV12-3/4,TRBJ1-1,CASSLSGAVPEAFF,1,0,1,1
TRBV28,TRBJ1-2,CASSLWKQRDGYTF,1,0,1,1
TRBV12-3/4,TRBJ2-1,CASSLRLAGAEQFF,2,0,1,2
TRBV28,TRBJ2-7,CASSLHRVPPEQYF,1,0,1,1
TRBV12-3/4,TRBJ2-3,CASSLQGFTDTQYF,1,0,1,1
TRBV28,TRBJ2-7,CASSLDTVPYEQYF,1,0,1,1
TRBV28,TRBJ2-3,CASSLILGTDTQYF,1,0,1,1
TRBV12-3/4,TRBJ2-1,CASSLIVTPQEQFF,1,0,1,1
TRBV6-2/3/5/6,TRBJ2-1,CASSLKGNHNEQFF,1,0,1,1
TRBV28,TRBJ2-7,CASSSHGSSYEQYF,1,0,1,1
TRBV6-2/3/5/6,TRBJ1-1,CASSSGPGDTEAFF,1,0,1,1
TRBV6-2/3/5/6,TRBJ2-3,CASSSGLLLDTQYF,1,0,1,1
TRBV28,TRBJ1-5,CASSWGSARQPQHF,1,0,1,1
TRBV7-9,TRBJ1-1,CASSWDLYATEAFF,1,0,1,1
TRBV6-2/3/5/6,TRBJ2-3,CASSYSPEKDTQYF,1,0,1,1
TRBV6-2/3/5/6,TRBJ1-5,CASSYGGNNQPQHF,1,0,1,1
TRBV12-3/4,TRBJ2-1,CASSLAGGYNEQFF,1,0,1,1
TRBV28,TRBJ2-7,CASSLTRAQYEQYF,1,0,1,1
TRBV7-2,TRBJ2-1,CASSPGLARNEQFF,1,0,1,1
TRBV6-2/3/5/6,TRBJ2-4,CASSPTATKNIQYF,1,0,1,1
TRBV27,TRBJ2-7,CASSRRGYSYEQYF,1,0,1,1
TRBV6-2/3/5/6,TRBJ2-5,CASSQGALEETQYF,1,0,1,1
TRBV2,TRBJ1-5,CASSVGQPNQPQHF,1,0,1,1
TRBV2,TRBJ1-5,CASSVQRGPQPQHF,1,0,1,1
TRBV2,TRBJ1-5,CASSASISNQPQHF,1,0,1,1
TRBV6-1,TRBJ1-1,CASSAADRETEAFF,1,0,1,1
TRBV6-1,TRBJ1-5,CASSAQRGPQPQHF,1,0,1,1
TRBV6-1,TRBJ2-7,CASSDRYRDYEQYF,1,0,1,1
TRBV2,TRBJ1-5,CASSEAGLWQPQHF,1,0,1,1
TRBV5-4,TRBJ2-7,CASSETGSSYEQYF,1,0,1,1
TRBV28,TRBJ2-3,CASSTSTNTDTQYF,1,0,1,1
TRBV13,TRBJ2-3,CASSFPENTDTQYF,1,0,1,1
TRBV11-2,TRBJ2-1,CASSFGGPYNEQFF,1,0,1,1
TRBV7-2,TRBJ2-5,CASSFGAGVETQYF,1,0,1,1
TRBV5-6,TRBJ2-3,CASSFPTHTDTQYF,1,1,2,2
TRBV7-2,TRBJ2-1,CASSFGAAGSRKFS,1,0,1,1
TRBV7-9,TRBJ1-1,CASSFGQGGTEAFF,1,0,1,1
TRBV7-9,TRBJ2-5,CASSFRTGVETQYF,1,0,1,1
TRBV5-6,TRBJ2-5,CASSLRGTRETQYF,1,0,1,1
TRBV7-6,TRBJ2-3,CASSLSSGRDTQYF,1,0,1,1
TRBV7-2,TRBJ1-2,CASSLYQGAYGYTF,1,0,1,1
TRBV7-9,TRBJ1-1,CASSLVSRDTEAFF,1,0,1,1
TRBV11-2,TRBJ2-5,CASSLVQGQETQYF,1,0,1,1
TRBV7-6,TRBJ1-3,CASSLVESGNTIYF,1,0,1,1
TRBV11-2,TRBJ2-2,CASSLARNTGELFF,1,0,1,1
TRBV7-9,TRBJ1-2,CASSLGDRWDGYTF,1,0,1,1
TRBV11-2,TRBJ2-1,CASSLDVMGPEQFF,1,1,2,2
TRBV11-2,TRBJ1-4,CASSLEKASEKLFF,1,0,1,1
TRBV7-2,TRBJ1-1,CASSLILGNTEAFF,1,0,1,1
TRBV7-3,TRBJ1-1,CASSLTGVNTEAFF,1,0,1,1
TRBV5-8,TRBJ2-7,CASSLNGYSYEQYF,1,0,1,1
TRBV7-6,TRBJ2-7,CASSSYSGTYEQYF,1,0,1,1
TRBV13,TRBJ1-6,CASSSTGVGSPLHL,1,0,1,1
TRBV5-4,TRBJ1-1,CASSYPDRPGEAFF,1,0,1,1
TRBV7-9,TRBJ2-7,CASSYRDRGDEQYF,1,0,1,1
TRBV2,TRBJ2-7,CASSYAQRGDEQYF,1,0,1,1
TRBV11-2,TRBJ2-7,CASSLSGHNYEQYF,1,0,1,1
TRBV3-1,TRBJ2-3,CASSPSLSTDTQYF,1,0,1,1
TRBV12-3/4,TRBJ2-3,CASSPSGGSDTQYF,1,0,1,1
TRBV9,TRBJ1-1,CASSPRGIGTEAFF,1,0,1,1
TRBV7-9,TRBJ1-2,CASSPSGHSYGYTF,1,0,1,1
TRBV7-6,TRBJ1-2,CASSPPASNYGYTF,1,0,1,1
TRBV7-9,TRBJ2-5,CASSPPGGQETQYF,1,0,1,1
TRBV7-2,TRBJ1-2,CASSPGGPGYGYTF,1,0,1,1
TRBV7-3,TRBJ2-3,CASSPITAGDTQYF,1,0,1,1
TRBV12-3/4,TRBJ2-7,CASSRLGGSYEQYF,1,0,1,1
TRBV6-2/3/5/6,TRBJ2-7,CASSRSYRVVGQYF,1,0,1,1
TRBV7-3,TRBJ2-1,CASSRRDRMNEQFY,1,0,1,1
TRBV5-5,TRBJ2-5,CASSRGQHKETQYF,1,0,1,1
TRBV7-9,TRBJ2-2,CASSQGSRTGELFF,1,0,1,1
TRBV7-2,TRBJ2-3,CASSQDRGPDTQYF,1,0,1,1
TRBV7-2,TRBJ2-6,CASSQESGANVLTF,1,1,2,2
TRBV4-2,TRBJ1-6,CASSQRTNASPLHF,1,0,1,1
TRBV3-1,TRBJ2-2,CASSQAPDAGELFF,1,0,1,1
TRBV3-1,TRBJ2-7,CASSQDPNSYEQYF,1,0,1,1
TRBV3-1,TRBJ1-1,CASSQSQGNTEAFF,1,0,1,1
TRBV9,TRBJ2-7,CASSVGGFLYEQYF,2,0,1,2
TRBV9,TRBJ2-7,CASSVDGTGREQYF,1,1,2,2
TRBV12-3/4,TRBJ2-3,CASSATGSTDTQYF,1,0,1,1
TRBV7-9,TRBJ2-5,CASSSAGSQETQYF,1,0,1,1
TRBV3-1,TRBJ2-5,CASSRNPNTETQYF,1,0,1,1
TRBV11-3,TRBJ2-7,CASSKGFGSGEQYF,1,0,1,1
TRBV27,TRBJ1-1,CASRPQGLNTEAFF,1,0,1,1
TRBV12-3/4,TRBJ1-4,CASRRVATNEKLFF,1,0,1,1
TRBV6-2/3/5/6,TRBJ1-5,CASRRGTGSQPQHF,1,0,1,1
TRBV11-2,TRBJ2-5,CASRAGGGEETQYF,1,0,1,1
TRBV12-3/4,TRBJ2-4,CASREALAKNIQYF,1,0,1,1
TRBV12-3/4,TRBJ2-1,CASRPGSQVNEQFF,1,0,1,1
TRBV28,TRBJ1-6,CASRPGPVGSPLHF,1,0,1,1
TRBV6-2/3/5/6,TRBJ1-5,CASRAPAGNQPQHF,1,0,1,1
TRBV6-4,TRBJ1-4,CASRDRWANEKLFF,1,0,1,1
TRBV2,TRBJ2-5,CASNYGGGKETQYF,1,0,1,1
TRBV2,TRBJ1-5,CASNSGHGNQPQHF,1,0,1,1
TRBV28,TRBJ2-7,CASKIAGGPYELYF,1,0,1,1
TRBV5-1,TRBJ2-1,CASYLAGGYNEQFF,1,0,1,1
TRBV5-1,TRBJ2-5,CASGTGQGRETQYF,1,0,1,1
TRBV10-1,TRBJ2-5,CASSETSSGETQYF,1,0,1,1
TRBV10-1,TRBJ1-6,CASSESTGGSPLHF,1,0,1,1
TRBV5-1,TRBJ2-7,CASSLLGGSGEQYF,1,0,1,1
TRBV5-1,TRBJ1-1,CASSLVPENTEAFF,1,0,1,1
TRBV5-1,TRBJ2-3,CASSLAYSTDTQYF,1,0,1,1
TRBV5-1,TRBJ1-2,CASSLARQGSGYTF,1,0,1,1
TRBV5-1,TRBJ2-5,CASSLAQEDETQYF,1,0,1,1
TRBV5-1,TRBJ2-5,CASSLAGSQETQYF,2,0,1,2
TRBV5-1,TRBJ2-1,CASSLAGDTNEQFF,1,1,2,2
TRBV5-1,TRBJ1-1,CASSLARGYTEAFF,1,0,1,1
TRBV5-1,TRBJ2-7,CASSLGDKIYEQYF,1,0,1,1
TRBV5-1,TRBJ2-2,CASSLEEATGELSF,1,0,1,1
TRBV5-1,TRBJ2-7,CASSLTQGFYEQYF,1,0,1,1
TRBV5-1,TRBJ2-7,CASSLNAVFYEQYL,1,0,1,1
TRBV5-1,TRBJ2-1,CASSSSGVASEQFF,1,0,1,1
TRBV5-1,TRBJ2-1,CASSLENSYNEQFF,1,0,1,1
TRBV5-1,TRBJ2-5,CASSPQGPRETQYF,1,0,1,1
TRBV4-1,TRBJ2-4,CASSPKPHWDIQYF,1,0,1,1
TRBV5-1,TRBJ2-5,CASSRTGSAETQYF,1,0,1,1
TRBV4-1,TRBJ2-7,CASSHSPAGNEQYF,1,0,1,1
TRBV4-1,TRBJ2-7,CASSQQTGVYEQYF,1,0,1,1
TRBV4-1,TRBJ1-1,CASSQAGGGSEAFF,1,0,1,1
TRBV5-1,TRBJ1-1,CASSGLGGRAEAFF,1,0,1,1
TRBV5-1,TRBJ1-1,CASSSRGLGSEAFF,1,0,1,1
TRBV4-1,TRBJ2-5,CASSKGQAQETQYF,1,0,1,1
TRBV20-1,TRBJ2-7,CSAPEWGGSYEQYF,1,0,1,1
TRBV20-1,TRBJ1-5,CSAQDRIISGPQHY,1,0,1,1
TRBV20-1,TRBJ1-5,CSAIGQGGNQPQHF,1,0,1,1
TRBV20-1,TRBJ2-1,CSATYYSSYNEQFF,1,0,1,1
TRBV20-1,TRBJ2-1,CSARLAGGIDEQFF,1,0,1,1
TRBV20-1,TRBJ1-5,CSARGGSQVQPQHF,1,0,1,1
TRBV20-1,TRBJ1-4,CSARGAANNEKLFF,1,0,1,1
TRBV20-1,TRBJ1-5,CSARGGGSNQPQHF,1,0,1,1
TRBV20-1,TRBJ1-4,CSARGREGWEKLFF,1,0,1,1
TRBV20-1,TRBJ1-1,CSARDEFPGFEAYF,1,0,1,1
TRBV20-1,TRBJ2-3,CSASLPGVTDTQYF,1,0,1,1
TRBV20-1,TRBJ1-5,CSAQGGTANQPQHF,1,0,1,1
TRBV29-1,TRBJ1-2,CSVLLAGGGYGYTF,1,0,1,1
TRBV29-1,TRBJ2-1,CSVLHRVSYNEQFF,1,0,1,1
TRBV29-1,TRBJ1-1,CSVGDRESNTEAFF,1,0,1,1
TRBV29-1,TRBJ2-5,CSVDLAGGPETQYF,1,0,1,1
TRBV29-1,TRBJ2-1,CSVEDPYHGNEQFF,1,0,1,1
TRBV29-1,TRBJ2-3,CSVEESDKADTQYF,1,0,1,1
TRBV29-1,TRBJ2-1,CSVITRQLYNEQFF,1,0,1,1
TRBV29-1,TRBJ1-5,CSVDMTDSNQPQHF,1,0,1,1
TRBV29-1,TRBJ2-5,CSVEGQPIGETQYF,1,0,1,1
TRBV29-1,TRBJ1-2,CSAVYRGRDYGYTF,1,0,1,1
TRBV29-1,TRBJ2-2,CSAEIQGNPGELFF,1,0,1,1
TRBV29-1,TRBJ2-7,CSIQRSGDSYEQYF,1,0,1,1
TRBV5-1,TRBJ1-1,WASSYLGGSTEAFF,1,0,1,1
TRBV12-5,TRBJ1-1,CASGLHVNTEAFF,1,0,1,1
TRBV30,TRBJ2-5,CAWSVGGVETQYF,1,0,1,1
TRBV30,TRBJ1-2,CAWSVSFNYGYTF,1,0,1,1
TRBV30,TRBJ1-5,CAWSVQGNQPQHF,1,0,1,1
TRBV30,TRBJ2-7,CAWSVDNSYEQYF,1,0,1,1
TRBV30,TRBJ1-2,CAWSPSQVYGYTF,1,0,1,1
TRBV30,TRBJ2-1,CAWRNRGTNEQFF,1,0,1,1
TRBV30,TRBJ2-7,CAWNVVSSYEQYF,1,0,1,1
TRBV30,TRBJ2-5,CAWKVSGGGTQYF,1,0,1,1
TRBV10-3,TRBJ1-2,CAISENRSGAYTF,1,0,1,1
TRBV24-1,TRBJ1-4,CATAGGPDEKLFF,1,0,1,1
TRBV28,TRBJ1-5,CATQYRGNQPQHF,1,0,1,1
TRBV27,TRBJ1-2,CATGPGAPYGYTF,1,0,1,1
TRBV24-1,TRBJ2-3,CATSDFGTDTQYF,1,0,1,1
TRBV24-1,TRBJ1-5,CATSDFSGGPQHF,1,0,1,1
TRBV15,TRBJ1-3,CATSREGWSTIYF,1,0,1,1
TRBV10-3,TRBJ2-3,CATKGPGGNTQYF,1,0,1,1
TRBV19,TRBJ1-4,CASSSQGSEKLFF,1,0,1,1
TRBV19,TRBJ2-4,CASSSGRKNIQYF,1,1,2,2
TRBV19,TRBJ2-3,CASSSRLQDTQYF,1,0,1,1
TRBV19,TRBJ1-6,CASSRGLGSPLHF,1,0,1,1
TRBV19,TRBJ1-1,CASSVDRNTEAFF,1,0,1,1
TRBV19,TRBJ1-5,CASSINFGQPQHF,1,0,1,1
TRBV19,TRBJ2-3,CASSMVGTDTQYF,1,0,1,1
TRBV19,TRBJ1-2,CASSMRQAHGYTF,1,0,1,1
TRBV19,TRBJ1-1,CASSRDKNTEAFF,1,0,1,1
TRBV19,TRBJ2-5,CASSVTGTETQYF,1,0,1,1
TRBV18,TRBJ2-7,CASSEGQSYEQYF,1,0,1,1
TRBV18,TRBJ1-1,CASSLGTGNEAFF,1,0,1,1
TRBV18,TRBJ2-5,CASSPGVQETQYF,1,0,1,1
TRBV18,TRBJ2-5,CASSPPEGVTQYF,1,0,1,1
TRBV2,TRBJ1-1,CASQTAGGTEAFS,1,0,1,1
TRBV2,TRBJ1-1,CASARRGNTEAFY,1,0,1,1
TRBV6-2/3/5/6,TRBJ1-3,CASGTGGVNTIYL,1,0,1,1
TRBV12-3/4,TRBJ1-5,CASIDREGQPQHF,1,0,1,1
TRBV12-3/4,TRBJ2-7,CASMEGSGGEQYF,1,0,1,1
TRBV28,TRBJ1-3,CASTPETANTIYF,1,0,1,1
TRBV28,TRBJ1-2,CASTPQGSYGYTF,1,0,1,1
TRBV9,TRBJ2-7,CASTKDGMSEQYF,1,0,1,1
TRBV28,TRBJ2-5,CASSFLSLETQYF,1,0,1,1
TRBV12-3/4,TRBJ1-5,CASSFLGGQPQHF,1,0,1,1
TRBV12-3/4,TRBJ1-2,CASSFGGAQGYTF,1,0,1,1
TRBV6-2/3/5/6,TRBJ1-5,CASSFGSNQPQHF,1,0,1,1
TRBV27,TRBJ2-3,CASSLWGEDTQYF,1,0,1,1
TRBV6-2/3/5/6,TRBJ2-5,CASSLGSRETQYF,1,0,1,1
TRBV12-3/4,TRBJ1-1,CASSLAGGSTAFF,1,0,1,1
TRBV12-3/4,TRBJ1-5,CASSLSGNQPQHF,1,1,2,2
TRBV28,TRBJ1-1,CASSSPGDSEAFF,1,0,1,1
TRBV28,TRBJ2-7,CASSSGGLYEQYF,1,0,1,1
TRBV6-2/3/5/6,TRBJ2-7,CASSWITGPEQYF,2,0,1,2
TRBV6-2/3/5/6,TRBJ1-6,CASSYSRDSPLLF,1,0,1,1
TRBV28,TRBJ2-1,CASSLRSYNEQFF,1,0,1,1
TRBV3-1,TRBJ2-3,CASSPLATDTQYF,1,0,1,1
TRBV27,TRBJ1-5,CASSPGQAQPQHF,1,0,1,1
TRBV12-3/4,TRBJ2-1,CASSPDREYEQFF,1,0,1,1
TRBV12-3/4,TRBJ2-2,CASSRRGSGELFF,1,0,1,1
TRBV2,TRBJ2-5,CASSVRYQETQYF,1,0,1,1
TRBV6-1,TRBJ1-1,CASSALLLTEAFF,1,0,1,1
TRBV6-1,TRBJ1-1,CASSGLMNTEAFF,1,0,1,1
TRBV6-1,TRBJ1-5,CASSGEGNQPQHF,1,0,1,1
TRBV2,TRBJ2-3,CASSEYYTDTQYF,1,0,1,1
TRBV25-1,TRBJ2-3,CASSEQGTDTQYF,1,0,1,1
TRBV6-1,TRBJ1-6,CASSEGPGSPLHF,1,0,1,1
TRBV2,TRBJ1-1,CASSETSGTEAFF,1,0,1,1
TRBV2,TRBJ1-1,CASSERVFTEAFF,1,0,1,1
TRBV7-9,TRBJ2-5,CASSTGGAGTQYF,1,0,1,1
TRBV6-4,TRBJ1-1,CASSSRSNTEAFF,1,0,1,1
TRBV11-2,TRBJ1-5,CASSFRQNQPQHF,1,0,1,1
TRBV7-3,TRBJ2-5,CASSFQHQETQYF,1,0,1,1
TRBV5-5,TRBJ1-5,CASSLGGDQPQHF,1,0,1,1
TRBV5-4,TRBJ2-7,CASSLGLNYEQYF,1,0,1,1
TRBV5-4,TRBJ2-7,CASSLERPHEQYF,1,0,1,1
TRBV7-2,TRBJ2-5,CASSLLGQETQYF,1,0,1,1
TRBV7-3,TRBJ2-1,CASSLLLDNEQFF,1,0,1,1
TRBV7-9,TRBJ2-1,CASSLVGYREQFF,1,0,1,1
TRBV7-2,TRBJ1-2,CASSLAGDYGYTF,1,0,1,1
TRBV11-2,TRBJ2-4,CASSLGSKNIQYF,1,0,1,1
TRBV11-3,TRBJ2-1,CASSLGPWDREFF,1,0,1,1
TRBV7-3,TRBJ1-6,CASSLEWGSPLHF,1,0,1,1
TRBV7-9,TRBJ2-7,CASSLRGGYEQYF,1,0,1,1
TRBV7-3,TRBJ2-7,CASSLNPSFEQYF,1,0,1,1
TRBV7-2,TRBJ1-6,CASSSLIGSPLHF,1,0,1,1
TRBV6-2/3/5/6,TRBJ1-2,CASSLSETRSYTF,1,0,1,1
TRBV7-9,TRBJ1-1,CASSLLVGTEAFF,1,1,2,2
TRBV7-2,TRBJ1-5,CASSLGQGQPQHF,1,0,1,1
TRBV11-2,TRBJ2-5,CASSLDRGETQYF,1,0,1,1
TRBV7-3,TRBJ2-7,CASSPSGGYEQYF,1,0,1,1
TRBV12-3/4,TRBJ1-1,CASSPDRYTEAFF,1,0,1,1
TRBV7-3,TRBJ2-7,CASSPSGYGEQYF,1,0,1,1
TRBV7-3,TRBJ2-1,CASSPRQGNEQFF,1,0,1,1
TRBV7-2,TRBJ1-3,CASSPQVGNTIYF,1,0,1,1
TRBV11-2,TRBJ1-2,CASSPGFNYGYTF,1,0,1,1
TRBV7-9,TRBJ1-2,CASSPTAGVGYTF,1,0,1,1
TRBV3-1,TRBJ2-4,CASSRYGGDIQYF,1,0,1,1
TRBV7-9,TRBJ1-5,CASSRAGGQPQHF,1,0,1,1
TRBV7-9,TRBJ2-5,CASSHDSQETQYF,1,0,1,1
TRBV14,TRBJ2-5,CASSHLVQETQYF,1,0,1,1
TRBV3-1,TRBJ2-3,CASSHASADTQYF,1,0,1,1
TRBV28,TRBJ1-4,CASSQGWDEKLFF,1,0,1,1
TRBV3-1,TRBJ2-7,CASSQGDYYEQYF,1,0,1,1
TRBV14,TRBJ2-7,CASSQVTGSEQYF,1,0,1,1
TRBV3-1,TRBJ2-3,CASSQVAGNTQYF,1,0,1,1
TRBV3-1,TRBJ1-1,CASSQAGVPEAFF,1,0,1,1
TRBV14,TRBJ2-7,CASSQGRGVEQYF,1,0,1,1
TRBV14,TRBJ1-5,CASSQERFAPQHF,1,0,1,1
TRBV7-2,TRBJ2-1,CASSADSNNEQFF,1,0,1,1
TRBV7-9,TRBJ1-1,CASSTRANTEAFF,1,0,1,1
TRBV7-9,TRBJ1-2,CASSTRTGAGYTF,1,0,1,1
TRBV6-4,TRBJ2-6,CASRWTGANVLTF,1,0,1,1
TRBV27,TRBJ1-2,CASRPRGLYGYTF,1,0,1,1
TRBV2,TRBJ1-1,CASRTDRGAEAFF,1,0,1,1
TRBV6-2/3/5/6,TRBJ1-1,CASRRGSGTEAFF,1,0,1,1
TRBV12-3/4,TRBJ1-2,CASRLGQAGGCTF,1,0,1,1
TRBV7-9,TRBJ2-7,CASRPGTGYEQYF,1,0,1,1
TRBV6-2/3/5/6,TRBJ1-6,CASRRQVESPLHF,1,0,1,1
TRBV12-3/4,TRBJ2-1,CASRAGPPNEQFF,1,0,1,1
TRBV30,TRBJ2-3,CASEQGETDTQYF,1,0,1,1
TRBV5-1,TRBJ2-1,CASQPSTRDREFF,1,0,1,1
TRBV5-1,TRBJ1-1,CASVQSGDTEAFF,1,0,1,1
TRBV5-1,TRBJ2-1,CASMGVSYNEQFF,1,0,1,1
TRBV10-1,TRBJ2-1,CASSESGTETKVF,1,0,1,1
TRBV5-1,TRBJ2-3,CASSLSQLDTQYF,1,0,1,1
TRBV5-1,TRBJ1-1,CASSLVGGGEAFF,1,0,1,1
TRBV5-1,TRBJ1-5,CASSLDVDQPQHF,1,0,1,1
TRBV5-1,TRBJ2-1,CASSLDSYNEQFF,1,1,2,2
TRBV5-1,TRBJ2-7,CASSLTTGYEQYF,1,0,1,1
TRBV5-1,TRBJ2-7,CASSLLADYEQYF,1,0,1,1
TRBV5-1,TRBJ1-1,CASSLGQGAVAFF,1,0,1,1
TRBV5-1,TRBJ2-7,CASSLGTAYEQYF,1,0,1,1
TRBV5-1,TRBJ1-1,CASSPQGHTEAFF,1,0,1,1
TRBV4-1,TRBJ2-2,CASSPTQTGELFF,1,0,1,1
TRBV5-1,TRBJ1-1,CASSGGGGTEAFF,1,0,1,1
TRBV10-1,TRBJ2-1,CASSRGRLYEQFF,1,0,1,1
TRBV20-1,TRBJ2-5,CSVSGTGYETQYF,1,0,1,1
TRBV20-1,TRBJ2-1,CSALNDILDEQFF,1,0,1,1
TRBV20-1,TRBJ1-5,CSASGGTNQPQHF,1,0,1,1
TRBV20-1,TRBJ2-5,CSARSLTQETQYF,1,0,1,1
TRBV20-1,TRBJ2-3,CSARAPPSATQYF,1,0,1,1
TRBV20-1,TRBJ1-1,CSARAGTGSEAFF,1,0,1,1
TRBV20-1,TRBJ1-1,CSARGERARQTFF,1,0,1,1
TRBV20-1,TRBJ2-7,CSAKGTSDYEQYF,1,0,1,1
TRBV20-1,TRBJ2-3,CSARGGTADTQYF,1,0,1,1
TRBV20-1,TRBJ1-2,CSARPTANYGYTF,1,0,1,1
TRBV20-1,TRBJ2-7,CSAKPGAGDEQYF,1,0,1,1
TRBV29-1,TRBJ2-7,CSVAKGQPYEQYF,1,0,1,1
TRBV29-1,TRBJ2-7,CSVAKDMAYEQYF,1,0,1,1
TRBV29-1,TRBJ2-5,CSVAVGGQETQYF,1,0,1,1
TRBV29-1,TRBJ2-3,CSVDRGGTDTQYF,1,0,1,1
TRBV29-1,TRBJ2-7,CSVESPGSYEQYF,1,0,1,1
TRBV29-1,TRBJ2-2,CSVEVWWGGELFF,1,0,1,1
TRBV29-1,TRBJ2-7,CSVEEGTRFEQFL,1,0,1,1
TRBV29-1,TRBJ2-7,CSVEEGTRFEQYF,1,0,1,1
TRBV29-1,TRBJ2-3,CSVENNLTDTQYF,1,0,1,1
TRBV29-1,TRBJ2-7,CSVISADSYEQYS,1,0,1,1
TRBV29-1,TRBJ1-4,CSVAGSGNEKLFF,1,0,1,1
TRBV29-1,TRBJ2-7,CSVGTSGSYEQYF,1,0,1,1
TRBV29-1,TRBJ1-1,CSVATGGDTEAFF,1,0,1,1
TRBV29-1,TRBJ1-1,CSVAQGSNTEAFF,1,0,1,1
TRBV29-1,TRBJ2-1,CSVTGTGYNEQFF,1,0,1,1
TRBV29-1,TRBJ1-4,CSARRSTNEKLFF,1,0,1,1
TRBV29-1,TRBJ2-1,CSTSSGGDNEQFF,1,0,1,1
TRBV30,TRBJ2-7,CAWMPGQEKQYF,1,0,1,1
TRBV30,TRBJ1-1,CAWSQGSTEAFF,1,1,2,2
TRBV30,TRBJ2-7,CAWSWDTYEQYF,1,0,1,1
TRBV30,TRBJ1-5,CAWSLRRGAQHF,1,0,1,1
TRBV19,TRBJ2-3,CASSMGADTQHF,1,0,1,1
TRBV19,TRBJ2-3,CASSMEGDTQYF,1,0,1,1
TRBV19,TRBJ2-7,CASSREPSEQYF,1,0,1,1
TRBV19,TRBJ1-1,CASRQGATEAFF,1,0,1,1
TRBV6-2/3/5/6,TRBJ2-7,CASSWTGERQYF,1,0,1,1
TRBV18,TRBJ1-1,CASSPLRGEAFF,1,0,1,1
TRBV18,TRBJ2-7,CASSPGDYEEYF,1,0,1,1
TRBV2,TRBJ1-1,CASRGGNTEAFF,1,0,1,1
TRBV27,TRBJ2-7,CASRGDSYEQYF,1,0,1,1
TRBV19,TRBJ2-3,CASGTSTDTQYF,1,0,1,1
TRBV2,TRBJ1-2,CASIDVLGGYTF,1,0,1,1
TRBV2,TRBJ2-5,CASIGYQETQYF,1,0,1,1
TRBV28,TRBJ1-5,CASSLVGQPQHF,1,0,1,1
TRBV28,TRBJ1-5,CASSLLRQPQHF,1,0,1,1
TRBV28,TRBJ1-5,CASSLRVQPQHF,1,0,1,1
TRBV12-3/4,TRBJ1-5,CASSLAGLPQHF,1,0,1,1
TRBV12-3/4,TRBJ2-4,CASSLRGNIQYF,1,0,1,1
TRBV12-3/4,TRBJ2-5,CASSLKGETQYF,1,0,1,1
TRBV6-2/3/5/6,TRBJ2-7,CASSWTDYEQYF,1,0,1,1
TRBV6-2/3/5/6,TRBJ1-1,CASSYWQGEAFF,1,0,1,1
TRBV12-3/4,TRBJ2-7,CASSYGHDEQYF,1,0,1,1
TRBV6-2/3/5/6,TRBJ2-3,CASSQTTDTQYF,1,0,1,1
TRBV2,TRBJ2-2,CASSVGPGELFF,1,0,1,1
TRBV2,TRBJ2-5,CASSGGLETQYF,1,0,1,1
TRBV5-4,TRBJ2-3,CASSLDGVAQYF,1,0,1,1
TRBV7-9,TRBJ2-2,CASSLGPGELFF,1,0,1,1
TRBV7-9,TRBJ1-5,CASSLESQPQHF,1,0,1,1
TRBV7-9,TRBJ1-2,CASSLTEYGYTF,1,0,1,1
TRBV7-9,TRBJ1-1,CASSSSNTEAFF,1,0,1,1
TRBV11-2,TRBJ2-3,CASSWVTDTQYF,1,0,1,1
TRBV7-6,TRBJ1-2,CASSLMNYGYTF,1,0,1,1
TRBV12-3/4,TRBJ2-1,CASSLTGDEQFF,1,0,1,1
TRBV7-9,TRBJ1-2,CASSPSLDGYTF,1,0,1,1
TRBV3-1,TRBJ2-7,CASSQTLYEQYF,1,0,1,1
TRBV7-3,TRBJ2-3,CASSMVGDTQYF,1,0,1,1
TRBV7-9,TRBJ2-3,CASSSEGDTQYF,1,0,1,1
TRBV12-3/4,TRBJ2-7,CASSRDSYEQYL,1,0,1,1
TRBV2,TRBJ2-5,CASRPRQETQYF,1,1,2,2
TRBV6-2/3/5/6,TRBJ2-7,CASNQGAYEQYF,1,1,2,2
TRBV28,TRBJ1-1,CASKGVNTEAFF,1,0,1,1
TRBV5-1,TRBJ1-2,CASSLDNYGYTF,1,0,1,1
TRBV5-1,TRBJ2-5,CASSLEQETQYF,1,0,1,1
TRBV5-1,TRBJ2-3,CASSLGRDTQYF,1,0,1,1
TRBV4-1,TRBJ1-1,CASSQVSGSTFF,1,0,1,1
TRBV29-1,TRBJ1-1,CSLSLQNTEAFF,1,0,1,1
TRBV20-1,TRBJ2-7,CSALPGPYEQYF,1,0,1,1
TRBV20-1,TRBJ1-1,CSASSMGDEAFF,1,0,1,1
TRBV20-1,TRBJ2-7,CSARVGVYEQFF,1,0,1,1
TRBV20-1,TRBJ1-5,CSARDADQPQHF,1,0,1,1
TRBV20-1,TRBJ2-7,CSARIREGGQYF,1,0,1,1
TRBV20-1,TRBJ1-6,CSARQPNSPLHF,1,0,1,1
TRBV29-1,TRBJ2-5,CSLGDIQETQYF,1,0,1,1
TRBV29-1,TRBJ1-2,CSVVGRNYGYTF,1,0,1,1
TRBV29-1,TRBJ2-3,CSVARFGDTQYF,1,0,1,1
TRBV29-1,TRBJ1-1,CSVDQQNTEAFF,1,0,1,1
TRBV29-1,TRBJ2-2,CSVEATVGELFF,1,0,1,1
TRBV29-1,TRBJ1-4,CSVEDGNEKLFF,1,0,1,1
TRBV29-1,TRBJ1-2,CSVRQGAEGYTF,1,0,1,1
TRBV29-1,TRBJ2-5,CSVRTGEETQYF,1,0,1,1
TRBV29-1,TRBJ1-2,CSVSGQNYGYTF,1,0,1,1
TRBV12-3/4,TRBJ1-2,RASTFRAYGYTF,1,0,1,1
TRBV30,TRBJ1-1,CAWSAYTEAFF,1,0,1,1
TRBV19,TRBJ2-1,CASSNVNEQFF,2,0,1,2
TRBV28,TRBJ2-7,CASRDLYAQYF,1,0,1,1
TRBV12-3/4,TRBJ1-2,CASKERDGYTF,1,0,1,1
TRBV2,TRBJ1-1,CASTQGAAAFF,1,0,1,1
TRBV6-2/3/5/6,TRBJ2-5,CASSLQETQYF,1,0,1,1
TRBV28,TRBJ1-5,CASSSDQPQHF,1,0,1,1
TRBV2,TRBJ2-4,CASSEVTIQYF,1,0,1,1
TRBV2,TRBJ2-1,CASSEAEGMFF,1,0,1,1
TRBV5-5,TRBJ2-5,CASSFTETQYF,1,0,1,1
TRBV11-3,TRBJ2-1,CASSSAHEQFF,1,0,1,1
TRBV7-9,TRBJ2-7,CASSSGRSSAF,1,0,1,1
TRBV3-1,TRBJ2-7,CASSYRYEQYF,1,0,1,1
TRBV7-8,TRBJ2-5,CASSLKETQYF,1,1,2,2
TRBV6-2/3/5/6,TRBJ2-5,CASSVRETQYF,1,0,1,1
TRBV2,TRBJ2-3,CASRGADTQYF,1,0,1,1
TRBV6-2/3/5/6,TRBJ2-7,CASRNSYEQYF,1,0,1,1
TRBV12-3/4,TRBJ1-3,CASNLVDTIYF,1,0,1,1
TRBV5-1,TRBJ2-3,CATSRTDTQYF,1,0,1,1
TRBV5-1,TRBJ2-1,CASSFGDEQFF,1,0,1,1
TRBV4-1,TRBJ2-2,CASSQTGELFF,1,0,1,1
TRBV5-1,TRBJ2-1,CASSTGPEQFF,1,0,1,1
TRBV20-1,TRBJ2-1,CSASADHEQFF,1,0,1,1
TRBV29-1,TRBJ1-1,CSVRQNTEAFF,1,0,1,1
TRBV29-1,TRBJ2-2,CSVQDTGELFF,1,0,1,1
TRBV29-1,TRBJ2-1,CSVGGVNEQFF,1,0,1,1
TRBV29-1,TRBJ2-4,CSVEKGLFQYF,1,0,1,1
TRBV29-1,TRBJ2-1,CSAARTNEQFF,1,0,1,1
TRBV29-1,TRBJ1-1,CSAIQNTEAFF,1,0,1,1
TRBV29-1,TRBJ1-2,CSGRQGEGYTF,1,0,1,1
TRBV28,TRBJ2-1,CASWGHEQFF,1,0,1,1
TRBV2,TRBJ2-5,CASGEETQYF,1,0,1,1
TRBV20-1,TRBJ1-2,CSAHSRGYTF,1,0,1,1
TRBV29-1,TRBJ1-1,CSVDPEAFF,1,0,1,1
TRBV15,TRBJ1-1,CATSSPMGQAGNTEAFF,1,0,1,1
TRBV18,TRBJ2-3,CASSALLAGSNADTQYF,1,0,1,1
TRBV14,TRBJ2-1,CASGRTVWQGPYNEQFF,1,0,1,1
TRBV11-2,TRBJ2-3,CASSLGGAGARIDTQYF,1,0,1,1
TRBV4-1,TRBJ1-2,CASSQDPGTGKNYGYTF,1,0,1,1
TRBV5-1,TRBJ1-1,CASRALQVSWVYTEAFF,1,0,1,1
TRBV18,TRBJ2-3,CASSSERDSSTGTQYF,1,0,1,1
TRBV5-6,TRBJ1-2,CASSSVLVPGGYGYTF,1,0,1,1
TRBV5-1,TRBJ2-7,CASSLALTGGTYEQYF,1,0,1,1
TRBV20-1,TRBJ2-7,CSALSTSAVVGYEQYF,1,0,1,1
TRBV5-4,TRBJ1-4,CASSLQQGEEEKLFF,1,0,1,1
TRBV7-9,TRBJ2-6,CASSSPVSGANVLTF,1,0,1,1
TRBV7-3,TRBJ2-1,CASSEAGGLYNELFF,1,0,1,1
TRBV5-1,TRBJ2-2,CASSLGSVITGELFF,1,0,1,1
TRBV4-1,TRBJ1-1,CASSHLTEVNTEAFF,1,0,1,1
TRBV29-1,TRBJ2-1,CGVSGPGPTYNEQFF,1,0,1,1
TRBV20-1,TRBJ1-3,CSARVDSSGNTIYF,1,0,1,1
TRBV9,TRBJ2-2,SASERQNTGELFF,1,0,1,1
TRBV7-8,TRBJ1-5,CASSLSRNQPQHF,1,0,1,1
TRBV12-3/4,TRBJ2-7,CAISLVGWGEQYF,2,0,1,2
TRBV18,TRBJ2-5,CASSRGVQETQYF,2,0,1,2
TRBV7-9,TRBJ2-5,CASSFSSQETQYF,1,0,1,1
TRBV20-1,TRBJ2-1,CSASSLLNEQFF,1,0,1,1
TRBV29-1,TRBJ2-5,CTTFGFSVPGHSSETRVLKETQYF,1,0,1,1
TRBV12-3/4,TRBJ2-1,CASSSIWAPASGGEGYTYEQFF,1,0,1,1
TRBV28,TRBJ2-3,CASSLELPRAYNKGIGTDTQYF,1,0,1,1
TRBV14,TRBJ2-1,CASSQDISGTGYSLSYNEQFF,1,0,1,1
TRBV6-2/3/5/6,TRBJ1-5,CASSLRLGQGWLLFNQPQHF,1,0,1,1
TRBV2,TRBJ1-2,CASSASQGASVNLLNYGYTF,1,0,1,1
TRBV6-1,TRBJ1-2,CASSGSGGIKDPFSNYGYTF,1,0,1,1
TRBV5-6,TRBJ2-3,CASSLRAASGGAGFTDTQYF,1,0,1,1
TRBV3-1,TRBJ2-3,CASSHLGLAGSGAPTDTQYF,1,0,1,1
TRBV4-1,TRBJ2-6,CASSQDPREPRVPGANVLTF,1,0,1,1
TRBV30,TRBJ2-2,CAWSVRGGTGGRGTGELFS,1,0,1,1
TRBV10-3,TRBJ2-7,CAISEGGYGDRAIVGEQYF,1,0,1,1
TRBV19,TRBJ2-1,CASSKGASGQASSYNEQFF,1,0,1,1
TRBV2,TRBJ2-7,CASSYPGDRIIYLSYEQYF,1,0,1,1
TRBV12-3/4,TRBJ2-6,CASSLGLAGGPSGANVLTF,1,0,1,1
TRBV25-1,TRBJ2-1,CASSDPHGQRSQGGNEQFF,1,0,1,1
TRBV7-9,TRBJ1-4,CASSLGGFATSATNEKLFF,1,0,1,1
TRBV11-2,TRBJ2-1,CASSLDGSPGQGVYNEQFF,1,0,1,1
TRBV7-9,TRBJ2-6,CASSTTSQAGASGANVLTF,1,0,1,1
TRBV7-9,TRBJ2-6,CASSTRTSGGSSGANVLTF,1,0,1,1
TRBV15,TRBJ2-3,CATSRVGTAGGLIDTQYF,1,0,1,1
TRBV6-2/3/5/6,TRBJ2-1,CASSFLGVIGDTYNEQFF,1,0,1,1
TRBV12-3/4,TRBJ2-2,CASSPWIGGERNTGELFF,1,0,1,1
TRBV2,TRBJ2-5,CASSDGRLLAFFRETQYF,1,0,1,1
TRBV2,TRBJ2-5,CASSEAWLAGGQQETQYF,1,1,2,2
TRBV7-2,TRBJ1-5,CASSFLSTRDIPYQPQHF,1,0,1,1
TRBV5-4,TRBJ2-5,CASSFTSGGPTYQETQYF,1,0,1,1
TRBV7-2,TRBJ2-5,CASSLAIGSGGAQETQYF,1,0,1,1
TRBV7-9,TRBJ2-3,CASSLTSYRGRYTDTQYF,1,0,1,1
TRBV11-2,TRBJ2-6,CASSPRDSKLSGANVLTF,1,0,1,1
TRBV14,TRBJ2-1,CASSQDKRASGANNEQFL,1,0,1,1
TRBV4-2,TRBJ1-1,CASSQEVAGKLGNTEAFF,1,0,1,1
TRBV10-2,TRBJ1-1,CASSESTQTAGYRTEAFF,1,0,1,1
TRBV5-1,TRBJ1-1,CASSSSGVTGTGTSEAFF,1,0,1,1
TRBV5-1,TRBJ2-3,CASSPSRTSGGITDTQYF,1,1,2,2
TRBV20-1,TRBJ2-3,CSAGAGTSGGSLADTQYF,1,0,1,1
TRBV20-1,TRBJ2-1,CSARGPRTGGIFFNEQFF,1,0,1,1
TRBV20-1,TRBJ1-1,CSARDQVRVGGRATEAFF,1,0,1,1
TRBV7-9,TRBJ2-1,YASRAPGVPSLGWNEQFF,1,0,1,1
TRBV12-5,TRBJ2-1,CASGFHGGGGNYNEQFF,1,0,1,1
TRBV24-1,TRBJ2-2,CATSDPSGGLNTGELFF,1,0,1,1
TRBV19,TRBJ1-5,CASSMRGQGTDNQPQHF,1,0,1,1
TRBV18,TRBJ1-1,CASSPYPVGGANTEAFF,1,0,1,1
TRBV18,TRBJ2-5,CASSPVFAGQYQETQYF,1,0,1,1
TRBV5-6,TRBJ2-5,CASTRFAWNNGEETQYF,1,0,1,1
TRBV12-3/4,TRBJ2-7,CASSFPREGQGLNEQYF,1,0,1,1
TRBV28,TRBJ2-3,CASSLGQGVRGTDTQYF,1,0,1,1
TRBV28,TRBJ1-5,CASSLFLTGGRGQPQHF,1,0,1,1
TRBV12-3/4,TRBJ2-1,CASSLPGLAGDYNEQFF,1,0,1,1
TRBV6-2/3/5/6,TRBJ2-3,CASSLGLGGLISDTQYF,1,0,1,1
TRBV28,TRBJ1-5,CASSYQRRILGNQPQHF,1,0,1,1
TRBV28,TRBJ2-5,CASSPRLAGGPRETQYF,1,0,1,1
TRBV6-4,TRBJ1-5,CASSDPGTGGDNQPQHF,1,0,1,1
TRBV2,TRBJ1-1,CASSEVGGVIMNTEAFF,1,0,1,1
TRBV6-1,TRBJ1-6,CASSEAPGRLLLSPLHF,1,0,1,1
TRBV27,TRBJ2-3,CASSIDLPGPSTDTQYF,1,0,1,1
TRBV7-2,TRBJ2-6,CASSLALRFSGANVLTF,1,0,1,1
TRBV11-2,TRBJ1-6,CASSLDPWQGYNSPLHF,1,0,1,1
TRBV11-3,TRBJ2-1,CASSLEYLRGGDNEQFF,1,0,1,1
TRBV7-9,TRBJ1-4,CASSLIEGAVSNEKLFF,1,0,1,1
TRBV6-2/3/5/6,TRBJ2-1,CASSSVAGSGGAGEQFF,1,0,1,1
TRBV7-9,TRBJ2-5,CASSSRTSGGGEETQYF,1,0,1,1
TRBV7-6,TRBJ2-3,CASSSRKERGFTDTQYF,1,0,1,1
TRBV7-9,TRBJ1-6,CASSSTDYSSYNSPLHF,1,0,1,1
TRBV5-4,TRBJ2-2,CASSWRIDRTNTGELFF,1,0,1,1
TRBV12-3/4,TRBJ1-6,CASSPHTTGSFNSPLHF,1,0,1,1
TRBV7-8,TRBJ2-1,CASSPFTGTGNPNEQFF,1,0,1,1
TRBV9,TRBJ2-1,CASSPTFGGGGHNEQFF,1,0,1,1
TRBV7-2,TRBJ2-3,CASSRGMISRSTDTQYF,1,0,1,1
TRBV2,TRBJ1-3,CASSRGDSYSSGNTIYF,1,0,1,1
TRBV3-1,TRBJ2-3,CASSQPLGGGTTDTQYF,1,0,1,1
TRBV6-2/3/5/6,TRBJ1-5,CASSQHTPTYSNQPQHF,1,0,1,1
TRBV4-2,TRBJ2-3,CASSQRGPGSGTDTQYF,1,0,1,1
TRBV3-1,TRBJ2-3,CASSQRGRGARTDTQYF,1,0,1,1
TRBV3-1,TRBJ2-5,CASSQDGGTSGESTQYF,1,0,1,1
TRBV3-1,TRBJ2-1,CASSGASGGAPYNEQFF,1,0,1,1
TRBV6-2/3/5/6,TRBJ1-1,CASRAGTGAPMNTEAFF,1,0,1,1
TRBV2,TRBJ1-5,CASRRDRGFASNQPQHF,1,0,1,1
TRBV7-8,TRBJ2-3,CASRQQPWGGNTDTQYF,1,0,1,1
TRBV5-1,TRBJ2-7,CASSLARLGQGSYEQYF,1,0,1,1
TRBV5-1,TRBJ2-7,CASSLAPGTSETYEQYF,1,0,1,1
TRBV5-1,TRBJ2-3,CASSLGDQGTREDTQYF,1,0,1,1
TRBV5-1,TRBJ2-4,CASSLEGSLLAKNIQYF,1,0,1,1
TRBV5-1,TRBJ2-3,CASSSRTSGSFTDTQYF,1,0,1,1
TRBV4-1,TRBJ1-5,CASSPTGDSGSNQPQHF,1,0,1,1
TRBV4-1,TRBJ2-1,CASSQVSGGELYNEQFF,1,0,1,1
TRBV4-1,TRBJ2-7,CASSQGNGVLAGSEQYF,1,0,1,1
TRBV4-1,TRBJ1-1,CASSQDFIGQRDWGAFF,1,0,1,1
TRBV4-1,TRBJ2-3,CASSQEVRGGGGDTQYF,1,0,1,1
TRBV4-1,TRBJ1-6,CASSQRGQSSYNSPLHF,1,0,1,1
TRBV20-1,TRBJ1-6,CSARRTGEVYNNSPLHF,1,1,2,2
TRBV20-1,TRBJ1-2,CSARDFVRVIGVPGYTF,1,0,1,1
TRBV29-1,TRBJ2-7,CSVELLEVEQGIYEQYF,1,0,1,1
TRBV29-1,TRBJ1-5,CSVEGSVGGTQNQPQHF,1,0,1,1
TRBV29-1,TRBJ1-1,CSVGEDRGSSSIAEAFF,1,0,1,1
TRBV7-2,TRBJ1-2,SASSLSVGGQGAHGYTF,1,0,1,1
TRBV7-2,TRBJ1-1,CACSLGQGGRRTEAFF,1,0,1,1
TRBV30,TRBJ1-6,CAWSVYSGQDNSPLHF,1,0,1,1
TRBV18,TRBJ1-2,CAGSPVGPQGKYGYTF,1,0,1,1
TRBV10-3,TRBJ1-6,CAISESGQGGNSPLHF,1,0,1,1
TRBV10-3,TRBJ2-7,CAISESGQGGTYEQYF,1,0,1,1
TRBV2,TRBJ2-1,CATQEGRLAGLGEQFF,1,0,1,1
TRBV24-1,TRBJ2-3,CATSAGRGVRTDTQYF,1,0,1,1
TRBV24-1,TRBJ2-6,CATSDGGSSGANVLTF,1,0,1,1
TRBV15,TRBJ2-7,CATSRDLSQVSYEQYF,1,0,1,1
TRBV27,TRBJ2-3,CASEERRAGATDTQYF,1,0,1,1
TRBV19,TRBJ1-5,CASSITTGGGNQPQHF,1,0,1,1
TRBV19,TRBJ1-1,CASSIPGRYVNTEAFF,1,0,1,1
TRBV19,TRBJ2-3,CASSIDSAALRDTQYF,1,0,1,1
TRBV19,TRBJ2-5,CASSMSVADIQETQYF,1,0,1,1
TRBV19,TRBJ2-7,CASSMGGGGVSYEQYF,1,0,1,1
TRBV19,TRBJ2-3,CASSMTSGGITDTQYF,1,2,2,3
TRBV19,TRBJ1-5,CASSTIRDRVIKPQHF,1,0,1,1
TRBV19,TRBJ1-5,CASSRGTGGNNQPQHF,1,0,1,1
TRBV19,TRBJ2-7,CASRPGLADADYEQYF,1,0,1,1
TRBV18,TRBJ2-3,CASSLSPRGATDTQYF,1,0,1,1
TRBV18,TRBJ2-5,CASSPPWTGGGETQYF,1,0,1,1
TRBV18,TRBJ2-4,CASSPAAGGVLNIQYF,1,0,1,1
TRBV18,TRBJ1-1,CASPPGTGRPATEAFF,1,0,1,1
TRBV19,TRBJ1-3,CASRIQGQEAGNTIYF,1,0,1,1
TRBV3-1,TRBJ2-1,CASTLAGGGSYNEQFF,1,0,1,1
TRBV12-3/4,TRBJ1-5,CASSFLRGVSNQPQHF,1,1,2,2
TRBV12-3/4,TRBJ2-6,CASSFALGAGANVLTF,1,0,1,1
TRBV12-3/4,TRBJ1-1,CASSFGTLVMNTEALF,1,0,1,1
TRBV6-2/3/5/6,TRBJ2-4,CASSFPPGIAKNIQYF,1,0,1,1
TRBV28,TRBJ2-2,CASSFRGGVGTGELFF,1,0,1,1
TRBV12-3/4,TRBJ2-1,CASSFGGGPVTNEQFF,1,0,1,1
TRBV28,TRBJ2-1,CASSLGGRGPYNEQFF,1,0,1,1
TRBV28,TRBJ1-5,CASSLGGGAIRQPQHF,1,0,1,1
TRBV27,TRBJ2-5,CASSLGTSGGGETQYF,1,0,1,1
TRBV6-2/3/5/6,TRBJ2-6,CASSLEMGSGANVLTF,1,0,1,1
TRBV28,TRBJ2-1,CASSLTPGQGENEQFF,1,0,1,1
TRBV28,TRBJ1-6,CASSSPGSRSNSPLHF,1,0,1,1
TRBV6-2/3/5/6,TRBJ1-5,CASSSHRVYRNQPQHF,1,0,1,1
TRBV2,TRBJ1-2,CASSSDRGQVGHGYTF,1,0,1,1
TRBV28,TRBJ2-7,CASSSPPGQPSYEQYF,1,0,1,1
TRBV6-2/3/5/6,TRBJ2-7,CASSYSLGLRTYEQYF,1,0,1,1
TRBV6-2/3/5/6,TRBJ2-7,CASSYRQGTPSYEQYF,1,0,1,1
TRBV6-2/3/5/6,TRBJ2-3,CASSYGGAWGTDTQYF,1,0,1,1
TRBV6-2/3/5/6,TRBJ2-2,CASSYDEGSGTGELFF,1,0,1,1
TRBV5-4,TRBJ1-1,CASSPIWGTGNTEAFF,1,0,1,1
TRBV6-1,TRBJ2-5,CASSATGTGGRETQYF,1,0,1,1
TRBV2,TRBJ2-1,CASSGNFRGGPNEQFF,1,0,1,1
TRBV28,TRBJ2-1,CASSGTSGGVYNEQFF,1,0,1,1
TRBV6-1,TRBJ1-5,CASSELVGRGNQPQHF,1,0,1,1
TRBV6-1,TRBJ1-2,CASSEAGVGGNYGYTF,1,0,1,1
TRBV11-2,TRBJ1-6,CASSFSPGQGDSPLHF,1,0,1,1
TRBV11-2,TRBJ2-1,CASSFLDSGGAHEQFF,1,0,1,1
TRBV13,TRBJ2-3,CASSFGTSGYTDTQYF,1,0,1,1
TRBV5-4,TRBJ2-3,CASSFGRDRNTDTQYF,1,0,1,1
TRBV5-5,TRBJ2-1,CASSFLSRGSTDEQFF,1,0,1,1
TRBV7-3,TRBJ2-2,CASSFPDLQGPGELFS,1,0,1,1
TRBV5-6,TRBJ2-7,CASSLPLGTATYEQYF,1,0,1,1
TRBV5-5,TRBJ2-1,CASSLRGLAAHNEQFF,1,0,1,1
TRBV5-6,TRBJ2-1,CASSLGMRMGGNEQFF,1,0,1,1
TRBV7-2,TRBJ2-7,CASSLDRGAIDYEQYF,1,0,1,1
TRBV5-5,TRBJ1-5,CASSLRDREGNQPQHF,1,0,1,1
TRBV7-3,TRBJ2-5,CASSLSAGTGQETQYF,1,0,1,1
TRBV7-3,TRBJ2-6,CASSLRRVSGVNVLTF,1,0,1,1
TRBV11-2,TRBJ2-6,CASSLVGLFGANVLTF,1,0,1,1
TRBV7-3,TRBJ2-1,CASSLVVGGGFNEQFF,1,0,1,1
TRBV7-2,TRBJ2-1,CASSLGAGLSYNEQFF,1,0,1,1
TRBV11-2,TRBJ2-3,CASSLDGLPGTDTQYF,1,0,1,1
TRBV11-2,TRBJ2-1,CASSLDLAGGQGEQFF,1,0,1,1
TRBV11-1,TRBJ2-1,CASSLDGGRGRNEQFF,1,0,1,1
TRBV7-9,TRBJ2-7,CASSSPPGLAGGEQYF,1,0,1,1
TRBV11-2,TRBJ2-7,CASSSRGGRTAYEQYF,1,0,1,1
TRBV7-9,TRBJ2-1,CASSSRQGVTYNEQFF,1,0,1,1
TRBV7-9,TRBJ1-2,CASSSNLHGKNYGYTF,1,0,1,1
TRBV7-9,TRBJ2-3,CASSSGLAGATDTQYF,1,0,1,1
TRBV5-6,TRBJ2-7,CASSWSSGPSSYEQYF,1,0,1,1
TRBV5-4,TRBJ2-3,CASSWGLGTSTDTQYF,1,0,1,1
TRBV7-9,TRBJ2-1,CASSLAGTKTYNEQFF,1,0,1,1
TRBV3-1,TRBJ2-7,CASSLSLAGMTYEQYF,1,0,1,1
TRBV6-2/3/5/6,TRBJ2-3,CASSLKRTRLTDTQYF,1,0,1,1
TRBV7-2,TRBJ1-4,CASSLGPAATNEKLFF,1,0,1,1
TRBV3-1,TRBJ2-5,CASSLLKGPAPETQYF,1,0,1,1
TRBV5-6,TRBJ2-1,CASSLKLAGGPNEQLF,1,0,1,1
TRBV6-2/3/5/6,TRBJ2-1,CASSPLGAGVDNEQFF,1,0,1,1
TRBV7-9,TRBJ2-7,CASSPLGLAGTRKQYF,1,0,1,1
TRBV12-3/4,TRBJ2-3,CASSPPAVSGGDTQYF,1,0,1,1
TRBV7-2,TRBJ2-1,CASSPPGLAVYNEQFF,1,0,1,1
TRBV5-4,TRBJ2-3,CASSPRTGKLTDTQYF,1,0,1,1
TRBV3-1,TRBJ2-6,CASSPGRGDGANVLTF,1,0,1,1
TRBV28,TRBJ2-7,CASSPPRADLAYEQYF,1,0,1,1
TRBV11-3,TRBJ2-1,CASSPAGAGAYNEQFF,1,0,1,1
TRBV5-4,TRBJ2-3,CASSPPQRRSTDTQYF,1,0,1,1
TRBV7-9,TRBJ2-3,CASSPARRGSTDTQYF,1,0,1,1
TRBV3-1,TRBJ2-7,CASSRSRDRVFYEQYF,1,0,1,1
TRBV12-3/4,TRBJ1-1,CASSRLPGQDNTEAFF,1,0,1,1
TRBV3-1,TRBJ2-5,CASSRGDRGHQGTQYF,1,0,1,1
TRBV6-2/3/5/6,TRBJ1-1,CASSRILQGARTEAFF,1,0,1,1
TRBV3-1,TRBJ2-3,CASSHSVGLATDTQYF,1,0,1,1
TRBV7-9,TRBJ2-5,CASSHLSGTVEETQYF,1,0,1,1
TRBV6-2/3/5/6,TRBJ2-3,CASSHRQGLWADTQYF,1,0,1,1
TRBV6-2/3/5/6,TRBJ2-3,CASSQPNRGGTDTQYF,1,0,1,1
TRBV6-2/3/5/6,TRBJ2-6,CASSQVTKTGANVLTF,1,0,1,1
TRBV3-1,TRBJ2-1,CASSQASLAGYNEQFF,1,0,1,1
TRBV4-2,TRBJ1-6,CASSQGVGATNSPLHF,1,0,1,1
TRBV9,TRBJ2-3,CASSVERAIRTDTQYF,1,0,1,1
TRBV9,TRBJ1-3,CASSVGAGLAGNTIYF,1,0,1,1
TRBV9,TRBJ1-1,CASSASPGTSNTEAFF,1,0,1,1
TRBV7-2,TRBJ1-4,CASSAGTIRTNEKLFF,1,0,1,1
TRBV7-3,TRBJ2-1,CASSMVVGGGYNEQFF,1,0,1,1
TRBV7-2,TRBJ2-3,CASSTRLAGGVDTQYF,1,0,1,1
TRBV2,TRBJ2-5,CASRVTGTGGRETQYF,1,0,1,1
TRBV28,TRBJ1-2,CASRIPTGGGGYGYTF,1,0,1,1
TRBV2,TRBJ1-1,CASRVPGQGQNTEAFF,1,1,2,2
TRBV12-3/4,TRBJ1-1,CASRGQGGRLLYEAFF,1,0,1,1
TRBV2,TRBJ2-5,CASRKGLAGEQETQYF,1,0,1,1
TRBV5-1,TRBJ2-1,CASGRTSGTNYNEQFF,1,0,1,1
TRBV10-1,TRBJ2-3,CASSESPGISTDTQYF,1,0,1,1
TRBV5-1,TRBJ2-1,CASSLVGLAGGNEQFF,1,0,1,1
TRBV5-1,TRBJ2-7,CASSLGSLALTYEQYF,1,0,1,1
TRBV5-1,TRBJ2-3,CASSLGSGSSTDTQYF,1,0,1,1
TRBV5-1,TRBJ1-4,CASSLDADRTNEKLFF,1,0,1,1
TRBV5-1,TRBJ2-3,CASSLERPDSTDTQYF,1,0,1,1
TRBV5-1,TRBJ1-2,CASSLEDRVAGYGYTF,1,0,1,1
TRBV5-1,TRBJ1-3,CASSLRTGSSGNTIYF,1,0,1,1
TRBV5-1,TRBJ1-2,CASSSAGEQTNYGYTF,1,0,1,1
TRBV5-1,TRBJ1-5,CASSLGDGYSNQPQHF,1,0,1,1
TRBV5-1,TRBJ1-2,CASSPWGTVGAYGYTF,1,0,1,1
TRBV4-1,TRBJ1-6,CASSPEFGGGNSPLHF,1,0,1,1
TRBV5-1,TRBJ1-4,CASSPTPGSPNEKLFF,1,0,1,1
TRBV5-1,TRBJ2-7,CASSPKSWTGTREQYF,1,0,1,1
TRBV4-1,TRBJ2-7,CASSRGQGAGSYEQYF,1,0,1,1
TRBV4-1,TRBJ2-1,CASSQTKRTGGNEQFF,1,0,1,1
TRBV4-1,TRBJ1-6,CASSQDLNRAGSPLHF,1,0,1,1
TRBV4-1,TRBJ2-3,CASSQDASSSTDTQYF,1,0,1,1
TRBV5-1,TRBJ2-1,CASSRGPGVSYNEQFF,1,0,1,1
TRBV5-1,TRBJ2-2,CASSRGQAANTGELFF,1,0,1,1
TRBV5-1,TRBJ2-5,CARSLSSGGTQETQYF,1,0,1,1
TRBV20-1,TRBJ2-3,CSAPRWTSGGTDTQYF,1,0,1,1
TRBV20-1,TRBJ1-6,CSARDGGSSYNSPLHF,1,0,1,1
TRBV20-1,TRBJ2-7,CSAREDWDAVIHEQYF,1,0,1,1
TRBV20-1,TRBJ2-3,CSASITSGGNTDTQYF,1,0,1,1
TRBV29-1,TRBJ2-3,CSVGSGGTIAADTQYF,1,0,1,1
TRBV29-1,TRBJ2-2,CSVEGTSGGNTGELFF,1,0,1,1
TRBV5-1,TRBJ2-3,SASSLGGTGPTDTQYF,1,0,1,1
TRBV3-1,TRBJ1-1,CASSPTTGQNTEAFF,1,0,1,1
TRBV30,TRBJ1-2,CAWSRIVSDGYGYTF,1,0,1,1
TRBV30,TRBJ2-3,CAWRRQGSGTDTQYF,1,0,1,1
TRBV6-2/3/5/6,TRBJ2-1,CAGSYSAAGDNEQFF,1,0,1,1
TRBV11-2,TRBJ2-7,CAGSLLLAGFGEQYF,1,0,1,1
TRBV10-3,TRBJ2-3,CAISVQGGPTDTQYF,1,0,1,1
TRBV10-3,TRBJ2-7,CAISGAGTGNYEQYF,1,0,1,1
TRBV10-3,TRBJ1-5,CAISEGRNSNQPQHF,1,1,2,2
TRBV10-3,TRBJ1-6,CAIRAGGGESSPLHF,1,0,1,1
TRBV24-1,TRBJ2-7,CATPVRDRGVGEQYF,1,0,1,1
TRBV28,TRBJ2-5,CATGQGASGQETQYF,1,0,1,1
TRBV24-1,TRBJ2-5,CATSDAQAPRETQYF,1,0,1,1
TRBV12-3/4,TRBJ2-2,CATRGRSAVTGELFF,1,0,1,1
TRBV24-1,TRBJ2-2,CATRRTGENTGELFF,1,0,1,1
TRBV19,TRBJ2-7,CASSSLTGSSYEQYF,1,0,1,1
TRBV19,TRBJ1-5,CASTTRDGSNQPQHF,1,0,1,1
TRBV19,TRBJ2-3,CASSSNSGSTDTQYF,1,0,1,1
TRBV19,TRBJ1-2,CASSLRTGGGYGYTF,1,0,1,1
TRBV19,TRBJ2-6,CASSDGTPGANVLTF,1,0,1,1
TRBV19,TRBJ2-1,CASSIAGHNYNEQFF,1,0,1,1
TRBV19,TRBJ2-7,CASSINSGNPYEQYF,1,0,1,1
TRBV19,TRBJ1-2,CASSIGDVLNYGYTF,1,0,1,1
TRBV19,TRBJ1-5,CASSMADYSNQPQHF,1,0,1,1
TRBV19,TRBJ2-2,CASSMGGTDTGVLFF,1,0,1,1
TRBV19,TRBJ1-4,CASSSPRGNNEKLFF,1,0,1,1
TRBV19,TRBJ2-3,CASSGPGGSTDTQYF,1,0,1,1
TRBV18,TRBJ1-1,CASSPGQGMNTEAFF,1,0,1,1
TRBV18,TRBJ1-2,CASSPRQGGDYGYTF,1,0,1,1
TRBV18,TRBJ2-7,CASSPIAQGAYEQYF,1,0,1,1
TRBV18,TRBJ2-1,CASSPSSGNWNEQFF,1,0,1,1
TRBV18,TRBJ2-5,CASSPSGGIQETQYF,1,0,1,1
TRBV18,TRBJ1-1,CASSKDRALNTEAFF,1,0,1,1
TRBV11-2,TRBJ2-3,CASTRTGGSTDTQYF,1,0,1,1
TRBV12-3/4,TRBJ2-7,CASTEGPHTDYEQYF,1,0,1,1
TRBV18,TRBJ2-1,CASTPGLDTRNEQFF,1,0,1,1
TRBV6-2/3/5/6,TRBJ2-5,CASSFFTQGGEAQYF,1,0,1,1
TRBV12-3/4,TRBJ2-5,CASSFVGSGEETQYF,1,0,1,1
TRBV12-3/4,TRBJ1-4,CASSFRTGGYEKLFF,1,0,1,1
TRBV12-3/4,TRBJ1-5,CASSLAVSENQPQHF,1,0,1,1
TRBV6-2/3/5/6,TRBJ2-7,CASSLGLAGSYEQYF,1,0,1,1
TRBV6-2/3/5/6,TRBJ2-7,CASSLGDREDYEQYF,1,0,1,1
TRBV28,TRBJ2-7,CASSSPFSGVYEQYF,1,0,1,1
TRBV28,TRBJ2-3,CASSSSGGGTDTQYF,1,0,1,1
TRBV27,TRBJ1-6,CASSWSWGNGSPLHF,1,0,1,1
TRBV6-2/3/5/6,TRBJ2-3,CASSYGAGSTDTLYF,1,0,1,1
TRBV6-2/3/5/6,TRBJ2-6,CASSYGNSGANVLTF,1,0,1,1
TRBV6-2/3/5/6,TRBJ1-5,CASSLGQSSNQPQHF,1,0,1,1
TRBV28,TRBJ1-4,CASSPWGGLGEKLFF,1,0,1,1
TRBV6-2/3/5/6,TRBJ1-2,CASSPLTPRRGGYTF,1,0,1,1
TRBV12-3/4,TRBJ2-5,CASSPPVGGQETQYF,1,0,1,1
TRBV28,TRBJ2-2,CASSPIAPGVGELFF,1,0,1,1
TRBV6-2/3/5/6,TRBJ1-3,CASSPPRAAGNTIYF,1,0,1,1
TRBV28,TRBJ2-7,CASSPGISNHYEQYF,1,0,1,1
TRBV12-3/4,TRBJ2-3,CASSPGTGGSDTQYF,1,0,1,1
TRBV6-2/3/5/6,TRBJ2-7,CASSPMGGGWYEQYF,1,0,1,1
TRBV2,TRBJ2-5,CASSPGAMFKETQYF,1,0,1,1
TRBV28,TRBJ1-4,CASSRIGQGGEKLFF,1,0,1,1
TRBV12-3/4,TRBJ1-5,CASSRQGANNQPQHF,1,0,1,1
TRBV2,TRBJ2-1,CASSVSSGSYNEQFF,1,0,1,1
TRBV6-1,TRBJ1-4,CASSVGTGGHEKLFF,1,0,1,1
TRBV2,TRBJ1-1,CASSGVGDINTEAFF,1,0,1,1
TRBV7-8,TRBJ2-3,CASSGAGASTDTQYF,1,0,1,1
TRBV25-1,TRBJ1-2,CASSGDRGPVNGYTF,1,0,1,1
TRBV6-4,TRBJ2-1,CASSDSSGGANEQFF,1,0,1,1
TRBV2,TRBJ2-1,CASSDRQGGFNEQFF,1,0,1,1
TRBV25-1,TRBJ1-1,CASSEYWGRNTEAFF,1,0,1,1
TRBV2,TRBJ2-5,CASSEQGVRVETQYF,1,0,1,1
TRBV6-1,TRBJ1-5,CASSEVGISNQPQHF,1,0,1,1
TRBV11-3,TRBJ2-5,CASSFGSLADETQYF,1,0,1,1
TRBV7-9,TRBJ1-6,CASSFNGDSNSPLHF,1,0,1,1
TRBV5-6,TRBJ2-7,CASSFAPGEGYEQYF,1,0,1,1
TRBV3-1,TRBJ2-1,CASSFEGQAYNEQFF,1,0,1,1
TRBV5-5,TRBJ2-1,CASSLSESSYNEQFF,1,0,1,1
TRBV7-9,TRBJ1-3,CASSLGQVSGNTIYF,1,0,1,1
TRBV5-6,TRBJ2-7,CASSLGLAGDCEQYF,1,0,1,1
TRBV5-4,TRBJ2-2,CASSLEGGTTGELFF,1,0,1,1
TRBV7-2,TRBJ2-1,CASSLMLAGGTEQFF,1,2,2,3
TRBV13,TRBJ2-3,CASSLTSGSTDTQYF,1,0,1,1
TRBV5-5,TRBJ2-3,CASSLNGLITDTQYF,1,0,1,1
TRBV11-2,TRBJ1-6,CASSLFRGMNSPLHF,1,1,2,2
TRBV7-2,TRBJ2-2,CASSLYLAVTGELVF,1,0,1,1
TRBV7-8,TRBJ2-3,CASSLLVRATDTQYF,1,0,1,1
TRBV7-9,TRBJ2-3,CASSLVWASTDTQYF,1,0,1,1
TRBV7-9,TRBJ2-1,CASSLVSGRVNEQFF,1,0,1,1
TRBV7-2,TRBJ2-1,CASSLVTGGRYEQFF,1,0,1,1
TRBV7-6,TRBJ1-5,CASSLVSGGNQPQHF,1,0,1,1
TRBV7-9,TRBJ2-5,CASSLVSRGPETQYF,1,0,1,1
TRBV7-9,TRBJ2-7,CASSLASGRGMEQYF,1,0,1,1
TRBV7-9,TRBJ1-3,CASSLAQSSGNTIYF,1,0,1,1
TRBV7-2,TRBJ2-5,CASSLAGRQQETQYF,1,0,1,1
TRBV5-4,TRBJ2-1,CASSLAGGQYNEQFF,1,0,1,1
TRBV11-2,TRBJ1-4,CASSLAGDMDEKLFF,1,0,1,1
TRBV11-2,TRBJ2-5,CASSLGGGIGETQYF,1,0,1,1
TRBV7-9,TRBJ2-3,CASSLGWSGRDTQYF,1,0,1,1
TRBV7-2,TRBJ1-2,CASSLGGDANYGYTF,1,0,1,1
TRBV7-9,TRBJ1-1,CASSLGDPRGTEAFF,1,0,1,1
TRBV7-2,TRBJ2-3,CASSLGWLDTDTQYF,1,0,1,1
TRBV11-2,TRBJ2-5,CASSLDWARRETQYF,1,0,1,1
TRBV7-9,TRBJ1-2,CASSLELGQNYGYTF,1,0,1,1
TRBV11-1,TRBJ2-1,CASSLERSSYNEQFF,1,0,1,1
TRBV7-3,TRBJ2-5,CASSLIGTGQETQYF,1,0,1,1
TRBV11-3,TRBJ2-2,CASSLMGGDTGEPFF,1,0,1,1
TRBV7-9,TRBJ1-3,CASSLTEISGNTIYF,1,0,1,1
TRBV7-9,TRBJ2-7,CASSLTGQLTYEQYF,1,0,1,1
TRBV7-3,TRBJ2-6,CASSLRNSGANVLTF,1,0,1,1
TRBV7-9,TRBJ2-2,CASSLNSAGAGELFF,1,0,1,1
TRBV5-4,TRBJ2-5,CASSSGTGFEETQYF,1,0,1,1
TRBV7-9,TRBJ2-1,CASSSMTGEDNEQFF,1,0,1,1
TRBV7-9,TRBJ1-2,CASSSLQGIGYGYTF,1,0,1,1
TRBV11-2,TRBJ1-1,CASSSYYTANTEAFF,1,0,1,1
TRBV7-9,TRBJ2-7,CASSSPLGGTYEQYF,1,0,1,1
TRBV7-9,TRBJ2-1,CASSSGRSAYNEQFF,1,0,1,1
TRBV7-2,TRBJ2-3,CASSWREPPGDTQYF,1,0,1,1
TRBV5-6,TRBJ2-3,CASSWGTPTTDTQYF,1,0,1,1
TRBV11-2,TRBJ1-1,CASSWRTGQNTEAFF,1,0,1,1
TRBV7-9,TRBJ2-1,CASSYWDRPYNEQFF,1,0,1,1
TRBV7-9,TRBJ2-5,CASSYGLAGEETQYF,1,0,1,1
TRBV7-2,TRBJ2-1,CASSLTRGVGNEQFF,1,0,1,1
TRBV14,TRBJ1-1,CASSLLVGGSTEAFF,1,0,1,1
TRBV3-1,TRBJ2-2,CASSLQGAGTGELFF,1,0,1,1
TRBV4-2,TRBJ2-7,CASSLTTGGQYEQYF,1,0,1,1
TRBV7-2,TRBJ2-3,CASSPWTSRTDTRYF,1,0,1,1
TRBV7-9,TRBJ1-1,CASSPRGGREAEAFF,1,0,1,1
TRBV11-2,TRBJ2-2,CASSPRGANTGELFF,1,0,1,1
TRBV14,TRBJ2-2,CASSPGTSFVGELFF,1,0,1,1
TRBV6-2/3/5/6,TRBJ2-1,CASSPGTSGGNEQFF,1,0,1,1
TRBV7-9,TRBJ2-2,CASSPGTGNTGELFF,1,0,1,1
TRBV5-4,TRBJ2-3,CASSPDMSSTDTQYF,1,0,1,1
TRBV7-2,TRBJ2-3,CASSPNGVGTDTQYL,1,0,1,1
TRBV7-3,TRBJ1-2,CASSPGGLNNYGYTF,1,0,1,1
TRBV5-4,TRBJ2-5,CASSPGIVERKTQYF,1,0,1,1
TRBV7-2,TRBJ2-7,CASSPGQVATYEQYF,1,0,1,1
TRBV12-3/4,TRBJ1-1,CASSPFGGLNTEAFF,1,0,1,1
TRBV7-8,TRBJ2-5,CASSPGTGLAETQYF,1,0,1,1
TRBV7-2,TRBJ1-2,CASSRTGGTNYGYTF,1,0,1,1
TRBV7-3,TRBJ2-2,CASSRDSSNTGELFF,1,0,1,1
TRBV5-4,TRBJ2-3,CASSRGLADTDTQYF,1,0,1,1
TRBV5-4,TRBJ2-1,CASSHSRQGPNEQFF,1,0,1,1
TRBV5-6,TRBJ1-5,CASSHRGGSNQPQHF,1,0,1,1
TRBV14,TRBJ1-3,CASSQFSRAGNTIYF,1,0,1,1
TRBV14,TRBJ1-3,CASSQLWGSGNTIYF,1,0,1,1
TRBV7-8,TRBJ2-1,CASSQPQRGHNEQFF,1,0,1,1
TRBV7-3,TRBJ2-3,CASSQPGGATDTQYF,1,0,1,1
TRBV3-1,TRBJ1-2,CASSQPYPAYYGYTF,1,0,1,1
TRBV3-1,TRBJ1-1,CASSQAFSEGTEAFF,1,0,1,1
TRBV3-1,TRBJ1-1,CASSQADRQNTEAFF,1,0,1,1
TRBV5-5,TRBJ2-3,CASSQAGGPIDTQYF,1,0,1,1
TRBV3-1,TRBJ1-5,CASSQAGQGNQPQHF,1,0,1,1
TRBV3-1,TRBJ1-5,CASSQGTRGNQPQHF,1,0,1,1
TRBV7-6,TRBJ2-3,CASSQGLLDTDTQYF,1,0,1,1
TRBV3-1,TRBJ2-7,CASSQDLGLGYEQYF,1,0,1,1
TRBV3-1,TRBJ2-3,CASSQKGAGTDTQYF,1,0,1,1
TRBV9,TRBJ1-2,CASSVGRGDGYGYTF,1,0,1,1
TRBV2,TRBJ2-4,CASSVSGGPQNIQYF,1,0,1,1
TRBV9,TRBJ2-3,CASSVSGVRQDTQYF,1,0,1,1
TRBV9,TRBJ2-1,CASSVAGVNWDEQFF,1,0,1,1
TRBV7-2,TRBJ1-2,CASSAHTGTNYGYTF,1,0,1,1
TRBV9,TRBJ2-6,CASSGDYSGANVLTF,1,0,1,1
TRBV5-4,TRBJ2-7,CASSDPTLSANEQYF,1,0,1,1
TRBV5-4,TRBJ2-7,CASSDDIESTYEQYF,1,0,1,1
TRBV5-4,TRBJ2-7,CASSTDRATFYEQYF,1,0,1,1
TRBV7-3,TRBJ2-1,CASSTGLAGVNEQFF,1,0,1,1
TRBV7-9,TRBJ2-3,CASSSLGQATDTQYF,1,0,1,1
TRBV6-2/3/5/6,TRBJ2-3,CASSKTSGGADTQYF,1,0,1,1
TRBV12-3/4,TRBJ2-5,CASSKNGQNQETQYF,1,0,1,1
TRBV12-3/4,TRBJ2-5,CASRLAEGHRETQYF,1,0,1,1
TRBV6-2/3/5/6,TRBJ1-1,CASRSWTFPGPEAFF,1,0,1,1
TRBV28,TRBJ2-3,CASRPTGYNTDTQYF,1,0,1,1
TRBV5-6,TRBJ1-2,CASRQIRTSNYGYTF,1,0,1,1
TRBV28,TRBJ2-1,CASRGPGQGRDEQFF,1,0,1,1
TRBV6-4,TRBJ2-1,CASRGDRYSYNEQFF,1,0,1,1
TRBV12-3/4,TRBJ2-1,CASRMDGDSYNEQFF,1,0,1,1
TRBV5-4,TRBJ2-7,CASRLGLGAGGEQYF,1,0,1,1
TRBV6-2/3/5/6,TRBJ2-1,CASRLAGGPGNERFF,1,0,1,1
TRBV6-2/3/5/6,TRBJ1-4,CASRREAGPDEKLFF,1,0,1,1
TRBV2,TRBJ1-3,CASNGPPLSGSTIYF,1,0,1,1
TRBV6-4,TRBJ2-7,CASKLTGTPSYEQYF,1,0,1,1
TRBV11-2,TRBJ2-2,CANSFLQWGTGELFF,1,0,1,1
TRBV28,TRBJ1-1,CANSFRTSGNTEAFF,1,0,1,1
TRBV7-2,TRBJ1-2,CTSSLVMAGSYGYTF,1,0,1,1
TRBV5-1,TRBJ2-7,CAGTLNGGPSYEQYF,1,0,1,1
TRBV18,TRBJ1-6,CASSRDGNGNSPLHF,1,0,1,1
TRBV5-1,TRBJ2-1,CASHFDRGSYNEQFF,1,0,1,1
TRBV4-1,TRBJ1-4,CASTKEGQGAGKLFF,1,0,1,1
TRBV5-1,TRBJ2-3,CASSSFGGATDTQYF,1,0,1,1
TRBV5-1,TRBJ1-2,CASSSSVAQGTGYTF,1,0,1,1
TRBV10-1,TRBJ2-7,CASSESEANPYEQYF,1,0,1,1
TRBV5-1,TRBJ2-7,CASSFYSGPTYEQYF,1,0,1,1
TRBV5-1,TRBJ2-3,CASSFAGRGTDTQYF,1,0,1,1
TRBV5-1,TRBJ2-2,CASSFATGGTGELFF,1,0,1,1
TRBV5-1,TRBJ1-1,CASSFTGVGNTEAFF,1,0,1,1
TRBV5-1,TRBJ1-6,CASSLFSVQNSPLHF,1,0,1,1
TRBV5-1,TRBJ2-4,CASSLSSRQENIQYF,1,0,1,1
TRBV5-1,TRBJ1-5,CASSLSGYSNQPQHF,1,0,1,1
TRBV5-1,TRBJ1-5,CASSLVGHPNQPQHF,1,0,1,1
TRBV5-1,TRBJ2-5,CASSLVTSGDGTQYF,1,0,1,1
TRBV5-1,TRBJ2-3,CASSLVMGATDTQYF,1,0,1,1
TRBV5-1,TRBJ2-1,CASSLAGVFGGEQFF,1,0,1,1
TRBV5-1,TRBJ1-1,CASSLGGQVNTEAFF,1,0,1,1
TRBV5-1,TRBJ2-7,CASSLGSGANYEQYF,1,0,1,1
TRBV5-1,TRBJ2-1,CASSLGQRTYNEQFF,1,0,1,1
TRBV5-1,TRBJ2-1,CASSLDGESYNEQFF,1,0,1,1
TRBV5-1,TRBJ2-2,CASSLETGRTGELFF,1,0,1,1
TRBV5-1,TRBJ2-7,CASSLSRGIPYEQYF,1,0,1,1
TRBV5-1,TRBJ1-6,CASSLTDRRGSPLHF,1,0,1,1
TRBV5-1,TRBJ2-5,CASSSSSGGGETQYF,1,0,1,1
TRBV5-1,TRBJ2-3,CASSSGQYSTDTQYF,1,0,1,1
TRBV5-1,TRBJ2-4,CASSWAAGAKNIQYF,1,0,1,1
TRBV10-2,TRBJ1-2,CASSYRGEGLYGYTF,1,0,1,1
TRBV5-1,TRBJ1-6,CASSYGQWRDSPLHF,1,0,1,1
TRBV5-1,TRBJ2-5,CASSLGLAVQETQYF,1,0,1,1
TRBV5-1,TRBJ2-6,CASSPGVAGANVLTF,1,0,1,1
TRBV5-1,TRBJ2-1,CASSPGQGYHNEQFF,1,0,1,1
TRBV5-1,TRBJ2-3,CASSRADRETDTQYF,1,0,1,1
TRBV5-1,TRBJ2-3,CASSQGDGSTDTQYF,1,0,1,1
TRBV4-1,TRBJ2-1,CASSQSAPSANEQFF,1,0,1,1
TRBV4-1,TRBJ1-5,CASSQVFISNQPQHF,1,0,1,1
TRBV4-1,TRBJ1-5,CASSQGGQGNQPQHF,1,0,1,1
TRBV4-1,TRBJ1-4,CASSQDPGGWAKLFF,1,0,1,1
TRBV4-1,TRBJ1-5,CASSQDRGSNQPQHF,1,0,1,1
TRBV4-1,TRBJ2-7,CASSQEGQGTYEQYF,1,0,1,1
TRBV5-1,TRBJ2-3,CASSTGTPTTDTQYF,1,0,1,1
TRBV5-1,TRBJ2-5,CASSTGVNIEETQYF,1,0,1,1
TRBV5-1,TRBJ1-6,CASSRIGQGNSPLHF,1,0,1,1
TRBV5-1,TRBJ1-1,CASSKGQGRSPEAFF,1,0,1,1
TRBV5-1,TRBJ2-2,CASRAVLSLTGELFF,1,0,1,1
TRBV5-1,TRBJ2-1,CASRERTGLYNEQFF,1,0,1,1
TRBV20-1,TRBJ1-1,CSAPDPGEGATEAFF,1,0,1,1
TRBV20-1,TRBJ2-5,CSAGVENRDFGTQYF,1,0,1,1
TRBV20-1,TRBJ2-1,CSADLTGGPYNEQFF,1,0,1,1
TRBV20-1,TRBJ2-1,CSASLWGRSYNEQFF,1,0,1,1
TRBV20-1,TRBJ2-2,CSASPLIANTGELFF,1,0,1,1
TRBV20-1,TRBJ1-6,CSASGTGVNNSPLHL,1,0,1,1
TRBV20-1,TRBJ2-1,CSARGLAGYNNEQFF,1,0,1,1
TRBV20-1,TRBJ2-2,CSARKGGRVDGELFF,1,0,1,1
TRBV20-1,TRBJ2-1,CSAFSGQGAGDEQFF,1,0,1,1
TRBV20-1,TRBJ1-1,CSGEGGGISNTEAFF,1,0,1,1
TRBV29-1,TRBJ2-2,CSVGQPGQGTGELFF,1,0,1,1
TRBV29-1,TRBJ2-7,CSVEWVGTGSHEQYF,1,0,1,1
TRBV29-1,TRBJ2-1,CSAESVTSSYNEQFF,1,0,1,1
TRBV5-5,TRBJ2-1,GASSLFLAVYNEQFF,1,0,1,1
TRBV7-4,TRBJ2-6,GASSLAPSGANVLTF,1,0,1,1
TRBV19,TRBJ1-1,CASEDSRGDTEAFF,1,0,1,1
TRBV30,TRBJ2-7,CAWASGGGSYEQYF,1,0,1,1
TRBV30,TRBJ1-3,CAWMAASSGNTIYF,1,0,1,1
TRBV30,TRBJ1-5,CAWSPGGSNQPQHF,1,0,1,1
TRBV30,TRBJ1-4,CAWSRGPGGEKLFF,1,0,1,1
TRBV30,TRBJ2-3,CAWSVRGVGDTQYF,1,0,1,1
TRBV30,TRBJ2-5,CAWSARGFRGTQYF,1,0,1,1
TRBV30,TRBJ2-1,CAWSEMDRDNEQFF,1,0,1,1
TRBV30,TRBJ2-2,CAWKRLAITGELFF,1,0,1,1
TRBV30,TRBJ2-3,CAWKRGQGLDTQYF,1,0,1,1
TRBV2,TRBJ2-1,CAGPPGSSYNEQFF,1,0,1,1
TRBV10-3,TRBJ2-7,CAISAIGSVYEQYF,1,0,1,1
TRBV10-3,TRBJ2-7,CAISELGGPYEQYF,1,0,1,1
TRBV10-3,TRBJ1-1,CAIRKQGRDTEAFF,1,0,1,1
TRBV24-1,TRBJ2-3,CATSDWLGTDTQYF,1,0,1,1
TRBV15,TRBJ2-7,CATSRGAGSHGQYF,1,0,1,1
TRBV19,TRBJ1-1,CASGQGGADTEAFF,1,0,1,1
TRBV19,TRBJ2-1,CASSSLAGDNEQFF,1,0,1,1
TRBV19,TRBJ1-5,CASSYRDSNQPQHF,1,0,1,1
TRBV19,TRBJ2-7,CASSDGAETYEQYF,1,0,1,1
TRBV19,TRBJ1-1,CASSIGGVYTEAFF,1,0,1,1
TRBV19,TRBJ1-6,CASSSRDRESPLHF,1,0,1,1
TRBV19,TRBJ2-3,CASRAGPSTDTQYF,1,0,1,1
TRBV19,TRBJ2-1,CASRNYGGADEQFF,1,0,1,1
TRBV18,TRBJ2-7,CASSPGTVSYEQYF,1,0,1,1
TRBV18,TRBJ1-5,CASSPWTGDQPQHF,1,0,1,1
TRBV18,TRBJ1-1,CASSPGQGAAEAFF,1,0,1,1
TRBV18,TRBJ2-5,CASSPTGHRETQYS,1,0,1,1
TRBV7-2,TRBJ2-3,CASAPGGPSDTQYF,1,0,1,1
TRBV28,TRBJ2-1,CASGLSGLYNEQFF,1,0,1,1
TRBV18,TRBJ2-3,CASGGPVRTDTQYF,1,0,1,1
TRBV5-6,TRBJ2-3,CASGVGDLTDTQYF,1,0,1,1
TRBV28,TRBJ2-2,CASGDTGGPGSCFF,1,0,1,1
TRBV2,TRBJ2-1,CASDLAGGQGEQFF,1,0,1,1
TRBV27,TRBJ2-2,CASMLTEHTGELFF,1,0,1,1
TRBV12-3/4,TRBJ1-5,CASTQWGSNQPQHF,1,0,1,1
TRBV18,TRBJ2-2,CASTRTSGTGELFF,1,0,1,1
TRBV6-2/3/5/6,TRBJ1-5,CASSFAMQDQPQHF,1,0,1,1
TRBV6-2/3/5/6,TRBJ2-7,CASSFPPTSYEQYF,1,0,1,1
TRBV12-3/4,TRBJ2-3,CASSFVVNTDTQYF,1,1,2,2
TRBV6-2/3/5/6,TRBJ1-6,CASSFGQGVTPLHF,1,0,1,1
TRBV28,TRBJ1-4,CASSLGGSDEKLFF,1,0,1,1
TRBV28,TRBJ1-4,CASSLGGAGEKLFF,1,0,1,1
TRBV12-3/4,TRBJ2-5,CASSLVGPTRAQYF,1,0,1,1
TRBV28,TRBJ1-1,CASSLTVMNTEAFF,1,0,1,1
TRBV6-2/3/5/6,TRBJ2-7,CASSLRQVSYEQYF,1,0,1,1
TRBV28,TRBJ2-7,CASSLNRVMYEQYF,1,0,1,1
TRBV28,TRBJ2-3,CASSSADYTDTQYF,1,0,1,1
TRBV6-2/3/5/6,TRBJ2-5,CASSSWSEQETQYF,1,0,1,1
TRBV27,TRBJ1-3,CASSSDRAGNTIYF,1,0,1,1
TRBV6-2/3/5/6,TRBJ2-2,CASSSRSGTGELFF,1,0,1,1
TRBV6-2/3/5/6,TRBJ2-7,CASSSGTGAYEQYF,1,0,1,1
TRBV2,TRBJ1-2,CASSSGQLGYGYTF,1,0,1,1
TRBV27,TRBJ2-3,CASSWASGTDTQYF,1,0,1,1
TRBV6-2/3/5/6,TRBJ2-1,CASSYSEGYNEQFF,1,0,1,1
TRBV6-2/3/5/6,TRBJ2-1,CASSYSPNRVEQFF,1,0,1,1
TRBV6-2/3/5/6,TRBJ2-7,CASSYSGEGAEQYF,1,0,1,1
TRBV6-2/3/5/6,TRBJ1-1,CASSYSIGGTEAFF,1,0,1,1
TRBV6-2/3/5/6,TRBJ2-7,CASSLRDRSHEQYF,1,0,1,1
TRBV28,TRBJ1-5,CASSLHSSNQPQHF,1,0,1,1
TRBV28,TRBJ1-2,CASSPTGDGYGYTF,1,0,1,1
TRBV2,TRBJ2-5,CASSPRGFEETQYF,1,0,1,1
TRBV12-3/4,TRBJ1-1,CASSPGAGNTEAFF,1,0,1,1
TRBV6-2/3/5/6,TRBJ1-1,CASSRGWTSPEAFF,1,0,1,1
TRBV7-3,TRBJ2-7,CASSRTSGSYEQYF,1,0,1,1
TRBV6-1,TRBJ1-4,CASSQQGSNEKLFF,1,0,1,1
TRBV2,TRBJ2-7,CASSVTGGTYEQYF,1,0,1,1
TRBV2,TRBJ1-1,CASSAFGRETEAFF,1,0,1,1
TRBV6-4,TRBJ1-1,CASSDWTGITEAFF,1,0,1,1
TRBV2,TRBJ2-7,CASSEGRDFDEQYF,1,0,1,1
TRBV2,TRBJ1-2,CASSEFPGMNGYTF,1,0,1,1
TRBV6-1,TRBJ2-7,CASSEWGDNYEQYF,1,0,1,1
TRBV2,TRBJ1-6,CASSEGTGRSPLHF,1,0,1,1
TRBV6-1,TRBJ2-3,CASSERDSTDTQYF,1,0,1,1
TRBV6-2/3/5/6,TRBJ2-7,CASSTPGGTYEQYF,1,0,1,1
TRBV12-3/4,TRBJ1-4,CASSTHGVREKLFF,1,0,1,1
TRBV5-6,TRBJ1-3,CASSTGSSGNTIYF,1,0,1,1
TRBV6-2/3/5/6,TRBJ2-5,CASSRDYLLETQYF,1,0,1,1
TRBV7-9,TRBJ1-6,CASSFAGPRSPLHF,1,0,1,1
TRBV7-9,TRBJ1-2,CASSFDSTNYGYTF,1,0,1,1
TRBV7-2,TRBJ2-7,CASSFLAGSYEQYF,1,0,1,1
TRBV3-1,TRBJ1-1,CASSFPGGTTEAFF,1,0,1,1
TRBV5-6,TRBJ2-1,CASSFQTQSTEQFF,1,0,1,1
TRBV5-6,TRBJ1-1,CASSLVGDATEAFF,1,0,1,1
TRBV5-4,TRBJ2-3,CASSLDRVTDTHYF,1,0,1,1
TRBV7-3,TRBJ2-3,CASSLMGFTDTQYF,1,0,1,1
TRBV7-2,TRBJ2-7,CASSLWTSGGEQYF,1,0,1,1
TRBV7-9,TRBJ2-3,CASSLPGRADTQYF,1,0,1,1
TRBV7-9,TRBJ2-7,CASSLPQGFAEQYF,1,0,1,1
TRBV7-2,TRBJ2-7,CASSLVGGSYEQYF,1,0,1,1
TRBV7-2,TRBJ2-3,CASSLVASTDPQYF,1,0,1,1
TRBV7-2,TRBJ2-7,CASSLVAGPYEQYF,1,0,1,1
TRBV7-6,TRBJ2-7,CASSLGPQSYEQYF,1,0,1,1
TRBV11-3,TRBJ2-5,CASSLGDSERTQYF,1,0,1,1
TRBV7-9,TRBJ1-1,CASSLGDRGNEAFF,1,0,1,1
TRBV7-3,TRBJ2-3,CASSLIGPTDTQYF,1,0,1,1
TRBV7-3,TRBJ1-5,CASSLMAGNQPQHF,1,0,1,1
TRBV7-3,TRBJ2-5,CASSLTGIGETQYF,1,0,1,1
TRBV7-9,TRBJ2-3,CASSSYGTSDTQYF,1,0,1,1
TRBV5-4,TRBJ2-1,CASSSQGGGNEQFF,1,0,1,1
TRBV3-1,TRBJ1-1,CASSSGTVNTEAFF,1,0,1,1
TRBV7-9,TRBJ1-1,CASSSGSYNPEAFF,1,0,1,1
TRBV5-8,TRBJ2-1,CASSSGLLYNEQFF,1,0,1,1
TRBV7-9,TRBJ2-7,CASSSDRGTYEQYF,1,0,1,1
TRBV5-5,TRBJ1-1,CASSSTGVNTEAFF,1,0,1,1
TRBV7-2,TRBJ2-3,CASSWVRSTDTQYF,1,0,1,1
TRBV5-5,TRBJ2-4,CASSWGLAKNIQYF,1,0,1,1
TRBV7-2,TRBJ1-1,CASSLSGTATRAFF,1,0,1,1
TRBV7-2,TRBJ2-7,CASSLGTGNYEQYF,1,0,1,1
TRBV3-1,TRBJ2-7,CASSLGQASYEQYF,1,0,1,1
TRBV12-3/4,TRBJ2-7,CASSLHRDSYEQYF,1,0,1,1
TRBV7-9,TRBJ1-3,CASSPGQGGNTIYF,1,0,1,1
TRBV11-2,TRBJ2-5,CASSPRTGQETQYF,1,0,1,1
TRBV2,TRBJ2-7,CASSPAGSFYEQYF,1,0,1,1
TRBV7-3,TRBJ1-1,CASSPGDRDSEAFF,1,0,1,1
TRBV5-6,TRBJ2-5,CASSPMRGQETQYF,1,0,1,1
TRBV3-1,TRBJ2-5,CASSPTGGWETQYF,1,0,1,1
TRBV3-1,TRBJ2-7,CASSPRTGPYEQYF,1,0,1,1
TRBV27,TRBJ2-6,CASSPTEGANVLTF,1,0,1,1
TRBV11-2,TRBJ1-5,CASSPTSPGQPQHF,1,0,1,1
TRBV7-2,TRBJ1-1,CASSPLLGNTEAFF,1,0,1,1
TRBV7-3,TRBJ1-2,CASSPQGIGFGYTF,1,0,1,1
TRBV5-8,TRBJ1-5,CASSPTDSNQPQHF,1,0,1,1
TRBV7-3,TRBJ1-2,CASSRDRAQSGYTF,1,0,1,1
TRBV6-2/3/5/6,TRBJ2-3,CASSRTSSPDTQYF,1,0,1,1
TRBV28,TRBJ2-4,CASSRNLPRDIQYF,1,0,1,1
TRBV7-2,TRBJ1-5,CASSRQGLYQPQHF,1,0,1,1
TRBV3-1,TRBJ1-1,CASSHGTDGLEAFF,1,0,1,1
TRBV11-1,TRBJ2-2,CASSHRGNTGELFF,1,0,1,1
TRBV7-3,TRBJ2-5,CASSQGRFQETQYF,1,0,1,1
TRBV14,TRBJ1-1,CASSQYRVVTEAFF,1,0,1,1
TRBV16,TRBJ1-6,CASSQPNSNSPLHF,1,0,1,1
TRBV14,TRBJ1-2,CASSQVTGEYGYTF,1,0,1,1
TRBV3-1,TRBJ2-5,CASSQAPLQETQYF,1,0,1,1
TRBV3-1,TRBJ2-7,CASSQGPGAYEQYF,1,0,1,1
TRBV7-3,TRBJ2-3,CASSQGLAADTQYF,1,0,1,1
TRBV3-1,TRBJ2-1,CASSQDVNANEQFF,1,0,1,1
TRBV9,TRBJ2-1,CASSVLRGSNEQFF,1,0,1,1
TRBV9,TRBJ1-6,CASSVLSENSPLHF,1,0,1,1
TRBV9,TRBJ2-1,CASSVDTDYNEQFF,1,0,1,1
TRBV9,TRBJ1-5,CASSVESGSQPQHF,1,0,1,1
TRBV7-9,TRBJ2-5,CASSGSGGKETQYF,1,0,1,1
TRBV5-4,TRBJ2-1,CASSGGQTYNEQFF,1,0,1,1
TRBV7-2,TRBJ2-5,CASSDDISKETQYF,1,0,1,1
TRBV7-6,TRBJ2-3,CASSMGLAADTQYF,1,0,1,1
TRBV7-9,TRBJ2-2,CASSMGLGAGELFF,1,0,1,1
TRBV28,TRBJ2-7,CASSTQARLYEQYF,1,0,1,1
TRBV9,TRBJ1-1,CASSTQGFGTEAFF,1,0,1,1
TRBV6-2/3/5/6,TRBJ2-7,CASRRDRDHYEQYF,1,0,1,1
TRBV2,TRBJ1-5,CASRADIGNQPQHF,1,0,1,1
TRBV7-9,TRBJ2-7,CASREGTGSYEQYF,1,0,1,1
TRBV2,TRBJ2-7,CASRTGAQNYEQYF,1,0,1,1
TRBV6-2/3/5/6,TRBJ2-5,CASRWQGDQETQYF,1,0,1,1
TRBV6-2/3/5/6,TRBJ2-1,CASRVNRGAGEQFF,1,0,1,1
TRBV12-3/4,TRBJ1-1,CASRVTMENTEAFF,1,0,1,1
TRBV6-2/3/5/6,TRBJ2-7,CASRTARGPYEQYF,1,0,1,1
TRBV5-4,TRBJ2-3,CASNQGTHTDTQYF,1,0,1,1
TRBV2,TRBJ2-1,CASNRDLRYNEQFF,1,0,1,1
TRBV19,TRBJ2-7,CARSPWTGGYEQYF,1,0,1,1
TRBV28,TRBJ2-5,CGSNDIRVVETQYF,1,0,1,1
TRBV20-1,TRBJ2-5,CSVPGAGGQETQYF,1,0,1,1
TRBV5-1,TRBJ2-3,CASSPGQITDTQYF,1,0,1,1
TRBV10-2,TRBJ2-7,CASARGTSSYEQYF,1,0,1,1
TRBV5-1,TRBJ2-3,CASTSGQLLDTQYF,1,0,1,1
TRBV5-1,TRBJ2-2,CASSSGQNTGELFF,1,0,1,1
TRBV5-1,TRBJ2-7,CASSSGTGRYEQYF,1,0,1,1
TRBV12-3/4,TRBJ2-5,CASSSTGGQETQYF,1,0,1,1
TRBV5-1,TRBJ1-6,CASSLRETNSPLHF,1,0,1,1
TRBV5-1,TRBJ2-5,CASSLARGQETQYF,1,0,1,1
TRBV5-1,TRBJ2-1,CASSLALRHPEQFF,1,0,1,1
TRBV5-1,TRBJ1-2,CASSLGAAGQGYTF,1,0,1,1
TRBV5-1,TRBJ1-1,CASSLELTNTEAFF,1,0,1,1
TRBV5-1,TRBJ2-5,CASSLETGQETQYF,1,0,1,1
TRBV5-1,TRBJ2-3,CASSLIDNTDTQYF,1,0,1,1
TRBV5-1,TRBJ1-4,CASSSRTGEGKLFF,1,0,1,1
TRBV5-1,TRBJ1-6,CASSSRGGDEPLHF,1,0,1,1
TRBV5-1,TRBJ1-2,CASSSGTGTYGYTF,1,0,1,1
TRBV5-1,TRBJ2-7,CASSWRTGTYEQYF,1,0,1,1
TRBV5-1,TRBJ1-2,CASSYDGMDYGYTF,1,0,1,1
TRBV5-1,TRBJ2-3,CASSLRKSADTQYF,1,0,1,1
TRBV4-1,TRBJ1-1,CASSPRGAGTEAFF,1,0,1,1
TRBV4-1,TRBJ2-1,CASSPRTSYNEQFF,1,0,1,1
TRBV4-1,TRBJ2-7,CASSRVGKSYEQYF,1,0,1,1
TRBV5-1,TRBJ2-1,CASSQRGGYNEQFF,1,0,1,1
TRBV4-1,TRBJ2-7,CASSQAQGDYEQYF,1,0,1,1
TRBV4-1,TRBJ2-4,CASSQVSPIDIQYF,1,0,1,1
TRBV4-1,TRBJ2-3,CASSQETSADTQYF,1,0,1,1
TRBV4-1,TRBJ1-6,CASSQETAGSPLHF,1,0,1,1
TRBV5-1,TRBJ1-1,CASSTDAGVTEAFF,1,0,1,1
TRBV5-1,TRBJ1-1,CASSRQGEDTEAFF,1,0,1,1
TRBV5-1,TRBJ2-2,CASRYTSGPGELFF,1,0,1,1
TRBV5-1,TRBJ2-1,CASNAGNSYNEQFF,1,0,1,1
TRBV10-2,TRBJ2-3,CASKGTPSTDTQHF,1,0,1,1
TRBV29-1,TRBJ2-3,CTVATSGVVDTQYF,1,0,1,1
TRBV29-1,TRBJ2-7,CSVEIVGNPYEQYF,1,1,2,2
TRBV20-1,TRBJ1-4,CSASRVARGGKLFF,1,0,1,1
TRBV20-1,TRBJ2-7,CSAISPPGLYEQYF,1,0,1,1
TRBV20-1,TRBJ2-3,CSATGQGGSDTQYF,1,0,1,1
TRBV20-1,TRBJ2-7,CSASSNAYSYEQYF,1,0,1,1
TRBV20-1,TRBJ2-1,CSASRAGSNNEQLF,1,0,1,1
TRBV20-1,TRBJ1-4,CSASVGAGTEKLFF,1,0,1,1
TRBV20-1,TRBJ2-1,CSARTSEGANEQFF,1,0,1,1
TRBV20-1,TRBJ1-6,CSARQTGNNSPLHF,1,0,1,1
TRBV20-1,TRBJ1-1,CSARARRANTEAFF,1,0,1,1
TRBV20-1,TRBJ1-1,CSARGTGGDTEAFF,1,0,1,1
TRBV20-1,TRBJ1-2,CSARDTGGDYGYTF,1,0,1,1
TRBV20-1,TRBJ1-1,CSAREEVVGTEAFF,1,0,1,1
TRBV20-1,TRBJ2-7,CSAPRDRSSREQYF,1,0,1,1
TRBV20-1,TRBJ1-5,CSAARGGGNQPQHL,1,0,1,1
TRBV20-1,TRBJ2-5,CSAKAGVRQETQYF,1,0,1,1
TRBV20-1,TRBJ2-3,CSAAGQGGTDTQYF,1,0,1,1
TRBV29-1,TRBJ2-3,CSSRTGMGTDTQYF,1,0,1,1
TRBV29-1,TRBJ2-7,CSVARGGLSYEQYF,1,0,1,1
TRBV29-1,TRBJ2-2,CSVAGSGRTGELFF,1,0,1,1
TRBV29-1,TRBJ2-7,CSVGQDRGLYEQYF,1,0,1,1
TRBV29-1,TRBJ2-1,CSVGGLAGLGEQFF,1,0,1,1
TRBV29-1,TRBJ2-5,CSVEGRTPSETQYF,1,0,1,1
TRBV29-1,TRBJ2-1,CSVEAQGARNEQFF,1,0,1,1
TRBV29-1,TRBJ2-3,CSVRGTLATDTQYF,1,0,1,1
TRBV29-1,TRBJ2-5,CSVKGGVIQETQYF,1,0,1,1
TRBV29-1,TRBJ2-5,CSVKTGALGETQYF,1,0,1,1
TRBV29-1,TRBJ2-2,CSVSRQGGTGELLF,1,0,1,1
TRBV29-1,TRBJ2-7,CSVTTTGSPYEQYF,1,0,1,1
TRBV29-1,TRBJ2-2,CSVPGQGAAGELFF,1,0,1,1
TRBV29-1,TRBJ2-2,CSAGSGGATGELFL,1,0,1,1
TRBV29-1,TRBJ2-5,CSADWTGNQETQYF,1,0,1,1
TRBV29-1,TRBJ2-1,CSAEQDSGVNEQFF,1,0,1,1
TRBV29-1,TRBJ2-5,CSGKPGGASQTQYF,1,0,1,1
TRBV29-1,TRBJ2-3,CSTTSGDGTDTQYF,1,0,1,1
TRBV29-1,TRBJ1-2,RSVEVGQGNYGYTF,1,0,1,1
TRBV30,TRBJ1-2,CAWGSGGDYGYTF,1,0,1,1
TRBV30,TRBJ2-7,CAWGTGTRNEQYF,1,0,1,1
TRBV30,TRBJ1-1,CAWIPRESTEAFF,1,0,1,1
TRBV30,TRBJ2-7,CAWSVNEAYEQYF,1,0,1,1
TRBV30,TRBJ1-5,CAWSLREDQPQHF,1,0,1,1
TRBV30,TRBJ1-1,CAWRGQGRTEAFF,1,0,1,1
TRBV30,TRBJ2-2,CAWRLQRAGELFF,1,0,1,1
TRBV30,TRBJ1-5,CAWNAGGSQPQHF,1,0,1,1
TRBV30,TRBJ2-2,CAERGGLTGELFF,1,0,1,1
TRBV3-1,TRBJ2-5,CATASRGGETQYF,1,0,1,1
TRBV24-1,TRBJ2-3,CATSVRGSDTQYF,1,0,1,1
TRBV28,TRBJ1-1,CATYSGQNTEAFF,1,0,1,1
TRBV27,TRBJ2-5,CATRQGAHETQYF,1,0,1,1
TRBV2,TRBJ1-1,CASLQGAVTEAFF,1,0,1,1
TRBV19,TRBJ2-4,CASSIGPIDIQYF,1,0,1,1
TRBV19,TRBJ1-5,CASSIWSNQPQHF,1,0,1,1
TRBV19,TRBJ2-5,CASSTDREETQYF,1,0,1,1
TRBV19,TRBJ2-2,CASSSAVTGGLFF,1,0,1,1
TRBV19,TRBJ2-7,CASSIQGTYEQYF,1,0,1,1
TRBV18,TRBJ2-5,CASSPYTEETQYF,1,0,1,1
TRBV18,TRBJ2-3,CASSPIYTDTQYF,1,0,1,1
TRBV18,TRBJ1-5,CASSPNSGQPQHF,1,0,1,1
TRBV2,TRBJ2-2,CASSVASTGELFF,1,0,1,1
TRBV18,TRBJ1-2,CASPPQGADGYTF,1,0,1,1
TRBV12-3/4,TRBJ2-1,CASRGADYNEQFF,1,0,1,1
TRBV27,TRBJ2-5,CASRTGVGETQYF,1,0,1,1
TRBV6-4,TRBJ1-1,CASAPRGNTEAFF,1,0,1,1
TRBV9,TRBJ2-3,CASARVTTDTQYF,1,0,1,1
TRBV12-3/4,TRBJ2-5,CASGSGQQETQYF,1,0,1,1
TRBV28,TRBJ2-7,CASGDRVLYEQYF,1,0,1,1
TRBV27,TRBJ1-6,CASEGQLNSPLHF,1,0,1,1
TRBV6-2/3/5/6,TRBJ2-5,CASISSGGGTQYF,1,0,1,1
TRBV6-2/3/5/6,TRBJ1-3,CASTRTAGNTIYF,1,0,1,1
TRBV2,TRBJ1-1,CASTNLWGTEAFF,1,0,1,1
TRBV6-2/3/5/6,TRBJ1-1,CASSLGGRTEAFF,1,0,1,1
TRBV6-2/3/5/6,TRBJ1-5,CASSLDPNQPQHF,1,0,1,1
TRBV12-3/4,TRBJ2-2,CASSLREEGELFF,1,0,1,1
TRBV28,TRBJ1-1,CASSLAGARRAFF,1,0,1,1
TRBV12-3/4,TRBJ2-7,CASSLGQGVQQYF,1,0,1,1
TRBV28,TRBJ1-1,CASSLNFQLEAFF,1,0,1,1
TRBV12-3/4,TRBJ1-5,CASSSPGLQPQHF,1,0,1,1
TRBV2,TRBJ1-4,CASSSGSQEKLFL,1,0,1,1
TRBV6-2/3/5/6,TRBJ1-1,CASSYSLNTEAFF,1,0,1,1
TRBV12-3/4,TRBJ2-3,CASSPSGGDTQYF,1,0,1,1
TRBV12-3/4,TRBJ2-7,CASSPTISYEQYF,1,0,1,1
TRBV11-2,TRBJ2-3,CASSVVGTDTQYF,1,0,1,1
TRBV2,TRBJ2-7,CASSAWDRDEQYF,1,0,1,1
TRBV6-4,TRBJ1-1,CASSAYKNTEAFF,1,0,1,1
TRBV6-1,TRBJ1-3,CASSANNGNTIYF,1,0,1,1
TRBV7-9,TRBJ1-2,CASSGGSGYGYTF,1,0,1,1
TRBV6-4,TRBJ1-6,CASSDLPNSPLHF,1,0,1,1
TRBV6-1,TRBJ2-1,CASSEGTSNEQFF,1,0,1,1
TRBV6-1,TRBJ2-1,CASSKDRGNEQFF,1,0,1,1
TRBV7-9,TRBJ2-7,CASSFGRSSEQYF,1,0,1,1
TRBV7-8,TRBJ2-7,CASSFGTSYEQYF,1,0,1,1
TRBV7-9,TRBJ1-1,CASSFGQNTEAFF,1,0,1,1
TRBV5-4,TRBJ1-5,CASSLGRGQPQHF,1,0,1,1
TRBV5-4,TRBJ2-7,CASSLGGFYEQYF,1,0,1,1
TRBV7-3,TRBJ2-1,CASSLEGLAGGNF,1,0,1,1
TRBV7-9,TRBJ2-7,CASSLSLANEQYF,1,0,1,1
TRBV7-6,TRBJ2-3,CASSLVLADTQYF,1,0,1,1
TRBV7-6,TRBJ2-3,CASSLAGSDTQYF,1,0,1,1
TRBV7-6,TRBJ1-5,CASSLGVFQPQHF,1,0,1,1
TRBV5-6,TRBJ2-6,CASSLTGANVLTF,1,0,1,1
TRBV5-4,TRBJ2-3,CASSSLGPDTQYF,1,0,1,1
TRBV7-9,TRBJ2-7,CASSSTRGNEQYF,1,0,1,1
TRBV5-5,TRBJ2-7,CASSWPGADEQYF,1,0,1,1
TRBV7-3,TRBJ1-1,CASSLLVDTEAFF,1,0,1,1
TRBV7-9,TRBJ1-2,CASSLGTTYGYTF,1,0,1,1
TRBV7-2,TRBJ1-6,CASSLDTNSPLHF,1,0,1,1
TRBV9,TRBJ2-5,CASSPGPGETQYF,1,0,1,1
TRBV5-6,TRBJ2-7,CASSRDRGWEQYF,1,0,1,1
TRBV3-1,TRBJ2-1,CASSHAGFNEQFF,1,0,1,1
TRBV14,TRBJ1-1,CASSQYQNTEAFF,1,0,1,1
TRBV5-6,TRBJ2-7,CASSQRRQREQYF,1,0,1,1
TRBV3-1,TRBJ1-5,CASSQGGNQPQHF,1,0,1,1
TRBV3-1,TRBJ2-7,CASSQTGLDEQYF,1,0,1,1
TRBV9,TRBJ1-5,CASSVSVDQPQHF,1,0,1,1
TRBV6-4,TRBJ2-5,CASSVGAGKTQYF,1,0,1,1
TRBV7-9,TRBJ2-5,CASSADGRGTQYF,1,0,1,1
TRBV3-1,TRBJ1-6,CASSGVSNSPLHF,1,0,1,1
TRBV7-2,TRBJ2-1,CASSMDYYNEQFF,1,0,1,1
TRBV5-6,TRBJ2-4,CASSTGQGMGQYF,1,0,1,1
TRBV7-8,TRBJ2-1,CASSTDRYNEQFF,1,1,2,2
TRBV11-2,TRBJ1-1,CASSKVENTEAFF,1,0,1,1
TRBV28,TRBJ1-2,CASRGDSGNGYTF,1,0,1,1
TRBV7-9,TRBJ1-1,CASRGDRAYEAFF,1,0,1,1
TRBV3-1,TRBJ2-1,CASRGQGLNEQFF,1,0,1,1
TRBV28,TRBJ2-7,CASRDQGPYEQYF,1,0,1,1
TRBV6-4,TRBJ2-6,CASRDSGADVLTF,1,0,1,1
TRBV6-4,TRBJ1-1,CASRDSGNTEAFF,1,0,1,1
TRBV6-2/3/5/6,TRBJ2-1,CASRRTGEDEQFF,1,0,1,1
TRBV6-2/3/5/6,TRBJ2-3,CASRQGGSDTQYF,1,0,1,1
TRBV12-3/4,TRBJ1-5,CASRQGGHQPQHF,1,0,1,1
TRBV7-2,TRBJ2-1,CASRAVGVNEQFF,1,0,1,1
TRBV6-2/3/5/6,TRBJ1-2,CASNTGGGYGYTF,1,0,1,1
TRBV7-3,TRBJ1-1,CASNPRGDTEAFF,1,0,1,1
TRBV7-9,TRBJ2-1,CASNVGRNNEQFF,1,0,1,1
TRBV28,TRBJ2-1,CASNGALVDEQFS,1,0,1,1
TRBV7-9,TRBJ2-3,CASKGPSKDTQYF,1,0,1,1
TRBV12-3/4,TRBJ2-5,CGTAGTGKETQYF,1,0,1,1
TRBV29-1,TRBJ1-1,CCAREGARPEAFF,1,0,1,1
TRBV5-1,TRBJ1-5,CASSLEVNQPQHF,1,0,1,1
TRBV5-1,TRBJ1-1,CASSSQGNTEAFF,1,0,1,1
TRBV10-1,TRBJ2-5,CASSHPQAETQYF,1,0,1,1
TRBV4-1,TRBJ2-7,CASSQVLEYEQYF,1,0,1,1
TRBV5-1,TRBJ2-3,CASSAIRTDTQYF,1,0,1,1
TRBV4-1,TRBJ1-2,CASSGQGGYGYTF,1,0,1,1
TRBV5-1,TRBJ1-2,CASSMDRVGGYTF,1,0,1,1
TRBV5-1,TRBJ2-3,CASREPPADTQYF,1,0,1,1
TRBV10-1,TRBJ1-1,CASRTGRNTEAFF,1,0,1,1
TRBV29-1,TRBJ2-5,CGLRGGGLETQYF,1,0,1,1
TRBV20-1,TRBJ1-1,CSASKSGYTEAFF,1,0,1,1
TRBV20-1,TRBJ1-2,CSAGTGYNYGYTF,1,0,1,1
TRBV20-1,TRBJ1-5,CSAEGQSNQPQHF,1,1,2,2
TRBV20-1,TRBJ2-5,CSATDIVAETQYF,1,0,1,1
TRBV20-1,TRBJ2-7,CSASPISSYEQYF,1,0,1,1
TRBV20-1,TRBJ1-1,CSASRAANTEAFF,1,0,1,1
TRBV20-1,TRBJ2-5,CSARDGGRETQYF,1,0,1,1
TRBV20-1,TRBJ1-5,CSARDRGQQPQHF,1,0,1,1
TRBV20-1,TRBJ2-1,CSARRPGDYEQFF,1,0,1,1
TRBV20-1,TRBJ2-3,CSALQGTTDTQYF,1,0,1,1
TRBV20-1,TRBJ2-5,CSACPGAVETQYF,1,0,1,1
TRBV20-1,TRBJ2-5,CSATYRVSETQYF,1,0,1,1
TRBV29-1,TRBJ1-1,CSSEERADTEAFF,1,0,1,1
TRBV29-1,TRBJ1-1,CSLGGPMNTEAFF,1,0,1,1
TRBV29-1,TRBJ2-3,CSVRGTSTDTQYF,1,0,1,1
TRBV29-1,TRBJ2-5,CSVAPTGGETQYF,1,0,1,1
TRBV29-1,TRBJ2-7,CSVARQGTNEQYF,1,0,1,1
TRBV29-1,TRBJ1-2,CSVATVSGRGYTF,1,0,1,1
TRBV29-1,TRBJ1-1,CSVASQGETEAFF,1,0,1,1
TRBV29-1,TRBJ1-5,CSVAGDSNQPQHF,1,0,1,1
TRBV29-1,TRBJ2-7,CSVGAIETYEQYF,1,0,1,1
TRBV29-1,TRBJ1-2,CSVDVRQELGYTF,1,0,1,1
TRBV29-1,TRBJ1-4,CSVEITPGEKLFF,1,0,1,1
TRBV29-1,TRBJ2-1,CSVESMAYNEQFF,1,0,1,1
TRBV29-1,TRBJ2-7,CSVEVASAYEQYF,1,0,1,1
TRBV29-1,TRBJ1-5,CSVEEGANQPQHF,1,0,1,1
TRBV29-1,TRBJ1-5,CSVRTESNQPQHF,1,0,1,1
TRBV29-1,TRBJ2-7,CSVGLPGDGEQYF,1,0,1,1
TRBV29-1,TRBJ1-1,CSVERTGATEAFF,1,0,1,1
TRBV29-1,TRBJ2-3,CSVAITATDTQYF,1,0,1,1
TRBV29-1,TRBJ2-3,CSAGGGPGDTQYF,1,0,1,1
TRBV29-1,TRBJ2-1,CSARGAPYDEQFF,1,0,1,1
TRBV29-1,TRBJ1-1,CSAQNSLKTEAFF,1,0,1,1
TRBV29-1,TRBJ2-7,CSGGTSGAGEQYF,1,0,1,1
TRBV29-1,TRBJ2-2,CSGYLSEAGELFF,1,0,1,1
TRBV20-1,TRBJ2-3,CSSLGPNTDTQYF,1,0,1,1
TRBV28,TRBJ1-2,SASSYTGVYGYTF,1,0,1,1
TRBV30,TRBJ2-5,CASASGAETQYF,1,0,1,1
TRBV30,TRBJ2-5,CACQRDQETQYF,1,0,1,1
TRBV30,TRBJ1-2,CAWSAWNYGYTF,1,0,1,1
TRBV30,TRBJ1-1,CAWSRRGAEAFF,1,0,1,1
TRBV30,TRBJ1-2,CAWNQGNYGYTF,1,0,1,1
TRBV10-3,TRBJ2-3,CAIMDSTDTQYF,1,0,1,1
TRBV10-3,TRBJ1-4,CAISDKGEKLFF,1,0,1,1
TRBV28,TRBJ2-7,CASGVVSYEQYF,1,0,1,1
TRBV28,TRBJ1-6,CASSPGRSPLHF,1,0,1,1
TRBV18,TRBJ2-3,CASSMYLDTQYF,1,0,1,1
TRBV28,TRBJ2-7,CASAGDAYEQYF,1,0,1,1
TRBV7-9,TRBJ1-5,CASGTDNQPQHF,1,0,1,1
TRBV12-3/4,TRBJ2-7,CASTGETYEQYF,1,0,1,1
TRBV28,TRBJ2-3,CASSLRTDTQYF,1,0,1,1
TRBV28,TRBJ1-5,CASSLGNQPQHF,1,0,1,1
TRBV12-3/4,TRBJ2-3,CASSLTGDTQYF,1,0,1,1
TRBV6-2/3/5/6,TRBJ1-5,CASSLEVQPQHF,1,0,1,1
TRBV12-3/4,TRBJ1-1,CASSLMNTEAFF,1,0,1,1
TRBV6-2/3/5/6,TRBJ2-7,CASSSSRYEQYF,1,0,1,1
TRBV6-2/3/5/6,TRBJ2-3,CASSSSTDTQYF,1,0,1,1
TRBV27,TRBJ2-3,CASSSQSDTQYF,1,0,1,1
TRBV6-2/3/5/6,TRBJ2-7,CASSYPDGEQYF,1,0,1,1
TRBV27,TRBJ2-7,CASSPRPYEQYF,1,0,1,1
TRBV5-6,TRBJ2-1,CASSPDSNEQFF,1,0,1,1
TRBV6-2/3/5/6,TRBJ1-2,CASSQGRGGYTF,1,0,1,1
TRBV6-1,TRBJ1-2,CASSQLDRVDTF,1,0,1,1
TRBV6-1,TRBJ2-3,CASSGGEDTQYF,1,0,1,1
TRBV12-3/4,TRBJ1-1,CASSDGPHEAFF,1,0,1,1
TRBV2,TRBJ2-2,CASSELTGELFF,1,0,1,1
TRBV2,TRBJ2-5,CASSEGGETQYF,1,1,2,2
TRBV25-1,TRBJ2-3,CASSEGLPTQYI,1,0,1,1
TRBV6-1,TRBJ2-5,CASSETSGTQYF,1,0,1,1
TRBV9,TRBJ2-3,CASSTGTEAQYF,1,0,1,1
TRBV5-6,TRBJ2-7,CASSLLGYEQYF,1,0,1,1
TRBV7-3,TRBJ2-1,CASSLIRNEQLF,1,0,1,1
TRBV7-2,TRBJ1-2,CASSLMGLGYTF,1,0,1,1
TRBV5-6,TRBJ2-7,CASSLTIGEQYF,1,0,1,1
TRBV28,TRBJ2-1,CASSSWEFEQFF,1,0,1,1
TRBV5-4,TRBJ1-2,CASSSLDTRSTF,1,0,1,1
TRBV7-6,TRBJ2-3,CASSSSLGTQYF,1,0,1,1
TRBV5-4,TRBJ1-2,CASSWTGGGYTF,1,0,1,1
TRBV5-6,TRBJ2-7,CASSPGTYEQYF,1,0,1,1
TRBV3-1,TRBJ1-5,CASSRDSQPQHF,1,0,1,1
TRBV3-1,TRBJ2-2,CASSHTSGELFF,1,0,1,1
TRBV7-2,TRBJ2-1,CASSHGSNEQFF,1,0,1,1
TRBV3-1,TRBJ2-7,CASSHNSYEQYF,1,0,1,1
TRBV3-1,TRBJ2-5,CASSQLGETQYF,1,0,1,1
TRBV4-2,TRBJ2-5,CASSQETETQYF,1,0,1,1
TRBV3-1,TRBJ2-7,CASSQNLREQYF,1,0,1,1
TRBV9,TRBJ1-4,CASSGGGGKLFF,1,0,1,1
TRBV5-6,TRBJ2-7,CASSEGQSEQYF,1,0,1,1
TRBV12-3/4,TRBJ1-5,CASSNSLGPQHF,1,0,1,1
TRBV28,TRBJ1-6,CASRAPQSPLHF,1,0,1,1
TRBV28,TRBJ2-3,CASRGLADTQYF,1,0,1,1
TRBV6-2/3/5/6,TRBJ2-7,CASRTGGYEQYF,1,0,1,1
TRBV28,TRBJ1-4,CASRTGNEKLFF,1,0,1,1
TRBV6-2/3/5/6,TRBJ1-1,CASRQGDGEAFF,1,4,2,5
TRBV27,TRBJ2-7,CASNSHSYEQYF,1,0,1,1
TRBV2,TRBJ1-1,CASNPWAAEAFF,1,0,1,1
TRBV2,TRBJ1-2,CASNRADYGYTF,1,0,1,1
TRBV5-1,TRBJ1-1,CASRGDNTEAFF,1,0,1,1
TRBV5-1,TRBJ2-7,CASSFGGYEQYF,1,0,1,1
TRBV5-1,TRBJ2-3,CASSLLVDMQYF,1,0,1,1
TRBV5-1,TRBJ2-1,CASSLGYSEQFF,1,0,1,1
TRBV5-1,TRBJ1-1,CASSLDGTEAFF,1,0,1,1
TRBV20-1,TRBJ2-7,CSVERGDLEQYF,1,0,1,1
TRBV20-1,TRBJ1-5,CSASGQQGPQHF,1,0,1,1
TRBV20-1,TRBJ1-2,CSAAGSGYGYTF,1,0,1,1
TRBV20-1,TRBJ2-3,CSASLNTDTQYF,1,0,1,1
TRBV20-1,TRBJ1-5,CSASGGGQPQHF,1,0,1,1
TRBV20-1,TRBJ1-5,CSASVPLGPQHF,1,0,1,1
TRBV20-1,TRBJ1-1,CSARPKNTEAFF,1,0,1,1
TRBV20-1,TRBJ2-1,CSARQALGEQFF,1,1,2,2
TRBV20-1,TRBJ1-1,CSADRGNTEAFF,1,0,1,1
TRBV29-1,TRBJ1-2,CSVVLVFPGYTF,1,0,1,1
TRBV29-1,TRBJ2-7,CSVVDGSYEQYF,1,0,1,1
TRBV29-1,TRBJ1-2,CSVVTGYYGYTF,1,0,1,1
TRBV29-1,TRBJ2-7,CSVGGTVSEQYF,1,0,1,1
TRBV29-1,TRBJ1-1,CSVEAHDVKAFF,1,0,1,1
TRBV29-1,TRBJ1-3,CSVEDVGNTIYF,1,0,1,1
TRBV29-1,TRBJ1-1,CSVDREGTEAFF,1,0,1,1
TRBV29-1,TRBJ2-1,CSAGHQGNEQFF,1,0,1,1
TRBV29-1,TRBJ1-5,CSAGGGSQPQHF,1,0,1,1
TRBV29-1,TRBJ2-7,CSGYRVPHEQYF,1,0,1,1
TRBV3-1,TRBJ1-5,WASSQGGRHKNF,1,0,1,1
TRBV10-3,TRBJ2-7,CASADPYEQYF,1,0,1,1
TRBV30,TRBJ2-5,CAWGQQETQYF,1,0,1,1
TRBV30,TRBJ2-7,CAWSVQEEQYF,1,0,1,1
TRBV30,TRBJ1-2,CAWSVGVGYTF,1,0,1,1
TRBV30,TRBJ1-1,CARQKNTEAFF,1,0,1,1
TRBV10-3,TRBJ2-5,CAISERETQYF,1,0,1,1
TRBV15,TRBJ2-1,CATPLLLALFF,1,0,1,1
TRBV7-8,TRBJ1-1,CATATAAEAFF,1,0,1,1
TRBV19,TRBJ1-1,CASSDRWAAFF,1,0,1,1
TRBV19,TRBJ1-1,CASSIRIEAFF,1,0,1,1
TRBV28,TRBJ2-5,CASIKRETQYL,1,0,1,1
TRBV2,TRBJ2-7,CASTPGYEQYF,1,0,1,1
TRBV6-2/3/5/6,TRBJ2-1,CASSFHNEQFF,1,0,1,1
TRBV28,TRBJ1-1,CASSLNREAFF,1,0,1,1
TRBV2,TRBJ1-1,CASSRRTEAFF,1,0,1,1
TRBV5-6,TRBJ2-1,CASSFISEQFF,1,0,1,1
TRBV5-4,TRBJ2-1,CASSLYNEQFF,1,0,1,1
TRBV7-9,TRBJ2-7,CASSLEGEQYF,1,0,1,1
TRBV7-9,TRBJ2-7,CASSLRDMTYF,1,0,1,1
TRBV4-2,TRBJ2-1,CASSQDGGSHF,1,0,1,1
TRBV3-1,TRBJ2-7,CASSQEYEQYF,1,0,1,1
TRBV12-3/4,TRBJ2-5,CASSTKETQYF,1,0,1,1
TRBV3-1,TRBJ2-5,CASSSQETQYF,1,0,1,1
TRBV28,TRBJ2-3,CASSRTDTQYF,1,0,1,1
TRBV7-6,TRBJ2-7,CASKGWGEQYF,1,0,1,1
TRBV4-1,TRBJ1-4,CASSGMVGLFF,1,0,1,1
TRBV29-1,TRBJ1-1,CSVVAHTEAFF,1,0,1,1
TRBV29-1,TRBJ1-2,CSVAWIYGYTF,1,0,1,1
TRBV29-1,TRBJ2-3,CSVGPTDTQYF,1,0,1,1
TRBV29-1,TRBJ1-2,CSVEKGSGYTF,1,0,1,1
TRBV29-1,TRBJ2-7,CSAAESYEQYF,1,0,1,1
TRBV29-1,TRBJ2-7,CSAIIDNKQYF,1,0,1,1
TRBV29-1,TRBJ2-3,CSAGDPDTQYF,1,0,1,1
TRBV29-1,TRBJ1-2,CSAGQTYGYTF,1,0,1,1
TRBV29-1,TRBJ2-1,CSARGGGLQFF,1,0,1,1
TRBV6-2/3/5/6,TRBJ2-7,CASSPCEQYF,1,0,1,1
TRBV10-1,TRBJ2-7,CASSEFEQYF,1,0,1,1
TRBV27,TRBJ1-5,CASSFHSAEGTGGPTKGQPQHF,1,0,1,1
TRBV10-3,TRBJ2-1,CAISESIWILSSGGRLDEQFF,1,0,1,1
TRBV15,TRBJ1-1,CATSRDPPFQGAMKDGTEAFF,1,0,1,1
TRBV11-2,TRBJ2-3,CASSLDFSLGLAGIHTDTQYF,1,0,1,1
TRBV5-1,TRBJ2-6,CASSLANAPALSDSGANVLTF,1,0,1,1
TRBV6-2/3/5/6,TRBJ2-5,CASTFTRSDGRGLGGETQYF,1,0,1,1
TRBV5-5,TRBJ1-4,CASSLTPNLIQGDQPEKLFS,1,0,1,1
TRBV7-8,TRBJ2-6,CASSPRPRTGRISGANVLTF,1,0,1,1
TRBV7-9,TRBJ2-7,CASSGEEAREGTDSSYEQYF,1,0,1,1
TRBV15,TRBJ2-7,CATSRDGLTGGWKVYEQYF,1,0,1,1
TRBV19,TRBJ2-1,CASSSLEVGTGDSYNEQFF,1,0,1,1
TRBV6-1,TRBJ1-3,CASSARDRLPLDSGNTVYF,1,0,1,1
TRBV11-2,TRBJ2-1,CASSFPGTSGGAHRHEQFF,1,0,1,1
TRBV5-5,TRBJ1-5,CASSLGVGTGFYSNQPQLF,1,0,1,1
TRBV11-2,TRBJ2-7,CASSLTSGGYFRSSYEQYF,1,0,1,1
TRBV7-9,TRBJ2-1,CASSLVHKRGDYMSDEQFF,1,0,1,1
TRBV7-3,TRBJ1-1,CASSPTEQNVGPTNTEAFF,1,0,1,1
TRBV6-2/3/5/6,TRBJ2-6,CASSHIRGDYHSGANVLTF,1,0,1,1
TRBV4-2,TRBJ2-2,CASSQDRSRTGGRTGELFF,1,0,1,1
TRBV10-1,TRBJ2-7,CASSGDPGLAVFGTNEQCF,1,0,1,1
TRBV4-1,TRBJ2-4,CASSQEGRSGAGAKNTQYF,1,0,1,1
TRBV20-1,TRBJ1-5,CSATNYRDRGTYSNQPQHF,1,0,1,1
TRBV10-3,TRBJ2-3,CAISYGQGGGGSTDTQYF,1,0,1,1
TRBV19,TRBJ2-7,CASSSAGAKSPDSYEQYF,1,0,1,1
TRBV19,TRBJ2-2,CASSIPTSGGARPGVLFF,1,0,1,1
TRBV19,TRBJ2-2,CASKVHAGRVTNTGELFL,1,0,1,1
TRBV11-2,TRBJ2-3,CASSITSGVSTSTDTQYF,1,0,1,1
TRBV11-2,TRBJ2-4,CASTPFNDPKIAKNIQYF,1,0,1,1
TRBV28,TRBJ2-5,CASSLFGRTSGGRETQYF,1,0,1,1
TRBV6-2/3/5/6,TRBJ2-3,CASSSGLAGGPGTDTQYF,1,0,1,1
TRBV5-5,TRBJ2-5,CASSYYRDRVILQETQYF,1,0,1,1
TRBV28,TRBJ1-1,CASSPLIPYSALATEAFF,1,0,1,1
TRBV2,TRBJ1-4,CASSEVARGSGTNEKLFF,1,0,1,1
TRBV11-3,TRBJ2-1,CASSLVYSRGRVSNEQFF,1,0,1,1
TRBV7-9,TRBJ2-3,CASSLALTSGPSTDTQYF,1,0,1,1
TRBV7-6,TRBJ1-6,CASSLGFRDTTYNSPLHF,1,0,1,1
TRBV11-2,TRBJ2-3,CASSLDLGFGPATDTQYF,1,0,1,1
TRBV5-5,TRBJ1-5,CASSPGRNRYLGNQPQHF,1,0,1,1
TRBV7-9,TRBJ1-1,CASSPRYGEELMNTKAFF,1,0,1,1
TRBV5-4,TRBJ2-1,CASSPTSGGGRSINEQFF,1,0,1,1
TRBV7-3,TRBJ2-6,CASSPTVRGPSGANVLTF,1,0,1,1
TRBV9,TRBJ2-3,CASSPLGGTSEVTDTQYF,1,0,1,1
TRBV4-2,TRBJ2-2,CASSQFLAGGLYTGELFF,1,0,1,1
TRBV4-2,TRBJ1-4,CASSQVEFRGLANEKLFF,1,0,1,1
TRBV14,TRBJ2-1,CASSQEIGAGATYNEQFS,1,0,1,1
TRBV7-9,TRBJ2-5,CASSATSGTGVFRETQYF,1,0,1,1
TRBV9,TRBJ2-7,CASSEGTSGGGASYEQYF,1,0,1,1
TRBV12-3/4,TRBJ2-5,CASSLALASGGVGQTQYF,1,0,1,1
TRBV5-1,TRBJ2-2,CASSLDLVAGGLTGELFF,1,0,1,1
TRBV5-1,TRBJ1-6,CASSLEGTGRTYNSPLHF,1,0,1,1
TRBV5-1,TRBJ1-5,CASSPPTGNAGCNQPQHF,1,0,1,1
TRBV4-1,TRBJ1-6,CASSRGGQGLRYNSPLHF,1,0,1,1
TRBV5-1,TRBJ1-2,CASSGVPISGAAADGYTF,1,0,1,1
TRBV20-1,TRBJ2-3,CSAPRYSISFVHTDTQYF,1,1,2,2
TRBV20-1,TRBJ2-7,CSASGWSQRGYASYEQYF,1,0,1,1
TRBV20-1,TRBJ2-1,CSARSGLAGSFPYNEQFF,1,0,1,1
TRBV20-1,TRBJ2-5,CSARAGLAGATYQETQYF,1,0,1,1
TRBV29-1,TRBJ2-1,CSVEGSGGPLWSYNEQFF,1,0,1,1
TRBV10-3,TRBJ2-7,CAISGAGTSGGGYEQYF,1,0,1,1
TRBV10-3,TRBJ1-4,CAISESTLDKQPGKLFF,1,0,1,1
TRBV19,TRBJ2-6,CASSIGQGLSGANVLTF,1,0,1,1
TRBV19,TRBJ1-5,CASSIEVWTGANQPQHF,1,0,1,1
TRBV19,TRBJ1-5,CASSTLTGRGINQPQHF,1,0,1,1
TRBV12-3/4,TRBJ1-6,CASCLAFPGSYNSPLHF,1,0,1,1
TRBV27,TRBJ2-3,CASYHKVSISSTDTQYF,1,0,1,1
TRBV11-2,TRBJ1-3,CASGGTRGGPSGNTIYF,1,0,1,1
TRBV28,TRBJ1-2,CASTKPGTGSINYGYTF,1,0,1,1
TRBV27,TRBJ1-2,CASSLSIGPHTNYGYTF,1,2,2,3
TRBV28,TRBJ1-5,CASSLYTGGRSSQPQHF,1,0,1,1
TRBV6-2/3/5/6,TRBJ2-7,CASSLVGRERRDYELYF,1,0,1,1
TRBV6-2/3/5/6,TRBJ2-3,CASSWITAGELTDTQYF,1,0,1,1
TRBV6-2/3/5/6,TRBJ2-7,CASSPTLPPAGTREQYF,1,0,1,1
TRBV2,TRBJ1-3,CASSDARTIGSGNTIYF,1,0,1,1
TRBV2,TRBJ2-5,CASSERPRTSSLETQYF,1,0,1,1
TRBV6-1,TRBJ1-5,CASSEDWAGTVNQPQHF,1,0,1,1
TRBV5-8,TRBJ2-5,CASSFSFGEGPQETQYF,1,0,1,1
TRBV11-2,TRBJ2-1,CASSFSTSGGKDHEQFF,1,0,1,1
TRBV7-2,TRBJ2-5,CASSFQTSGGFQETQYF,1,0,1,1
TRBV7-9,TRBJ2-1,CASSFTRAVSSYNEQFF,1,0,1,1
TRBV5-6,TRBJ2-4,CASSLVGTSGTKNIQYF,1,0,1,1
TRBV5-6,TRBJ1-5,CASSLNLGTYSNQPQHF,1,0,1,1
TRBV5-6,TRBJ2-2,CASSLLYSVPNTGELFS,1,0,1,1
TRBV7-9,TRBJ1-5,CASSLPGDLGLQQPQHF,1,0,1,1
TRBV7-9,TRBJ2-7,CASSLGGGRGPLYEQYF,1,0,1,1
TRBV7-8,TRBJ2-1,CASSLDVVGGRNIEQFF,1,0,1,1
TRBV7-3,TRBJ2-2,CASSLTSGGGVAGELFF,1,0,1,1
TRBV7-9,TRBJ2-3,CASSSAPGLTQGDTQYF,1,0,1,1
TRBV28,TRBJ2-3,CASSSGTSGGATDTQYF,1,0,1,1
TRBV3-1,TRBJ1-6,CASSLSGGTGVNSPLHF,1,0,1,1
TRBV7-9,TRBJ2-3,CASSLGGSGSSTDTQYF,1,0,1,1
TRBV7-2,TRBJ2-1,CASSPQPLAGANLGQFF,1,0,1,1
TRBV3-1,TRBJ2-5,CASSPFVVAGVLETQYF,1,0,1,1
TRBV7-3,TRBJ2-3,CASSPWGSETRTDTQYF,1,0,1,1
TRBV6-2/3/5/6,TRBJ2-6,CASSPGTGISGANVLTF,1,0,1,1
TRBV7-2,TRBJ1-6,CASSPIGGHQTNSPLHF,1,0,1,1
TRBV5-4,TRBJ2-3,CASSPTTGAGGTDTQYF,1,0,1,1
TRBV7-3,TRBJ2-2,CASSPSVEGTMAGELFF,1,0,1,1
TRBV7-9,TRBJ1-2,CASSPWDTQGANYGYTF,1,0,1,1
TRBV11-1,TRBJ1-1,CASSPRSTRGIGTEAFF,1,0,1,1
TRBV7-8,TRBJ2-3,CASSRGMISRSTDTQYS,1,0,1,1
TRBV5-6,TRBJ2-1,CASSRERGSSSYNEQFF,1,0,1,1
TRBV7-9,TRBJ2-6,CASSHRDRGAGANVLTF,1,0,1,1
TRBV4-2,TRBJ1-2,CASSQVSLTAGFNGYTF,1,0,1,1
TRBV3-1,TRBJ2-2,CASSQALARTKAGELFF,1,0,1,1
TRBV4-2,TRBJ2-1,CASSQAVAGGGDNEQFF,1,0,1,1
TRBV3-1,TRBJ2-6,CASSQDLGVAGANVLTF,1,0,1,1
TRBV9,TRBJ1-2,CASSVDGDSLELYGYTF,1,0,1,1
TRBV3-1,TRBJ1-4,CASSAWTGVPTNEKLFF,1,0,1,1
TRBV9,TRBJ1-5,CASSAGGGASSNQPQHF,1,0,1,1
TRBV28,TRBJ1-1,CASRPGTNFRLPTEAFF,1,0,1,1
TRBV5-1,TRBJ1-4,CASSLVVNEGSNEKLFF,1,0,1,1
TRBV5-1,TRBJ1-1,CASSLVGAGLMNTEAFF,1,0,1,1
TRBV5-1,TRBJ2-6,CASSLAAGASGANVLTF,1,0,1,1
TRBV5-1,TRBJ1-6,CASSLATGQGENSPLHF,1,1,2,2
TRBV5-1,TRBJ1-4,CASSLGAGGAGEEKLFF,1,0,1,1
TRBV5-1,TRBJ1-1,CASSLGQGTGGGTEAFF,1,0,1,1
TRBV5-1,TRBJ1-1,CASSLTHRARLNTEAFF,1,0,1,1
TRBV5-1,TRBJ2-6,CASSSDRGLNGANVLTF,1,0,1,1
TRBV5-1,TRBJ1-6,CASSWAMVRDSYSPLHF,1,0,1,1
TRBV4-1,TRBJ2-3,CASSLSPGTPSTDTQYF,1,0,1,1
TRBV4-1,TRBJ2-1,CASSPGLAGPRGNEQFF,1,0,1,1
TRBV5-1,TRBJ1-1,CASSPGEQGMSNTEAFF,1,0,1,1
TRBV4-1,TRBJ1-2,CASSQLPRQDTVGGYTF,1,0,1,1
TRBV4-1,TRBJ2-1,CASSQGPWGGRINEQFY,1,0,1,1
TRBV4-1,TRBJ2-2,CASSQGLLGARTGELFF,1,0,1,1
TRBV4-1,TRBJ1-4,CASSQEVPGPGNEKLFF,1,0,1,1
TRBV5-1,TRBJ2-1,CASRGLAGEPRGNGQFF,1,0,1,1
TRBV20-1,TRBJ2-7,CSARGGGRARMGYEQYF,1,0,1,1
TRBV20-1,TRBJ1-5,CSARDPQQGASNQPQHF,1,1,2,2
TRBV20-1,TRBJ1-5,CSAREGKGSVGNQPQHF,1,0,1,1
TRBV29-1,TRBJ2-3,CSVVVAGTNLYTDTQYF,1,0,1,1
TRBV29-1,TRBJ2-7,CSVEDWRTSGGGYEQYF,1,0,1,1
TRBV29-1,TRBJ2-1,CSVAGAVGSQHYNEQFF,1,0,1,1
TRBV29-1,TRBJ2-3,CSALGLAGGSTTDTQYF,1,0,1,1
TRBV5-6,TRBJ1-6,YAGPGQGCSSYNSPLHF,1,0,1,1
TRBV11-2,TRBJ2-1,CACSPARDPTGDEQFF,1,0,1,1
TRBV30,TRBJ1-1,CAWSSTGIRVNTEAFF,1,0,1,1
TRBV30,TRBJ1-2,CAWSPKQGAIGQGYTF,1,0,1,1
TRBV30,TRBJ1-1,CAWSVHEERGITEAFF,1,0,1,1
TRBV28,TRBJ1-4,CAGSSSGTGIGEKLFF,1,0,1,1
TRBV3-1,TRBJ1-1,CATQPSPGQGSTEAFF,1,0,1,1
TRBV15,TRBJ1-5,CATSREVAYSNQPQHF,1,0,1,1
TRBV15,TRBJ2-5,CATSRAWGGPQETQYF,1,0,1,1
TRBV15,TRBJ2-1,CATSRETGGSYNEQFF,1,1,2,2
TRBV19,TRBJ1-5,CASTRHGASSNQPQHF,1,0,1,1
TRBV19,TRBJ1-5,CASSIIGGIGNQPQHF,1,0,1,1
TRBV19,TRBJ2-3,CASSIPAGPSTDTQYF,1,0,1,1
TRBV19,TRBJ1-6,CASSIRQVWSSSPLHF,1,0,1,1
TRBV19,TRBJ1-1,CASSKIPGQGMVEAFF,1,0,1,1
TRBV19,TRBJ2-3,CASSSPGTGGTDTQYF,1,0,1,1
TRBV18,TRBJ2-3,CASSLGTSGNTDTQYF,1,0,1,1
TRBV18,TRBJ2-7,CASSPSFGTGYYEQYF,1,0,1,1
TRBV18,TRBJ2-1,CASSPGTSGGYNERFF,1,0,1,1
TRBV18,TRBJ2-2,CASSPSPQGSTGELFF,1,0,1,1
TRBV18,TRBJ1-6,CASSPGTGWTNSPLHF,1,0,1,1
TRBV28,TRBJ1-5,CASYGRDRGFNQPQHF,1,0,1,1
TRBV6-2/3/5/6,TRBJ2-6,CASGLPGAPGANVLTF,1,0,1,1
TRBV6-1,TRBJ2-1,CASGVLGGATYNEQFF,1,0,1,1
TRBV3-1,TRBJ1-2,CASGLSGASFSYGYTF,1,0,1,1
TRBV2,TRBJ1-6,CASGDAFRAYNSPLHF,1,0,1,1
TRBV28,TRBJ2-1,CASIDMDGPEGYGQFF,1,0,1,1
TRBV12-3/4,TRBJ1-6,CASSFILGQGGSPLHF,1,0,1,1
TRBV6-2/3/5/6,TRBJ2-7,CASSFFLGGTSYEQYF,1,0,1,1
TRBV28,TRBJ1-4,CASSLYGQGINEKLFF,1,0,1,1
TRBV28,TRBJ2-2,CASSLLDRINTGELFF,1,0,1,1
TRBV12-3/4,TRBJ2-3,CASSLRRAGGTDTQYF,1,0,1,1
TRBV6-2/3/5/6,TRBJ2-1,CASSLGGWTLGNEQFF,1,0,1,1
TRBV27,TRBJ2-7,CASSLNRWTDSAEQYF,1,0,1,1
TRBV12-3/4,TRBJ2-3,CASSSGTSGPTDTQYF,1,0,1,1
TRBV6-2/3/5/6,TRBJ2-5,CASSSFPPAIEETQYF,1,0,1,1
TRBV6-2/3/5/6,TRBJ2-3,CASSYSGGGFPDTQYF,1,0,1,1
TRBV6-2/3/5/6,TRBJ1-2,CASSYSIAGSRYGYTF,1,0,1,1
TRBV6-2/3/5/6,TRBJ2-5,CASSLERGEGQETQYF,1,0,1,1
TRBV27,TRBJ2-3,CASSPRDLWDVNTQYF,1,0,1,1
TRBV27,TRBJ2-1,CASSPVLTSGANEQFF,1,0,1,1
TRBV6-2/3/5/6,TRBJ2-1,CASSRTSGGPYNEQFF,1,0,1,1
TRBV11-2,TRBJ2-5,CASSQRGEVRGETQYF,1,0,1,1
TRBV11-2,TRBJ2-1,CASSQNLAGGQDEQFL,1,0,1,1
TRBV6-1,TRBJ2-4,CASSQLAGLAKNIQYF,1,0,1,1
TRBV12-3/4,TRBJ2-1,CASSGLSGGAANEQFF,1,0,1,1
TRBV6-1,TRBJ1-5,CASSGPTGQSNQPQHF,1,1,2,2
TRBV2,TRBJ1-6,CASSERGPGANSPLYF,1,0,1,1
TRBV6-1,TRBJ2-5,CASSEVAGGYQETQYF,1,0,1,1
TRBV2,TRBJ2-7,CASSERYTSEPYEQYF,1,0,1,1
TRBV6-2/3/5/6,TRBJ2-7,CASSMVAGTPTYEQYF,1,0,1,1
TRBV6-1,TRBJ2-2,CASSRTGTRNTGELFF,1,0,1,1
TRBV11-2,TRBJ1-6,CASSFGPKLYNSPLHF,1,0,1,1
TRBV5-5,TRBJ1-4,CASSLGNSLVNEKPFF,1,0,1,1
TRBV5-4,TRBJ2-2,CASSLGQGVLTGELFF,1,0,1,1
TRBV5-6,TRBJ2-3,CASSLRRGGTTDTQYF,1,0,1,1
TRBV7-9,TRBJ1-1,CASSLLAGGKNTEAFF,1,0,1,1
TRBV7-9,TRBJ2-1,CASSLLRDSATDEQFF,1,0,1,1
TRBV13,TRBJ2-1,CASSLWAGPKRNEQFF,1,0,1,1
TRBV7-9,TRBJ2-3,CASSLWDYRNTDTQYF,1,0,1,1
TRBV7-9,TRBJ1-6,CASSLPSGTVGSPLHF,1,0,1,1
TRBV7-6,TRBJ1-3,CASSLVRGLGGNTIYF,1,0,1,1
TRBV7-9,TRBJ2-3,CASSLVLGGSTDTQYF,1,0,1,1
TRBV7-9,TRBJ2-1,CASSLVSRLPYNEQFF,1,0,1,1
TRBV7-9,TRBJ1-4,CASSLARRGRNEKLFF,1,0,1,1
TRBV7-2,TRBJ1-1,CASSLAGLRRNTEAFF,1,0,1,1
TRBV7-2,TRBJ2-1,CASSLARGGTVNEQFF,1,0,1,1
TRBV7-2,TRBJ1-2,CASSLAGPFLMDGYTF,1,0,1,1
TRBV7-2,TRBJ2-3,CASSLGGRGFTDTQYF,1,0,1,1
TRBV7-2,TRBJ2-5,CASSLGGLPRQETQYF,1,0,1,1
TRBV7-9,TRBJ2-1,CASSLGRYRSYNEKFS,1,0,1,1
TRBV7-8,TRBJ1-5,CASSLGQEYSNQPQHF,1,0,1,1
TRBV7-2,TRBJ1-5,CASSLDQGAIYQPQHF,1,0,1,1
TRBV11-2,TRBJ1-1,CASSLDSIGGMTEAFF,1,0,1,1
TRBV7-3,TRBJ2-1,CASSLTTGGGYNEQFF,1,0,1,1
TRBV11-2,TRBJ2-1,CASSSLRGSSYNEQFF,1,1,2,2
TRBV7-2,TRBJ2-2,CASSSLGNRGRRELFF,1,0,1,1
TRBV7-9,TRBJ2-1,CASSSSLSGGYNEQFF,1,0,1,1
TRBV7-9,TRBJ2-7,CASSSLITGKGGEQYF,1,0,1,1
TRBV11-2,TRBJ2-5,CASSSGTSEEVETQCF,1,0,1,1
TRBV7-2,TRBJ2-3,CASSSGLAGNTDTQYF,1,0,1,1
TRBV12-3/4,TRBJ1-1,CASSYKWTEYNTEAFF,1,0,1,1
TRBV9,TRBJ2-1,CASSLGQGAPYNEQFF,1,0,1,1
TRBV7-6,TRBJ2-5,CASSLSSGGVEETQYF,1,0,1,1
TRBV12-3/4,TRBJ1-3,CASSLYGAPRGNAIYF,1,0,1,1
TRBV7-2,TRBJ2-5,CASSLRLAGGQETQYF,1,0,1,1
TRBV3-1,TRBJ2-5,CASSPFGTSNQETQYF,1,0,1,1
TRBV3-1,TRBJ2-7,CASSPHWTSGVYEQYF,1,0,1,1
TRBV9,TRBJ2-3,CASSPQLRGGPDTQYF,1,0,1,1
TRBV6-2/3/5/6,TRBJ1-5,CASSPGAFYSNQPQHF,1,0,1,1
TRBV11-2,TRBJ2-1,CASSPSGGWDYNEQFF,1,0,1,1
TRBV5-8,TRBJ2-1,CASSPWTSGAYNEQFF,1,0,1,1
TRBV11-2,TRBJ2-7,CASSPYGDRGYYEQYF,1,0,1,1
TRBV7-9,TRBJ2-3,CASSPGWDRSTDTQYF,1,0,1,1
TRBV7-3,TRBJ2-5,CASSPGTSGVTETQYF,1,0,1,1
TRBV7-2,TRBJ2-1,CASSPTAPGSYNEQFF,1,0,1,1
TRBV7-2,TRBJ2-1,CASSPGRGGEYNEQFF,1,0,1,1
TRBV11-2,TRBJ1-4,CASSRGGAGDNEKLFF,1,0,1,1
TRBV3-1,TRBJ2-3,CASSRNSGLPTDTQYF,1,0,1,1
TRBV28,TRBJ2-3,CASSQTSGGTTDTQYF,1,0,1,1
TRBV4-2,TRBJ2-5,CASSQVGGQPSETQYF,1,0,1,1
TRBV3-1,TRBJ2-1,CASSQAGTGDYNEQFF,1,0,1,1
TRBV14,TRBJ2-3,CASSQGPQGILDTQYF,1,0,1,1
TRBV14,TRBJ2-4,CASSQGVLLAKNIQYF,1,0,1,1
TRBV3-1,TRBJ2-5,CASSQGGSGGKETQYF,1,0,1,1
TRBV9,TRBJ2-7,CASSVGVRTGLGEQYF,1,0,1,1
TRBV5-4,TRBJ1-5,CASSVGGGSGRQPQHF,1,0,1,1
TRBV11-2,TRBJ2-3,CASSAWAGGGSDTQHF,1,0,1,1
TRBV7-9,TRBJ2-6,CASSAVGRTGANVLTF,1,0,1,1
TRBV6-2/3/5/6,TRBJ2-7,CASSAKLLAHHYEQYF,1,0,1,1
TRBV2,TRBJ1-2,CASSGLIQGANYGYTF,1,0,1,1
TRBV9,TRBJ2-4,CASSEDTRLAKNIQYF,1,1,2,2
TRBV7-2,TRBJ2-7,CASSTRTGGRSYEQYF,1,0,1,1
TRBV11-2,TRBJ1-3,CASSTGGGLSGNTIYF,1,0,1,1
TRBV12-3/4,TRBJ2-7,CASSRKLDRSFNERYF,1,0,1,1
TRBV5-4,TRBJ2-2,CASRAGQGADTGELFF,1,0,1,1
TRBV20-1,TRBJ2-7,CGARESVGDRPYEQYF,1,0,1,1
TRBV24-1,TRBJ2-1,CTTRTSGGAIIDEQFF,1,0,1,1
TRBV4-1,TRBJ1-6,CAGSRARDTNREPLHF,1,0,1,1
TRBV5-1,TRBJ2-3,CASSNLVGGNTDTQYF,1,0,1,1
TRBV28,TRBJ2-4,CASSLWMGVAKNIQYF,1,0,1,1
TRBV5-1,TRBJ2-2,CASSFKRLDYTGELCF,1,0,1,1
TRBV5-1,TRBJ1-2,CASSLSQVGGNYGYTF,1,0,1,1
TRBV5-1,TRBJ2-1,CASSLLPSGDYNEQFF,1,0,1,1
TRBV5-1,TRBJ2-1,CASSLVGGQGGNEQFF,1,0,1,1
TRBV5-1,TRBJ1-2,CASSLAGNAQVTGYTF,1,0,1,1
TRBV5-1,TRBJ2-3,CASSLAGLARVDTQYF,1,0,1,1
TRBV5-1,TRBJ1-3,CASSLGWGSSGNTICF,1,0,1,1
TRBV5-1,TRBJ1-1,CASSLMLGTGSTEAFF,1,0,1,1
TRBV5-1,TRBJ2-2,CASSLLAGGPTGELFF,1,0,1,1
TRBV5-1,TRBJ1-5,CASSSPDSYSNQPQHI,1,0,1,1
TRBV5-1,TRBJ2-3,CASSSGGLQAIGTQYF,1,0,1,1
TRBV5-1,TRBJ2-2,CASSSSPGLNTGELFF,1,0,1,1
TRBV5-1,TRBJ1-6,CASSLGGGIGLSPLHF,1,0,1,1
TRBV5-1,TRBJ1-6,CASSLTTDAYNSPLHF,1,0,1,1
TRBV5-1,TRBJ2-1,CASSLRTDGSYNEQFF,1,0,1,1
TRBV4-1,TRBJ1-3,CASSLKGQISGNTIYF,1,0,1,1
TRBV5-1,TRBJ2-7,CASSLDGGGSAREQYF,1,0,1,1
TRBV4-1,TRBJ2-1,CASSLERGSSYNEQFF,1,0,1,1
TRBV4-1,TRBJ2-5,CASSPSPSRGGETQYF,1,0,1,1
TRBV5-1,TRBJ2-1,CASSPRPGGVYNEQFF,1,0,1,1
TRBV5-1,TRBJ2-3,CASSPQPSWDTDTQYF,1,0,1,1
TRBV4-1,TRBJ1-1,CASSRQSDRGPTEAFF,1,0,1,1
TRBV5-1,TRBJ2-1,CASSRTGGTGRNEQFF,1,0,1,1
TRBV4-1,TRBJ1-5,CASSRRQNPSNQPQHF,1,0,1,1
TRBV5-1,TRBJ1-6,CASSRIPGQDNSPLHF,1,0,1,1
TRBV5-1,TRBJ2-5,CASSQDAAGGEETQYF,1,0,1,1
TRBV4-1,TRBJ2-1,CASSQGRGGLYNEQFF,1,0,1,1
TRBV4-1,TRBJ1-5,CASSQDGEFSNQPQHF,1,0,1,1
TRBV4-1,TRBJ2-7,CASSQKISGDPYEQYF,1,0,1,1
TRBV5-1,TRBJ1-4,CASSRGNRGANEKLFF,1,0,1,1
TRBV5-1,TRBJ2-5,CASKPLWTGEVETQYF,1,0,1,1
TRBV20-1,TRBJ2-1,CGASLAGGRDYNEQFF,1,0,1,1
TRBV20-1,TRBJ2-2,CSASRLAGEFTGELFF,1,0,1,1
TRBV20-1,TRBJ2-1,CSARGQAGGVYNEQFF,1,1,2,2
TRBV20-1,TRBJ2-1,CSARDLRTRYSGEQFF,1,0,1,1
TRBV20-1,TRBJ2-1,CSALTGLAGGSDEQFF,1,0,1,1
TRBV20-1,TRBJ2-1,CSAGQSSGGVFNEQFF,1,0,1,1
TRBV29-1,TRBJ1-3,CSVDAGTGVSGNTIYF,1,0,1,1
TRBV29-1,TRBJ2-3,CSVEPPLAGGADTRYF,1,0,1,1
TRBV29-1,TRBJ2-1,CSVEFTTGVIGNEQFF,1,0,1,1
TRBV20-1,TRBJ2-7,CRARDSGGTSFYEQYF,1,0,1,1
TRBV6-2/3/5/6,TRBJ1-4,CVSSKRRAANEKLFF,1,0,1,1
TRBV12-5,TRBJ2-7,CASGSSGTVAYEQYF,1,0,1,1
TRBV7-6,TRBJ2-5,CASSLAAGNIETQYF,1,0,1,1
TRBV7-7,TRBJ2-5,CASSLDRGSLETQYF,1,0,1,1
TRBV7-7,TRBJ2-5,CASSAPDRPQETQYF,1,0,1,1
TRBV7-9,TRBJ2-2,CASEYAGGGTGELFF,1,0,1,1
TRBV30,TRBJ1-6,CAWSVLQEYNSPLHF,1,0,1,1
TRBV30,TRBJ2-5,CAWSGDSGAQETQYF,1,0,1,1
TRBV30,TRBJ2-7,CAWSEGSEGVYEQYF,1,0,1,1
TRBV30,TRBJ1-1,CAWSKPGGMNTEAFF,1,0,1,1
TRBV30,TRBJ1-5,CAWSRRGGGNQPQHF,1,0,1,1
TRBV30,TRBJ1-1,CAWSARQGMNTEAFF,1,0,1,1
TRBV30,TRBJ2-7,CAWRGLAGGSYEQYF,1,0,1,1
TRBV30,TRBJ2-1,CAWNGGVSSYNEQFF,1,0,1,1
TRBV18,TRBJ2-1,CAGSPGLDMRNEQFF,1,0,1,1
TRBV25-1,TRBJ1-2,CAGSDPAGESYGYTF,1,0,1,1
TRBV24-1,TRBJ2-2,CATSGPVWSTGELFF,1,0,1,1
TRBV15,TRBJ2-5,CATSGQTSSVETQYF,1,0,1,1
TRBV15,TRBJ2-2,CATSRTGGITGELFF,1,0,1,1
TRBV15,TRBJ2-5,CATSRLAGGQETQYF,1,0,1,1
TRBV15,TRBJ2-5,CATSRRQGFGETQYF,1,0,1,1
TRBV15,TRBJ2-1,CATSRDPQAYNEQFF,1,0,1,1
TRBV19,TRBJ1-5,CASTPGTGRDQPQHF,1,0,1,1
TRBV5-4,TRBJ2-3,CASTWDRGATDTQYF,1,0,1,1
TRBV19,TRBJ2-2,CASSILTGNTGELFF,1,0,1,1
TRBV19,TRBJ2-2,CASSINPGATGELFF,1,0,1,1
TRBV19,TRBJ2-6,CASSMGGPGANVLTF,1,0,1,1
TRBV19,TRBJ1-1,CASSIEWDLNTEAFF,1,0,1,1
TRBV19,TRBJ1-1,CASSIEASRNTEAFF,1,0,1,1
TRBV19,TRBJ2-7,CASSTSGTGAYEQYF,1,0,1,1
TRBV19,TRBJ1-6,CASSSRIGANSPLHF,1,0,1,1
TRBV19,TRBJ2-2,CASKIPGLVAGELFF,1,0,1,1
TRBV18,TRBJ1-2,CASSPQSREREGYTF,1,0,1,1
TRBV18,TRBJ2-1,CASSPGTGLYNEQFF,1,0,1,1
TRBV18,TRBJ2-1,CASSPGTGGGDEQFF,1,0,1,1
TRBV18,TRBJ2-7,CASSPGTGTFYEQYF,1,0,1,1
TRBV18,TRBJ2-5,CASSPLGTDQETQYF,1,0,1,1
TRBV18,TRBJ1-5,CASSPPARAGQPQHF,1,0,1,1
TRBV18,TRBJ2-3,CASSPAQISTDTQYF,1,0,1,1
TRBV28,TRBJ2-2,CASQGRTGDRAELFF,1,0,1,1
TRBV11-2,TRBJ1-3,CASGLLVGGGNTIYF,1,0,1,1
TRBV11-1,TRBJ2-3,CASGGQGINTDTQYF,1,0,1,1
TRBV12-3/4,TRBJ1-6,CASTLGQGAASPLHF,1,0,1,1
TRBV28,TRBJ2-1,CASTLGGSPENEQFF,1,0,1,1
TRBV6-2/3/5/6,TRBJ1-1,CASTPSTGRNTEAFF,1,0,1,1
TRBV7-2,TRBJ2-3,CASTTRGLAADTQYF,1,0,1,1
TRBV7-6,TRBJ2-3,CASTKWGEGTDTQYF,1,0,1,1
TRBV6-2/3/5/6,TRBJ1-2,CASTPRGGSNYGYTF,1,0,1,1
TRBV28,TRBJ1-1,CASSFPSGRNTEAFF,1,0,1,1
TRBV12-3/4,TRBJ2-7,CASSFGPGKAYEQYF,1,0,1,1
TRBV6-2/3/5/6,TRBJ2-1,CASSFSGPPYNEQFF,1,0,1,1
TRBV28,TRBJ2-1,CASSFGGRASEEQFF,1,0,1,1
TRBV12-3/4,TRBJ2-1,CASSLEGGAFNEQFF,1,0,1,1
TRBV27,TRBJ2-1,CASSLSGEPYNEQFF,1,0,1,1
TRBV28,TRBJ2-3,CASSLWGRATDTQYF,1,0,1,1
TRBV6-2/3/5/6,TRBJ2-7,CASSLYRGGAYEQYF,1,0,1,1
TRBV28,TRBJ2-5,CASSLQTAWKETRYF,1,0,1,1
TRBV6-2/3/5/6,TRBJ2-7,CASSLVGGPADEQYF,1,0,1,1
TRBV6-2/3/5/6,TRBJ1-1,CASSLARRGNTEASF,1,0,1,1
TRBV28,TRBJ2-5,CASSLASRGQETQYF,1,0,1,1
TRBV6-2/3/5/6,TRBJ2-3,CASSLGGGAWDTQYF,1,0,1,1
TRBV28,TRBJ2-7,CASSLGTGTGEGQYF,1,0,1,1
TRBV28,TRBJ1-5,CASSLGGQYNQPQHF,1,0,1,1
TRBV12-3/4,TRBJ2-3,CASSLMGGSTDTQYF,1,0,1,1
TRBV28,TRBJ2-4,CASSSSTGAKNIQYF,1,0,1,1
TRBV28,TRBJ2-3,CASSSYYDSRDTQYF,1,0,1,1
TRBV6-2/3/5/6,TRBJ1-4,CASSSLGQENEKLFF,1,0,1,1
TRBV28,TRBJ1-4,CASSSPGQGNEKLFF,1,0,1,1
TRBV13,TRBJ2-7,CASSSHPRGGYEQYF,1,0,1,1
TRBV28,TRBJ2-1,CASSSQGLGYNEQFF,1,0,1,1
TRBV6-2/3/5/6,TRBJ2-7,CASSSAGTGNYEQYF,1,0,1,1
TRBV27,TRBJ2-1,CASSSRGGTYNEQFF,1,0,1,1
TRBV28,TRBJ1-5,CASSSEGPGGQPQHF,1,1,2,2
TRBV28,TRBJ2-3,CASSSAAILPDTQYF,1,0,1,1
TRBV28,TRBJ2-3,CASSWAGRRGDTQYF,1,0,1,1
TRBV6-2/3/5/6,TRBJ2-7,CASSYYRDPTCEQYF,1,0,1,1
TRBV12-3/4,TRBJ1-5,CASSYLDRPNQPQHF,1,0,1,1
TRBV6-2/3/5/6,TRBJ1-5,CASSYSGDSNQPQHF,1,0,1,1
TRBV6-2/3/5/6,TRBJ2-7,CASSYHGTDSYEQYF,1,0,1,1
TRBV12-3/4,TRBJ2-1,CASSLTSGSYNEQFF,1,0,1,1
TRBV5-5,TRBJ2-3,CASSLKQGYTDTQYF,1,0,1,1
TRBV12-3/4,TRBJ2-3,CASSPPRGLTDTQYF,1,0,1,1
TRBV11-2,TRBJ1-1,CASSPGGGRHTEAFF,1,0,1,1
TRBV12-3/4,TRBJ1-1,CASSPRGEGSTEAFF,1,0,1,1
TRBV6-2/3/5/6,TRBJ2-7,CASSRDTTSSYEQYF,1,0,1,1
TRBV5-4,TRBJ1-2,CASSRELGLAYGYTF,1,0,1,1
TRBV27,TRBJ1-1,CASSRRQGLGTEAFF,1,0,1,1
TRBV28,TRBJ1-2,CASSQYIQDGYGYTF,1,0,1,1
TRBV28,TRBJ1-2,CASSVRQGVGAGYTF,1,0,1,1
TRBV28,TRBJ2-7,CASSASGTGAYEQYF,1,0,1,1
TRBV12-3/4,TRBJ1-5,CASSARASTIKPQHF,1,0,1,1
TRBV2,TRBJ2-7,CASSDRAGASYEQYF,1,0,1,1
TRBV25-1,TRBJ1-5,CASSDGRGDNQPQHF,1,0,1,1
TRBV28,TRBJ2-2,CASSDTRGLTGELFF,1,0,1,1
TRBV10-3,TRBJ2-5,CASSESRGGRETQYF,1,0,1,1
TRBV6-1,TRBJ2-7,CASSERGGSSYEQYF,1,0,1,1
TRBV2,TRBJ2-3,CASSEQGGKTDTQYF,1,0,1,1
TRBV2,TRBJ2-2,CASSEQGVDTGELFF,1,0,1,1
TRBV6-1,TRBJ2-1,CASSEQGGSYNEQFF,1,0,1,1
TRBV2,TRBJ1-4,CASSEGRGRNEKLFF,1,0,1,1
TRBV6-1,TRBJ2-1,CASSEGGPRLNEQFF,1,0,1,1
TRBV28,TRBJ2-2,CASSMMTSPTGELFF,1,0,1,1
TRBV6-2/3/5/6,TRBJ2-7,CASSIRSGGPYEQYF,1,0,1,1
TRBV6-1,TRBJ2-4,CASSKGLAGAGVQYF,1,0,1,1
TRBV12-3/4,TRBJ2-5,CASSKGLGFQETQYF,1,0,1,1
TRBV7-9,TRBJ2-7,CASSFGGGASYEQYF,1,0,1,1
TRBV11-3,TRBJ2-1,CASSFLGTRGNEQFF,1,0,1,1
TRBV5-5,TRBJ1-2,CASSFPDWGKYGYTF,1,0,1,1
TRBV12-3/4,TRBJ2-1,CASSFGTGDYNEQFF,1,0,1,1
TRBV11-2,TRBJ2-5,CASSLVGTQEETQYF,1,0,1,1
TRBV5-4,TRBJ2-5,CASSLGGGATETQYF,1,0,1,1
TRBV5-4,TRBJ2-5,CASSLDQGALETQYF,1,0,1,1
TRBV7-3,TRBJ2-1,CASSLTGGSYNEQFF,1,0,1,1
TRBV5-4,TRBJ2-3,CASSLKRGVIDTQYF,1,0,1,1
TRBV7-9,TRBJ2-1,CASSLSVTSYNEQFF,1,0,1,1
TRBV7-2,TRBJ2-7,CASSLLRDRGSEQYF,1,0,1,1
TRBV7-3,TRBJ2-1,CASSLVRGPYNEQFF,1,0,1,1
TRBV7-2,TRBJ1-5,CASSLVDGDHQPQHF,1,0,1,1
TRBV7-9,TRBJ2-4,CASSLVSGVGNIQYF,1,0,1,1
TRBV11-2,TRBJ2-1,CASSLGDRVIDEQFF,1,0,1,1
TRBV7-2,TRBJ2-7,CASSLGTGDSYEQYF,1,1,2,2
TRBV7-3,TRBJ2-5,CASSLGSQGGRTQYF,1,0,1,1
TRBV7-9,TRBJ1-2,CASSLDWGEAYGYTF,1,0,1,1
TRBV7-9,TRBJ2-3,CASSLEGLDTDTQYF,1,0,1,1
TRBV7-2,TRBJ2-3,CASSLIGTYTDTQYF,1,0,1,1
TRBV7-2,TRBJ2-6,CASSLMVSGANVLTF,1,0,1,1
TRBV7-2,TRBJ2-3,CASSLIWGLANTQYF,1,0,1,1
TRBV7-3,TRBJ2-5,CASSLTPGGLETQYL,1,0,1,1
TRBV11-2,TRBJ2-3,CASSLTLAGGYTQYF,1,0,1,1
TRBV7-9,TRBJ2-3,CASSLRAGGEDTQYF,1,0,1,1
TRBV5-4,TRBJ2-3,CASSLRAGSTDTQYF,1,0,1,1
TRBV7-9,TRBJ2-7,CASSSSGTGSPEQYF,1,0,1,1
TRBV12-3/4,TRBJ1-5,CASSSGQGGNQPQHF,1,0,1,1
TRBV7-3,TRBJ1-1,CASSSSGTPNTEAFF,1,0,1,1
TRBV7-9,TRBJ2-1,CASSSSGASFDEQFF,1,0,1,1
TRBV11-2,TRBJ2-1,CASSSGGLSYNEQFF,1,0,1,1
TRBV9,TRBJ2-1,CASSSGTGGYNEQFF,1,0,1,1
TRBV7-9,TRBJ2-3,CASSSTSGGADTQYF,1,0,1,1
TRBV7-9,TRBJ2-2,CASSSRNVAGGELFF,1,0,1,1
TRBV7-9,TRBJ2-7,CASSSGLAVSYEQYF,1,0,1,1
TRBV7-9,TRBJ1-2,CASSSWDGVGYGYTF,1,0,1,1
TRBV28,TRBJ2-3,CASSSRTGRRDTQYF,1,0,1,1
TRBV7-3,TRBJ2-3,CASSSNGGAVDTQYF,1,0,1,1
TRBV7-6,TRBJ2-3,CASSYGPRYTDTQYF,1,0,1,1
TRBV3-1,TRBJ2-1,CASSLFYLTYNEQFF,1,0,1,1
TRBV11-2,TRBJ2-5,CASSLGTVVGETQYF,1,0,1,1
TRBV7-9,TRBJ2-1,CASSLGLAGRDEQFF,1,0,1,1
TRBV7-2,TRBJ2-2,CASSLGLAGAGELFF,1,0,1,1
TRBV7-2,TRBJ1-4,CASSLNGGANEKLFS,1,0,1,1
TRBV7-8,TRBJ2-3,CASSLPGGGGDTQYF,1,0,1,1
TRBV3-1,TRBJ2-3,CASSLTSGRTDTQYF,1,0,1,1
TRBV11-2,TRBJ2-1,CASSPTSGGANEQFF,1,0,1,1
TRBV7-9,TRBJ2-2,CASSPRAQNTGELFF,1,0,1,1
TRBV7-2,TRBJ2-5,CASSPNPGGKETQYF,1,0,1,1
TRBV11-2,TRBJ2-3,CASSPWTSGTDTQYF,1,1,2,2
TRBV9,TRBJ2-5,CASSPRRDIQETQYF,1,0,1,1
TRBV3-1,TRBJ2-5,CASSPRGASQETQYF,1,0,1,1
TRBV3-1,TRBJ2-7,CASSPRTGGAGEQYF,1,0,1,1
TRBV3-1,TRBJ2-7,CASSPRQGGSYEQYF,1,0,1,1
TRBV14,TRBJ2-1,CASSPHRTRDNEQFF,1,0,1,1
TRBV7-9,TRBJ2-7,CASSPDQRGGYEQYF,1,0,1,1
TRBV7-8,TRBJ1-4,CASSPDGGRAEKLFF,1,0,1,1
TRBV7-9,TRBJ1-2,CASSPDRGQGYGYTF,1,0,1,1
TRBV6-2/3/5/6,TRBJ2-3,CASSPKASGADTQYF,1,0,1,1
TRBV3-1,TRBJ1-4,CASSPPGSEGEKLFF,1,0,1,1
TRBV5-4,TRBJ1-2,CASSPPGQGNYGYTF,1,0,1,1
TRBV7-9,TRBJ2-2,CASSPAGTGSGELVF,1,0,1,1
TRBV7-9,TRBJ2-5,CASSPGPGPKETQYF,1,0,1,1
TRBV13,TRBJ2-7,CASSPTRTATYEQYF,1,0,1,1
TRBV11-1,TRBJ1-1,CASSREGSLNTEAFF,1,0,1,1
TRBV11-3,TRBJ2-1,CASSRSGGTYNEQFF,1,0,1,1
TRBV7-9,TRBJ2-1,CASSRDRVSTNEQFF,1,0,1,1
TRBV7-3,TRBJ2-7,CASSRTDAPYVEQYF,1,0,1,1
TRBV9,TRBJ2-2,CASSRTGDPTGELFF,1,0,1,1
TRBV7-2,TRBJ1-2,CASSQAIQSNYGYTF,1,0,1,1
TRBV4-2,TRBJ1-1,CASSQGRQMNTEAFF,1,0,1,1
TRBV3-1,TRBJ2-7,CASSQGQRPWDEQYF,1,0,1,1
TRBV3-1,TRBJ1-2,CASSQGQGRSDGYTF,1,0,1,1
TRBV7-9,TRBJ2-5,CASSQSTGQETSQYF,1,0,1,1
TRBV4-2,TRBJ1-3,CASSQVRSSGNTIYF,1,0,1,1
TRBV3-1,TRBJ2-5,CASSQVGPVVETQYF,1,0,1,1
TRBV3-1,TRBJ2-3,CASSQGRGSTDTQYF,1,0,1,1
TRBV4-2,TRBJ2-1,CASSQDLGLGNEQFF,1,0,1,1
TRBV3-1,TRBJ2-7,CASSQDPAGPREQYF,1,0,1,1
TRBV3-1,TRBJ2-4,CASSQDVRGVNIQYF,1,0,1,1
TRBV3-1,TRBJ1-1,CASSQEGRMGTEAFF,1,0,1,1
TRBV14,TRBJ2-7,CASSQIPGGAGTQYF,1,0,1,1
TRBV3-1,TRBJ2-1,CASSQSGAGFNEQFF,1,0,1,1
TRBV7-3,TRBJ2-1,CASSVLAGGFNEQFF,1,0,1,1
TRBV9,TRBJ2-3,CASSVVAGLTDTQYF,1,0,1,1
TRBV9,TRBJ1-1,CASSVGPGAEAEAFF,1,0,1,1
TRBV6-2/3/5/6,TRBJ2-1,CASSGELSSYNEQFF,1,0,1,1
TRBV9,TRBJ1-1,CASSEGDRGNTEAFF,1,0,1,1
TRBV11-2,TRBJ2-2,CASSILRGNTGEPFF,1,0,1,1
TRBV7-9,TRBJ1-1,CASSTTRFMNTEAFF,1,0,1,1
TRBV7-3,TRBJ1-6,CASSTLGGGSSPLHF,1,0,1,1
TRBV6-4,TRBJ2-3,CASSNSGQASDTQYF,1,0,1,1
TRBV7-9,TRBJ1-4,CASRLRDNPSEKLFF,1,0,1,1
TRBV7-6,TRBJ2-1,CASRRTSGGGNEQFF,1,0,1,1
TRBV12-3/4,TRBJ2-2,CASRQDRLNTGELFF,1,0,1,1
TRBV6-2/3/5/6,TRBJ2-3,CASRGLAGEGGTQYF,1,0,1,1
TRBV6-2/3/5/6,TRBJ2-4,CASRDSGAGKNIQYF,1,0,1,1
TRBV28,TRBJ1-5,CASRPRGRDNQPQHF,1,0,1,1
TRBV6-2/3/5/6,TRBJ2-6,CASRRVASGANVLTF,1,0,1,1
TRBV7-2,TRBJ1-3,CASRRNPGTGNTIYF,1,0,1,1
TRBV7-9,TRBJ2-1,CASRHWELAYNEQFF,1,0,1,1
TRBV7-9,TRBJ1-1,CASRGYRDRGPKAFF,1,0,1,1
TRBV6-2/3/5/6,TRBJ1-5,CASRGGISWAQPQHF,1,0,1,1
TRBV5-5,TRBJ2-1,CASRIAGLANNEQFF,1,0,1,1
TRBV28,TRBJ2-4,CASRITGATGNIQYF,1,0,1,1
TRBV6-2/3/5/6,TRBJ2-3,CASRNIAGGTDTRYF,1,0,1,1
TRBV2,TRBJ2-2,CASKIRQGSTGELFF,1,0,1,1
TRBV5-1,TRBJ2-1,CATTGLGNSYNEQFF,1,0,1,1
TRBV10-1,TRBJ2-2,CASGRDRGLAGELFF,1,0,1,1
TRBV5-1,TRBJ2-3,CASSGTVSYTDTQYF,1,0,1,1
TRBV5-1,TRBJ1-1,CASSSDGRTNTEAFF,1,0,1,1
TRBV4-1,TRBJ2-7,CASSPGGARTYEQYF,1,0,1,1
TRBV4-1,TRBJ2-1,CASSQRTGSHNEQFF,1,0,1,1
TRBV10-1,TRBJ2-5,CASSASSDNQETQYF,1,0,1,1
TRBV10-2,TRBJ1-5,CASSGTDRGYQPQHF,1,0,1,1
TRBV4-1,TRBJ2-7,CASSFGQGEGYEQYF,1,0,1,1
TRBV5-1,TRBJ2-5,CASSFDGALGETQYF,1,0,1,1
TRBV5-1,TRBJ2-1,CASSLLPGGHNEQFF,1,0,1,1
TRBV5-1,TRBJ2-7,CASSLQGQGSYEQYF,1,0,1,1
TRBV5-1,TRBJ2-2,CASSLADPYTGELFF,1,0,1,1
TRBV5-1,TRBJ2-3,CASSLAVEWTDTQYF,1,0,1,1
TRBV5-1,TRBJ2-1,CASSLAASSYNEQFF,1,0,1,1
TRBV5-1,TRBJ2-1,CASSLAGLVGNEQFF,1,0,1,1
TRBV5-1,TRBJ1-6,CASSLDPTYNSPLHF,1,0,1,1
TRBV5-1,TRBJ1-1,CASSLEVREGTEAFF,1,0,1,1
TRBV5-1,TRBJ1-3,CASSLEGVPGNTIYF,1,0,1,1
TRBV5-1,TRBJ2-1,CASSLSGGPYNEQFF,1,0,1,1
TRBV5-1,TRBJ1-4,CASSLSGSTNEKLFF,1,0,1,1
TRBV5-1,TRBJ2-7,CASSLTKTGIDEQYF,1,0,1,1
TRBV7-2,TRBJ2-7,CASSLSSPLAYEQYF,1,0,1,1
TRBV5-1,TRBJ1-1,CASSSLQEAGTEAFF,1,0,1,1
TRBV5-1,TRBJ2-5,CASSSGTSLLETQYF,1,0,1,1
TRBV5-1,TRBJ1-5,CASSSTGTADQPQHF,1,0,1,1
TRBV4-1,TRBJ2-7,CASSLDPGPILMQYF,1,0,1,1
TRBV5-1,TRBJ2-7,CASSLGTGGSYEQYF,1,0,1,1
TRBV5-1,TRBJ1-1,CASSLGGRGGTEAFF,1,0,1,1
TRBV5-1,TRBJ2-3,CASSPSSGPTDTQYF,1,0,1,1
TRBV5-1,TRBJ2-1,CASSPPVGSYNEQFF,1,0,1,1
TRBV4-3,TRBJ2-1,CASSPLAGGPEEQFF,1,0,1,1
TRBV4-1,TRBJ1-2,CASSPGTGNNWGYTF,1,0,1,1
TRBV4-1,TRBJ1-1,CASSQGDRMNTEAFF,1,0,1,1
TRBV4-1,TRBJ2-4,CASSQPTGLGNIQYF,1,0,1,1
TRBV4-1,TRBJ2-3,CASSQASASTDTQYF,1,0,1,1
TRBV4-1,TRBJ2-7,CASSQAYAQSYEQYF,1,0,1,1
TRBV4-1,TRBJ1-4,CASSQADRDNEKLFF,1,0,1,1
TRBV4-1,TRBJ2-7,CASSQGRGTSYEQYF,1,0,1,1
TRBV4-1,TRBJ2-1,CASSQGGTAYNEQFF,1,0,1,1
TRBV4-1,TRBJ2-7,CASSQTGGILYEQYF,1,0,1,1
TRBV5-1,TRBJ1-4,CASSAGQGTNGKLFF,1,0,1,1
TRBV5-1,TRBJ1-2,CASSGRRGSSYGYTF,1,0,1,1
TRBV5-1,TRBJ2-2,CASSIKKPDTGELFF,1,0,1,1
TRBV10-2,TRBJ2-3,CASSTGLAGPDTQYF,1,0,1,1
TRBV5-1,TRBJ2-7,CASRLVMGETYEQYF,1,0,1,1
TRBV5-1,TRBJ1-4,CASRVRDRGYEKLFF,1,0,1,1
TRBV4-1,TRBJ2-6,CASKQEGWGANVLTF,1,0,1,1
TRBV20-1,TRBJ2-5,CSASPYRAGQETQYF,1,0,1,1
TRBV20-1,TRBJ2-1,CSASLAGGRSNEQFF,1,0,1,1
TRBV20-1,TRBJ2-1,CSARVGAFFGNEQFF,1,0,1,1
TRBV20-1,TRBJ2-7,CSARSSSGGSYEQYF,1,0,1,1
TRBV20-1,TRBJ2-1,CSARRPPVAYNEQFF,1,0,1,1
TRBV20-1,TRBJ2-7,CSARQRGSGISEQYF,1,0,1,1
TRBV20-1,TRBJ1-5,CSARAPTVNNQPQHF,1,0,1,1
TRBV20-1,TRBJ1-5,CSARAGTDSNQPQHF,1,0,1,1
TRBV20-1,TRBJ1-5,CSARAPTVSNQPQHF,1,0,1,1
TRBV20-1,TRBJ2-3,CSARGLRGRTDTQYF,1,0,1,1
TRBV20-1,TRBJ2-1,CSARGTSGGANEQFF,1,0,1,1
TRBV20-1,TRBJ2-1,CSARDGRQLVNEQFF,1,0,1,1
TRBV20-1,TRBJ2-5,CSAWSAGRSQETQYF,1,0,1,1
TRBV29-1,TRBJ2-1,CSFMGLAGGPFEQFF,1,0,1,1
TRBV29-1,TRBJ2-7,CSVEGIWGQEYEQYF,1,0,1,1
TRBV29-1,TRBJ2-2,CSAQSQTERTGELFF,1,0,1,1
TRBV3-1,TRBJ2-3,WASSQNWSPQDTQYF,1,0,1,1
TRBV28,TRBJ1-1,RASSSPGLLSTEAFF,1,0,1,1
TRBV30,TRBJ1-4,CACARGGEAEKLFF,1,0,1,1
TRBV30,TRBJ2-3,CAWEQGMSTDTQYF,1,0,1,1
TRBV30,TRBJ2-7,CAWSWWQGPYEQYF,1,0,1,1
TRBV30,TRBJ1-1,CAWSVLRQNTEAFF,1,0,1,1
TRBV30,TRBJ2-4,CAWSVPGSKNIQYF,1,0,1,1
TRBV30,TRBJ2-3,CAWSMGLITDTQYF,1,0,1,1
TRBV30,TRBJ1-5,CAWNPGTINQPQHF,1,0,1,1
TRBV9,TRBJ2-3,CAGSGRGSTDTQYS,1,0,1,1
TRBV2,TRBJ2-5,CAISVVRSQETQYF,1,0,1,1
TRBV10-3,TRBJ2-5,CAISGGSRQETQYF,1,0,1,1
TRBV10-3,TRBJ2-1,CAISGTPDYNEQFF,1,0,1,1
TRBV10-3,TRBJ2-5,CAISGSRNQETQYF,1,0,1,1
TRBV10-3,TRBJ2-4,CAISEDRDKNIQYF,1,0,1,1
TRBV7-9,TRBJ1-1,CAITGGAGNTEAFF,1,0,1,1
TRBV15,TRBJ2-3,CATSGHRDADTQYF,1,0,1,1
TRBV15,TRBJ1-1,CATSGGAPNTEAFF,1,0,1,1
TRBV15,TRBJ2-5,CATSSRGGQETQYF,1,0,1,1
TRBV15,TRBJ1-5,CATSRGSANGPQHF,1,0,1,1
TRBV15,TRBJ2-1,CATSREQGDNEQFF,1,0,1,1
TRBV15,TRBJ2-3,CATSREGSSDTQYF,1,0,1,1
TRBV19,TRBJ2-3,CATKELVSTDTQYF,1,0,1,1
TRBV12-3/4,TRBJ1-1,CASSRSEMNTEAFF,1,0,1,1
TRBV12-3/4,TRBJ1-5,CASRSVASNQPQHF,1,0,1,1
TRBV19,TRBJ2-2,CASVGQGVTGELFF,1,0,1,1
TRBV19,TRBJ2-4,CASSIMWAKNIQNF,1,0,1,1
TRBV19,TRBJ1-5,CASSITGSNQPQHF,1,0,1,1
TRBV19,TRBJ1-2,CASRPTGANYGYTF,1,0,1,1
TRBV19,TRBJ1-2,CASRPRRSNYGYTF,1,0,1,1
TRBV18,TRBJ2-7,CASSPPSGAYEQYF,1,0,1,1
TRBV18,TRBJ1-1,CASSAGVGFTEAFF,1,0,1,1
TRBV18,TRBJ1-6,CASSSNLSNSPLHF,1,0,1,1
TRBV18,TRBJ2-1,CASSPSLASNEQFF,1,0,1,1
TRBV18,TRBJ2-5,CASSPLVREKTQYF,1,0,1,1
TRBV18,TRBJ2-3,CASSAWGATDTQYF,1,0,1,1
TRBV28,TRBJ2-5,CASQDLLRGETQYF,1,0,1,1
TRBV7-9,TRBJ2-5,CASGELGRLETQYF,1,0,1,1
TRBV5-1,TRBJ2-7,CASGTSGGPYEQYF,1,1,2,2
TRBV28,TRBJ2-5,CASGGRGAGETQYF,1,0,1,1
TRBV7-2,TRBJ1-2,CASISSGRYYGYTF,1,0,1,1
TRBV7-9,TRBJ2-6,CASTWGSGANVLTF,1,0,1,1
TRBV28,TRBJ1-1,CASTPGVQNTEAFF,1,0,1,1
TRBV2,TRBJ2-3,CASTRGLAPDTQYF,1,1,2,2
TRBV12-3/4,TRBJ2-3,CASTQDYNTDTQYF,1,0,1,1
TRBV28,TRBJ1-5,CASSFAGRVKPQHF,1,0,1,1
TRBV6-2/3/5/6,TRBJ2-7,CASSFISPTYEQYF,1,0,1,1
TRBV12-3/4,TRBJ2-7,CASSFREKVYEQYF,1,0,1,1
TRBV12-3/4,TRBJ1-1,CASSFGQQPIEAFF,1,0,1,1
TRBV12-3/4,TRBJ2-2,CASSLSGGAGELFF,1,0,1,1
TRBV12-3/4,TRBJ2-7,CASSLFQGAGEQYF,1,0,1,1
TRBV27,TRBJ1-5,CASSLFGFNQPQHF,1,0,1,1
TRBV27,TRBJ2-7,CASSLSAIPYEQYF,1,0,1,1
TRBV12-3/4,TRBJ1-1,CASSLSAGYTEAFF,1,0,1,1
TRBV28,TRBJ1-1,CASSLYRRDAEAFF,1,0,1,1
TRBV27,TRBJ2-1,CASSLLGRSDEQFF,1,0,1,1
TRBV12-3/4,TRBJ2-1,CASSLLALYNEQFF,1,1,2,2
TRBV12-3/4,TRBJ2-7,CASSLRDTLYEQYF,1,0,1,1
TRBV28,TRBJ1-1,CASSLGQGWTEAFF,1,0,1,1
TRBV12-3/4,TRBJ1-5,CASSLGDSNQPQHF,1,0,1,1
TRBV28,TRBJ1-6,CASSSYSYNSPLHF,1,0,1,1
TRBV6-2/3/5/6,TRBJ1-1,CASSSYRVVAEAFF,1,0,1,1
TRBV28,TRBJ1-5,CASSSHSEAQPQHF,1,0,1,1
TRBV28,TRBJ2-5,CASSSGSVVETQYF,1,0,1,1
TRBV28,TRBJ1-2,CASSWAGGNYGYTF,1,0,1,1
TRBV6-2/3/5/6,TRBJ1-2,CASSYSPRSYGYTF,1,0,1,1
TRBV6-2/3/5/6,TRBJ1-1,CASSYPQWGAEAFF,1,0,1,1
TRBV6-2/3/5/6,TRBJ2-6,CASSYVSGANVLTF,1,0,1,1
TRBV6-2/3/5/6,TRBJ1-4,CASSYARANEKLFF,1,0,1,1
TRBV6-2/3/5/6,TRBJ2-3,CASSYGGYTDTQYF,1,0,1,1
TRBV6-2/3/5/6,TRBJ1-6,CASSYEGPYSPLHF,1,0,1,1
TRBV12-3/4,TRBJ1-5,CASSLPGSHQPQHF,1,0,1,1
TRBV28,TRBJ2-5,CASSPAGGQETQYF,1,0,1,1
TRBV6-2/3/5/6,TRBJ2-3,CASSPTGGWDTQYF,1,0,1,1
TRBV11-2,TRBJ2-3,CASSRGGFTDTQYF,1,0,1,1
TRBV7-3,TRBJ2-3,CASSHGGGTDTQYF,1,0,1,1
TRBV2,TRBJ2-1,CASSVTRSGYEQFF,1,0,1,1
TRBV2,TRBJ1-5,CASSVDRDPQPQHL,1,0,1,1
TRBV12-3/4,TRBJ1-5,CASSAGELTQPQHF,1,0,1,1
TRBV28,TRBJ1-5,CASSGGQRNQPQHF,1,0,1,1
TRBV28,TRBJ2-7,CASSGTGSSYEQYF,1,0,1,1
TRBV6-1,TRBJ2-5,CASSDVGSQETQYF,1,0,1,1
TRBV6-1,TRBJ1-5,CASSDGLGNQPQHF,1,0,1,1
TRBV12-3/4,TRBJ1-6,CASSDGGNNSPLHF,1,0,1,1
TRBV6-1,TRBJ1-2,CASSEVTTNYGYTI,1,0,1,1
TRBV25-1,TRBJ2-7,CASSELSGNYEQYF,1,0,1,1
TRBV6-1,TRBJ1-1,CASSEEGGDTEAFF,1,0,1,1
TRBV7-9,TRBJ1-2,CASSSRGPGSGYTF,1,0,1,1
TRBV2,TRBJ1-2,CASSRRGFGYGYTF,1,0,1,1
TRBV6-2/3/5/6,TRBJ2-1,CASSFFTGDNEQFF,1,0,1,1
TRBV11-2,TRBJ1-5,CASSFLGSGQPQHF,1,0,1,1
TRBV7-6,TRBJ1-5,CASSFGGRNQPQHF,1,0,1,1
TRBV5-4,TRBJ1-1,CASSFSLGNTEAFF,1,0,1,1
TRBV7-9,TRBJ2-3,CASSFVGPTDAQYF,1,0,1,1
TRBV7-2,TRBJ1-5,CASSFAREGQPQHF,1,0,1,1
TRBV7-8,TRBJ2-7,CASSFGTGGNEQYF,1,0,1,1
TRBV11-1,TRBJ2-2,CASSFGTGTGELFF,1,0,1,1
TRBV5-6,TRBJ1-2,CASSFGQAQGGYTF,1,0,1,1
TRBV5-4,TRBJ1-1,CASSFTGGRTEAFF,1,0,1,1
TRBV5-4,TRBJ2-1,CASSLSGHYNEQFF,1,0,1,1
TRBV5-5,TRBJ1-1,CASSLWGENPEAFF,1,0,1,1
TRBV11-2,TRBJ2-2,CASSLLQAPGELFF,1,0,1,1
TRBV5-6,TRBJ2-4,CASSLPGGDGIQYF,1,0,1,1
TRBV11-2,TRBJ1-6,CASSLGQGNSPLHF,1,0,1,1
TRBV7-3,TRBJ2-1,CASSLTSGGNEQFF,1,0,1,1
TRBV7-9,TRBJ2-1,CASSLLSAYNEQFF,1,0,1,1
TRBV7-2,TRBJ2-3,CASSLPLGVGTQYF,1,0,1,1
TRBV5-5,TRBJ1-1,CASSLRDVDTEAFF,1,0,1,1
TRBV7-9,TRBJ1-3,CASSLQRSGNTIYF,1,0,1,1
TRBV7-9,TRBJ2-3,CASSLAWGRDTQYF,1,0,1,1
TRBV7-2,TRBJ1-2,CASSLARGTSGYTF,1,0,1,1
TRBV7-9,TRBJ1-2,CASSLAGVDYGYTF,1,0,1,1
TRBV7-8,TRBJ2-7,CASSLGYQRYEQYF,1,0,1,1
TRBV7-8,TRBJ2-5,CASSLGTNQETQYF,1,0,1,1
TRBV7-6,TRBJ1-6,CASSLGQDNSPLHF,1,0,1,1
TRBV7-3,TRBJ2-3,CASSLDDRTDTQYF,1,0,1,1
TRBV11-2,TRBJ2-7,CASSLDVTTYEQYL,1,0,1,1
TRBV7-2,TRBJ2-1,CASSLRQGGGEQFF,1,1,2,2
TRBV11-2,TRBJ2-1,CASSLRPGLYEQFF,1,0,1,1
TRBV7-3,TRBJ2-1,CASSLNWGYNEQFF,1,0,1,1
TRBV7-9,TRBJ1-6,CASSSRDRVAPLHF,1,0,1,1
TRBV11-2,TRBJ1-5,CASSSGQGNQPQHF,1,0,1,1
TRBV5-4,TRBJ1-2,CASSSGQTVYGYTF,1,0,1,1
TRBV7-6,TRBJ2-7,CASSSSGDNYEQYF,1,0,1,1
TRBV5-6,TRBJ2-2,CASSSGVGFGELFF,1,0,1,1
TRBV5-6,TRBJ1-2,CASSSGQGARGYTF,1,1,2,2
TRBV5-6,TRBJ1-1,CASSWQGPNTEAFF,1,0,1,1
TRBV28,TRBJ2-4,CASSYLGVANIQYF,1,0,1,1
TRBV5-4,TRBJ1-1,CASSYQDRDPEAFF,1,0,1,1
TRBV5-5,TRBJ2-7,CASSYGGMGYEQYF,1,0,1,1
TRBV28,TRBJ1-6,CASSYRNPNSPLHF,1,0,1,1
TRBV7-9,TRBJ1-4,CASSLTGAGEKLFF,1,0,1,1
TRBV5-6,TRBJ2-5,CASSLRTLEETQYF,1,0,1,1
TRBV7-9,TRBJ1-1,CASSPGRLNTEAFF,1,0,1,1
TRBV28,TRBJ1-3,CASSPRVSRNTIYF,1,0,1,1
TRBV7-9,TRBJ2-7,CASSPNRGPYEQYF,1,0,1,1
TRBV7-2,TRBJ2-3,CASSPGLAVDAQYF,1,0,1,1
TRBV7-2,TRBJ2-7,CASSPELLPYEQYF,1,0,1,1
TRBV2,TRBJ1-3,CASSPQGGGNTIYF,1,0,1,1
TRBV7-3,TRBJ2-5,CASSPGGGGETQYF,1,0,1,1
TRBV3-1,TRBJ1-4,CASSRGQINEKLFF,1,0,1,1
TRBV5-5,TRBJ2-7,CASSRDPLGYEQYF,1,0,1,1
TRBV7-2,TRBJ1-5,CASSHPGLDQPQHF,1,0,1,1
TRBV3-1,TRBJ2-1,CASSQRTVNNEQFF,1,0,1,1
TRBV14,TRBJ1-4,CASSQDRVNEKLFF,1,0,1,1
TRBV7-9,TRBJ1-1,CASSQQGINTEAFF,1,0,1,1
TRBV4-2,TRBJ2-2,CASSQQEVTGELFF,1,0,1,1
TRBV3-1,TRBJ2-1,CASSQVSAYNEQFF,1,0,1,1
TRBV4-2,TRBJ2-5,CASSQGFGQETQYL,1,0,1,1
TRBV4-2,TRBJ2-2,CASSQDSRTGELFF,1,0,1,1
TRBV3-1,TRBJ2-1,CASSQDGQGFEQFF,1,0,1,1
TRBV3-1,TRBJ2-1,CASSQTPDYNEQFF,1,0,1,1
TRBV16,TRBJ2-7,CASSQTGQGYEQYF,1,0,1,1
TRBV7-9,TRBJ2-5,CASSVPGGWETQYF,1,0,1,1
TRBV9,TRBJ2-3,CASSVVGFTDTQYF,1,0,1,1
TRBV9,TRBJ1-1,CASSAGTVNTEAFF,1,0,1,1
TRBV7-9,TRBJ2-1,CASSGLSSYNEQFF,1,0,1,1
TRBV7-2,TRBJ1-5,CASSGYEYSQPQHF,1,0,1,1
TRBV7-9,TRBJ1-4,CASSGDHSNEKLFF,1,0,1,1
TRBV11-3,TRBJ1-1,CASSERHWSTEAFF,1,0,1,1
TRBV5-4,TRBJ2-5,CASSIYRESETQYF,1,0,1,1
TRBV12-3/4,TRBJ2-7,CASSTGQRVYEQYF,1,0,1,1
TRBV3-1,TRBJ1-4,CASSSGSDNEKLLF,1,0,1,1
TRBV6-2/3/5/6,TRBJ1-2,CASSKDSVWYGYTF,1,0,1,1
TRBV7-3,TRBJ2-2,CASSKGLASGELFF,1,0,1,1
TRBV5-6,TRBJ2-7,CASSKGHAPYEQYF,1,0,1,1
TRBV6-2/3/5/6,TRBJ2-3,CASRLGGGADTQYF,1,0,1,1
TRBV27,TRBJ1-1,CASRPGQFYTEAFF,1,0,1,1
TRBV5-6,TRBJ2-1,CASRRDSFHNDQFF,1,0,1,1
TRBV12-3/4,TRBJ2-3,CASRGIVSTDTQYF,1,0,1,1
TRBV28,TRBJ1-4,CASRGIQGGEKLFF,1,0,1,1
TRBV19,TRBJ1-1,CASRTGEENTEAFF,1,0,1,1
TRBV7-9,TRBJ2-3,CASRNTGERDTQYF,1,0,1,1
TRBV12-3/4,TRBJ2-1,CASRLPGGYNEQFF,1,0,1,1
TRBV6-2/3/5/6,TRBJ2-7,CASRVLATAYEQYF,1,0,1,1
TRBV28,TRBJ2-7,CASNPGQGTHEQYF,1,0,1,1
TRBV28,TRBJ2-7,CASNPTDSPYEQYF,1,0,1,1
TRBV28,TRBJ1-6,CASNTQGRHSPLHF,1,0,1,1
TRBV2,TRBJ1-1,CASKLGTGNTEAFF,1,0,1,1
TRBV5-1,TRBJ1-1,CASSRTGENTEAFF,1,0,1,1
TRBV5-1,TRBJ1-5,CASSSGRGGGPQHF,1,0,1,1
TRBV12-3/4,TRBJ2-7,CASSPGQGNYEQYF,1,0,1,1
TRBV5-1,TRBJ2-5,CASSPGQPGETQYF,1,0,1,1
TRBV5-1,TRBJ2-2,CASSGAANTGGLFF,1,0,1,1
TRBV5-1,TRBJ2-7,CASSFEGQRYEQYF,1,0,1,1
TRBV5-1,TRBJ2-3,CASSLFEPPDTQYF,1,0,1,1
TRBV5-1,TRBJ2-1,CASSLVLDYNEQFF,1,0,1,1
TRBV5-1,TRBJ2-1,CASSLVGPRGEQFF,1,0,1,1
TRBV5-1,TRBJ1-1,CASSLGDTRNVAFF,1,0,1,1
TRBV5-1,TRBJ1-1,CASSLIDGGTEAFF,1,0,1,1
TRBV5-1,TRBJ2-2,CASSLNGGTGELFF,1,0,1,1
TRBV5-1,TRBJ1-2,CASSSRQGNYGYTF,1,0,1,1
TRBV5-1,TRBJ1-2,CASSSTAVGTPGAF,1,0,1,1
TRBV4-1,TRBJ2-5,CASSLVTAAETQYF,1,0,1,1
TRBV5-1,TRBJ2-7,CASSLGQGPYEQYF,1,0,1,1
TRBV5-1,TRBJ1-1,CASSLGGITAEAFF,1,0,1,1
TRBV5-1,TRBJ2-5,CASSLTGGEETQYF,1,0,1,1
TRBV5-1,TRBJ2-1,CASSPLDLYNEQFF,1,0,1,1
TRBV5-1,TRBJ1-1,CASSPDRPNTEAFF,1,0,1,1
TRBV5-1,TRBJ2-1,CASSPGGARDELFF,1,0,1,1
TRBV5-1,TRBJ2-1,CASSPGTPRGEQFF,1,0,1,1
TRBV5-1,TRBJ1-1,CASSHHGQNTEAFF,1,0,1,1
TRBV4-1,TRBJ1-2,CASSHGGSNYGYTF,1,0,1,1
TRBV4-1,TRBJ2-3,CASSQTSGADTQYF,1,0,1,1
TRBV4-1,TRBJ1-1,CASSQYSTHTEAFF,1,0,1,1
TRBV4-1,TRBJ2-1,CASSQDFRGLALHV,1,0,1,1
TRBV4-1,TRBJ2-7,CASSQDGLAPEQYF,1,0,1,1
TRBV4-1,TRBJ2-3,CASSQEKFRDTQYF,1,0,1,1
TRBV5-1,TRBJ2-7,CASSVQGSSYEQYF,1,0,1,1
TRBV4-1,TRBJ2-1,CASSARQGNNEQFF,1,0,1,1
TRBV4-1,TRBJ1-1,CASRQGAGTTEAFF,1,0,1,1
TRBV5-1,TRBJ2-3,CASRRTERTDTQYF,1,0,1,1
TRBV20-1,TRBJ2-2,CGAHGLASTGELFF,1,0,1,1
TRBV5-1,TRBJ2-5,CTSSMGGPRAAQYF,1,0,1,1
TRBV20-1,TRBJ2-3,CSASKQRGADTQYF,1,0,1,1
TRBV20-1,TRBJ2-3,CSAWTSGGTDTQYF,1,0,1,1
TRBV20-1,TRBJ2-1,CSAIISGGANEQFF,1,0,1,1
TRBV20-1,TRBJ1-2,CSASPVLGGSGYTF,1,0,1,1
TRBV20-1,TRBJ1-6,CSASEDSPNSPLRF,1,0,1,1
TRBV20-1,TRBJ2-3,CSARLAGGSDTQYF,1,0,1,1
TRBV20-1,TRBJ2-5,CSARWTSGQETQYF,1,0,1,1
TRBV20-1,TRBJ2-2,CSARVRGADGELFF,1,0,1,1
TRBV20-1,TRBJ1-5,CSARAQGGAQPQHF,1,0,1,1
TRBV20-1,TRBJ2-4,CSANPQGAKNIQYF,1,0,1,1
TRBV20-1,TRBJ1-3,CSAPDRNSGNTIYF,1,0,1,1
TRBV20-1,TRBJ1-5,CSATTGISNQPQHF,1,0,1,1
TRBV29-1,TRBJ2-3,CSVSVGSAGDTQYF,1,0,1,1
TRBV29-1,TRBJ2-2,CSVRASGNTGELFF,1,0,1,1
TRBV29-1,TRBJ2-7,CSVVTVLSSYEQYF,1,0,1,1
TRBV29-1,TRBJ1-1,CSVAQGASVTEAFF,1,0,1,1
TRBV29-1,TRBJ2-5,CSVGVGLWEETQYF,1,0,1,1
TRBV29-1,TRBJ2-3,CSVGRAQSTDTQYF,1,0,1,1
TRBV29-1,TRBJ2-3,CSVGPGTSSDTQYF,1,0,1,1
TRBV29-1,TRBJ2-1,CSVDSMISYDEQFF,1,0,1,1
TRBV29-1,TRBJ1-2,CSVDMDRGVYGYTF,1,0,1,1
TRBV29-1,TRBJ2-2,CSVEQGLNTGELFF,1,0,1,1
TRBV29-1,TRBJ1-5,CSVRLGGPNQPQHF,1,0,1,1
TRBV29-1,TRBJ2-5,CSVYSDTDQETQYF,1,0,1,1
TRBV29-1,TRBJ2-3,CSAPLRGTTDTQYF,1,0,1,1
TRBV29-1,TRBJ2-3,CSARTELSTDTQYF,1,0,1,1
TRBV29-1,TRBJ2-3,CSAQRGIYPDTQYF,1,0,1,1
TRBV29-1,TRBJ2-1,CSAGGPESHNEQFF,1,0,1,1
TRBV29-1,TRBJ1-4,CSATTGGTSEKLFF,1,1,2,2
TRBV29-1,TRBJ1-1,CSGGTPDPDTEAFF,1,0,1,1
TRBV29-1,TRBJ1-1,CSGLFGPSNTEAFF,1,0,1,1
TRBV29-1,TRBJ2-1,CSGVGGSYYNEQFF,1,0,1,1
TRBV29-1,TRBJ2-1,CSGDLATSYNEQFF,1,0,1,1
TRBV3-1,TRBJ2-1,YASSQSRDVGEQFF,1,0,1,1
TRBV9,TRBJ2-3,GASSGRRSTDTQYF,1,0,1,1
TRBV7-2,TRBJ2-5,CASRLAGGKTQYF,1,0,1,1
TRBV12-5,TRBJ2-3,CASGLQLAGAQYY,1,0,1,1
TRBV12-5,TRBJ2-7,CASGRDGPHEQYF,1,0,1,1
TRBV30,TRBJ1-1,CAWDQAANTEAFF,1,0,1,1
TRBV30,TRBJ2-5,CAWSVRVRETQYF,1,0,1,1
TRBV30,TRBJ1-5,CAWSVNADQPQHF,1,0,1,1
TRBV30,TRBJ1-1,CAWSGLANTEAFF,1,0,1,1
TRBV30,TRBJ2-1,CAWSGGTYNEQFF,1,0,1,1
TRBV30,TRBJ2-3,CAWSSGGTDTQYF,1,0,1,1
TRBV30,TRBJ2-1,CAWSRGFDNEQFF,1,0,1,1
TRBV30,TRBJ2-2,CAWKRGSDGELFF,1,0,1,1
TRBV10-3,TRBJ1-5,CAIRDRGNQPQHF,1,1,2,2
TRBV10-3,TRBJ2-1,CAISGSSGDGQFF,1,0,1,1
TRBV2,TRBJ1-3,CATQDLPGNTIYF,1,0,1,1
TRBV24-1,TRBJ2-3,CATDGGYTDTQYF,1,0,1,1
TRBV24-1,TRBJ1-1,CATSDSHRFEAFF,1,0,1,1
TRBV19,TRBJ1-1,CASSFAGEAEAFF,1,0,1,1
TRBV19,TRBJ1-1,CASSPRGGTEAFF,1,0,1,1
TRBV19,TRBJ1-2,CASSIYGGYGYTF,1,0,1,1
TRBV19,TRBJ1-1,CASSIRRGTEAFF,1,0,1,1
TRBV19,TRBJ1-5,CASSIGAPPSQLF,1,0,1,1
TRBV19,TRBJ2-1,CASSTWAYNEQFF,1,0,1,1
TRBV19,TRBJ1-1,CASSTARNTEAFF,1,0,1,1
TRBV19,TRBJ2-2,CASSTDRDGELFF,1,0,1,1
TRBV19,TRBJ2-7,CASSRGTLYEQYF,1,0,1,1
TRBV19,TRBJ2-4,CASSIYRGNIQYF,1,0,1,1
TRBV19,TRBJ1-5,CASRAQGIQPQHF,1,0,1,1
TRBV19,TRBJ1-2,CASNTDRDYGYTF,1,0,1,1
TRBV18,TRBJ1-3,CASSADRGNTIYF,1,0,1,1
TRBV18,TRBJ1-5,CASSTSKNQPQHF,1,0,1,1
TRBV18,TRBJ1-1,CASSLQTNTEAFF,1,0,1,1
TRBV18,TRBJ2-5,CASSPQDQETQYF,1,0,1,1
TRBV18,TRBJ2-3,CASSPVTRDTQYF,1,0,1,1
TRBV18,TRBJ2-5,CASSPGYQETQYF,1,0,1,1
TRBV18,TRBJ1-1,CASSAGTGLEAFF,1,0,1,1
TRBV6-2/3/5/6,TRBJ1-1,CASWSDGNTEAFF,1,0,1,1
TRBV12-3/4,TRBJ2-3,CASLGQGQDTQYF,1,1,2,2
TRBV12-3/4,TRBJ2-7,CASGRQGINELYF,1,0,1,1
TRBV2,TRBJ2-3,CASGGLAGDTQYF,1,0,1,1
TRBV7-9,TRBJ2-1,CASGGQGLNEQFF,1,0,1,1
TRBV12-3/4,TRBJ1-5,CASGTGTNQPQHF,1,0,1,1
TRBV2,TRBJ2-2,CASDGADTGELFF,1,0,1,1
TRBV5-4,TRBJ2-1,CASEAGSYNEQFF,1,0,1,1
TRBV6-1,TRBJ1-1,CASIGQGVTEAFF,1,0,1,1
TRBV28,TRBJ1-2,CASITGAFDGYSF,1,0,1,1
TRBV12-3/4,TRBJ1-3,CASTLVAGNTIYF,1,0,1,1
TRBV28,TRBJ2-3,CASTPTSADTQYF,1,0,1,1
TRBV28,TRBJ1-5,CASSFSSNQPQHF,1,1,2,2
TRBV12-3/4,TRBJ1-1,CASSLIQGTEAFF,1,0,1,1
TRBV12-3/4,TRBJ2-5,CASSLLLAETQYF,1,0,1,1
TRBV12-3/4,TRBJ2-7,CASSLRGAREQYF,1,0,1,1
TRBV12-3/4,TRBJ1-5,CASSLARGQPQHF,1,0,1,1
TRBV7-9,TRBJ1-1,CASSLGVNTEAFF,1,1,2,2
TRBV28,TRBJ1-4,CASSSGGAEKLFF,1,0,1,1
TRBV6-2/3/5/6,TRBJ1-2,CASSSGHTYGYTL,1,0,1,1
TRBV28,TRBJ1-2,CASSYSNQYGYTF,1,0,1,1
TRBV6-2/3/5/6,TRBJ2-7,CASSYSKGYEQYF,1,0,1,1
TRBV6-2/3/5/6,TRBJ1-6,CASSYWGDSHLHF,1,0,1,1
TRBV6-2/3/5/6,TRBJ1-1,CASSYDRNTEAFF,1,0,1,1
TRBV27,TRBJ2-1,CASSLWSDNEQFF,1,0,1,1
TRBV6-2/3/5/6,TRBJ1-2,CASSLAGQGVYTF,1,0,1,1
TRBV28,TRBJ2-2,CASSPQPTGELFF,1,0,1,1
TRBV12-3/4,TRBJ1-2,CASSEGQGTGYTF,1,0,1,1
TRBV6-1,TRBJ2-1,CASSEGRRGEQFF,1,0,1,1
TRBV28,TRBJ1-5,CASSETGLQPQHF,1,0,1,1
TRBV28,TRBJ2-5,CASSTDAGETQYF,1,0,1,1
TRBV12-3/4,TRBJ1-1,CASSTYTNTEAFF,1,0,1,1
TRBV12-3/4,TRBJ1-1,CASSKNRDAEAFF,1,0,1,1
TRBV5-6,TRBJ1-1,CASSFWVDTEAFF,1,0,1,1
TRBV11-2,TRBJ1-1,CASSFQGRNEAFF,1,0,1,1
TRBV11-2,TRBJ2-7,CASSFDFGQEQYF,1,0,1,1
TRBV11-3,TRBJ2-1,CASSFSSGDEQFF,1,0,1,1
TRBV7-9,TRBJ2-2,CASSFKITGELFF,1,0,1,1
TRBV7-9,TRBJ2-2,CASSLLNTGELFF,1,0,1,1
TRBV5-6,TRBJ2-1,CASSLGGDNEQFF,1,0,1,1
TRBV5-6,TRBJ1-2,CASSLSVNSVYTF,1,0,1,1
TRBV7-2,TRBJ2-7,CASSLYTGYEQYF,1,0,1,1
TRBV7-3,TRBJ2-1,CASSLPSSDEQFF,1,0,1,1
TRBV11-2,TRBJ1-5,CASSLPGNQPQHF,1,0,1,1
TRBV7-9,TRBJ2-3,CASSLPTSFAQYF,1,0,1,1
TRBV11-2,TRBJ2-2,CASSLRRAGELFF,1,0,1,1
TRBV7-9,TRBJ2-7,CASSLAQGYEQYF,1,0,1,1
TRBV7-9,TRBJ2-7,CASSLGEGGSLHF,1,0,1,1
TRBV7-2,TRBJ1-2,CASSLGAVYVYTF,1,0,1,1
TRBV11-2,TRBJ2-1,CASSLGAQREQFF,1,0,1,1
TRBV7-9,TRBJ1-6,CASSLEYNSPLHF,1,0,1,1
TRBV7-3,TRBJ1-1,CASSLSPNTEAFF,1,0,1,1
TRBV6-2/3/5/6,TRBJ2-5,CASSSRLQETQYF,1,0,1,1
TRBV7-3,TRBJ1-1,CASSSGMNTEAFF,1,0,1,1
TRBV11-1,TRBJ1-1,CASSLDLNTDAFL,1,0,1,1
TRBV7-9,TRBJ1-2,CASSLDRNYGYTF,1,0,1,1
TRBV7-9,TRBJ2-5,CASSLIGAETQYF,1,0,1,1
TRBV7-3,TRBJ2-7,CASSPRQGDEQYL,1,0,1,1
TRBV13,TRBJ2-7,CASSPQGGDEQYF,1,0,1,1
TRBV7-8,TRBJ2-5,CASSPLSSWVQYF,1,0,1,1
TRBV7-9,TRBJ1-2,CASSPQKDRGYTF,1,0,1,1
TRBV7-2,TRBJ2-7,CASSPRYEGEQYF,1,0,1,1
TRBV7-3,TRBJ2-5,CASSPRPQETQYF,1,0,1,1
TRBV14,TRBJ1-6,CASSPMAGSSLHF,1,0,1,1
TRBV7-9,TRBJ2-7,CASSPIPGLEQYF,1,0,1,1
TRBV3-1,TRBJ1-2,CASSRPYPYGYTF,1,0,1,1
TRBV7-9,TRBJ2-1,CASSRGTASEQFF,1,0,1,1
TRBV14,TRBJ2-7,CASSRAGLSEQYF,1,0,1,1
TRBV6-2/3/5/6,TRBJ2-7,CASSRDGGYEQYF,1,0,1,1
TRBV6-2/3/5/6,TRBJ2-1,CASSRDRNNEQFF,1,0,1,1
TRBV7-6,TRBJ1-1,CASSHDLNTEAFF,1,0,1,1
TRBV28,TRBJ1-1,CASSQLMNTEAFF,1,0,1,1
TRBV16,TRBJ1-1,CASSQPSGSEAFF,1,0,1,1
TRBV14,TRBJ1-5,CASSQEGGQPQHF,1,0,1,1
TRBV7-9,TRBJ1-1,CASSVGTATEAFF,1,0,1,1
TRBV9,TRBJ1-3,CASSVDRLDTIYL,1,0,1,1
TRBV11-2,TRBJ1-4,CASSAQGSEKLFF,1,0,1,1
TRBV9,TRBJ2-7,CASSAGGLGEQYF,1,0,1,1
TRBV7-3,TRBJ1-2,CASSAERQYGYTF,1,1,2,2
TRBV9,TRBJ1-2,CASSETGGYGYTF,1,0,1,1
TRBV7-6,TRBJ1-1,CASSTRQGFTAFF,1,0,1,1
TRBV11-2,TRBJ2-7,CASSTEREREQYF,1,0,1,1
TRBV7-2,TRBJ2-7,CASSSGGAYEQYF,1,0,1,1
TRBV28,TRBJ2-2,CASRSGFTGELFF,1,0,1,1
TRBV6-2/3/5/6,TRBJ2-7,CASRRQVAYEQYF,1,0,1,1
TRBV6-2/3/5/6,TRBJ1-2,CASRMDQNYGYTF,1,0,1,1
TRBV28,TRBJ2-5,CASRNAEAETQYF,1,0,1,1
TRBV2,TRBJ1-5,CASRPDSLQPQHF,1,0,1,1
TRBV6-2/3/5/6,TRBJ1-6,CASRPGPGSPLHF,1,0,1,1
TRBV7-9,TRBJ1-2,CASRGGQGHGYTF,1,0,1,1
TRBV3-1,TRBJ1-2,CASRKTAGGGYTY,1,0,1,1
TRBV2,TRBJ2-4,CASNGQTKNIQYF,1,0,1,1
TRBV4-1,TRBJ1-1,CASRLAGGPEAFF,1,0,1,1
TRBV4-1,TRBJ2-7,CASTHRGAYEQYF,1,0,1,1
TRBV4-1,TRBJ2-2,CASSPSQFGELFF,1,0,1,1
TRBV5-1,TRBJ2-3,CASSQGSTDTQYF,1,0,1,1
TRBV10-2,TRBJ2-7,CASSAGQALEQYF,1,0,1,1
TRBV10-2,TRBJ1-5,CASSDPGAQPQHF,1,0,1,1
TRBV5-1,TRBJ1-1,CASSFNRNTEAFF,1,0,1,1
TRBV5-1,TRBJ1-5,CASSFGTDQPQHF,1,0,1,1
TRBV5-1,TRBJ1-2,CASSLFEGYGYTF,1,0,1,1
TRBV5-1,TRBJ2-2,CASSLALREELFF,1,0,1,1
TRBV5-1,TRBJ1-2,CASSLDRDYGYTF,1,0,1,1
TRBV5-1,TRBJ2-7,CASSLTQEYEQYF,1,0,1,1
TRBV5-1,TRBJ2-4,CASSSLAKNIQYF,1,0,1,1
TRBV5-1,TRBJ1-1,CASSWGENTEAFF,1,0,1,1
TRBV5-1,TRBJ1-6,CASSRDSNSPLHF,1,0,1,1
TRBV4-1,TRBJ2-1,CASSQDRDTSVFF,1,0,1,1
TRBV4-1,TRBJ2-1,CASSQELAREQFF,1,0,1,1
TRBV4-1,TRBJ2-1,CASSQIDPPEQFF,1,0,1,1
TRBV5-1,TRBJ2-7,CASSVADRGEQYF,1,0,1,1
TRBV10-1,TRBJ1-5,CASSGSGDQPQHF,1,0,1,1
TRBV5-1,TRBJ2-3,CASSGTSTDTQYF,1,0,1,1
TRBV5-1,TRBJ1-1,CASSGGQGTEAFF,1,0,1,1
TRBV5-1,TRBJ2-7,CASSGDREGEQYF,1,0,1,1
TRBV5-1,TRBJ2-6,CASSIDGANVLTF,1,0,1,1
TRBV5-1,TRBJ2-7,CASRGTGRYEQYF,1,0,1,1
TRBV29-1,TRBJ1-1,CTTRAAANTEAFF,1,0,1,1
TRBV20-1,TRBJ2-3,CSVDRQGADTQYF,1,0,1,1
TRBV20-1,TRBJ1-5,CSAARQGNQPQHF,1,0,1,1
TRBV20-1,TRBJ1-5,CSAGWDRHQPLHF,1,0,1,1
TRBV20-1,TRBJ2-7,CSAEGDGSYEQYF,1,0,1,1
TRBV20-1,TRBJ1-2,CSAIPRGGYGHTF,1,0,1,1
TRBV20-1,TRBJ2-1,CSATWSGVDEQFF,1,0,1,1
TRBV20-1,TRBJ2-3,CSATTGITDTQYF,1,0,1,1
TRBV20-1,TRBJ2-1,CSASGLAEDEQFF,1,0,1,1
TRBV20-1,TRBJ1-1,CSASTQMNTEAFF,1,0,1,1
TRBV20-1,TRBJ1-6,CSARTGDDSPLHF,1,0,1,1
TRBV20-1,TRBJ1-2,CSARFTGAGGYTF,1,0,1,1
TRBV20-1,TRBJ2-5,CSARLGFQETQYF,1,0,1,1
TRBV20-1,TRBJ2-7,CSARLGQTNEQYF,1,0,1,1
TRBV20-1,TRBJ1-1,CSARDLLNTEAFF,1,0,1,1
TRBV20-1,TRBJ1-4,CSAKGAGDEKLFF,1,0,1,1
TRBV20-1,TRBJ1-2,CSAPRAPSDGYTF,1,0,1,1
TRBV20-1,TRBJ1-2,CSAERQGATGYTF,1,0,1,1
TRBV29-1,TRBJ2-3,CSSRGQNTDTQYF,1,0,1,1
TRBV29-1,TRBJ2-7,CSVYRDSTYEQYF,1,0,1,1
TRBV29-1,TRBJ2-1,CSVLQARGNEQFF,1,0,1,1
TRBV29-1,TRBJ1-1,CSVVRALNTEAFF,1,0,1,1
TRBV29-1,TRBJ2-1,CSVGSGEDNEQFF,1,0,1,1
TRBV29-1,TRBJ2-7,CSVGYGEGYEQYF,1,0,1,1
TRBV29-1,TRBJ2-1,CSVGLATINEQFF,1,0,1,1
TRBV29-1,TRBJ1-3,CSVGGGVGNTIYF,1,0,1,1
TRBV29-1,TRBJ2-5,CSVGKQEQETQYF,1,0,1,1
TRBV29-1,TRBJ1-4,CSVDEQGGEKLFF,1,0,1,1
TRBV29-1,TRBJ1-4,CSVEAVGSGKLFF,1,0,1,1
TRBV29-1,TRBJ2-1,CSVEEGAWNEQFF,1,0,1,1
TRBV29-1,TRBJ1-4,CSVEEGAEEKLFF,1,0,1,1
TRBV29-1,TRBJ2-7,CSVSNQAGYEQYF,1,0,1,1
TRBV29-1,TRBJ2-1,CSVPLGGLNEQFF,1,0,1,1
TRBV29-1,TRBJ2-7,CSVNARTGTEQYF,1,0,1,1
TRBV29-1,TRBJ2-7,CSVTDRTFYEQYF,1,0,1,1
TRBV29-1,TRBJ2-5,CSVHRRQRGTQYF,1,0,1,1
TRBV29-1,TRBJ1-1,CSVGQGANTEAFF,1,0,1,1
TRBV29-1,TRBJ1-1,CSVRTDPNTEAFF,1,0,1,1
TRBV29-1,TRBJ1-5,CSAGTGDGQPQHF,1,0,1,1
TRBV29-1,TRBJ1-1,CSAPGTAGTEAFF,1,0,1,1
TRBV29-1,TRBJ2-1,CSAGTSHSNEQFF,1,0,1,1
TRBV29-1,TRBJ2-7,CSAGTLHSYEQYF,1,0,1,1
TRBV29-1,TRBJ2-6,CSADTGTADVLTF,1,0,1,1
TRBV29-1,TRBJ2-7,CSAGNQEPYEQYF,1,1,2,2
TRBV29-1,TRBJ1-1,CSGWTGVNTEAFF,1,0,1,1
TRBV29-1,TRBJ2-5,CSGGTAHGETQYF,1,0,1,1
TRBV20-1,TRBJ2-3,CRAGQGKTDTQYF,1,0,1,1
TRBV11-2,TRBJ2-1,RASSLDQVNEQFF,1,0,1,1
TRBV30,TRBJ1-2,CAWSGGNYGYTF,1,0,1,1
TRBV30,TRBJ1-6,CAWRGSRSPLHF,1,0,1,1
TRBV10-3,TRBJ1-4,CAMGDPNEKLFF,1,0,1,1
TRBV28,TRBJ2-7,CATSWGFYEQYF,1,0,1,1
TRBV24-1,TRBJ2-1,CATSDVYNEQFF,1,0,1,1
TRBV19,TRBJ1-2,CASSPGTGVYTF,1,0,1,1
TRBV19,TRBJ1-4,CASSVPPEKLFF,1,0,1,1
TRBV19,TRBJ2-3,CASSIVTGAQYF,1,0,1,1
TRBV18,TRBJ2-7,CASSLPGNEQYF,1,0,1,1
TRBV18,TRBJ1-3,CASSRATGTIYF,1,0,1,1
TRBV18,TRBJ1-5,CASSPRDGPQHF,1,0,1,1
TRBV18,TRBJ2-3,CASSPYADTQYF,1,0,1,1
TRBV18,TRBJ1-1,CASSPPRGEAFF,1,0,1,1
TRBV7-2,TRBJ2-5,CASGRGQETQYF,1,0,1,1
TRBV5-4,TRBJ1-1,CASGWQNTEAFF,1,0,1,1
TRBV28,TRBJ1-3,CASTQNGDTIYF,1,0,1,1
TRBV12-3/4,TRBJ2-5,CASSLWQETQYF,1,0,1,1
TRBV6-2/3/5/6,TRBJ2-7,CASSLPGYEQYF,1,0,1,1
TRBV7-3,TRBJ2-1,CASSSSGVEQFF,1,0,1,1
TRBV6-2/3/5/6,TRBJ2-7,CASSYSLREQYF,1,0,1,1
TRBV6-2/3/5/6,TRBJ1-1,CASSYDLREAFL,1,0,1,1
TRBV28,TRBJ2-1,CASSPSSANPFF,1,0,1,1
TRBV2,TRBJ2-1,CASSVLGDEQFF,1,0,1,1
TRBV28,TRBJ2-1,CASSGPLRGPFF,1,0,1,1
TRBV2,TRBJ2-3,CASSGGTDTQYF,1,0,1,1
TRBV6-4,TRBJ2-7,CASSESGYEQYF,1,0,1,1
TRBV6-1,TRBJ1-4,CASSEMGEKLFF,1,0,1,1
TRBV6-2/3/5/6,TRBJ2-7,CASSSVGREQYF,1,0,1,1
TRBV28,TRBJ2-1,CASSRRGNEQFF,1,0,1,1
TRBV7-9,TRBJ1-1,CASSFDRAEAFF,1,0,1,1
TRBV5-5,TRBJ1-5,CASSFPNQPQHF,1,0,1,1
TRBV5-8,TRBJ2-1,CASSLVGVEQFF,1,0,1,1
TRBV5-8,TRBJ2-1,CASSLGGNEQFF,1,0,1,1
TRBV5-6,TRBJ2-1,CASSLEVNEQFF,1,0,1,1
TRBV5-6,TRBJ2-7,CASSLSFYEQYF,1,0,1,1
TRBV7-9,TRBJ1-2,CASSLRSYGYTF,1,0,1,1
TRBV7-9,TRBJ2-5,CASSLVGETQYF,1,1,2,2
TRBV11-2,TRBJ2-1,CASSLGGDEQFF,1,0,1,1
TRBV7-9,TRBJ2-7,CASSLGSHEQYF,1,1,2,2
TRBV7-9,TRBJ1-2,CASSLDVSGYTF,1,0,1,1
TRBV7-3,TRBJ2-1,CASSLDLNEQFF,1,0,1,1
TRBV11-2,TRBJ2-2,CASSLTRSELFF,1,0,1,1
TRBV7-9,TRBJ2-7,CASSSFGHEQYF,1,0,1,1
TRBV7-9,TRBJ1-5,CASSSNDQPQHF,1,0,1,1
TRBV5-6,TRBJ1-2,CASSLDAGGYTF,1,0,1,1
TRBV3-1,TRBJ2-3,CASSLERYTQYF,1,0,1,1
TRBV7-9,TRBJ2-1,CASSLIINEQFF,1,0,1,1
TRBV7-2,TRBJ2-3,CASSPRTDTQYF,1,0,1,1
TRBV7-9,TRBJ1-5,CASSRGDQPQHF,1,0,1,1
TRBV7-9,TRBJ1-6,CASSRRGSPLHF,1,0,1,1
TRBV3-1,TRBJ2-7,CASSHGEGRGYF,1,0,1,1
TRBV3-1,TRBJ2-1,CASSQGNNEQFF,1,0,1,1
TRBV9,TRBJ2-3,CASSVDGDTQYF,1,0,1,1
TRBV2,TRBJ2-1,CASSEVLNEQFF,1,0,1,1
TRBV6-2/3/5/6,TRBJ2-7,CASSRDSYEQYF,1,0,1,1
TRBV28,TRBJ2-7,CASRTGVFEQYF,1,0,1,1
TRBV2,TRBJ1-2,CASRQGGYGYTF,1,0,1,1
TRBV27,TRBJ2-2,CASRTGAGELFF,1,0,1,1
TRBV28,TRBJ1-5,CASNQGNQPQHF,1,0,1,1
TRBV6-2/3/5/6,TRBJ1-5,CASKRINQPQHF,1,0,1,1
TRBV10-1,TRBJ2-7,CASSDRNYEQYF,1,0,1,1
TRBV5-1,TRBJ2-3,CASSLATDTQYF,1,0,1,1
TRBV5-1,TRBJ2-1,CASSLGGREQFF,1,0,1,1
TRBV5-1,TRBJ2-2,CASSLDVGELFF,1,0,1,1
TRBV5-1,TRBJ2-7,CASSLDRGEQYF,1,0,1,1
TRBV5-1,TRBJ2-3,CASSSRGDTQYF,1,0,1,1
TRBV4-1,TRBJ2-5,CASSQDRETQYF,1,0,1,1
TRBV4-1,TRBJ2-7,CASSQEWGEQYF,1,0,1,1
TRBV20-1,TRBJ1-2,CSAIPSLYGYTF,1,0,1,1
TRBV20-1,TRBJ1-5,CSASPGGKPQHF,1,0,1,1
TRBV20-1,TRBJ1-2,CSAPRGADGYTF,1,0,1,1
TRBV20-1,TRBJ1-4,CSAPYPNEKLFF,1,0,1,1
TRBV20-1,TRBJ2-3,CSAARSRDTQYF,1,0,1,1
TRBV20-1,TRBJ1-4,CSAPSQGEKLFF,1,0,1,1
TRBV29-1,TRBJ1-2,CSSGQGDYGYTF,1,0,1,1
TRBV29-1,TRBJ2-4,CSVYPGRNIQYF,1,0,1,1
TRBV29-1,TRBJ1-1,CSVAPGFTEAFF,1,0,1,1
TRBV29-1,TRBJ1-2,CSVEGVGAGYTF,1,0,1,1
TRBV29-1,TRBJ2-3,CSVLPDTDTQYF,1,0,1,1
TRBV29-1,TRBJ1-5,CSVGGQGQPQHF,1,0,1,1
TRBV29-1,TRBJ2-1,CSVRILAGEQFF,1,0,1,1
TRBV29-1,TRBJ2-5,CSAYQGGQTQYF,1,0,1,1
TRBV29-1,TRBJ2-5,CSAAGFGETQYF,1,0,1,1
TRBV20-1,TRBJ2-3,CSIAPSTDTQYF,1,0,1,1
TRBV29-1,TRBJ2-1,CSTGQGINEQFL,1,0,1,1
TRBV19,TRBJ1-2,CVSVTLYGYTF,1,0,1,1
TRBV12-5,TRBJ2-1,CASGFGNEQFF,1,0,1,1
TRBV30,TRBJ1-4,CACSIREKLFF,1,0,1,1
TRBV30,TRBJ1-1,CAWRGNTEAFF,1,0,1,1
TRBV19,TRBJ1-1,CATRTVHVAFL,1,0,1,1
TRBV2,TRBJ2-4,CASSAKNIQYF,1,0,1,1
TRBV7-9,TRBJ2-7,CASGRGYEQYF,1,0,1,1
TRBV6-2/3/5/6,TRBJ2-7,CASTIGNEQYF,1,0,1,1
TRBV2,TRBJ2-4,CASTQGNIQYF,1,0,1,1
TRBV6-2/3/5/6,TRBJ2-3,CASSFLDTQYY,1,0,1,1
TRBV28,TRBJ1-1,CASSLTGGAFF,1,0,1,1
TRBV12-3/4,TRBJ2-1,CASSGGVEQFF,1,0,1,1
TRBV2,TRBJ1-1,CASSILLEAFF,1,0,1,1
TRBV5-6,TRBJ2-1,CASSLGNEQFF,1,0,1,1
TRBV7-2,TRBJ2-7,CASSLALEQYF,1,0,1,1
TRBV7-2,TRBJ1-6,CASSLISPLHF,1,0,1,1
TRBV7-9,TRBJ2-7,CASSLTYEQYF,1,1,2,2
TRBV14,TRBJ2-7,CASSWGEEQYF,1,0,1,1
TRBV6-2/3/5/6,TRBJ2-1,CASSRHNEQFF,1,0,1,1
TRBV3-1,TRBJ2-7,CASSQAVEQYF,1,0,1,1
TRBV20-1,TRBJ2-1,CSVEGDRRQFF,1,0,1,1
TRBV29-1,TRBJ1-2,CSVETKNGYTF,1,0,1,1
TRBV29-1,TRBJ1-2,CSVGQPYGYTF,1,0,1,1
TRBV29-1,TRBJ2-1,CSGRRRDEQFF,1,0,1,1
TRBV30,TRBJ2-1,CAWSFDEQFF,1,0,1,1
TRBV6-2/3/5/6,TRBJ1-1,CASTGTEAFF,1,0,1,1
TRBV6-2/3/5/6,TRBJ1-4,CASSSEKLFF,1,0,1,1
TRBV20-1,TRBJ2-5,CSANSGAQYF,1,0,1,1
TRBV29-1,TRBJ2-1,CSVYQDEQFF,1,0,1,1
TRBV29-1,TRBJ2-5,CSVGEETQYF,1,0,1,1
TRBV7-3,TRBJ1-5,CAVGGPQHF,1,0,1,1
TRBV3-1,TRBJ2-2,CANTGELFF,1,0,1,1
TRBV27,TRBJ2-2,CASSLMATGGLGELFF,0,3,1,3
TRBV3-1,TRBJ1-5,CASSPGQGGQPQHF,0,1,1,1
TRBV20-1,TRBJ1-1,CSASSGTEAFF,0,2,1,2
TRBV19,TRBJ2-4,CASSRGANKNIQYF,0,2,1,2
TRBV19,TRBJ2-7,CASSGQISYEQYF,0,2,1,2
TRBV19,TRBJ1-1,CASSLGPNTEAFF,0,1,1,1
TRBV19,TRBJ1-1,CASSSRTDLNTEAFF,0,2,1,2
TRBV3-1,TRBJ2-5,CASSPQWGQETQYF,0,1,1,1
TRBV7-2,TRBJ2-7,CASSSVSYEQYF,0,2,1,2
TRBV19,TRBJ2-6,CASSIEQGAYGANVLTF,0,1,1,1
TRBV19,TRBJ2-7,CASSIRVGVKQYF,0,1,1,1
TRBV6-4,TRBJ1-2,CASTYGNYGYTF,0,1,1,1
TRBV5-1,TRBJ2-3,CASALERDTQYF,0,1,1,1
TRBV16,TRBJ2-4,CASSQTGGQNIQYF,0,1,1,1
TRBV3-1,TRBJ1-6,CASSQGQGYSSPLHF,0,1,1,1
TRBV19,TRBJ1-4,CASSIDRPRGKLFF,0,1,1,1
TRBV19,TRBJ2-5,CASSTGKQETQYF,0,1,1,1
TRBV29-1,TRBJ1-1,CSVLLARVGEAFF,0,1,1,1
TRBV14,TRBJ1-2,CASSRTGYGYTF,0,1,1,1
TRBV12-3/4,TRBJ2-2,CASSYLNSPNTGELFF,0,1,1,1
TRBV20-1,TRBJ2-3,CSARKAGVSTDTQYF,0,2,1,2
TRBV25-1,TRBJ2-2,CASSEQGFTRELFF,0,1,1,1
TRBV11-2,TRBJ2-1,CASSITSVNEQFF,0,3,1,3
TRBV12-3/4,TRBJ2-7,CASTRESYEQYF,0,1,1,1
TRBV7-3,TRBJ2-3,CASSQSGSGRGTDTQYF,0,1,1,1
TRBV20-1,TRBJ2-3,CSGTIGGGAGTDTQYF,0,2,1,2
TRBV2,TRBJ2-4,CASSLGPDTADIQYF,0,2,1,2
TRBV19,TRBJ1-5,CASSIRRGLLNQPQHF,0,1,1,1
TRBV7-8,TRBJ1-4,CASSLEGRGPTNEKLFF,0,1,1,1
TRBV2,TRBJ2-4,CASSSDSRLAKNIQYF,0,1,1,1
TRBV12-3/4,TRBJ1-1,CASSPRGSLDTEAFF,0,1,1,1
TRBV12-3/4,TRBJ1-1,CASSFEGFTEAFF,0,1,1,1
TRBV29-1,TRBJ1-4,CAGDFSEKLFF,0,1,1,1
TRBV7-3,TRBJ1-5,CGRSNQPQHF,0,1,1,1
TRBV18,TRBJ2-7,CASSPQGHTNYEQYF,0,1,1,1
TRBV19,TRBJ2-1,CASSIQARRDEQFF,0,1,1,1
TRBV19,TRBJ1-2,CASTGDSALGYGYTF,0,2,1,2
TRBV11-2,TRBJ1-1,CASSLEGGGLQKLFF,0,3,1,3
TRBV29-1,TRBJ1-1,CSVAGVKMNTEAFF,0,1,1,1
TRBV19,TRBJ2-7,CASSIRLDGPYEQYF,0,1,1,1
TRBV29-1,TRBJ2-5,CSVEVMGQGIRETQYF,0,1,1,1
TRBV29-1,TRBJ2-1,CSVTGLAGAQYNEQFF,0,3,1,3
TRBV28,TRBJ1-4,CASSFRQAPNEKLFF,0,3,1,3
TRBV5-6,TRBJ1-5,CASSIWTDHQPQHF,0,1,1,1
TRBV7-2,TRBJ1-1,CASSFHRDTEAFF,0,1,1,1
TRBV7-9,TRBJ1-5,CANEDAGQGINQPQHF,0,1,1,1
TRBV20-1,TRBJ2-3,CSASLHRGGLMDTQYF,0,1,1,1
TRBV20-1,TRBJ1-1,CSATYDRARNTEAFF,0,1,1,1
TRBV19,TRBJ1-1,CASSPQGWDTEAFF,0,2,1,2
TRBV18,TRBJ1-5,CASSASQGDQPQHF,0,1,1,1
TRBV20-1,TRBJ1-4,CSASQGFTNEKLFF,0,1,1,1
TRBV18,TRBJ1-1,CASSPFSNTEAFF,0,2,1,2
TRBV2,TRBJ2-2,CARGDRDTGELFF,0,1,1,1
TRBV29-1,TRBJ2-3,CSVVPGSTDTQYF,0,2,1,2
TRBV29-1,TRBJ1-2,CSVVLGQGSGYTF,0,1,1,1
TRBV7-3,TRBJ2-1,CASSLLGNEQFF,0,3,1,3
TRBV6-2/3/5/6,TRBJ2-1,CASSPDREQFF,0,1,1,1
TRBV5-4,TRBJ1-2,CASTPDRALYGYTF,0,1,1,1
TRBV5-6,TRBJ1-3,CASSTGFSGNTMYF,0,1,1,1
TRBV5-1,TRBJ1-5,CASSELGGSNQPQHF,0,1,1,1
TRBV7-9,TRBJ1-5,CASSLETGDQPQHF,0,3,1,3
TRBV19,TRBJ1-2,CASSLSDPADRAIYGYTF,0,1,1,1
TRBV5-1,TRBJ2-2,CASRVTGSNTGELFF,0,1,1,1
TRBV2,TRBJ1-2,CASAPHRGIVGYTF,0,1,1,1
TRBV3-1,TRBJ2-5,CASSGLAGLQTQYF,0,2,1,2
TRBV10-2,TRBJ1-1,CASSESPGQGEAFF,0,1,1,1
TRBV5-1,TRBJ1-6,CASSGGQPNSPLHF,0,1,1,1
TRBV29-1,TRBJ1-4,CSVKTGGHNEKLFF,0,1,1,1
TRBV19,TRBJ1-5,CATSQVSNQPQHF,0,1,1,1
TRBV18,TRBJ2-3,CASSPFTGDTQYF,0,1,1,1
TRBV5-1,TRBJ1-1,CASSSDRGREAFF,0,1,1,1
TRBV20-1,TRBJ2-7,CSARETGRYEQYF,0,1,1,1
TRBV5-6,TRBJ1-2,CASSLGVRDPTF,0,1,1,1
TRBV20-1,TRBJ2-4,CSANPEGVLKNIQYF,0,1,1,1
TRBV30,TRBJ2-3,CAWSVGLAGYTDTQYF,0,2,1,2
TRBV3-1,TRBJ1-2,CASSRLGRTYGYTF,0,1,1,1
TRBV2,TRBJ1-3,CASRQHLSRAGNTIHF,0,1,1,1
TRBV7-9,TRBJ1-3,CASGQTGSDTIYF,0,1,1,1
TRBV5-8,TRBJ1-1,CASSLGTGVFTEAFF,0,2,1,2
TRBV5-6,TRBJ2-1,CASSSFGTGASGRLEEQFF,0,1,1,1
TRBV5-8,TRBJ1-3,CASSSGTVYRPRGNTIYF,0,1,1,1
TRBV19,TRBJ2-7,CASSEGQPESSYEQYF,0,2,1,2
TRBV5-5,TRBJ2-5,CASSLSVQGVVETQYF,0,1,1,1
TRBV18,TRBJ2-2,CASSPGGYYTGELFF,0,2,1,2
TRBV28,TRBJ2-7,CASSLIAGGTYEQYF,0,1,1,1
TRBV27,TRBJ1-5,CASSPGRGYGQPQHF,0,1,1,1
TRBV5-4,TRBJ1-2,CASSRKQQGGYGYTF,0,1,1,1
TRBV6-1,TRBJ1-3,CASSAGRAGQDTIYF,0,1,1,1
TRBV5-1,TRBJ2-3,CASSFYRGGTDTQYF,0,1,1,1
TRBV20-1,TRBJ1-1,CSARLTGGRNTEAFF,0,1,1,1
TRBV3-1,TRBJ1-5,CASSLGGIGQPQHF,0,1,1,1
TRBV4-1,TRBJ2-7,CASSLRDSHYEQYF,0,1,1,1
TRBV20-1,TRBJ2-7,CSAPMTSGVNEQYF,0,1,1,1
TRBV29-1,TRBJ1-4,CSVDLQGSSEKLFF,0,1,1,1
TRBV30,TRBJ1-5,CAWSEGSGWPQHF,0,4,1,4
TRBV19,TRBJ2-2,CASSGGLAGELFF,0,3,1,3
TRBV6-1,TRBJ2-7,CASSEQGTYEQYF,0,1,1,1
TRBV3-1,TRBJ2-3,CASSQASDGSQYF,0,1,1,1
TRBV12-3/4,TRBJ1-5,CASNQQSNQPQHF,0,1,1,1
TRBV5-1,TRBJ2-7,CASSGGASYEQYF,0,1,1,1
TRBV29-1,TRBJ2-7,CSVDLAGGNEQYF,0,1,1,1
TRBV19,TRBJ1-1,CASSTRDRRAFF,0,1,1,1
TRBV7-9,TRBJ2-1,CASSLDWNEQFF,0,1,1,1
TRBV4-2,TRBJ2-3,CASSLSADTQYF,0,1,1,1
TRBV3-1,TRBJ1-2,CASSHGTYGYTF,0,2,1,2
TRBV28,TRBJ1-2,CASKEGYGYTF,0,1,1,1
TRBV7-3,TRBJ1-1,CASSLTLNTEAFF,0,2,1,2
TRBV5-1,TRBJ1-3,CASSLVGDQSLGNTIYF,0,1,1,1
TRBV18,TRBJ2-3,CASSLGQSTDTQYF,0,1,1,1
TRBV18,TRBJ1-5,CASSPPPLGQPQHF,0,1,1,1
TRBV29-1,TRBJ2-7,CRVEAAGTGAMGQYF,0,2,1,2
TRBV2,TRBJ2-7,CASSSQGSSYEQYF,0,2,1,2
TRBV12-5,TRBJ2-1,CASGLGTSNEQFF,0,1,1,1
TRBV20-1,TRBJ1-1,CSARETGGTEVFF,0,1,1,1
TRBV5-1,TRBJ1-4,CASSLDSANEKLFF,0,3,1,3
TRBV5-1,TRBJ2-3,CASSFFRVRDTQYF,0,2,1,2
TRBV5-8,TRBJ1-5,CASSSLRDQPQHF,0,1,1,1
TRBV19,TRBJ1-5,CASSKDRTIRGGGNQPQHF,0,1,1,1
TRBV16,TRBJ2-7,CASSEGLAGAPSYEQYF,0,1,1,1
TRBV19,TRBJ1-1,CASTIEGGTGNTEAFF,0,1,1,1
TRBV18,TRBJ1-1,CASSPSYASSYTEAFF,0,1,1,1
TRBV12-3/4,TRBJ2-7,CASSLSLAGGPYEQYF,0,1,1,1
TRBV11-2,TRBJ2-5,CASSSGTSEEVETQYF,0,3,1,3
TRBV2,TRBJ2-3,CARPGLAGGITDTQYF,0,2,1,2
TRBV20-1,TRBJ2-2,CSARDPDRGAGGELFF,0,1,1,1
TRBV10-3,TRBJ1-6,CAISGGGDSNSPLHF,0,1,1,1
TRBV7-2,TRBJ2-3,CASDWSSGGKDTQYF,0,1,1,1
TRBV28,TRBJ2-4,CASSDRSWAKNIQYF,0,1,1,1
TRBV11-2,TRBJ1-2,CASSLGSGRDYGYTF,0,1,1,1
TRBV7-9,TRBJ1-2,CASSADRGRNYGYTF,0,1,1,1
TRBV10-2,TRBJ1-3,CASSESGLFGNTIYF,0,1,1,1
TRBV20-1,TRBJ1-1,CSATPGQGASTEAFF,0,2,1,2
TRBV19,TRBJ1-6,CASSMRIYNSPLHF,0,2,1,2
TRBV18,TRBJ2-3,CASSPAGNTDTQYF,0,1,1,1
TRBV19,TRBJ1-5,CASGRGQSNQPQHF,0,1,1,1
TRBV2,TRBJ2-1,CASTETGGPYEQFF,0,1,1,1
TRBV7-2,TRBJ1-2,CASSFGTGMYGCTF,0,1,1,1
TRBV5-6,TRBJ1-2,CASSQSTGLYGYTF,0,1,1,1
TRBV2,TRBJ1-4,CASSAGGANEKLFF,0,2,1,2
TRBV7-9,TRBJ1-5,CASRSSYSNQPQHF,0,1,1,1
TRBV10-2,TRBJ2-7,CASGPSPGRYEQYF,0,2,1,2
TRBV5-1,TRBJ1-1,CASSLWTTNTEAFF,0,2,1,2
TRBV5-1,TRBJ1-2,CASSLDGQGRGYTF,0,1,1,1
TRBV4-1,TRBJ2-7,CASSPGQGVYEQYF,0,1,1,1
TRBV20-1,TRBJ1-4,CSAPRGGGGEKLFF,0,1,1,1
TRBV20-1,TRBJ2-5,CSARSSGGQETQYF,0,1,1,1
TRBV20-1,TRBJ1-2,CSALRGGGFYGYTF,0,1,1,1
TRBV29-1,TRBJ1-4,CSARGTADNEKLFF,0,1,1,1
TRBV12-5,TRBJ2-7,CASGFGRAYEQYF,0,1,1,1
TRBV19,TRBJ2-5,CASSPSSQETQYF,0,1,1,1
TRBV18,TRBJ1-1,CASSPQEGTEAYF,0,1,1,1
TRBV6-2/3/5/6,TRBJ2-5,CASSLLGEETQYF,0,1,1,1
TRBV7-2,TRBJ1-3,CASSLTRGNTIYF,0,2,1,2
TRBV5-1,TRBJ2-1,CASSLGWGHEQFF,0,1,1,1
TRBV11-2,TRBJ1-5,CASSGQGSQPQHF,0,1,1,1
TRBV5-1,TRBJ2-7,CASRWAEAYEQYF,0,1,1,1
TRBV29-1,TRBJ2-5,CSVSLTGWETQYF,0,1,1,1
TRBV29-1,TRBJ2-1,CSVVSTGYNEQFF,0,1,1,1
TRBV29-1,TRBJ1-2,CSVESPGTHGYTF,0,2,1,2
TRBV29-1,TRBJ2-7,CSVEDGGSYEQYF,0,3,1,3
TRBV29-1,TRBJ2-7,CSVIRDSTYEQYF,0,1,1,1
TRBV29-1,TRBJ1-1,CSVGVGGQGEAFF,0,1,1,1
TRBV29-1,TRBJ1-5,CSGRTDRDQPQHF,0,1,1,1
TRBV18,TRBJ1-1,CASSPMNTEAFF,0,1,1,1
TRBV7-9,TRBJ1-2,CASSLDTYGYTF,0,1,1,1
TRBV14,TRBJ2-4,CASSQGWTGQYF,0,1,1,1
TRBV5-1,TRBJ2-3,CASSLAPDTQYF,0,1,1,1
TRBV5-6,TRBJ2-1,CASSLGLAGIIEQFF,0,1,1,1
TRBV29-1,TRBJ2-1,CSVEGRRIYNEQFF,0,1,1,1
TRBV12-3/4,TRBJ2-5,CASSPPGLAVKETQYF,0,2,1,2
TRBV28,TRBJ2-3,CASSLLLAGGLSSAADTQYF,0,1,1,1
TRBV3-1,TRBJ1-6,CASSQEEPFIGWSGSPLHF,0,1,1,1
TRBV7-9,TRBJ1-2,CASSLPPDRVLDYGYTF,0,1,1,1
TRBV29-1,TRBJ2-3,CSVEGTTKNLNTDTQYF,0,1,1,1
TRBV19,TRBJ1-2,CASRPWDSPSLYGYTF,0,1,1,1
TRBV5-4,TRBJ2-1,CASIKAGGRSYNEQFF,0,1,1,1
TRBV28,TRBJ2-3,CASSSAGTGGWNTQYF,0,1,1,1
TRBV12-3/4,TRBJ2-7,CASSAGTGSRGYEQYF,0,2,1,2
TRBV20-1,TRBJ2-7,CSASPSGGLFSYEQYF,0,1,1,1
TRBV28,TRBJ2-1,CASSTAGTGRNEQFF,0,1,1,1
TRBV7-8,TRBJ1-2,CASSSYRLTNYGYTF,0,2,1,2
TRBV3-1,TRBJ1-5,CASSLGVGGNQPQHF,0,1,1,1
TRBV7-2,TRBJ2-1,CASSLTSGVGNEQFF,0,1,1,1
TRBV3-1,TRBJ1-1,CASSQDVHRNTEAFF,0,1,1,1
TRBV5-1,TRBJ2-7,CASSLGSGESYEQYF,0,1,1,1
TRBV5-1,TRBJ1-4,CASSLEAATNEKLFF,0,1,1,1
TRBV12-5,TRBJ2-3,CASGFEGRSDTQYF,0,1,1,1
TRBV18,TRBJ1-1,CASSQNRGQTEAFF,0,1,1,1
TRBV12-3/4,TRBJ2-7,CASSSWTGINEQYF,0,1,1,1
TRBV7-2,TRBJ1-5,CASSLWDNNQPQHF,0,1,1,1
TRBV3-1,TRBJ2-7,CASSQREGYDEQYF,0,1,1,1
TRBV14,TRBJ2-5,CASSQVSVKETQYF,0,1,1,1
TRBV3-1,TRBJ1-1,CASSQDSGGDGAFF,0,1,1,1
TRBV9,TRBJ2-3,CASNVRGGTNTQYF,0,1,1,1
TRBV10-2,TRBJ1-3,CASREQGFGDTIYF,0,1,1,1
TRBV20-1,TRBJ2-3,CSARVAGFLDTQYF,0,1,1,1
TRBV20-1,TRBJ2-5,CSAIRASGRETQYF,0,1,1,1
TRBV29-1,TRBJ2-3,CSVVTPEDVYTQYF,0,1,1,1
TRBV7-2,TRBJ2-7,CASSWARTYEQYF,0,1,1,1
TRBV3-1,TRBJ2-1,CASSQDSPGEQFF,0,1,1,1
TRBV5-1,TRBJ1-6,CASRDTENSPLHF,0,2,1,2
TRBV20-1,TRBJ2-2,CSASDRNTGELFF,0,1,1,1
TRBV20-1,TRBJ1-4,CSASTGDHEKLFF,0,1,1,1
TRBV7-2,TRBJ2-7,CASSSPGGEQYF,0,1,1,1
TRBV5-1,TRBJ2-1,CASSQTSDEQFF,0,1,1,1
TRBV29-1,TRBJ2-3,CSVQGSTDTQYF,0,1,1,1
TRBV29-1,TRBJ1-1,CSVEDLSDRLSL,0,1,1,1
TRBV20-1,TRBJ1-3,CRARGPGNTIYF,0,1,1,1
TRBV20-1,TRBJ2-7,CSARDHGPTVAGEQYF,0,1,1,1
TRBV10-1,TRBJ2-1,CASSPGTSGANEQFF,0,2,1,2
TRBV7-9,TRBJ1-1,CASNTVAGNTEAFF,0,1,1,1
TRBV5-1,TRBJ1-1,CASSLDGVNTEAFF,0,2,1,2
TRBV7-3,TRBJ2-5,CASSLGYRETQCF,0,2,1,2
TRBV29-1,TRBJ2-1,CSVEVGLADLTFF,0,2,1,2
TRBV2,TRBJ1-5,CASRGMGLSNQPQHF,0,1,1,1
TRBV4-1,TRBJ2-5,CASSQVSQFQETQYF,0,1,1,1
TRBV19,TRBJ2-7,CASSIGAGAYEQYF,0,1,1,1
TRBV14,TRBJ1-1,CASSQEARQKAFF,0,1,1,1
TRBV20-1,TRBJ1-2,CSARVYFFQQGPGLGGYTF,0,1,1,1
TRBV28,TRBJ1-6,CASSLSLGYASYNSPLHF,0,1,1,1
TRBV28,TRBJ1-4,CASSPPRGGESTDEKLFF,0,1,1,1
TRBV2,TRBJ2-5,CASSEAWLAGGGETQYF,0,2,1,2
TRBV5-6,TRBJ1-1,CASSLVVRGEGDTEAFF,0,2,1,2
TRBV28,TRBJ2-1,CASSHLSWTTTYNEQFF,0,1,1,1
TRBV2,TRBJ1-5,CASSEGQGGGSNQPQHF,0,1,1,1
TRBV5-1,TRBJ2-6,CASSLAAGTSGANVLTF,0,2,1,2
TRBV5-1,TRBJ2-4,CASSLRPFGEVLKIQYF,0,1,1,1
TRBV29-1,TRBJ2-3,CSVEDGRDTSGTDTQYF,0,1,1,1
TRBV11-3,TRBJ2-3,CASSLDKTGGADTQYF,0,2,1,2
TRBV28,TRBJ1-5,CASSSSQGIQGQPQHF,0,1,1,1
TRBV3-1,TRBJ2-7,CASSQAVGSGVHEQYF,0,1,1,1
TRBV3-1,TRBJ2-1,CASSQGWRGTYNEQFF,0,1,1,1
TRBV12-3/4,TRBJ2-7,CASSALGLAPDYEQYF,0,1,1,1
TRBV6-2/3/5/6,TRBJ2-1,CASRIKSGGSYNEQFF,0,1,1,1
TRBV29-1,TRBJ2-1,CSVSSRGQGYYNEQFF,0,1,1,1
TRBV29-1,TRBJ2-1,CSVEGTSGGAIDEQFF,0,1,1,1
TRBV7-7,TRBJ2-1,CASSLDWDSYNEQFF,0,1,1,1
TRBV19,TRBJ2-4,CASSLGQGAYNIQYF,0,1,1,1
TRBV19,TRBJ2-7,CASSDIGTGSYEQYF,0,1,1,1
TRBV19,TRBJ2-7,CASSIRRSSSYEQYF,0,1,1,1
TRBV19,TRBJ2-5,CASKAGGGPQETQYF,0,1,1,1
TRBV7-8,TRBJ2-3,CASIPGTGFWGTQYF,0,1,1,1
TRBV6-2/3/5/6,TRBJ2-3,CASSLGRGSTDTQYF,0,1,1,1
TRBV28,TRBJ1-6,CASSLNRPGNSPLHF,0,1,1,1
TRBV2,TRBJ2-2,CASSEARVGAGELFF,0,2,1,2
TRBV11-2,TRBJ1-6,CASSFTGVSRSPLHF,0,1,1,1
TRBV5-6,TRBJ1-2,CASSLPAGTGYGYTF,0,1,1,1
TRBV5-4,TRBJ1-2,CASSLNTVLNYGYTF,0,1,1,1
TRBV28,TRBJ1-4,CASSLLPGINEKLFF,0,1,1,1
TRBV3-1,TRBJ1-2,CASSLGDFFNYGYTF,0,1,1,1
TRBV9,TRBJ1-2,CASSPSSERIYGYTF,0,2,1,2
TRBV10-2,TRBJ2-7,CASTLGGWGSYEQYF,0,1,1,1
TRBV5-1,TRBJ1-5,CASSPGQEGDQPQHF,0,1,1,1
TRBV5-1,TRBJ1-3,CASSDWGVNGNTIYF,0,1,1,1
TRBV5-1,TRBJ1-5,CASSLGGSSNQPQHF,0,1,1,1
TRBV5-1,TRBJ2-7,CASSLRSGAVPEQYF,0,1,1,1
TRBV20-1,TRBJ2-3,CSAIRTGGEADTQYF,0,1,1,1
TRBV18,TRBJ1-2,CASSPGTGIEFDTF,0,1,1,1
TRBV18,TRBJ1-4,CASSPRQVNEKLFF,0,2,1,2
TRBV19,TRBJ2-5,CASSKQGPQETQYF,0,1,1,1
TRBV12-3/4,TRBJ1-5,CASTGSVSNQPQHF,0,2,1,2
TRBV2,TRBJ1-1,CASTMTAMETEAFF,0,1,1,1
TRBV28,TRBJ2-7,CASSFEGQPYEQHF,0,1,1,1
TRBV27,TRBJ1-1,CASSLGWSNTEAFF,0,1,1,1
TRBV2,TRBJ1-5,CASSGGQGYQPQHF,0,1,1,1
TRBV3-1,TRBJ2-3,CASSKAGNTDTQYF,0,1,1,1
TRBV7-2,TRBJ1-6,CASSSRVTGSPLHF,0,1,1,1
TRBV3-1,TRBJ2-7,CASSHRDRSYEQYF,0,1,1,1
TRBV3-1,TRBJ2-5,CASSQSAGQETQYF,0,1,1,1
TRBV10-2,TRBJ2-3,CASSEGERTDTQYF,0,1,1,1
TRBV5-1,TRBJ2-1,CASSLVEGRGEQFF,0,1,1,1
TRBV5-1,TRBJ1-2,CASSLDVYSRGYTF,0,1,1,1
TRBV5-1,TRBJ1-5,CASSPGTSNQPQHF,0,1,1,1
TRBV20-1,TRBJ1-1,CSAPRRTVNTEAFF,0,1,1,1
TRBV20-1,TRBJ1-6,CSAAPQVGNSPLHF,0,1,1,1
TRBV29-1,TRBJ1-1,CSVGPQGSNTEAFF,0,1,1,1
TRBV29-1,TRBJ2-2,CSVKGASMAGELFF,0,2,1,2
TRBV27,TRBJ2-7,CASSLAGTYEQYF,0,1,1,1
TRBV7-9,TRBJ1-1,CASSLVERTEAFF,0,1,1,1
TRBV11-2,TRBJ2-1,CASSLAFYNEQFF,0,1,1,1
TRBV7-9,TRBJ2-1,CASSLGQAFGQFF,0,1,1,1
TRBV5-6,TRBJ1-4,CASSWAPNEKLFF,0,1,1,1
TRBV2,TRBJ2-3,CASSPPFTDTQYF,0,1,1,1
TRBV5-6,TRBJ2-6,CASSRLGANVLTF,0,1,1,1
TRBV5-1,TRBJ1-1,CASSSIDRGEAFF,0,1,1,1
TRBV20-1,TRBJ2-7,CSAPGTGDLEQYF,0,1,1,1
TRBV20-1,TRBJ1-1,CSATNSLNTEAFF,0,1,1,1
TRBV29-1,TRBJ2-1,CSVRLDNPNEQFF,0,1,1,1
TRBV29-1,TRBJ1-1,CSVEDGLNTEAFF,0,1,1,1
TRBV28,TRBJ1-6,CATRGANSPLHF,0,2,1,2
TRBV6-2/3/5/6,TRBJ1-6,CASSYGDSPLHF,0,2,1,2
TRBV3-1,TRBJ2-3,CASSQLGDTQYF,0,1,1,1
TRBV20-1,TRBJ1-4,CSVRGRGEKLFF,0,1,1,1
TRBV29-1,TRBJ2-2,CSVRPYTGELFF,0,1,1,1
TRBV29-1,TRBJ1-1,CSVIQGNTEAFF,0,1,1,1
TRBV7-9,TRBJ2-1,CATSLGVEQFF,0,1,1,1
TRBV5-1,TRBJ2-7,CASRQGNRQYF,0,1,1,1
TRBV19,TRBJ2-3,CASPSSEGDDSDTQYF,0,2,1,2
TRBV19,TRBJ2-6,CASSMDSSGANVLTF,0,1,1,1
TRBV19,TRBJ2-2,CASSRGLAGGWDTGELFF,0,1,1,1
TRBV11-1,TRBJ2-1,CASSLAGASGYNEQFF,0,1,1,1
TRBV12-5,TRBJ1-1,CASGFGAGVGTEAFF,0,1,1,1
TRBV11-1,TRBJ1-1,CASSLAFTGWTEAFY,0,1,1,1
TRBV12-5,TRBJ1-6,CASGLRGQNPPLHF,0,1,1,1
TRBV5-4,TRBJ2-1,CASSLGGINEQFF,0,1,1,1
TRBV19,TRBJ2-3,CASSRPTGGLDTQYF,0,1,1,1
TRBV20-1,TRBJ2-3,CSAIAREKGTDTQYF,0,1,1,1
TRBV18,TRBJ1-1,CASSHAKGTEAFF,0,1,1,1
TRBV20-1,TRBJ2-5,CSARLAVLETQYF,0,1,1,1
TRBV5-5,TRBJ2-3,CASRGEPDTQYF,0,1,1,1
TRBV9,TRBJ2-7,CASSPSADQQTSEQYF,0,1,1,1
TRBV20-1,TRBJ1-1,CSARRGGRGLRVAFF,0,1,1,1
TRBV5-6,TRBJ2-1,CASSAGLAATEQFF,0,1,1,1
TRBV20-1,TRBJ2-7,CSARRPGTAYEQYF,0,2,1,2
TRBV29-1,TRBJ2-5,CSVTPPILGETQYF,0,1,1,1
TRBV19,TRBJ1-1,CASSLQGNTEAFF,0,2,1,2
TRBV2,TRBJ2-1,CASSAGPNNEQFF,0,1,1,1
TRBV29-1,TRBJ1-4,CSVEDRGARGVFF,0,1,1,1
TRBV6-1,TRBJ2-1,CASSGLGAHSTSSYNEQFF,0,1,1,1
TRBV6-2/3/5/6,TRBJ2-1,CASSYSIYAGTSYNEQFF,0,1,1,1
TRBV28,TRBJ1-1,CASSPLRRTGYNTEAFF,0,1,1,1
TRBV7-2,TRBJ2-7,CASSLVVAAGAYEQYF,0,2,1,2
TRBV5-1,TRBJ2-5,CASDASPGGGAETQYF,0,2,1,2
TRBV5-1,TRBJ2-3,CASSLNWGGITDTQYF,0,1,1,1
TRBV2,TRBJ1-3,CATKYGGYSGNTIYF,0,1,1,1
TRBV18,TRBJ1-2,CASSPSTGHNYGYTF,0,1,1,1
TRBV9,TRBJ2-3,CASSEGSGSTDTQYF,0,1,1,1
TRBV20-1,TRBJ1-1,CSARDWAGENTEAFF,0,2,1,2
TRBV30,TRBJ1-3,CAWSRDSSGNTIYF,0,1,1,1
TRBV7-2,TRBJ2-7,CANSPTGQGHGQYF,0,1,1,1
TRBV5-1,TRBJ2-7,CASSLERSSYEQCF,0,2,1,2
TRBV20-1,TRBJ1-5,CSATPDSSNQPQHF,0,1,1,1
TRBV2,TRBJ1-1,CASAKNTEAFF,0,1,1,1
TRBV12-3/4,TRBJ1-6,CASSRWRFDGKNSPLHHHLHF,0,1,1,1
TRBV19,TRBJ1-5,CASSTPSGDSHYSNQPQHF,0,1,1,1
TRBV3-1,TRBJ2-1,CASSPRTSGGIFYNEQFF,0,1,1,1
TRBV6-4,TRBJ1-1,CASSGEGQGSPWGTEAFF,0,1,1,1
TRBV5-1,TRBJ1-3,CASSLGRPSSVSGNTIYF,0,1,1,1
TRBV4-1,TRBJ2-4,CASSLSNGGSKAKNIQYF,0,1,1,1
TRBV5-1,TRBJ2-1,CASSRTSGGPTIYNEQFF,0,1,1,1
TRBV20-1,TRBJ2-1,CSARDRMAGGSSYNEQFF,0,2,1,2
TRBV7-9,TRBJ2-3,CASSSWDRGRQTDTQYF,0,1,1,1
TRBV12-3/4,TRBJ2-3,CASSPRAGGVRTDTQYF,0,1,1,1
TRBV6-1,TRBJ1-5,CASSRIPGQIANQPQHF,0,1,1,1
TRBV7-2,TRBJ2-1,CASSLGGSGGAHNEQLF,0,1,1,1
TRBV7-2,TRBJ1-1,CASSLIGGVNTNTEAFF,0,1,1,1
TRBV11-2,TRBJ2-5,CASSIGTSGGAAETQYF,0,1,1,1
TRBV28,TRBJ2-4,CASRGAGGALAKNIQYF,0,1,1,1
TRBV5-1,TRBJ1-1,CASSLPKGRFWDTEAFF,0,1,1,1
TRBV20-1,TRBJ2-5,CSARALSSGGDSETQYF,0,2,1,2
TRBV12-5,TRBJ1-4,CASGLSRGFTNEKLVF,0,1,1,1
TRBV19,TRBJ2-4,CASSIGGGWSKNIQYF,0,1,1,1
TRBV5-6,TRBJ2-4,CASTTTGMLAKNIQYF,0,1,1,1
TRBV6-2/3/5/6,TRBJ1-5,CASTGPGSYSNQPQHF,0,1,1,1
TRBV6-2/3/5/6,TRBJ2-2,CASSLSGPTNAGELFF,0,1,1,1
TRBV6-2/3/5/6,TRBJ1-2,CASSSPDLLRSYGYTF,0,1,1,1
TRBV6-2/3/5/6,TRBJ2-7,CASSRGNAGTEYEQYF,0,1,1,1
TRBV11-2,TRBJ2-7,CASSLVRAVTSYEQYL,0,1,1,1
TRBV7-3,TRBJ2-3,CASSLISSGGRYTQYF,0,1,1,1
TRBV3-1,TRBJ2-1,CASSSPLAETYNEQFF,0,1,1,1
TRBV5-1,TRBJ2-3,CASSLSLAGGTDTQYF,0,1,1,1
TRBV20-1,TRBJ1-2,CSARNPVGATLYGYTF,0,1,1,1
TRBV10-3,TRBJ2-5,CAISESGGSGETQYF,0,1,1,1
TRBV10-3,TRBJ2-3,CAISESTINPDTQYF,0,1,1,1
TRBV19,TRBJ2-2,CASSSLPGNTGELFF,0,1,1,1
TRBV18,TRBJ2-6,CASSPLGSGANVLTF,0,1,1,1
TRBV18,TRBJ1-1,CASSHKQGLNTEAFF,0,1,1,1
TRBV28,TRBJ2-3,CASSFSTSSIDTQYF,0,1,1,1
TRBV12-3/4,TRBJ2-1,CASSLLPNSYNEQFF,0,1,1,1
TRBV6-2/3/5/6,TRBJ2-5,CASSLDGTGKETQYF,0,1,1,1
TRBV12-3/4,TRBJ2-2,CASSYDRGRPGELFF,0,1,1,1
TRBV6-2/3/5/6,TRBJ2-1,CASSYHRGRGVEQFF,0,1,1,1
TRBV28,TRBJ2-6,CASSPNRAGANVLTF,0,1,1,1
TRBV2,TRBJ2-1,CASSEGLAGANEQFF,0,1,1,1
TRBV7-2,TRBJ1-6,CASSFRDRGNSPLHF,0,1,1,1
TRBV11-2,TRBJ2-2,CASSLTSGAVGELFF,0,1,1,1
TRBV7-9,TRBJ1-4,CASSLELATNEKLFF,0,1,1,1
TRBV7-9,TRBJ2-7,CASSSPGQGTYEQYF,0,1,1,1
TRBV7-2,TRBJ1-1,CASSLETGQGTEAFF,0,1,1,1
TRBV3-1,TRBJ2-3,CASSPTGQGAFTQYF,0,1,1,1
TRBV3-1,TRBJ2-3,CASSHRGGGTDTQYF,0,1,1,1
TRBV3-1,TRBJ2-7,CASSHGSAGAYEQYF,0,1,1,1
TRBV3-1,TRBJ2-1,CASSQARSSYNEQFF,0,1,1,1
TRBV12-3/4,TRBJ2-5,CASRPTSGGQETQYF,0,1,1,1
TRBV12-3/4,TRBJ1-6,CASRPDRGANSPLHF,0,1,1,1
TRBV18,TRBJ1-5,CASSPPGGLNQPQHF,0,1,1,1
TRBV5-1,TRBJ1-1,CASSYLTGAGTEAFF,0,1,1,1
TRBV4-1,TRBJ1-1,CASSQPIRGNTEAFF,0,1,1,1
TRBV20-1,TRBJ2-7,CSAREGPPKAYEQYF,0,1,1,1
TRBV20-1,TRBJ2-2,CSARVGGAQTGELFF,0,1,1,1
TRBV29-1,TRBJ1-5,CSVEVTGDSNQPQHF,0,1,1,1
TRBV29-1,TRBJ2-1,CSVETSGGSYNEQFF,0,2,1,2
TRBV29-1,TRBJ2-3,CSVRQGDGSTDTQYF,0,2,1,2
TRBV29-1,TRBJ2-3,CSAGTGGWSTDTQYF,0,1,1,1
TRBV19,TRBJ1-1,CASSLHNGNTEAFF,0,1,1,1
TRBV19,TRBJ1-5,CASSIARSNQPQHF,0,1,1,1
TRBV2,TRBJ2-1,CASLGYLSYNEQFF,0,1,1,1
TRBV18,TRBJ2-5,CASSPWAPQEAQYF,0,1,1,1
TRBV18,TRBJ2-3,CASSPPGGSDTQYF,0,1,1,1
TRBV5-6,TRBJ2-7,CASASPDRTYEQYF,0,1,1,1
TRBV28,TRBJ2-7,CASGGLAPLREQYF,0,1,1,1
TRBV12-3/4,TRBJ2-7,CASSFRTGGGEQYF,0,1,1,1
TRBV28,TRBJ1-1,CASSLWTVNTEAFF,0,1,1,1
TRBV6-2/3/5/6,TRBJ2-7,CASSLGLEVYEQYF,0,1,1,1
TRBV12-3/4,TRBJ2-3,CASSSGTVKDTQYF,0,1,1,1
TRBV12-3/4,TRBJ1-1,CASSPQGTNTEAFF,0,1,1,1
TRBV6-1,TRBJ2-3,CASSVLGSSDTQYF,0,1,1,1
TRBV7-8,TRBJ1-2,CASSRTGTSYGYTF,0,1,1,1
TRBV5-4,TRBJ2-7,CASSFGGPSYEQYF,0,1,1,1
TRBV5-4,TRBJ2-3,CASSLATGTDTQYF,0,1,1,1
TRBV5-6,TRBJ2-7,CASSLEGFPYEQYF,0,1,1,1
TRBV11-2,TRBJ1-5,CASSLVPLGQPQHF,0,1,1,1
TRBV28,TRBJ2-5,CASSPPGNLKTQYF,0,2,1,2
TRBV3-1,TRBJ1-4,CASSQRQPNEKLFF,0,1,1,1
TRBV2,TRBJ2-7,CASRGDRESYEQYF,0,1,1,1
TRBV10-2,TRBJ2-3,CASTLAGGADTQYF,0,2,1,2
TRBV5-1,TRBJ2-5,CASSLATIGETQYF,0,1,1,1
TRBV5-1,TRBJ2-7,CASSLGNRGDEQYF,0,1,1,1
TRBV4-1,TRBJ2-1,CASSQVNAGDKQFF,0,1,1,1
TRBV5-1,TRBJ2-5,CASSAADRGKTQYF,0,1,1,1
TRBV5-1,TRBJ2-1,CASSIRDSYNEQFF,0,1,1,1
TRBV5-1,TRBJ2-7,CASRATDDTYEQYF,0,1,1,1
TRBV20-1,TRBJ2-1,CSARVAGTHGEQFF,0,1,1,1
TRBV20-1,TRBJ2-4,CSARDPRGAVIQYF,0,1,1,1
TRBV2,TRBJ2-5,CASLRDSRGTQYF,0,1,1,1
TRBV18,TRBJ1-1,CASSPTVNTEAFF,0,1,1,1
TRBV18,TRBJ2-3,CASSPPLVMPQYF,0,1,1,1
TRBV18,TRBJ1-5,CASSPTWNQPQHF,0,1,1,1
TRBV2,TRBJ1-2,CASMQGVNYGYTF,0,2,1,2
TRBV12-3/4,TRBJ1-2,CASSLAISYGYTF,0,1,1,1
TRBV28,TRBJ2-7,CASSSDRGQRLLF,0,1,1,1
TRBV6-2/3/5/6,TRBJ1-2,CASSSSTADGYTF,0,1,1,1
TRBV6-2/3/5/6,TRBJ1-1,CASSYSDRGWAFF,0,1,1,1
TRBV6-2/3/5/6,TRBJ2-2,CASSYGFAGELFF,0,1,1,1
TRBV7-9,TRBJ2-5,CASSFVGVETQYF,0,1,1,1
TRBV7-9,TRBJ2-2,CASSRINTGELFF,0,1,1,1
TRBV14,TRBJ1-1,CASSQDPQGRAFF,0,2,1,2
TRBV5-4,TRBJ1-2,CASSGTGAVGYTF,0,1,1,1
TRBV10-1,TRBJ1-1,CATAPFSSSRTFF,0,1,1,1
TRBV5-1,TRBJ1-1,CASSDIRGTEAFF,0,1,1,1
TRBV5-1,TRBJ2-1,CASSLLVYNEQFF,0,1,1,1
TRBV20-1,TRBJ1-5,CSASRGINQPQHF,0,1,1,1
TRBV20-1,TRBJ1-1,CSARSGRNTEAFF,0,1,1,1
TRBV20-1,TRBJ1-5,CSARGQNNQPQHF,0,1,1,1
TRBV29-1,TRBJ2-7,CSVVSGVSYEQYF,0,1,1,1
TRBV29-1,TRBJ2-2,CSVRTGTTGELFF,0,1,1,1
TRBV29-1,TRBJ1-1,CSTALQGNTEAFF,0,1,1,1
TRBV30,TRBJ2-6,CAVGSGANVLTF,0,1,1,1
TRBV10-3,TRBJ1-1,CAISESGGQAFF,0,1,1,1
TRBV24-1,TRBJ1-2,CATSDRGSGYTF,0,1,1,1
TRBV28,TRBJ2-3,CASWGGTDTQYF,0,1,1,1
TRBV12-3/4,TRBJ2-5,CASRDFQETQYF,0,1,1,1
TRBV27,TRBJ2-1,CASSSRTGGEFF,0,1,1,1
TRBV6-2/3/5/6,TRBJ1-2,CASSSSSLPYTF,0,1,1,1
TRBV6-1,TRBJ1-5,CASSEPNQPQHF,0,1,1,1
TRBV5-4,TRBJ2-5,CASSLGEGTQYF,0,2,1,2
TRBV11-3,TRBJ2-1,CASSLISEEQFF,0,1,1,1
TRBV28,TRBJ1-1,CASSWAGTRAFF,0,1,1,1
TRBV3-1,TRBJ2-7,CASSRRTGLKYF,0,1,1,1
TRBV16,TRBJ1-1,CASSQTGTETFF,0,1,1,1
TRBV10-1,TRBJ2-7,CATSTGSLEQYF,0,1,1,1
TRBV20-1,TRBJ2-7,CSAWTRSYEQYF,0,1,1,1
TRBV29-1,TRBJ1-1,CSVDSVYTEAFL,0,1,1,1
TRBV29-1,TRBJ1-2,CSVEVAQSGYTF,0,1,1,1
TRBV29-1,TRBJ2-3,CSARLTGSTQYF,0,1,1,1
TRBV28,TRBJ2-1,CASIQFNEQFF,0,1,1,1
TRBV12-3/4,TRBJ2-1,CASSLMAVPSF,0,2,1,2
TRBV29-1,TRBJ2-3,CSVETRSKQYF,0,1,1,1
TRBV18,TRBJ2-3,CASSPKATWARTDTQYF,0,2,1,2
TRBV7-2,TRBJ2-7,CASSFLGRGSSSYEQYF,0,1,1,1
TRBV6-2/3/5/6,TRBJ2-3,CASSLDGGAETDTQYF,0,1,1,1
TRBV11-1,TRBJ2-1,CASSLAWGLADEQFF,0,1,1,1
TRBV7-9,TRBJ2-5,CASSSRAGARETQYF,0,1,1,1
TRBV3-1,TRBJ2-7,CASSPRDSSNYEQYF,0,1,1,1
TRBV5-1,TRBJ2-3,CASSSAGESTDTQYF,0,1,1,1
TRBV2,TRBJ2-1,CASTWDRGANEQFF,0,1,1,1
TRBV4-1,TRBJ1-2,CASSQPTGLGGYTF,0,2,1,2
TRBV2,TRBJ2-1,CASSGVGGNEQFF,0,1,1,1
TRBV20-1,TRBJ1-5,CSARPLGIGDLISYSNQPQHF,0,1,1,1
TRBV28,TRBJ2-4,CASSLGRAQVGRPKNIQYF,0,1,1,1
TRBV6-2/3/5/6,TRBJ2-6,CASSLGLAGGPSGANILTF,0,1,1,1
TRBV5-1,TRBJ1-1,CASSLPPFPRRRQVPEAFF,0,1,1,1
TRBV19,TRBJ2-2,CASTPRLAGGPNTGELFF,0,1,1,1
TRBV19,TRBJ2-1,CASSIDLPSGGVYNEQFF,0,1,1,1
TRBV12-3/4,TRBJ2-5,CASSLRLAGDTLQGTQYF,0,1,1,1
TRBV7-2,TRBJ2-3,CASSSDPLYGARTDTQYF,0,1,1,1
TRBV5-1,TRBJ1-1,CASSSLISGTGSGTEAFF,0,1,1,1
TRBV4-1,TRBJ2-6,CASSQDRGQGPGANVLTF,0,2,1,2
TRBV4-1,TRBJ1-5,CASSNRDMGFGFNQPQHF,0,1,1,1
TRBV5-1,TRBJ2-3,CASNPGLAGGLSTDTQYF,0,1,1,1
TRBV29-1,TRBJ1-1,CSVPPDRGEAGENTEAFF,0,1,1,1
TRBV10-3,TRBJ1-5,CAISESLSGADNQPQHF,0,1,1,1
TRBV18,TRBJ1-5,CASSPFETEYSNQPQHF,0,1,1,1
TRBV18,TRBJ2-5,CASSPPLGQLWQETQYF,0,1,1,1
TRBV18,TRBJ1-6,CASSPPNMGSPNSPLHF,0,1,1,1
TRBV18,TRBJ1-6,CASTEPDRYFYNSPLHF,0,1,1,1
TRBV7-9,TRBJ2-5,CASSYNVAGGLRETQYF,0,1,1,1
TRBV11-2,TRBJ2-5,CASSSTRTGGTQETQYF,0,1,1,1
TRBV7-9,TRBJ2-2,CASRPRLAAANTGELFF,0,1,1,1
TRBV4-1,TRBJ1-5,CASSEDWGGVLGQPQHF,0,1,1,1
TRBV29-1,TRBJ2-4,CSVGLGQARLPKNIQYF,0,1,1,1
TRBV29-1,TRBJ2-3,CSVENLKASASTDTQYF,0,1,1,1
TRBV12-5,TRBJ1-4,CASGFYHRGAHEKLFF,0,1,1,1
TRBV12-5,TRBJ1-1,CASGRRTGSMNTEAFF,0,1,1,1
TRBV10-3,TRBJ2-1,CAISEVGGGARDEQFF,0,1,1,1
TRBV19,TRBJ1-5,CASSTRPQAGNQPQHF,0,1,1,1
TRBV18,TRBJ2-1,CASSPFGTGDYNEQFF,0,1,1,1
TRBV12-3/4,TRBJ2-2,CASSLDSGGPPGELFF,0,1,1,1
TRBV6-2/3/5/6,TRBJ2-5,CASSYRLTGGPETQYF,0,1,1,1
TRBV28,TRBJ1-2,CASSPPGQGLNYGYTF,0,1,1,1
TRBV27,TRBJ2-7,CASSPSIGQGFYEQYF,0,1,1,1
TRBV3-1,TRBJ2-3,CASSFRTGARTDTQYF,0,1,1,1
TRBV7-2,TRBJ1-5,CASSLFPPYSNQPQHF,0,1,1,1
TRBV13,TRBJ2-3,CASSLRAGTRTDTQYF,0,1,1,1
TRBV7-9,TRBJ2-1,CASSYRPGDRNNEQFF,0,1,1,1
TRBV5-1,TRBJ2-3,CASSFGASGGTDTQYF,0,1,1,1
TRBV5-1,TRBJ1-6,CASSLAGEAYNSPLHF,0,1,1,1
TRBV5-1,TRBJ2-3,CASSRLGGTNTDTQYF,0,1,1,1
TRBV5-1,TRBJ2-1,CASSVGLAGGVHEQFF,0,1,1,1
TRBV29-1,TRBJ2-1,CSVGGVGGATYNEQFF,0,1,1,1
TRBV20-1,TRBJ1-3,CSASKGVSQAGNTIYF,0,1,1,1
TRBV7-6,TRBJ2-3,CASSPGLAAADTQYF,0,1,1,1
TRBV15,TRBJ2-5,CATSRDRQGAQTQYF,0,1,1,1
TRBV19,TRBJ1-1,CASIGSGRVFPEAFF,0,1,1,1
TRBV19,TRBJ1-2,CASSSSDRGNYGYTF,0,1,1,1
TRBV19,TRBJ2-3,CASSTGTSRTDTQYF,0,1,1,1
TRBV19,TRBJ2-2,CASKRTSGFTGELFF,0,1,1,1
TRBV18,TRBJ2-7,CASSPTLTGTYEQYF,0,1,1,1
TRBV18,TRBJ1-5,CASSPWEGENQPQHF,0,1,1,1
TRBV18,TRBJ1-4,CASSPSTGVDEKLFF,0,1,1,1
TRBV28,TRBJ1-5,CASISSLGDNQPQHF,0,1,1,1
TRBV6-2/3/5/6,TRBJ1-2,CASSFAGHPNYGYTF,0,1,1,1
TRBV28,TRBJ2-3,CASSFNRGATDTQYF,0,1,1,1
TRBV12-3/4,TRBJ1-5,CASSSQGALNQPQHF,0,1,1,1
TRBV6-2/3/5/6,TRBJ1-5,CASSYSRGSNQPQHF,0,1,1,1
TRBV6-2/3/5/6,TRBJ1-2,CASSPSGDGIYGYTF,0,1,1,1
TRBV6-1,TRBJ2-5,CASSELAGGQETQYF,0,1,1,1
TRBV28,TRBJ2-1,CASSTLAGGVNEQFF,0,1,1,1
TRBV5-5,TRBJ2-2,CASSLVSRVPGELFF,0,1,1,1
TRBV5-5,TRBJ1-1,CASSLGGTDNTEAFF,0,1,1,1
TRBV7-2,TRBJ1-2,CASSLSTGSNYGYTF,0,1,1,1
TRBV13,TRBJ2-7,CASSLVGVGSYEQYF,0,1,1,1
TRBV7-2,TRBJ2-1,CASSLGLLVYNEQFF,0,1,1,1
TRBV7-3,TRBJ2-3,CASSSSGGVADTQYF,0,1,1,1
TRBV28,TRBJ2-3,CASSWVRSSTDTQYF,0,1,1,1
TRBV5-6,TRBJ2-3,CASSPGLAGTDTQYF,0,1,1,1
TRBV7-3,TRBJ2-1,CASSRIGSSYNEQFF,0,1,1,1
TRBV3-1,TRBJ2-3,CASSQGGLSADTQYF,0,1,1,1
TRBV16,TRBJ1-1,CASSQFDSPHTEAFF,0,1,1,1
TRBV14,TRBJ2-1,CASSQVASSYNEQFF,0,1,1,1
TRBV11-2,TRBJ2-3,CASSQASGLGNTQYF,0,2,1,2
TRBV3-1,TRBJ1-5,CASSQDWHSNQPQHF,0,1,1,1
TRBV4-2,TRBJ2-1,CASSQDKTGYNEQFF,0,1,1,1
TRBV7-9,TRBJ2-1,CASSILAGGLNEQFF,0,2,1,2
TRBV7-3,TRBJ2-4,CASSTSASAKNIQYF,0,1,1,1
TRBV7-9,TRBJ1-4,CASSTGGATNEKLFF,0,1,1,1
TRBV28,TRBJ1-1,CASSNRGSANTEAFF,0,1,1,1
TRBV7-9,TRBJ1-1,CASRGQGSPDTEAFF,0,2,1,2
TRBV6-2/3/5/6,TRBJ1-3,CASRGTQGARNTIYF,0,1,1,1
TRBV19,TRBJ2-1,CASSSGTGGWNEQFV,0,1,1,1
TRBV5-1,TRBJ2-3,CASSLGHYSTDTQYF,0,1,1,1
TRBV5-1,TRBJ1-1,CASSLRTGLNTESFF,0,1,1,1
TRBV5-1,TRBJ2-7,CASSEGTGRTYEQYF,0,1,1,1
TRBV20-1,TRBJ1-5,CSAAEGAYRRQPQHF,0,1,1,1
TRBV20-1,TRBJ1-4,CSAMGYGTLNEKLFF,0,1,1,1
TRBV20-1,TRBJ1-6,CSATPGGAGNSPLHF,0,1,1,1
TRBV20-1,TRBJ2-7,CSASHLGVLKYEQYF,0,1,1,1
TRBV20-1,TRBJ2-5,CSARRGSGDQETQYF,0,1,1,1
TRBV20-1,TRBJ2-5,CSAREAGGIQETQYF,0,1,1,1
TRBV29-1,TRBJ2-6,CSVGGPVGGANVLTF,0,1,1,1
TRBV29-1,TRBJ1-4,CSVETSGWNGEKLFF,0,1,1,1
TRBV29-1,TRBJ1-5,CSVDAGVVGNQPQHF,0,1,1,1
TRBV29-1,TRBJ2-6,CSAGVGHGEANVLTF,0,1,1,1
TRBV19,TRBJ1-1,CASIPTGVYTEAFF,0,1,1,1
TRBV19,TRBJ1-4,CASTDRESNEKLFF,0,1,1,1
TRBV19,TRBJ1-1,CASSPRQASVPAFF,0,1,1,1
TRBV18,TRBJ2-5,CASSPRRDQETQYF,0,1,1,1
TRBV27,TRBJ1-3,CASARVGAGNTIYF,0,1,1,1
TRBV2,TRBJ2-5,CASIKGPLTETQYF,0,1,1,1
TRBV2,TRBJ2-3,CASTRTSGTDTQYF,0,1,1,1
TRBV12-3/4,TRBJ2-7,CASSFWGASYEQYF,0,1,1,1
TRBV12-3/4,TRBJ2-7,CASSFNEGQSFTYF,0,1,1,1
TRBV6-2/3/5/6,TRBJ2-7,CASSFLTGGYEQYF,0,1,1,1
TRBV12-3/4,TRBJ1-6,CASSFGRDNSPLHF,0,1,1,1
TRBV28,TRBJ1-5,CASSLSLGLQPQHF,0,1,1,1
TRBV2,TRBJ1-5,CASSSSWGNQPQHF,0,1,1,1
TRBV6-2/3/5/6,TRBJ2-1,CASSSTDRYNEQFF,0,1,1,1
TRBV2,TRBJ1-1,CASSYYRAGAEAFF,0,1,1,1
TRBV6-1,TRBJ1-1,CASSVRQPNTEAFF,0,1,1,1
TRBV5-4,TRBJ2-3,CASSLAGATDTQYF,0,1,1,1
TRBV5-5,TRBJ1-1,CASSLDSGHTEALF,0,1,1,1
TRBV7-2,TRBJ2-3,CASSLVHRTSGGPE,0,1,1,1
TRBV7-9,TRBJ1-5,CASSLEAGNQPQHF,0,1,1,1
TRBV7-9,TRBJ1-1,CASSLELMNTEAFF,0,2,1,2
TRBV11-2,TRBJ2-3,CASSLGLSTDTQYF,0,2,1,2
TRBV12-3/4,TRBJ1-1,CASSRDTQDTEAFF,0,1,1,1
TRBV12-3/4,TRBJ2-1,CASSRQGPYNEQFF,0,2,1,2
TRBV5-5,TRBJ2-4,CASSQVIAKNIQYF,0,1,1,1
TRBV3-1,TRBJ1-6,CASSQASVDSPLHF,0,1,1,1
TRBV3-1,TRBJ2-7,CASSQGPTGTEQYF,0,1,1,1
TRBV3-1,TRBJ2-5,CASSQGLAAKTQYF,0,1,1,1
TRBV3-1,TRBJ2-2,CASSQEGATGELFF,0,1,1,1
TRBV9,TRBJ2-3,CASSVAEAGDTQYF,0,1,1,1
TRBV5-4,TRBJ2-4,CASSARTGGNIQYF,0,1,1,1
TRBV6-1,TRBJ1-2,CASSETGGTYGYTF,0,1,1,1
TRBV28,TRBJ1-2,CASSKTGGGWGYTF,0,1,1,1
TRBV28,TRBJ2-7,CASRLQGGNHEQYF,0,1,1,1
TRBV12-3/4,TRBJ2-7,CAKGLAGLTYEQYF,0,1,1,1
TRBV5-1,TRBJ1-4,CASSLTVGNEKLFF,0,1,1,1
TRBV5-1,TRBJ2-6,CASSLASGANVLTF,0,1,1,1
TRBV5-1,TRBJ1-6,CASSSDRGDSPLHF,0,1,1,1
TRBV5-1,TRBJ2-3,CASSPRTVSDTQYF,0,1,1,1
TRBV5-1,TRBJ1-1,CASSPQTGDTEAFF,0,1,1,1
TRBV5-1,TRBJ1-1,CASSAGVWGTEAFF,0,1,1,1
TRBV20-1,TRBJ2-5,CSARLPGGQETQYF,0,1,1,1
TRBV20-1,TRBJ2-5,CSARPGTEVKTQYF,0,1,1,1
TRBV20-1,TRBJ1-6,CSAREDRGNSPLHF,0,2,1,2
TRBV20-1,TRBJ1-1,CSAPDGGVNTEAFF,0,1,1,1
TRBV20-1,TRBJ2-7,CSAIVWDSTYEQYF,0,1,1,1
TRBV20-1,TRBJ2-3,CSAKGIAGTDTRYF,0,1,1,1
TRBV29-1,TRBJ2-7,CSVVDRAFSYEQYF,0,1,1,1
TRBV29-1,TRBJ1-3,CSVDPAGTGNTIYF,0,1,1,1
TRBV29-1,TRBJ2-1,CSVAGLPGVNEQFF,0,1,1,1
TRBV20-1,TRBJ2-3,CSARTSGGTDTQYF,0,1,1,1
TRBV29-1,TRBJ1-1,CSAELTAANTEAFF,0,1,1,1
TRBV29-1,TRBJ1-5,CSASGQNSNQPQHF,0,1,1,1
TRBV30,TRBJ2-7,CAWSGDRGREQYF,0,1,1,1
TRBV15,TRBJ1-6,CATSLNPGSPLHF,0,1,1,1
TRBV2,TRBJ1-5,CATKTGVGQPQHF,0,2,1,2
TRBV19,TRBJ2-1,CASSYGLYNEQFF,0,1,1,1
TRBV19,TRBJ2-7,CASSMGQNYEQYF,0,1,1,1
TRBV12-3/4,TRBJ2-3,CASLAGGTDTQYF,0,1,1,1
TRBV2,TRBJ2-1,CASTAGPYNEQFF,0,1,1,1
TRBV27,TRBJ1-1,CASSFRGGTEAFF,0,1,1,1
TRBV28,TRBJ1-5,CASSLRGNQPQHF,0,1,1,1
TRBV27,TRBJ1-1,CASSTTVYSEAFF,0,1,1,1
TRBV7-2,TRBJ2-7,CASSLAGSLGQYF,0,1,1,1
TRBV5-5,TRBJ2-5,CASSWAAEETQYF,0,1,1,1
TRBV6-2/3/5/6,TRBJ2-7,CASSLRTAYEQYF,0,1,1,1
TRBV16,TRBJ2-7,CASSQGGSYEQYF,0,1,1,1
TRBV5-6,TRBJ1-2,CASSGQGTYGYTF,0,1,1,1
TRBV11-2,TRBJ1-2,CASSENVEYGYTF,0,2,1,2
TRBV28,TRBJ2-5,CASRSTGKETQYF,0,1,1,1
TRBV2,TRBJ2-3,CASRGTSVDTQYF,0,1,1,1
TRBV6-2/3/5/6,TRBJ2-7,CASKDRGAYEQYF,0,1,1,1
TRBV5-1,TRBJ2-1,CASSLGSAGTRFF,0,1,1,1
TRBV20-1,TRBJ2-3,CSARRSSTDTQYF,0,1,1,1
TRBV20-1,TRBJ1-1,CSARDRGETEAFF,0,1,1,1
TRBV29-1,TRBJ2-5,CSVGGGLGETQYF,0,1,1,1
TRBV29-1,TRBJ2-3,CSVEWQSTDTQYF,0,1,1,1
TRBV29-1,TRBJ2-1,CSMGTATYNEQFF,0,1,1,1
TRBV10-3,TRBJ2-5,CAIRGREETQYF,0,2,1,2
TRBV6-2/3/5/6,TRBJ1-1,CASRQGGTEAFF,0,1,1,1
TRBV12-3/4,TRBJ2-2,CASGSDGGELFF,0,1,1,1
TRBV6-2/3/5/6,TRBJ1-5,CASSLFASAQHF,0,1,1,1
TRBV28,TRBJ1-2,CASSLPVYGYTF,0,1,1,1
TRBV6-4,TRBJ1-6,CASSLSDSPLHF,0,1,1,1
TRBV2,TRBJ2-5,CASSDRVETQYF,0,1,1,1
TRBV28,TRBJ1-6,CASSDTGAPLHF,0,1,1,1
TRBV2,TRBJ2-7,CASSEGAAEQYF,0,1,1,1
TRBV6-2/3/5/6,TRBJ1-5,CASSSQGQPQHF,0,1,1,1
TRBV7-9,TRBJ2-3,CASSLVGDTQYF,0,1,1,1
TRBV7-2,TRBJ1-5,CASSLESSTQHF,0,1,1,1
TRBV7-9,TRBJ2-7,CASSPRGDEQYF,0,1,1,1
TRBV28,TRBJ1-1,CASRTGFTEAFF,0,1,1,1
TRBV3-1,TRBJ2-1,CASKLPGGTQFF,0,1,1,1
TRBV10-2,TRBJ2-7,CASSGTSYEQYF,0,1,1,1
TRBV5-1,TRBJ2-3,CASSLGSDTQYF,0,1,1,1
TRBV20-1,TRBJ1-4,CSATENNEKLFF,0,1,1,1
TRBV20-1,TRBJ2-5,CSAKAQARGQYF,0,1,1,1
TRBV29-1,TRBJ1-1,CSALRWNTEAFF,0,1,1,1
TRBV29-1,TRBJ2-4,CSIVPDRNIQYF,0,1,1,1
TRBV28,TRBJ2-1,CASGYSFEQFF,0,1,1,1
TRBV6-2/3/5/6,TRBJ2-1,CASSFSNEQFF,0,1,1,1
TRBV2,TRBJ2-7,CASSVFYEQYF,0,1,1,1
TRBV6-1,TRBJ2-7,CASSALYEQYF,0,1,1,1
TRBV7-2,TRBJ2-3,CASSLESLAAF,0,1,1,1
TRBV5-4,TRBJ2-7,CASSSPRRQYF,0,1,1,1
TRBV5-1,TRBJ1-1,CASSGGAEAFF,0,1,1,1
TRBV29-1,TRBJ2-1,CSVYSYNEQFF,0,1,1,1
TRBV29-1,TRBJ2-1,CSHLRGHEQFF,0,1,1,1
TRBV5-1,TRBJ1-2,CASSSYRGRDFYYGYTF,0,1,1,1
TRBV11-2,TRBJ2-1,CASSLGGGQFNEQFF,0,1,1,1
TRBV20-1,TRBJ2-7,CSARPLFGGQHEQYF,0,1,1,1
TRBV20-1,TRBJ1-1,CSARDAQGGNTEAFF,0,2,1,2
TRBV19,TRBJ1-1,CASSISPGNTEAFF,0,1,1,1
TRBV5-5,TRBJ2-7,CASSLQGDSYEQYF,0,1,1,1
TRBV20-1,TRBJ2-2,CSARPPRGTGELFF,0,1,1,1
TRBV30,TRBJ2-3,CAWSVQTADTQYF,0,1,1,1
TRBV28,TRBJ1-4,CASSLTNEKLFF,0,1,1,1
TRBV16,TRBJ2-4,CASSPDKNIQCF,0,2,1,2
TRBV29-1,TRBJ2-7,CSVDGGQF,0,1,1,1
TRBV6-2/3/5/6,TRBJ1-1,CASSYSPDREGLADTEAFF,0,1,1,1
TRBV5-1,TRBJ2-2,CASSLVLAGGLGFSGELFF,0,1,1,1
TRBV28,TRBJ2-5,CAGSLIGRMRDLQETQYF,0,1,1,1
TRBV19,TRBJ1-5,CASSPSRTSSYSNQPQHF,0,1,1,1
TRBV6-2/3/5/6,TRBJ2-3,CASTSRPPTSGGAYTQYF,0,1,1,1
TRBV28,TRBJ2-6,CASSFPGQGPSGANVLTF,0,1,1,1
TRBV2,TRBJ2-7,CASSEGPSGGLFSYEQYF,0,1,1,1
TRBV5-6,TRBJ1-1,CASSLGQGAPVWSTEAFF,0,1,1,1
TRBV7-8,TRBJ2-1,CASSLGSERGAKRNEQFF,0,1,1,1
TRBV14,TRBJ1-5,CASSLLLGRDYSNQPQHF,0,1,1,1
TRBV7-2,TRBJ2-1,CASSPGLAGVSSYNEQFF,0,1,1,1
TRBV5-1,TRBJ2-7,CASSSGISGGATRTEQYF,0,1,1,1
TRBV4-1,TRBJ2-3,CASSQPRGSFTSTDTQYF,0,1,1,1
TRBV5-6,TRBJ2-1,CSSSLGVWTSGGNEQFF,0,1,1,1
TRBV12-5,TRBJ1-1,CASGLVPGTGSVTEAFF,0,1,1,1
TRBV30,TRBJ2-2,CAWNKALQRANTGELFF,0,2,1,2
TRBV19,TRBJ1-5,CASGDLGVPGRDQPQHF,0,1,1,1
TRBV19,TRBJ1-1,CASSIGHWVEAKTEAFF,0,1,1,1
TRBV19,TRBJ2-2,CASSMIAPSQGTGELFF,0,1,1,1
TRBV2,TRBJ2-3,CASGGGGVSESTDTQYF,0,1,1,1
TRBV6-2/3/5/6,TRBJ2-2,CASSLSLMQVTAGELFF,0,1,1,1
TRBV6-2/3/5/6,TRBJ2-3,CASSLEGLAGGRDTQYF,0,1,1,1
TRBV6-2/3/5/6,TRBJ1-6,CASSSTGLGPSNSPLHF,0,1,1,1
TRBV6-2/3/5/6,TRBJ2-6,CASSSRMGATGANVLTF,0,1,1,1
TRBV6-2/3/5/6,TRBJ2-7,CASSYIQWGQGSYEQYF,0,1,1,1
TRBV28,TRBJ1-2,CASSEASQGNFNYGYTF,0,1,1,1
TRBV7-2,TRBJ1-5,CASSFGADKGIHQPQHF,0,1,1,1
TRBV7-9,TRBJ1-1,CASSFRASHLRLAEAFF,0,1,1,1
TRBV14,TRBJ2-1,CASSRTVWQGPYNEQFF,0,1,1,1
TRBV28,TRBJ2-2,CASSTVEGTGGPGELFF,0,1,1,1
TRBV7-3,TRBJ2-6,CASSKTGLSSGANVLTF,0,1,1,1
TRBV10-1,TRBJ2-1,CASSKGTGGPLGNEQFF,0,1,1,1
TRBV5-1,TRBJ2-7,CASSSIGTEGPPYEQYF,0,1,1,1
TRBV20-1,TRBJ2-3,CSAPRPGGTSLTDTQYF,0,1,1,1
TRBV4-2,TRBJ2-2,YASSPAGLAGQTGELFF,0,1,1,1
TRBV10-3,TRBJ2-2,CAISRDSVPNTGELFF,0,1,1,1
TRBV24-1,TRBJ2-3,CATSDTDRSGSDTQYF,0,1,1,1
TRBV15,TRBJ1-5,CATSRDGRGINQPQHF,0,1,1,1
TRBV19,TRBJ1-5,CASISEPKDSNQPQHF,0,1,1,1
TRBV19,TRBJ2-7,CASRIGGQGSEYEQYF,0,1,1,1
TRBV19,TRBJ2-1,CASRAPTSSSYNEQFF,0,1,1,1
TRBV18,TRBJ2-1,CASSPLIDFQRNEQFF,0,1,1,1
TRBV18,TRBJ2-6,CASSPGVLSGANVLTF,0,1,1,1
TRBV18,TRBJ1-3,CASSPGGYHSGNTIYF,0,1,1,1
TRBV18,TRBJ2-3,CASSPNRGQGLKGQYF,0,1,1,1
TRBV18,TRBJ2-1,CASSSTGVFSYNEQFF,0,1,1,1
TRBV6-1,TRBJ2-1,CASLHPLAGTGNEQFF,0,1,1,1
TRBV12-3/4,TRBJ2-5,CASSPRTSGYKETQYF,0,1,1,1
TRBV2,TRBJ1-2,CASSGPGTGVNYGYTF,0,1,1,1
TRBV7-9,TRBJ1-4,CASSFSQEATNEKLFF,0,1,1,1
TRBV7-2,TRBJ2-3,CASSLEALAGVDTQYF,0,1,1,1
TRBV7-3,TRBJ2-6,CASSLSSVPGANVLTF,0,1,1,1
TRBV7-3,TRBJ2-2,CASSLRQGARTGELFF,0,1,1,1
TRBV7-3,TRBJ1-2,CASSSPNTTRFYGYTF,0,1,1,1
TRBV5-5,TRBJ2-7,CASSWAGQGVLYEQYF,0,1,1,1
TRBV11-2,TRBJ2-3,CASSPTGGWAADTQYF,0,1,1,1
TRBV4-2,TRBJ2-1,CASSPGLLYDYNEQFF,0,1,1,1
TRBV14,TRBJ2-1,CASSRDRGLGYNEQFF,0,1,1,1
TRBV5-6,TRBJ2-7,CASSRPGTGEFYEQYF,0,1,1,1
TRBV28,TRBJ1-5,CASSRQELGSRQPQHF,0,1,1,1
TRBV3-1,TRBJ2-5,CASSQERRQRQETQYF,0,1,1,1
TRBV7-3,TRBJ2-2,CASSAGTGGTAGELFF,0,1,1,1
TRBV12-3/4,TRBJ2-1,CASRTPDYQSYNEQFF,0,1,1,1
TRBV6-2/3/5/6,TRBJ2-1,CASKRTGQGSYNEQFF,0,1,1,1
TRBV10-2,TRBJ2-1,CASSESGDSRRGEQFF,0,1,1,1
TRBV5-1,TRBJ2-7,CASSLVLSGIAYEQYF,0,1,1,1
TRBV5-1,TRBJ2-3,CASSPGGTVIGDTQYF,0,1,1,1
TRBV5-1,TRBJ2-3,CASSPLPGPSTDTQYF,0,1,1,1
TRBV5-1,TRBJ1-1,CASSGGNRFTNTEAFF,0,1,1,1
TRBV29-1,TRBJ2-3,CSVGPGQIFTTDTQYF,0,1,1,1
TRBV29-1,TRBJ2-7,CSVEFRMGQRSYEQYF,0,1,1,1
TRBV28,TRBJ2-5,YASSSAGLAGGETQYF,0,1,1,1
TRBV30,TRBJ1-4,CAWSVQLGHGEKLFF,0,1,1,1
TRBV10-3,TRBJ1-4,CAISESGQGYEKLFF,0,1,1,1
TRBV10-3,TRBJ2-3,CAISPLAGGTDTQYF,0,1,1,1
TRBV19,TRBJ1-4,CASSSPGEPNEKLFF,0,1,1,1
TRBV19,TRBJ2-1,CASSISQRDGNEQFF,0,1,1,1
TRBV19,TRBJ1-1,CASSIVAGVATEAFF,0,1,1,1
TRBV19,TRBJ2-1,CASSTGTYSYNEQFF,0,1,1,1
TRBV19,TRBJ1-6,CASSRDTYQFSPLHF,0,2,1,2
TRBV19,TRBJ2-2,CASRPSGLNTGELFF,0,1,1,1
TRBV9,TRBJ1-6,CASNDRGRRDSPLHF,0,1,1,1
TRBV18,TRBJ1-3,CASSPSGTQGNTIYF,0,1,1,1
TRBV18,TRBJ1-4,CASSPPGGAIEKLFF,0,1,1,1
TRBV28,TRBJ1-5,CASAPGGAGDPAQHF,0,1,1,1
TRBV19,TRBJ2-1,CASGRGGVSYNEQFF,0,1,1,1
TRBV6-2/3/5/6,TRBJ2-3,CASIELAGGLDTQYF,0,1,1,1
TRBV12-3/4,TRBJ2-3,CASTPFQGLTDTQYF,0,1,1,1
TRBV6-2/3/5/6,TRBJ1-5,CASSLGRAGNQPQHF,0,1,1,1
TRBV27,TRBJ1-1,CASSLSRGMNTEAFF,0,1,1,1
TRBV6-2/3/5/6,TRBJ1-2,CASSLWAGGADGYTF,0,1,1,1
TRBV28,TRBJ1-1,CASSLRDRGNTEAFF,0,1,1,1
TRBV12-3/4,TRBJ1-2,CASSLAPAGHYGYTF,0,1,1,1
TRBV12-3/4,TRBJ2-2,CASSLARGRTGELFF,0,1,1,1
TRBV28,TRBJ1-4,CASSLGGQGDEKLFF,0,1,1,1
TRBV12-3/4,TRBJ2-5,CASSSSGGVMETQYF,0,1,1,1
TRBV12-3/4,TRBJ1-5,CASSSLPEANQPQHF,0,1,1,1
TRBV12-3/4,TRBJ1-5,CASSSGQEYNQPQHF,0,1,1,1
TRBV28,TRBJ2-5,CASSSLSAIKETQYF,0,1,1,1
TRBV6-2/3/5/6,TRBJ2-3,CASSYLSGTTDTQYF,0,1,1,1
TRBV6-2/3/5/6,TRBJ2-3,CASSYSPGGTDTQYF,0,1,1,1
TRBV6-2/3/5/6,TRBJ2-7,CASSYGTDRSHEQYI,0,1,1,1
TRBV5-4,TRBJ2-2,CASSREYGGTGELFF,0,1,1,1
TRBV6-2/3/5/6,TRBJ1-1,CASSRIVDDYEGAFF,0,1,1,1
TRBV6-1,TRBJ2-3,CASSRRAGVTDTQYS,0,1,1,1
TRBV6-4,TRBJ2-7,CASSRQGVSSYEQYF,0,1,1,1
TRBV6-1,TRBJ2-5,CASSQTTGKQETRYF,0,1,1,1
TRBV6-1,TRBJ1-5,CASSEGDRVGQPQHF,0,1,1,1
TRBV27,TRBJ1-1,CASSTPSGQNTEAFF,0,1,1,1
TRBV7-2,TRBJ2-3,CASSFGPSRTDTQYF,0,1,1,1
TRBV3-1,TRBJ2-5,CASSFGQGRRETQYF,0,1,1,1
TRBV5-6,TRBJ1-1,CASSLSIWGNTEAFF,0,1,1,1
TRBV5-4,TRBJ2-1,CASSLSSGGVRAQFF,0,1,1,1
TRBV5-4,TRBJ2-6,CASSLSGSGANVLTF,0,1,1,1
TRBV5-4,TRBJ2-5,CASSLAPTLQETQYF,0,1,1,1
TRBV7-3,TRBJ2-2,CASSLHGPNTGELFF,0,1,1,1
TRBV11-2,TRBJ2-1,CASSLVETQYNEQFF,0,1,1,1
TRBV7-2,TRBJ1-2,CASSLEAQTPYGYTF,0,1,1,1
TRBV6-1,TRBJ2-1,CASSLSGFSDNEQFF,0,1,1,1
TRBV5-6,TRBJ2-7,CASSYRDRHSYEQYF,0,1,1,1
TRBV6-2/3/5/6,TRBJ1-6,CASSLDRGWDSPLHF,0,1,1,1
TRBV7-2,TRBJ2-5,CASSLGGQPEETQYF,0,1,1,1
TRBV28,TRBJ2-7,CASSPLGARFYEQYF,0,1,1,1
TRBV7-8,TRBJ1-3,CASSPGTGAGNTIYF,0,1,1,1
TRBV3-1,TRBJ1-6,CASSPPGRKNSPLHF,0,1,1,1
TRBV3-1,TRBJ2-7,CASSPRQYLSYEQYF,0,1,1,1
TRBV6-2/3/5/6,TRBJ2-1,CASSPGAGAYDEQFF,0,1,1,1
TRBV6-2/3/5/6,TRBJ1-1,CASSHPGEVNTEAFF,0,1,1,1
TRBV3-1,TRBJ2-3,CASSHRNPSTDTQYF,0,1,1,1
TRBV3-1,TRBJ1-6,CASSQSQGVNSPLHF,0,1,1,1
TRBV9,TRBJ2-1,CASSARDRSYNEQFF,0,1,1,1
TRBV11-2,TRBJ2-3,CASSAYLAGTDTQYF,0,1,1,1
TRBV2,TRBJ2-5,CASSTGAGGQETQYF,0,1,1,1
TRBV7-8,TRBJ1-3,CASRPDGISGNTIYF,0,1,1,1
TRBV2,TRBJ2-5,CASRGRVAYQETQYF,0,1,1,1
TRBV5-1,TRBJ1-2,CASSLAAGMNYGYTF,0,2,1,2
TRBV5-1,TRBJ2-1,CASSSTGSSYNEQFF,0,2,1,2
TRBV5-1,TRBJ2-1,CASSSTGTSVREQFF,0,1,1,1
TRBV5-1,TRBJ2-2,CASSLTGVGTGELFF,0,1,1,1
TRBV5-1,TRBJ2-1,CASSAQPGPENEQFF,0,1,1,1
TRBV5-1,TRBJ2-3,CASSTSSGGADTQYF,0,1,1,1
TRBV20-1,TRBJ2-1,CSAPSRGTGPGEQFF,0,1,1,1
TRBV20-1,TRBJ2-3,CSAQLTSASTDTQYF,0,1,1,1
TRBV20-1,TRBJ2-3,CSATLAGGPSDTQYF,0,1,1,1
TRBV20-1,TRBJ2-3,CSASLTSGAADTQYF,0,1,1,1
TRBV20-1,TRBJ1-5,CSARGRGLGNQPQHF,0,1,1,1
TRBV20-1,TRBJ2-5,CSARDFKDYQETQYF,0,1,1,1
TRBV20-1,TRBJ2-7,CSARDSQRGIYEQYF,0,1,1,1
TRBV20-1,TRBJ1-5,CSARDLGEGNQPQHF,0,1,1,1
TRBV20-1,TRBJ2-1,CSARELAGGGNEQFF,0,1,1,1
TRBV20-1,TRBJ2-1,CSAPLAGGFYNEQFF,0,1,1,1
TRBV20-1,TRBJ2-1,CSATGLAGDYNEQFF,0,1,1,1
TRBV29-1,TRBJ2-7,CSVEYGDRAPYEQYF,0,1,1,1
TRBV29-1,TRBJ2-3,CSVERLAGVTDTQYF,0,1,1,1
TRBV29-1,TRBJ1-1,CSVEGTLDRRFEAFF,0,1,1,1
TRBV29-1,TRBJ2-1,CSAGKWGSNYNEQFF,0,1,1,1
TRBV5-4,TRBJ1-1,CACSLGQENTEAFF,0,1,1,1
TRBV30,TRBJ2-7,CAWNREAGAYEQYF,0,1,1,1
TRBV18,TRBJ2-7,CARSPGSGEYEQYF,0,1,1,1
TRBV10-3,TRBJ2-7,CAIMRTGPSYEQYF,0,1,1,1
TRBV19,TRBJ1-1,CATADPGGITEAFF,0,1,1,1
TRBV15,TRBJ1-2,CATSRQGDNYGYTF,0,1,1,1
TRBV19,TRBJ1-6,CASSSLKETSPLHF,0,1,1,1
TRBV19,TRBJ1-1,CASSYRVRNTEAFF,0,1,1,1
TRBV19,TRBJ1-5,CASSIVDIYQPQHF,0,1,1,1
TRBV18,TRBJ2-5,CASSPSGVQETQYF,0,1,1,1
TRBV18,TRBJ2-5,CASSRRQDRETQYF,0,1,1,1
TRBV18,TRBJ2-3,CASSTGQDPDTQYF,0,1,1,1
TRBV11-2,TRBJ2-7,CASCLTGGRYEQYF,0,1,1,1
TRBV28,TRBJ2-2,CASWDRANTGELFF,0,1,1,1
TRBV2,TRBJ2-7,CASVKGLAGYEQYF,0,1,1,1
TRBV5-5,TRBJ2-3,CASTSWGGTDTQYF,0,1,1,1
TRBV28,TRBJ2-5,CASTSSHALETQYF,0,1,1,1
TRBV6-2/3/5/6,TRBJ1-5,CASTLTGGGQPQHF,0,1,1,1
TRBV2,TRBJ2-7,CASTTRGLGGEQYF,0,1,1,1
TRBV3-1,TRBJ1-3,CASTTQHSGITIYF,0,1,1,1
TRBV6-4,TRBJ1-1,CASTTGPMNTEAFF,0,1,1,1
TRBV28,TRBJ1-5,CASSLYRSNQPQHF,0,1,1,1
TRBV28,TRBJ1-4,CASSLSSPLTQLFF,0,1,1,1
TRBV6-2/3/5/6,TRBJ1-1,CASSSQGAGTEAFF,0,1,1,1
TRBV12-3/4,TRBJ1-6,CASSSGGNNSPLHF,0,1,1,1
TRBV27,TRBJ2-5,CASSSSGGLETQYF,0,1,1,1
TRBV6-2/3/5/6,TRBJ2-3,CASSYSGRGDTQYF,0,1,1,1
TRBV6-2/3/5/6,TRBJ1-2,CASSLLSANYGYTF,0,1,1,1
TRBV2,TRBJ1-2,CASSLQGPDYGYTF,0,1,1,1
TRBV12-3/4,TRBJ1-2,CASSPLTGNYGYTF,0,1,1,1
TRBV12-3/4,TRBJ2-3,CASSRQDLTDTQYF,0,1,1,1
TRBV6-1,TRBJ2-2,CASSGQGSTGELFF,0,1,1,1
TRBV2,TRBJ2-3,CASSELAGADTQYF,0,1,1,1
TRBV2,TRBJ2-1,CASSEMVVYNEQFF,0,1,1,1
TRBV28,TRBJ2-7,CASSTPGPNNEQYF,0,1,1,1
TRBV7-3,TRBJ1-2,CASSLPGVDYGYTF,0,1,1,1
TRBV7-9,TRBJ2-5,CASSLVPGVETQYF,0,1,1,1
TRBV11-2,TRBJ2-7,CASSLGGRPYEQYF,0,1,1,1
TRBV7-9,TRBJ2-1,CASSLEPGYNEQFF,0,1,1,1
TRBV7-3,TRBJ2-1,CASSSPGVYNEQFF,0,1,1,1
TRBV7-2,TRBJ1-1,CASSSPGHSTEAFF,0,1,1,1
TRBV11-1,TRBJ2-1,CASSSGPPRYEQFF,0,1,1,1
TRBV7-2,TRBJ2-5,CASSSDRVEETQYF,0,1,1,1
TRBV5-6,TRBJ2-3,CASSWGTSTDTQYF,0,1,1,1
TRBV13,TRBJ1-4,CASSPLSTNEKLFF,0,1,1,1
TRBV3-1,TRBJ1-1,CASSPTGLDTEAFF,0,1,1,1
TRBV11-1,TRBJ1-1,CASSPTRTRTEAFF,0,1,1,1
TRBV3-1,TRBJ1-1,CASSREYSYLEAFF,0,1,1,1
TRBV11-2,TRBJ1-2,CASSRNRDSYGYTF,0,1,1,1
TRBV3-1,TRBJ2-7,CASSRGGTTYEQYF,0,1,1,1
TRBV7-8,TRBJ2-7,CASSRIQGAYEQYF,0,1,1,1
TRBV14,TRBJ2-5,CASSQAQPPETQYF,0,1,1,1
TRBV3-1,TRBJ1-1,CASSQAKQNTVAFF,0,1,1,1
TRBV14,TRBJ2-7,CASSQDRGTYEQYF,0,1,1,1
TRBV6-4,TRBJ2-3,CASSDRGSEDTQYF,0,1,1,1
TRBV5-4,TRBJ2-7,CASSENDRDYEQYF,0,1,1,1
TRBV7-2,TRBJ2-3,CASSITGISDTQYF,0,1,1,1
TRBV28,TRBJ2-7,CASRVAGVIYEQYF,0,1,1,1
TRBV12-3/4,TRBJ2-2,CASRMTGPTGELFF,0,1,1,1
TRBV28,TRBJ1-1,CASNQAAVNTEAFF,0,1,1,1
TRBV5-1,TRBJ1-1,CASTFGTEGAEAFF,0,1,1,1
TRBV5-1,TRBJ1-4,CASSFTSGTENLFF,0,1,1,1
TRBV5-1,TRBJ1-5,CASSLGGSNQPQHF,0,1,1,1
TRBV5-1,TRBJ2-5,CASSLDTGQETQHF,0,1,1,1
TRBV5-1,TRBJ2-3,CASSLEASGYTQYF,0,1,1,1
TRBV5-1,TRBJ1-5,CASSLTGGEQPQHF,0,1,1,1
TRBV5-1,TRBJ2-1,CASSYDYSYNEQFF,0,1,1,1
TRBV5-1,TRBJ1-2,CASSPAEGRDGYTF,0,1,1,1
TRBV5-1,TRBJ1-2,CASSPDSGNYGYTF,0,2,1,2
TRBV5-1,TRBJ2-6,CASSRQSGANVLTF,0,1,1,1
TRBV5-1,TRBJ1-1,CASSKGQRDTEAFF,0,1,1,1
TRBV20-1,TRBJ2-7,CSAGGQGAAYEQYF,0,1,1,1
TRBV20-1,TRBJ2-7,CSARAFTGGDEQYF,0,1,1,1
TRBV20-1,TRBJ2-7,CSARDLGGHDEQYF,0,1,1,1
TRBV20-1,TRBJ2-7,CSAREAGGPYEQYF,0,1,1,1
TRBV20-1,TRBJ2-3,CSADRDRSTDTQYF,0,1,1,1
TRBV29-1,TRBJ2-3,CSFTGTSSTDTQYF,0,1,1,1
TRBV29-1,TRBJ1-3,CSVVIPVSGNTIYF,0,1,1,1
TRBV29-1,TRBJ2-1,CSVAQGAYYNEQFF,0,1,1,1
TRBV29-1,TRBJ1-2,CSVARDILGYGYTF,0,1,1,1
TRBV30,TRBJ2-5,CAWSVSGGKTQYF,0,1,1,1
TRBV10-3,TRBJ1-1,CAIGDRGDTEAFF,0,1,1,1
TRBV10-3,TRBJ2-5,CAISSTSRETQYF,0,1,1,1
TRBV10-3,TRBJ1-1,CAISRGANTEAFF,0,1,1,1
TRBV10-3,TRBJ1-1,CAIREQPNTEAFF,0,1,1,1
TRBV19,TRBJ2-1,CASSGLSYNEQFF,0,1,1,1
TRBV19,TRBJ1-5,CASSRDSLEPQHF,0,1,1,1
TRBV19,TRBJ2-7,CASSEGGTYEQYF,0,1,1,1
TRBV19,TRBJ2-3,CASRQASTDTQYF,0,1,1,1
TRBV19,TRBJ1-1,CASNRAENTEAFF,0,1,1,1
TRBV18,TRBJ1-1,CASSLHKDTEAFF,0,1,1,1
TRBV18,TRBJ1-2,CASSLALNYGYTF,0,2,1,2
TRBV18,TRBJ2-1,CASSPPEGTEQFF,0,1,1,1
TRBV28,TRBJ2-1,CASRPTGDNEQFF,0,1,1,1
TRBV2,TRBJ1-2,CASRSSPSYGYTF,0,1,1,1
TRBV6-2/3/5/6,TRBJ2-3,CASSFFGADTQYF,0,1,1,1
TRBV6-2/3/5/6,TRBJ1-1,CASSFSGGTEAFF,0,1,1,1
TRBV28,TRBJ1-5,CASSFGHGQPQHF,0,1,1,1
TRBV27,TRBJ2-3,CASSFGIGDTQYF,0,1,1,1
TRBV12-3/4,TRBJ2-1,CASSLLGSNEQFF,0,1,1,1
TRBV12-3/4,TRBJ2-5,CASSLGTAETQYF,0,1,1,1
TRBV12-3/4,TRBJ1-1,CASSSQGGTEAFF,0,1,1,1
TRBV6-2/3/5/6,TRBJ1-1,CASSYGTLGEAFF,0,1,1,1
TRBV6-2/3/5/6,TRBJ2-5,CASSYTDQETQYF,0,1,1,1
TRBV28,TRBJ2-7,CASSLRQAYEQYF,0,1,1,1
TRBV12-3/4,TRBJ1-5,CASSLSGDQPQHF,0,1,1,1
TRBV6-4,TRBJ2-7,CASSDDKTYEQYF,0,1,1,1
TRBV5-5,TRBJ2-1,CASSFLDYNEQFF,0,1,1,1
TRBV7-6,TRBJ1-1,CASSFTLNTEAFF,0,1,1,1
TRBV5-6,TRBJ2-5,CASSLDSEETQYF,0,1,1,1
TRBV7-2,TRBJ2-3,CASSLPHQSTQYF,0,1,1,1
TRBV7-2,TRBJ2-1,CASSLPIRTEQFF,0,1,1,1
TRBV5-6,TRBJ2-7,CASSLHLAGEQYF,0,1,1,1
TRBV11-3,TRBJ2-1,CASSLGGGNEQFF,0,1,1,1
TRBV11-2,TRBJ2-3,CASSLGVGDTQYF,0,1,1,1
TRBV11-2,TRBJ2-6,CASSLTDGDVLTF,0,1,1,1
TRBV6-2/3/5/6,TRBJ2-7,CASSPDNLYEQYF,0,1,1,1
TRBV7-6,TRBJ2-5,CASSPPAQETQYF,0,1,1,1
TRBV5-4,TRBJ2-3,CASSRLAGARQYF,0,1,1,1
TRBV3-1,TRBJ2-7,CASSQGRESEQYF,0,1,1,1
TRBV3-1,TRBJ2-7,CASSQDRTGEQYF,0,1,1,1
TRBV3-1,TRBJ2-1,CASSQEGANEQFF,0,1,1,1
TRBV11-1,TRBJ2-1,CASRMSSSNEQFF,0,1,1,1
TRBV5-4,TRBJ2-4,CASRGGAVDIQYF,0,1,1,1
TRBV6-2/3/5/6,TRBJ1-6,CASNQGFNSPLHL,0,1,1,1
TRBV5-1,TRBJ1-1,CASSTQLNTEAFF,0,1,1,1
TRBV5-1,TRBJ2-7,CASSLEANYEQYF,0,1,1,1
TRBV5-1,TRBJ2-3,CASSSKRTDTQYF,0,1,1,1
TRBV4-1,TRBJ1-2,CASSQGTVYGYTF,0,1,1,1
TRBV29-1,TRBJ2-3,CSLNPTRADTQYF,0,1,1,1
TRBV20-1,TRBJ1-1,CSVETTGGVEAFF,0,1,1,1
TRBV20-1,TRBJ2-3,CSAGTSSTDTQYF,0,1,1,1
TRBV20-1,TRBJ1-1,CSASVTKNTEAFF,0,1,1,1
TRBV20-1,TRBJ1-1,CSARPRMNTEAFF,0,1,1,1
TRBV20-1,TRBJ2-1,CSARGGSGDEQFF,0,1,1,1
TRBV20-1,TRBJ2-3,CSAPKAGTDTQYF,0,1,1,1
TRBV29-1,TRBJ2-7,CSAPGQGTYEQYF,0,1,1,1
TRBV20-1,TRBJ2-7,CSARVGGFYEQYF,0,1,1,1
TRBV29-1,TRBJ2-7,CSVLDPYSYEQYF,0,1,1,1
TRBV29-1,TRBJ2-2,CSVAFQGTGELFF,0,1,1,1
TRBV29-1,TRBJ1-2,CSVDLDRVSGYTF,0,1,1,1
TRBV29-1,TRBJ1-5,CSVEGPLGQPQHF,0,1,1,1
TRBV29-1,TRBJ2-1,CSVEDRTGFEQFF,0,1,1,1
TRBV29-1,TRBJ1-1,CSAGQGDDTEAFF,0,1,1,1
TRBV29-1,TRBJ1-3,CSAYETPGNTIYF,0,1,1,1
TRBV19,TRBJ1-1,CASTSQGRGASF,0,1,1,1
TRBV19,TRBJ1-5,CASSVGNQPQHF,0,1,1,1
TRBV18,TRBJ1-2,CASSPKQGGNTF,0,1,1,1
TRBV18,TRBJ2-7,CASSQRTGEQYF,0,1,1,1
TRBV6-2/3/5/6,TRBJ1-1,CASGVRDTEAFF,0,1,1,1
TRBV28,TRBJ1-2,CASSSFRYGYTF,0,1,1,1
TRBV6-2/3/5/6,TRBJ2-7,CASSYFPSEQYF,0,1,1,1
TRBV28,TRBJ1-1,CASSPRRTEAFF,0,1,1,1
TRBV28,TRBJ1-4,CASSPANEKLFF,0,1,1,1
TRBV12-3/4,TRBJ2-7,CASSHGTYEQYF,0,1,1,1
TRBV5-4,TRBJ2-3,CASSFDSDTQYF,0,1,1,1
TRBV7-9,TRBJ2-7,CASSLSSYEQYF,0,1,1,1
TRBV11-2,TRBJ2-5,CASSLYQETQYF,0,2,1,2
TRBV7-2,TRBJ1-1,CASSLVRVGAFF,0,1,1,1
TRBV7-9,TRBJ1-5,CASSLDNQPQHF,0,1,1,1
TRBV3-1,TRBJ2-2,CASSPDDGELFF,0,1,1,1
TRBV28,TRBJ2-7,CASRKDGVGQYF,0,1,1,1
TRBV5-1,TRBJ2-3,CACSLDPDTQYF,0,1,1,1
TRBV10-2,TRBJ1-5,CASSTSGQPQHF,0,1,1,1
TRBV20-1,TRBJ2-3,CSARAATNTQYF,0,1,1,1
TRBV20-1,TRBJ2-7,CSASGVFYEQYF,0,1,1,1
TRBV29-1,TRBJ2-7,CSVAPSSYEQYF,0,1,1,1
TRBV29-1,TRBJ2-3,CSVEGSTDTQYF,0,1,1,1
TRBV29-1,TRBJ2-3,CSVGPRGDTQYF,0,1,1,1
TRBV29-1,TRBJ2-5,CSAGTDKETQYF,0,2,1,2
TRBV29-1,TRBJ1-1,RSVVEQGTEAFF,0,1,1,1
TRBV18,TRBJ2-5,CASSQQETQYF,0,1,1,1
TRBV28,TRBJ1-4,CASSLREKLFF,0,1,1,1
TRBV5-4,TRBJ2-5,CASSFRETQYF,0,1,1,1
TRBV7-9,TRBJ1-1,CASSLDTEAFF,0,1,1,1
TRBV5-1,TRBJ2-3,CASTSTDTQYF,0,1,1,1
TRBV20-1,TRBJ2-7,CSASLDTQQYF,0,1,1,1
TRBV20-1,TRBJ1-1,CSARDLSEAFF,0,1,1,1
TRBV29-1,TRBJ2-5,CSTRGSETQYF,0,1,1,1
TRBV19,TRBJ2-5,CASSTPRKRGVYQETQYF,0,1,1,1
TRBV11-2,TRBJ2-1,CASSFAPPGQGLDNERFF,0,1,1,1
TRBV19,TRBJ1-5,CASSRGGGQVGNQPQHF,0,2,1,2
TRBV14,TRBJ1-1,CASSQDALQGKATEAFF,0,1,1,1
TRBV19,TRBJ1-4,CASSGYASLGGEKLFF,0,1,1,1
TRBV3-1,TRBJ2-3,CASSQDMGGGTDTQYF,0,1,1,1
TRBV29-1,TRBJ2-7,CSVGLEDRSPSYEQYF,0,1,1,1
TRBV10-3,TRBJ2-3,CAISYLAGRTGTQYF,0,1,1,1
TRBV19,TRBJ1-4,CASSTSGQTNEKLFF,0,1,1,1
TRBV28,TRBJ1-5,CASSFLSNSNQPQHF,0,1,1,1
TRBV28,TRBJ2-1,CASSPLTDRHNELFF,0,2,1,2
TRBV2,TRBJ1-2,CASSDVWDTNYGYTF,0,1,1,1
TRBV5-5,TRBJ2-1,CASSLEGGNNNEQFF,0,2,1,2
TRBV5-1,TRBJ2-2,CASSLDLGNTGELFF,0,1,1,1
TRBV5-1,TRBJ1-6,CASSWRTGGNSPLHF,0,1,1,1
TRBV5-1,TRBJ2-3,CASSPGTGITDTQCF,0,1,1,1
TRBV18,TRBJ2-7,CASSRDREFDEQYF,0,1,1,1
TRBV2,TRBJ1-5,CASSGSTAHQPQHF,0,1,1,1
TRBV7-9,TRBJ2-5,CASSLAGAQETQYF,0,2,1,2
TRBV5-1,TRBJ2-5,CASSLLGVQETQYF,0,2,1,2
TRBV12-5,TRBJ1-5,CASGLARYRGPRDGYSNQPQHF,0,1,1,1
TRBV28,TRBJ1-2,CASSLSTDRPSSNLQANYGYTF,0,1,1,1
TRBV7-3,TRBJ2-5,CASSSTRDRASSGSELETQYF,0,1,1,1
TRBV6-2/3/5/6,TRBJ2-1,CASSLSDLLAGGFDYNEQFF,0,1,1,1
TRBV28,TRBJ1-1,CASSLPTGAGAGGWTEAFF,0,1,1,1
TRBV28,TRBJ1-5,CASSSLTGWGGYSNQPQHF,0,1,1,1
TRBV5-5,TRBJ2-6,CASSSRTSGVPSGANVLTF,0,1,1,1
TRBV7-2,TRBJ2-4,CASSSGTSGGFLAKNIQYF,0,1,1,1
TRBV7-9,TRBJ2-6,CASSPSRQGALAGANVLTF,0,1,1,1
TRBV5-8,TRBJ2-1,CASSKKASGGAGTYNEQFF,0,1,1,1
TRBV5-1,TRBJ2-3,CASSLTPGTSEVSTDTQYF,0,1,1,1
TRBV20-1,TRBJ2-5,CSGRDLRRGLFRFQETQYF,0,1,1,1
TRBV29-1,TRBJ2-2,CSVEEFRGFDGRWTGELFF,0,1,1,1
TRBV30,TRBJ2-1,CAWSVLKSGLKNPNEQFF,0,1,1,1
TRBV19,TRBJ1-6,CASSSAGTLWGRNSPLHF,0,1,1,1
TRBV6-1,TRBJ1-1,CASSQPAGQGVVNTEAFF,0,1,1,1
TRBV7-8,TRBJ2-1,CASSFLAGGQKAYNEQFF,0,1,1,1
TRBV7-8,TRBJ2-1,CASSLAISGGGTYNEQFF,0,1,1,1
TRBV11-2,TRBJ2-1,CASSLRFSGTRRYNEQFF,0,1,1,1
TRBV5-4,TRBJ2-1,CASSPRTSGVARYNEQFF,0,1,1,1
TRBV3-1,TRBJ1-1,CASSPWKTQGRANTEAFF,0,1,1,1
TRBV7-8,TRBJ2-1,CASSPLAGTTYSYNEQFF,0,1,1,1
TRBV14,TRBJ2-7,CASSPYETQPNTSYEQYF,0,1,1,1
TRBV28,TRBJ1-1,CASSHFRFRGRMDTEAFF,0,1,1,1
TRBV5-1,TRBJ2-3,CASSLGTSSGGVSDTQYF,0,1,1,1
TRBV5-1,TRBJ2-3,CASRVPVDAFVATDTQYF,0,1,1,1
TRBV20-1,TRBJ1-6,CSAAGNRGDSSYNSPLHF,0,1,1,1
TRBV20-1,TRBJ2-1,CSARAPGLAGETYNEQFF,0,1,1,1
TRBV15,TRBJ1-5,CATSRDSRMRGNQPQHF,0,1,1,1
TRBV6-4,TRBJ2-1,CASGLAGAPSSYNEQFF,0,1,1,1
TRBV7-9,TRBJ1-1,CASTHPGTGSWYTEAFF,0,1,1,1
TRBV6-2/3/5/6,TRBJ1-2,CASSLRISRAAGYGYTF,0,1,1,1
TRBV3-1,TRBJ2-7,CASSLGSPGGGGLEQYF,0,1,1,1
TRBV28,TRBJ2-3,CASSPPLTGTSTDTQYF,0,1,1,1
TRBV7-9,TRBJ2-3,CASSPGTSGIYQDTQYF,0,1,1,1
TRBV12-3/4,TRBJ1-2,CASSPPRRDTQNYGYTF,0,1,1,1
TRBV7-9,TRBJ2-1,CASSPRDGMAVGNEQFF,0,1,1,1
TRBV14,TRBJ2-1,CASSPGTNSFPYNEQFF,0,1,1,1
TRBV7-9,TRBJ2-3,CASSPPRLAGQTDTQYF,0,1,1,1
TRBV12-3/4,TRBJ2-5,CASSRSPLAQPRETQYF,0,1,1,1
TRBV3-1,TRBJ2-3,CASSQVPGGGRADTQYF,0,1,1,1
TRBV3-1,TRBJ2-5,CASSQVALAGGVETQYF,0,1,1,1
TRBV4-2,TRBJ1-3,CASSQDQGGNTRNTIYF,0,1,1,1
TRBV4-2,TRBJ2-2,CASSQTDRGGGIGELFF,0,1,1,1
TRBV9,TRBJ2-3,CASSERERVLSTDTQYF,0,1,1,1
TRBV7-9,TRBJ1-1,CASSEWGGQGPNTEAFF,0,1,1,1
TRBV11-1,TRBJ2-5,CASSMGHSGSPQETQYF,0,1,1,1
TRBV10-2,TRBJ2-1,CASSELSGASSYNEQFF,0,1,1,1
TRBV5-1,TRBJ2-1,CASSLARTGQLDNEQFF,0,1,1,1
TRBV5-1,TRBJ2-3,CASSLARDSPSTDTQYF,0,1,1,1
TRBV5-1,TRBJ2-6,CASSLAAGSTGANVLTF,0,1,1,1
TRBV5-1,TRBJ1-3,CASSLEAGLSSGNTIYF,0,1,1,1
TRBV5-1,TRBJ2-1,CASSRTSGGAVYNEQFF,0,1,1,1
TRBV5-1,TRBJ2-5,CASRDTLNSKIQETQYF,0,1,1,1
TRBV20-1,TRBJ2-6,CSAPSGTVSSGANVLTF,0,1,1,1
TRBV29-1,TRBJ2-2,CSVGTSGGAVDTGELFF,0,1,1,1
TRBV29-1,TRBJ2-3,CSVDGLAGGPKADTQYF,0,1,1,1
TRBV29-1,TRBJ2-1,CSAGAGNQVGNYNEQFF,0,1,1,1
TRBV28,TRBJ1-2,CACILFPDRIIVCYTF,0,1,1,1
TRBV10-3,TRBJ1-1,CAISESSDSVNTEAFF,0,1,1,1
TRBV10-3,TRBJ2-5,CAIRSSIGRGKETQYF,0,1,1,1
TRBV19,TRBJ1-2,CASSYRDRTSHYGYTF,0,1,1,1
TRBV19,TRBJ2-1,CASSRLPGQGLVLEFF,0,1,1,1
TRBV19,TRBJ2-1,CASSILGPSSYNEQFF,0,1,1,1
TRBV19,TRBJ2-1,CASSIYGRGPQDEQFF,0,1,1,1
TRBV19,TRBJ2-3,CASSIDLSGVTDTQYF,0,1,1,1
TRBV18,TRBJ2-1,CASSPPPSGRANEQFF,0,1,1,1
TRBV18,TRBJ1-4,CASSQFGGGHNEKLFF,0,1,1,1
TRBV28,TRBJ2-1,CASSFETSGIDNEQFF,0,1,1,1
TRBV12-3/4,TRBJ2-3,CASSLDPDPSTDMQYF,0,1,1,1
TRBV27,TRBJ2-5,CASSLYLAGNQETQYF,0,1,1,1
TRBV28,TRBJ1-5,CASSLATGTRNKPQHF,0,1,1,1
TRBV6-2/3/5/6,TRBJ2-3,CASSLIGGGSTDTQYF,0,1,1,1
TRBV28,TRBJ1-1,CASSSPTGNLNTEAFF,0,1,1,1
TRBV6-2/3/5/6,TRBJ2-1,CASSPSQGASYNEQFF,0,1,1,1
TRBV12-3/4,TRBJ2-2,CASSGLGLPNTGELFF,0,1,1,1
TRBV28,TRBJ2-7,CASSDFGQGEFREQYF,0,1,1,1
TRBV25-1,TRBJ1-1,CASSEPGRGLGTEAFF,0,1,1,1
TRBV2,TRBJ2-7,CASSEAPRQATYEQYF,0,1,1,1
TRBV6-1,TRBJ2-3,CASSEGASTGSDTQYF,0,1,1,1
TRBV28,TRBJ2-1,CASSTTSGGAYNEQFF,0,1,1,1
TRBV5-6,TRBJ1-5,CASSFGAGQGNQPQHF,0,1,1,1
TRBV7-2,TRBJ2-4,CASSFSALGPKNIQYF,0,1,1,1
TRBV5-6,TRBJ2-1,CASSLARRARGHEQFF,0,1,1,1
TRBV5-6,TRBJ2-1,CASSLSAGGRNNEQFF,0,1,1,1
TRBV7-2,TRBJ2-7,CASSLVAGMVSYEQYF,0,1,1,1
TRBV7-2,TRBJ2-1,CASSLGGGVTNNEQFF,0,1,1,1
TRBV7-2,TRBJ2-1,CASSLGPGTASIEQFF,0,1,1,1
TRBV7-9,TRBJ2-3,CASSLDWVGSTDTQYF,0,1,1,1
TRBV11-2,TRBJ2-4,CASSSISGDKSGIQYF,0,1,1,1
TRBV9,TRBJ2-3,CASSSSSGGYADTQYF,0,1,1,1
TRBV28,TRBJ1-5,CASSPPGTARNQPQHF,0,1,1,1
TRBV7-2,TRBJ2-3,CASSPRTSGGADTQYF,0,1,1,1
TRBV7-2,TRBJ2-3,CASSPRLAGATGTQYF,0,1,1,1
TRBV3-1,TRBJ2-1,CASSRSLAVEYNEQFF,0,1,1,1
TRBV27,TRBJ2-1,CASSHDRDSVYNEQFF,0,1,1,1
TRBV3-1,TRBJ1-1,CASSQRAGMRNTEAFF,0,1,1,1
TRBV3-1,TRBJ2-6,CASSQFASAGANVLTF,0,1,1,1
TRBV3-1,TRBJ1-1,CASSQQRGVVNTEAFF,0,1,1,1
TRBV3-1,TRBJ1-1,CASSQGTGGPGTEAFF,0,1,1,1
TRBV14,TRBJ1-5,CASSQIRRGANQPQHF,0,1,1,1
TRBV9,TRBJ2-5,CASSVGPDYRQETQYF,0,1,1,1
TRBV7-6,TRBJ2-2,CASRSSPNRDSGELFF,0,1,1,1
TRBV28,TRBJ2-7,CASRLTPGPTGSEQYF,0,1,1,1
TRBV6-1,TRBJ1-5,CASNGVGRLNFQPQHF,0,1,1,1
TRBV6-2/3/5/6,TRBJ2-3,CASNYLGGVDTDTQYF,0,1,1,1
TRBV5-1,TRBJ1-4,CASSSGTDSTNEKLFF,0,1,1,1
TRBV10-2,TRBJ2-7,CASSEISGTSSYEQYF,0,1,1,1
TRBV5-1,TRBJ2-1,CASSLFGQGASNEQFF,0,1,1,1
TRBV5-1,TRBJ1-4,CASSLVAQAPNEKLFF,0,1,1,1
TRBV5-1,TRBJ2-1,CASSLAAGALGNEQFF,0,1,1,1
TRBV5-1,TRBJ2-5,CASSLEGRGVQETQYF,0,1,1,1
TRBV5-1,TRBJ2-5,CASSLMFGVGQETQYF,0,1,1,1
TRBV5-1,TRBJ2-1,CASSLSGSGGAAEQLF,0,1,1,1
TRBV5-1,TRBJ2-2,CASSLSASGNTGELFF,0,1,1,1
TRBV4-1,TRBJ2-1,CASSHRGQAQDNEQFF,0,1,1,1
TRBV20-1,TRBJ2-3,CSATRLAGGRTDTLYF,0,1,1,1
TRBV20-1,TRBJ2-1,CSARRGRTEGGNEQFF,0,1,1,1
TRBV20-1,TRBJ2-7,CSARVSGADISYEQYF,0,1,1,1
TRBV20-1,TRBJ2-7,CSARGQFRVRPYEQYF,0,1,1,1
TRBV20-1,TRBJ2-5,CSAELPIAAYQETQYF,0,1,1,1
TRBV20-1,TRBJ2-1,CSALGTSGMIYNEQFF,0,1,1,1
TRBV29-1,TRBJ2-1,CSVEVGAGVRYNEQFF,0,1,1,1
TRBV7-9,TRBJ2-1,RASSLGAGTGGNEQFF,0,1,1,1
TRBV12-5,TRBJ2-1,CASGLLRGGYNEQFF,0,1,1,1
TRBV30,TRBJ2-1,CAWSVRDGHIGEQFF,0,1,1,1
TRBV30,TRBJ1-3,CAWSAGTTSGNTIYF,0,1,1,1
TRBV28,TRBJ2-7,CAISAGGILSYEQYF,0,1,1,1
TRBV10-3,TRBJ1-6,CAISWDKGNNSPLHF,0,1,1,1
TRBV24-1,TRBJ2-2,CATSDAGQGTGELFF,0,1,1,1
TRBV15,TRBJ1-5,CATSKTGKGYQPQHF,0,1,1,1
TRBV15,TRBJ1-2,CATSRDERGNYGYTF,0,1,1,1
TRBV15,TRBJ1-3,CATRAWGLSGNTIYF,0,1,1,1
TRBV19,TRBJ2-7,CASSSDRGEVSEQYF,0,1,1,1
TRBV19,TRBJ2-1,CASTRMRGGDNEQFF,0,1,1,1
TRBV19,TRBJ2-7,CASSSGTGIHYEQYF,0,1,1,1
TRBV19,TRBJ2-2,CASSPQGANTGELFF,0,1,1,1
TRBV19,TRBJ2-7,CASSELESGPYEQYF,0,1,1,1
TRBV19,TRBJ1-4,CASSIGEGAAGKLFF,0,1,1,1
TRBV19,TRBJ2-5,CASSIRAGDQETQYF,0,1,1,1
TRBV19,TRBJ1-6,CASSSTADYNSPLHF,0,1,1,1
TRBV19,TRBJ2-3,CASRTGAEGTDTQYF,0,1,1,1
TRBV19,TRBJ1-5,CASRKTDNSNQPQHF,0,1,1,1
TRBV18,TRBJ1-4,CASSPEDRVLEKLFF,0,1,1,1
TRBV18,TRBJ2-5,CASSPLGQSQETQYF,0,1,1,1
TRBV28,TRBJ2-2,CASYAGGPLTGELFF,0,1,1,1
TRBV19,TRBJ1-1,CASAKHVGLYGEAFF,0,1,1,1
TRBV28,TRBJ2-7,CASETSGTGSYEQYF,0,1,1,1
TRBV28,TRBJ2-3,CASMPLAESTDTQYS,0,1,1,1
TRBV28,TRBJ2-7,CASTQSGGDPYEQYF,0,1,1,1
TRBV6-2/3/5/6,TRBJ1-1,CASSFTGLDMVEAFF,0,1,1,1
TRBV28,TRBJ1-4,CASSFGARRYEKLFF,0,1,1,1
TRBV2,TRBJ2-7,CASSFTGGDGYEQYF,0,1,1,1
TRBV28,TRBJ1-3,CASSLSDRAGNTIYF,0,1,1,1
TRBV12-3/4,TRBJ1-5,CASSLGQGAIQPQHF,0,1,1,1
TRBV12-3/4,TRBJ2-5,CASSLNRRPQETQYF,0,1,1,1
TRBV28,TRBJ1-5,CASSLWGASNQLQHF,0,1,1,1
TRBV12-3/4,TRBJ2-1,CASSLPGASYNEQFF,0,1,1,1
TRBV6-2/3/5/6,TRBJ1-5,CASSLVGNSNQPQHF,0,1,1,1
TRBV12-3/4,TRBJ1-1,CASSLAPLFDTEAFF,0,1,1,1
TRBV12-3/4,TRBJ1-6,CASSLGTSLWSPLHF,0,1,1,1
TRBV28,TRBJ1-5,CASSLGGRSNQPQHF,0,1,1,1
TRBV6-2/3/5/6,TRBJ2-1,CASSLGDRVINEQFF,0,1,1,1
TRBV28,TRBJ1-3,CASSSPTFSGNTIYF,0,1,1,1
TRBV6-2/3/5/6,TRBJ1-5,CASSYSSGHNQPQHF,0,1,1,1
TRBV13,TRBJ2-7,CASSYRDRGTYEQYF,0,1,1,1
TRBV6-2/3/5/6,TRBJ2-5,CASSYRAGGQETQYF,0,1,1,1
TRBV12-3/4,TRBJ2-1,CASSPDRTSYNEQFF,0,1,1,1
TRBV27,TRBJ2-7,CASSRDHAGTREQYF,0,1,1,1
TRBV28,TRBJ2-3,CASSRDGRSTDTQYF,0,1,1,1
TRBV3-1,TRBJ1-4,CASSQDSGIIEKLFF,0,1,1,1
TRBV6-1,TRBJ2-3,CASSGTSGRTDTQYF,0,1,1,1
TRBV6-1,TRBJ1-1,CASSGTGMRTTKAFF,0,1,1,1
TRBV2,TRBJ1-5,CASSGGTGNGTPQHF,0,1,1,1
TRBV6-1,TRBJ2-3,CASSETSGGADTQYF,0,1,1,1
TRBV2,TRBJ1-5,CASSEARGRGQPQHF,0,1,1,1
TRBV12-3/4,TRBJ2-6,CASSTTGAGANVLTF,0,1,1,1
TRBV28,TRBJ2-7,CASSTSGRSSYEQYF,0,1,1,1
TRBV5-6,TRBJ2-7,CASSLGTSGGAEQYF,0,1,1,1
TRBV11-2,TRBJ2-1,CASSLDRGHYNEQFF,0,1,1,1
TRBV7-2,TRBJ2-1,CASSLIGTGGNEQFF,0,1,1,1
TRBV5-6,TRBJ1-1,CASSLTVTSNTEAFF,0,1,1,1
TRBV11-2,TRBJ2-1,CASSLSSGGAGEQFF,0,1,1,1
TRBV7-2,TRBJ1-6,CASSLWGDRESPLHF,0,1,1,1
TRBV7-2,TRBJ2-3,CASSLLAGEVDTQYF,0,1,1,1
TRBV7-8,TRBJ2-4,CASSLAGRAKNIQYF,0,1,1,1
TRBV7-9,TRBJ1-4,CASSLAGTVNEKLFF,0,1,1,1
TRBV11-2,TRBJ2-5,CASSLGAGPGETQYF,0,1,1,1
TRBV7-9,TRBJ2-3,CASSLGGGSTDTQYF,0,1,1,1
TRBV7-3,TRBJ2-3,CASSLNPHGGDTQYF,0,1,1,1
TRBV7-9,TRBJ2-3,CASSLHGEVTDTQYF,0,1,1,1
TRBV3-1,TRBJ1-6,CASSLRQGENSPLHF,0,1,1,1
TRBV11-2,TRBJ2-5,CASSLRDSLQETQYF,0,1,1,1
TRBV2,TRBJ1-1,CASSLNRVSNTEAFF,0,1,1,1
TRBV5-8,TRBJ1-6,CASSLGQGGNSPLHF,0,1,1,1
TRBV14,TRBJ2-1,CASSPEWGGLNEQFF,0,1,1,1
TRBV7-9,TRBJ2-5,CASSPETRLGETQYF,0,1,1,1
TRBV3-1,TRBJ2-3,CASSPGTAFTDTQYF,0,1,1,1
TRBV5-6,TRBJ2-7,CASSPPTGWSYEQYF,0,1,1,1
TRBV7-9,TRBJ1-1,CASSPGTPWSTEAFF,0,1,1,1
TRBV5-4,TRBJ1-2,CASSPDATVPYGYTF,0,1,1,1
TRBV5-4,TRBJ2-5,CASSPDGTSVETQYF,0,1,1,1
TRBV28,TRBJ2-7,CASSRVLRGEYEQYF,0,1,1,1
TRBV11-3,TRBJ1-4,CASSRTGGTNGKLFF,0,1,1,1
TRBV7-9,TRBJ1-5,CASSHDRGPNQPQHF,0,1,1,1
TRBV11-3,TRBJ2-5,CASSQWWDRGETQYF,0,1,1,1
TRBV6-2/3/5/6,TRBJ1-2,CASSQVARTNYGYTF,0,1,1,1
TRBV3-1,TRBJ1-5,CASSQGRAENQPQHF,0,1,1,1
TRBV3-1,TRBJ1-5,CASSQDYGVGQPQHF,0,1,1,1
TRBV3-1,TRBJ2-4,CASSQDTGRHNIQYF,0,1,1,1
TRBV3-1,TRBJ2-1,CASSQERGGYNEQFF,0,1,1,1
TRBV9,TRBJ2-5,CASSVGGTTQETQYF,0,1,1,1
TRBV5-4,TRBJ1-6,CASSASGTRSSPLHF,0,1,1,1
TRBV9,TRBJ2-3,CASSAHRGSTDTQYF,0,1,1,1
TRBV7-3,TRBJ2-2,CASSEQGANGGELFF,0,1,1,1
TRBV7-3,TRBJ2-1,CASSTSPDSYNEQFF,0,1,1,1
TRBV27,TRBJ1-5,CASRLEDVRNQPQHF,0,1,1,1
TRBV6-2/3/5/6,TRBJ1-5,CASRRQGAAGEPQHF,0,1,1,1
TRBV6-2/3/5/6,TRBJ1-6,CASRQQGADNSPLHF,0,1,1,1
TRBV2,TRBJ2-1,CASRVTGSYANEQFF,0,1,1,1
TRBV28,TRBJ2-5,CASRTASGNVETQYF,0,1,1,1
TRBV12-3/4,TRBJ1-2,CASNCRAREGYGYTF,0,1,1,1
TRBV19,TRBJ1-6,CASNEAGIGISPLHF,0,1,1,1
TRBV6-2/3/5/6,TRBJ2-7,CASNKRGTGAYEQYF,0,1,1,1
TRBV6-2/3/5/6,TRBJ2-5,CASKRGVGSVETQYF,0,1,1,1
TRBV9,TRBJ2-7,CARARPAAHSYEQYF,0,1,1,1
TRBV5-1,TRBJ2-3,CAPERGTLVSVTQYF,0,1,1,1
TRBV5-1,TRBJ1-4,CASTPGPATNEKLFF,0,1,1,1
TRBV5-1,TRBJ2-2,CASSFGTSGTGELFF,0,1,1,1
TRBV5-1,TRBJ1-1,CASSFWDTLNTEAFF,0,1,1,1
TRBV5-1,TRBJ2-3,CASSLQRGRADSQYF,0,1,1,1
TRBV5-1,TRBJ1-5,CASSLEGTGNQPQHF,0,1,1,1
TRBV5-1,TRBJ2-1,CASSLTYGFYNEQFF,0,1,1,1
TRBV5-1,TRBJ2-5,CASSWGGNPQETQYF,0,1,1,1
TRBV5-1,TRBJ1-5,CASSLGVGSNQPQHF,0,1,1,1
TRBV5-1,TRBJ2-7,CASSPFGLGQGEQYF,0,1,1,1
TRBV4-1,TRBJ2-7,CASSPRGQGDHEQYF,0,1,1,1
TRBV5-1,TRBJ1-2,CASSRSLDPNYGYTS,0,1,1,1
TRBV4-1,TRBJ2-1,CASSQATGGVSEQFF,0,1,1,1
TRBV4-1,TRBJ2-7,CASSQDVGVVYEQYF,0,1,1,1
TRBV4-1,TRBJ2-1,CASSEAPTAYNEQFF,0,1,1,1
TRBV5-1,TRBJ1-4,CASRPRSATNEKLFF,0,1,1,1
TRBV20-1,TRBJ1-3,CSARTGQGAGNTIYF,0,1,1,1
TRBV20-1,TRBJ2-3,CSATGLAGETDTQYF,0,1,1,1
TRBV20-1,TRBJ1-1,CSASRAGTMNTEAFF,0,1,1,1
TRBV20-1,TRBJ1-6,CSARAQGADNSPLHF,0,1,1,1
TRBV29-1,TRBJ1-3,CSVGDPPMPGNTIYF,0,1,1,1
TRBV29-1,TRBJ2-7,CSVGQDRDEPAGQYF,0,1,1,1
TRBV18,TRBJ2-1,RASSIAGGRHNEQFF,0,1,1,1
TRBV3-1,TRBJ2-7,CACSQQDRGGEQYF,0,1,1,1
TRBV30,TRBJ2-2,CAWSRQGGTGELFF,0,1,1,1
TRBV30,TRBJ1-2,CAWSVLGRNYGYTF,0,1,1,1
TRBV10-3,TRBJ1-6,CAVSELETNSPLHF,0,1,1,1
TRBV10-3,TRBJ2-7,CAITPDRGRQQQYF,0,1,1,1
TRBV19,TRBJ1-6,CATHSDTGPAPLHF,0,1,1,1
TRBV15,TRBJ2-2,CATSTTSGTGELFF,0,1,1,1
TRBV19,TRBJ2-1,CASSSTLQGGEQFF,0,1,1,1
TRBV19,TRBJ1-2,CASSIDTGQDRYTF,0,1,1,1
TRBV19,TRBJ1-5,CASSTGLSNQPQHF,0,1,1,1
TRBV19,TRBJ1-2,CASSTNRDTTYYTF,0,1,1,1
TRBV19,TRBJ1-5,CASSKTGTNQPQHF,0,1,1,1
TRBV18,TRBJ2-5,CASSPSDRTETQYF,0,1,1,1
TRBV18,TRBJ2-1,CASSPLGAHNEQFF,0,1,1,1
TRBV5-5,TRBJ1-4,CASRLWQGNEKLFF,0,1,1,1
TRBV3-1,TRBJ2-2,CASRGVGNTGELFF,0,1,1,1
TRBV12-3/4,TRBJ2-1,CASAGQGQDNEQFF,0,1,1,1
TRBV27,TRBJ1-2,CASGLDGIVYGYTF,0,1,1,1
TRBV5-8,TRBJ2-7,CASTWTSVTYEQYF,0,1,1,1
TRBV2,TRBJ1-2,CASTRDRGVYGYTF,0,1,1,1
TRBV6-2/3/5/6,TRBJ2-7,CASTATGMPYEQYF,0,1,1,1
TRBV28,TRBJ1-2,CASTEGLANYGYTF,0,1,1,1
TRBV7-8,TRBJ1-6,CASTTGGAYSPLHF,0,1,1,1
TRBV5-4,TRBJ2-7,CASTNGGGNYEQYF,0,1,1,1
TRBV12-3/4,TRBJ1-4,CASSFRQGDEKLFF,0,1,1,1
TRBV12-3/4,TRBJ2-7,CASSLFGGTYEQYF,0,1,1,1
TRBV28,TRBJ1-4,CASSLPGFNEKLFF,0,1,1,1
TRBV28,TRBJ2-5,CASSLSGGRETQYF,0,1,1,1
TRBV28,TRBJ1-6,CASSLRTGGSPLHF,0,1,1,1
TRBV12-3/4,TRBJ1-1,CASSSFSGSTEAFF,0,1,1,1
TRBV6-2/3/5/6,TRBJ2-3,CASSYWASTDTQYL,0,1,1,1
TRBV6-4,TRBJ1-2,CASSPLGADYGYTF,0,1,1,1
TRBV28,TRBJ2-5,CASSPWDYQETQYF,0,1,1,1
TRBV12-3/4,TRBJ1-2,CASSPPGRLYGYTF,0,1,1,1
TRBV6-2/3/5/6,TRBJ1-4,CASSRRGRTEKLFF,0,1,1,1
TRBV3-1,TRBJ1-5,CASSHGNRGKPQHF,0,1,1,1
TRBV6-1,TRBJ2-2,CASSVGRFTGELFF,0,1,1,1
TRBV6-1,TRBJ2-5,CASSGAGEVETQYF,0,1,1,1
TRBV2,TRBJ1-6,CASSDLTGNQPLHF,0,1,1,1
TRBV6-1,TRBJ2-3,CASSDGRAPDTQYF,0,1,1,1
TRBV2,TRBJ1-5,CASSEVSAIQPQHF,0,1,1,1
TRBV2,TRBJ2-7,CASSEGGRSYEQYF,0,1,1,1
TRBV2,TRBJ2-3,CASSRGLAGDTQYF,0,1,1,1
TRBV28,TRBJ1-1,CASSRTGGNTEAFF,0,1,1,1
TRBV5-4,TRBJ1-1,CASSFSTGNTEAIF,0,1,1,1
TRBV7-8,TRBJ2-3,CASSFGTSTDTQYF,0,1,1,1
TRBV7-2,TRBJ1-1,CASSLHGQGTEAFF,0,1,1,1
TRBV5-4,TRBJ2-3,CASSLMSVADTQYF,0,1,1,1
TRBV7-8,TRBJ2-3,CASSLPPPTGAVYF,0,1,1,1
TRBV7-9,TRBJ1-1,CASSLPGDHTEAFF,0,1,1,1
TRBV3-1,TRBJ2-1,CASSLQGLHNEQFF,0,1,1,1
TRBV7-8,TRBJ1-2,CASSLVVDLSGYTF,0,1,1,1
TRBV7-6,TRBJ1-1,CASSLAHLNTEAFF,0,1,1,1
TRBV11-2,TRBJ1-1,CASSLDRRGAEAFF,0,1,1,1
TRBV11-3,TRBJ2-5,CASSLDRATETQYF,0,1,1,1
TRBV7-2,TRBJ2-5,CASSLRQGQETQYF,0,1,1,1
TRBV7-2,TRBJ2-7,CASSLNGGTYEQYF,0,1,1,1
TRBV5-6,TRBJ2-7,CASSSGTGEGEQYF,0,1,1,1
TRBV11-2,TRBJ2-3,CASSLGTSTSTQYF,0,1,1,1
TRBV7-8,TRBJ2-3,CASSPSAGGDTQYF,0,1,1,1
TRBV7-3,TRBJ1-1,CASSQRGRWAEAFF,0,1,1,1
TRBV3-1,TRBJ2-1,CASSQVTGAGEQFF,0,1,1,1
TRBV3-1,TRBJ1-5,CASSQVSAQGPQHF,0,1,1,1
TRBV3-1,TRBJ2-3,CASSQAGATDTQYF,0,1,1,1
TRBV3-1,TRBJ2-3,CASSQDRTTDTQYF,0,1,1,1
TRBV9,TRBJ2-7,CASSASYGPYEQYF,0,1,1,1
TRBV6-1,TRBJ1-4,CASSDTGTDEKLFF,0,1,1,1
TRBV6-2/3/5/6,TRBJ1-4,CASSDRDTNEKLFF,0,1,1,1
TRBV9,TRBJ2-7,CASSEGDSAYEQYF,0,1,1,1
TRBV7-2,TRBJ2-7,CASSTPLATYEQYF,0,1,1,1
TRBV11-2,TRBJ1-1,CASSKDTWNTEAFF,0,1,1,1
TRBV12-3/4,TRBJ2-2,CASRSGTQGGELFF,0,1,1,1
TRBV2,TRBJ1-1,CASRGDLPNTEAFF,0,1,1,1
TRBV6-4,TRBJ1-5,CASRTGPRGEPQHF,0,1,1,1
TRBV5-6,TRBJ2-5,CASRSPQGPPTQYF,0,1,1,1
TRBV6-2/3/5/6,TRBJ1-1,CASNPAGWNTEAFF,0,1,1,1
TRBV28,TRBJ2-7,CASNPTGASYEQYF,0,1,1,1
TRBV7-9,TRBJ1-3,CASKREGGRNTIYF,0,1,1,1
TRBV7-9,TRBJ1-1,CTSSHTRAVTEAFF,0,1,1,1
TRBV5-1,TRBJ1-1,CASSFFNGNTEAFF,0,1,1,1
TRBV5-1,TRBJ2-7,CASSFMDGSVEQYF,0,1,1,1
TRBV5-1,TRBJ1-2,CASSLSPPNYGYTF,0,1,1,1
TRBV5-1,TRBJ2-3,CASSLGSSTDTQYF,0,1,1,1
TRBV5-1,TRBJ1-2,CASSLDGANYGYTF,0,1,1,1
TRBV5-1,TRBJ1-1,CASSSGDRFTETFF,0,1,1,1
TRBV5-1,TRBJ1-5,CASSPEGINQPQHF,0,1,1,1
TRBV5-1,TRBJ1-5,CASSDEGGDQPQHF,0,1,1,1
TRBV5-1,TRBJ2-1,CASSMAGAYNEQFF,0,1,1,1
TRBV5-1,TRBJ2-5,CASSTTGTEETQYF,0,1,1,1
TRBV5-1,TRBJ2-7,CASRPHGGSNEQYF,0,1,1,1
TRBV20-1,TRBJ2-7,CSAHSGVSSYEQYF,0,1,1,1
TRBV20-1,TRBJ2-2,CSAMKGSNTGELFF,0,1,1,1
TRBV20-1,TRBJ2-7,CSATPLASVYEQYF,0,1,1,1
TRBV20-1,TRBJ2-5,CSATARAGYETQYF,0,1,1,1
TRBV20-1,TRBJ2-3,CSASLRWATDTQYF,0,1,1,1
TRBV20-1,TRBJ1-5,CSARGGHKNQPQHF,0,1,1,1
TRBV20-1,TRBJ2-3,CSARIAGTADTQYF,0,1,1,1
TRBV20-1,TRBJ1-5,CSARVGPYNQPQHF,0,1,1,1
TRBV20-1,TRBJ1-5,CSARAQGLNQPQHF,0,1,1,1
TRBV20-1,TRBJ2-7,CSARDPRASDEQYF,0,1,1,1
TRBV20-1,TRBJ2-1,CSARDSIHKNEQFF,0,1,1,1
TRBV29-1,TRBJ1-1,CSVFYQGWNTEAFF,0,1,1,1
TRBV29-1,TRBJ2-1,CSVSRTQGYNEQFF,0,1,1,1
TRBV29-1,TRBJ1-5,CSVVVSGPNQPQHF,0,1,1,1
TRBV29-1,TRBJ2-7,CSVVDRGSSYEQYF,0,1,1,1
TRBV29-1,TRBJ2-1,CSVAFLRGDTEQFF,0,1,1,1
TRBV29-1,TRBJ2-7,CSVGGTGIDYEQYF,0,1,1,1
TRBV29-1,TRBJ1-1,CSVGRGSMNTEAFF,0,1,1,1
TRBV29-1,TRBJ1-2,CSVEDGVSRYGYTF,0,1,1,1
TRBV29-1,TRBJ2-7,CSVRTSGGAYEQYF,0,1,1,1
TRBV29-1,TRBJ2-3,CSVDWGRGTDTQYF,0,1,1,1
TRBV29-1,TRBJ2-1,CSATTGGIYNEQFF,0,1,1,1
TRBV28,TRBJ1-4,CAGRGTANEKLFF,0,2,1,2
TRBV12-5,TRBJ2-1,CASGSDRVNEQFF,0,1,1,1
TRBV18,TRBJ1-5,CACSPGPAQPQHF,0,1,1,1
TRBV30,TRBJ2-7,CAWRKDRLNEQYF,0,1,1,1
TRBV30,TRBJ1-2,CAWSVQGDGGYTF,0,1,1,1
TRBV10-3,TRBJ2-5,CAIGVGGKETQYF,0,1,1,1
TRBV10-3,TRBJ1-5,CAISDNPYQPQHF,0,1,1,1
TRBV19,TRBJ2-1,CATWTASYNEQFF,0,1,1,1
TRBV15,TRBJ2-1,CATSRVGTNEQFF,0,1,1,1
TRBV2,TRBJ2-1,CASGTGAGNEQFF,0,1,1,1
TRBV19,TRBJ1-1,CASSLRANTEAFF,0,1,1,1
TRBV19,TRBJ1-1,CASSIGWGTEAFS,0,1,1,1
TRBV19,TRBJ2-1,CASSIDELSEQFF,0,1,1,1
TRBV19,TRBJ1-2,CASSIRTPRGYTF,0,1,1,1
TRBV19,TRBJ1-5,CASRKTVNQPQHF,0,1,1,1
TRBV18,TRBJ2-7,CASSEHPAYEQYF,0,1,1,1
TRBV18,TRBJ1-1,CASSGVLRREAFF,0,1,1,1
TRBV6-2/3/5/6,TRBJ1-2,CASLTEGDYGYTF,0,1,1,1
TRBV28,TRBJ1-6,CASQGGYNSPLHF,0,1,1,1
TRBV11-2,TRBJ2-1,CASTQGNYNEQFF,0,2,1,2
TRBV12-3/4,TRBJ2-7,CASTTGLDYGQYF,0,1,1,1
TRBV6-2/3/5/6,TRBJ1-5,CASSLAVNQPQHF,0,1,1,1
TRBV27,TRBJ1-5,CASSLGRFQPQHF,0,1,1,1
TRBV27,TRBJ1-1,CASSLKGNTEAFF,0,1,1,1
TRBV6-2/3/5/6,TRBJ1-2,CASSSGIVYGYTF,0,1,1,1
TRBV6-2/3/5/6,TRBJ1-4,CASSYASFLRLFF,0,1,1,1
TRBV2,TRBJ2-3,CASSPPSTDTQYF,0,1,1,1
TRBV27,TRBJ1-2,CASSPQGARGYTF,0,1,1,1
TRBV12-3/4,TRBJ2-7,CASSRLAGYEQYF,0,1,1,1
TRBV6-1,TRBJ1-5,CASSVHSNQPQHF,0,1,1,1
TRBV2,TRBJ2-3,CASSGTSGDTQYF,0,1,1,1
TRBV2,TRBJ1-5,CASSEPVNQPQRF,0,1,1,1
TRBV25-1,TRBJ2-2,CASSERNTGEPFF,0,1,1,1
TRBV12-3/4,TRBJ1-2,CASSTGANYGYTF,0,1,1,1
TRBV7-6,TRBJ1-5,CASSFSLNQPQHF,0,1,1,1
TRBV5-8,TRBJ2-7,CASSFGLGTEQYF,0,1,1,1
TRBV11-3,TRBJ2-3,CASSLSPTDTQYF,0,1,1,1
TRBV7-3,TRBJ1-1,CASSLYLNTEAFF,0,1,1,1
TRBV7-9,TRBJ2-7,CASSLVPPVGQYF,0,1,1,1
TRBV7-6,TRBJ1-1,CASSLAMNTEAFF,0,1,1,1
TRBV7-2,TRBJ2-4,CASSLAPENIQYF,0,1,1,1
TRBV11-3,TRBJ2-7,CASSLGLAYEQYF,0,1,1,1
TRBV11-2,TRBJ2-1,CASSLGLYNEQLF,0,1,1,1
TRBV27,TRBJ2-7,CASSSSGAREQYF,0,1,1,1
TRBV5-6,TRBJ1-1,CASSYNGRPEAFF,0,1,1,1
TRBV16,TRBJ1-2,CASSPDRDYGYTF,0,1,1,1
TRBV3-1,TRBJ1-1,CASSPLRPGEAFF,0,1,1,1
TRBV5-6,TRBJ2-2,CASSPPAAGELFF,0,1,1,1
TRBV13,TRBJ1-2,CASSPTGGYGYTF,0,1,1,1
TRBV7-9,TRBJ1-2,CASSRRTGNGYTF,0,1,1,1
TRBV7-9,TRBJ2-7,CASSQSGGGEQYF,0,1,1,1
TRBV3-1,TRBJ1-5,CASSQDGGGPQHF,0,1,1,1
TRBV7-8,TRBJ2-1,CASSQTSGGEQFF,0,1,1,1
TRBV28,TRBJ2-1,CASSQTSDDEQFF,0,1,1,1
TRBV4-2,TRBJ1-2,CASSQEKIYGYTF,0,1,1,1
TRBV7-8,TRBJ1-1,CASSATGVTEAFF,0,1,1,1
TRBV5-6,TRBJ2-3,CASSTPGGDTQYF,0,1,1,1
TRBV11-3,TRBJ2-7,CASSTGLASEQYF,0,1,1,1
TRBV6-2/3/5/6,TRBJ2-7,CASRLSIAYEQYF,0,1,1,1
TRBV12-3/4,TRBJ1-5,CASRETSLGPQHF,0,2,1,2
TRBV7-9,TRBJ2-5,CASRSPYQETQYF,0,1,1,1
TRBV7-9,TRBJ1-5,CASRLGTGQPQHF,0,1,1,1
TRBV2,TRBJ1-1,CASRGTGNTEAFF,0,1,1,1
TRBV12-3/4,TRBJ2-7,CASRDSQGGEQYF,0,1,1,1
TRBV11-2,TRBJ2-3,CASNLGYTDTQYF,0,1,1,1
TRBV10-1,TRBJ2-2,CASAMGGTGELFF,0,1,1,1
TRBV2,TRBJ1-6,CASSLRTDSPLHF,0,1,1,1
TRBV5-1,TRBJ2-7,CASSLSRGSEQYF,0,1,1,1
TRBV5-1,TRBJ2-1,CASSLGQVNEQFF,0,1,1,1
TRBV5-1,TRBJ2-1,CASSLDRSNEQFF,0,1,1,1
TRBV5-1,TRBJ2-1,CASSLEVRDEQFF,0,1,1,1
TRBV5-1,TRBJ1-4,CASSSGQLEKLFF,0,1,1,1
TRBV5-1,TRBJ2-1,CASSLWVDNEQFF,0,1,1,1
TRBV10-1,TRBJ1-6,CASSEDLDSPLHF,0,1,1,1
TRBV20-1,TRBJ2-1,CSARGLLYNEQFF,0,1,1,1
TRBV20-1,TRBJ2-7,CSASLGQGYEQYF,0,1,1,1
TRBV20-1,TRBJ1-5,CSASEGPNQPQHF,0,1,1,1
TRBV20-1,TRBJ2-3,CSARHLSTDTQYF,0,1,1,1
TRBV20-1,TRBJ1-2,CSALLTGVDGYTF,0,1,1,1
TRBV20-1,TRBJ2-5,CSADRGGRETQYF,0,1,1,1
TRBV20-1,TRBJ1-1,CSAAGGTKTEAFF,0,1,1,1
TRBV29-1,TRBJ2-7,CSVVKGSSYEQYF,0,1,1,1
TRBV29-1,TRBJ1-1,CSVVDGGNTEAFF,0,1,1,1
TRBV29-1,TRBJ2-7,CSVVTGGTYEQYF,0,1,1,1
TRBV29-1,TRBJ2-5,CSVAETGGETQYF,0,1,1,1
TRBV29-1,TRBJ2-1,CSVGNGLDNEQFF,0,1,1,1
TRBV29-1,TRBJ2-7,CSVGRALKPEQYF,0,1,1,1
TRBV29-1,TRBJ1-1,CSVDRGGDTEAFF,0,1,1,1
TRBV29-1,TRBJ2-7,CSVDGDRTYEQYF,0,1,1,1
TRBV29-1,TRBJ2-3,CSVTPLVPDTQYF,0,1,1,1
TRBV29-1,TRBJ1-1,CSVKGQRNTEAFF,0,1,1,1
TRBV29-1,TRBJ1-1,CSVDRGPGTEAFF,0,1,1,1
TRBV29-1,TRBJ2-7,CSVSETASYEQYF,0,1,1,1
TRBV29-1,TRBJ2-7,CSVTGQGDYEQYF,0,1,1,1
TRBV29-1,TRBJ1-1,CSAPDKTSTEAFF,0,1,1,1
TRBV29-1,TRBJ2-2,CSAIQANTGELFF,0,1,1,1
TRBV19,TRBJ1-5,CVWGLGEQPQHF,0,1,1,1
TRBV28,TRBJ1-5,CVSSFSNQPQHF,0,1,1,1
TRBV30,TRBJ1-2,CAWIKDNYGYTF,0,1,1,1
TRBV11-2,TRBJ2-5,CATEDRSETQYF,0,1,1,1
TRBV19,TRBJ2-7,CASSPRGHEQYF,0,1,1,1
TRBV19,TRBJ2-3,CASSMGGDTQYF,0,1,1,1
TRBV18,TRBJ1-2,CASSPLGRSYTF,0,1,1,1
TRBV18,TRBJ2-7,CASSPQGREQYF,0,1,1,1
TRBV28,TRBJ1-5,CASSFLRQPQHF,0,1,1,1
TRBV28,TRBJ1-2,CASSLSNYGYTF,0,1,1,1
TRBV28,TRBJ1-2,CASSLGGYGYTF,0,1,1,1
TRBV6-2/3/5/6,TRBJ1-1,CASSLRGTEAFF,0,1,1,1
TRBV12-3/4,TRBJ1-1,CASSWGHTEAFF,0,1,1,1
TRBV2,TRBJ2-5,CASSVVGETQYF,0,1,1,1
TRBV2,TRBJ2-7,CASSDSYSKQYF,0,1,1,1
TRBV6-2/3/5/6,TRBJ1-1,CASSTQGSEAFF,0,1,1,1
TRBV11-3,TRBJ1-1,CASSFSGGRTFF,0,1,1,1
TRBV5-6,TRBJ2-7,CASSLYRGEQYF,0,1,1,1
TRBV13,TRBJ2-2,CASSLYTGELFF,0,1,1,1
TRBV7-9,TRBJ1-1,CASSLRGAEAFF,0,1,1,1
TRBV7-9,TRBJ1-5,CASSSQNQPQHF,0,1,1,1
TRBV3-1,TRBJ2-3,CASSLVRDTQYF,0,1,1,1
TRBV14,TRBJ2-1,CASSRVEDRQFF,0,1,1,1
TRBV3-1,TRBJ2-7,CASSQAVNEQYF,0,1,1,1
TRBV3-1,TRBJ2-2,CASSQRAGELFF,0,1,1,1
TRBV6-2/3/5/6,TRBJ2-1,CASSQSVHEQFF,0,1,1,1
TRBV3-1,TRBJ2-1,CASSQVRGLSSF,0,1,1,1
TRBV12-3/4,TRBJ2-7,CASSKGVDEQYF,0,1,1,1
TRBV28,TRBJ2-1,CASRGTGREQFF,0,1,1,1
TRBV27,TRBJ1-2,CASKGFNYGYTF,0,1,1,1
TRBV5-1,TRBJ2-1,CASSLEGNEQFF,0,1,1,1
TRBV5-1,TRBJ2-2,CASSLPPGELFF,0,1,1,1
TRBV20-1,TRBJ1-1,CSAYGQGTEAFF,0,1,1,1
TRBV20-1,TRBJ1-5,CSASSSNQPQHF,0,1,1,1
TRBV20-1,TRBJ1-1,CSASPGNTEAFF,0,1,1,1
TRBV20-1,TRBJ2-5,CSARSGQETQYF,0,1,1,1
TRBV29-1,TRBJ2-7,CSVVNFSGEQYF,0,1,1,1
TRBV29-1,TRBJ1-1,CSVVGEGTEAFF,0,1,1,1
TRBV29-1,TRBJ2-7,CSVGSGDYEQYF,0,1,1,1
TRBV29-1,TRBJ1-1,CSVEAVGTEAFF,0,1,1,1
TRBV29-1,TRBJ2-1,CSVRLPSNEQFF,0,1,1,1
TRBV29-1,TRBJ1-1,CSATGGSTEAFF,0,1,1,1
TRBV29-1,TRBJ2-3,CSAREGSDTQYF,0,1,1,1
TRBV29-1,TRBJ2-5,CSARTGEETQYF,0,1,1,1
TRBV20-1,TRBJ1-1,CSGGWQNTEAFF,0,1,1,1
TRBV29-1,TRBJ2-3,CSGLPSTDTQYF,0,1,1,1
TRBV29-1,TRBJ2-5,CSGTGGQETQYF,0,1,1,1
TRBV30,TRBJ2-5,CACGQQETQYF,0,1,1,1
TRBV30,TRBJ2-3,CAWSAADTQYF,0,1,1,1
TRBV10-3,TRBJ2-1,CAAGRFNEQFF,0,1,1,1
TRBV18,TRBJ1-1,CASSRGAEAFF,0,1,1,1
TRBV2,TRBJ1-2,CASTEDYGYTF,0,1,1,1
TRBV2,TRBJ2-7,CASSEVVEQYF,0,1,1,1
TRBV7-9,TRBJ2-3,CASSFQGTQYF,0,1,1,1
TRBV7-9,TRBJ2-2,CASSFAGELFF,0,1,1,1
TRBV2,TRBJ1-4,CASSLGGGVFF,0,1,1,1
TRBV11-2,TRBJ2-1,CASSSLIEQFF,0,1,1,1
TRBV7-6,TRBJ2-7,CASSSHYEQYF,0,1,1,1
TRBV28,TRBJ1-4,CASREVEKLFF,0,1,1,1
TRBV20-1,TRBJ2-5,CSAALQETQYF,0,1,1,1
TRBV20-1,TRBJ1-2,CSAPEAYGYTF,0,1,1,1
TRBV29-1,TRBJ2-1,CSVARPHEQFF,0,1,1,1
TRBV29-1,TRBJ2-3,CSAASTDTQYF,0,1,1,1
TRBV20-1,TRBJ2-5,CSARMETQYF,0,1,1,1
TRBV29-1,TRBJ2-7,CSVRTYEQYF,0,1,1,1
TRBV29-1,TRBJ1-2,CSVRQGGYTF,0,1,1,1
TRBV19,TRBJ2-1,CASSIRGGETSGGGYEQFF,0,1,1,1
TRBV5-6,TRBJ1-4,CASTLGPRQLNEKLFF,0,1,1,1
TRBV11-2,TRBJ2-1,CASSLVRGPSFNEQFF,0,1,1,1
TRBV12-3/4,TRBJ2-3,CACSLEGTSTDTQYF,0,2,1,2
TRBV6-2/3/5/6,TRBJ1-1,CASSYSTGLGTEAFF,0,1,1,1
TRBV11-3,TRBJ2-1,CASSSYSGGGSEQFF,0,1,1,1
TRBV7-2,TRBJ2-7,CASSVNPGLDYEQYF,0,1,1,1
TRBV12-3/4,TRBJ2-1,CASRSRDYPLNEQFF,0,1,1,1
TRBV5-1,TRBJ1-1,CASSLELQDGTEASF,0,1,1,1
TRBV5-1,TRBJ2-1,CASSSSGGSYNEQFF,0,1,1,1
TRBV6-2/3/5/6,TRBJ1-1,CASTTGPMNAGAFF,0,1,1,1
TRBV2,TRBJ1-2,CASSGQGVGYGYTF,0,1,1,1
TRBV4-1,TRBJ2-5,CACSRLALETQYF,0,1,1,1
TRBV29-1,TRBJ2-7,CSVASDSFNEQYF,0,1,1,1
TRBV13,TRBJ2-5,CASSEATTSQGRSSSSGNQYF,0,1,1,1
TRBV6-2/3/5/6,TRBJ2-3,CASSYLQGSSGISSTDTQYF,0,1,1,1
TRBV6-2/3/5/6,TRBJ2-5,CASSYHQGSGGTILGETQYF,0,1,1,1
TRBV12-3/4,TRBJ2-6,CASSYGIGGLLSSGANVLTF,0,1,1,1
TRBV7-8,TRBJ2-1,CASSLGVAGGHWSPYNEQFF,0,1,1,1
TRBV13,TRBJ1-2,CASSPTGTAGWGLVNYGYTF,0,1,1,1
TRBV7-9,TRBJ2-7,CASSPPLSGTENLLPHEQYF,0,1,1,1
TRBV10-3,TRBJ2-6,CAISESMGTLRTGANVLTF,0,1,1,1
TRBV7-2,TRBJ2-1,CASSLLGPSTSGIFNEQFF,0,1,1,1
TRBV3-1,TRBJ2-1,CASSRLAGGPESSYNEQFF,0,1,1,1
TRBV4-2,TRBJ2-3,CASSQETSGGALNTDTQYF,0,1,1,1
TRBV5-6,TRBJ2-5,CASSMGVGGIRPYGETQYF,0,1,1,1
TRBV12-3/4,TRBJ2-6,CARRGQGPLTYSGANVLTF,0,1,1,1
TRBV4-1,TRBJ2-3,CASSHLGLAGGPGADTQYF,0,1,1,1
TRBV30,TRBJ1-1,CAWSPPIAVGGWNTEAFS,0,1,1,1
TRBV28,TRBJ1-1,CASSLLVWQRSMNTEAFF,0,1,1,1
TRBV6-2/3/5/6,TRBJ2-1,CASSLSGRWDRDYNEQFF,0,1,1,1
TRBV2,TRBJ1-4,CASSSGQGWLVRGEKLFF,0,1,1,1
TRBV6-2/3/5/6,TRBJ2-5,CASSYSSQTGGRRETQYF,0,1,1,1
TRBV2,TRBJ1-2,CASSLTGTGTLAIYGYTF,0,1,1,1
TRBV6-2/3/5/6,TRBJ1-5,CASSPSTFGQGGNQPQHF,0,1,1,1
TRBV6-1,TRBJ2-2,CASSAEGPRTVNTGELFF,0,1,1,1
TRBV6-1,TRBJ2-3,CASSGAGGTGEGTDTQYF,0,1,1,1
TRBV7-2,TRBJ1-3,CASSFLGGGAHSGNTIYF,0,1,1,1
TRBV4-2,TRBJ2-6,CASSQDLAGGAGANVLTF,0,1,1,1
TRBV5-1,TRBJ1-6,CASSLSGSQGMGVSPLHF,0,1,1,1
TRBV5-1,TRBJ2-1,CASSLGQGAVSSYNEQFF,0,1,1,1
TRBV5-1,TRBJ2-3,CASSYRQVAGGNTDTQYF,0,1,1,1
TRBV5-1,TRBJ2-1,CASSHHGPGGSSYNEQFF,0,1,1,1
TRBV20-1,TRBJ2-3,CSSKRQGASSLLTDTQYF,0,1,1,1
TRBV20-1,TRBJ2-5,CSARDFLAGSLTQETQYF,0,1,1,1
TRBV20-1,TRBJ2-3,CSAPGLAGALTSTDTQYF,0,1,1,1
TRBV29-1,TRBJ1-1,CSVENPPDGYSPRPEAFF,0,1,1,1
TRBV2,TRBJ2-1,CASAGAGGKPAYNEQFF,0,1,1,1
TRBV24-1,TRBJ2-6,CATSAPGPSSGANVLTF,0,1,1,1
TRBV19,TRBJ1-2,CASSRMGQSAYLRGYTF,0,1,1,1
TRBV19,TRBJ2-1,CASSIVSGRGIYNEQFF,0,1,1,1
TRBV19,TRBJ1-1,CASSTQGRAPLNTEAFF,0,1,1,1
TRBV19,TRBJ1-5,CASSIIENWDSNQPQHF,0,1,1,1
TRBV18,TRBJ2-3,CASSPLLTDRGTDTQYF,0,1,1,1
TRBV18,TRBJ1-4,CASSQGTAVTTNEKPFF,0,1,1,1
TRBV28,TRBJ2-3,CASPPSEGSPSTDTQYF,0,1,1,1
TRBV6-2/3/5/6,TRBJ2-6,CASTLRTGGTGANVLTF,0,1,1,1
TRBV28,TRBJ1-5,CASSFPVEGTTLQPQYF,0,1,1,1
TRBV28,TRBJ2-7,CASSFPITGGSSYEQYF,0,1,1,1
TRBV6-9,TRBJ2-7,CASSLPFVGLSSYEQYF,0,1,1,1
TRBV6-2/3/5/6,TRBJ2-6,CASSYFVSGSGANVLTF,0,1,1,1
TRBV6-2/3/5/6,TRBJ2-2,CASSYSPTGLRTGELFF,0,1,1,1
TRBV2,TRBJ2-2,CASSEVGRTVNTGELFF,0,1,1,1
TRBV6-1,TRBJ1-3,CASSNRGGANSGNTIYF,0,1,1,1
TRBV5-6,TRBJ2-5,CASSFTSGTGGRKTQYF,0,1,1,1
TRBV5-6,TRBJ2-7,CASSLMWSRGPSYEQYF,0,1,1,1
TRBV11-1,TRBJ2-1,CASSLAGGMGGYNEQFF,0,1,1,1
TRBV13,TRBJ2-5,CASSLGWPSGEQETQYF,0,1,1,1
TRBV7-9,TRBJ1-5,CASSSVLQGASNQPQHF,0,1,1,1
TRBV5-6,TRBJ2-7,CASSSVILRHKAYEQYF,0,1,1,1
TRBV7-2,TRBJ2-5,CASSSTLLGGGLKTQYF,0,1,1,1
TRBV9,TRBJ2-3,CASSLRAGDPFKDTQYF,0,1,1,1
TRBV3-1,TRBJ2-3,CASSPSYQATYTDTQYF,0,1,1,1
TRBV12-3/4,TRBJ2-3,CASSHLQGRGATDTQYF,0,1,1,1
TRBV7-2,TRBJ2-1,CASSQRLGARGYNEQFF,0,1,1,1
TRBV3-1,TRBJ2-7,CASSQDLSPGYSYEQYF,0,1,1,1
TRBV4-2,TRBJ1-3,CASSQDSGRDRGNTIYF,0,1,1,1
TRBV14,TRBJ1-2,CASSQDASTGINYGYTF,0,1,1,1
TRBV7-9,TRBJ2-1,CASSGQTSGAVGNEQFF,0,1,1,1
TRBV7-9,TRBJ1-5,CASSNSGGGRGNQPQHF,0,1,1,1
TRBV11-2,TRBJ2-6,CASRPGTGGGGANVLTF,0,1,1,1
TRBV5-4,TRBJ2-2,CASRPTSGGADTGELFF,0,1,1,1
TRBV5-1,TRBJ1-6,CASGLTAGTGVNSPLHF,0,1,1,1
TRBV5-1,TRBJ2-5,CASSFGVAGLAYETQYF,0,1,1,1
TRBV5-1,TRBJ2-2,CASSFLPSGTGTGELFF,0,1,1,1
TRBV5-1,TRBJ2-1,CASSLFRERGGYNEQFF,0,1,1,1
TRBV5-1,TRBJ2-7,CASSLSGLPGTGYEQYF,0,1,1,1
TRBV5-1,TRBJ1-2,CASSPDRGFDLIYGYTF,0,1,1,1
TRBV4-1,TRBJ2-5,CASSQDRPGTEQETQYF,0,1,1,1
TRBV20-1,TRBJ2-3,CSASDALRGSAPDTQYF,0,1,1,1
TRBV29-1,TRBJ2-1,CSVGGTSGTRGLNELFF,0,1,1,1
TRBV29-1,TRBJ2-5,CSVEGDYRGEIQETQYF,0,1,1,1
TRBV30,TRBJ2-4,CAWSVLHRIAKNIQYF,0,1,1,1
TRBV10-3,TRBJ2-2,CAISDSGVANTGELFF,0,1,1,1
TRBV10-3,TRBJ2-3,CAISDQKTPSTDTQYF,0,1,1,1
TRBV15,TRBJ1-5,CATSRELRDRNQPQHF,0,1,1,1
TRBV19,TRBJ1-1,CATTKLQGVVNTEAFF,0,1,1,1
TRBV19,TRBJ2-1,CASSAGTSGGSSEQFF,0,1,1,1
TRBV19,TRBJ1-5,CASSMARGGANQPQHF,0,1,1,1
TRBV19,TRBJ2-1,CASSMMKGARGVEQFF,0,1,1,1
TRBV19,TRBJ2-5,CASSTRTSGGERTQYF,0,1,1,1
TRBV19,TRBJ1-5,CASRDDLGGGNQPQHF,0,1,1,1
TRBV18,TRBJ2-3,CASSVYAGEKTDTQYF,0,1,1,1
TRBV18,TRBJ1-1,CASSPQTGTVNTEAFF,0,1,1,1
TRBV18,TRBJ2-7,CASSPLVGAGIHEQYF,0,1,1,1
TRBV18,TRBJ2-3,CASSQPGQGVPDTQYF,0,1,1,1
TRBV18,TRBJ2-1,CASARGRASSYNEQFF,0,1,1,1
TRBV2,TRBJ2-3,CASGTGVRTGTDTQYI,0,1,1,1
TRBV11-2,TRBJ2-3,CASTYTGYTSTDTQYF,0,1,1,1
TRBV28,TRBJ2-5,CASSLWVSGGQETQYF,0,1,1,1
TRBV6-2/3/5/6,TRBJ2-3,CASSLLAGGVTDTQYF,0,1,1,1
TRBV28,TRBJ2-1,CASSLGTDTSYNEQFF,0,1,1,1
TRBV6-2/3/5/6,TRBJ1-2,CASSYSDDQADYGYTF,0,1,1,1
TRBV6-2/3/5/6,TRBJ1-1,CASSYPGQALNTEAFF,0,1,1,1
TRBV6-2/3/5/6,TRBJ2-1,CASSYDSIYSYNEQFF,0,1,1,1
TRBV6-2/3/5/6,TRBJ2-5,CASSLGGGGGQETQYF,0,1,1,1
TRBV6-2/3/5/6,TRBJ2-7,CASSPSSGTAPYEQYF,0,1,1,1
TRBV12-3/4,TRBJ2-1,CASSQQGLAGDNEQFF,0,1,1,1
TRBV6-1,TRBJ1-5,CASSVRVSAGNQPQHF,0,1,1,1
TRBV6-1,TRBJ2-3,CASSAGTSGYTDTQYF,0,1,1,1
TRBV6-1,TRBJ2-7,CASSEALAGAAYEQYF,0,1,1,1
TRBV2,TRBJ1-1,CASSEADRGWNTEAFF,0,1,1,1
TRBV7-9,TRBJ1-4,CASSFPRGGTNEKLFF,0,1,1,1
TRBV5-6,TRBJ1-5,CASSLLGRATDQPQHF,0,1,1,1
TRBV5-6,TRBJ2-7,CASSLWAGVSSYEQYF,0,1,1,1
TRBV5-4,TRBJ2-4,CASSLRGSLAKNIQYF,0,1,1,1
TRBV11-2,TRBJ2-5,CASSLDSGLNQETQYF,0,1,1,1
TRBV5-4,TRBJ2-2,CASSLNRGGNTGELFF,0,1,1,1
TRBV7-3,TRBJ2-3,CASSLLGGAVADTQYF,0,1,1,1
TRBV11-2,TRBJ1-1,CASSLSQYLMNTEAFF,0,1,1,1
TRBV7-9,TRBJ1-5,CASSLVLWGRGEPQHF,0,1,1,1
TRBV7-2,TRBJ2-1,CASSLVGGGTYNEQFF,0,1,1,1
TRBV7-2,TRBJ1-5,CASSLAGGRGNQPQHI,0,1,1,1
TRBV7-9,TRBJ2-7,CASSLAEDKPLQEQYF,0,1,1,1
TRBV7-8,TRBJ1-1,CASSLARGDSGTEAFF,0,1,1,1
TRBV11-1,TRBJ2-3,CASSLGVGLAVDTQYF,0,1,1,1
TRBV7-9,TRBJ1-5,CASSLDSGASNQPQHF,0,1,1,1
TRBV11-2,TRBJ2-3,CASSLTGSTLGDTQYF,0,1,1,1
TRBV7-3,TRBJ2-3,CASSLSRSGGADTQYF,0,1,1,1
TRBV7-3,TRBJ2-7,CASSLNSPGTLSEQYF,0,1,1,1
TRBV7-3,TRBJ2-1,CASSSDRPSSYNEQFF,0,1,1,1
TRBV3-1,TRBJ2-5,CASSSFLGGSGETQYF,0,1,1,1
TRBV5-6,TRBJ1-2,CASSSTWTGRSGGYTF,0,1,1,1
TRBV6-2/3/5/6,TRBJ2-1,CASSSALAGVYNEQFF,0,1,1,1
TRBV6-2/3/5/6,TRBJ1-5,CASSLKAAYSNQPQHF,0,1,1,1
TRBV3-1,TRBJ2-5,CASSLRVEWGQETQYF,0,1,1,1
TRBV5-5,TRBJ2-3,CASSLQGLPSTDTQYF,0,1,1,1
TRBV7-2,TRBJ2-7,CASSPTPTTEPREQYF,0,1,1,1
TRBV7-9,TRBJ2-3,CASSPNPHRRADTQYF,0,1,1,1
TRBV3-1,TRBJ2-2,CASSPQAGQDSGELFF,0,1,1,1
TRBV11-2,TRBJ1-6,CASSPGSSSYNSPLHF,0,1,1,1
TRBV11-3,TRBJ2-1,CASSPGGLAVGNEQFL,0,1,1,1
TRBV5-4,TRBJ2-1,CASSPGTAGSYNEQFF,0,1,1,1
TRBV3-1,TRBJ2-7,CASSPIPGQGTYEQYF,0,1,1,1
TRBV7-3,TRBJ1-5,CASSPFSEQINQPQHF,0,1,1,1
TRBV3-1,TRBJ2-3,CASSRASALALDTQYF,0,1,1,1
TRBV3-1,TRBJ2-1,CASSHLAGGFYNEQSF,0,1,1,1
TRBV3-1,TRBJ2-1,CASSQPTSGYYNEQFF,0,1,1,1
TRBV3-1,TRBJ2-3,CASSQWKAGGPDTQYF,0,1,1,1
TRBV3-1,TRBJ2-1,CASSQAPSVLYNEQLF,0,1,1,1
TRBV14,TRBJ2-2,CASSQATGKITGELFF,0,1,1,1
TRBV3-1,TRBJ2-3,CASSQGRDRSTDTQYF,0,1,1,1
TRBV4-2,TRBJ2-1,CASSQGLAGTYNEQFF,0,1,1,1
TRBV14,TRBJ2-5,CASSQDSWPFQETQYF,0,1,1,1
TRBV14,TRBJ2-1,CASSQEESTIYNEQFF,0,1,1,1
TRBV5-4,TRBJ2-2,CASSVGLAFNTGELFF,0,1,1,1
TRBV7-8,TRBJ2-1,CASSVGASVGGFTQFL,0,1,1,1
TRBV9,TRBJ2-3,CASSVGGAYGTDTQYF,0,1,1,1
TRBV9,TRBJ2-3,CASSVDPGHATDTQYF,0,1,1,1
TRBV14,TRBJ2-2,CASSEAGVENTGELFF,0,1,1,1
TRBV5-5,TRBJ1-5,CASSTSLDRGGQPQHF,0,1,1,1
TRBV6-2/3/5/6,TRBJ2-3,CASSTTSGVSTDTQYF,0,1,1,1
TRBV5-4,TRBJ1-1,CASRVDLTAMNTEAFF,0,1,1,1
TRBV6-2/3/5/6,TRBJ2-3,CASRLGGTNPAYTQYF,0,1,1,1
TRBV5-1,TRBJ2-5,CASSWGLAGDLETQYF,0,1,1,1
TRBV5-1,TRBJ2-7,CASRRSSGGETYEQYF,0,1,1,1
TRBV12-3/4,TRBJ1-5,CASSFLLGDSNQPQHF,0,1,1,1
TRBV5-1,TRBJ2-7,CASSLAFLAGAYEQYF,0,1,1,1
TRBV5-1,TRBJ2-7,CASSLARTGFSYEQYF,0,1,1,1
TRBV5-1,TRBJ1-2,CASSLEGTVHYYGYTF,0,1,1,1
TRBV5-1,TRBJ2-3,CASSSGLAGGRGTQYF,0,1,1,1
TRBV5-1,TRBJ2-3,CASSSGLAGAIDTQYF,0,1,1,1
TRBV4-1,TRBJ1-1,CASSQSRGQGNTEAFF,0,1,1,1
TRBV4-1,TRBJ2-7,CASSQAGSFSSYEQYF,0,1,1,1
TRBV4-1,TRBJ2-7,CASSQGRTLSSYEQYF,0,1,1,1
TRBV4-1,TRBJ1-5,CASSQDAGAGNQPQHF,0,1,1,1
TRBV4-1,TRBJ2-2,CASSQNPSGGTGGAVF,0,1,1,1
TRBV5-1,TRBJ1-1,CASSTRDSSMNTEAYF,0,1,1,1
TRBV5-1,TRBJ2-4,CASRATPGQGFDIQYF,0,1,1,1
TRBV20-1,TRBJ1-5,CSASAPGLGSNQPQHF,0,1,1,1
TRBV20-1,TRBJ1-5,CSARDEGSESNQPQHF,0,1,1,1
TRBV20-1,TRBJ1-1,CSARDTTGYSNTVAFF,0,1,1,1
TRBV20-1,TRBJ1-5,CSAREPSRGSNQPQHF,0,1,1,1
TRBV6-1,TRBJ2-5,WASSAGTGGAGETQYF,0,1,1,1
TRBV7-9,TRBJ2-3,CAITYDGGLADTQYF,0,1,1,1
TRBV30,TRBJ2-3,CAWSVTSGSTDTQYF,0,1,1,1
TRBV30,TRBJ2-2,CAWSNQGLAHGELFF,0,1,1,1
TRBV30,TRBJ1-1,CAWSKGGPGNTEAFF,0,1,1,1
TRBV30,TRBJ1-5,CAWSHRRDSYQPQHF,0,1,1,1
TRBV30,TRBJ1-5,CAWSRDRGNNQPQHF,0,1,1,1
TRBV24-1,TRBJ1-5,CATPTGGHSNQPQHF,0,1,1,1
TRBV19,TRBJ1-1,CASTLGQGTNTEAFF,0,1,1,1
TRBV19,TRBJ1-2,CASSSDRGWDYGYTF,0,1,1,1
TRBV19,TRBJ1-5,CASSHRDRFNQPQHF,0,1,1,1
TRBV19,TRBJ2-1,CASSISGVSYNEQFF,0,1,1,1
TRBV19,TRBJ2-7,CASSMGRAADYEQYF,0,1,1,1
TRBV19,TRBJ2-5,CASSMDRRLGETQYF,0,1,1,1
TRBV19,TRBJ2-1,CASSIEPGLANEQFF,0,1,1,1
TRBV19,TRBJ1-1,CASSPGGGGGTEAFF,0,1,1,1
TRBV19,TRBJ2-3,CASSPTSAGADTQYF,0,1,1,1
TRBV28,TRBJ2-3,CASSISDMDTDTQYF,0,1,1,1
TRBV10-3,TRBJ2-5,CASSPLAGGQETQYF,0,1,1,1
TRBV18,TRBJ2-3,CASSPGTGGRDTQYF,0,1,1,1
TRBV18,TRBJ1-3,CASSPTDDPGNTIYF,0,1,1,1
TRBV18,TRBJ1-1,CASSPPVVLNTEAFF,0,1,1,1
TRBV18,TRBJ1-1,CASSPPGTGNTEAFS,0,1,1,1
TRBV18,TRBJ1-1,CASSPPGQGGTEAFF,0,1,1,1
TRBV18,TRBJ2-7,CASSHGGQGVYEQYF,0,1,1,1
TRBV6-4,TRBJ1-5,CASVRGPSGNQPQHF,0,1,1,1
TRBV2,TRBJ1-5,CASGGQGFSNQPQHF,0,1,1,1
TRBV12-3/4,TRBJ2-7,CASTPGGGFDYEQYF,0,1,1,1
TRBV28,TRBJ2-7,CASTPTGLGPYEQYF,0,1,1,1
TRBV7-6,TRBJ1-1,CASTARWGSNTEAFF,0,1,1,1
TRBV18,TRBJ1-5,CASTTGKGNNQPQHF,0,1,1,1
TRBV18,TRBJ2-1,CASTKGGPPYNEQFF,0,1,1,1
TRBV27,TRBJ1-4,CASSFRRATNEKLFF,0,1,1,1
TRBV12-3/4,TRBJ2-7,CASSFDSGLGGEQYF,0,1,1,1
TRBV28,TRBJ2-3,CASSFPGLAKDTQYF,0,1,1,1
TRBV12-3/4,TRBJ1-4,CASSFATGDNENLFF,0,1,1,1
TRBV12-3/4,TRBJ1-5,CASSFGAGQGQPQHF,0,1,1,1
TRBV28,TRBJ1-6,CASSLRTVIDSPLHF,0,1,1,1
TRBV28,TRBJ2-7,CASSLLAGATREQYF,0,1,1,1
TRBV27,TRBJ1-3,CASSLQGVSGNTIYF,0,1,1,1
TRBV12-3/4,TRBJ2-7,CASSLTFQGMDEQYF,0,1,1,1
TRBV7-2,TRBJ1-4,CASSSVTEGREKLFF,0,1,1,1
TRBV6-2/3/5/6,TRBJ2-5,CASSSADRGRATQYF,0,1,1,1
TRBV28,TRBJ2-7,CASSSPFSGVYEQYS,0,1,1,1
TRBV6-2/3/5/6,TRBJ2-7,CASSSRQAIGDEQYF,0,1,1,1
TRBV6-2/3/5/6,TRBJ2-3,CASSYFLGRTDTQYF,0,1,1,1
TRBV6-2/3/5/6,TRBJ2-6,CASSYSNTGANVLTF,0,1,1,1
TRBV6-2/3/5/6,TRBJ2-6,CASSYSAYGANVLTF,0,1,1,1
TRBV6-2/3/5/6,TRBJ2-7,CASSLLRTGRYEQYF,0,1,1,1
TRBV6-2/3/5/6,TRBJ1-1,CASSLSGLLNTEAFF,0,1,1,1
TRBV6-4,TRBJ2-3,CASSLGLAGADTQYF,0,1,1,1
TRBV2,TRBJ1-5,CASSPWQAANQPQHF,0,1,1,1
TRBV6-2/3/5/6,TRBJ1-6,CASSPDRAANSPLHF,0,1,1,1
TRBV7-9,TRBJ2-1,CASSRPSVPDNEQFF,0,1,1,1
TRBV28,TRBJ2-1,CASSRLAGLYNEQFF,0,1,1,1
TRBV11-1,TRBJ2-7,CASSQAGLYSYEQYF,0,1,1,1
TRBV6-1,TRBJ2-4,CASSGQQGAKNIQYF,0,1,1,1
TRBV2,TRBJ1-2,CASSDTGAQGYGYTF,0,1,1,1
TRBV2,TRBJ1-5,CASSESGGSNQPQHF,0,1,1,1
TRBV25-1,TRBJ2-7,CASSEWKRGSYEQYF,0,1,1,1
TRBV6-1,TRBJ1-1,CASSEYGQLNTEAFF,0,1,1,1
TRBV2,TRBJ1-1,CASSEAGGFYTEAFF,0,1,1,1
TRBV6-1,TRBJ2-5,CASSEMAGGQETQYF,0,1,1,1
TRBV6-2/3/5/6,TRBJ1-6,CASSTRTGDNSPLHF,0,1,1,1
TRBV2,TRBJ2-5,CASSNPGGGKETQYF,0,1,1,1
TRBV5-5,TRBJ2-2,CASSFYDDDTGELFF,0,1,1,1
TRBV7-2,TRBJ1-2,CASSFGAGDVGGYTF,0,1,1,1
TRBV5-6,TRBJ1-5,CASSLVGESNQPQHF,0,1,1,1
TRBV5-4,TRBJ1-2,CASSLAQGFNYGYTF,0,1,1,1
TRBV7-3,TRBJ2-3,CASSLGLRGTDTQYF,0,1,1,1
TRBV5-5,TRBJ2-1,CASSLSQGFYNEQFF,0,1,1,1
TRBV7-9,TRBJ2-1,CASSLLGAAYNEQFF,0,1,1,1
TRBV11-3,TRBJ2-1,CASSLSASLGNEQFF,0,1,1,1
TRBV7-2,TRBJ1-1,CASSLVGGMNTEAFF,0,1,1,1
TRBV11-2,TRBJ2-1,CASSLVTGGHNEQFF,0,1,1,1
TRBV11-2,TRBJ2-1,CASSLATGEHNEQFF,0,1,1,1
TRBV7-9,TRBJ2-3,CASSLARRGTDTQYF,0,1,1,1
TRBV7-6,TRBJ2-5,CASSLAVQPQETQYF,0,1,1,1
TRBV7-9,TRBJ2-5,CASSLDLARQETQYF,0,1,1,1
TRBV11-2,TRBJ1-1,CASSLDGGMDTEAFF,0,1,1,1
TRBV7-9,TRBJ2-5,CASSLDMEGRETQYF,0,1,1,1
TRBV5-4,TRBJ2-2,CASSLDNTNTGELFF,0,1,1,1
TRBV7-9,TRBJ2-3,CASSLEGQVADTQYF,0,1,1,1
TRBV7-2,TRBJ2-3,CASSLETGGTDTQYF,0,1,1,1
TRBV7-2,TRBJ2-7,CASSLIASPKDEQCI,0,1,1,1
TRBV7-9,TRBJ2-3,CASSLTGFFADTQYF,0,1,1,1
TRBV11-2,TRBJ2-7,CASSLRPGQGREQYF,0,1,1,1
TRBV11-2,TRBJ2-1,CASSSRDTTYNEQFF,0,1,1,1
TRBV7-9,TRBJ2-3,CASSSLSGVTDTQYF,0,1,1,1
TRBV7-2,TRBJ2-3,CASSSQQGITDMQYF,0,1,1,1
TRBV7-9,TRBJ2-7,CASSSASRYPYEQYF,0,1,1,1
TRBV7-2,TRBJ2-3,CASSLSGGAGDTQYF,0,1,1,1
TRBV7-9,TRBJ2-1,CASSLTGVSYNEQFF,0,1,1,1
TRBV5-4,TRBJ2-1,CASSLERGRYNEQFF,0,1,1,1
TRBV11-1,TRBJ2-3,CASSLKLASTDTQYF,0,1,1,1
TRBV7-9,TRBJ1-6,CASSPSGTANSPLHY,0,1,1,1
TRBV5-4,TRBJ2-1,CASSPLRDHPNEQFF,0,1,1,1
TRBV7-2,TRBJ2-3,CASSPGYLNTDTQYF,0,1,1,1
TRBV6-2/3/5/6,TRBJ2-1,CASSPGASALGEQFF,0,1,1,1
TRBV7-3,TRBJ2-1,CASSPGLAGYNEQFF,0,1,1,1
TRBV28,TRBJ1-3,CASSPEGLSGNTIYF,0,1,1,1
TRBV28,TRBJ1-5,CASSPRGIGDQPQHF,0,1,1,1
TRBV7-9,TRBJ2-7,CASSPMGARQGEQYF,0,1,1,1
TRBV7-9,TRBJ1-4,CASSPSSRLNEKLFF,0,1,1,1
TRBV7-3,TRBJ2-3,CASSRGGATTNTQYF,0,1,1,1
TRBV3-1,TRBJ2-7,CASSRTGGPSYEQYF,0,1,1,1
TRBV7-9,TRBJ2-1,CASSRGRGGTDEQFF,0,1,1,1
TRBV5-6,TRBJ1-2,CASSRTPGPTYGYTF,0,1,1,1
TRBV3-1,TRBJ1-2,CASSHPGQSYYGYTF,0,1,1,1
TRBV5-5,TRBJ1-4,CASSQGPTGSEKLFF,0,1,1,1
TRBV3-1,TRBJ2-2,CASSQHGGGTGELFF,0,1,1,1
TRBV3-1,TRBJ2-7,CASSQAGTGFYEQYF,0,1,1,1
TRBV4-2,TRBJ2-7,CASSQGLAGLYEQYF,0,1,1,1
TRBV3-1,TRBJ1-1,CASSQGGTGLTEAFF,0,1,1,1
TRBV3-1,TRBJ2-5,CASSQGSLIQETQYF,0,1,1,1
TRBV3-1,TRBJ2-7,CASSQDVSRTSEQYF,0,1,1,1
TRBV3-1,TRBJ2-5,CASSQDIGSRETQYF,0,1,1,1
TRBV3-1,TRBJ2-7,CASSQEGGRSYEQYF,0,1,1,1
TRBV7-2,TRBJ2-1,CASSVLAGALNEQFF,0,1,1,1
TRBV9,TRBJ1-6,CASSVALGFASPLHF,0,1,1,1
TRBV11-2,TRBJ2-7,CASSDTSGGAYEQYF,0,1,1,1
TRBV12-3/4,TRBJ2-7,CASSMIQGSSYEQYF,0,1,1,1
TRBV7-9,TRBJ2-7,CASSTRSMPLYEQYF,0,1,1,1
TRBV13,TRBJ2-7,CASSTGQGATYEQYF,0,1,1,1
TRBV7-9,TRBJ1-3,CASSRAGGIGNTIYF,0,1,1,1
TRBV11-2,TRBJ2-3,CASSNMGRGTDTQYF,0,1,1,1
TRBV7-9,TRBJ2-3,CASSKRRIGTDTQYF,0,1,1,1
TRBV11-2,TRBJ2-7,CASRKWGGVLDEQYF,0,1,1,1
TRBV7-3,TRBJ2-7,CASRPGLAGTNEQYF,0,1,1,1
TRBV11-2,TRBJ2-1,CASRPGTGTYNEQFF,0,1,1,1
TRBV7-8,TRBJ2-7,CASREGVTSSYEQYF,0,1,1,1
TRBV7-3,TRBJ1-1,CASRKSQAMNTEAFF,0,1,1,1
TRBV7-9,TRBJ2-2,CASNHATPRTGELFF,0,1,1,1
TRBV6-4,TRBJ2-7,CASNERGTGAYEQYF,0,1,1,1
TRBV5-1,TRBJ2-7,CPSSSGDKILDEQYF,0,1,1,1
TRBV5-1,TRBJ2-1,CASCYAAGGPDEQFF,0,1,1,1
TRBV5-1,TRBJ1-5,CASATGGVGNQPQHF,0,1,1,1
TRBV10-1,TRBJ2-7,CASSESGRSSYEQYF,0,1,1,1
TRBV5-1,TRBJ2-7,CASSSPAGGRDEQYF,0,1,1,1
TRBV5-1,TRBJ2-5,CASSLYGIGQETQYF,0,1,1,1
TRBV5-1,TRBJ2-5,CASSLVSGGEQTQYF,0,1,1,1
TRBV5-1,TRBJ1-1,CASSLASAGNTEAFF,0,1,1,1
TRBV5-1,TRBJ1-6,CASSLAGTSRSPLLF,0,1,1,1
TRBV5-1,TRBJ2-3,CASSLRQAGTDTQYF,0,1,1,1
TRBV5-1,TRBJ1-6,CASSLEGGGNSPLHF,0,1,1,1
TRBV5-1,TRBJ2-1,CASSSSGGIAHEQFF,0,1,1,1
TRBV5-1,TRBJ2-6,CASSWTVSGANVLTF,0,1,1,1
TRBV4-1,TRBJ2-1,CASSLESAVWDEQFF,0,1,1,1
TRBV4-1,TRBJ2-5,CASSLRDTTSETQYF,0,1,1,1
TRBV5-1,TRBJ2-3,CASSPLAGGPDTQYF,0,1,1,1
TRBV5-1,TRBJ2-1,CASSQRTGNSVGWFF,0,1,1,1
TRBV4-1,TRBJ1-1,CASSQAIGAGTEAFF,0,1,1,1
TRBV4-1,TRBJ1-3,CASSAWTGTRNTIYF,0,1,1,1
TRBV5-1,TRBJ2-7,CASSEGLAGYNEQYF,0,1,1,1
TRBV5-1,TRBJ2-1,CASSTTSGGGDEQFF,0,1,1,1
TRBV5-1,TRBJ2-2,CASRIGGANTGELFF,0,1,1,1
TRBV20-1,TRBJ2-1,CSALGGGGSYNEQFF,0,1,1,1
TRBV20-1,TRBJ2-7,CSATNPGAGLNEQYF,0,1,1,1
TRBV20-1,TRBJ2-7,CSASSAGGLYYEQYF,0,1,1,1
TRBV20-1,TRBJ2-5,CSARDEGGARETQYF,0,1,1,1
TRBV20-1,TRBJ2-1,CSARDTGGPINEQFF,0,1,1,1
TRBV20-1,TRBJ2-5,CSARDEGGAQETQYF,0,1,1,1
TRBV20-1,TRBJ2-6,CSARATETGANVLTF,0,1,1,1
TRBV29-1,TRBJ2-5,CSVGEGSEVQETQYF,0,1,1,1
TRBV29-1,TRBJ2-3,CSVESGSGGTDTQYF,0,1,1,1
TRBV29-1,TRBJ2-1,CSVEKDSEINNEQFF,0,1,1,1
TRBV29-1,TRBJ2-1,CSVGGKRDRYNEQFF,0,1,1,1
TRBV10-3,TRBJ1-5,RAISADRVGKQPQHF,0,1,1,1
TRBV18,TRBJ2-1,RASPPSINSYNEQFF,0,1,1,1
TRBV29-1,TRBJ2-1,RSVESRGNAYKEQFF,0,1,1,1
TRBV28,TRBJ2-3,CAIGASGGADTQYF,0,1,1,1
TRBV12-5,TRBJ2-1,CASGFGGLKGEQFF,0,1,1,1
TRBV30,TRBJ1-1,CASKGGSQNTEAFF,0,1,1,1
TRBV30,TRBJ2-2,CASTRGLDTGELFF,0,1,1,1
TRBV30,TRBJ1-4,CAWSFDSVNEKLFF,0,1,1,1
TRBV30,TRBJ1-2,CAWSPDHRGSGYTF,0,1,1,1
TRBV30,TRBJ1-1,CAWSVTGSSTEAFF,0,1,1,1
TRBV30,TRBJ2-3,CAWSGQGRTDTQYF,0,1,1,1
TRBV28,TRBJ1-1,CAVNGGGRVTEAFF,0,1,1,1
TRBV30,TRBJ2-7,CAGGMTGGPYEQYF,0,1,1,1
TRBV10-3,TRBJ2-3,CAITSGGHTDTQYF,0,1,1,1
TRBV10-3,TRBJ1-6,CAIRQGEHNSPLHF,0,1,1,1
TRBV10-3,TRBJ2-1,CAIRENDSPNEQFF,0,1,1,1
TRBV11-2,TRBJ2-7,CATRIAGSSYEQYF,0,1,1,1
TRBV15,TRBJ2-5,CATSRGEAQETQYF,0,1,1,1
TRBV19,TRBJ2-7,CASSPPGQFYEQYF,0,1,1,1
TRBV19,TRBJ1-5,CASSIRQGSQPQHF,0,1,1,1
TRBV19,TRBJ1-5,CASSTFPGNQPQHF,0,1,1,1
TRBV19,TRBJ2-3,CASSSGGGTDTQYF,0,1,1,1
TRBV19,TRBJ2-7,CASSAGLFLYEQYF,0,1,1,1
TRBV12-3/4,TRBJ2-1,CASSREGSRNEQFF,0,1,1,1
TRBV18,TRBJ2-5,CASSSGLNQETQYF,0,1,1,1
TRBV18,TRBJ2-2,CASSPRDGTGELFF,0,1,1,1
TRBV18,TRBJ1-3,CASSPDTSGNTIYF,0,1,1,1
TRBV18,TRBJ2-7,CASSPRGVGSEQYF,0,1,1,1
TRBV18,TRBJ2-5,CASSALGYQETQYF,0,1,1,1
TRBV12-3/4,TRBJ1-1,CASRDRLVNTEAFF,0,1,1,1
TRBV28,TRBJ1-4,CASHRAGRNEKLFF,0,1,1,1
TRBV4-2,TRBJ2-3,CASGTSGGSDTQYF,0,1,1,1
TRBV6-2/3/5/6,TRBJ2-5,CASIRHLNQETQYF,0,1,1,1
TRBV3-1,TRBJ2-5,CASIDRGKGETQYF,0,1,1,1
TRBV6-1,TRBJ1-4,CASTAGTGNEKLLF,0,1,1,1
TRBV7-9,TRBJ1-2,CASTVSRVNYGYTF,0,1,1,1
TRBV12-3/4,TRBJ2-7,CASSFGQGPSLQYF,0,1,1,1
TRBV28,TRBJ2-1,CASSLGYSYNEQFF,0,1,1,1
TRBV6-2/3/5/6,TRBJ2-1,CASSLLAGNNEQFF,0,1,1,1
TRBV27,TRBJ2-7,CASSLRQGSYEQYF,0,1,1,1
TRBV12-3/4,TRBJ1-5,CASSLQGGGQPQHF,0,1,1,1
TRBV12-3/4,TRBJ2-3,CASSLGGSTDTQYF,0,1,1,1
TRBV6-2/3/5/6,TRBJ2-7,CASSLERGDNEQYF,0,1,1,1
TRBV2,TRBJ2-7,CASSSTGGDYEQYF,0,1,1,1
TRBV12-3/4,TRBJ2-3,CASSWAGDTDTQYF,0,1,1,1
TRBV28,TRBJ1-5,CASSWDRTGQPQHF,0,1,1,1
TRBV6-2/3/5/6,TRBJ2-7,CASSYTSTRAGQYF,0,1,1,1
TRBV6-2/3/5/6,TRBJ2-3,CASSYTGSTDTQYF,0,1,1,1
TRBV28,TRBJ1-1,CASSPLTSGTEAFF,0,1,1,1
TRBV6-2/3/5/6,TRBJ2-5,CASSRTLSGETQYF,0,1,1,1
TRBV6-4,TRBJ2-7,CASSALGQTYEQYF,0,1,1,1
TRBV6-1,TRBJ2-1,CASSGTNPYNEQFF,0,1,1,1
TRBV2,TRBJ1-4,CASSDRGMDEKLFF,0,1,1,1
TRBV2,TRBJ2-5,CASSEAWTQETQYF,0,1,1,1
TRBV2,TRBJ1-2,CASSEGEFNYGYTF,0,1,1,1
TRBV6-1,TRBJ1-4,CASSEDGINEKLFF,0,1,1,1
TRBV12-3/4,TRBJ1-2,CASSIRYMSYGYTF,0,1,1,1
TRBV7-9,TRBJ2-1,CASSFWQGPNEQFF,0,1,1,1
TRBV7-6,TRBJ2-1,CASSFGGDGYEQFF,0,1,1,1
TRBV7-9,TRBJ1-4,CASSFGTTNENLFF,0,1,1,1
TRBV5-5,TRBJ1-5,CASSLWQGEQPQHF,0,1,1,1
TRBV5-4,TRBJ2-5,CASSLASAGETQYF,0,1,1,1
TRBV5-5,TRBJ1-3,CASSLGPGGNTIYF,0,1,1,1
TRBV7-9,TRBJ2-7,CASSLMDSSYEQYF,0,1,1,1
TRBV5-6,TRBJ2-7,CASSLTGGTYEQYF,0,1,1,1
TRBV28,TRBJ1-1,CASSLQGQNTEAFF,0,1,1,1
TRBV7-9,TRBJ2-7,CASSLVGTEDEQYF,0,1,1,1
TRBV7-2,TRBJ1-2,CASSLMGQNYGYTF,0,1,1,1
TRBV7-3,TRBJ2-5,CASSLTGIGETQNF,0,1,1,1
TRBV7-9,TRBJ2-7,CASSSTLILYEQYF,0,1,1,1
TRBV13,TRBJ2-7,CASSSPSTPYEQYF,0,1,1,1
TRBV7-9,TRBJ1-1,CASSSGRANTEAFF,0,1,1,1
TRBV7-3,TRBJ2-4,CASSSGQGEDIQYF,0,1,1,1
TRBV7-2,TRBJ2-7,CASSLGGHSYEQYF,0,1,1,1
TRBV3-1,TRBJ2-4,CASSLTSQRNIQYF,0,1,1,1
TRBV5-4,TRBJ2-7,CASSLGDNSYEQYF,0,1,1,1
TRBV7-2,TRBJ1-1,CASSLGRRATEAFF,0,1,1,1
TRBV3-1,TRBJ1-5,CASSPRTGNQPQHF,0,1,1,1
TRBV5-4,TRBJ2-3,CASSPGQRTDTQYF,0,1,1,1
TRBV28,TRBJ2-7,CASSPDPGQSEQYF,0,1,1,1
TRBV3-1,TRBJ2-1,CASSPEGRGSEQFF,0,1,1,1
TRBV3-1,TRBJ1-5,CASSPRQSNQPQHF,0,1,1,1
TRBV6-2/3/5/6,TRBJ2-4,CASSPRSGENIQYF,0,1,1,1
TRBV3-1,TRBJ2-7,CASSPRTSRGEQYF,0,1,1,1
TRBV7-8,TRBJ1-1,CASSPTGGNTEAFF,0,1,1,1
TRBV14,TRBJ2-1,CASSPSLVIYEQFF,0,1,1,1
TRBV3-1,TRBJ1-4,CASSPAGGGEKLFF,0,1,1,1
TRBV2,TRBJ2-3,CASSPTPILDTQYF,0,1,1,1
TRBV12-3/4,TRBJ2-7,CASSRGTYTYEQYF,0,1,1,1
TRBV7-6,TRBJ1-1,CASSRGGEHTEAFF,0,1,1,1
TRBV2,TRBJ1-2,CASSRTGDHYGYTF,0,1,1,1
TRBV7-9,TRBJ1-5,CASSRQNSNQPQHF,0,1,1,1
TRBV3-1,TRBJ2-2,CASSRTGYTGELFF,0,1,1,1
TRBV4-2,TRBJ2-1,CASSHDHSYNEQFF,0,1,1,1
TRBV5-5,TRBJ2-7,CASSHRGRTYEQYF,0,1,1,1
TRBV7-8,TRBJ1-1,CASSHREGSTEAFF,0,1,1,1
TRBV3-1,TRBJ1-5,CASSQDPSNQPQHF,0,1,1,1
TRBV4-2,TRBJ1-5,CASSQEVSGQPQHF,0,1,1,1
TRBV3-1,TRBJ2-1,CASSQEGTDGQQFF,0,1,1,1
TRBV9,TRBJ2-7,CASSQTGAPYEQYF,0,1,1,1
TRBV3-1,TRBJ1-1,CASSQSLRNTEAFF,0,1,1,1
TRBV7-9,TRBJ1-1,CASSVGQGNTEAFF,0,1,1,1
TRBV13,TRBJ1-1,CASSADRTVHEAFF,0,1,1,1
TRBV7-6,TRBJ2-5,CASSGWTFQETQYF,0,1,1,1
TRBV28,TRBJ2-3,CASSGGAYTDTQYF,0,1,1,1
TRBV7-9,TRBJ2-5,CASSDPGGLETQYF,0,1,1,1
TRBV12-3/4,TRBJ1-5,CASSDIYSNQPQHF,0,1,1,1
TRBV5-6,TRBJ2-7,CASSIPGQDYEQYF,0,1,1,1
TRBV9,TRBJ2-5,CASSRTSNQETQYF,0,1,1,1
TRBV6-2/3/5/6,TRBJ2-3,CASSRAGSTDTQYF,0,1,1,1
TRBV7-2,TRBJ2-5,CASSNAGGQETQYF,0,1,1,1
TRBV7-9,TRBJ1-1,CASRWDRGATEAFF,0,1,1,1
TRBV6-2/3/5/6,TRBJ1-5,CASRLTGGRQPQHF,0,1,1,1
TRBV6-2/3/5/6,TRBJ2-1,CASRPWGQNNEQFF,0,1,1,1
TRBV12-3/4,TRBJ1-5,CASRQTRGLQPQHF,0,1,1,1
TRBV2,TRBJ2-2,CASRGRTNTGELFF,0,1,1,1
TRBV2,TRBJ2-7,CASRGRGHSYEQYF,0,1,1,1
TRBV12-3/4,TRBJ2-1,CASRGLAGFDEQFF,0,1,1,1
TRBV2,TRBJ1-2,CASRDLTGSYGYTF,0,1,1,1
TRBV28,TRBJ2-7,CASRRAGGDCEQYF,0,1,1,1
TRBV6-2/3/5/6,TRBJ2-7,CASRQDRVHYEQYF,0,1,1,1
TRBV12-3/4,TRBJ2-3,CASNEGPFTDTQYF,0,1,1,1
TRBV28,TRBJ2-2,CASKFQGNTGELFF,0,1,1,1
TRBV28,TRBJ2-2,CASKVAWKGGQLFF,0,1,1,1
TRBV2,TRBJ2-7,CASKPTQGSYEQYF,0,1,1,1
TRBV5-6,TRBJ2-2,CDSSFTRNTGELFF,0,1,1,1
TRBV18,TRBJ2-5,CASSPPGIQETQYF,0,1,1,1
TRBV5-1,TRBJ2-7,CASRPGLADYEQYF,0,1,1,1
TRBV5-1,TRBJ2-1,CASATGQRVSEQFF,0,1,1,1
TRBV5-1,TRBJ2-7,CASSWDRPQYEQYF,0,1,1,1
TRBV5-1,TRBJ1-5,CASSFTGMDQPQHF,0,1,1,1
TRBV5-1,TRBJ1-4,CASSFSGGDEKLFF,0,1,1,1
TRBV5-1,TRBJ1-1,CASSLQRASGAAFF,0,1,1,1
TRBV5-1,TRBJ1-1,CASSLVPGDTEAFF,0,1,1,1
TRBV5-1,TRBJ2-7,CASSLAGTSYEQYF,0,1,1,1
TRBV5-1,TRBJ1-5,CASSLAGEGQPQHF,0,1,1,1
TRBV5-1,TRBJ2-5,CASSLASTQETQYF,0,1,1,1
TRBV5-1,TRBJ1-2,CASSLGDSNYGYTF,0,1,1,1
TRBV5-1,TRBJ2-7,CASSLSDQSYEQYF,0,1,1,1
TRBV5-1,TRBJ1-4,CASSPQSLNEKLFF,0,1,1,1
TRBV5-1,TRBJ2-7,CASSPGQVSYEQYF,0,1,1,1
TRBV5-1,TRBJ1-1,CASSPWVTNTEAFF,0,1,1,1
TRBV5-1,TRBJ1-1,CASSPGGGVTEAFF,0,1,1,1
TRBV4-1,TRBJ2-7,CASSPSGSTYEQYF,0,1,1,1
TRBV5-1,TRBJ2-5,CASSQQTSGETQYF,0,1,1,1
TRBV4-1,TRBJ1-5,CASSQTGVAQPQHF,0,1,1,1
TRBV5-1,TRBJ1-1,CASSVTGTSTEAFF,0,1,1,1
TRBV5-1,TRBJ2-5,CASRPMGVQETQYF,0,1,1,1
TRBV20-1,TRBJ2-2,CGALGTINTGELFF,0,1,1,1
TRBV20-1,TRBJ2-2,CSVVRDREGGELFF,0,1,1,1
TRBV20-1,TRBJ2-5,CSAPPGQGQETQYF,0,1,1,1
TRBV20-1,TRBJ1-5,CSASLGMGNQPQHF,0,1,1,1
TRBV20-1,TRBJ1-4,CSASVSGTGEKLFF,0,1,1,1
TRBV20-1,TRBJ2-1,CSARDRLAGGPLFF,0,1,1,1
TRBV20-1,TRBJ1-6,CSARWDGGDSPLHF,0,1,1,1
TRBV20-1,TRBJ2-3,CSARPSGGTYTQYF,0,1,1,1
TRBV20-1,TRBJ1-1,CSARVLEANTEAFF,0,1,1,1
TRBV20-1,TRBJ2-3,CSARDRGGTDTQYF,0,1,1,1
TRBV20-1,TRBJ1-6,CSAREGSLRSPLHF,0,1,1,1
TRBV20-1,TRBJ2-4,CSARSRGFQNIQYF,0,1,1,1
TRBV20-1,TRBJ2-4,CSALGGAALYIQYF,0,1,1,1
TRBV20-1,TRBJ2-5,CSADAGPGKETQYF,0,1,1,1
TRBV20-1,TRBJ2-3,CSAGVFSPTDTQYF,0,1,1,1
TRBV29-1,TRBJ1-1,CSVVGGELNTEAFF,0,1,1,1
TRBV29-1,TRBJ1-5,CSVVAGTGDQPQHF,0,1,1,1
TRBV29-1,TRBJ1-2,CSVGLGQGAYGYTF,0,1,1,1
TRBV29-1,TRBJ2-1,CSVGGLSSYNEQFF,0,1,1,1
TRBV29-1,TRBJ2-3,CSVEGRGAPDTQYF,0,1,1,1
TRBV29-1,TRBJ2-7,CSVERGYTPAEQYF,0,1,1,1
TRBV29-1,TRBJ2-5,CSVERTGRRETQYF,0,1,1,1
TRBV29-1,TRBJ2-6,CSVSSLSGANVLTF,0,1,1,1
TRBV29-1,TRBJ2-7,CSVRLGDFFDEQYF,0,1,1,1
TRBV29-1,TRBJ2-7,CSVALSGVAYEQYF,0,1,1,1
TRBV18,TRBJ1-5,WASSPGQGNQPQHF,0,1,1,1
TRBV7-9,TRBJ2-7,RASSLAGTTYEQYF,0,1,1,1
TRBV7-2,TRBJ2-3,RASSPGTNPDTQYF,0,1,1,1
TRBV29-1,TRBJ2-7,GSATSGLRTGEQYF,0,1,1,1
TRBV7-8,TRBJ2-1,CVTRRRDYNEQFF,0,1,1,1
TRBV7-7,TRBJ2-3,CASSLQGTDTQYF,0,1,1,1
TRBV30,TRBJ1-2,CASTTGVNYGYTF,0,1,1,1
TRBV30,TRBJ2-7,CAWTMAGGDEQYF,0,1,1,1
TRBV30,TRBJ1-4,CAWTIQGDEKLFF,0,1,1,1
TRBV15,TRBJ2-5,CATSTGEKETQYF,0,1,1,1
TRBV19,TRBJ2-7,CASSSPTRYEQYF,0,1,1,1
TRBV6-2/3/5/6,TRBJ2-1,CASFNRISNEQFF,0,1,1,1
TRBV18,TRBJ2-5,CASSPNSHETQYF,0,1,1,1
TRBV18,TRBJ1-5,CASSPQGDQPQHF,0,1,1,1
TRBV18,TRBJ2-3,CASSTSGTDTQYF,0,1,1,1
TRBV2,TRBJ2-3,CASCNREADTQYF,0,1,1,1
TRBV11-2,TRBJ1-1,CASQRAGKSEAFF,0,1,1,1
TRBV14,TRBJ1-1,CASGPHLNTEAFF,0,1,1,1
TRBV12-3/4,TRBJ1-2,CASGGRGGYGYTF,0,1,1,1
TRBV28,TRBJ2-5,CASIDQWEETQYF,0,1,1,1
TRBV12-3/4,TRBJ1-2,CASTPSGLYGYTF,0,1,1,1
TRBV7-2,TRBJ1-2,CASTPWGVYGYTF,0,1,1,1
TRBV7-9,TRBJ2-3,CASTPRDTDTQYF,0,1,1,1
TRBV6-2/3/5/6,TRBJ2-7,CASSFPPLYEQYF,0,1,1,1
TRBV12-3/4,TRBJ2-3,CASSFGSTDTQYF,0,1,1,1
TRBV11-2,TRBJ2-5,CASSFTEQETQYC,0,1,1,1
TRBV28,TRBJ2-5,CASSLSGQETQYF,0,1,1,1
TRBV12-3/4,TRBJ2-1,CASSLGQLNEQFF,0,1,1,1
TRBV27,TRBJ1-1,CASSLRIFHEAFF,0,1,1,1
TRBV6-2/3/5/6,TRBJ2-7,CASSYSRGNEQYF,0,1,1,1
TRBV28,TRBJ2-7,CASSYLQGIEQYF,0,1,1,1
TRBV6-2/3/5/6,TRBJ1-2,CASSLTGSLGYTF,0,1,1,1
TRBV28,TRBJ2-7,CASSPPQVYEQYF,0,1,1,1
TRBV6-1,TRBJ1-5,CASSRTPTPPQHF,0,1,1,1
TRBV6-2/3/5/6,TRBJ2-7,CASSQGSSYEQYF,0,1,1,1
TRBV11-1,TRBJ2-1,CASSVTGYNEQFF,0,1,1,1
TRBV2,TRBJ1-6,CASSAWVNSPLHF,0,1,1,1
TRBV12-3/4,TRBJ2-4,CASSGLAKNIQYF,0,1,1,1
TRBV25-1,TRBJ2-3,CASSEYTGTAQYF,0,1,1,1
TRBV6-1,TRBJ1-2,CASSSSGIYGYTF,0,1,1,1
TRBV11-2,TRBJ1-1,CASSFEGANEAFF,0,1,1,1
TRBV11-2,TRBJ2-3,CASSFSGTDTQYF,0,1,1,1
TRBV6-2/3/5/6,TRBJ1-1,CASSFGTGSEAFF,0,1,1,1
TRBV11-3,TRBJ2-5,CASSFGTEETQYF,0,1,1,1
TRBV7-2,TRBJ2-1,CASSLFWTDEQFF,0,1,1,1
TRBV7-8,TRBJ2-3,CASSLEGTDTQYF,0,1,1,1
TRBV7-2,TRBJ2-1,CASSLMGYNEQFF,0,1,1,1
TRBV7-9,TRBJ1-5,CASSLQGDQPQHF,0,1,1,1
TRBV11-3,TRBJ2-3,CASSLGRADTQYF,0,1,1,1
TRBV11-2,TRBJ1-5,CASSLDISQPQHF,0,1,1,1
TRBV7-3,TRBJ1-6,CASSLDSNSPLHF,0,1,1,1
TRBV7-9,TRBJ2-5,CASSLEGRETQYF,0,1,1,1
TRBV7-9,TRBJ2-1,CASSLTGEYEQFF,0,1,1,1
TRBV7-3,TRBJ2-1,CASSLTTYNEQFF,0,1,1,1
TRBV7-3,TRBJ2-6,CASSSSGANVLTF,0,1,1,1
TRBV11-2,TRBJ1-1,CASSSVEGSEAFF,0,1,1,1
TRBV11-2,TRBJ2-1,CASSSDDYNEQFF,0,1,1,1
TRBV12-3/4,TRBJ1-5,CASSSDEKGAQHF,0,1,1,1
TRBV7-8,TRBJ2-5,CASSSGRWAPEYF,0,1,1,1
TRBV7-2,TRBJ2-3,CASSYSLADTQYF,0,1,1,1
TRBV3-1,TRBJ2-7,CASSLWSTGEQYF,0,1,1,1
TRBV3-1,TRBJ1-5,CASSLQGFEPQHF,0,1,1,1
TRBV7-3,TRBJ2-3,CASSPRGADTQYF,0,1,1,1
TRBV7-2,TRBJ2-7,CASSPATGEEQYF,0,1,1,1
TRBV14,TRBJ1-1,CASSPGLEVEAFF,0,1,1,1
TRBV6-2/3/5/6,TRBJ1-5,CASSRDLNQPQHF,0,1,1,1
TRBV3-1,TRBJ2-7,CASSREGTYEQYF,0,1,1,1
TRBV3-1,TRBJ1-1,CASSQGNTVEAFF,0,1,1,1
TRBV14,TRBJ2-7,CASSQTVLGQQYF,0,1,1,1
TRBV3-1,TRBJ2-2,CASSQYGSEALFF,0,1,1,1
TRBV3-1,TRBJ1-5,CASSQVGNQPQHF,0,1,1,1
TRBV12-3/4,TRBJ2-1,CASSVLELGEQFF,0,1,1,1
TRBV7-3,TRBJ1-1,CASSAQGNTEAFS,0,1,1,1
TRBV7-6,TRBJ2-3,CASSGFGAQAQYF,0,1,1,1
TRBV7-9,TRBJ1-4,CASSEVTDEKLFF,0,1,1,1
TRBV28,TRBJ1-2,CASSEQGARGYTF,0,1,1,1
TRBV13,TRBJ2-7,CASSTSWGIEQYF,0,1,1,1
TRBV3-1,TRBJ1-2,CASSKQGLNGYTF,0,1,1,1
TRBV28,TRBJ2-7,CASRPTGRYEQYF,0,1,1,1
TRBV5-4,TRBJ2-1,CASRVVSYNEQFF,0,1,1,1
TRBV7-9,TRBJ1-3,CASRGGAGNTIYF,0,1,1,1
TRBV11-2,TRBJ2-7,CASRNQTGYEQYF,0,1,1,1
TRBV12-3/4,TRBJ1-2,CASRHGQIDGYTF,0,1,1,1
TRBV6-4,TRBJ1-2,CASRDRDIYGYTF,0,1,1,1
TRBV12-3/4,TRBJ1-6,CASNQGFNSPLHF,0,1,1,1
TRBV12-3/4,TRBJ2-3,CASKLQGTDTQYF,0,1,1,1
TRBV12-3/4,TRBJ2-1,CANSLPTSVEQFF,0,1,1,1
TRBV7-6,TRBJ1-1,CASMRGRNTEAFF,0,1,1,1
TRBV28,TRBJ1-4,CASSLSTVEKLFF,0,1,1,1
TRBV5-1,TRBJ2-3,CASSIDNTDTQYF,0,1,1,1
TRBV5-1,TRBJ1-1,CASSLVENTEAFF,0,1,1,1
TRBV5-1,TRBJ1-1,CASSLAGTVEAFF,0,1,1,1
TRBV5-1,TRBJ1-5,CASSLDTDQPQHF,0,1,1,1
TRBV5-1,TRBJ1-1,CASSLERNTEAFF,0,1,1,1
TRBV5-1,TRBJ1-1,CASSLGQGELAFF,0,1,1,1
TRBV5-1,TRBJ2-1,CASSSGRVNEQFF,0,1,1,1
TRBV4-1,TRBJ2-3,CASSPLDPRAQYF,0,1,1,1
TRBV4-1,TRBJ1-1,CASSRQGATEAFF,0,1,1,1
TRBV4-1,TRBJ1-5,CASSQDLGQPQHF,0,1,1,1
TRBV10-2,TRBJ2-2,CASKQGYTGELFF,0,1,1,1
TRBV20-1,TRBJ1-5,CSAVAVSNQPQHF,0,1,1,1
TRBV20-1,TRBJ1-3,CSAMAEAGNTIYF,0,1,1,1
TRBV20-1,TRBJ1-5,CSASLQVSQPQHF,0,1,1,1
TRBV20-1,TRBJ2-5,CSARVGAVETQYF,0,1,1,1
TRBV20-1,TRBJ2-7,CSARGQGEYEQYF,0,1,1,1
TRBV20-1,TRBJ1-1,CSARRQLNTEAFF,0,1,1,1
TRBV20-1,TRBJ1-4,CSARGLSDEKLLF,0,1,1,1
TRBV20-1,TRBJ2-7,CSAPSGGHYEQYF,0,1,1,1
TRBV20-1,TRBJ2-5,CSAVRDRAKTQYF,0,1,1,1
TRBV20-1,TRBJ2-7,CSAGAGLANEQYF,0,1,1,1
TRBV29-1,TRBJ2-7,CSVVVGGSYEQYF,0,1,1,1
TRBV29-1,TRBJ1-1,CSVADRLNTEAFF,0,1,1,1
TRBV29-1,TRBJ1-5,CSVANRENQPQHF,0,1,1,1
TRBV29-1,TRBJ2-7,CSVDETGADEQYF,0,1,1,1
TRBV29-1,TRBJ1-5,CSVESGRDQPQHF,0,1,1,1
TRBV29-1,TRBJ1-3,CSVEVLSGNTIYF,0,1,1,1
TRBV29-1,TRBJ1-2,CSVGTGGDYGYTF,0,1,1,1
TRBV29-1,TRBJ2-5,CSVTSGDQETQYF,0,1,1,1
TRBV29-1,TRBJ1-1,CSVATGAGTEAFS,0,1,1,1
TRBV29-1,TRBJ1-1,CSVGDLGITEAFF,0,1,1,1
TRBV29-1,TRBJ2-5,CSIERGGKETQYF,0,1,1,1
TRBV5-1,TRBJ2-7,YASRQDVIYEQYF,0,1,1,1
TRBV30,TRBJ1-1,CACRQGNTEAFF,0,1,1,1
TRBV30,TRBJ2-2,CAWSDNTGELFF,0,1,1,1
TRBV30,TRBJ2-7,CAWSERPGEQYF,0,1,1,1
TRBV30,TRBJ2-7,CAWRGQGNEQYF,0,1,1,1
TRBV10-3,TRBJ2-3,CAIAGGKATQYF,0,1,1,1
TRBV19,TRBJ2-1,CASSTPGQGEFF,0,1,1,1
TRBV19,TRBJ1-2,CASRGPSYGYTF,0,1,1,1
TRBV18,TRBJ2-7,CASSPAPYEQYF,0,1,1,1
TRBV19,TRBJ1-1,CASGGHLTEAFF,0,1,1,1
TRBV6-2/3/5/6,TRBJ1-5,CASTGGNQPQHF,0,1,1,1
TRBV28,TRBJ1-1,CASSFYRTEAFF,0,1,1,1
TRBV6-2/3/5/6,TRBJ1-5,CASSLDSQPQHF,0,1,1,1
TRBV12-3/4,TRBJ2-5,CASSLDKETQYF,0,1,1,1
TRBV12-3/4,TRBJ2-5,CASSLLGETQYF,0,1,1,1
TRBV12-3/4,TRBJ2-1,CASSLWYGERFF,0,1,1,1
TRBV28,TRBJ2-1,CASSLQLNEQFF,0,1,1,1
TRBV28,TRBJ1-1,CASSLVNTEAFF,0,1,1,1
TRBV12-3/4,TRBJ2-5,CASSLGQETQYF,0,1,1,1
TRBV6-2/3/5/6,TRBJ2-5,CASSSDGGTQYF,0,1,1,1
TRBV6-2/3/5/6,TRBJ2-1,CASSYPGRKQFF,0,1,1,1
TRBV6-2/3/5/6,TRBJ2-7,CASSYMRGEQYF,0,1,1,1
TRBV7-9,TRBJ1-1,CASSPRGSEAFF,0,1,1,1
TRBV2,TRBJ2-5,CASSDVLETQYF,0,1,1,1
TRBV12-3/4,TRBJ2-7,CASSRGLPEQYF,0,1,1,1
TRBV11-2,TRBJ2-7,CASSFSIYEQYF,0,1,1,1
TRBV7-9,TRBJ2-7,CASSLGGYEQYF,0,1,1,1
TRBV7-9,TRBJ1-5,CASSLEAQPQHF,0,1,1,1
TRBV28,TRBJ1-2,CASSSSAYGYTF,0,1,1,1
TRBV11-2,TRBJ2-4,CASSSRGQGVEF,0,1,1,1
TRBV6-2/3/5/6,TRBJ2-7,CASSYGTYEQYF,0,1,1,1
TRBV7-9,TRBJ2-7,CASSPSSYEQYF,0,1,1,1
TRBV12-3/4,TRBJ1-5,CASSPPFQPQHF,0,1,1,1
TRBV7-9,TRBJ1-1,CASSQWNTEAFF,0,1,1,1
TRBV14,TRBJ1-2,CASSQQNGGYTF,0,1,1,1
TRBV28,TRBJ2-7,CASRRSSYEQYF,0,1,1,1
TRBV12-3/4,TRBJ1-6,CASRVNNSPLHF,0,1,1,1
TRBV12-3/4,TRBJ2-7,CASRRGSYEQHF,0,1,1,1
TRBV3-1,TRBJ1-1,CASRGQTGEAFF,0,1,1,1
TRBV28,TRBJ1-5,CASRSSNQPQHF,0,1,1,1
TRBV11-3,TRBJ2-3,CASGQRTDTQYS,0,1,1,1
TRBV5-1,TRBJ2-5,CASSGDQETQYF,0,1,1,1
TRBV10-1,TRBJ2-7,CASSAGTYEQYF,0,1,1,1
TRBV5-1,TRBJ1-2,CASSGRDYGYTF,0,1,1,1
TRBV10-2,TRBJ2-3,CASSEWADTQYF,0,1,1,1
TRBV5-1,TRBJ2-7,CASSFTGTEQYF,0,1,1,1
TRBV5-1,TRBJ2-1,CASSLGLNEQFF,0,1,1,1
TRBV5-1,TRBJ1-1,CASSLDRAEAFF,0,1,1,1
TRBV5-1,TRBJ2-7,CASRSDAYEQYF,0,1,1,1
TRBV10-2,TRBJ2-3,CASKASTDTQYF,0,1,1,1
TRBV20-1,TRBJ2-3,CSAALGTDTQYF,0,1,1,1
TRBV20-1,TRBJ2-1,CSASKGGGEQFF,0,1,1,1
TRBV20-1,TRBJ2-3,CSARANTDTQYF,0,1,1,1
TRBV20-1,TRBJ2-7,CSARDSTYEQYF,0,1,1,1
TRBV29-1,TRBJ1-2,CSSRRGEEGYTF,0,1,1,1
TRBV29-1,TRBJ2-7,CSVRISSYEQYF,0,1,1,1
TRBV29-1,TRBJ2-7,CSVVGASYEQYF,0,1,1,1
TRBV29-1,TRBJ2-7,CSVGGSGDEQYF,0,1,1,1
TRBV29-1,TRBJ2-3,CSVEEPRDTQYF,0,1,1,1
TRBV29-1,TRBJ2-7,CSVRAAGREQYF,0,1,1,1
TRBV29-1,TRBJ2-7,CSVKEGVSEQYF,0,1,1,1
TRBV29-1,TRBJ1-1,CSAGHLNTEAFF,0,1,1,1
TRBV29-1,TRBJ2-2,CSAGSSTGELFF,0,1,1,1
TRBV29-1,TRBJ1-1,CSGGQMNTEAFF,0,1,1,1
TRBV19,TRBJ2-1,CATAGLNGQFF,0,1,1,1
TRBV24-1,TRBJ1-1,CATSVGGEAFF,0,1,1,1
TRBV3-1,TRBJ1-3,CASSIGNTIYF,0,1,1,1
TRBV28,TRBJ2-1,CASQALARQFF,0,1,1,1
TRBV18,TRBJ2-7,CASSQRDEQYF,0,1,1,1
TRBV18,TRBJ1-1,CASSPGPEASF,0,1,1,1
TRBV7-9,TRBJ1-4,CASCFREKLFF,0,1,1,1
TRBV28,TRBJ1-2,CASMRDGGYTF,0,1,1,1
TRBV7-9,TRBJ1-2,CASTPDYGYTF,0,1,1,1
TRBV28,TRBJ1-2,CASSGQASYTF,0,1,1,1
TRBV10-2,TRBJ1-2,CASSSYYGYTF,0,1,1,1
TRBV20-1,TRBJ1-1,CSAGRGTEAFF,0,1,1,1
TRBV20-1,TRBJ2-7,CSARETYEQYF,0,1,1,1
TRBV29-1,TRBJ2-1,CSVGGGREQFF,0,1,1,1
TRBV29-1,TRBJ2-7,CSVEVGTSRYF,0,1,1,1
TRBV29-1,TRBJ2-7,CSVEGQAKQYF,0,1,1,1
TRBV29-1,TRBJ2-1,CSDSSYNEQFF,0,1,1,1
TRBV20-1,TRBJ1-2,CRPTDSYGYTF,0,1,1,1
TRBV12-5,TRBJ1-2,CASGLGGYTF,0,1,1,1
TRBV12-3/4,TRBJ2-1,CASSLTRTIF,0,1,1,1
TRBV7-9,TRBJ1-1,CASSGGGAFF,0,1,1,1
TRBV29-1,TRBJ2-1,CSVQRVEQFF,0,1,1,1
TRBV5-1,TRBJ2-7,CASSLAQRTGFEGLVPFPLEQYF,0,1,1,1
TRBV28,TRBJ2-3,CASTTPLIGLALRDGDTQYF,0,1,1,1
TRBV6-2/3/5/6,TRBJ2-1,CASSYHQGSGGTILGETQFF,0,1,1,1
TRBV7-2,TRBJ2-7,CASSLIRWPNNGTSSYEQYF,0,1,1,1
TRBV14,TRBJ2-7,CASGQDPSTGGFLAYEQYF,0,1,1,1
TRBV28,TRBJ2-6,CASSLRSGTGSSGANVLTF,0,1,1,1
TRBV6-2/3/5/6,TRBJ2-7,CASSYSEPADQETGYEQYF,0,1,1,1
TRBV7-9,TRBJ2-3,CASSLMDPRLEVRTDTQYF,0,1,1,1
TRBV9,TRBJ2-2,CASSVSSASGRSNTGELFF,0,1,1,1
TRBV5-1,TRBJ2-1,CASSLFPSPGQGGYNEQFF,0,1,1,1
TRBV5-1,TRBJ2-1,CASSPGGAVRGGPYNEQFF,0,1,1,1
TRBV4-1,TRBJ2-1,CASSQLTRAATGRYNEQFF,0,1,1,1
TRBV4-1,TRBJ2-3,CASSQDSSGWTVGTDTQYF,0,1,1,1
TRBV4-1,TRBJ1-5,CASSQDLGFRDIRNQPQHF,0,1,1,1
TRBV12-5,TRBJ2-7,CASGLGGAESASNYEQYF,0,1,1,1
TRBV19,TRBJ2-3,CASSWDRPFPASTDTQYF,0,1,1,1
TRBV19,TRBJ2-6,CASSILWRPPSGANVLTF,0,1,1,1
TRBV19,TRBJ2-3,CASSIGPTSGKLTDTQYF,0,1,1,1
TRBV11-2,TRBJ2-6,CASIRVVQRGSGANVLTF,0,1,1,1
TRBV28,TRBJ2-7,CASSLSLAGGGYSYEQYF,0,1,1,1
TRBV28,TRBJ2-1,CASSLPLGSGGDPHKQFF,0,1,1,1
TRBV28,TRBJ2-1,CASSLGNIWGSSYNEQFF,0,1,1,1
TRBV6-2/3/5/6,TRBJ1-6,CASSYSVGTGELNSPLHF,0,1,1,1
TRBV28,TRBJ2-3,CASSILRGGAPWSVTQYF,0,1,1,1
TRBV11-2,TRBJ2-5,CASSLFPHVEGELETQYF,0,1,1,1
TRBV11-2,TRBJ2-1,CASSLPPTRLARDNEQFF,0,1,1,1
TRBV5-4,TRBJ2-2,CASSSTRPGQGRTGELFF,0,1,1,1
TRBV11-1,TRBJ2-1,CASSLTSGGAASYNEQFF,0,1,1,1
TRBV7-8,TRBJ1-6,CASSPFGATSSYNSPLHF,0,1,1,1
TRBV3-1,TRBJ1-2,CASSPSTGTGTTNYGYTF,0,1,1,1
TRBV2,TRBJ2-3,CASSPRLAGWVGTDTQYF,0,1,1,1
TRBV6-2/3/5/6,TRBJ1-1,CASSHFKSRGRMDTEAFF,0,1,1,1
TRBV3-1,TRBJ2-3,CASSQDPGRNLWDHTQYF,0,1,1,1
TRBV3-1,TRBJ2-1,CASRPSSGDFSFPNEQFF,0,1,1,1
TRBV9,TRBJ2-6,CASRNPGHSVSGANVLTF,0,1,1,1
TRBV3-1,TRBJ2-1,CGSSHLLSTSGGVGEQFF,0,1,1,1
TRBV5-1,TRBJ2-5,CASSLGLAGGYGQETQYF,0,1,1,1
TRBV4-1,TRBJ1-2,CASSPRPGQGVFGRGYTF,0,1,1,1
TRBV5-1,TRBJ2-5,CASRQRLAGAFSQETQYF,0,1,1,1
TRBV20-1,TRBJ2-7,CSATWDRGNVFMSYEQYF,0,1,1,1
TRBV20-1,TRBJ2-1,CSARDMRGQGAMSNEQFF,0,1,1,1
TRBV29-1,TRBJ2-1,CSVEDPQGAKSSYNEQFL,0,1,1,1
TRBV4-1,TRBJ2-5,RASSQDWYGGGPRETQYF,0,1,1,1
TRBV12-5,TRBJ2-1,CASGLVLGGVSYNEQFF,0,1,1,1
TRBV10-3,TRBJ2-1,CAISEPDGTEVYNEQFF,0,1,1,1
TRBV24-1,TRBJ2-3,CATSDLLLVTSGQRQYF,0,1,1,1
TRBV19,TRBJ1-1,CASSIPQQYSGNTEAYF,0,1,1,1
TRBV19,TRBJ2-5,CASSKGRGSGGGETQYF,0,1,1,1
TRBV3-1,TRBJ2-6,CASCQFSGILGANVLTF,0,1,1,1
TRBV27,TRBJ2-1,CASAGTSGGITYNEQSF,0,1,1,1
TRBV7-8,TRBJ2-1,CASGIQRGLAGSNEQFF,0,1,1,1
TRBV6-2/3/5/6,TRBJ2-3,CASSFQRGGVSTDAQYF,0,1,1,1
TRBV27,TRBJ2-6,CASSLSGAYSSANVLTF,0,1,1,1
TRBV6-2/3/5/6,TRBJ2-2,CASSLFFTGDITGELFF,0,1,1,1
TRBV28,TRBJ2-1,CASSLPTSGGLFNEQFF,0,1,1,1
TRBV12-3/4,TRBJ1-2,CASSLVWHMGTNYGYTF,0,1,1,1
TRBV27,TRBJ1-6,CASSLIPSSSYNSPLHF,0,1,1,1
TRBV12-3/4,TRBJ2-2,CASSSPLTSANTGELFF,0,1,1,1
TRBV27,TRBJ2-3,CASSSRKSGAGTDTQYF,0,1,1,1
TRBV6-2/3/5/6,TRBJ2-4,CASSYASGALAKNIQYF,0,1,1,1
TRBV6-2/3/5/6,TRBJ1-2,CASSYSEWGRVGYGYTF,0,1,1,1
TRBV6-2/3/5/6,TRBJ1-3,CASSYRPTGGDGNTIYF,0,1,1,1
TRBV2,TRBJ2-5,CASSPRWTSGEQETQYF,0,1,1,1
TRBV7-9,TRBJ2-2,CASSPQEASANTGELFF,0,1,1,1
TRBV28,TRBJ1-5,CASSPVRTGGFNQPQHF,0,1,1,1
TRBV7-9,TRBJ2-3,CASSPPPGEGYTDTQYF,0,1,1,1
TRBV7-9,TRBJ1-3,CASSFNPGQLSGNTIYF,0,1,1,1
TRBV5-5,TRBJ2-7,CASSFLNPGQGLVEQYF,0,1,1,1
TRBV7-8,TRBJ1-4,CASSLRGQGATNEELFF,0,1,1,1
TRBV7-9,TRBJ2-7,CASSLVGGQGVSREQYF,0,1,1,1
TRBV7-9,TRBJ2-1,CASSLALTLNSYNEQFF,0,1,1,1
TRBV7-2,TRBJ1-6,CASSLAGGGAGFLSLHF,0,1,1,1
TRBV7-6,TRBJ1-5,CASSLGSGTGNNQPQHF,0,1,1,1
TRBV7-9,TRBJ2-3,CASSLGGTSGATDTQYF,0,1,1,1
TRBV7-9,TRBJ2-7,CASSLGTEGVYSYEQYF,0,1,1,1
TRBV11-2,TRBJ2-6,CASSLEYGGSGANVLTF,0,1,1,1
TRBV11-2,TRBJ2-5,CASSLTRGAAEQETQYF,0,1,1,1
TRBV7-3,TRBJ2-1,CASSLSRESGAAIEQFF,0,1,1,1
TRBV7-9,TRBJ1-2,CASSLKAQAGNNYGYTF,0,1,1,1
TRBV7-9,TRBJ2-5,CASSSSGASGPTETQYF,0,1,1,1
TRBV28,TRBJ1-5,CASSYTGTGATNQPQHF,0,1,1,1
TRBV7-3,TRBJ2-3,CASSLSSGGAATDTQYF,0,1,1,1
TRBV7-3,TRBJ2-5,CASSLMGGVRVGETQYF,0,1,1,1
TRBV5-6,TRBJ2-5,CASSRTINREREETQYF,0,1,1,1
TRBV6-2/3/5/6,TRBJ2-7,CASSRTSGGARGYEQYF,0,1,1,1
TRBV14,TRBJ2-2,CASSQVWPPGPTGELFF,0,1,1,1
TRBV3-1,TRBJ2-7,CASSQAFRGGDPYEQYF,0,1,1,1
TRBV4-2,TRBJ2-5,CASSQGNGGASQETQYF,0,1,1,1
TRBV11-2,TRBJ2-3,CASSERLASGGPDTQYF,0,1,1,1
TRBV7-2,TRBJ1-3,CASRKREGFHSGNTIYF,0,1,1,1
TRBV10-1,TRBJ2-3,CASSESQARLFGDTQYF,0,1,1,1
TRBV5-1,TRBJ2-2,CASSLASLGPNTGELFF,0,1,1,1
TRBV5-1,TRBJ2-5,CASSLGAQITWQETQYF,0,1,1,1
TRBV5-1,TRBJ2-7,CASSLGDSEVSSYEQYF,0,1,1,1
TRBV5-1,TRBJ1-2,CASSLTGTGVLNYGYTF,0,1,1,1
TRBV5-1,TRBJ2-1,CASSLRRSEGAYYEQFF,0,1,1,1
TRBV4-1,TRBJ1-1,CASSHLTPGQGLIEAFF,0,1,1,1
TRBV4-1,TRBJ1-5,CASSQDRGRGLSQPQHF,0,1,1,1
TRBV4-1,TRBJ2-7,CASSQMEPGLAGYEQYF,0,1,1,1
TRBV5-1,TRBJ2-7,CASRMSGGPPTTYEQYF,0,1,1,1
TRBV20-1,TRBJ1-5,CSAAPGHHKQSNQPQHF,0,1,1,1
TRBV20-1,TRBJ2-7,CSARGSQVASSSYEQYF,0,1,1,1
TRBV20-1,TRBJ2-3,CSARGPTSGGAEGTQYF,0,1,1,1
TRBV20-1,TRBJ2-3,CSARDRVGGGGTDTQYF,0,1,1,1
TRBV20-1,TRBJ2-7,CSARDRGPGLAGREQYF,0,1,1,1
TRBV20-1,TRBJ2-5,CSARDLRLAGGQETQYF,0,1,1,1
TRBV5-1,TRBJ2-6,RATRPGQFGSGANVLTF,0,1,1,1
TRBV2,TRBJ1-1,CADRGEPGRSSTEAFF,0,1,1,1
TRBV30,TRBJ1-5,CAWSGETLRGNQPQRF,0,1,1,1
TRBV30,TRBJ1-3,CAWSIRRGRSGNTIYF,0,1,1,1
TRBV10-3,TRBJ1-3,CAISEPGQSSGNTIYF,0,1,1,1
TRBV19,TRBJ2-6,CASSPHGQGGANVLTF,0,1,1,1
TRBV19,TRBJ2-2,CASSPWTSGGWGELFF,0,1,1,1
TRBV19,TRBJ2-3,CASSVLPGQGSDTQYF,0,1,1,1
TRBV19,TRBJ2-1,CASSIRVRAPRNEQFF,0,1,1,1
TRBV19,TRBJ1-5,CASSISSPGGRQPQHF,0,1,1,1
TRBV18,TRBJ1-1,CASSSLRDRTNTEAFF,0,1,1,1
TRBV18,TRBJ2-3,CASSPGQGSFADTQYS,0,1,1,1
TRBV18,TRBJ1-1,CASSPPDRTRGTVAFF,0,1,1,1
TRBV18,TRBJ2-3,CASHEKGQASTDTQYF,0,1,1,1
TRBV28,TRBJ2-4,CASGQVVILAKNIQYF,0,1,1,1
TRBV28,TRBJ2-5,CASSFSSGGRGETQYF,0,1,1,1
TRBV12-3/4,TRBJ2-1,CASSFPTGRLYNEQFF,0,1,1,1
TRBV7-3,TRBJ1-5,CASSFILTSRNQPQHF,0,1,1,1
TRBV6-2/3/5/6,TRBJ2-3,CASSFASGGPTDTQYF,0,1,1,1
TRBV28,TRBJ1-3,CASSLGGQGSGNTIYF,0,1,1,1
TRBV28,TRBJ2-6,CASSLPTGVGANVLTF,0,1,1,1
TRBV27,TRBJ1-4,CASSLDTEGTNEKLFF,0,1,1,1
TRBV28,TRBJ1-4,CASSSLGQGAREKLFF,0,1,1,1
TRBV6-2/3/5/6,TRBJ1-5,CASSYSRDSSNQPQHF,0,1,1,1
TRBV6-2/3/5/6,TRBJ1-2,CASSYSAGTGGYGYTF,0,1,1,1
TRBV6-2/3/5/6,TRBJ2-6,CASSYVAGVGANVLTS,0,1,1,1
TRBV28,TRBJ1-5,CASSYNLRGRYQPQHF,0,1,1,1
TRBV6-2/3/5/6,TRBJ2-7,CASSLRQNRGTYEQYF,0,1,1,1
TRBV28,TRBJ2-7,CASSLGQLALSYEQYF,0,1,1,1
TRBV28,TRBJ1-6,CASSPPGKARGSPLHF,0,1,1,1
TRBV12-3/4,TRBJ2-7,CASSPRVVLVSYEQYF,0,1,1,1
TRBV7-9,TRBJ1-3,CASSRARDYSGNTIYF,0,1,1,1
TRBV6-1,TRBJ2-3,CASSQDGGAETDTQYF,0,1,1,1
TRBV6-1,TRBJ2-7,CASSEDVDELGHEQYF,0,1,1,1
TRBV6-1,TRBJ2-1,CASSEWRGPGYNEQFF,0,1,1,1
TRBV6-1,TRBJ2-7,CASSEALKGRGTGIYF,0,1,1,1
TRBV6-1,TRBJ2-5,CASSEGGTALGETQYF,0,1,1,1
TRBV2,TRBJ2-7,CASSEGALAVPYEQYF,0,1,1,1
TRBV6-1,TRBJ1-5,CASSEDSPYSNQPQHF,0,1,1,1
TRBV2,TRBJ2-3,CASSERTQHPSGTQYF,0,1,1,1
TRBV28,TRBJ2-5,CASSTTRTGLQETQYF,0,1,1,1
TRBV5-5,TRBJ1-6,CASSFRDRSYNSPLHF,0,1,1,1
TRBV11-2,TRBJ2-1,CASSFQGASPYNEQFF,0,1,1,1
TRBV5-6,TRBJ2-1,CASSLAGGRVGNEQFF,0,1,1,1
TRBV7-3,TRBJ2-5,CASSLSGGADQETQYF,0,1,1,1
TRBV5-4,TRBJ2-5,CASSLKSGAHQETQYF,0,1,1,1
TRBV7-2,TRBJ2-5,CASSLHLAGPQETQYF,0,1,1,1
TRBV7-3,TRBJ2-1,CASSLVVGSPYNEQFF,0,1,1,1
TRBV7-2,TRBJ2-7,CASSLAAGGRLYEQYF,0,1,1,1
TRBV7-2,TRBJ2-5,CASSLAISGGQETQYF,0,1,1,1
TRBV7-6,TRBJ2-6,CASSLGFSSGANVLTF,0,1,1,1
TRBV11-2,TRBJ2-5,CASSLGLAGGGETQYF,0,1,1,1
TRBV11-2,TRBJ2-4,CASSLEVSGDKNIQYF,0,1,1,1
TRBV7-6,TRBJ2-5,CASSLNVRGAGETQYF,0,1,1,1
TRBV7-9,TRBJ2-3,CASSSTLGRGTDTQYF,0,1,1,1
TRBV7-2,TRBJ1-4,CASSWTRTGPGEKLFF,0,1,1,1
TRBV7-9,TRBJ2-7,CASSPSEGLPSYEQYF,0,1,1,1
TRBV27,TRBJ1-5,CASSPRTGHSNQPQHF,0,1,1,1
TRBV7-9,TRBJ2-1,CASSPPAGGTYNEQFF,0,1,1,1
TRBV5-8,TRBJ2-6,CASSPAYISGANVLTF,0,1,1,1
TRBV5-4,TRBJ2-1,CASSPTAQTGNNEQFF,0,1,1,1
TRBV4-2,TRBJ2-3,CASSPLDRGSTDTQYF,0,1,1,1
TRBV12-3/4,TRBJ2-5,CASSPGLADYQETQYF,0,1,1,1
TRBV6-2/3/5/6,TRBJ1-6,CASSPRGRGADSPPHF,0,1,1,1
TRBV13,TRBJ2-3,CASSRGTSGGLDTQYF,0,1,1,1
TRBV5-4,TRBJ2-3,CASSRELAGGRDTQYF,0,1,1,1
TRBV28,TRBJ2-3,CASSQTSGGTTDTQYL,0,1,1,1
TRBV3-1,TRBJ1-2,CASSQSDSRSVYGYTF,0,1,1,1
TRBV14,TRBJ2-4,CASSQLSTGGYDIQYF,0,1,1,1
TRBV3-1,TRBJ2-2,CASSQVPSSNTGELFF,0,1,1,1
TRBV3-1,TRBJ1-1,CASSQGPGQGNTEAFF,0,1,1,1
TRBV4-2,TRBJ2-2,CASSQDSAGDAGELFF,0,1,1,1
TRBV4-2,TRBJ1-1,CASSQDRGGGSAEAFF,0,1,1,1
TRBV14,TRBJ2-7,CASSQDGPYWGYEQYF,0,1,1,1
TRBV4-2,TRBJ1-4,CASSQEARPTNEKLFF,0,1,1,1
TRBV9,TRBJ2-1,CASSVGLAGKRGEQFF,0,1,1,1
TRBV9,TRBJ2-5,CASSVAGQGGQETQYF,0,1,1,1
TRBV6-2/3/5/6,TRBJ2-7,CASSALGLAADYEQYF,0,1,1,1
TRBV9,TRBJ2-7,CASSAGTSGELYEQYF,0,1,1,1
TRBV2,TRBJ2-6,CASREEQVSGASVLTF,0,1,1,1
TRBV2,TRBJ1-5,CASRAHRGRSNQPQHF,0,1,1,1
TRBV7-2,TRBJ1-3,CASNPAGGSGGNTIYF,0,1,1,1
TRBV28,TRBJ2-5,CASKRLAGGPGETQYF,0,1,1,1
TRBV7-9,TRBJ1-5,CTSSPGDRGRNQPQHF,0,1,1,1
TRBV5-1,TRBJ1-1,CASSFGTGGLNTEAFF,0,1,1,1
TRBV5-1,TRBJ2-5,CASSFLGDRRGETQYF,0,1,1,1
TRBV5-1,TRBJ1-1,CASSFGHGQGYTEAFF,0,1,1,1
TRBV5-1,TRBJ1-3,CASSLSPRTTGNTIYF,0,1,1,1
TRBV5-1,TRBJ1-2,CASSLGLYRAMDGYTF,0,1,1,1
TRBV5-1,TRBJ2-5,CASSLGAGAFQETQYF,0,1,1,1
TRBV5-1,TRBJ2-3,CASSLGGTGPTDTQYF,0,1,1,1
TRBV5-1,TRBJ2-5,CASSLGTAHDGETQYF,0,1,1,1
TRBV5-1,TRBJ2-1,CASSLELGGSYNEQFF,0,1,1,1
TRBV5-1,TRBJ2-3,CASSLNQRGPTDTQYF,0,1,1,1
TRBV5-1,TRBJ1-1,CASSSAIDGVNTEAFF,0,1,1,1
TRBV5-1,TRBJ2-3,CASSLAGGRGTDTQYL,0,1,1,1
TRBV4-1,TRBJ1-4,CASSQVLGQRNEKLFF,0,1,1,1
TRBV4-1,TRBJ2-1,CASSQVETATYNEQFF,0,1,1,1
TRBV4-1,TRBJ2-3,CASSQGNSGNTDTQYF,0,1,1,1
TRBV4-1,TRBJ2-7,CASSQDWASGGIEQYF,0,1,1,1
TRBV4-1,TRBJ1-4,CASSQDLYSSSEKLFF,0,1,1,1
TRBV4-1,TRBJ1-6,CASSQDWFAVNSPLHF,0,1,1,1
TRBV4-1,TRBJ1-1,CASSQEPDGGLTEAFF,0,1,1,1
TRBV5-1,TRBJ2-1,CASSTSLGGGHNEQFF,0,1,1,1
TRBV5-1,TRBJ2-3,CASSTRLAGNADTQYF,0,1,1,1
TRBV7-6,TRBJ2-2,CASRPPGGGNTGELFF,0,1,1,1
TRBV5-1,TRBJ2-2,CASRRGSTTNTGELFF,0,1,1,1
TRBV20-1,TRBJ2-2,CSALAPGQSPGGELFF,0,1,1,1
TRBV20-1,TRBJ2-7,CSARSPGQGKSYEQYF,0,1,1,1
TRBV20-1,TRBJ2-4,CSARVPGGASKDIQYF,0,1,1,1
TRBV20-1,TRBJ2-1,CSARDRLAGFYNEQFF,0,1,1,1
TRBV20-1,TRBJ1-2,CSARENRGGLEHGYTF,0,1,1,1
TRBV20-1,TRBJ2-1,CSARTSGESSYNEQFF,0,1,1,1
TRBV20-1,TRBJ1-3,CSASGTGDTSGNTIYF,0,1,1,1
TRBV29-1,TRBJ2-3,CSSLGGLAGGKDTQYF,0,1,1,1
TRBV29-1,TRBJ2-1,CSVPKRPLGPYNEQFF,0,1,1,1
TRBV29-1,TRBJ1-2,CSVDYLDRDLNYGYTF,0,1,1,1
TRBV18,TRBJ2-6,SASSFRGKAGANVLTF,0,1,1,1
TRBV10-3,TRBJ2-2,CASRAGQLNTGELFF,0,1,1,1
TRBV30,TRBJ2-2,CAWSVGGANTGELFF,0,1,1,1
TRBV30,TRBJ2-6,CAWSVDLSGANVLTF,0,1,1,1
TRBV30,TRBJ1-4,CAWSVNPTGWSEKLF,0,1,1,1
TRBV30,TRBJ2-2,CAWRLAGAATGELFF,0,1,1,1
TRBV10-3,TRBJ2-5,CAVSEAQGNGETQYF,0,1,1,1
TRBV11-2,TRBJ2-7,CAGSLGSGAPYEQYF,0,1,1,1
TRBV10-3,TRBJ2-1,CAISGQGNSYNEQFF,0,1,1,1
TRBV10-3,TRBJ1-6,CAISESGGSNSPLHF,0,1,1,1
TRBV15,TRBJ2-5,CATSQNRGRRETQYF,0,1,1,1
TRBV19,TRBJ1-5,CASSIWEGPYQPQHF,0,1,1,1
TRBV19,TRBJ1-5,CASSIYQGGNQPQRF,0,1,1,1
TRBV19,TRBJ2-5,CASSIPAGSQETQYF,0,1,1,1
TRBV19,TRBJ2-1,CASSISSGGYNEQFF,0,1,1,1
TRBV19,TRBJ1-1,CASSIVGQAYTEAFF,0,1,1,1
TRBV19,TRBJ2-7,CASSIGVGTSGGQYF,0,1,1,1
TRBV19,TRBJ1-1,CASSIDGQLNTEAFF,0,1,1,1
TRBV19,TRBJ1-6,CASSTQQGSISPLHF,0,1,1,1
TRBV19,TRBJ1-2,CASSLAANRIYGYAF,0,1,1,1
TRBV18,TRBJ1-5,CASSSTGRSNQPQHF,0,1,1,1
TRBV18,TRBJ2-1,CASSPAENRPHEQFF,0,1,1,1
TRBV18,TRBJ1-5,CASSPVRASNQPQHF,0,1,1,1
TRBV18,TRBJ2-7,CASSPGGQGDYEQYF,0,1,1,1
TRBV18,TRBJ2-3,CASSRTGQSPDTQYF,0,1,1,1
TRBV27,TRBJ2-1,CASYRTSGGYNEQFF,0,1,1,1
TRBV18,TRBJ2-3,CASQARTASPDTQYF,0,1,1,1
TRBV12-3/4,TRBJ1-5,CASGPGHPSNQPQHF,0,1,1,1
TRBV2,TRBJ2-7,CASGRRNSGAYEQYF,0,1,1,1
TRBV7-9,TRBJ2-5,CASILQRGQQEIQYF,0,1,1,1
TRBV2,TRBJ2-3,CASIRAGRLTDTQYF,0,1,1,1
TRBV27,TRBJ2-7,CASITDRQYSYEQYF,0,1,1,1
TRBV5-6,TRBJ1-5,CASTLTGFPIEGQHF,0,1,1,1
TRBV2,TRBJ2-3,CASTRTSPSTDTQYF,0,1,1,1
TRBV12-3/4,TRBJ1-3,CASTAGQPPGNTIYF,0,1,1,1
TRBV6-2/3/5/6,TRBJ1-1,CASTEGDISYTEAFF,0,1,1,1
TRBV27,TRBJ2-7,CASSFRQGSSYEQYF,0,1,1,1
TRBV6-2/3/5/6,TRBJ2-5,CASSFVAGESETQYF,0,1,1,1
TRBV12-3/4,TRBJ1-5,CASSLFTGGNQPQHF,0,1,1,1
TRBV6-2/3/5/6,TRBJ2-1,CASSLPGASYYEQFF,0,1,1,1
TRBV28,TRBJ1-5,CASSLVRNSNQPQHF,0,1,1,1
TRBV12-3/4,TRBJ2-7,CASSLVGTGVYEQYF,0,1,1,1
TRBV12-3/4,TRBJ2-7,CASSLGQAGLAEQYF,0,1,1,1
TRBV12-3/4,TRBJ2-7,CASSLGGGGRYEQYF,0,1,1,1
TRBV6-2/3/5/6,TRBJ1-2,CASSYSPGQFYGYTF,0,1,1,1
TRBV6-2/3/5/6,TRBJ2-1,CASSYSGGGPNEQFF,0,1,1,1
TRBV6-2/3/5/6,TRBJ2-7,CASSYSSGLGNEQYF,0,1,1,1
TRBV6-2/3/5/6,TRBJ1-1,CASSYATGGWTEAFF,0,1,1,1
TRBV6-2/3/5/6,TRBJ1-4,CASSYGYRGREKLFF,0,1,1,1
TRBV12-3/4,TRBJ1-3,CASSLPLGTGNTIYF,0,1,1,1
TRBV7-2,TRBJ2-7,CASSLGLAISYEQYF,0,1,1,1
TRBV6-2/3/5/6,TRBJ1-5,CASSPGGGLNQPQHF,0,1,1,1
TRBV12-3/4,TRBJ1-5,CASSPGTGGNQPQHF,0,1,1,1
TRBV12-3/4,TRBJ1-5,CASSPQGALSQPQHF,0,1,1,1
TRBV2,TRBJ2-7,CASSPTSGGAHEQYF,0,1,1,1
TRBV28,TRBJ1-6,CASSRVVGQNSPLHF,0,1,1,1
TRBV2,TRBJ1-6,CASSVDSSYNSPLHF,0,1,1,1
TRBV6-1,TRBJ2-7,CASSAGTGVSYEQYF,0,1,1,1
TRBV28,TRBJ2-5,CASSAGQGRGETQYF,0,1,1,1
TRBV6-1,TRBJ2-7,CASSGAGTRAEEQYF,0,1,1,1
TRBV6-1,TRBJ2-7,CASSGLAGARGEQYF,0,1,1,1
TRBV25-1,TRBJ1-1,CASSDRKGVEDEAFF,0,1,1,1
TRBV6-1,TRBJ2-3,CASSDSGGAFDTQYF,0,1,1,1
TRBV6-4,TRBJ2-3,CASSDPQGRTDTQYF,0,1,1,1
TRBV6-1,TRBJ1-4,CASSEYGLSNEKLFF,0,1,1,1
TRBV6-1,TRBJ2-3,CASSESSDRADTQYF,0,1,1,1
TRBV2,TRBJ1-4,CASSEPWLGNEKLFF,0,1,1,1
TRBV6-1,TRBJ2-7,CASSEPVAFPYEQYF,0,1,1,1
TRBV2,TRBJ2-3,CASSEQGGGPDTQYF,0,1,1,1
TRBV6-1,TRBJ1-1,CASSEARQATTEAFF,0,1,1,1
TRBV2,TRBJ2-5,CASSEGLTLVETQYF,0,1,1,1
TRBV28,TRBJ1-6,CASSTPQGVNSPLHF,0,1,1,1
TRBV6-1,TRBJ1-6,CASSKGTAYNSPLHF,0,1,1,1
TRBV7-2,TRBJ2-3,CASSFGLAETDTQYF,0,1,1,1
TRBV7-3,TRBJ2-2,CASSFSDSFTGELFF,0,1,1,1
TRBV5-5,TRBJ2-7,CASSLVWRASYEQYF,0,1,1,1
TRBV7-9,TRBJ2-5,CASSLDGGWTETQYF,0,1,1,1
TRBV7-2,TRBJ2-1,CASSLQGDSYNEQFF,0,1,1,1
TRBV7-9,TRBJ1-4,CASSLVPGASEKLFF,0,1,1,1
TRBV7-9,TRBJ1-4,CASSLVPGRRRKLFF,0,1,1,1
TRBV7-2,TRBJ2-7,CASSLVRGPSYEQYF,0,1,1,1
TRBV7-8,TRBJ1-1,CASSLAPRGLTEAFF,0,1,1,1
TRBV7-9,TRBJ1-5,CASSLAGEDNQPQHF,0,1,1,1
TRBV7-9,TRBJ2-3,CASSLGPTVRDTQYL,0,1,1,1
TRBV11-3,TRBJ2-7,CASSLGGPFSYEQYF,0,1,1,1
TRBV11-2,TRBJ1-1,CASSLGDRVGAEAFF,0,1,1,1
TRBV7-2,TRBJ1-6,CASSLGTGRLAPLHF,0,1,1,1
TRBV7-2,TRBJ2-3,CASSLDQGSTDTQYF,0,1,1,1
TRBV7-9,TRBJ1-3,CASSLDAGPGNTIYF,0,1,1,1
TRBV7-2,TRBJ2-7,CASSLDPWTYHEQYF,0,1,1,1
TRBV7-3,TRBJ2-1,CASSLTRDLDNEQFF,0,1,1,1
TRBV7-9,TRBJ2-7,CASSLTGQLTCEQYF,0,1,1,1
TRBV7-9,TRBJ2-2,CASSLRAGAPGELFF,0,1,1,1
TRBV11-2,TRBJ2-3,CASSSSGGAGNTQYF,0,1,1,1
TRBV7-9,TRBJ2-1,CASSSRSSSYNEQFF,0,1,1,1
TRBV5-4,TRBJ2-7,CASSSYLGGGYEQYF,0,1,1,1
TRBV7-9,TRBJ2-5,CASSSPDRHQETQYF,0,1,1,1
TRBV7-9,TRBJ2-3,CASSSKPTGTDTQYF,0,1,1,1
TRBV12-3/4,TRBJ1-4,CASSSDGGTNEKLFF,0,1,1,1
TRBV11-1,TRBJ1-1,CASSWDRLPNTEAFF,0,1,1,1
TRBV7-2,TRBJ2-3,CASSYTSGDTDTQYF,0,1,1,1
TRBV7-9,TRBJ1-6,CASSYEGQGDSPLHF,0,1,1,1
TRBV12-3/4,TRBJ2-7,CASSLTETGAYEQYF,0,1,1,1
TRBV11-2,TRBJ2-5,CASSLSFREQETQYF,0,1,1,1
TRBV7-6,TRBJ2-1,CASSLSAPSYNEQFF,0,1,1,1
TRBV5-4,TRBJ2-5,CASSLAGTSQETQYF,0,1,1,1
TRBV7-3,TRBJ2-7,CASSLNGGPSYEQYF,0,1,1,1
TRBV3-1,TRBJ1-6,CASSPWAGPGSPLHF,0,1,1,1
TRBV11-1,TRBJ2-1,CASSPGYYLYNEQFF,0,1,1,1
TRBV7-2,TRBJ2-7,CASSPLDRDNYEQYF,0,1,1,1
TRBV28,TRBJ1-1,CASSPPDVVNTEAFF,0,1,1,1
TRBV7-2,TRBJ2-7,CASSPPPAVTYEQYF,0,1,1,1
TRBV7-9,TRBJ1-1,CASSPRRAGQTEAFF,0,1,1,1
TRBV14,TRBJ2-3,CASSPHAGWTDTQYF,0,1,1,1
TRBV11-1,TRBJ2-3,CASSPQGSGTDTQYF,0,1,1,1
TRBV7-3,TRBJ2-5,CASSPVLANLETQYF,0,1,1,1
TRBV7-2,TRBJ2-1,CASSPGTGIYNEQFF,0,1,1,1
TRBV28,TRBJ2-1,CASSPTGAGSNEQFF,0,1,1,1
TRBV7-9,TRBJ2-7,CASSPGQGLSYEQYF,0,1,1,1
TRBV3-1,TRBJ2-7,CASSPGQGVGDEQYF,0,1,1,1
TRBV5-6,TRBJ2-5,CASSPNGGQVFPSYF,0,1,1,1
TRBV7-2,TRBJ2-3,CASSPRGRSTDTQYF,0,1,1,1
TRBV14,TRBJ2-5,CASSRYRGFQETQYF,0,1,1,1
TRBV3-1,TRBJ2-3,CASSRSGGAPDTQYF,0,1,1,1
TRBV5-6,TRBJ1-4,CASSRPGATNEKLFF,0,1,1,1
TRBV28,TRBJ2-7,CASSRGGTGINEQYF,0,1,1,1
TRBV16,TRBJ2-7,CASSHYRDRAGEQYF,0,1,1,1
TRBV7-9,TRBJ1-5,CASSQGQGFGQPQHF,0,1,1,1
TRBV3-1,TRBJ2-3,CASSQVGGPTDTQYF,0,1,1,1
TRBV3-1,TRBJ2-5,CASSQGLRGQETQYF,0,1,1,1
TRBV3-1,TRBJ2-3,CASSQDVRGADTQYF,0,1,1,1
TRBV11-3,TRBJ2-3,CASSAGTSVTDTQYF,0,1,1,1
TRBV7-9,TRBJ1-4,CASSGPGTGGEKLFF,0,1,1,1
TRBV3-1,TRBJ2-1,CASSGRGRQDNEQFF,0,1,1,1
TRBV28,TRBJ1-1,CASRLPGFRNTEAFF,0,1,1,1
TRBV2,TRBJ2-3,CASRALAGSTDTQYF,0,1,1,1
TRBV2,TRBJ2-1,CASRLGQGHYNGQFF,0,1,1,1
TRBV12-3/4,TRBJ2-5,CASRPRQGAGETQYF,0,1,1,1
TRBV28,TRBJ1-4,CASRPSGQGGEKLFF,0,1,1,1
TRBV28,TRBJ1-4,CASRHRATTNEKLFF,0,1,1,1
TRBV6-2/3/5/6,TRBJ1-1,CASRATGFGGTEAFF,0,1,1,1
TRBV28,TRBJ2-3,CASRRGRVKDGTQYF,0,1,1,1
TRBV28,TRBJ1-2,CASRKVQGADYGYAF,0,1,1,1
TRBV28,TRBJ2-7,CASNTLGQGMREQYF,0,1,1,1
TRBV12-3/4,TRBJ2-7,CASKGGGGGYYEQYF,0,1,1,1
TRBV6-2/3/5/6,TRBJ1-3,CTSSSPTFSGNTIYF,0,1,1,1
TRBV7-6,TRBJ1-5,CPSQGVTYSNQPQHF,0,1,1,1
TRBV5-1,TRBJ2-2,CASSLVSAFTGELFF,0,1,1,1
TRBV5-1,TRBJ1-1,CASSFQGRMNTEAFF,0,1,1,1
TRBV5-1,TRBJ2-3,CASSLAPGSPDTQYF,0,1,1,1
TRBV5-1,TRBJ2-3,CASSLAGGETDTQYF,0,1,1,1
TRBV5-1,TRBJ1-6,CASSLGQQNNSPLHL,0,1,1,1
TRBV5-1,TRBJ1-2,CASSLDVAGHYGYTF,0,1,1,1
TRBV5-1,TRBJ2-3,CASSLDRGITDTQYF,0,1,1,1
TRBV5-1,TRBJ2-1,CASSLEAGVHNEQFF,0,1,1,1
TRBV5-1,TRBJ1-4,CASSLTTGFDEKLFF,0,1,1,1
TRBV5-1,TRBJ2-1,CASSLPPGQSREQFF,0,1,1,1
TRBV5-1,TRBJ2-1,CASSLRQGLYNELFF,0,1,1,1
TRBV5-1,TRBJ2-1,CASSSWPSSYNEQFF,0,1,1,1
TRBV5-1,TRBJ2-1,CASSSGTSGVNEQFF,0,1,1,1
TRBV5-1,TRBJ1-1,CASSWGEALGTEAFF,0,1,1,1
TRBV4-1,TRBJ2-1,CASSLGLAGVRQQFF,0,1,1,1
TRBV5-1,TRBJ2-7,CASSLTGQGVIEQYF,0,1,1,1
TRBV5-1,TRBJ1-3,CASSPLVRSANTIYF,0,1,1,1
TRBV4-1,TRBJ2-7,CASSPAMGASYEQYF,0,1,1,1
TRBV5-1,TRBJ2-6,CASSPGDSSSNVLTF,0,1,1,1
TRBV4-1,TRBJ2-7,CASSQSDGEFREQYF,0,1,1,1
TRBV4-1,TRBJ2-1,CASSQVYFGENEQFF,0,1,1,1
TRBV4-1,TRBJ1-4,CASSQDPGGGEKLFF,0,1,1,1
TRBV4-1,TRBJ2-1,CASSQRDADYNEQFF,0,1,1,1
TRBV5-1,TRBJ1-6,CASSDGRSYNSPLHF,0,1,1,1
TRBV5-1,TRBJ2-7,CASSITGQLIYEQCF,0,1,1,1
TRBV5-1,TRBJ1-5,CASSIGPDHNQPQHF,0,1,1,1
TRBV4-1,TRBJ1-2,CASSTQGPTNYGYTF,0,1,1,1
TRBV5-1,TRBJ1-6,CASSRANFYNSPLHF,0,1,1,1
TRBV5-1,TRBJ2-7,CASRGTSGTSFEQYF,0,1,1,1
TRBV10-1,TRBJ2-7,CASRNRVRFSYEQYF,0,1,1,1
TRBV20-1,TRBJ2-7,CGATGTVWSDYEQYF,0,1,1,1
TRBV29-1,TRBJ2-5,CGVSPSGAYQETQYF,0,1,1,1
TRBV20-1,TRBJ2-1,CSAPPLAGGPHEQFF,0,1,1,1
TRBV20-1,TRBJ1-5,CSATGTDYSNQPQHF,0,1,1,1
TRBV20-1,TRBJ1-2,CSARPGTGANYGYTF,0,1,1,1
TRBV20-1,TRBJ2-5,CSARPPLAEQETQYF,0,1,1,1
TRBV20-1,TRBJ2-5,CSARGLGGYQETQYF,0,1,1,1
TRBV20-1,TRBJ2-7,CSARDPIAGAFEQYF,0,1,1,1
TRBV20-1,TRBJ2-1,CSARDPGGSYNEQFF,0,1,1,1
TRBV20-1,TRBJ2-7,CSAREGTSGNYEQYF,0,1,1,1
TRBV20-1,TRBJ2-7,CSAREIAGGRYEQYF,0,1,1,1
TRBV20-1,TRBJ2-1,CSIPGRDWSYNEQFF,0,1,1,1
TRBV29-1,TRBJ2-5,CSVPSRIQYQETQYF,0,1,1,1
TRBV29-1,TRBJ1-1,CSVEEPGQRNTEAFF,0,1,1,1
TRBV29-1,TRBJ2-7,CSVSHLGQVICEQYF,0,1,1,1
TRBV29-1,TRBJ1-1,CSVIRQGGVATEAFF,0,1,1,1
TRBV29-1,TRBJ2-3,CSALWSGVSTDTQYF,0,1,1,1
TRBV5-6,TRBJ2-1,RASSTPLGNYNEQFF,0,1,1,1
TRBV12-3/4,TRBJ1-4,RASSKGQGVVEKLFF,0,1,1,1
TRBV5-1,TRBJ1-4,RASSLGVAANEKLFF,0,1,1,1
TRBV7-9,TRBJ2-1,CPSSLAGQNNEQFF,0,1,1,1
TRBV11-2,TRBJ1-1,CASSLDRGGTEAFF,0,1,1,1
TRBV30,TRBJ1-6,CAWCGTDLNSPLHF,0,1,1,1
TRBV30,TRBJ2-1,CAWGTSAGPHEQFF,0,1,1,1
TRBV30,TRBJ1-2,CAWSFLRDGDGYTF,0,1,1,1
TRBV30,TRBJ1-5,CAWSVPHSNQPQHF,0,1,1,1
TRBV30,TRBJ2-7,CAWSVLAGPYEQYF,0,1,1,1
TRBV30,TRBJ1-5,CAWSAGGLNQPQHF,0,1,1,1
TRBV30,TRBJ1-1,CAWSEPQFFAKAFF,0,1,1,1
TRBV30,TRBJ1-2,CAWSLVGTGVGYTF,0,1,1,1
TRBV30,TRBJ2-6,CAWKQRSGANVLTF,0,1,1,1
TRBV30,TRBJ2-3,CARSVGGSADTQYF,0,1,1,1
TRBV18,TRBJ2-5,CAGSLGPTQETQYF,0,1,1,1
TRBV28,TRBJ2-1,CAISGAGGLNEQFF,0,1,1,1
TRBV10-3,TRBJ2-7,CAISQSDTPYEQYF,0,1,1,1
TRBV2,TRBJ2-3,CATCGGRHTDTQYF,0,1,1,1
TRBV24-1,TRBJ2-2,CATSATGSTGELFF,0,1,1,1
TRBV15,TRBJ2-7,CATSRGGDSYEQYF,0,1,1,1
TRBV15,TRBJ2-2,CATRDGLNTGELFF,0,1,1,1
TRBV19,TRBJ2-5,CASSPRGLGETQYF,0,1,1,1
TRBV12-5,TRBJ2-1,CASVGGQGYNEQFF,0,1,1,1
TRBV19,TRBJ2-1,CASGIQQGHNEQFF,0,1,1,1
TRBV2,TRBJ2-1,CASMGQGYYNEQFF,0,1,1,1
TRBV19,TRBJ2-7,CASTLTGTSVEQYF,0,1,1,1
TRBV19,TRBJ2-7,CASSLDSNSYEQYF,0,1,1,1
TRBV19,TRBJ2-7,CASSISGATYEQYF,0,1,1,1
TRBV19,TRBJ2-2,CASSIGLETGELFF,0,1,1,1
TRBV19,TRBJ1-5,CASSSSGSAQPQHF,0,1,1,1
TRBV19,TRBJ1-1,CASRWDARYTEAFF,0,1,1,1
TRBV18,TRBJ1-5,CASSPRQEHQPQHF,0,1,1,1
TRBV18,TRBJ1-4,CASSPQGGNEKLFF,0,1,1,1
TRBV18,TRBJ1-6,CASSQAAYNSPLHF,0,1,1,1
TRBV18,TRBJ1-5,CASPPKGGNQPQHF,0,1,1,1
TRBV18,TRBJ2-3,CASRESGGADTQYF,0,1,1,1
TRBV18,TRBJ1-4,CASQSSQGTEKLFF,0,1,1,1
TRBV28,TRBJ1-2,CASQRTGENYGYTF,0,1,1,1
TRBV28,TRBJ2-1,CASASRVAIDEQFF,0,1,1,1
TRBV6-4,TRBJ2-6,CASARVSGANVLTF,0,1,1,1
TRBV6-2/3/5/6,TRBJ1-1,CASGYTGGRTEAFF,0,1,1,1
TRBV27,TRBJ1-4,CASGETGATERLFF,0,1,1,1
TRBV28,TRBJ2-5,CASGLSGGQETQYF,0,1,1,1
TRBV6-2/3/5/6,TRBJ1-1,CASGNQDRNTEAFF,0,1,1,1
TRBV28,TRBJ2-3,CASIPGQNTDTQYF,0,1,1,1
TRBV2,TRBJ2-3,CASIEAGAPDTQYF,0,1,1,1
TRBV2,TRBJ2-7,CASTRRASTEEQYF,0,1,1,1
TRBV12-3/4,TRBJ2-6,CASTRGAGANVLTF,0,1,1,1
TRBV2,TRBJ1-1,CASTGGALNTEAFF,0,1,1,1
TRBV6-2/3/5/6,TRBJ1-5,CASSFGSGGQPQHF,0,1,1,1
TRBV12-3/4,TRBJ1-1,CASSFDTRNTEAFF,0,1,1,1
TRBV12-3/4,TRBJ1-1,CASSFSQGITEAFF,0,1,1,1
TRBV5-6,TRBJ2-1,CASSFPNPSNEQFF,0,1,1,1
TRBV28,TRBJ1-5,CASSFRQANQPQHF,0,1,1,1
TRBV12-3/4,TRBJ2-4,CASSFGEAKNIQYF,0,1,1,1
TRBV12-3/4,TRBJ2-5,CASSLTSGAATQYF,0,1,1,1
TRBV28,TRBJ1-5,CASSLSQGGRPQHS,0,1,1,1
TRBV12-3/4,TRBJ1-1,CASSLVQANTEAFF,0,1,1,1
TRBV12-3/4,TRBJ1-1,CASSLAGGNTEAFF,0,1,1,1
TRBV6-2/3/5/6,TRBJ1-6,CASSLDRGGSPLHF,0,1,1,1
TRBV12-3/4,TRBJ2-3,CASSLDPSTDTQYF,0,1,1,1
TRBV6-2/3/5/6,TRBJ2-7,CASSLRSRENEQYF,0,1,1,1
TRBV12-3/4,TRBJ1-1,CASSSGERVTEAFF,0,1,1,1
TRBV12-3/4,TRBJ2-1,CASSSSGKWNEQFF,0,1,1,1
TRBV28,TRBJ1-6,CASSSAGTGSPLHF,0,1,1,1
TRBV6-2/3/5/6,TRBJ2-1,CASSSRSKNNEQFF,0,1,1,1
TRBV6-2/3/5/6,TRBJ2-3,CASSYSASTDTQYF,0,1,1,1
TRBV7-2,TRBJ2-7,CASSPEDRTYEQYF,0,1,1,1
TRBV6-2/3/5/6,TRBJ2-5,CASSPTGIGETQYF,0,1,1,1
TRBV28,TRBJ2-3,CASSPPTSTDTQYF,0,1,1,1
TRBV7-9,TRBJ1-1,CASSRPGRGTEAFF,0,1,1,1
TRBV28,TRBJ2-7,CASSRDRGLVEQYF,0,1,1,1
TRBV6-1,TRBJ1-5,CASSVIYSNQPQHF,0,1,1,1
TRBV28,TRBJ2-3,CASSGGQVTDTQYF,0,1,1,1
TRBV2,TRBJ1-1,CASSDDRVLAEAFF,0,1,1,1
TRBV6-1,TRBJ2-3,CASSEPGSTDTQYF,0,1,1,1
TRBV6-1,TRBJ1-5,CASSEGQGAQPQHF,0,1,1,1
TRBV28,TRBJ2-5,CASSMAAAQETQYF,0,1,1,1
TRBV5-6,TRBJ2-5,CASSSGPIPETQYF,0,1,1,1
TRBV11-2,TRBJ1-1,CASSFLAGGTEAFF,0,1,1,1
TRBV7-2,TRBJ2-1,CASSFSSVYNEQFF,0,1,1,1
TRBV7-9,TRBJ2-3,CASSFLGGTDTQYF,0,1,1,1
TRBV7-2,TRBJ2-5,CASSFGTDQETQYF,0,1,1,1
TRBV5-5,TRBJ2-2,CASSLAVLAGELFF,0,1,1,1
TRBV7-2,TRBJ1-2,CASSLGGGSYGYTF,0,1,1,1
TRBV7-9,TRBJ2-7,CASSLGTGSYEQYF,0,1,1,1
TRBV5-6,TRBJ2-3,CASSLDQGTDTQYF,0,1,1,1
TRBV7-3,TRBJ1-1,CASSLTGGSAEAFF,0,1,1,1
TRBV7-2,TRBJ2-7,CASSLSGLIYEQYF,0,1,1,1
TRBV7-2,TRBJ1-1,CASSLVPGPHKAFF,0,1,1,1
TRBV7-9,TRBJ1-2,CASSLATLNYGYTF,0,1,1,1
TRBV7-2,TRBJ1-2,CASSLAMPSYGYTF,0,1,1,1
TRBV7-2,TRBJ2-7,CASSLGQGWYEQYF,0,1,1,1
TRBV7-3,TRBJ2-2,CASSLGWNTGELFF,0,1,1,1
TRBV7-2,TRBJ1-6,CASSLGRGDWALHF,0,1,1,1
TRBV11-3,TRBJ2-5,CASSLDLAQETQYF,0,1,1,1
TRBV7-2,TRBJ1-1,CASSLEQGNTEAFF,0,1,1,1
TRBV11-2,TRBJ2-7,CASSLRVGSYGQYF,0,1,1,1
TRBV7-8,TRBJ2-2,CASSSWTYTGELFF,0,1,1,1
TRBV7-2,TRBJ1-1,CASSSLGQATVAFF,0,1,1,1
TRBV7-3,TRBJ2-7,CASSSGTGDYEQYF,0,1,1,1
TRBV5-4,TRBJ2-7,CASSSPAGDLEQYF,0,1,1,1
TRBV6-2/3/5/6,TRBJ1-6,CASSSQGANSPLHF,0,1,1,1
TRBV7-2,TRBJ1-1,CASSSGFMITEAFF,0,1,1,1
TRBV9,TRBJ2-1,CASSWRGEGNEQFF,0,1,1,1
TRBV11-2,TRBJ2-5,CASSLGTTQETQYF,0,1,1,1
TRBV28,TRBJ1-4,CASSLQGRKEKLFF,0,1,1,1
TRBV7-9,TRBJ2-4,CASSPGRDQNIQYF,0,1,1,1
TRBV3-1,TRBJ2-5,CASSPRTSGETQYF,0,1,1,1
TRBV7-9,TRBJ2-7,CASSPYRASYERYF,0,1,1,1
TRBV7-6,TRBJ1-5,CASSPGQTNQPQHF,0,1,1,1
TRBV12-3/4,TRBJ2-7,CASSPWRDPYEQYF,0,1,1,1
TRBV3-1,TRBJ2-5,CASSPTSRRETQYF,0,1,1,1
TRBV4-2,TRBJ2-7,CASSQYVTSYEQYF,0,1,1,1
TRBV28,TRBJ1-2,CASSQYGFNYGYTF,0,1,1,1
TRBV3-1,TRBJ2-7,CASSQGQWVYEQYF,0,1,1,1
TRBV28,TRBJ2-7,CASSQPYVPRTEYF,0,1,1,1
TRBV3-1,TRBJ1-5,CASSQVIGGQPQHF,0,1,1,1
TRBV3-1,TRBJ2-5,CASSQASSEKTQYF,0,1,1,1
TRBV3-1,TRBJ2-3,CASSQEAGRNTQYF,0,1,1,1
TRBV3-1,TRBJ1-3,CASSQTPFGTDVNF,0,1,1,1
TRBV3-1,TRBJ1-2,CASSQRTGFYGYTF,0,1,1,1
TRBV5-4,TRBJ2-7,CASSVTGRGDEQYF,0,1,1,1
TRBV9,TRBJ1-6,CASSVGDPSGSLHF,0,1,1,1
TRBV9,TRBJ2-7,CASSAQGDRDEQYF,0,1,1,1
TRBV7-9,TRBJ1-6,CASSEGAGVSPLHF,0,1,1,1
TRBV7-9,TRBJ2-1,CASSIMWRDHEQFF,0,1,1,1
TRBV2,TRBJ1-1,CASSMSGVNTEAFF,0,1,1,1
TRBV2,TRBJ1-5,CASSTLNEGQPQHF,0,1,1,1
TRBV7-3,TRBJ1-2,CASSTSGTVSGYTF,0,1,1,1
TRBV7-3,TRBJ2-2,CASSKAGDTGELFF,0,1,1,1
TRBV7-9,TRBJ1-4,CASSKVGYNEKLFF,0,1,1,1
TRBV7-2,TRBJ2-3,CASRRGSHTDTQYF,0,1,1,1
TRBV2,TRBJ1-1,CASRRYAGPTEAFF,0,1,1,1
TRBV12-3/4,TRBJ1-4,CASKETQGNEKLFF,0,1,1,1
TRBV28,TRBJ1-6,CASKWTGGNSPLHF,0,1,1,1
TRBV6-2/3/5/6,TRBJ2-1,CASKAGGPLDEQFF,0,1,1,1
TRBV12-3/4,TRBJ2-7,CAGLAGIPPHEQYF,0,1,1,1
TRBV5-5,TRBJ2-1,CTSSLAISKDEQFF,0,1,1,1
TRBV5-1,TRBJ2-1,CASFEGGSYNEQIF,0,1,1,1
TRBV5-1,TRBJ2-5,CASRHPGVRETQYF,0,1,1,1
TRBV5-1,TRBJ1-1,CASGPGQEDTEAFF,0,1,1,1
TRBV5-1,TRBJ2-2,CASEDRGDTGELFF,0,1,1,1
TRBV5-1,TRBJ2-2,CASTREGEGGELFF,0,1,1,1
TRBV5-1,TRBJ1-2,CASSSGPGIYTYTF,0,1,1,1
TRBV5-1,TRBJ2-3,CASSLFGRRDTQYF,0,1,1,1
TRBV5-1,TRBJ2-7,CASSLARGLYEQYF,0,1,1,1
TRBV5-1,TRBJ1-2,CASSLAGSGGSYTF,0,1,1,1
TRBV5-1,TRBJ1-1,CASSLATTGAEAFF,0,1,1,1
TRBV7-2,TRBJ2-1,CASSLKVGGNEQFF,0,1,1,1
TRBV5-1,TRBJ2-1,CASSYGTSTDEQFF,0,1,1,1
TRBV5-1,TRBJ2-3,CASSLGGGTDTQYF,0,1,1,1
TRBV4-1,TRBJ2-7,CASSLAGGPYEQYF,0,1,1,1
TRBV5-1,TRBJ2-3,CASSPGRSSDTQYF,0,1,1,1
TRBV4-1,TRBJ1-3,CASSHPDKGNTIYF,0,1,1,1
TRBV4-1,TRBJ2-5,CASSQAPNQETQYF,0,1,1,1
TRBV3-1,TRBJ2-1,CASSQDTLPSEQFF,0,1,1,1
TRBV5-1,TRBJ1-3,CASSVLGTGNTIYF,0,1,1,1
TRBV5-1,TRBJ1-4,CASSAGQLNEKLFF,0,1,1,1
TRBV5-1,TRBJ1-1,CASSGGGANTEAFF,0,1,1,1
TRBV4-1,TRBJ2-1,CASSGAGGLNEQFF,0,1,1,1
TRBV5-1,TRBJ2-3,CASSIRTRTDTQYF,0,1,1,1
TRBV5-1,TRBJ2-3,CASSMTSGTDTQYF,0,1,1,1
TRBV20-1,TRBJ2-7,CSAWVSGGSYEQYF,0,1,1,1
TRBV20-1,TRBJ1-2,CSATDGRGLYGYTF,0,1,1,1
TRBV20-1,TRBJ2-1,CSASDRDGMDEQFF,0,1,1,1
TRBV20-1,TRBJ1-1,CSASETGESAEAFF,0,1,1,1
TRBV20-1,TRBJ1-2,CSARYLGGNYGYTF,0,1,1,1
TRBV20-1,TRBJ1-1,CSARVRAWSTEAFF,0,1,1,1
TRBV20-1,TRBJ2-7,CSARGVLGTNEQYF,0,1,1,1
TRBV20-1,TRBJ1-3,CSARDQSSGNTIYF,0,1,1,1
TRBV20-1,TRBJ1-2,CSARDIQGDYGYTF,0,1,1,1
TRBV20-1,TRBJ2-7,CSARELAGAYEQYF,0,1,1,1
TRBV20-1,TRBJ1-1,CSARSGTVNTEAFF,0,1,1,1
TRBV20-1,TRBJ2-5,CSAKIPASRETQYF,0,1,1,1
TRBV20-1,TRBJ2-1,CSASGQISYKEQFF,0,1,1,1
TRBV20-1,TRBJ1-1,CSAVLRGMNTEALF,0,1,1,1
TRBV20-1,TRBJ2-1,CSADNSGGANEQFF,0,1,1,1
TRBV29-1,TRBJ2-7,CSVLSPRGVNEQYF,0,1,1,1
TRBV29-1,TRBJ2-5,CSVLRRDREETQYF,0,1,1,1
TRBV29-1,TRBJ1-5,CSVLQGGLNQPQHF,0,1,1,1
TRBV29-1,TRBJ2-3,CSVDGVGDTDTQYF,0,1,1,1
TRBV29-1,TRBJ2-3,CSVDLTGSTDTQYF,0,1,1,1
TRBV29-1,TRBJ2-3,CSVEGGAATDTQYF,0,1,1,1
TRBV29-1,TRBJ1-1,CSVEVRVGDAEAFF,0,1,1,1
TRBV29-1,TRBJ1-1,CSVEESGGGTEAFF,0,1,1,1
TRBV29-1,TRBJ2-5,CSVETSGAGETQYF,0,1,1,1
TRBV29-1,TRBJ2-3,CSVESSGATDTQYF,0,1,1,1
TRBV29-1,TRBJ2-1,CSVERGGRGNEQFF,0,1,1,1
TRBV2,TRBJ2-1,RASTIEALYNEQFF,0,1,1,1
TRBV5-5,TRBJ1-3,RASSLDISGNTIYF,0,1,1,1
TRBV12-5,TRBJ2-1,CASGRDRGNEQFF,0,1,1,1
TRBV7-7,TRBJ2-1,CASSSDSYNEQFF,0,1,1,1
TRBV30,TRBJ1-2,CACATGGDYGYTF,0,1,1,1
TRBV7-9,TRBJ1-1,CACSFGTGGEAFF,0,1,1,1
TRBV30,TRBJ2-3,CAWSVLGTDTQYF,0,1,1,1
TRBV30,TRBJ1-2,CAWSVSGDGGYTF,0,1,1,1
TRBV30,TRBJ1-5,CAWSVQGDQPQHF,0,1,1,1
TRBV30,TRBJ2-1,CAWSVGSENEQFF,0,1,1,1
TRBV30,TRBJ1-1,CAWSVIGNTKAFF,0,1,1,1
TRBV30,TRBJ1-5,CAWNSALDQPQHF,0,1,1,1
TRBV30,TRBJ2-2,CAWNNQGAGELFF,0,1,1,1
TRBV5-6,TRBJ1-2,CAPVNDILGGYTF,0,1,1,1
TRBV19,TRBJ2-5,CAGSTGQKETQYF,0,1,1,1
TRBV11-2,TRBJ2-4,CAIPNYIKNIQYF,0,1,1,1
TRBV19,TRBJ2-1,CATGLGGNNEQFF,0,1,1,1
TRBV12-3/4,TRBJ1-1,CATSLGSAGEAFF,0,1,1,1
TRBV15,TRBJ2-3,CATSRVIQDTQYF,0,1,1,1
TRBV15,TRBJ2-5,CATSRDLEETQYF,0,1,1,1
TRBV28,TRBJ1-1,CASSFYSQGVAFF,0,1,1,1
TRBV19,TRBJ1-2,CASSPQGNYGYTF,0,1,1,1
TRBV19,TRBJ2-7,CASSRQGTNEQYF,0,1,1,1
TRBV19,TRBJ1-5,CASSIRNNQPQHF,0,1,1,1
TRBV19,TRBJ1-5,CASSRYRAQPQHF,0,1,1,1
TRBV2,TRBJ1-5,CASSLEAGQPQHF,0,1,1,1
TRBV19,TRBJ1-1,CASSWTVNTEAFF,0,1,1,1
TRBV18,TRBJ1-1,CASLTGVDTEAFF,0,1,1,1
TRBV28,TRBJ2-7,CASSFGGLYEQYF,0,1,1,1
TRBV18,TRBJ1-1,CASSPSQDTEAFF,0,1,1,1
TRBV18,TRBJ2-7,CASSPGRLYEQYF,0,1,1,1
TRBV18,TRBJ2-5,CASSPPGYETQYF,0,1,1,1
TRBV18,TRBJ2-7,CASSPEGLYEQYF,0,1,1,1
TRBV18,TRBJ2-5,CASRTGNGETQYF,0,1,1,1
TRBV28,TRBJ1-1,CASVPGIDTEAFF,0,1,1,1
TRBV12-3/4,TRBJ1-3,CASGPLGGNTIYF,0,1,1,1
TRBV5-6,TRBJ2-5,CASGTPGRETQYF,0,1,1,1
TRBV3-1,TRBJ2-2,CASIAGGIGELFF,0,1,1,1
TRBV2,TRBJ1-5,CASMRGGNQPQHF,0,1,1,1
TRBV28,TRBJ2-1,CASTPPEHNEQFF,0,1,1,1
TRBV6-2/3/5/6,TRBJ2-7,CASTIGGLYEQYF,0,1,1,1
TRBV7-9,TRBJ2-1,CASTLAGGDEQFF,0,1,1,1
TRBV6-2/3/5/6,TRBJ2-3,CASTGVARDTQYF,0,1,1,1
TRBV12-3/4,TRBJ1-1,CASTRRGGAAAFF,0,1,1,1
TRBV27,TRBJ2-5,CASSFGVRETQYF,0,1,1,1
TRBV6-2/3/5/6,TRBJ2-7,CASSFDISYEQYF,0,1,1,1
TRBV12-3/4,TRBJ1-5,CASSFTGTQPQHF,0,1,1,1
TRBV12-3/4,TRBJ2-5,CASSLWLKETQYF,0,1,1,1
TRBV12-3/4,TRBJ1-2,CASSLDRAYGYTF,0,1,1,1
TRBV6-2/3/5/6,TRBJ1-2,CASSLFGSYGYTF,0,1,1,1
TRBV28,TRBJ2-7,CASSLQGAYEQYF,0,1,1,1
TRBV6-2/3/5/6,TRBJ1-1,CASSLVVGGPAFF,0,1,1,1
TRBV28,TRBJ1-1,CASSLDRWAEAFF,0,1,1,1
TRBV28,TRBJ1-1,CASSWVQNTEAFF,0,1,1,1
TRBV6-2/3/5/6,TRBJ2-7,CASSWTSGYEQYF,0,1,1,1
TRBV12-3/4,TRBJ2-7,CASSWTGVHEQYF,0,1,1,1
TRBV12-3/4,TRBJ1-5,CASSWRVYQPQHF,0,1,1,1
TRBV6-2/3/5/6,TRBJ1-5,CASSYGAYQPQHF,0,1,1,1
TRBV6-2/3/5/6,TRBJ2-6,CASSLSGANVLTF,0,1,1,1
TRBV6-2/3/5/6,TRBJ1-5,CASSPLSNQPQHF,0,1,1,1
TRBV12-3/4,TRBJ1-1,CASSAGARAEVFF,0,1,1,1
TRBV12-3/4,TRBJ2-7,CASSDQGFHGQYF,0,1,1,1
TRBV2,TRBJ2-3,CASSEALQSTQYF,0,1,1,1
TRBV6-1,TRBJ2-7,CASSEGAFYEQYF,0,1,1,1
TRBV6-1,TRBJ2-1,CASSETQGNEQFF,0,1,1,1
TRBV2,TRBJ1-5,CASSIGSPRPQHF,0,1,1,1
TRBV7-2,TRBJ1-2,CASSFDRVWGYTF,0,1,1,1
TRBV7-6,TRBJ2-5,CASSFSRQETQYF,0,1,1,1
TRBV7-2,TRBJ1-3,CASSFRPRDTIYF,0,1,1,1
TRBV7-9,TRBJ1-2,CASSFAASAGYTF,0,1,1,1
TRBV6-2/3/5/6,TRBJ1-1,CASSLEYGTEAFF,0,1,1,1
TRBV7-6,TRBJ1-2,CASSLTVADGYTF,0,1,1,1
TRBV7-2,TRBJ2-1,CASSLSWSTTQFF,0,1,1,1
TRBV7-2,TRBJ1-5,CASSLRQNQPQHF,0,1,1,1
TRBV7-6,TRBJ2-1,CASSLVQTSEQFF,0,1,1,1
TRBV11-3,TRBJ1-1,CASSLAENTEAFF,0,1,1,1
TRBV7-9,TRBJ1-2,CASSLGQLLGYTF,0,1,1,1
TRBV11-1,TRBJ2-1,CASSLDRNNEQFF,0,1,1,1
TRBV7-2,TRBJ2-5,CASSLIGQETQYF,0,1,1,1
TRBV7-2,TRBJ1-2,CASSLIGGHGYTF,0,1,1,1
TRBV7-2,TRBJ2-7,CASSLTPPYEQYF,0,1,1,1
TRBV7-3,TRBJ1-5,CASSLSTDQPQHF,0,1,1,1
TRBV7-9,TRBJ2-1,CASSLSRANEQFF,0,1,1,1
TRBV28,TRBJ2-2,CASSSPNTGELFF,0,1,1,1
TRBV7-3,TRBJ1-6,CASSSQPNSPLHF,0,1,1,1
TRBV7-2,TRBJ2-1,CASSSGLAGEQFF,0,1,1,1
TRBV5-6,TRBJ1-4,CASSWAPNEKLFL,0,1,1,1
TRBV11-3,TRBJ2-1,CASSYRDSGEQFF,0,1,1,1
TRBV5-4,TRBJ1-2,CASSYGRGHGYTF,0,1,1,1
TRBV11-2,TRBJ1-5,CASSLGSNQPQHF,0,1,1,1
TRBV2,TRBJ2-5,CASSLGYPETQYF,0,1,1,1
TRBV12-3/4,TRBJ1-5,CASSPLGNQPQHF,0,1,1,1
TRBV7-3,TRBJ2-5,CASSPSGQETQYF,0,1,1,1
TRBV11-2,TRBJ2-7,CASSPRTYYEQYF,0,1,1,1
TRBV7-3,TRBJ1-1,CASSPAGGTEAFF,0,1,1,1
TRBV28,TRBJ2-5,CASSPGVAKTQYF,0,1,1,1
TRBV14,TRBJ1-2,CASSPGTAYGYTF,0,1,1,1
TRBV6-2/3/5/6,TRBJ1-2,CASSPGQIYGYTF,0,1,1,1
TRBV5-5,TRBJ1-6,CASSPWDSRALHF,0,1,1,1
TRBV7-6,TRBJ2-7,CASSPGSSYEQYF,0,1,1,1
TRBV28,TRBJ2-7,CASSPETGREQYF,0,1,1,1
TRBV14,TRBJ1-1,CASSRQGASEAFF,0,1,1,1
TRBV7-6,TRBJ2-7,CASSHGADYEQYF,0,1,1,1
TRBV3-1,TRBJ2-7,CASSHLGVYEQYF,0,1,1,1
TRBV11-2,TRBJ2-1,CASSQAANNEQFF,0,1,1,1
TRBV27,TRBJ1-4,CASSQGFNEKLFF,0,1,1,1
TRBV3-1,TRBJ2-5,CASSQGPQETQYF,0,1,1,1
TRBV4-2,TRBJ1-5,CASSQDTGQPQHF,0,1,1,1
TRBV9,TRBJ2-7,CASSVATGGEQYF,0,1,1,1
TRBV9,TRBJ1-1,CASSVAMYAEAFF,0,1,1,1
TRBV9,TRBJ1-1,CASSVASAGKAFF,0,1,1,1
TRBV9,TRBJ2-1,CASSGQGYNEQFF,0,1,1,1
TRBV28,TRBJ2-7,CASSKGSTGEQYF,0,1,1,1
TRBV5-4,TRBJ2-5,CASRFWVGETQYF,0,1,1,1
TRBV28,TRBJ2-5,CASRSGGQETQYF,0,1,1,1
TRBV2,TRBJ1-5,CASRASSNQPQHF,0,1,1,1
TRBV9,TRBJ2-2,CASRGGNAGELFF,0,1,1,1
TRBV7-9,TRBJ1-1,CASRDRGGTEAFF,0,1,1,1
TRBV6-2/3/5/6,TRBJ2-7,CASRSQGAYEQYF,0,1,1,1
TRBV5-4,TRBJ2-5,CASKTGRQETQYF,0,1,1,1
TRBV10-2,TRBJ2-1,CASSSGGPYEQFF,0,1,1,1
TRBV5-1,TRBJ1-6,CASITYREDPLHF,0,1,1,1
TRBV5-1,TRBJ1-1,CASTLGVNTEAFF,0,1,1,1
TRBV5-1,TRBJ2-5,CASSLGDGETQYF,0,1,1,1
TRBV5-1,TRBJ2-2,CASSLSGTGELFF,0,1,1,1
TRBV4-1,TRBJ1-1,CASSYWTGVEAFF,0,1,1,1
TRBV5-1,TRBJ2-3,CASSLDFGDTQYF,0,1,1,1
TRBV5-1,TRBJ1-2,CASSPAGTEGYTF,0,1,1,1
TRBV4-1,TRBJ2-3,CASSDRGLDTQYF,0,1,1,1
TRBV4-1,TRBJ2-1,CASRPDGYNEQFF,0,1,1,1
TRBV20-1,TRBJ2-7,CSLKGTGIYEQYF,0,1,1,1
TRBV20-1,TRBJ2-1,CSASPAGYNEQFF,0,1,1,1
TRBV20-1,TRBJ2-3,CSASGVGTDTQYF,0,1,1,1
TRBV20-1,TRBJ2-7,CSARGGFSYEQYF,0,1,1,1
TRBV20-1,TRBJ2-7,CSARGDSVYEQYF,0,1,1,1
TRBV20-1,TRBJ2-5,CSARGLAGETQYF,0,1,1,1
TRBV20-1,TRBJ1-2,CSAPDREYYGYTF,0,1,1,1
TRBV20-1,TRBJ2-5,CSATPGGEETQYF,0,1,1,1
TRBV20-1,TRBJ2-5,CSALDRAGETQYF,0,1,1,1
TRBV20-1,TRBJ1-5,CSARQGDGQPQHF,0,1,1,1
TRBV20-1,TRBJ2-2,CSIHSGVTGELFF,0,1,1,1
TRBV29-1,TRBJ1-1,CSPQKVANTEAFF,0,1,1,1
TRBV29-1,TRBJ1-1,CSVLDRGDTEAFF,0,1,1,1
TRBV29-1,TRBJ1-6,CSVSDGGNSPLHF,0,1,1,1
TRBV29-1,TRBJ2-3,CSVRLVGADTQYF,0,1,1,1
TRBV29-1,TRBJ2-5,CSVGTSGGETQYF,0,1,1,1
TRBV29-1,TRBJ2-1,CSVGSGEDSEQFF,0,1,1,1
TRBV29-1,TRBJ2-3,CSVDQTSTDTQYF,0,1,1,1
TRBV29-1,TRBJ1-1,CSVDRQLNTEAFF,0,1,1,1
TRBV29-1,TRBJ1-4,CSVDRVTNEKLFF,0,1,1,1
TRBV29-1,TRBJ1-4,CSVESGSGEKLFF,0,1,1,1
TRBV29-1,TRBJ2-3,CSVEQLGTDTQYF,0,1,1,1
TRBV29-1,TRBJ1-1,CSVEQDSNTEAFF,0,1,1,1
TRBV29-1,TRBJ1-1,CSVEVVLNTEAFF,0,1,1,1
TRBV29-1,TRBJ1-3,CSVEVGTGNTIYF,0,1,1,1
TRBV29-1,TRBJ2-3,CSVEGQDQDTQYS,0,1,1,1
TRBV29-1,TRBJ2-5,CSVSGDGGETQYF,0,1,1,1
TRBV29-1,TRBJ2-7,CSVEVYLLGEQYF,0,1,1,1
TRBV29-1,TRBJ2-5,CSVEPGQKETQYF,0,1,1,1
TRBV29-1,TRBJ1-2,CSAREYGIQDYTF,0,1,1,1
TRBV29-1,TRBJ2-4,CSAKGRGFDIQDF,0,1,1,1
TRBV29-1,TRBJ1-1,CSGFTGRSTEAFF,0,1,1,1
TRBV29-1,TRBJ2-1,YSVGRQGVGVWFF,0,1,1,1
TRBV7-9,TRBJ2-1,CVSSSNLNEQFF,0,1,1,1
TRBV30,TRBJ2-1,CACERGGDEQFF,0,1,1,1
TRBV30,TRBJ2-3,CAWSVRGDTQYF,0,1,1,1
TRBV30,TRBJ2-3,CAWSVRGNTQYF,0,1,1,1
TRBV30,TRBJ2-3,CAWSKVSDTQYF,0,1,1,1
TRBV10-3,TRBJ2-5,CAIGETEETQYF,0,1,1,1
TRBV10-3,TRBJ1-2,CAISGDNYGYTF,0,1,1,1
TRBV24-1,TRBJ2-1,CATSRTDNEQFS,0,1,1,1
TRBV19,TRBJ1-5,CASSIWRQPQHF,0,1,1,1
TRBV18,TRBJ2-3,CASSTTSGSQYF,0,1,1,1
TRBV2,TRBJ2-2,CASGLDTGELFF,0,1,1,1
TRBV28,TRBJ1-5,CASGRQNQPQHF,0,1,1,1
TRBV6-2/3/5/6,TRBJ2-7,CASSFLDRAQYF,0,1,1,1
TRBV12-3/4,TRBJ2-7,CASSFSNYEQYF,0,1,1,1
TRBV12-3/4,TRBJ2-5,CASSFLGETQYF,0,1,1,1
TRBV12-3/4,TRBJ2-3,CASSFSTDTQYF,0,1,1,1
TRBV28,TRBJ1-5,CASSLLGQPQHF,0,1,1,1
TRBV28,TRBJ2-7,CASSLAGDEQYF,0,1,1,1
TRBV12-3/4,TRBJ1-1,CASSLKATEAFF,0,1,1,1
TRBV12-3/4,TRBJ1-2,CASSSSPFSYTF,0,1,1,1
TRBV6-2/3/5/6,TRBJ1-6,CASSWTNSPLHF,0,1,1,1
TRBV28,TRBJ2-7,CASSLRGDEQYF,0,1,1,1
TRBV28,TRBJ2-5,CASSPGEETQYF,0,1,1,1
TRBV28,TRBJ2-1,CASSQTSVEQFF,0,1,1,1
TRBV7-3,TRBJ2-1,CASSVVGDEQFF,0,1,1,1
TRBV25-1,TRBJ2-7,CASSEYLYEQYF,0,1,1,1
TRBV9,TRBJ1-2,CASSRTDYGYTF,0,1,1,1
TRBV11-2,TRBJ1-1,CASSFGAVEAFF,0,1,1,1
TRBV7-9,TRBJ2-3,CASSFSGDAQYF,0,1,1,1
TRBV7-9,TRBJ2-7,CASSFRTYEQYF,0,1,1,1
TRBV11-2,TRBJ2-5,CASSLRSGDQYF,0,1,1,1
TRBV7-9,TRBJ2-5,CASSLGQETQHF,0,1,1,1
TRBV7-9,TRBJ1-2,CASSLTEYGYTS,0,1,1,1
TRBV5-5,TRBJ2-7,CASSPLAYEQYF,0,1,1,1
TRBV7-9,TRBJ2-7,CASSPGGYEQYF,0,1,1,1
TRBV3-1,TRBJ2-7,CASSQVPNEQYF,0,1,1,1
TRBV3-1,TRBJ1-6,CASSQARAPLHF,0,1,1,1
TRBV7-9,TRBJ1-1,CASSQTPGGAFF,0,1,1,1
TRBV6-2/3/5/6,TRBJ2-3,CASSQGGLTQYF,0,1,1,1
TRBV9,TRBJ2-6,CASSGGANVLTF,0,1,1,1
TRBV7-2,TRBJ1-1,CASSGQGLRGFF,0,1,1,1
TRBV7-9,TRBJ2-1,CASSGEYNEQFF,0,1,1,1
TRBV6-2/3/5/6,TRBJ2-5,CASSIYESLPYF,0,1,1,1
TRBV7-3,TRBJ2-1,CASSNIEGRQFF,0,1,1,1
TRBV2,TRBJ2-5,CASRGSGATQYF,0,1,1,1
TRBV6-4,TRBJ1-4,CASRTDKEKLFF,0,1,1,1
TRBV2,TRBJ1-2,CASNQGIGGYTF,0,1,1,1
TRBV12-3/4,TRBJ2-3,CANGQSTDTQYF,0,1,1,1
TRBV28,TRBJ2-5,CDNGGSPETQYF,0,1,1,1
TRBV5-1,TRBJ2-1,CASRDSYNEQFF,0,1,1,1
TRBV5-1,TRBJ2-5,CASRNEKGTQYF,0,1,1,1
TRBV5-1,TRBJ2-7,CASSLDYYEQYF,0,1,1,1
TRBV5-1,TRBJ2-3,CASSYTGKPQYF,0,1,1,1
TRBV4-1,TRBJ2-3,CASSQDLYTQYF,0,1,1,1
TRBV29-1,TRBJ2-1,CTQGLANNEQFF,0,1,1,1
TRBV20-1,TRBJ2-7,CSALTVPYEQYF,0,1,1,1
TRBV20-1,TRBJ2-7,CSAIRTNYEQYF,0,1,1,1
TRBV20-1,TRBJ1-1,CSARGGVTEAFF,0,1,1,1
TRBV20-1,TRBJ2-3,CSAGRSIDTQYF,0,1,1,1
TRBV29-1,TRBJ2-3,CSLTVSTDTQYF,0,1,1,1
TRBV29-1,TRBJ2-3,CSVVQGEDTQYF,0,1,1,1
TRBV29-1,TRBJ1-4,CSVGGYGEKLFF,0,1,1,1
TRBV29-1,TRBJ2-7,CSVESGGREQYF,0,1,1,1
TRBV29-1,TRBJ2-5,CSVEARGETQYF,0,1,1,1
TRBV29-1,TRBJ2-3,CSVEGVTDTQYF,0,1,1,1
TRBV29-1,TRBJ1-1,CSVEDRADEAFF,0,1,1,1
TRBV29-1,TRBJ2-7,CSVEEGAVEPYF,0,1,1,1
TRBV29-1,TRBJ2-5,CSVESPKWETYF,0,1,1,1
TRBV29-1,TRBJ2-5,CSVTRGQETQYF,0,1,1,1
TRBV29-1,TRBJ2-5,CSVLEVGKTQYF,0,1,1,1
TRBV29-1,TRBJ2-5,CSAHTAQETQYF,0,1,1,1
TRBV20-1,TRBJ2-7,CSGGQGPYEQYY,0,1,1,1
TRBV29-1,TRBJ2-2,CSIGMNTGELFF,0,1,1,1
TRBV28,TRBJ2-1,CASRAEHEQFF,0,1,1,1
TRBV10-3,TRBJ2-3,CAIRYGDTQYF,0,1,1,1
TRBV7-9,TRBJ1-1,CAIVRYTEAFF,0,1,1,1
TRBV18,TRBJ1-6,CASRFDSPLHF,0,1,1,1
TRBV12-3/4,TRBJ2-7,CASGFMYEQYF,0,1,1,1
TRBV7-6,TRBJ2-1,CASGVYNEQFF,0,1,1,1
TRBV6-2/3/5/6,TRBJ1-1,CASEEGTEAFP,0,1,1,1
TRBV3-1,TRBJ2-2,CASMLAGELFF,0,1,1,1
TRBV28,TRBJ1-2,CASSLAYGYTF,0,1,1,1
TRBV12-3/4,TRBJ2-5,CASSLRETQYF,0,1,1,1
TRBV12-3/4,TRBJ1-1,CASSSWTEAFF,0,1,1,1
TRBV2,TRBJ1-2,CASSVTGGYTF,0,1,1,1
TRBV6-1,TRBJ1-2,CASSGEYGYTF,0,1,1,1
TRBV11-1,TRBJ2-5,CASSFQETQYF,0,1,1,1
TRBV7-9,TRBJ1-3,CASSLVNTIYF,0,1,1,1
TRBV7-9,TRBJ1-2,CASSLALGYTF,0,1,1,1
TRBV5-6,TRBJ2-1,CASSSGLAEIT,0,1,1,1
TRBV3-1,TRBJ2-1,CASSQGSEQFF,0,1,1,1
TRBV7-9,TRBJ2-1,CASSAGGEQFF,0,1,1,1
TRBV7-9,TRBJ1-2,CASSGGGGYTF,0,1,1,1
TRBV7-3,TRBJ2-4,CASRRGNIQYF,0,1,1,1
TRBV5-1,TRBJ1-2,CASRASYGYTF,0,1,1,1
TRBV5-1,TRBJ2-7,CASSGQGEQYF,0,1,1,1
TRBV4-1,TRBJ2-2,CASSNTGEPFF,0,1,1,1
TRBV20-1,TRBJ1-1,CSARLNFEAFF,0,1,1,1
TRBV20-1,TRBJ2-7,CSATTSYEQYF,0,1,1,1
TRBV20-1,TRBJ2-5,CSARDWETQYF,0,1,1,1
TRBV29-1,TRBJ1-1,CSVGVDSGAFF,0,1,1,1
TRBV20-1,TRBJ2-1,CSVGGWNEQFF,0,1,1,1
TRBV29-1,TRBJ2-1,CSVEVGNEQFF,0,1,1,1
TRBV29-1,TRBJ2-3,CSVETWDTQYF,0,1,1,1
TRBV29-1,TRBJ2-7,CSVEDPNEQYF,0,1,1,1
TRBV29-1,TRBJ1-1,CSVERGTEAFF,0,1,1,1
TRBV29-1,TRBJ1-2,CSVTRVGGYTF,0,1,1,1
TRBV28,TRBJ2-5,CASGRETQYF,0,1,1,1
TRBV20-1,TRBJ2-3,CSASEDTQYF,0,1,1,1
TRBV29-1,TRBJ1-2,CSVDADGYTF,0,1,1,1
TRBV29-1,TRBJ2-5,CSAGDETQYF,0,1,1,1
