v_hit,j_hit,cdr3,S1-10ng_S6,S1-10ng_S18,freq,count_sum
TRBV5-1,TRBJ1-2,CASSLVGGGSGYTF,117,72,2,189
TRBV3-1,TRBJ2-7,CASPHSKSTRDRGRSFYEQYF,87,50,2,137
TRBV28,TRBJ1-2,CASGYAYNYGYTF,72,67,2,139
TRBV19,TRBJ1-1,CASSIGWGTEAFF,62,52,2,114
TRBV3-1,TRBJ2-6,CASSQGAAGGANVLTF,49,75,2,124
TRBV19,TRBJ1-1,CASSIWGSLNTEAFF,45,0,1,45
TRBV10-2,TRBJ2-3,CASMMTASTDTQYF,39,25,2,64
TRBV29-1,TRBJ2-1,CSVDRGQDKYNEQFF,30,0,1,30
TRBV18,TRBJ2-3,CASSPDSSTDTQYF,30,0,1,30
TRBV2,TRBJ2-7,CASSERDRAYEQYF,29,0,1,29
TRBV6-2/3/5/6,TRBJ2-1,CASWVAGNNEQFF,29,31,2,60
TRBV28,TRBJ2-7,CASSLENRLGTYEQYF,29,0,1,29
TRBV29-1,TRBJ2-3,CSVAGTSGEADTQYF,29,0,1,29
TRBV7-8,TRBJ1-1,CASSSTSQAYTEAFF,28,13,2,41
TRBV28,TRBJ2-1,CASSPPGLAGVYEQFF,27,7,2,34
TRBV11-2,TRBJ2-3,CASSSGTDTQYF,27,0,1,27
TRBV3-1,TRBJ2-3,CASSPLELGGADTQYF,27,45,2,72
TRBV30,TRBJ2-2,CALTKRPSENTGELFF,26,4,2,30
TRBV20-1,TRBJ2-7,CSAKFYEQYF,25,0,1,25
TRBV12-3/4,TRBJ2-5,CATVAGEDETQYF,25,8,2,33
TRBV20-1,TRBJ2-7,CSARGSQGASSSYEQYF,24,0,1,24
TRBV28,TRBJ2-2,CASSLGRDPTGELFF,24,8,2,32
TRBV28,TRBJ1-5,CASSLRDTNQPQHF,24,0,1,24
TRBV7-8,TRBJ1-5,CASSGSPLGPRDQPQHF,24,5,2,29
TRBV3-1,TRBJ1-1,CASSQGGTGLTGAFF,24,0,1,24
TRBV28,TRBJ2-3,CASSFSRVADTQYF,22,0,1,22
TRBV28,TRBJ2-2,CASGLRLAGITGELFF,22,18,2,40
TRBV6-2/3/5/6,TRBJ1-1,CASSPSANTEAFF,22,0,1,22
TRBV19,TRBJ2-3,CATSGGEVTQYF,22,0,1,22
TRBV11-2,TRBJ1-4,CASSPFAPYAHEKLFF,22,16,2,38
TRBV5-1,TRBJ1-2,CASSLDTGKGYTF,21,0,1,21
TRBV7-9,TRBJ1-1,CASSLDRVKAFF,21,0,1,21
TRBV13,TRBJ2-7,CASSLRTSGEWEQYF,21,5,2,26
TRBV5-1,TRBJ2-2,CASSLSGQSNTGELFF,20,0,1,20
TRBV19,TRBJ2-7,CASSMGGHSYEQYF,20,9,2,29
TRBV20-1,TRBJ2-3,CSARGTGLTDTQYF,20,7,2,27
TRBV11-2,TRBJ2-5,CASSLPGAGEREF,20,0,1,20
TRBV4-1,TRBJ1-1,CASSGKFTAEAFF,20,0,1,20
TRBV3-1,TRBJ2-5,CASSQDPGLAGGQETQYF,19,0,1,19
TRBV2,TRBJ1-4,CASRVYEGAVEKLFF,19,0,1,19
TRBV5-1,TRBJ2-3,CASSLAGRAADTQYF,19,0,1,19
TRBV19,TRBJ1-5,CASSIVGAFQPQHF,19,0,1,19
TRBV5-1,TRBJ1-3,CASSSSGSGNTIYF,19,0,1,19
TRBV18,TRBJ2-1,CASSPPMEQGEFF,19,0,1,19
TRBV7-3,TRBJ2-1,CASSLSGDEQFF,19,0,1,19
TRBV18,TRBJ2-1,CASSTTGYYNEQFF,19,0,1,19
TRBV5-1,TRBJ2-1,CASSLGQGAYNEQFF,19,0,1,19
TRBV3-1,TRBJ2-1,CASSQKLGAGGGYNEQFF,19,0,1,19
TRBV5-4,TRBJ1-1,CASSLGQGFDTEAFF,18,0,1,18
TRBV5-1,TRBJ2-2,CASSFSGQDGELFF,18,0,1,18
TRBV20-1,TRBJ2-2,CSAESGSWTGELFF,18,0,1,18
TRBV2,TRBJ1-1,CASSQGFGTEAFF,18,0,1,18
TRBV12-3/4,TRBJ1-1,CASSLIRGEAFF,18,0,1,18
TRBV28,TRBJ1-1,CASRTGGPEAFF,18,0,1,18
TRBV5-1,TRBJ2-1,CASSSKREAGGNSEQFF,18,5,2,23
TRBV29-1,TRBJ2-1,CSVEGLAGVYNEQFF,18,0,1,18
TRBV20-1,TRBJ2-4,CSARVPGGASKNIQYF,18,0,1,18
TRBV5-5,TRBJ1-1,CASSLVSGGYTEAFF,18,0,1,18
TRBV3-1,TRBJ2-1,CASSQVRNNEQFF,17,0,1,17
TRBV12-3/4,TRBJ1-2,CASSSSPFGYTF,17,0,1,17
TRBV28,TRBJ1-2,CASSPGSDRVSGYTF,17,0,1,17
TRBV20-1,TRBJ2-4,CSARAGTGGSNIQYF,17,0,1,17
TRBV5-1,TRBJ1-6,CASSWTGGDSPLHF,17,0,1,17
TRBV2,TRBJ2-1,CASRPLSHNSEQFF,17,0,1,17
TRBV5-6,TRBJ2-1,CASSSGQSSYNEQFF,17,0,1,17
TRBV19,TRBJ1-1,CASSISRENTEAFF,17,0,1,17
TRBV12-3/4,TRBJ2-1,CASSIDRGDGNEQFF,16,0,1,16
TRBV20-1,TRBJ2-5,CSANSRGLGETQYF,16,0,1,16
TRBV20-1,TRBJ2-3,CSVRHTDTQYF,16,0,1,16
TRBV7-8,TRBJ2-3,CASSSRRWSTDTQYF,16,0,1,16
TRBV10-1,TRBJ1-1,CASSEVGRTEAFF,16,0,1,16
TRBV12-3/4,TRBJ2-1,CASSFLGGSLSYNEQFF,16,0,1,16
TRBV3-1,TRBJ2-1,CASSPLAGGQGEQFF,16,0,1,16
TRBV29-1,TRBJ1-5,CSVAQGANNQPRHF,16,0,1,16
TRBV28,TRBJ1-1,CASSLAGSMAHETEAFF,16,0,1,16
TRBV19,TRBJ1-1,CASSIRQDSLNTEAFF,16,0,1,16
TRBV5-6,TRBJ2-6,CASSLRGSGANVLTF,16,0,1,16
TRBV19,TRBJ2-4,CASSMLGVLNIQYF,16,0,1,16
TRBV18,TRBJ1-2,CASSPPVRTYGYTF,16,0,1,16
TRBV12-3/4,TRBJ2-3,CASSAGGPTDTQYF,16,0,1,16
TRBV28,TRBJ1-5,CASSALGVQPQHF,16,0,1,16
TRBV7-3,TRBJ2-3,CASSLVATDTQYF,16,0,1,16
TRBV13,TRBJ2-4,CASSQGTANIQYF,16,6,2,22
TRBV29-1,TRBJ2-1,CSVGSGEGYEQFF,16,19,2,35
TRBV12-3/4,TRBJ2-3,CASSLLNTQYF,16,0,1,16
TRBV2,TRBJ2-2,CASSANRLAGGTGELFF,15,0,1,15
TRBV3-1,TRBJ2-3,CASSQDVGIDTDTQYF,15,0,1,15
TRBV28,TRBJ2-1,CASSQDGGAFNEQFF,15,0,1,15
TRBV6-4,TRBJ2-3,CASSGQTSGGGTQYF,15,0,1,15
TRBV7-9,TRBJ2-1,CASSLSRGRDNEQFF,15,7,2,22
TRBV11-1,TRBJ2-3,CASSRGQGTPDTQYF,15,0,1,15
TRBV11-3,TRBJ2-3,CASSPTGGADTQYF,15,0,1,15
TRBV2,TRBJ1-2,CARSGQVGYGYTF,15,0,1,15
TRBV5-1,TRBJ2-7,CASSLGTHEQYF,15,0,1,15
TRBV29-1,TRBJ2-1,CSVQEENEQFF,15,0,1,15
TRBV5-1,TRBJ2-3,CASSSLTGTVTDTQYF,15,0,1,15
TRBV2,TRBJ1-3,CASGTGGVNTIYF,15,30,2,45
TRBV5-1,TRBJ1-2,CASSGDGSYGYTF,15,0,1,15
TRBV12-3/4,TRBJ2-1,CASSLVPPGANEQFF,15,7,2,22
TRBV27,TRBJ1-1,CASSDPAYGNTEAFF,15,10,2,25
TRBV29-1,TRBJ1-1,CSVERTGAGTEAFF,15,0,1,15
TRBV20-1,TRBJ2-5,CSANRDNQETQYF,15,0,1,15
TRBV5-4,TRBJ2-7,CASSLGFGGLGSYEQYF,14,6,2,20
TRBV4-2,TRBJ2-1,CASSQDLAGGRNEQFF,14,0,1,14
TRBV2,TRBJ1-2,CASSELGGINYGYTF,14,0,1,14
TRBV30,TRBJ2-3,CAWTGVGTDTQYF,14,0,1,14
TRBV7-3,TRBJ2-3,CASSFSGGAADTQYF,14,0,1,14
TRBV3-1,TRBJ1-6,CASGQGGGGSPLHF,14,0,1,14
TRBV11-2,TRBJ1-1,CASSLDGAGAEAFF,14,0,1,14
TRBV12-3/4,TRBJ1-1,CASSHSQGWTEAFF,14,0,1,14
TRBV5-1,TRBJ2-3,CASSLEVYTDTQYF,14,0,1,14
TRBV7-8,TRBJ2-1,CASRLGAGGWYEQFF,14,0,1,14
TRBV4-1,TRBJ2-7,CASSPGTGEGYEQYF,14,3,2,17
TRBV20-1,TRBJ2-1,CSARLLAGDYNEQFF,14,0,1,14
TRBV5-1,TRBJ1-2,CASSTEQGLRGYTF,14,0,1,14
TRBV20-1,TRBJ1-3,CSARDLEGNSGNTIYF,14,0,1,14
TRBV7-8,TRBJ1-2,CASTNLGAVGYGYTF,14,6,2,20
TRBV2,TRBJ1-4,CASSEQGATNEKLFF,14,0,1,14
TRBV12-3/4,TRBJ1-2,CASRSRQYRNYGYTF,14,0,1,14
TRBV29-1,TRBJ2-5,CSVEGATPGGAAQYF,14,0,1,14
TRBV12-5,TRBJ2-2,CASGPWQLTGELFF,14,0,1,14
TRBV10-3,TRBJ1-1,CAISGEPLNTEAFF,14,0,1,14
TRBV2,TRBJ2-3,CASGGQGLGDTQYF,14,0,1,14
TRBV13,TRBJ2-5,CASSLGRQGETQYF,14,0,1,14
TRBV19,TRBJ1-2,CASMPRTPYGYTF,14,0,1,14
TRBV12-3/4,TRBJ2-7,CASSLAQGSEQYF,14,0,1,14
TRBV5-1,TRBJ2-3,CASSLGNTDTQYF,14,0,1,14
TRBV5-1,TRBJ1-1,CASSEDANTEAFF,14,0,1,14
TRBV6-2/3/5/6,TRBJ2-7,CASSSVGGEQYF,14,0,1,14
TRBV2,TRBJ2-3,CASGTGVRTGTDTQYF,14,0,1,14
TRBV10-1,TRBJ1-6,CASSDKGLSSSYNSPLHF,13,0,1,13
TRBV5-6,TRBJ2-2,CASSLFGGMSTGELFF,13,0,1,13
TRBV12-3/4,TRBJ2-3,CASSQSSGGSTDTQYF,13,0,1,13
TRBV19,TRBJ1-5,CASTINRGPNQPQHF,13,0,1,13
TRBV18,TRBJ2-6,CASSPTNSGANVLTF,13,0,1,13
TRBV12-3/4,TRBJ1-5,CASSSSDRVDQPQHF,13,0,1,13
TRBV11-2,TRBJ2-1,CASSRSGVSYNEQFF,13,0,1,13
TRBV5-5,TRBJ2-7,CASSRPGSAVDEQYF,13,3,2,16
TRBV20-1,TRBJ2-3,CSARAYTGGADTQYF,13,0,1,13
TRBV18,TRBJ2-7,CASSLNKQGNEQYF,13,0,1,13
TRBV2,TRBJ1-5,CASDQGQGGQPQHF,13,0,1,13
TRBV7-9,TRBJ1-5,CASSLGQMHQPQHF,13,5,2,18
TRBV7-3,TRBJ1-1,CASSRRQGGTEAFF,13,0,1,13
TRBV28,TRBJ2-1,CASSISGGQDEQFF,13,0,1,13
TRBV5-1,TRBJ2-3,CASKGHASTDTQYF,13,0,1,13
TRBV18,TRBJ2-3,CASSRGHTDTQYF,13,0,1,13
TRBV28,TRBJ1-2,CASSPSPHYGYTF,13,0,1,13
TRBV12-3/4,TRBJ1-3,CASRRGSGNTIYF,13,0,1,13
TRBV7-6,TRBJ2-3,CASSWGHDTQYF,13,8,2,21
TRBV5-1,TRBJ1-6,CASSSVGSPLHF,13,0,1,13
TRBV5-1,TRBJ2-7,CASRGSTYEQYF,13,0,1,13
TRBV29-1,TRBJ1-1,CSVRTGRTEAFF,13,0,1,13
TRBV29-1,TRBJ1-1,CSVGQGPTEAFF,13,0,1,13
TRBV6-2/3/5/6,TRBJ1-2,CASSPGRLYGYTF,13,0,1,13
TRBV20-1,TRBJ1-1,RSARGKINTEAFF,13,0,1,13
TRBV7-2,TRBJ1-4,CARAPPGQGVTNEKLFF,13,0,1,13
TRBV19,TRBJ1-1,CASSNLYQGVNTEAFF,13,0,1,13
TRBV2,TRBJ2-1,CASSDPPDGGAPDEQFF,13,0,1,13
TRBV6-1,TRBJ2-7,CASSEALNRGRNYEQYF,13,0,1,13
TRBV5-1,TRBJ1-1,CASSADETLEAFF,13,0,1,13
TRBV3-1,TRBJ2-3,CASSQVVVGADTQYF,13,0,1,13
TRBV19,TRBJ2-1,CASSIQGKSAQFF,13,0,1,13
TRBV11-3,TRBJ2-2,CSSSFGGELFF,13,0,1,13
TRBV28,TRBJ1-2,CASSLERGWYGYTF,12,0,1,12
TRBV29-1,TRBJ2-3,CSVAGRGGQYTQYF,12,0,1,12
TRBV5-1,TRBJ1-1,CASSPGVRGEAFF,12,0,1,12
TRBV19,TRBJ1-1,CASSIFLGRGLKGTEAFF,12,0,1,12
TRBV12-5,TRBJ2-1,CASGLASTSGTYNEQFF,12,0,1,12
TRBV19,TRBJ2-7,CASSPLGTGFSYEQYF,12,0,1,12
TRBV12-3/4,TRBJ2-7,CASSTPGTSGEYEQYF,12,0,1,12
TRBV12-3/4,TRBJ1-5,CASSLSFRGRNQPQHF,12,0,1,12
TRBV3-1,TRBJ2-5,CASSQNTGTAQETQYF,12,0,1,12
TRBV29-1,TRBJ2-3,CSVSVGLAEGTDTQYF,12,0,1,12
TRBV18,TRBJ1-1,CASSPPASRGTEAFF,12,0,1,12
TRBV5-5,TRBJ2-1,CASSAELQSYNEQFF,12,0,1,12
TRBV4-1,TRBJ1-5,CASSQGQGGNQPQHF,12,0,1,12
TRBV29-1,TRBJ2-7,CSVEAAGTGAMGQYF,12,0,1,12
TRBV19,TRBJ2-3,CATTDTSSTDTQYF,12,0,1,12
TRBV19,TRBJ1-1,CASSTADYNTEAFF,12,0,1,12
TRBV19,TRBJ2-1,CASRGTAAYNEQFF,12,0,1,12
TRBV19,TRBJ1-4,CASNQGLTNEKLFF,12,0,1,12
TRBV18,TRBJ1-1,CASSPPLGNTEAFF,12,0,1,12
TRBV5-6,TRBJ1-4,CASTVGSEGEKLFF,12,0,1,12
TRBV5-1,TRBJ1-4,CASSSTGGPEKLFF,12,0,1,12
TRBV5-1,TRBJ1-1,CASSYAGRNTEAFF,12,0,1,12
TRBV29-1,TRBJ2-5,CSLLGLAGQETQYF,12,0,1,12
TRBV12-3/4,TRBJ1-5,CASSTGYGQPQHF,12,0,1,12
TRBV18,TRBJ2-2,CASRQGNTGELFF,12,0,1,12
TRBV7-3,TRBJ1-2,CASSSGQSYGYTF,12,0,1,12
TRBV29-1,TRBJ2-5,CSVRQGAQETQYF,12,7,2,19
TRBV7-2,TRBJ1-2,CASSPLPYGYTF,12,0,1,12
TRBV20-1,TRBJ2-3,CSARASTDTQYF,12,0,1,12
TRBV18,TRBJ1-4,CASSPYPAPATNEKLFF,12,0,1,12
TRBV12-3/4,TRBJ2-2,CASSLDRGENTGELFF,12,0,1,12
TRBV7-3,TRBJ1-1,CASRRDRVNTEAFF,12,0,1,12
TRBV18,TRBJ1-1,CASSLPRAGVNTEAFF,12,0,1,12
TRBV12-3/4,TRBJ1-1,CASLKRDANTGAFF,12,0,1,12
TRBV6-2/3/5/6,TRBJ2-7,CASSYSEPADQKTGYEQYF,11,0,1,11
TRBV7-3,TRBJ1-1,CASSLKGIHGGGTEAFF,11,18,2,29
TRBV4-2,TRBJ2-1,CASSQDPGSGGNEQFF,11,0,1,11
TRBV20-1,TRBJ1-4,CSARDSGTGREKLFF,11,0,1,11
TRBV3-1,TRBJ2-5,CASSFSTSEETQYF,11,6,2,17
TRBV5-1,TRBJ1-2,CASSLAETDYGYTF,11,0,1,11
TRBV11-2,TRBJ2-1,CASSQGTNLKQFF,11,0,1,11
TRBV7-2,TRBJ2-1,CASSFVIQLAAGVEQFF,11,0,1,11
TRBV10-1,TRBJ2-3,CASSDDTGTGRADTQYF,11,0,1,11
TRBV12-3/4,TRBJ2-2,CASSPTRRSNTGELFF,11,0,1,11
TRBV4-2,TRBJ2-2,CASSQDGLTRAGELFF,11,2,2,13
TRBV18,TRBJ1-2,CASSPGTGSDDGYTF,11,0,1,11
TRBV2,TRBJ2-7,CASIPIRGAVDEQYF,11,0,1,11
TRBV3-1,TRBJ2-2,CASTFRQGDTGELFF,11,0,1,11
TRBV6-2/3/5/6,TRBJ2-3,CASSYGTGIPDTQYF,11,0,1,11
TRBV2,TRBJ2-7,CASSGVQGSAYEQYF,11,0,1,11
TRBV6-2/3/5/6,TRBJ1-2,CASSPTELTGRGYTF,11,12,2,23
TRBV3-1,TRBJ1-5,CASSQDGVRNQPQHF,11,0,1,11
TRBV5-1,TRBJ2-1,CASSTYKSSYNEQFF,11,0,1,11
TRBV20-1,TRBJ2-4,CSASAPRDIKNIQYF,11,0,1,11
TRBV19,TRBJ1-2,CASSGTGLSRGYTF,11,0,1,11
TRBV19,TRBJ1-1,CASKGTGGNTEAFF,11,0,1,11
TRBV18,TRBJ1-1,CASSPRQSNTEAFF,11,0,1,11
TRBV18,TRBJ2-1,CASVGTHRDIEQFF,11,0,1,11
TRBV12-3/4,TRBJ1-1,CASSLAQGSTEAFF,11,0,1,11
TRBV28,TRBJ1-2,CASSYTGAGYGYTF,11,0,1,11
TRBV12-3/4,TRBJ2-5,CASSPRDGQETQYF,11,0,1,11
TRBV5-5,TRBJ1-6,CASSLEDRGSPLHF,11,0,1,11
TRBV6-2/3/5/6,TRBJ2-7,CASSSFLVSYEQYF,11,0,1,11
TRBV3-1,TRBJ1-3,CASSQVDSGNTIYF,11,0,1,11
TRBV2,TRBJ2-3,CASRRDRSTDTQYF,11,0,1,11
TRBV5-1,TRBJ2-7,CASSLRAGGDEQYF,11,0,1,11
TRBV5-1,TRBJ1-1,CASSWQAMNTEAFF,11,0,1,11
TRBV5-1,TRBJ1-2,CASSYTGANYGYTF,11,0,1,11
TRBV29-1,TRBJ1-1,CSVAGTALNTEAFF,11,0,1,11
TRBV29-1,TRBJ1-4,CSAEVAGGNENLFF,11,0,1,11
TRBV24-1,TRBJ2-2,YATSGTENTGELFF,11,0,1,11
TRBV28,TRBJ1-2,CATPSGGVYGYTF,11,0,1,11
TRBV19,TRBJ1-6,CASIGQYNSPLHF,11,0,1,11
TRBV19,TRBJ1-2,CASNRDKMHGYTF,11,0,1,11
TRBV28,TRBJ2-5,CASGGTGVETQYF,11,0,1,11
TRBV28,TRBJ2-5,CASSFTALETQYF,11,0,1,11
TRBV27,TRBJ1-1,CASSIGENTEAFF,11,0,1,11
TRBV7-2,TRBJ1-5,CASSLGSYQPQHF,11,0,1,11
TRBV7-3,TRBJ2-5,CASSSGPQETQYF,11,0,1,11
TRBV9,TRBJ2-7,CASSGTGRYEQYF,11,0,1,11
TRBV2,TRBJ2-3,CASRAERTDTQYF,11,0,1,11
TRBV20-1,TRBJ2-5,CSVVAGSPETQYF,11,0,1,11
TRBV29-1,TRBJ1-1,CSVDRGLNTEAFF,11,0,1,11
TRBV12-3/4,TRBJ2-1,CASSLQVGEQFF,11,0,1,11
TRBV12-3/4,TRBJ1-3,CASSRGGNTIYF,11,0,1,11
TRBV29-1,TRBJ2-3,CSVRGAADTQYF,11,0,1,11
TRBV19,TRBJ1-5,CASILKQPQHF,11,5,2,16
TRBV6-2/3/5/6,TRBJ2-3,CASSRDTQYF,11,0,1,11
TRBV18,TRBJ2-7,CASSPPGGILYEQYF,11,0,1,11
TRBV6-1,TRBJ2-3,CASRNIAGGTDTQYF,11,0,1,11
TRBV5-1,TRBJ2-3,CASSLPLAGADTQYF,11,0,1,11
TRBV5-1,TRBJ1-1,CASSPGNPGQMGAFF,11,0,1,11
TRBV6-1,TRBJ1-3,CASTGRWGGNTIYF,11,0,1,11
TRBV29-1,TRBJ1-1,CSVVQGPEAFF,11,0,1,11
TRBV5-1,TRBJ1-6,CASSIQTGTPNSPLHF,11,0,1,11
TRBV12-3/4,TRBJ2-3,CASSFRQYTDTQYF,11,0,1,11
TRBV7-2,TRBJ2-1,CASSLWGAINEQFF,11,0,1,11
TRBV7-8,TRBJ2-6,CASSLATGANVLTF,11,0,1,11
TRBV7-6,TRBJ2-2,CASSFEASGRWTGELFF,11,0,1,11
TRBV20-1,TRBJ2-3,CSAPAGGYTDTQYF,11,0,1,11
TRBV5-4,TRBJ2-3,CASSRTSGGPKDTQYF,11,0,1,11
TRBV5-1,TRBJ2-7,CASSPDHYEQYF,11,0,1,11
TRBV6-2/3/5/6,TRBJ2-3,CASSYWSHLEPTDTQYF,11,0,1,11
TRBV7-2,TRBJ2-3,CASSLEGRGGTDTQYF,11,4,2,15
TRBV5-1,TRBJ1-6,CASSRSESSYNSPLHF,11,0,1,11
TRBV11-2,TRBJ1-1,CASSLIGEERAEAFF,11,0,1,11
TRBV4-1,TRBJ2-1,CASSRPGQGYNEQFF,11,0,1,11
TRBV3-1,TRBJ2-1,CASSQGTTSNEQFF,11,3,2,14
TRBV5-1,TRBJ2-6,CASSDGSGANVLTF,11,0,1,11
TRBV20-1,TRBJ2-5,CSARRLGGQETQYF,11,0,1,11
TRBV12-3/4,TRBJ1-6,CASSHWRFDGRNSPLHHHLHF,11,0,1,11
TRBV30,TRBJ1-5,CAWSGGPHQPQHF,10,6,2,16
TRBV6-2/3/5/6,TRBJ2-3,CASSQDSDTQYF,10,0,1,10
TRBV19,TRBJ1-2,CASSMGGHGDNNYGYTF,10,0,1,10
TRBV19,TRBJ1-5,CASRRQGGGWGNQPQHF,10,0,1,10
TRBV28,TRBJ1-2,CASQHGRGRGANYGYTF,10,0,1,10
TRBV28,TRBJ2-3,CASSLLLAGTDTDTQYF,10,0,1,10
TRBV6-2/3/5/6,TRBJ1-5,CASSRSADRAGGQPQHF,10,0,1,10
TRBV7-9,TRBJ2-6,CASSLLGAVSGANVLTF,10,0,1,10
TRBV11-2,TRBJ1-2,CASSLPRGGRSNYGYTF,10,0,1,10
TRBV3-1,TRBJ2-3,CASSPKTGQDPWDTQYF,10,0,1,10
TRBV28,TRBJ1-1,CASSRIQGAISGTEAFF,10,0,1,10
TRBV28,TRBJ2-1,CASSLIWGSSYNEQFF,10,4,2,14
TRBV6-2/3/5/6,TRBJ1-2,CASSSGTGVPGGGYTF,10,0,1,10
TRBV28,TRBJ2-6,CASSSGQLSGANVLTF,10,0,1,10
TRBV11-2,TRBJ2-3,CASSLDTSGVTDTQYF,10,0,1,10
TRBV7-3,TRBJ2-1,CASSLKGLGLRNEQFF,10,0,1,10
TRBV11-2,TRBJ1-1,CASSSQFGDLNTEAFF,10,0,1,10
TRBV5-6,TRBJ1-4,CASSRIDRATNEKLFF,10,0,1,10
TRBV3-1,TRBJ2-1,CASSHFTGSSYNEQFF,10,0,1,10
TRBV3-1,TRBJ2-1,CASSQAGGDAYNEQFF,10,0,1,10
TRBV7-9,TRBJ2-1,CASSDKGRGPYNEQFF,10,0,1,10
TRBV5-1,TRBJ2-3,CASSLGGGPRADTQYF,10,0,1,10
TRBV20-1,TRBJ1-6,CSATGTGGDTNSPLHF,10,0,1,10
TRBV20-1,TRBJ2-3,CSARLSKRGARDTQYF,10,0,1,10
TRBV29-1,TRBJ2-1,CSVERLAGAPYNEQFF,10,0,1,10
TRBV18,TRBJ2-1,CASSPGQGAYNEQFF,10,0,1,10
TRBV2,TRBJ2-7,CASTNRGGGGYEQYF,10,0,1,10
TRBV2,TRBJ1-5,CASSNRVGRYQPQHF,10,0,1,10
TRBV3-1,TRBJ1-2,CASSPTGARNYGYTF,10,0,1,10
TRBV5-4,TRBJ2-3,CASSRGKYFTDTQYF,10,0,1,10
TRBV19,TRBJ2-7,CARRPKGGFSYEQYF,10,0,1,10
TRBV4-1,TRBJ1-4,CASSQPDREREKLFF,10,0,1,10
TRBV4-1,TRBJ1-2,CASSQDLDRNYGYTF,10,0,1,10
TRBV5-1,TRBJ2-1,CASSKLAGEHDEQFF,10,2,2,12
TRBV10-1,TRBJ1-2,CASRAGGGGADGYTF,10,0,1,10
TRBV29-1,TRBJ2-1,CSVGTRLSVYNEQFF,10,0,1,10
TRBV3-1,TRBJ1-3,CAGRPTGSGNTIYF,10,0,1,10
TRBV18,TRBJ1-1,CASSPSMVNTEAFF,10,0,1,10
TRBV12-3/4,TRBJ2-3,CASTWGLAGDTQYF,10,0,1,10
TRBV27,TRBJ2-5,CASSFQGAGETQYF,10,0,1,10
TRBV12-3/4,TRBJ1-2,CASSLQGLNYGYTF,10,0,1,10
TRBV12-3/4,TRBJ2-1,CASSLGGAVNEQFF,10,0,1,10
TRBV12-3/4,TRBJ2-3,CASSVGGASDTQYF,10,0,1,10
TRBV7-2,TRBJ1-3,CASSLGTVGNTIYF,10,0,1,10
TRBV7-2,TRBJ2-7,CASSPGTQSYEQYF,10,0,1,10
TRBV3-1,TRBJ1-1,CASSQEGRVGPAFF,10,0,1,10
TRBV9,TRBJ1-2,CASSVEPNDYGYTF,10,0,1,10
TRBV7-9,TRBJ1-6,CASSRGQEISPLHF,10,0,1,10
TRBV10-2,TRBJ2-1,CASRLAGGGNEQFF,10,0,1,10
TRBV20-1,TRBJ2-7,CSARRGHLGDEQYF,10,0,1,10
TRBV29-1,TRBJ2-5,CSRRLAGIQETQYF,10,0,1,10
TRBV29-1,TRBJ2-3,CSVLGTIHTDTQYF,10,0,1,10
TRBV29-1,TRBJ2-4,CSVAQGGAKNIQYF,10,0,1,10
TRBV29-1,TRBJ1-5,CSVEEGRRNQPQHF,10,0,1,10
TRBV29-1,TRBJ2-7,CSVAQGLGSREQYF,10,0,1,10
TRBV5-6,TRBJ1-2,YASTRDYRGYGYTF,10,0,1,10
TRBV12-3/4,TRBJ1-1,CASLLTQGSEAFF,10,0,1,10
TRBV19,TRBJ1-1,CASRGQGVTEAFF,10,0,1,10
TRBV18,TRBJ2-1,CASSPYSDNEQFF,10,0,1,10
TRBV28,TRBJ2-4,CASSSVAKNIQYF,10,0,1,10
TRBV2,TRBJ2-1,CASSEEQYNEQFF,10,0,1,10
TRBV7-9,TRBJ2-1,CASSLLGVNEQFF,10,0,1,10
TRBV7-9,TRBJ2-5,CASSSPGGETQYF,10,4,2,14
TRBV12-3/4,TRBJ1-1,CASSWGRHTEAFF,10,0,1,10
TRBV3-1,TRBJ2-7,CASSRHLDYEQYF,10,0,1,10
TRBV5-6,TRBJ2-3,CASSGLVADTQYF,10,0,1,10
TRBV11-3,TRBJ2-2,CASSTRDPGELFF,10,4,2,14
TRBV12-3/4,TRBJ2-5,CASRQQGQETQYF,10,0,1,10
TRBV5-1,TRBJ2-2,CASSFGSTGELFF,10,0,1,10
TRBV5-1,TRBJ2-2,CASSLRGTGELFF,10,0,1,10
TRBV29-1,TRBJ1-1,CSVQGRGHTEAFF,10,0,1,10
TRBV29-1,TRBJ1-1,CSGSTGGRTEAFF,10,0,1,10
TRBV6-2/3/5/6,TRBJ1-2,CASYGGNYGYTF,10,0,1,10
TRBV12-3/4,TRBJ1-1,CASSYDLREAFF,10,0,1,10
TRBV2,TRBJ2-2,CASSEVGGELFF,10,0,1,10
TRBV28,TRBJ2-7,CASRTTSYEQYF,10,0,1,10
TRBV20-1,TRBJ1-5,CSAFKTPWPQHF,10,0,1,10
TRBV19,TRBJ2-7,CASSTGQLQYF,10,0,1,10
TRBV29-1,TRBJ1-1,CSVGVDRAFF,10,0,1,10
TRBV18,TRBJ1-5,CASSPPGGYSNQPQHF,10,0,1,10
TRBV2,TRBJ1-6,CASREVQLQGSSPLHF,10,0,1,10
TRBV29-1,TRBJ2-3,CSVPGNSGGGADTQYF,10,2,2,12
TRBV11-2,TRBJ2-5,CASSGQGSEETQYF,10,0,1,10
TRBV18,TRBJ2-6,CASSPNPDGSLEGANVLTF,10,0,1,10
TRBV11-2,TRBJ1-6,CASSFNPQGGSSLHF,10,0,1,10
TRBV5-1,TRBJ1-1,CASSFRTGNTEAFF,10,0,1,10
TRBV7-2,TRBJ2-3,CASSLIGGRTDTQYF,10,0,1,10
TRBV25-1,TRBJ2-3,CASSQSGTGITDTQYF,10,0,1,10
TRBV5-4,TRBJ1-2,CASSRGDRWLNYGYTF,10,0,1,10
TRBV28,TRBJ1-5,CASRPAGVGNQPQHF,10,0,1,10
TRBV11-2,TRBJ2-1,CASSLDIVGDKDGIF,10,0,1,10
TRBV29-1,TRBJ1-1,CSVELGTEAFF,10,0,1,10
TRBV28,TRBJ2-5,CASSLSLLAGVPPQETQYF,9,0,1,9
TRBV12-5,TRBJ1-1,CASGPDQRGPLNTEAFF,9,0,1,9
TRBV18,TRBJ2-5,CASSPPLAGDRKETQYF,9,7,2,16
TRBV12-3/4,TRBJ1-4,CASSLENKPGRNEKLFF,9,0,1,9
TRBV27,TRBJ2-6,CASSSPQGAGGANVLTF,9,9,2,18
TRBV11-2,TRBJ2-3,CASSFFTGGASTDTQYF,9,0,1,9
TRBV5-4,TRBJ2-5,CASRQGGRGGIQETQYF,9,0,1,9
TRBV5-1,TRBJ1-3,CASSPGDESYSGNTIYF,9,8,2,17
TRBV18,TRBJ1-6,CASSPSQGGNNSPLHF,9,0,1,9
TRBV6-2/3/5/6,TRBJ2-6,CASSSQGRSGANVLTF,9,0,1,9
TRBV6-1,TRBJ2-3,CASSGIGLTIADTQYF,9,0,1,9
TRBV5-6,TRBJ2-7,CASSLDRGVFSYEQYF,9,0,1,9
TRBV11-1,TRBJ1-1,CASSYITGGASTEAFF,9,0,1,9
TRBV5-6,TRBJ1-5,CASSYTGRGSDQPQHF,9,0,1,9
TRBV28,TRBJ2-7,CASSLSGGTGGYEQYF,9,0,1,9
TRBV7-2,TRBJ2-3,CASSLRRRASTDTQYF,9,0,1,9
TRBV7-9,TRBJ2-7,CASSHTPGTGGYEQYF,9,11,2,20
TRBV5-6,TRBJ2-7,CASSEPALGGTPEQYF,9,0,1,9
TRBV30,TRBJ2-1,CAWSPDYRGNNEQFF,9,0,1,9
TRBV18,TRBJ2-7,CASLLGGAVSYEQYF,9,0,1,9
TRBV18,TRBJ1-6,CASSLTGTANSPLHF,9,0,1,9
TRBV2,TRBJ2-5,CASDEGSDRGETQYF,9,0,1,9
TRBV28,TRBJ1-6,CASSFLQLFHSPLHF,9,0,1,9
TRBV2,TRBJ2-5,CASSFARGRGETQYF,9,0,1,9
TRBV12-3/4,TRBJ2-6,CASSLFGPGANVLTF,9,0,1,9
TRBV28,TRBJ1-2,CASSLGTSGFNGYTF,9,0,1,9
TRBV6-2/3/5/6,TRBJ1-1,CASSLNRGMNTEAFF,9,0,1,9
TRBV28,TRBJ2-3,CASSPYMVSADTQYF,9,0,1,9
TRBV2,TRBJ1-5,CASSVEGGTNQPQHF,9,0,1,9
TRBV2,TRBJ1-2,CASSEVQGADYGYTF,9,0,1,9
TRBV2,TRBJ1-6,CASSEFYGGNSPLHF,9,0,1,9
TRBV28,TRBJ1-5,CASSTGVNSNQPQHF,9,0,1,9
TRBV7-8,TRBJ1-2,CASSLARTGAGGYTF,9,0,1,9
TRBV7-2,TRBJ2-3,CASSSDRLSTDTQYF,9,0,1,9
TRBV14,TRBJ2-7,CASSLVRDPPDEQYF,9,0,1,9
TRBV3-1,TRBJ2-1,CASSPLAGASIEQFF,9,0,1,9
TRBV3-1,TRBJ2-5,CASSQWDSSSETQYF,9,0,1,9
TRBV5-1,TRBJ2-2,CASTTGAANTGELFF,9,0,1,9
TRBV10-2,TRBJ2-5,CASSERGFGQETQYF,9,0,1,9
TRBV5-1,TRBJ2-6,CASSFSGTGANVLTF,9,0,1,9
TRBV5-1,TRBJ2-5,CASSLAGGEQETQYF,9,0,1,9
TRBV5-1,TRBJ2-1,CASSLGGNTYNEQFF,9,0,1,9
TRBV20-1,TRBJ2-5,CSAGITGGAGETQYF,9,0,1,9
TRBV20-1,TRBJ2-7,CSASSGTVDSYEQYF,9,0,1,9
TRBV20-1,TRBJ1-6,CSARPETRTNSPLHF,9,2,2,11
TRBV20-1,TRBJ1-6,CSARDFGQLNSPLHF,9,4,2,13
TRBV20-1,TRBJ2-3,CSARDGTSPTDTQYF,9,0,1,9
TRBV20-1,TRBJ2-1,CSAHGGRQNYNEQFF,9,0,1,9
TRBV20-1,TRBJ2-7,CSAIRLGGGSYEQYF,9,6,2,15
TRBV29-1,TRBJ1-2,CSVEVLKRGLYRYTF,9,0,1,9
TRBV28,TRBJ1-6,CATAAPGGDSPLHF,9,0,1,9
TRBV19,TRBJ2-1,CASSDMIPYNEQFF,9,0,1,9
TRBV19,TRBJ2-3,CASSTGTSADTQYF,9,0,1,9
TRBV18,TRBJ2-3,CASSPLGGTDTQYF,9,0,1,9
TRBV18,TRBJ2-5,CASSPQQGRETQYF,9,0,1,9
TRBV7-9,TRBJ1-6,CASAGNGLNSPLHF,9,0,1,9
TRBV2,TRBJ2-2,CASTGGPTTGELFF,9,0,1,9
TRBV2,TRBJ2-7,CASSSGTDNYEQYF,9,0,1,9
TRBV2,TRBJ2-1,CASSEARSGGLGFF,9,0,1,9
TRBV2,TRBJ2-2,CASSRETNTGELFF,11,0,1,11
TRBV7-9,TRBJ2-7,CASSFVARTYEQYF,9,0,1,9
TRBV7-2,TRBJ2-3,CASSLTGGLDTQYF,9,0,1,9
TRBV12-3/4,TRBJ2-7,CASSPLGLSYEQYF,9,0,1,9
TRBV28,TRBJ1-5,CASSPGQGRQPQHF,9,0,1,9
TRBV7-2,TRBJ2-3,CASSPEPSTDTQYF,9,0,1,9
TRBV11-2,TRBJ2-7,CASSRAWRVGEQYF,9,0,1,9
TRBV3-1,TRBJ2-7,CASSQGGRSYEQYF,9,0,1,9
TRBV7-9,TRBJ2-7,CASRDGTGTQRQYF,9,0,1,9
TRBV5-1,TRBJ1-1,CASSLLEGLTEAFF,9,0,1,9
TRBV5-1,TRBJ2-3,CASSLAQGTDTQYF,9,0,1,9
TRBV20-1,TRBJ2-3,CSVKSGTTQDTQYF,9,2,2,11
TRBV20-1,TRBJ2-1,CSARIAGGNNEQFF,9,0,1,9
TRBV20-1,TRBJ2-1,CSAIRGSSYNEQFF,9,0,1,9
TRBV29-1,TRBJ1-1,CSVGQGASDTEAFF,9,0,1,9
TRBV29-1,TRBJ1-2,CSVDGAGAPFGYTF,9,0,1,9
TRBV15,TRBJ2-3,CATSRKSTDTQYF,9,0,1,9
TRBV18,TRBJ1-2,CASSPPQGFGYTF,9,0,1,9
TRBV12-3/4,TRBJ2-2,CASSFRATGELFF,9,0,1,9
TRBV28,TRBJ2-7,CASSLGGGYEQYF,14,0,1,14
TRBV28,TRBJ2-1,CASSSHDTMGMFF,9,0,1,9
TRBV6-2/3/5/6,TRBJ1-6,CASSYYYNSPLHF,9,0,1,9
TRBV12-3/4,TRBJ1-1,CASSLLDQAEAFF,9,0,1,9
TRBV11-2,TRBJ1-1,CASSFGAAGRAFF,9,0,1,9
TRBV5-6,TRBJ1-2,CASSLVAVGGYTF,9,0,1,9
TRBV12-3/4,TRBJ2-7,CASSSGPRDEQYF,9,0,1,9
TRBV3-1,TRBJ1-5,CASSPNPISPQHF,9,0,1,9
TRBV11-1,TRBJ1-6,CASSDGWDSPLHF,9,0,1,9
TRBV5-1,TRBJ1-5,CASTGQGDQPQHF,9,0,1,9
TRBV5-1,TRBJ2-1,CASSLVKYNEQFF,9,0,1,9
TRBV5-1,TRBJ2-1,CASSQGNYNEQFF,9,0,1,9
TRBV20-1,TRBJ1-5,CSVDTGGGQPQHF,9,0,1,9
TRBV20-1,TRBJ2-7,CSARQGALNEQYF,9,0,1,9
TRBV20-1,TRBJ2-5,CSATPGQRETQYF,9,0,1,9
TRBV29-1,TRBJ1-2,CSVTEGGDYGYTF,9,0,1,9
TRBV29-1,TRBJ2-7,CSAGTSGGIEQYF,9,0,1,9
TRBV30,TRBJ2-5,CAWKIAGETQYF,9,0,1,9
TRBV12-3/4,TRBJ2-1,CASSSRDNEQFF,9,0,1,9
TRBV5-5,TRBJ2-3,CASSGTSDTQYF,9,4,2,13
TRBV20-1,TRBJ1-5,CSALDLSGPQHF,9,0,1,9
TRBV20-1,TRBJ2-3,CSASGGAWTQYF,9,0,1,9
TRBV6-2/3/5/6,TRBJ2-7,CASSNPGTEYF,9,0,1,9
TRBV7-9,TRBJ2-1,CASSPYNEQFF,9,0,1,9
TRBV29-1,TRBJ2-4,CSVFRENIQYF,9,2,2,11
TRBV29-1,TRBJ1-1,CSVGNTEAFF,9,0,1,9
TRBV29-1,TRBJ2-5,CSVSVETQYF,9,2,2,11
TRBV19,TRBJ1-4,PGSENEKLFF,9,0,1,9
TRBV11-2,TRBJ1-1,CASSLRITTGNAYMNTEAFF,9,0,1,9
TRBV15,TRBJ2-3,CATSRDPRAEDTQYF,9,0,1,9
TRBV3-1,TRBJ2-7,CASSPELAASYEQYF,9,0,1,9
TRBV5-1,TRBJ1-1,CASSLAGTGETEAFF,9,0,1,9
TRBV4-1,TRBJ2-1,CASSPTSGEYNEQFF,9,8,2,17
TRBV7-2,TRBJ2-1,CASSLASGGGEQFF,9,0,1,9
TRBV4-1,TRBJ2-7,CASSPRDGAPEQYF,9,0,1,9
TRBV6-2/3/5/6,TRBJ2-3,CASSSGQGPQYF,9,0,1,9
TRBV2,TRBJ1-1,CASFKEMNTEAFF,9,0,1,9
TRBV5-6,TRBJ2-1,CASSSPTGTSGTPWNEQFF,9,0,1,9
TRBV3-1,TRBJ1-5,CASSQDRPGGGQPQHF,9,0,1,9
TRBV28,TRBJ1-4,CASAQPGQGIEKLFF,9,0,1,9
TRBV7-9,TRBJ2-2,CASSLGRDREVELFF,9,0,1,9
TRBV20-1,TRBJ2-3,CSASLPGAATDTQYF,9,0,1,9
TRBV29-1,TRBJ1-1,CSVVRGTGGEPAFF,9,0,1,9
TRBV7-3,TRBJ2-7,CASSRGEAYEQYF,9,0,1,9
TRBV5-1,TRBJ2-2,CASSKLQGIGELFF,9,0,1,9
TRBV7-9,TRBJ1-2,CASSFPGFAGYTF,9,0,1,9
TRBV6-4,TRBJ2-3,CASSELGGPTSGGHTDTQYF,8,7,2,15
TRBV12-5,TRBJ2-2,CASGFFRDTGLFNTGELFF,8,0,1,8
TRBV7-3,TRBJ1-2,CASSLREPGQKYFNYGYTF,8,0,1,8
TRBV4-2,TRBJ1-5,CASSQGLGTGPYSNQPQHF,8,2,2,10
TRBV19,TRBJ1-5,CASTPFPQGLRGNQPQHF,8,0,1,8
TRBV3-1,TRBJ1-1,CASSQDPRKTLMNTEAFF,8,0,1,8
TRBV3-1,TRBJ2-2,CASSQGVGLATYTGELFF,8,0,1,8
TRBV9,TRBJ1-6,CASSGHPDRGVYNSPLHF,8,0,1,8
TRBV6-2/3/5/6,TRBJ2-3,CASSYGHRVRDTDTQYF,8,0,1,8
TRBV12-3/4,TRBJ2-3,CASSPEGAGALTDTQYF,8,0,1,8
TRBV27,TRBJ1-1,CASSPRQGALINTEAFF,8,0,1,8
TRBV12-3/4,TRBJ1-5,CASSTLRQLLSNQPQHF,8,0,1,8
TRBV5-6,TRBJ2-4,CASSSPGGRGAKNIQYF,8,0,1,8
TRBV9,TRBJ2-1,CASSGTSGTNSYNEQFF,8,0,1,8
TRBV6-2/3/5/6,TRBJ2-5,CASRAILIQRGRETQYF,8,0,1,8
TRBV5-1,TRBJ2-5,CASSLGTSGGHQETQYF,8,0,1,8
TRBV29-1,TRBJ2-1,CSVAHRDRGTPYNEQFF,8,0,1,8
TRBV30,TRBJ2-6,CAWSRVRSSGANVLTF,8,0,1,8
TRBV15,TRBJ2-1,CATSRDLAGGYNEQFF,8,0,1,8
TRBV7-3,TRBJ2-2,CASSPPGGRQSGELFF,8,0,1,8
TRBV28,TRBJ2-6,CASIPVGSSGANVLTF,8,0,1,8
TRBV28,TRBJ2-6,CASSFGRFSGANVLTF,8,0,1,8
TRBV12-3/4,TRBJ2-7,CASSLWVGQGSYEQYF,8,0,1,8
TRBV2,TRBJ2-2,CASSDWRLAGTGELFF,8,0,1,8
TRBV5-6,TRBJ2-1,CASSLAQGEAYNEQFF,8,0,1,8
TRBV5-4,TRBJ1-2,CASSLAGNRANYGYTF,8,0,1,8
TRBV5-4,TRBJ2-1,CASSLTTGPRGNEQFF,8,0,1,8
TRBV13,TRBJ2-3,CASSLGSASVADTQYF,8,0,1,8
TRBV7-3,TRBJ2-1,CASSPSPAGGPYEQFF,8,0,1,8
TRBV7-3,TRBJ2-5,CASSPRTSGAQETQYF,8,0,1,8
TRBV2,TRBJ2-3,CASRLQLAGPTDTQYF,8,0,1,8
TRBV5-1,TRBJ2-7,CASSLGTNIPPYEQYF,8,0,1,8
TRBV4-1,TRBJ2-7,CASSPAGDHPFYEQYF,8,0,1,8
TRBV20-1,TRBJ2-7,CSARGSSTGSSYEQYF,8,14,2,22
TRBV29-1,TRBJ2-2,CSVAAPTGVDTGELFF,8,0,1,8
TRBV10-3,TRBJ1-1,CAIRRQGDMNTEAFF,8,0,1,8
TRBV19,TRBJ1-1,CASSDRSAGNTEAFF,8,0,1,8
TRBV19,TRBJ1-5,CASSMGHISNQPQHF,8,0,1,8
TRBV18,TRBJ2-7,CASSSNRDQTYEQYF,8,0,1,8
TRBV28,TRBJ1-6,CASWGGQGRNSPLHF,8,0,1,8
TRBV12-3/4,TRBJ2-5,CASTPIGTDKETQYF,8,0,1,8
TRBV2,TRBJ1-2,CASTNPYGGPYGYTF,8,0,1,8
TRBV3-1,TRBJ2-3,CASSSRDRGTDTQYF,8,0,1,8
TRBV6-2/3/5/6,TRBJ1-3,CASSYDGRSGNTIYF,8,0,1,8
TRBV11-3,TRBJ2-1,CASSQRQDDYNEQFF,8,0,1,8
TRBV2,TRBJ2-2,CASSVYRQTTGELFF,8,0,1,8
TRBV6-1,TRBJ2-5,CASSEFRGGRETQYF,8,0,1,8
TRBV7-9,TRBJ1-4,CASSLDRGADEKLFF,8,0,1,8
TRBV11-2,TRBJ2-7,CASSSLTGTPREQYF,8,0,1,8
TRBV11-1,TRBJ2-7,CASSSGTGLSYEQYF,8,0,1,8
TRBV7-3,TRBJ2-7,CASSYGELRPYEQYF,8,0,1,8
TRBV12-3/4,TRBJ1-2,CASSLGREVNYGYTF,8,0,1,8
TRBV28,TRBJ1-1,CASSLTLRRNTEAFF,8,0,1,8
TRBV7-6,TRBJ1-4,CASSPGGTGNEKLFF,8,0,1,8
TRBV28,TRBJ2-5,CASSRDGTGKETQYF,8,0,1,8
TRBV7-3,TRBJ2-3,CASSRTGLSTDTQYF,8,0,1,8
TRBV3-1,TRBJ2-1,CASSHATRSYNEQFF,8,0,1,8
TRBV3-1,TRBJ2-2,CASSQQQGSNGELFF,8,0,1,8
TRBV3-1,TRBJ2-1,CASSQGTGPRNEQFF,8,0,1,8
TRBV3-1,TRBJ2-3,CASSQDLGPPDTQYF,8,0,1,8
TRBV10-2,TRBJ2-1,CASSEVVASYNEQFF,8,0,1,8
TRBV5-1,TRBJ1-5,CASSLHTGVDQPQHF,8,0,1,8
TRBV20-1,TRBJ2-7,CSASSPGLARYEQYF,8,0,1,8
TRBV20-1,TRBJ2-2,CSARASSLDTGELFF,8,0,1,8
TRBV29-1,TRBJ2-5,CSVALGTGGGETQYF,8,0,1,8
TRBV29-1,TRBJ1-1,CSVGGSLRGNTEAFF,8,0,1,8
TRBV29-1,TRBJ1-1,CSVDITGATYTEAFF,8,0,1,8
TRBV29-1,TRBJ1-3,CSVTGAGNGGNTIYF,8,0,1,8
TRBV10-3,TRBJ2-1,CAISAFATENEQFF,8,0,1,8
TRBV19,TRBJ2-7,CASSLQGDLYEQYF,8,0,1,8
TRBV19,TRBJ1-2,CASSPQVTNYGYTF,8,0,1,8
TRBV18,TRBJ2-3,CASSPLDKVDAQYF,8,0,1,8
TRBV18,TRBJ2-3,CASSPARSTDTQYF,8,0,1,8
TRBV2,TRBJ2-5,CASGDYRVGETQYF,8,0,1,8
TRBV12-3/4,TRBJ1-5,CASGTQGGNQPQHF,8,0,1,8
TRBV12-3/4,TRBJ1-6,CASSFTGGDSPLHF,8,0,1,8
TRBV28,TRBJ1-5,CASSFSRVAQPQHF,8,0,1,8
TRBV28,TRBJ2-5,CASSRLAGRETQYF,8,0,1,8
TRBV2,TRBJ1-5,CASSARNLNQPQHF,8,0,1,8
TRBV5-4,TRBJ2-3,CASSLQGSTDTQYF,8,0,1,8
TRBV5-5,TRBJ1-5,CASSLDQVLQPQHF,8,0,1,8
TRBV13,TRBJ2-7,CASSLAGDPPEQYF,8,0,1,8
TRBV7-9,TRBJ1-1,CASSWEAGNTEAFF,8,0,1,8
TRBV5-6,TRBJ2-1,CASSPKVSYNEQFF,8,0,1,8
TRBV3-1,TRBJ2-3,CASSRSGRTDTQYF,8,0,1,8
TRBV14,TRBJ2-5,CASSQVKGQETQYF,8,0,1,8
TRBV14,TRBJ2-5,CASSQDSGEETQYF,8,0,1,8
TRBV28,TRBJ1-2,CASSDREAGYGYTF,8,0,1,8
TRBV7-3,TRBJ2-3,CASSKGQVTDTQYF,8,0,1,8
TRBV12-3/4,TRBJ1-1,CASRRTGGLTEAFF,8,0,1,8
TRBV6-2/3/5/6,TRBJ2-2,CASRRGGITGELFF,8,0,1,8
TRBV7-3,TRBJ1-3,CASSRTGTGNTIYF,12,0,1,12
TRBV5-1,TRBJ1-1,CASSFTGTNTEAFF,8,0,1,8
TRBV5-1,TRBJ1-1,CASSLGQGAQVAFF,8,0,1,8
TRBV5-1,TRBJ1-6,CASSLTGINSPLHF,8,0,1,8
TRBV5-1,TRBJ1-4,CASRRRGGNEKLFF,8,0,1,8
TRBV20-1,TRBJ2-5,CSALTYRGKETQYF,8,0,1,8
TRBV20-1,TRBJ2-1,CSAIRQGAGNEQFF,8,0,1,8
TRBV20-1,TRBJ2-3,CSARGGLAGLRLYF,8,0,1,8
TRBV20-1,TRBJ2-2,CSAREGLGTGELFF,8,0,1,8
TRBV20-1,TRBJ1-5,CSAKGTDSNQPQHF,8,0,1,8
TRBV29-1,TRBJ2-1,CSVLTSGGHNEQFF,8,0,1,8
TRBV29-1,TRBJ2-3,CSVDRLAGGNTQYF,8,0,1,8
TRBV29-1,TRBJ2-2,CSVEHLANTGELFF,8,0,1,8
TRBV29-1,TRBJ2-7,CSVEDRQGNYEQYF,8,0,1,8
TRBV30,TRBJ1-1,CAWSGQGTTEAFF,8,0,1,8
TRBV2,TRBJ2-7,CATERDSTYEQYF,8,0,1,8
TRBV12-3/4,TRBJ1-1,CASMGDRVSEAFF,8,0,1,8
TRBV12-3/4,TRBJ1-5,CASSFSEDQPQHF,8,0,1,8
TRBV6-2/3/5/6,TRBJ2-5,CASSLDYQETQYF,8,0,1,8
TRBV12-3/4,TRBJ1-6,CASSPTVGSPLHF,8,0,1,8
TRBV6-4,TRBJ1-2,CASSDYRSYGYTF,8,0,1,8
TRBV27,TRBJ1-1,CASSEKGKLRAFF,8,0,1,8
TRBV7-8,TRBJ1-1,CASSLQGAREAFF,8,0,1,8
TRBV11-2,TRBJ1-5,CASSYTYNQPQHF,8,0,1,8
TRBV5-6,TRBJ1-1,CASSPTGQGLAFF,8,0,1,8
TRBV14,TRBJ1-4,CASSRWIGEKLVF,8,0,1,8
TRBV11-2,TRBJ1-1,CASSQWRNGEAFF,8,0,1,8
TRBV3-1,TRBJ2-5,CASSQELQETQYF,8,0,1,8
TRBV2,TRBJ1-2,CASRPGQVDGYTF,8,0,1,8
TRBV5-6,TRBJ2-4,CASKDSDKNIQYF,8,0,1,8
TRBV5-1,TRBJ2-5,CASTGTGQETQYF,8,0,1,8
TRBV10-2,TRBJ2-7,CASSPTGVYEQYF,8,0,1,8
TRBV5-1,TRBJ1-1,CASSLLGNTEAFF,8,0,1,8
TRBV5-1,TRBJ1-4,CASSLGPGEKLFF,8,0,1,8
TRBV5-1,TRBJ2-7,CASSPWDSYEQYF,8,0,1,8
TRBV5-1,TRBJ2-3,CASRLQGGDTQYF,8,0,1,8
TRBV20-1,TRBJ2-3,CSVGGTGDGTQYF,8,0,1,8
TRBV20-1,TRBJ1-2,CSADTDRVAGYTF,8,0,1,8
TRBV29-1,TRBJ2-5,CSALQGQGETQYF,8,0,1,8
TRBV18,TRBJ1-1,CASSLDGGATEF,8,0,1,8
TRBV12-3/4,TRBJ2-5,CASSFVQQTQYF,8,0,1,8
TRBV2,TRBJ1-2,CASSVVWGSYTF,8,0,1,8
TRBV7-9,TRBJ2-2,CASSFAAGELFF,8,0,1,8
TRBV5-6,TRBJ2-1,CASSLQGHEQFF,8,0,1,8
TRBV11-1,TRBJ2-7,CASSPRAYEQYF,8,0,1,8
TRBV3-1,TRBJ2-1,CASSQVSDEQFF,8,0,1,8
TRBV4-1,TRBJ1-2,CASSQEVGGYTF,8,0,1,8
TRBV29-1,TRBJ2-5,CSVEVIKETQYF,8,0,1,8
TRBV29-1,TRBJ2-3,CSALTTTDTQYF,8,0,1,8
TRBV29-1,TRBJ2-7,SSAASESYEQYF,8,0,1,8
TRBV12-3/4,TRBJ1-3,CASSLGTTIYF,8,0,1,8
TRBV6-2/3/5/6,TRBJ1-1,CASSLNTEAFF,8,0,1,8
TRBV2,TRBJ1-1,CASRQQLEASF,8,0,1,8
TRBV20-1,TRBJ1-2,CSARDNYGYTF,8,0,1,8
TRBV29-1,TRBJ2-5,CSVENRGTQYF,8,0,1,8
TRBV5-1,TRBJ2-1,CASAGPEQFF,8,0,1,8
TRBV7-9,TRBJ1-1,CASSPSRRRGAYTEAFF,8,0,1,8
TRBV5-1,TRBJ2-3,CASSLGASGGSTDTQYF,8,0,1,8
TRBV12-3/4,TRBJ1-5,CASSLDRGEGNQPQHF,8,0,1,8
TRBV2,TRBJ2-1,CASNSGGSSYNEQFF,8,0,1,8
TRBV20-1,TRBJ1-6,CSARGTGIENSPLHF,8,0,1,8
TRBV11-2,TRBJ2-5,CASSFRGVQETQYF,8,0,1,8
TRBV7-2,TRBJ1-2,CASSLAMPFYGYTF,8,0,1,8
TRBV7-3,TRBJ2-5,CASSPMGTFETQYF,8,0,1,8
TRBV5-6,TRBJ1-1,RASSKGRSGTEAFF,8,0,1,8
TRBV28,TRBJ2-5,CATSTTAQETQYF,8,0,1,8
TRBV20-1,TRBJ2-1,CSASGGGYNEQFF,8,0,1,8
TRBV28,TRBJ2-3,CASGGDTDMQYF,8,0,1,8
TRBV3-1,TRBJ2-2,CASSQISGELFF,8,0,1,8
TRBV6-2/3/5/6,TRBJ2-2,CASSYMGVTSGTGELFF,8,0,1,8
TRBV19,TRBJ1-5,CASSTLDGDRQPQHF,8,0,1,8
TRBV7-3,TRBJ2-3,CASSLQGGNTDTQYF,8,0,1,8
TRBV3-1,TRBJ2-7,CASSPTPTASYEQYF,8,0,1,8
TRBV18,TRBJ2-5,CASSRDRDQETQYF,8,0,1,8
TRBV7-9,TRBJ2-7,CASSFDRTSYEQYF,8,0,1,8
TRBV7-3,TRBJ2-3,CASSLAGGSDTQYF,8,0,1,8
TRBV25-1,TRBJ2-4,CASSDYPKNIQYF,8,0,1,8
TRBV5-6,TRBJ2-3,CASSRRGQDTQYF,8,0,1,8
TRBV7-8,TRBJ2-1,CASRLSPTGGQFF,8,0,1,8
TRBV28,TRBJ1-4,CASRRQRNEKLFF,8,0,1,8
TRBV2,TRBJ2-7,CARSVFYEQYF,8,0,1,8
TRBV7-2,TRBJ2-1,CASSFQPGLAGIIYNEQFF,8,0,1,8
TRBV20-1,TRBJ2-4,CSARDPPGGEGKNIQYF,8,4,2,12
TRBV5-1,TRBJ2-7,CVSSLAPSGGPYEQYF,8,0,1,8
TRBV29-1,TRBJ2-1,CSVEGTDLSAYNEQFF,8,0,1,8
TRBV29-1,TRBJ2-6,CSVGTTSGANVLTF,8,2,2,10
TRBV29-1,TRBJ2-3,CKVGTSTDTQYF,8,0,1,8
TRBV3-1,TRBJ1-1,CASSQDLGFSTVGGNTEAFF,7,0,1,7
TRBV27,TRBJ2-6,CTSSYDVRAPSSGANVLTF,7,0,1,7
TRBV3-1,TRBJ2-3,CASSQLAGGSTDKQYF,7,0,1,7
TRBV30,TRBJ2-7,CAWSHRTSGVYEQYF,7,0,1,7
TRBV5-8,TRBJ2-1,CASSDYRVTYNEQFF,7,0,1,7
TRBV24-1,TRBJ2-1,SATSDRQGVFNEQFF,7,0,1,7
TRBV28,TRBJ2-1,CASGPPTEDNEQFF,7,0,1,7
TRBV12-3/4,TRBJ2-4,CASSFRTGSNIQDF,7,0,1,7
TRBV7-2,TRBJ2-7,CASSLGRDYYEQYF,7,0,1,7
TRBV5-1,TRBJ2-3,CASSVGLVTDTQHF,7,0,1,7
TRBV5-6,TRBJ2-1,CASSLDIGEQFF,7,2,2,9
TRBV20-1,TRBJ1-5,CSAVRGLAPQHF,7,0,1,7
TRBV5-1,TRBJ2-3,CASRMTDTQYF,7,0,1,7
TRBV7-9,TRBJ2-1,CASSLEGVRGRSYNEQFF,7,0,1,7
TRBV20-1,TRBJ1-5,RSARASRRGQYLNQPQHF,7,0,1,7
TRBV5-1,TRBJ1-4,CASSFRAASTNEKLFF,7,0,1,7
TRBV6-2/3/5/6,TRBJ2-1,CASSYSGTSFNEQFF,7,0,1,7
TRBV5-4,TRBJ2-3,CASSLNRGRFANQYF,7,0,1,7
TRBV20-1,TRBJ2-5,CSAREISLAGGSQYF,7,0,1,7
TRBV12-5,TRBJ2-1,CASLRGSSYNEQFF,7,0,1,7
TRBV18,TRBJ2-5,CASSPPPAGETQYF,7,0,1,7
TRBV11-2,TRBJ1-1,CASISPRVITEAFF,7,0,1,7
TRBV11-1,TRBJ2-3,CASSLQVSTDTQYF,7,0,1,7
TRBV20-1,TRBJ2-7,RSARLQGASYEQYF,7,0,1,7
TRBV20-1,TRBJ2-1,CSARPPSYNEQFF,7,0,1,7
TRBV29-1,TRBJ1-1,CSAVQAGTEAFF,7,0,1,7
TRBV28,TRBJ1-2,CASSPPRLFPGNFNYGYTF,7,0,1,7
TRBV14,TRBJ2-1,CASKGGTSGAPSSYNEQFF,7,0,1,7
TRBV19,TRBJ1-2,CASSLTAGSGAFNYGYTF,7,0,1,7
TRBV6-2/3/5/6,TRBJ2-3,CASSSLYPTSGGGDTQYF,7,0,1,7
TRBV28,TRBJ2-3,CASSSPYHLAGRTDTQYF,7,0,1,7
TRBV7-9,TRBJ1-2,CASSFGAGTEPSYYGYTF,7,0,1,7
TRBV3-1,TRBJ2-7,CASSQEAKLAGAAYEQYF,7,0,1,7
TRBV5-4,TRBJ2-1,CASSIRGRGPNRYNEQFF,7,0,1,7
TRBV5-1,TRBJ2-3,CASSFRLAELSSTDTQYF,7,0,1,7
TRBV7-2,TRBJ1-5,CVSSLDLRTGGNQPQHF,7,0,1,7
TRBV5-4,TRBJ2-2,CASSLAGTGGYTGELFF,7,0,1,7
TRBV13,TRBJ2-5,CASSLGWSSGEQETQYF,7,0,1,7
TRBV9,TRBJ2-3,CASSSSGGIPFTDTQYF,7,0,1,7
TRBV14,TRBJ2-5,CASSPRTAGTIQETQYF,7,0,1,7
TRBV3-1,TRBJ2-5,CASSHYGLAGGQETQYF,7,0,1,7
TRBV10-3,TRBJ2-3,CAISEWASGGTDTQYF,7,0,1,7
TRBV19,TRBJ1-2,CASSRRPGHGANGYTF,7,0,1,7
TRBV19,TRBJ2-5,CASSRGLAGGRETQYF,7,0,1,7
TRBV18,TRBJ1-1,CASSRPGGAEGTEAFF,7,0,1,7
TRBV18,TRBJ1-2,CASSRFGQGNNYGYTF,7,0,1,7
TRBV28,TRBJ1-1,CASSSHGGGVNTEAFF,7,0,1,7
TRBV6-2/3/5/6,TRBJ2-2,CASSYSFSVYTGELFF,7,0,1,7
TRBV27,TRBJ1-4,CASSRIGSARKEKLFF,7,0,1,7
TRBV5-4,TRBJ2-1,CASSLGGGADYNEQFF,7,0,1,7
TRBV7-3,TRBJ2-1,CASSLMLAGPHNEQFF,7,0,1,7
TRBV7-8,TRBJ1-1,CASSSSPRASNTEAFF,7,0,1,7
TRBV28,TRBJ1-2,CASSRPRTGINYGYTF,7,0,1,7
TRBV3-1,TRBJ1-1,CASSHYTSGSRTEAFF,7,0,1,7
TRBV3-1,TRBJ2-1,CASSHTGTGSYNEQFF,7,0,1,7
TRBV14,TRBJ1-2,CASSQGFTPTEHGYTF,7,0,1,7
TRBV3-1,TRBJ2-7,CASSQTRGLAGREQYF,7,0,1,7
TRBV28,TRBJ2-5,CASRPSGGALRETQHF,7,0,1,7
TRBV5-1,TRBJ1-1,CASSLGDLGVNTEAFF,7,0,1,7
TRBV4-1,TRBJ2-1,CASSQDPRSSYNEQFF,7,0,1,7
TRBV5-1,TRBJ1-4,CASRMEPHRGSGKLFF,7,0,1,7
TRBV20-1,TRBJ2-7,CSARDWSWTGIYEQYF,7,0,1,7
TRBV20-1,TRBJ1-2,CSARDYAGVFGYGYTF,7,0,1,7
TRBV19,TRBJ2-3,CASTKLGGGTDTQYF,7,0,1,7
TRBV19,TRBJ2-7,CASSQSLAGGREQYF,7,0,1,7
TRBV19,TRBJ1-1,CASSIGTLKGPEAFF,7,0,1,7
TRBV2,TRBJ2-3,CASSHGDFSTDTQYF,7,0,1,7
TRBV18,TRBJ1-2,CASSPPPGPNYGYTF,7,0,1,7
TRBV11-2,TRBJ1-5,CASAAGGIGNQPQHF,7,0,1,7
TRBV7-9,TRBJ2-5,CASTPPRAAQETQYF,7,5,2,12
TRBV28,TRBJ2-1,CASSLYLARHNEQFF,7,0,1,7
TRBV28,TRBJ1-5,CASSLVGGDNQPQHF,7,0,1,7
TRBV12-3/4,TRBJ2-2,CASSLRSLNTGELFF,7,0,1,7
TRBV12-3/4,TRBJ2-3,CASSSRTSGVDTQYF,7,0,1,7
TRBV28,TRBJ2-7,CASSSRAGGAYEQYF,7,0,1,7
TRBV2,TRBJ2-5,CASSSPPPGGETQYF,7,0,1,7
TRBV28,TRBJ2-3,CASSYSEPSTDTQYF,7,0,1,7
TRBV6-2/3/5/6,TRBJ1-6,CASSLQGQNNSPLHF,7,0,1,7
TRBV12-3/4,TRBJ2-1,CASSRSGGNYNEQFF,7,0,1,7
TRBV5-6,TRBJ2-1,CASSFRDSAYNEQFF,7,0,1,7
TRBV7-9,TRBJ1-1,CASSFATGTNTEAFF,7,0,1,7
TRBV7-6,TRBJ1-1,CASSLSSGEATEAFF,7,0,1,7
TRBV11-2,TRBJ2-5,CASSLGPGGQETQYF,7,0,1,7
TRBV7-9,TRBJ2-4,CASSLGRDSKNIQYF,7,0,1,7
TRBV7-9,TRBJ2-7,CASSLGDAGGYEQYF,7,0,1,7
TRBV7-2,TRBJ2-3,CASSSGRGSTDTQYF,7,0,1,7
TRBV11-2,TRBJ2-3,CASSLAGRGTDTQYF,7,0,1,7
TRBV14,TRBJ2-2,CASSPRTRNTGELFF,7,0,1,7
TRBV7-3,TRBJ2-7,CASSPSGQGTSEQYF,7,0,1,7
TRBV12-3/4,TRBJ2-2,CASSPGQGYTGELFF,7,0,1,7
TRBV11-2,TRBJ1-6,CASSPQQGMGSPLHF,7,0,1,7
TRBV3-1,TRBJ2-6,CASSQAGAGANVLTF,7,0,1,7
TRBV3-1,TRBJ2-4,CASSQETGGKNIQYF,7,0,1,7
TRBV3-1,TRBJ1-6,CASSQKGSQNSPLHF,7,0,1,7
TRBV7-9,TRBJ1-1,CASSGGQGAKTEAFF,7,0,1,7
TRBV2,TRBJ2-1,CASRVGSGPYNEQFF,7,0,1,7
TRBV2,TRBJ2-1,CASRAIAGGNNEQFF,7,0,1,7
TRBV5-1,TRBJ2-2,CASLPGGSNTGELFF,7,0,1,7
TRBV5-1,TRBJ2-2,CASTSGAGNTGELFF,7,0,1,7
TRBV5-1,TRBJ1-2,CASSLVPDPNYGYTF,7,0,1,7
TRBV5-1,TRBJ1-3,CASSLVGSPGNTIYF,7,0,1,7
TRBV5-1,TRBJ2-5,CASSLARDRQETQYF,7,0,1,7
TRBV5-1,TRBJ1-1,CASSLGQGARTEAFF,7,0,1,7
TRBV5-1,TRBJ2-5,CASSSGPSGGETQYF,7,0,1,7
TRBV5-1,TRBJ1-5,CASSLWGASNQPQHF,7,0,1,7
TRBV4-1,TRBJ1-2,CASSQLAKGRWGYTF,7,0,1,7
TRBV5-1,TRBJ1-2,CASSNTGQGAFGYTF,7,0,1,7
TRBV20-1,TRBJ2-7,CSARKPASGGHEQYF,7,0,1,7
TRBV20-1,TRBJ2-5,CSATRLAGGGETQYF,7,0,1,7
TRBV20-1,TRBJ1-1,CSASTGGGFYLEAFF,7,0,1,7
TRBV20-1,TRBJ1-2,CSARAPDSSNYGYTF,7,0,1,7
TRBV20-1,TRBJ1-5,CSARDKGRAYQPQHF,7,0,1,7
TRBV20-1,TRBJ1-1,CSARNLYSENTEAFF,7,0,1,7
TRBV29-1,TRBJ1-2,CSVDPAGTPENGYTF,7,0,1,7
TRBV7-7,TRBJ2-3,CASSRGGSTDTQYF,7,0,1,7
TRBV24-1,TRBJ1-3,CATRDNEIGNTIYF,7,0,1,7
TRBV19,TRBJ1-1,CASSSSSGRTEAFF,7,0,1,7
TRBV19,TRBJ2-2,CASSPGRYTGELFF,7,0,1,7
TRBV12-3/4,TRBJ1-1,CASRPWAINTEAFF,7,0,1,7
TRBV11-2,TRBJ1-1,CASGFNRGGTEAFF,7,0,1,7
TRBV12-3/4,TRBJ1-5,CASSFQGSAQPQHF,7,0,1,7
TRBV6-2/3/5/6,TRBJ2-3,CASSLEAITDTQYF,7,0,1,7
TRBV12-3/4,TRBJ1-2,CASSLRTGKNGYTF,7,0,1,7
TRBV27,TRBJ2-1,CASSSPGRSNEQFF,7,0,1,7
TRBV27,TRBJ2-7,CASSPSPRDYEQYF,7,0,1,7
TRBV6-2/3/5/6,TRBJ1-3,CASSPQGAGNTIYF,7,0,1,7
TRBV12-3/4,TRBJ2-5,CASSRRDKQETQYF,7,0,1,7
TRBV6-1,TRBJ1-5,CASSVDRGNQPQHF,7,0,1,7
TRBV6-1,TRBJ2-2,CASSALRNTGELFF,7,0,1,7
TRBV6-1,TRBJ1-1,CASSASGTDTEAFF,7,0,1,7
TRBV2,TRBJ2-1,CASSALAAYNEQFF,7,0,1,7
TRBV6-1,TRBJ1-4,CASSEVLIGEKLFF,7,0,1,7
TRBV7-9,TRBJ1-1,CASSMVQGRTEAFF,7,0,1,7
TRBV7-9,TRBJ1-1,CASSFTNLNTEAFF,7,0,1,7
TRBV7-2,TRBJ1-4,CASSLGLNNEKLFF,7,0,1,7
TRBV7-2,TRBJ1-5,CASSLLFSNQPQHF,7,0,1,7
TRBV11-2,TRBJ1-4,CASSLVGTDEKLFF,7,0,1,7
TRBV11-1,TRBJ2-1,CASSSGGLYNEQFF,10,0,1,10
TRBV7-9,TRBJ1-1,CASSWGQGMPEAFF,7,0,1,7
TRBV3-1,TRBJ1-1,CASSQTGGWNEAFF,7,0,1,7
TRBV3-1,TRBJ2-2,CASSQAPDTGELFF,7,8,2,15
TRBV3-1,TRBJ1-5,CASSQGTRNQPQHF,7,0,1,7
TRBV7-2,TRBJ2-7,CASSEGTGYYEQYF,7,0,1,7
TRBV7-2,TRBJ2-7,CASSNYGTSYEQYF,7,0,1,7
TRBV2,TRBJ2-3,CASRALWGTDTQYF,7,0,1,7
TRBV12-3/4,TRBJ2-6,CASNTGSGANVLTF,7,6,2,13
TRBV20-1,TRBJ2-5,CSALYQGYAETQYF,7,0,1,7
TRBV5-1,TRBJ2-3,CASTMGGDTDTQYF,7,0,1,7
TRBV4-1,TRBJ2-7,CASSFVGRSYEQYF,7,0,1,7
TRBV5-1,TRBJ1-3,CASSLQYPGNTIYF,7,0,1,7
TRBV20-1,TRBJ2-2,CSARDQGNTGELLF,7,0,1,7
TRBV20-1,TRBJ2-1,CSAPGAVPGHEQFF,7,0,1,7
TRBV20-1,TRBJ2-5,CSAHLLGGLETQYF,7,0,1,7
TRBV20-1,TRBJ2-5,CSGGAGGNRETQYF,7,0,1,7
TRBV29-1,TRBJ2-4,CSVLKNEAKNIQYF,7,0,1,7
TRBV29-1,TRBJ2-1,CSVLGWGGDNEQFF,7,0,1,7
TRBV29-1,TRBJ2-5,CSVEEDSGVETQYF,7,0,1,7
TRBV29-1,TRBJ2-1,CSVKGISAYNEQFF,7,0,1,7
TRBV29-1,TRBJ2-1,CSVAGVRSYNEQFF,7,0,1,7
TRBV29-1,TRBJ2-1,CSVYGTSSRNEQFF,7,0,1,7
TRBV29-1,TRBJ1-4,CSAAVGQANEKLFF,7,0,1,7
TRBV30,TRBJ1-1,CAWTRQGAAEAFF,7,0,1,7
TRBV18,TRBJ1-6,CAGKGQLNSPLHF,7,0,1,7
TRBV10-3,TRBJ1-5,CAISISSNQPQHF,7,0,1,7
TRBV24-1,TRBJ1-1,CATSERQGARAFF,7,0,1,7
TRBV15,TRBJ1-1,CATSRVKVPGAFF,7,0,1,7
TRBV15,TRBJ1-1,CATSRIGGTEAFF,7,0,1,7
TRBV19,TRBJ2-1,CASSVAGANEQFF,7,0,1,7
TRBV18,TRBJ2-7,CASSPAQAYEQYF,7,0,1,7
TRBV2,TRBJ1-4,CASGRGINEKLFF,7,0,1,7
TRBV27,TRBJ2-1,CASSFGLSNEQFF,10,0,1,10
TRBV6-2/3/5/6,TRBJ1-5,CASSFKENQPQHF,7,0,1,7
TRBV28,TRBJ2-6,CASSLAGINVLTF,7,0,1,7
TRBV6-2/3/5/6,TRBJ1-2,CASSSYLHYGYTF,7,0,1,7
TRBV6-2/3/5/6,TRBJ1-1,CASSYSGTGNVFF,7,0,1,7
TRBV28,TRBJ1-5,CASSGGSNQPQHF,7,0,1,7
TRBV2,TRBJ1-1,CASSEDDWTEAFF,7,0,1,7
TRBV12-3/4,TRBJ2-5,CASSEDSRETQYF,7,0,1,7
TRBV7-9,TRBJ2-7,CASSFFTRHEQYF,7,0,1,7
TRBV7-9,TRBJ2-3,CASSLRVPDTQYF,7,0,1,7
TRBV7-2,TRBJ1-1,CASSLVLGTEAFF,7,0,1,7
TRBV11-2,TRBJ2-3,CASSLGATDTQYF,7,0,1,7
TRBV7-3,TRBJ2-7,CASSLEQGYEQYF,7,2,2,9
TRBV5-4,TRBJ2-7,CASSSRDSYEQYF,7,0,1,7
TRBV7-6,TRBJ1-1,CASSSQENTEAFF,7,0,1,7
TRBV7-9,TRBJ1-6,CASSSEYNSPLHF,7,0,1,7
TRBV3-1,TRBJ2-4,CASSLERGNIQYF,7,0,1,7
TRBV12-3/4,TRBJ1-1,CASSLTGGTEAFF,7,0,1,7
TRBV7-3,TRBJ2-1,CASSPTGDNEQFF,7,0,1,7
TRBV14,TRBJ1-2,CASSRDISYGYAF,7,0,1,7
TRBV7-9,TRBJ1-2,CASSVTGVYGYTF,7,0,1,7
TRBV5-6,TRBJ2-1,CASRSRGKDEQFF,7,0,1,7
TRBV10-1,TRBJ2-7,CASSERARGEQYF,7,0,1,7
TRBV5-1,TRBJ2-5,CASSFSGAETQYF,7,0,1,7
TRBV5-1,TRBJ1-2,CASSSTDRGGYTF,7,0,1,7
TRBV5-1,TRBJ2-5,CASSLQGEETQYF,7,0,1,7
TRBV20-1,TRBJ1-5,CSASAQGTQPQHF,7,0,1,7
TRBV20-1,TRBJ1-2,CSASLRTGYGYTF,7,0,1,7
TRBV20-1,TRBJ1-6,CSASRQEHSPLHF,7,0,1,7
TRBV20-1,TRBJ2-3,CSARVSGADTQYF,7,2,2,9
TRBV20-1,TRBJ1-5,CSALGQGGQPQHF,7,0,1,7
TRBV29-1,TRBJ2-5,CSVHSGARETQYF,7,0,1,7
TRBV29-1,TRBJ2-7,CSVGTATSYEQYF,7,0,1,7
TRBV29-1,TRBJ1-1,CSVDRGRNTEAFF,7,0,1,7
TRBV29-1,TRBJ1-4,CSVEITPGEKLSF,7,0,1,7
TRBV29-1,TRBJ2-7,CSVLGGTAYEQYF,7,0,1,7
TRBV29-1,TRBJ1-1,CSAHGGGGTEAFF,7,0,1,7
TRBV20-1,TRBJ2-3,RSALQGTTNTQYF,7,0,1,7
TRBV18,TRBJ1-1,CASSQGYSEAFF,7,0,1,7
TRBV2,TRBJ1-5,CASRDSNQPQHF,7,0,1,7
TRBV6-2/3/5/6,TRBJ1-5,CASATTGQPQHF,7,0,1,7
TRBV28,TRBJ1-5,CASSFFNQPQHF,7,0,1,7
TRBV12-3/4,TRBJ2-2,CASSLLQGKVFF,7,0,1,7
TRBV6-2/3/5/6,TRBJ2-5,CASSYRGETQYF,7,0,1,7
TRBV7-9,TRBJ1-1,CASSFGRVEAFF,7,0,1,7
TRBV7-2,TRBJ2-3,CASSLVADTQYF,7,6,2,13
TRBV28,TRBJ1-1,CASSLSGIEAFF,7,0,1,7
TRBV28,TRBJ1-2,CASSLTGLGYTF,7,0,1,7
TRBV3-1,TRBJ1-1,CASSLRRAEAFF,7,0,1,7
TRBV14,TRBJ2-1,CASSPAPGEQFF,7,0,1,7
TRBV3-1,TRBJ1-2,CASSPAWYGYTF,7,0,1,7
TRBV14,TRBJ2-5,CASSQQGETQYF,7,0,1,7
TRBV7-8,TRBJ2-7,CARKDRTYEQYF,7,0,1,7
TRBV29-1,TRBJ2-5,CLAGGPQETQYF,7,0,1,7
TRBV10-1,TRBJ2-2,CASSGYTGELFF,7,0,1,7
TRBV5-1,TRBJ1-2,CASSLLGDGYTF,7,0,1,7
TRBV29-1,TRBJ1-2,CSVVGTGNGYTF,7,0,1,7
TRBV29-1,TRBJ2-5,CSVREHQETQYF,7,0,1,7
TRBV29-1,TRBJ1-4,CSGRQGGEKLFF,7,0,1,7
TRBV30,TRBJ2-1,CAWSRRGEQFF,7,0,1,7
TRBV19,TRBJ2-6,CASSGANVLTF,7,0,1,7
TRBV28,TRBJ2-5,CASSTGRTQYF,7,0,1,7
TRBV5-6,TRBJ1-1,CASSFNTEAFF,7,0,1,7
TRBV29-1,TRBJ1-1,CSVEISTEAFF,7,11,2,18
TRBV29-1,TRBJ1-1,CSVSVGTEAFF,7,0,1,7
TRBV29-1,TRBJ2-7,CSAGVSYEQYF,7,0,1,7
TRBV19,TRBJ2-1,CASGGVEQFF,7,0,1,7
TRBV7-9,TRBJ1-1,CASSLIEAFF,7,0,1,7
TRBV10-3,TRBJ1-1,CAISGDGSGQYKGDTEAFF,6,0,1,6
TRBV18,TRBJ1-2,CASSPGPLGYIQGVDGYTF,6,0,1,6
TRBV11-2,TRBJ1-6,CASSLRGDRGRQLNSPLHF,6,0,1,6
TRBV20-1,TRBJ1-2,CSASRGGYQDIRTNYGYTF,6,0,1,6
TRBV10-3,TRBJ2-7,CAISDPEGWYSISYEQYF,6,0,1,6
TRBV19,TRBJ2-6,CASSIPGRLSSGANVLTF,6,0,1,6
TRBV5-4,TRBJ2-1,CASSLEVGLAGGYNEQFF,6,0,1,6
TRBV11-2,TRBJ2-1,CASSLWGTGGGSPVPQFF,6,0,1,6
TRBV5-5,TRBJ1-3,CASSSPRTGVWSGNTIYF,6,0,1,6
TRBV5-6,TRBJ2-1,CASSSTPGLAGTWNEQFF,6,0,1,6
TRBV3-1,TRBJ2-5,CASSHEGGRQLGQETQYF,6,0,1,6
TRBV7-2,TRBJ2-3,CASSHAGTSGASTDTQYF,6,0,1,6
TRBV2,TRBJ2-3,CASSASTSGGTITDTQYF,6,0,1,6
TRBV11-3,TRBJ2-1,CASSKILPGFGPYNEQFF,6,0,1,6
TRBV5-1,TRBJ1-1,CASSLLPETGPEGTEAFF,6,0,1,6
TRBV18,TRBJ1-2,CASSPYRDQATNYGYTF,6,0,1,6
TRBV18,TRBJ2-1,CASSPYRDSIAGDEQFF,6,0,1,6
TRBV18,TRBJ2-7,CASSPKAGAMSTYEQYF,6,0,1,6
TRBV12-3/4,TRBJ2-1,CASSLVSGEGSYNEQFF,6,0,1,6
TRBV6-2/3/5/6,TRBJ2-1,CASSYRTSGALYNEQFF,6,0,1,6
TRBV11-1,TRBJ2-1,CASSLGRGTSGVSEQFF,6,0,1,6
TRBV7-2,TRBJ2-1,CASSLGGYRVMGNEQFF,6,0,1,6
TRBV3-1,TRBJ2-3,CASSLRASSGGTDTQYF,6,0,1,6
TRBV7-9,TRBJ2-1,CASSPKGGGAFYNEQFF,6,0,1,6
TRBV3-1,TRBJ2-5,CASSQGTSGGAAETQYI,6,0,1,6
TRBV3-1,TRBJ2-3,CASSQEITRSSTDTQYF,6,0,1,6
TRBV5-6,TRBJ2-3,CASSGRTSDSRTDTQYF,6,0,1,6
TRBV6-2/3/5/6,TRBJ1-6,CASRPGWRSRYNSPLHF,6,0,1,6
TRBV6-4,TRBJ2-3,CASRQNWDRSSTDTQYF,6,0,1,6
TRBV12-3/4,TRBJ2-3,CASRGYSGTGGVDTQYF,6,0,1,6
TRBV19,TRBJ2-2,CASNQDLRTVNTGELFF,6,0,1,6
TRBV5-1,TRBJ1-2,CASTQSDGTGQNYGYTF,6,5,2,11
TRBV18,TRBJ2-3,CASSPKAGTGTDTQYF,6,0,1,6
TRBV7-2,TRBJ1-5,CASSILSGQINQPRHF,6,0,1,6
TRBV12-3/4,TRBJ2-2,CASTQRDRINTGELFF,6,0,1,6
TRBV27,TRBJ1-5,CASSFPGTGGNQPQHF,6,0,1,6
TRBV12-3/4,TRBJ1-4,CASSFGNGHLNEKLFF,10,0,1,10
TRBV27,TRBJ2-7,CASSLSYRDRVYEQYF,6,0,1,6
TRBV28,TRBJ1-2,CASSLGTSRSLNGYTF,6,0,1,6
TRBV27,TRBJ2-5,CASSLLAGTQPETQYF,6,0,1,6
TRBV12-3/4,TRBJ2-3,CASSLGQGVGTDTQYF,6,0,1,6
TRBV12-3/4,TRBJ1-5,CASSWGGTGSNQPQHF,6,0,1,6
TRBV11-2,TRBJ2-5,CASSQGSSGGMKTQYF,6,0,1,6
TRBV6-1,TRBJ2-3,CASSEGASGGSDTQYF,6,0,1,6
TRBV6-4,TRBJ2-5,CASSMDFGPLQETQYF,6,0,1,6
TRBV2,TRBJ1-1,CASSSTGGAGNTEAFF,9,0,1,9
TRBV28,TRBJ2-3,CASSRISGGYTDTQYF,6,0,1,6
TRBV5-4,TRBJ1-1,CASSLPGEGLDTEAFF,6,0,1,6
TRBV7-9,TRBJ2-1,CASSPSQGRTYNEQFF,6,0,1,6
TRBV5-8,TRBJ2-1,CASSPFRGAVYNEQFF,6,0,1,6
TRBV14,TRBJ2-1,CASSRTSSGGADEQFF,6,5,2,11
TRBV14,TRBJ2-7,CASSQRGFWERYEQYF,6,0,1,6
TRBV13,TRBJ2-3,CASSQNRELATDTQYF,6,0,1,6
TRBV7-9,TRBJ1-5,CASSEGGGTVSQPQHF,6,0,1,6
TRBV11-2,TRBJ1-4,CASSNRGLAANEKLFF,6,0,1,6
TRBV7-3,TRBJ2-2,CASSNTGQGNTGELFF,6,0,1,6
TRBV5-5,TRBJ2-3,CASRLWVNHDVDTQYF,6,0,1,6
TRBV6-2/3/5/6,TRBJ2-1,CASRPIPTSGGGKQFF,6,0,1,6
TRBV7-9,TRBJ2-3,CASRGNTGGGSDTQYF,6,0,1,6
TRBV5-1,TRBJ2-1,CASTQPSGGAEDEQFF,6,0,1,6
TRBV5-1,TRBJ1-2,CASSLLGPENYYGYTF,6,0,1,6
TRBV5-1,TRBJ2-3,CASSLAERGSTDTQYF,6,0,1,6
TRBV4-1,TRBJ2-1,CASSQVGRQHYDEQFF,6,0,1,6
TRBV5-1,TRBJ2-4,CASSGPGVRAKNIQYF,6,0,1,6
TRBV20-1,TRBJ2-3,CSARGKRKSATDTQYF,6,0,1,6
TRBV20-1,TRBJ2-7,CSARDLGLAAVYEQYF,6,0,1,6
TRBV20-1,TRBJ2-7,CSARESVGGRPYEQYF,6,0,1,6
TRBV7-2,TRBJ2-3,CASSYSGFSTDTQYF,6,0,1,6
TRBV7-7,TRBJ2-5,CASSRWTGRRETQYF,6,0,1,6
TRBV19,TRBJ2-1,CASTAGTSGYNEQFF,6,0,1,6
TRBV7-2,TRBJ2-3,CASTRQGLSTDTQYF,6,0,1,6
TRBV19,TRBJ1-5,CASSMFGFGNQPQHF,6,0,1,6
TRBV19,TRBJ1-5,CASSIDRTVNQPQHL,6,0,1,6
TRBV19,TRBJ2-1,CASRSGTGESNEQFF,6,0,1,6
TRBV18,TRBJ2-2,CASSLGQANTGELFF,6,0,1,6
TRBV12-3/4,TRBJ2-7,CASTTRAGGDSEQYF,6,0,1,6
TRBV12-3/4,TRBJ1-6,CASSFAGSYNSPLHF,6,0,1,6
TRBV27,TRBJ1-6,CASSFGPTYNSPLHF,6,0,1,6
TRBV28,TRBJ1-6,CASSLSGQGSSPLHF,6,0,1,6
TRBV12-3/4,TRBJ1-5,CASSLRQASNQPQHF,6,0,1,6
TRBV6-2/3/5/6,TRBJ2-3,CASSLKGISTDTQYF,6,0,1,6
TRBV6-2/3/5/6,TRBJ1-5,CASSWQSISNQPQHF,6,0,1,6
TRBV28,TRBJ2-3,CASSWVRGATDTQYF,6,0,1,6
TRBV6-2/3/5/6,TRBJ1-5,CASSYSAGGNQPQHF,6,0,1,6
TRBV28,TRBJ2-7,CASSPGQGSTYEQYF,6,0,1,6
TRBV2,TRBJ1-5,CASSRVRGIGQPQRF,6,0,1,6
TRBV2,TRBJ2-7,CASSVVGRHSYEQYF,6,0,1,6
TRBV2,TRBJ1-6,CASSDYNSYNSPLHF,6,0,1,6
TRBV6-1,TRBJ2-7,CASSEAQGQGYEQYF,6,0,1,6
TRBV6-1,TRBJ2-5,CASSEAQPRSETQYF,6,0,1,6
TRBV2,TRBJ2-1,CASSEAQSSYNEQFF,6,0,1,6
TRBV6-1,TRBJ1-1,CASSEGGTVNTEAFF,6,0,1,6
TRBV11-2,TRBJ2-5,CASSFEPDFQETQYF,6,0,1,6
TRBV7-6,TRBJ1-6,CASSFSGQGNSPLHF,6,0,1,6
TRBV7-6,TRBJ2-1,CASSFLAGPFHEQFF,6,0,1,6
TRBV2,TRBJ1-4,CASSFHRGFSEKLFF,6,0,1,6
TRBV11-3,TRBJ2-2,CASSFGGGASGELFF,6,0,1,6
TRBV5-6,TRBJ1-2,CASSLVGGENYGYTF,6,0,1,6
TRBV11-2,TRBJ2-5,CASSLGLLQQETQYF,6,0,1,6
TRBV7-9,TRBJ1-1,CASSLGGGMNTEAFF,8,0,1,8
TRBV7-3,TRBJ2-3,CASSLISGSSGAQYF,6,0,1,6
TRBV7-9,TRBJ2-2,CASSSGGGNTGELFF,6,0,1,6
TRBV11-2,TRBJ2-7,CASSSKDSRTYEQYF,6,0,1,6
TRBV12-3/4,TRBJ2-5,CASSPTTGLGETQYF,6,0,1,6
TRBV4-2,TRBJ2-3,CASSPLAGGTDTQYF,6,0,1,6
TRBV3-1,TRBJ2-5,CASSHGRGGLETQYF,6,0,1,6
TRBV3-1,TRBJ2-7,CASSQATDSAYEQYF,6,0,1,6
TRBV3-1,TRBJ2-5,CASSQDYGGAGAQYF,6,0,1,6
TRBV7-2,TRBJ2-1,CASSTLNYVGNEQFF,6,0,1,6
TRBV5-1,TRBJ2-3,CASIAGQGAPDTQYF,6,0,1,6
TRBV5-1,TRBJ2-3,CASSLFQKNTDTQYF,6,4,2,10
TRBV5-1,TRBJ2-7,CASSLAPRGSYEQYF,6,0,1,6
TRBV5-1,TRBJ1-1,CASSLGRQGDNEAFF,6,0,1,6
TRBV5-1,TRBJ2-1,CASSLEGWGDNEQFF,6,0,1,6
TRBV5-1,TRBJ1-4,CASSPLGGTNEKLFS,6,0,1,6
TRBV4-1,TRBJ2-4,CASSQVSGGKNIQYF,6,0,1,6
TRBV20-1,TRBJ2-3,CSASLAGDPTDTQYF,6,0,1,6
TRBV20-1,TRBJ2-5,CSARRTGRWQETQYF,6,0,1,6
TRBV20-1,TRBJ2-1,CSARDGKSSYNEQFF,6,0,1,6
TRBV29-1,TRBJ2-2,CSVGRRTANTGELFF,6,0,1,6
TRBV29-1,TRBJ2-3,CSVEGAGGSTDTQYF,6,0,1,6
TRBV30,TRBJ1-1,CAWNDPGGLPEAFF,6,0,1,6
TRBV28,TRBJ2-2,CAGSTGWAAGELFF,6,0,1,6
TRBV30,TRBJ1-1,CAGAAGTLNTEAFF,6,0,1,6
TRBV10-3,TRBJ1-1,CAISEGQMNTEAFF,6,0,1,6
TRBV15,TRBJ1-5,CATSRGQGNQPQHF,6,0,1,6
TRBV19,TRBJ1-5,CASIRTGGNQPQHF,6,0,1,6
TRBV19,TRBJ1-5,CASRQGAGNQPQHF,6,0,1,6
TRBV18,TRBJ1-1,CASSARDSNTEAFF,6,0,1,6
TRBV18,TRBJ2-7,CASSPDRDDYEQYF,6,4,2,10
TRBV18,TRBJ2-7,CASSPRGFTYEQYF,6,0,1,6
TRBV28,TRBJ2-2,CASGTGTNTGELFF,6,0,1,6
TRBV12-3/4,TRBJ1-2,CASGPGQGFYGYTF,6,0,1,6
TRBV12-3/4,TRBJ1-2,CASTFGGANYGYTF,6,2,2,8
TRBV5-6,TRBJ2-3,CASTPLGRQDTQYF,6,0,1,6
TRBV2,TRBJ1-2,CASTRIGTAYGYTF,6,0,1,6
TRBV12-3/4,TRBJ2-5,CASTRRGGQETQYF,6,0,1,6
TRBV6-2/3/5/6,TRBJ2-1,CASSLLRAGDEQFF,6,0,1,6
TRBV28,TRBJ2-2,CASSLQGATGELFF,6,0,1,6
TRBV28,TRBJ1-5,CASSLRGWGQPQHF,6,0,1,6
TRBV12-3/4,TRBJ1-2,CASSLNRGSYGYTF,6,9,2,15
TRBV27,TRBJ2-7,CASSSRQGGYEQYF,6,0,1,6
TRBV12-3/4,TRBJ2-7,CASSYSSGSYEQYF,6,0,1,6
TRBV6-2/3/5/6,TRBJ1-5,CASSYGGGNQPQHF,6,0,1,6
TRBV2,TRBJ1-6,CASSPPGEISPLHF,6,0,1,6
TRBV2,TRBJ2-5,CASSGPGGRETQYF,6,0,1,6
TRBV2,TRBJ1-1,CASSGRGLNTEAFL,6,0,1,6
TRBV2,TRBJ1-1,CASSGDGRQTEAFF,6,0,1,6
TRBV6-1,TRBJ1-2,CASSGTGDYYGYTF,6,0,1,6
TRBV6-1,TRBJ1-1,CASSESGVYTEAFF,6,0,1,6
TRBV13,TRBJ2-7,CASSLRGGRYEQYF,6,0,1,6
TRBV5-4,TRBJ2-7,CASSLKGGSNEQYF,6,0,1,6
TRBV7-3,TRBJ2-3,CASSLTHTTDTQYF,6,0,1,6
TRBV7-9,TRBJ1-2,CASSLNQVAYGYTF,6,0,1,6
TRBV6-2/3/5/6,TRBJ1-2,CASSSQVTNYGYTF,6,0,1,6
TRBV6-2/3/5/6,TRBJ1-4,CASSLGQLYEKLFF,6,0,1,6
TRBV12-3/4,TRBJ1-5,CASSPLESNQPQHF,6,0,1,6
TRBV7-6,TRBJ1-1,CASSPRTGNTEAFF,6,0,1,6
TRBV7-6,TRBJ1-1,CASSHRYMNTEAFF,6,0,1,6
TRBV12-3/4,TRBJ1-1,CASSHREQNTEAFF,6,15,2,21
TRBV3-1,TRBJ2-1,CASSQNRLADEQFC,6,0,1,6
TRBV12-3/4,TRBJ1-5,CASSGGTSNQPQHF,6,0,1,6
TRBV9,TRBJ1-1,CASSDGQGWTEAFF,6,0,1,6
TRBV7-9,TRBJ2-7,CASSTWRGSYEQYF,6,0,1,6
TRBV13,TRBJ2-5,CASSSPGGEETQYF,6,0,1,6
TRBV5-6,TRBJ2-7,CASRREGTGYEQYF,6,0,1,6
TRBV2,TRBJ1-5,CASKKGGGSQPQHF,6,0,1,6
TRBV5-1,TRBJ2-3,CAARLVPSTDTQYF,6,0,1,6
TRBV5-1,TRBJ1-1,CASTPQGPNTEAFF,6,0,1,6
TRBV10-1,TRBJ2-3,CASSEAGGTDTQYF,6,0,1,6
TRBV5-1,TRBJ2-7,CASSFSGRVDEQYF,6,0,1,6
TRBV5-1,TRBJ2-7,CASSLAGDVYEQYF,6,0,1,6
TRBV5-1,TRBJ2-1,CASSLDRVSNEQFF,6,0,1,6
TRBV5-1,TRBJ1-4,CASSLQGASEKLFF,6,0,1,6
TRBV5-1,TRBJ2-1,CASSLTSGGEEQFF,6,0,1,6
TRBV5-1,TRBJ1-2,CASSSGWANYGYTF,6,0,1,6
TRBV5-1,TRBJ2-1,CASSPREFYNEQFF,6,0,1,6
TRBV4-1,TRBJ1-2,CASSQNRGVYGYTF,6,0,1,6
TRBV5-1,TRBJ1-1,CASSRQGGDTEAFF,6,0,1,6
TRBV20-1,TRBJ2-5,CSAPLPSGEETQYF,6,0,1,6
TRBV20-1,TRBJ1-5,CSARDGTVNQPQHF,6,0,1,6
TRBV29-1,TRBJ2-3,CSVTWGRGTDTQYF,6,3,2,9
TRBV5-1,TRBJ2-7,WASSYGTSGYEQYF,6,0,1,6
TRBV30,TRBJ1-1,CAWSRGPNTEAFF,6,0,1,6
TRBV10-3,TRBJ2-3,CASLAGVTDTQYF,6,0,1,6
TRBV19,TRBJ2-5,CASSMWEKETQYF,6,0,1,6
TRBV19,TRBJ2-1,CASSTGLAGVQFF,6,0,1,6
TRBV19,TRBJ2-1,CASSTKVYNEQFF,6,0,1,6
TRBV18,TRBJ1-5,CASSPGEDQPQHF,6,0,1,6
TRBV18,TRBJ2-5,CASSPGLGETQYF,6,0,1,6
TRBV18,TRBJ2-5,CASSPDSGETQYF,6,0,1,6
TRBV12-3/4,TRBJ2-5,CASSFLTSQTQYF,6,0,1,6
TRBV12-3/4,TRBJ1-3,CASSLSAGNTIYF,6,2,2,8
TRBV12-3/4,TRBJ2-3,CASSLQDADTQYF,6,0,1,6
TRBV2,TRBJ1-5,CASSVFENQPQHF,6,0,1,6
TRBV2,TRBJ1-1,CASSDRGDTEAFF,10,0,1,10
TRBV7-9,TRBJ2-3,CASSLDPVDTQYF,6,0,1,6
TRBV11-2,TRBJ2-5,CASSLERQETQYF,6,0,1,6
TRBV7-2,TRBJ2-2,CASSLTGAGELFF,6,0,1,6
TRBV5-6,TRBJ2-5,CASSLSPGETQYF,6,0,1,6
TRBV3-1,TRBJ2-7,CASSSGGGSEQYF,6,0,1,6
TRBV10-3,TRBJ2-7,CASSSGGPYEQYF,6,0,1,6
TRBV7-3,TRBJ2-3,CASSSDPADTQYF,6,0,1,6
TRBV7-9,TRBJ1-5,CASSWGQNQPQHF,6,0,1,6
TRBV12-3/4,TRBJ1-2,CASSPQANYGYTF,6,0,1,6
TRBV28,TRBJ2-7,CASSPGGSYEQYF,6,0,1,6
TRBV7-3,TRBJ2-1,CASSPTGYNEQFF,6,0,1,6
TRBV5-4,TRBJ2-1,CASSPGLADEQFF,6,0,1,6
TRBV3-1,TRBJ1-6,CASSRDRATPLHF,6,0,1,6
TRBV3-1,TRBJ1-2,CASSQDGRQFSAF,6,0,1,6
TRBV3-1,TRBJ1-2,CASSQDDNHGYTF,6,0,1,6
TRBV14,TRBJ2-7,CASSQEVRSEQYF,6,0,1,6
TRBV6-2/3/5/6,TRBJ2-2,CASSIQGAGELFF,6,0,1,6
TRBV7-9,TRBJ2-3,CASSTRAGATQYF,6,0,1,6
TRBV13,TRBJ1-1,CASSTQGLGEAFF,6,0,1,6
TRBV27,TRBJ2-1,CASRRGVDNEQFF,6,0,1,6
TRBV9,TRBJ2-2,CASRGPNTGELFF,6,0,1,6
TRBV6-4,TRBJ2-7,CASRTDDSYEQYF,6,0,1,6
TRBV28,TRBJ1-2,CTTPSGGVYSYTF,6,0,1,6
TRBV5-1,TRBJ2-3,CASSLSGTDTQYF,6,0,1,6
TRBV5-1,TRBJ1-1,CASSSGRNTEAFF,6,0,1,6
TRBV5-1,TRBJ2-3,CASSSGVPDTQYF,6,0,1,6
TRBV4-1,TRBJ2-3,CASSLRLADTQYF,6,0,1,6
TRBV5-1,TRBJ2-7,CASSTGQGFEQYF,6,0,1,6
TRBV10-2,TRBJ2-7,CASRGQVGYEQYF,6,0,1,6
TRBV20-1,TRBJ2-7,CSASDSLLQEQYF,6,0,1,6
TRBV29-1,TRBJ2-1,CSVVQGVYNEQFF,6,0,1,6
TRBV29-1,TRBJ2-7,CSVAKGISYEQYF,6,0,1,6
TRBV29-1,TRBJ2-7,CSVADTISYEQYF,6,0,1,6
TRBV29-1,TRBJ1-2,CSVGQVLNYGYTF,6,0,1,6
TRBV29-1,TRBJ2-6,CSVDRAGANVLAF,6,0,1,6
TRBV29-1,TRBJ2-7,CSVEVGGNYEQYF,6,0,1,6
TRBV29-1,TRBJ2-5,CSVEDLITETQYF,6,0,1,6
TRBV29-1,TRBJ2-5,CSVEEVGTETQYF,6,0,1,6
TRBV29-1,TRBJ2-3,CSVRTRHTDTQYF,6,0,1,6
TRBV29-1,TRBJ2-4,CSVVRGAKNIQYF,6,0,1,6
TRBV29-1,TRBJ1-1,CSVGRGENTEAFF,6,0,1,6
TRBV29-1,TRBJ1-1,CSADDTLNTEAFF,6,0,1,6
TRBV30,TRBJ1-5,CAWAPDRGPQHF,6,0,1,6
TRBV30,TRBJ1-4,CAWSSAPEKLFF,6,0,1,6
TRBV24-1,TRBJ1-5,CATGQGDQPQHF,6,0,1,6
TRBV12-3/4,TRBJ1-5,CATRQGDQPQHF,6,0,1,6
TRBV19,TRBJ2-1,CASSLHVGEQFF,6,0,1,6
TRBV19,TRBJ2-3,CASSISTDTQYF,6,0,1,6
TRBV19,TRBJ1-2,CASSTGARGYTF,6,0,1,6
TRBV18,TRBJ2-3,CASSPNTDTQYF,6,5,2,11
TRBV2,TRBJ2-5,CASGGQGETQYF,6,0,1,6
TRBV25-1,TRBJ1-6,CASELGNSPLHF,6,0,1,6
TRBV27,TRBJ1-5,CASTRGDQPQHF,6,0,1,6
TRBV28,TRBJ2-1,CASSFWVNEQFF,6,0,1,6
TRBV28,TRBJ1-2,CASSFVGYGYTF,6,0,1,6
TRBV12-3/4,TRBJ2-1,CASSRGQNEQFF,6,0,1,6
TRBV2,TRBJ2-3,CASSEGSGTQYF,6,0,1,6
TRBV2,TRBJ1-3,CASSETRNTIYF,6,0,1,6
TRBV7-9,TRBJ1-2,CASSLPLYGYTF,6,0,1,6
TRBV7-9,TRBJ2-3,CASSLDPNTQYF,6,0,1,6
TRBV5-4,TRBJ1-2,CASSWSGAGYTF,6,0,1,6
TRBV2,TRBJ1-5,CASNEVGQPQHF,6,0,1,6
TRBV2,TRBJ2-3,CGEGPPPDTQYF,6,0,1,6
TRBV5-1,TRBJ2-7,CASSLPGREQYF,6,0,1,6
TRBV20-1,TRBJ2-5,CSAPTVQETQYF,6,0,1,6
TRBV29-1,TRBJ2-5,CSVTGSGETQYF,6,0,1,6
TRBV29-1,TRBJ2-7,CSVDWGAGEQYF,6,0,1,6
TRBV29-1,TRBJ2-5,CSVTRNEETQYF,6,0,1,6
TRBV29-1,TRBJ1-2,CSASGLNYGYTF,6,0,1,6
TRBV29-1,TRBJ2-7,RSGGQGPYEQYF,6,0,1,6
TRBV28,TRBJ2-5,CAVASLETQYF,6,0,1,6
TRBV10-3,TRBJ2-5,CAAGIGETQYF,6,0,1,6
TRBV19,TRBJ1-4,CASESREKLFF,6,0,1,6
TRBV18,TRBJ2-1,CASSPFNEQFF,6,0,1,6
TRBV2,TRBJ2-1,CASRYHNEQFF,6,0,1,6
TRBV11-2,TRBJ2-3,CASTDRDTQYF,6,0,1,6
TRBV11-2,TRBJ1-1,CASSLAGYAFF,6,0,1,6
TRBV11-2,TRBJ2-5,CASSLAETQYF,6,3,2,9
TRBV7-9,TRBJ2-5,CASSSIETQYF,6,0,1,6
TRBV3-1,TRBJ1-1,CASSQGGQENF,6,0,1,6
TRBV29-1,TRBJ1-2,CSVSIAWGYTF,6,2,2,8
TRBV29-1,TRBJ1-1,CSVGGSTEAFF,6,0,1,6
TRBV6-4,TRBJ1-2,CASRGSGYTF,6,0,1,6
TRBV29-1,TRBJ2-7,CSVVSYEQYF,6,0,1,6
TRBV19,TRBJ1-6,CASSTLGHTNYNSPLHY,6,0,1,6
TRBV29-1,TRBJ2-1,CSVAVGLSGGAYNEQFF,6,0,1,6
TRBV6-2/3/5/6,TRBJ2-3,CASSTRRELWTDTQYF,6,0,1,6
TRBV5-1,TRBJ1-3,CASSVGTSPSGNTIYF,6,0,1,6
TRBV30,TRBJ1-5,CAWSAPALSNQPQHF,6,0,1,6
TRBV10-3,TRBJ1-1,CAISRTGSGITEAFF,6,0,1,6
TRBV7-9,TRBJ2-2,CASSLAPSNTGELFF,6,8,2,14
TRBV9,TRBJ1-5,CASSVEGRSNQPQHF,6,0,1,6
TRBV4-1,TRBJ1-6,CASSLRTGENSPLHF,6,8,2,14
TRBV4-1,TRBJ2-1,CASSKLGGLGNEQFF,6,0,1,6
TRBV19,TRBJ2-2,CARRLGSNTGELFF,6,0,1,6
TRBV18,TRBJ2-3,CASSGVESTDTQYF,6,0,1,6
TRBV7-6,TRBJ2-5,CASSLGQGRETQYF,6,0,1,6
TRBV14,TRBJ1-1,CASSQGWVNTEAFF,6,0,1,6
TRBV5-1,TRBJ2-7,CASSLGDRVDEQYF,6,0,1,6
TRBV5-1,TRBJ1-6,CASSLPGDNSPLHF,6,0,1,6
TRBV28,TRBJ1-2,CASSFGTDNGYTF,6,0,1,6
TRBV2,TRBJ2-3,CASRAGVTDTQYF,6,0,1,6
TRBV4-1,TRBJ2-3,CASSQVPGTAMHF,6,0,1,6
TRBV29-1,TRBJ1-3,CSVASGAGNTTYF,6,0,1,6
TRBV29-1,TRBJ2-7,CSDRDYATYEQYF,6,0,1,6
TRBV7-9,TRBJ1-1,CVSMGLVRSAFF,6,0,1,6
TRBV5-1,TRBJ2-1,CASSLEGLPQFF,6,0,1,6
TRBV7-2,TRBJ2-3,CASSLIFPRGGPTDTQYF,6,0,1,6
TRBV10-3,TRBJ2-3,CAISGTGLITSTGTQYF,6,0,1,6
TRBV3-1,TRBJ2-7,CASSQDRGVGGTYEQYF,6,0,1,6
TRBV18,TRBJ1-4,CASSPHPPATNENLFF,6,0,1,6
TRBV7-6,TRBJ1-3,CASSPRGNLAGNTIYL,6,0,1,6
TRBV14,TRBJ2-1,CASSQDKGDSYNEQFF,6,0,1,6
TRBV28,TRBJ1-1,CASSLWVSMNTEASF,6,0,1,6
TRBV28,TRBJ2-1,CASSRLAGLYNGQFF,6,0,1,6
TRBV7-9,TRBJ1-1,CASSLGGTGGTEAFF,6,0,1,6
TRBV7-3,TRBJ2-2,CASSLNGADTGELFF,6,0,1,6
TRBV4-1,TRBJ1-5,CVSSQASGGNQPQHF,6,0,1,6
TRBV5-1,TRBJ2-7,CASRQDSSISYEQYF,6,0,1,6
TRBV20-1,TRBJ1-1,CSARRFEGGDAEAFF,6,0,1,6
TRBV19,TRBJ1-1,CASSTQGARTEAFF,6,0,1,6
TRBV7-9,TRBJ2-7,CASSLARTAYEQYF,6,0,1,6
TRBV29-1,TRBJ1-5,CSVVVSGPNHPQHF,6,0,1,6
TRBV2,TRBJ2-5,CASNRGGRETQYF,6,0,1,6
TRBV12-3/4,TRBJ2-1,CASSRRAFEQFF,6,0,1,6
TRBV11-2,TRBJ1-1,CASSPRPPGAFF,6,0,1,6
TRBV28,TRBJ1-2,CASSLSTDRPSFNLQANYGYTF,5,0,1,5
TRBV6-2/3/5/6,TRBJ1-1,CASSYKGPGQVYGANTEAFF,5,0,1,5
TRBV7-9,TRBJ2-1,CATRPLGLAGATSYNEQFF,5,0,1,5
TRBV2,TRBJ2-3,CASSDGTSGGVFRTDTQYF,5,0,1,5
TRBV28,TRBJ2-3,CASSNGLGTWSRASDTQYF,5,0,1,5
TRBV11-2,TRBJ2-7,CASSLPLSFDRAPYYEQYF,5,0,1,5
TRBV14,TRBJ2-7,CASSQDPSTGGFLAYEQYF,5,0,1,5
TRBV5-1,TRBJ2-1,CASKSDGVLVPYSYNEQFF,5,0,1,5
TRBV12-5,TRBJ1-2,CASGWYDIWQGINYGYTF,5,0,1,5
TRBV28,TRBJ1-1,CAGSFRLGGGNQNTEAFF,5,0,1,5
TRBV6-2/3/5/6,TRBJ2-1,CASSYTSPAGVFYNEQFF,5,0,1,5
TRBV28,TRBJ2-7,CASSPMFVAATGHYEQYF,5,0,1,5
TRBV7-2,TRBJ2-2,CASSLVIWAGGSAGELFF,5,0,1,5
TRBV7-3,TRBJ2-1,CASSLTLLAEGPYNEQFF,5,0,1,5
TRBV9,TRBJ2-2,CASSPSWGHPSYTGELFF,5,0,1,5
TRBV14,TRBJ1-3,CASSQDLWDPRGRNTIYF,5,2,2,7
TRBV3-1,TRBJ2-2,CASSQDLLRGGLTGELFF,5,0,1,5
TRBV3-1,TRBJ2-3,CASSQEASGGSVSGTQYF,5,0,1,5
TRBV7-9,TRBJ2-3,CASSGGRLAERSTDTQYF,5,0,1,5
TRBV4-1,TRBJ1-5,CASSQGVKAGASNQPQHF,5,0,1,5
TRBV19,TRBJ2-1,CASSMGSGAGSEYKQFF,5,0,1,5
TRBV19,TRBJ1-2,CASSIGSAGDRNYGYTL,5,0,1,5
TRBV19,TRBJ2-7,CASSIDWWQGVAYEQYF,5,0,1,5
TRBV28,TRBJ1-5,CASTRRGAGGNSQPQHF,5,0,1,5
TRBV28,TRBJ2-3,CASSLWGSGESTDTQYF,5,0,1,5
TRBV2,TRBJ2-1,CASSSRTSGGRYNEQFF,5,0,1,5
TRBV6-2/3/5/6,TRBJ2-3,CASSYSRLVTGTDTQYF,5,0,1,5
TRBV9,TRBJ1-2,CASSPLPSRGAGYGYTF,5,0,1,5
TRBV28,TRBJ2-7,CASSHRLAGGRIYEQYF,5,0,1,5
TRBV6-4,TRBJ1-6,CASSVSLIGGFNSPLHF,5,0,1,5
TRBV7-3,TRBJ1-4,CASSFERIPLPHEKLFF,5,0,1,5
TRBV7-9,TRBJ1-1,CASSLWGTGEINTEAFF,5,0,1,5
TRBV7-3,TRBJ2-1,CASSLLGQHSSYNEQFF,5,0,1,5
TRBV7-2,TRBJ2-7,CASSLGQTGVISYEQYF,5,0,1,5
TRBV5-6,TRBJ1-5,CASSSPGGKGGNQPQHF,5,0,1,5
TRBV11-2,TRBJ1-2,CASSSLRVGGSNYGYTF,5,0,1,5
TRBV11-2,TRBJ2-1,CASSSALLRGGRNEQFF,5,0,1,5
TRBV11-2,TRBJ1-1,CASSSTTLGQPNTEAFF,5,0,1,5
TRBV5-6,TRBJ2-2,CASSPQLAGEHTGELFF,5,0,1,5
TRBV3-1,TRBJ2-2,CASSQRDRGANTGELFF,5,0,1,5
TRBV3-1,TRBJ2-5,CASSQDAPRPLHETQYF,5,0,1,5
TRBV9,TRBJ2-1,CASSVEGGGRGSNEQFF,5,0,1,5
TRBV12-3/4,TRBJ2-1,CASSGLAGGPSYNEQFF,5,9,2,14
TRBV27,TRBJ2-1,CASRKLSVGRGSNEQFF,5,0,1,5
TRBV5-1,TRBJ2-1,CASSLVAGGSSYNEQFF,5,0,1,5
TRBV5-1,TRBJ2-2,CASSLDGSGDVTGELFF,5,0,1,5
TRBV5-1,TRBJ2-3,CASSRTSGGAPADTQYF,5,0,1,5
TRBV4-1,TRBJ2-1,CASSQVLAGGPLSEQFF,5,0,1,5
TRBV4-1,TRBJ1-2,CASSQGVGGLRHLGYTF,5,0,1,5
TRBV29-1,TRBJ2-3,CSVEFRSGGPFTDTQYF,5,0,1,5
TRBV7-7,TRBJ2-2,CASSERQASNTGELFF,5,0,1,5
TRBV10-3,TRBJ2-5,CAISDSEAGILETQYF,5,0,1,5
TRBV19,TRBJ1-1,CASTSFLGRLNTEAFF,5,0,1,5
TRBV12-3/4,TRBJ1-1,CASSFGTLVMSTEAFF,5,0,1,5
TRBV19,TRBJ2-1,CASRTSGPLSNNEQFF,5,0,1,5
TRBV18,TRBJ1-1,CASSPLGGHLNTEAFF,5,0,1,5
TRBV18,TRBJ1-5,CASSRSGRGSNQPQHF,5,0,1,5
TRBV18,TRBJ1-2,CASSRGPGPTNYGYTF,5,0,1,5
TRBV28,TRBJ1-4,CASGPRATGSNEKLFF,5,0,1,5
TRBV2,TRBJ2-1,CASTASRGGAYNEQFF,5,0,1,5
TRBV28,TRBJ1-1,CASSFRSGMGNAEAFF,5,0,1,5
TRBV12-3/4,TRBJ2-3,CASSLARDRGPDTQYF,5,0,1,5
TRBV28,TRBJ1-3,CASSLGRANSGNTIYF,5,0,1,5
TRBV6-2/3/5/6,TRBJ2-5,CASSYSTGVGQETQYF,5,0,1,5
TRBV28,TRBJ1-5,CASSPPPGGQRQPQHF,5,0,1,5
TRBV28,TRBJ1-4,CASSPDIYATNEKLFF,5,0,1,5
TRBV5-5,TRBJ2-3,CASSRGPSGGLDTQYF,5,0,1,5
TRBV12-3/4,TRBJ1-4,CASSVRGRASNEKLFF,5,0,1,5
TRBV6-2/3/5/6,TRBJ2-1,CASSALTSSGRYEQFF,5,0,1,5
TRBV6-1,TRBJ2-1,CASSDVSWDWYNEQFF,5,0,1,5
TRBV2,TRBJ2-7,CASSDPGHGTGYEQYF,5,0,1,5
TRBV2,TRBJ2-7,CASSEITTDLLHEQYF,5,0,1,5
TRBV28,TRBJ2-5,CASSMDFGPSQETQYF,5,0,1,5
TRBV6-2/3/5/6,TRBJ2-1,CASSTKTSGTFWRQFF,5,0,1,5
TRBV27,TRBJ2-1,CASSKGIGPSYNEQFF,5,0,1,5
TRBV5-6,TRBJ1-5,CASSFGRTGPSQPQHF,5,0,1,5
TRBV5-6,TRBJ2-3,CASSLRQPVTTDTQYF,5,0,1,5
TRBV5-5,TRBJ2-3,CASSLVHMGFTDTQYF,5,0,1,5
TRBV7-2,TRBJ2-5,CASSLAGSAGQETQYF,5,0,1,5
TRBV7-9,TRBJ1-1,CASSLARTGVNTEAFF,5,0,1,5
TRBV11-2,TRBJ2-1,CASSLGSGSSYNEQFF,5,0,1,5
TRBV7-2,TRBJ2-2,CASSLGGGASIGELFF,5,0,1,5
TRBV7-3,TRBJ2-6,CASSLSGGSGANVLTF,5,0,1,5
TRBV28,TRBJ2-3,CASSSPPGGRTDTQYF,5,0,1,5
TRBV12-3/4,TRBJ2-2,CASSWGTGQNTGELFF,5,0,1,5
TRBV6-2/3/5/6,TRBJ2-5,CASSPPGGGLQETQYF,5,0,1,5
TRBV7-9,TRBJ2-1,CASSPYTRQGYNEQFF,5,0,1,5
TRBV11-2,TRBJ1-2,CASSPAAATLNYGYTF,5,0,1,5
TRBV27,TRBJ1-4,CASSPGTGGTNEKLFF,5,0,1,5
TRBV7-3,TRBJ2-1,CASSPSSGGVRHEQFF,5,0,1,5
TRBV12-3/4,TRBJ1-5,CASSRLTRGSNQPQHF,5,0,1,5
TRBV28,TRBJ2-4,CASSRRQSVAKNIQYF,5,0,1,5
TRBV3-1,TRBJ2-3,CASSQAHSGGTDTQYF,5,0,1,5
TRBV6-2/3/5/6,TRBJ2-1,CASSQSGTREYNEQFF,5,0,1,5
TRBV5-4,TRBJ2-3,CASSQRLAGGTDTQYF,5,0,1,5
TRBV3-1,TRBJ2-3,CASSQASSGGRDTQYF,5,0,1,5
TRBV11-2,TRBJ2-2,CASSVLTGGSAGELFF,5,0,1,5
TRBV9,TRBJ1-2,CASSVGTGTYRDGYTF,5,0,1,5
TRBV7-9,TRBJ2-4,CASSKQGVIAKNIQYF,5,0,1,5
TRBV14,TRBJ1-5,CASRPSRGVSNQPQHF,5,3,2,8
TRBV28,TRBJ1-2,CASKSPRTQGGYGYTF,5,0,1,5
TRBV2,TRBJ2-2,CAREAFPGGGNGELFF,5,0,1,5
TRBV5-1,TRBJ2-1,CASSLGPSGDHNEQFF,5,0,1,5
TRBV5-1,TRBJ2-3,CASSLEGGTGHAPQYF,5,0,1,5
TRBV5-1,TRBJ2-5,CASSLSGGPSQETQYF,5,0,1,5
TRBV4-1,TRBJ1-1,CASSLLPAGTPKAAFF,5,7,2,12
TRBV5-1,TRBJ2-2,CASSPWTGLRTGELFF,5,0,1,5
TRBV5-1,TRBJ2-6,CASSRDTQSGANVLTF,5,0,1,5
TRBV4-1,TRBJ2-7,CASSQDANRRTYEQYF,5,0,1,5
TRBV4-1,TRBJ1-2,CASSQEQGRLNYGYTF,5,2,2,7
TRBV5-1,TRBJ2-5,CASSTGRLAGQETQYF,5,0,1,5
TRBV4-1,TRBJ2-7,CASSNELAGGSYEQYF,5,0,1,5
TRBV20-1,TRBJ2-1,CSARVWGLSSYNEQFF,5,0,1,5
TRBV20-1,TRBJ2-2,CSARVIQGANTGGLFF,5,0,1,5
TRBV20-1,TRBJ1-2,CSARTQGAKLNYGYTF,5,0,1,5
TRBV29-1,TRBJ2-6,CSVSLQGAVGANVLTF,5,0,1,5
TRBV29-1,TRBJ2-6,CSVEVDYNSGANVLTF,5,0,1,5
TRBV18,TRBJ1-6,YASSPRIGDRNSPLRF,5,0,1,5
TRBV12-5,TRBJ2-1,CASGLGGAPFDEQFF,5,0,1,5
TRBV30,TRBJ1-4,CAWSTQSATNEKLFF,5,0,1,5
TRBV30,TRBJ2-2,CAWSGTSGVTGELFF,5,0,1,5
TRBV10-3,TRBJ1-6,CAISEGTADNSPLHF,5,0,1,5
TRBV24-1,TRBJ2-3,CATSLPGASSDTQYF,5,0,1,5
TRBV24-1,TRBJ2-1,CATSEAGGIRNEQFF,5,0,1,5
TRBV19,TRBJ2-3,CASRDSPRSTDTQYF,5,0,1,5
TRBV19,TRBJ2-1,CASSIGGEPYNEQFF,5,0,1,5
TRBV19,TRBJ2-4,CASSMGPSGKNIQYF,5,3,2,8
TRBV19,TRBJ2-2,CASSIDPGRNRELFF,5,0,1,5
TRBV19,TRBJ2-1,CASNAGGNSYNEQFF,5,0,1,5
TRBV18,TRBJ1-4,CASSPGTGDVEKLFF,5,0,1,5
TRBV18,TRBJ1-4,CASSPRRFSNEKLFF,5,6,2,11
TRBV28,TRBJ2-5,CASREGGACEETQYF,5,0,1,5
TRBV2,TRBJ2-3,CASGEQGIQRDTQYF,5,0,1,5
TRBV28,TRBJ1-6,CASTRVVGQNSPLHF,5,0,1,5
TRBV2,TRBJ2-1,CASTHGEAIYNEQFF,5,0,1,5
TRBV2,TRBJ1-5,CASTPAMDSFQPQHF,5,0,1,5
TRBV12-3/4,TRBJ1-4,CASSFDGPVNEKLFF,5,0,1,5
TRBV6-2/3/5/6,TRBJ2-7,CASSFPPQGKYEQYF,5,0,1,5
TRBV28,TRBJ2-7,CASSFRGGAKHEQYF,5,0,1,5
TRBV6-2/3/5/6,TRBJ2-6,CASSFGGPGANVLTF,5,0,1,5
TRBV6-2/3/5/6,TRBJ1-2,CASSFDVGVSNGYTF,5,0,1,5
TRBV12-3/4,TRBJ1-2,CASSLRVGTDYGYTF,5,0,1,5
TRBV7-9,TRBJ2-3,CASSLRAGGTDTQYF,7,0,1,7
TRBV6-2/3/5/6,TRBJ2-1,CASSLQARGYNEQFF,5,0,1,5
TRBV28,TRBJ1-2,CASSLQGANYYGYTL,5,0,1,5
TRBV5-1,TRBJ2-5,CASSLGQGGGETQYF,9,0,1,9
TRBV12-3/4,TRBJ1-5,CASSLGGNSNQPQHF,5,0,1,5
TRBV28,TRBJ1-1,CASSLRRGLDTEAFF,5,0,1,5
TRBV28,TRBJ2-7,CASSSWTGTRYEQYF,5,6,2,11
TRBV12-3/4,TRBJ2-3,CASSSRTGWPDTQYF,5,0,1,5
TRBV12-3/4,TRBJ2-7,CASSSGQGAFDEQYF,5,0,1,5
TRBV28,TRBJ2-5,CASSYVGTRRGTQYF,5,0,1,5
TRBV6-2/3/5/6,TRBJ2-7,CASSYGQGSSYEQYF,5,0,1,5
TRBV6-2/3/5/6,TRBJ2-1,CASSLGGRGYNEQFF,5,0,1,5
TRBV6-2/3/5/6,TRBJ1-1,CASSPTGQGYTEAFF,5,0,1,5
TRBV28,TRBJ2-7,CASSRGHIARIGQYF,5,0,1,5
TRBV2,TRBJ1-2,CASSATGSANYGYTF,5,0,1,5
TRBV6-1,TRBJ2-3,CASSDGTALGDTQYF,5,0,1,5
TRBV6-1,TRBJ2-3,CASSDSGVSTDTQYF,5,0,1,5
TRBV6-2/3/5/6,TRBJ1-5,CASSTGGMGNQPQHF,5,0,1,5
TRBV6-2/3/5/6,TRBJ2-1,CASSFSPPGYNEQFF,5,0,1,5
TRBV5-5,TRBJ1-1,CASSFVTGANTEAFF,5,0,1,5
TRBV5-5,TRBJ1-5,CASSLQGYSNQPQHF,5,0,1,5
TRBV5-5,TRBJ2-3,CASSLARGGGDTQYF,5,0,1,5
TRBV5-8,TRBJ1-1,CASSLSIRGRPEAFF,5,0,1,5
TRBV11-2,TRBJ1-1,CASSLLVDSNTEAFF,5,0,1,5
TRBV7-9,TRBJ1-1,CASSLVRSTNTEAFF,5,0,1,5
TRBV7-9,TRBJ2-2,CASSLVRIFTGELFF,5,0,1,5
TRBV5-6,TRBJ1-6,CASSLAQWLNSPLHF,5,0,1,5
TRBV11-2,TRBJ1-5,CASSLGGQGNQPQHF,5,0,1,5
TRBV11-2,TRBJ1-1,CASSLEGGGLQKPFF,5,0,1,5
TRBV7-3,TRBJ2-1,CASSLTLLGDNEQFF,5,0,1,5
TRBV7-2,TRBJ1-4,CASSSAAGPNEKLFF,5,0,1,5
TRBV9,TRBJ2-3,CASSWGQGATDTQYF,5,0,1,5
TRBV11-2,TRBJ2-5,CASSPPRQFQETQYF,5,0,1,5
TRBV7-9,TRBJ2-1,CASSPPGVSYNEQFF,5,0,1,5
TRBV14,TRBJ1-2,CASSPSTGYGYGYTF,5,0,1,5
TRBV28,TRBJ2-5,CASSPAWDRQETQYF,5,0,1,5
TRBV7-3,TRBJ2-1,CASSRLAGGFDEQFF,5,0,1,5
TRBV3-1,TRBJ2-3,CASSHLGARTDTQYF,5,0,1,5
TRBV3-1,TRBJ2-3,CASSQFASGAYTQYF,5,0,1,5
TRBV7-3,TRBJ1-2,CASSQAGTGLDGYTF,5,0,1,5
TRBV3-1,TRBJ1-5,CASSQGGGSNQPQHF,5,0,1,5
TRBV3-1,TRBJ1-1,CASSQDPRRDTEAFF,5,0,1,5
TRBV4-2,TRBJ2-5,CASSQDQGRGETQYF,5,0,1,5
TRBV14,TRBJ1-1,CASSQDVGTYTEAFF,5,0,1,5
TRBV11-2,TRBJ1-4,CASSQDRIRGEKLFF,5,0,1,5
TRBV4-2,TRBJ2-1,CASSQERLSYNEQFF,5,0,1,5
TRBV3-1,TRBJ1-6,CASSQTTVANSPLHF,5,0,1,5
TRBV2,TRBJ1-4,CASSVLGGYNEKLFF,5,0,1,5
TRBV2,TRBJ2-3,CASSVLGPTADTQYF,5,0,1,5
TRBV9,TRBJ2-3,CASSVGVDRADTQYF,5,0,1,5
TRBV7-2,TRBJ2-3,CASSASSGGGGTQYF,5,0,1,5
TRBV9,TRBJ2-1,CASSAQGASYNEQFF,5,0,1,5
TRBV9,TRBJ2-2,CASSDQAGAIGELFF,5,0,1,5
TRBV12-3/4,TRBJ2-7,CASRGDARSSYEQYF,5,0,1,5
TRBV6-2/3/5/6,TRBJ1-5,CASRPGTISNQPQHF,5,0,1,5
TRBV14,TRBJ2-2,CASRRQGLNTGELFF,5,0,1,5
TRBV2,TRBJ1-3,CASRGVKSSRNTIYF,5,0,1,5
TRBV27,TRBJ2-7,CASRETGQVVNEQYF,5,0,1,5
TRBV5-4,TRBJ1-2,CASNPELSNPAGYTF,5,0,1,5
TRBV6-2/3/5/6,TRBJ2-7,CASKKLAASSYEQYF,5,0,1,5
TRBV28,TRBJ1-1,CTSSSPGQLNTEAFF,5,0,1,5
TRBV6-2/3/5/6,TRBJ1-2,CTSSYSPNMNYGYTF,5,0,1,5
TRBV10-3,TRBJ1-2,CAITAGTGDLYGYTF,5,0,1,5
TRBV5-1,TRBJ2-2,CASIIKKPNSGELFF,5,0,1,5
TRBV5-1,TRBJ1-1,CASSKTGGAYTEAFF,5,0,1,5
TRBV5-1,TRBJ2-1,CASSFSSSAANEQFF,5,0,1,5
TRBV5-1,TRBJ2-3,CASSFAGDSTDTQYF,5,0,1,5
TRBV5-1,TRBJ1-1,CASSLQAFGGTEAFF,5,0,1,5
TRBV5-1,TRBJ2-7,CASSLGGGTDYEQYF,5,0,1,5
TRBV5-1,TRBJ1-6,CASSLDQGKGSPLHF,5,0,1,5
TRBV5-1,TRBJ2-3,CASSLDRGAHDTQYF,5,0,1,5
TRBV5-1,TRBJ2-1,CASSLELASYNEQFF,5,0,1,5
TRBV5-1,TRBJ1-5,CASSSSGQVNQPQHF,5,0,1,5
TRBV5-1,TRBJ2-5,CASSSASGGFETQYF,5,0,1,5
TRBV4-1,TRBJ2-7,CASSPRAGGPPEQYF,5,0,1,5
TRBV5-1,TRBJ2-1,CASSPRQDNYNEQFF,5,0,1,5
TRBV5-1,TRBJ2-7,CASSPGTVLGFEQYF,5,0,1,5
TRBV5-1,TRBJ1-5,CASSPTGTEFQPQHF,5,0,1,5
TRBV5-1,TRBJ2-6,CASSREGTGANVLTF,5,0,1,5
TRBV5-1,TRBJ1-6,CASSRQQGRGSPLHF,5,0,1,5
TRBV4-1,TRBJ2-7,CASSRSALGDYEQYF,5,0,1,5
TRBV4-1,TRBJ1-1,CASSHGTGENTEAFF,5,0,1,5
TRBV5-1,TRBJ2-1,CASSQGTGFNNEQFF,5,0,1,5
TRBV4-1,TRBJ1-5,CASSQVVNSNQPQHF,5,0,1,5
TRBV4-1,TRBJ1-2,CASSQDSPGASGYTF,5,0,1,5
TRBV5-1,TRBJ1-2,CASSGGDPANYGYTF,5,0,1,5
TRBV5-1,TRBJ1-1,CASSGTGGRNTEAFF,5,0,1,5
TRBV5-1,TRBJ1-1,CASSKQGRMNTEAFF,5,0,1,5
TRBV20-1,TRBJ2-5,CSAISSGTGQETQYF,5,0,1,5
TRBV20-1,TRBJ2-1,CSARPPGRTGGEQFF,5,0,1,5
TRBV20-1,TRBJ1-1,CSARPRTGGSTEAFF,5,0,1,5
TRBV20-1,TRBJ2-1,CSARPLTGEYNEQFF,5,0,1,5
TRBV20-1,TRBJ1-1,CSARAPGTVNTEAFF,5,0,1,5
TRBV20-1,TRBJ2-1,CSARDLRQGNNELFF,5,0,1,5
TRBV20-1,TRBJ2-1,CSARRVGAYHNEQFF,5,0,1,5
TRBV20-1,TRBJ2-1,CSAPKRGGIYNEQFF,5,0,1,5
TRBV29-1,TRBJ2-3,CSVGGPGSITDTQYF,5,0,1,5
TRBV29-1,TRBJ1-3,CSVERTGSSGNTIYF,5,0,1,5
TRBV29-1,TRBJ1-6,CSVPMTRGKRSPLHF,5,0,1,5
TRBV29-1,TRBJ2-1,CSAPSGGRVGNEQFF,5,0,1,5
TRBV5-6,TRBJ2-1,SASSKSSALESEQFI,5,0,1,5
TRBV30,TRBJ1-4,CAWSIGGHAEKLFF,5,0,1,5
TRBV10-3,TRBJ1-1,CAISLDPVNTEAFF,5,0,1,5
TRBV10-3,TRBJ1-5,CAISELGDSQPQHF,5,0,1,5
TRBV19,TRBJ2-1,CATSIRQGPGEQFF,5,0,1,5
TRBV15,TRBJ1-5,CATGTSIGNQPQHF,5,0,1,5
TRBV24-1,TRBJ2-7,CATSDGTGRGEQYF,5,0,1,5
TRBV24-1,TRBJ2-2,CATSDHRDTGELFF,5,0,1,5
TRBV19,TRBJ1-5,CASGSQGSSQPQHF,5,0,1,5
TRBV19,TRBJ1-2,CASSSPGVGYGYTF,5,0,1,5
TRBV19,TRBJ1-4,CASSRRGGPEKLFF,5,0,1,5
TRBV19,TRBJ1-1,CASSIPNSNTEAFF,5,0,1,5
TRBV19,TRBJ1-5,CASSMLVGGQPQHF,5,0,1,5
TRBV19,TRBJ2-7,CASSNREAQAEQYF,5,0,1,5
TRBV19,TRBJ2-7,CASSQGRGVYEQYF,5,0,1,5
TRBV19,TRBJ2-6,CASRGSSGANVLTF,5,0,1,5
TRBV18,TRBJ1-1,CASSPGGGNTEAFF,5,0,1,5
TRBV18,TRBJ1-1,CASSHSDRVFEAFF,5,0,1,5
TRBV2,TRBJ1-1,CASRFKTTNTEAFF,5,0,1,5
TRBV5-4,TRBJ1-1,CASIDRNMNTEAFF,5,0,1,5
TRBV12-3/4,TRBJ1-2,CASSFLGQVYGYTF,5,0,1,5
TRBV6-2/3/5/6,TRBJ2-5,CASSFRGVEGTQYF,5,0,1,5
TRBV12-3/4,TRBJ1-1,CASSFTQGVGEAFF,5,0,1,5
TRBV12-3/4,TRBJ2-7,CASSLGRRTYEQYF,5,0,1,5
TRBV6-2/3/5/6,TRBJ2-3,CASSLRPLVNTQYF,5,0,1,5
TRBV6-2/3/5/6,TRBJ2-5,CASSSRQGQETQYF,5,0,1,5
TRBV2,TRBJ1-2,CASSRDRAGYGYTF,5,0,1,5
TRBV6-2/3/5/6,TRBJ1-1,CASSRGAVNAEALF,5,0,1,5
TRBV6-2/3/5/6,TRBJ2-3,CASSQRGIADTQYF,5,0,1,5
TRBV12-3/4,TRBJ1-6,CASSQNDRVSPLHF,5,0,1,5
TRBV6-1,TRBJ1-1,CASSEYRMNTEAFF,5,0,1,5
TRBV2,TRBJ2-5,CASSEQGVEETQYF,5,0,1,5
TRBV2,TRBJ2-7,CASSEVSSGYEQYF,5,0,1,5
TRBV27,TRBJ1-2,CASSIQGASDGYTF,5,0,1,5
TRBV5-6,TRBJ2-7,CASSFGGGSYEQYF,5,0,1,5
TRBV7-3,TRBJ2-1,CASSFTGSPNEQFF,5,0,1,5
TRBV7-3,TRBJ1-1,CASSFTGVDTEAFF,5,0,1,5
TRBV7-9,TRBJ2-1,CASSLSGQDNEQFF,5,0,1,5
TRBV5-6,TRBJ1-1,CASSLLTANTEAFF,5,0,1,5
TRBV5-4,TRBJ2-5,CASSLPGGRETQYF,5,0,1,5
TRBV11-2,TRBJ2-5,CASSLGSSVETQYF,5,0,1,5
TRBV7-9,TRBJ2-7,CASSLGTASNEQYF,5,0,1,5
TRBV7-9,TRBJ2-7,CASSLGQGTNEQYF,5,0,1,5
TRBV11-2,TRBJ2-7,CASSLNTGGYEQYF,5,0,1,5
TRBV7-6,TRBJ2-5,CASSLFRGKETQYF,5,0,1,5
TRBV7-2,TRBJ1-5,CASSLVREGQPQHF,5,0,1,5
TRBV7-2,TRBJ1-1,CASSLAQGLVRAFF,5,0,1,5
TRBV7-9,TRBJ1-5,CASSLADRGQPQHF,5,0,1,5
TRBV7-9,TRBJ1-1,CASSLGHLNTEAFF,5,0,1,5
TRBV11-2,TRBJ1-2,CASSLDVGPHGYTF,5,0,1,5
TRBV7-2,TRBJ2-7,CASSLSYRDHEQYF,5,0,1,5
TRBV7-9,TRBJ1-5,CASSSGTRNQPQHF,5,0,1,5
TRBV5-5,TRBJ1-4,CASSSRGSDEKLFF,5,0,1,5
TRBV5-4,TRBJ2-1,CASSSGLGYNEQFF,5,0,1,5
TRBV5-4,TRBJ1-6,CASSSDILTSPLHF,5,0,1,5
TRBV11-2,TRBJ2-2,CASSLSGGTGELFF,5,0,1,5
TRBV9,TRBJ2-7,CASSPRQVSGEQYF,5,0,1,5
TRBV6-2/3/5/6,TRBJ1-1,CASSPWTVNTEAFF,5,0,1,5
TRBV11-2,TRBJ2-3,CASSPRPLTDTQYF,5,0,1,5
TRBV5-4,TRBJ2-7,CASSPTAASYEQYF,5,0,1,5
TRBV12-3/4,TRBJ2-7,CASSPLGGIYEQYF,5,0,1,5
TRBV14,TRBJ1-1,CASSPVGRRTEAFF,5,0,1,5
TRBV7-9,TRBJ2-1,CASSPGGGYNEQFF,5,0,1,5
TRBV3-1,TRBJ1-1,CASSPNPDRFEAFF,5,0,1,5
TRBV11-1,TRBJ1-6,CASSRGSYNSPLHF,5,0,1,5
TRBV4-2,TRBJ1-2,CASSHPRDNYGYTF,5,0,1,5
TRBV7-9,TRBJ1-5,CASSHGGRGQPQHF,5,0,1,5
TRBV5-6,TRBJ1-2,CASSQTGFAYGYTF,5,0,1,5
TRBV7-3,TRBJ2-7,CASSQDSGDYEQYF,5,0,1,5
TRBV11-2,TRBJ2-7,CASSAPGQSYEQYF,5,0,1,5
TRBV3-1,TRBJ1-3,CASSIDRTGNTIYF,5,0,1,5
TRBV12-3/4,TRBJ1-1,CASRVLGTASEAFF,5,0,1,5
TRBV7-2,TRBJ2-3,CASRTTSTTDTQYF,5,0,1,5
TRBV28,TRBJ2-7,CASRLQDGAYEQYF,5,0,1,5
TRBV12-3/4,TRBJ1-2,CASRPTGTENGYTF,5,0,1,5
TRBV7-2,TRBJ2-1,CASRQGSSYNEQFF,5,0,1,5
TRBV28,TRBJ2-7,CASRQLPGLYEQYF,5,0,1,5
TRBV5-4,TRBJ2-5,CASRAGTSGDTQYF,5,0,1,5
TRBV7-2,TRBJ2-7,CASKGTLDFYEQYF,5,0,1,5
TRBV12-5,TRBJ2-7,CASDSGTGTYEQYF,5,0,1,5
TRBV10-1,TRBJ2-3,CACSSGGSTDTQYF,5,0,1,5
TRBV5-1,TRBJ1-4,CARSSRDQNEKLIF,5,0,1,5
TRBV5-1,TRBJ2-7,CASTWTGGFYEQYF,5,0,1,5
TRBV5-1,TRBJ2-7,CASSFYQGLYEQYF,5,0,1,5
TRBV5-1,TRBJ2-2,CASSLAGGTGELFF,5,0,1,5
TRBV5-1,TRBJ2-7,CASSLDFSRYEQYF,5,0,1,5
TRBV5-1,TRBJ2-7,CASSLDPSSYEQYF,5,0,1,5
TRBV5-1,TRBJ2-7,CASSLEANSYEQYF,5,0,1,5
TRBV5-1,TRBJ1-4,CASSSSQGAEKLFF,5,0,1,5
TRBV5-1,TRBJ1-5,CASSSGTGNQPQHF,5,0,1,5
TRBV5-1,TRBJ1-1,CASSQTGVNTEAFF,5,0,1,5
TRBV4-1,TRBJ2-2,CASSQVSNTGELFF,5,0,1,5
TRBV4-1,TRBJ1-1,CASSQGEWDTEAFF,5,0,1,5
TRBV5-1,TRBJ1-5,CASSTGQINQPQHF,5,0,1,5
TRBV20-1,TRBJ2-7,CSVLAGDFSYEQYF,5,0,1,5
TRBV20-1,TRBJ2-2,CSASAGRYTGELFF,5,0,1,5
TRBV20-1,TRBJ1-5,CSAQTGQSGQPQHF,5,0,1,5
TRBV20-1,TRBJ2-3,CSATPSGVTDTQYF,5,0,1,5
TRBV20-1,TRBJ2-3,CSASGGFKLDTQYF,5,2,2,7
TRBV20-1,TRBJ1-2,CSARASDRAIGYTF,5,0,1,5
TRBV20-1,TRBJ2-7,CSARDQLNSYEQYF,5,0,1,5
TRBV20-1,TRBJ2-1,CSASIGGRYNEQFF,5,0,1,5
TRBV20-1,TRBJ2-5,CSAPKGGGRETQYF,5,0,1,5
TRBV20-1,TRBJ2-1,CSAPGLAERHEQFF,5,0,1,5
TRBV20-1,TRBJ1-6,CSAPPHLRNSPLHF,5,0,1,5
TRBV29-1,TRBJ1-2,CSVPDRGFAHGYTF,5,0,1,5
TRBV29-1,TRBJ1-3,CSVEVPSSGNTIYF,5,0,1,5
TRBV29-1,TRBJ2-2,CSVETPTNTGELFF,5,0,1,5
TRBV29-1,TRBJ2-5,CSVERGRRGETQYF,5,0,1,5
TRBV29-1,TRBJ2-7,CSVIPGTGTYEQYF,5,0,1,5
TRBV29-1,TRBJ1-3,CSVTQGGSGNTIYF,5,0,1,5
TRBV29-1,TRBJ1-1,CSARTTGSNTEAFF,5,4,2,9
TRBV29-1,TRBJ2-7,CSATSGLRTGEQYI,5,0,1,5
TRBV29-1,TRBJ1-2,CSAEEGGGIYGYTF,5,0,1,5
TRBV29-1,TRBJ1-4,CSATPTGNYEKLFF,5,0,1,5
TRBV29-1,TRBJ2-1,CSGEGLAGAPGQFF,5,0,1,5
TRBV7-2,TRBJ1-1,WASSLQPTNTEAFF,5,0,1,5
TRBV11-2,TRBJ2-2,RASSWERGATEVFF,5,0,1,5
TRBV7-8,TRBJ2-2,CVSSRGGTGELFF,5,0,1,5
TRBV12-5,TRBJ2-7,CASGPDLGYEQYF,5,0,1,5
TRBV30,TRBJ2-1,CAWSSRRDSPPKI,5,0,1,5
TRBV7-9,TRBJ2-1,CAGIGGVYNEQFF,5,0,1,5
TRBV3-1,TRBJ1-2,CAGSQGQSGGYTF,5,0,1,5
TRBV7-2,TRBJ2-5,CAGSILPFQTQYF,5,0,1,5
TRBV2,TRBJ2-3,CAITSGGTDTQYF,5,0,1,5
TRBV10-3,TRBJ2-1,CAISEDTYNEQFF,5,0,1,5
TRBV2,TRBJ2-7,CATFLGTTYEQYF,5,0,1,5
TRBV24-1,TRBJ2-1,CATQGTIYNEQFF,5,0,1,5
TRBV24-1,TRBJ1-1,CATSDGMNTEAFF,5,0,1,5
TRBV28,TRBJ2-5,CASSPATQETQYF,5,0,1,5
TRBV19,TRBJ1-1,CASGLQANTEAFF,5,0,1,5
TRBV19,TRBJ1-6,CASSPGQNSPLHF,5,0,1,5
TRBV19,TRBJ2-1,CASSMVQGGEQFF,5,0,1,5
TRBV19,TRBJ2-1,CASSINPVGEQFF,5,0,1,5
TRBV19,TRBJ1-2,CASSTYRIPGYTF,5,0,1,5
TRBV18,TRBJ2-5,CASSSGTYGTQYF,5,0,1,5
TRBV25-1,TRBJ2-7,CASSQQNSYEQYF,5,0,1,5
TRBV25-1,TRBJ2-5,CASHRFSWETQYF,5,0,1,5
TRBV5-6,TRBJ2-2,CASGPGGFGELFF,5,0,1,5
TRBV7-9,TRBJ2-2,CASGRDFTGELFF,5,0,1,5
TRBV5-5,TRBJ2-3,CASGKTDTDTQYF,5,0,1,5
TRBV6-2/3/5/6,TRBJ2-7,CASGSTGSYEQYF,5,0,1,5
TRBV6-2/3/5/6,TRBJ2-5,CASSFSQQETQYF,5,0,1,5
TRBV12-3/4,TRBJ1-3,CASSFRGENTIYF,5,0,1,5
TRBV6-2/3/5/6,TRBJ2-3,CASSFAGVDTQYF,5,0,1,5
TRBV28,TRBJ1-6,CASSLEDASPLHF,5,0,1,5
TRBV12-3/4,TRBJ1-5,CASSLLGNQPQHF,5,0,1,5
TRBV12-3/4,TRBJ1-1,CASSLRGNGEAFF,5,2,2,7
TRBV7-8,TRBJ2-3,CASSLGPTDTQYF,5,3,2,8
TRBV6-2/3/5/6,TRBJ1-2,CASSYDQRYGYTF,5,0,1,5
TRBV12-3/4,TRBJ1-2,CASSPRPAYGYTF,5,0,1,5
TRBV12-3/4,TRBJ2-1,CASSPRGLGLQFF,5,0,1,5
TRBV2,TRBJ1-6,CASSRDLVSPLHF,5,0,1,5
TRBV6-2/3/5/6,TRBJ1-5,CASSQGWNQPQHF,5,0,1,5
TRBV2,TRBJ1-1,CASSVGGLTEAFF,5,0,1,5
TRBV6-1,TRBJ1-1,CASSVQGETEAFF,5,0,1,5
TRBV12-3/4,TRBJ2-5,CASSVEVRETQYF,5,0,1,5
TRBV6-1,TRBJ2-3,CASSDRWGDTQYF,5,0,1,5
TRBV2,TRBJ2-7,CASSEAGGYEQYF,5,0,1,5
TRBV6-1,TRBJ2-3,CASSKTGGDTQYF,5,0,1,5
TRBV11-2,TRBJ1-1,CASSFSENTEAFF,5,0,1,5
TRBV7-2,TRBJ1-1,CASSFSVNTEAFF,5,0,1,5
TRBV5-5,TRBJ1-2,CASSLGAGYGYTF,5,0,1,5
TRBV7-9,TRBJ2-2,CASSLARNGELFF,5,0,1,5
TRBV13,TRBJ2-1,CASSSDRPNEQFF,5,0,1,5
TRBV5-5,TRBJ2-2,CASSSSLAGGLFF,5,0,1,5
TRBV5-6,TRBJ2-5,CASSLARQETQYF,5,0,1,5
TRBV11-2,TRBJ1-1,CASSLEMGTEAFF,5,0,1,5
TRBV7-9,TRBJ1-1,CASSLESSLEAFF,5,0,1,5
TRBV11-2,TRBJ1-5,CASSLTSYQPQHF,5,0,1,5
TRBV3-1,TRBJ1-1,CASSPRVGTEAFF,5,0,1,5
TRBV11-3,TRBJ2-3,CASSPRRADTQYF,5,0,1,5
TRBV7-3,TRBJ2-1,CASSPRVLSEQFF,5,0,1,5
TRBV7-2,TRBJ2-5,CASSRRVQETQYF,5,0,1,5
TRBV3-1,TRBJ2-4,CASSQPISNIQYF,5,0,1,5
TRBV14,TRBJ2-1,CASSQQRVEEQFF,5,0,1,5
TRBV3-1,TRBJ1-1,CASSQALNTEAFF,5,0,1,5
TRBV3-1,TRBJ2-3,CASSQASTDTQYF,5,0,1,5
TRBV9,TRBJ1-1,CASSVGGNTEAFF,5,0,1,5
TRBV11-3,TRBJ1-1,CASSAQGNTEAFF,5,0,1,5
TRBV5-6,TRBJ2-1,CASSRYQRGQQFF,5,0,1,5
TRBV3-1,TRBJ2-3,CASRRTVQDTQYF,5,0,1,5
TRBV14,TRBJ2-1,CASRQQGYNEQFF,5,0,1,5
TRBV6-1,TRBJ2-3,CASRDRGSDTQYF,5,0,1,5
TRBV6-2/3/5/6,TRBJ1-2,CASRMGRNYGYTF,5,0,1,5
TRBV2,TRBJ1-1,CASRQDGNTEAFF,5,0,1,5
TRBV28,TRBJ2-5,CASNPGGQETQYF,5,0,1,5
TRBV2,TRBJ2-1,CASKELGYNEQFF,5,0,1,5
TRBV2,TRBJ2-3,CARGQTSTDTQYF,5,0,1,5
TRBV5-1,TRBJ1-2,CASGRDSNYGYTF,5,0,1,5
TRBV10-2,TRBJ2-5,CASSESEKETQYF,5,0,1,5
TRBV5-1,TRBJ1-1,CASSFRDTSEAFF,5,0,1,5
TRBV5-1,TRBJ1-1,CASSLAGTVGAFF,5,0,1,5
TRBV5-1,TRBJ2-1,CASSLDRGVEQFF,5,0,1,5
TRBV5-1,TRBJ2-2,CASSLGDTGELFF,5,0,1,5
TRBV5-1,TRBJ2-7,CASSSHRSVEQYF,5,0,1,5
TRBV4-1,TRBJ2-1,CASSQMGGNEQFF,5,0,1,5
TRBV5-1,TRBJ2-7,CASSQDQRRGQYF,5,0,1,5
TRBV4-1,TRBJ2-2,CASSQIDTGELFF,5,0,1,5
TRBV5-1,TRBJ2-5,CASSDLAQETQYF,5,0,1,5
TRBV5-1,TRBJ2-7,CASSIGQANEQYF,5,0,1,5
TRBV18,TRBJ1-1,CATTQGMNTEAFF,5,0,1,5
TRBV20-1,TRBJ2-1,CSPYDGVVHEQFF,5,0,1,5
TRBV20-1,TRBJ2-1,CSVIWGGYNEQFF,5,0,1,5
TRBV20-1,TRBJ1-5,CSAPGQGNQPQHF,5,0,1,5
TRBV20-1,TRBJ1-3,CSASRTGGNTIYF,5,0,1,5
TRBV20-1,TRBJ2-1,CSARPGGRVEQFF,5,0,1,5
TRBV20-1,TRBJ1-1,CSARFQGANEAFF,5,0,1,5
TRBV20-1,TRBJ1-1,CSARVTGGTEAFF,5,0,1,5
TRBV20-1,TRBJ2-1,CSARGGGFNEQFF,5,0,1,5
TRBV20-1,TRBJ2-7,CSAREPGGYEQYF,5,0,1,5
TRBV20-1,TRBJ1-4,CSAGATRSEKLFF,5,0,1,5
TRBV29-1,TRBJ2-1,CSVSRGAYNEQFF,5,0,1,5
TRBV29-1,TRBJ2-7,CSVRDRTSYEQYF,5,0,1,5
TRBV29-1,TRBJ1-5,CSVRDRGNQPQHF,5,0,1,5
TRBV29-1,TRBJ2-5,CSVVRGEGETQYF,5,0,1,5
TRBV29-1,TRBJ2-3,CSVVGAGGGTQYF,5,0,1,5
TRBV29-1,TRBJ2-5,CSVGLAGTETQYF,5,0,1,5
TRBV29-1,TRBJ1-1,CSVGQALNTEAFF,5,0,1,5
TRBV29-1,TRBJ1-1,CSVKRGGNTEAFF,5,0,1,5
TRBV29-1,TRBJ2-5,CSVQGTIGETQYF,5,0,1,5
TRBV29-1,TRBJ1-2,CSVTRGLDYGYTF,5,0,1,5
TRBV29-1,TRBJ1-1,CSVGGQPNTEAFF,5,0,1,5
TRBV29-1,TRBJ2-7,CSALGTANYEQYF,5,0,1,5
TRBV29-1,TRBJ1-4,CSGRQGASEKLFF,5,0,1,5
TRBV29-1,TRBJ1-1,CSGDQDLNTEAFF,5,0,1,5
TRBV30,TRBJ2-1,CAFAGLNNEQFF,5,0,1,5
TRBV30,TRBJ2-7,CAWSLQGNEQYF,5,0,1,5
TRBV28,TRBJ2-1,CAGGQAYNEQFF,5,0,1,5
TRBV2,TRBJ2-7,CATRDSPYEQYF,5,0,1,5
TRBV15,TRBJ2-1,CATTPDRHEQFF,5,0,1,5
TRBV3-1,TRBJ2-1,CASSILPHEQFF,5,0,1,5
TRBV18,TRBJ2-5,CASSTGSETQYF,5,0,1,5
TRBV18,TRBJ2-5,CASSPRPETQYF,5,0,1,5
TRBV5-4,TRBJ1-1,CASGTSGTEAFF,5,0,1,5
TRBV12-3/4,TRBJ2-5,CASSFVTETQYF,5,0,1,5
TRBV28,TRBJ2-7,CASSFIRNEQYF,5,0,1,5
TRBV28,TRBJ1-2,CASSLFGYGYTF,5,0,1,5
TRBV28,TRBJ1-2,CASSLRGHGYTF,5,0,1,5
TRBV6-2/3/5/6,TRBJ2-2,CASSSYTGELFF,5,0,1,5
TRBV12-3/4,TRBJ2-1,CASSSQGYEQFF,5,4,2,9
TRBV12-3/4,TRBJ1-5,CASSPGPAAQHF,5,0,1,5
TRBV7-3,TRBJ2-2,CASSHPAVELFF,5,0,1,5
TRBV2,TRBJ2-7,CASSDRVWEQYF,5,0,1,5
TRBV7-2,TRBJ2-1,CASSFQTGAQFF,5,0,1,5
TRBV5-6,TRBJ2-2,CASSFGSGELFF,5,0,1,5
TRBV11-2,TRBJ2-7,CASSLAGYEQYF,5,0,1,5
TRBV11-2,TRBJ1-1,CASSSSGVEAFF,5,0,1,5
TRBV5-6,TRBJ2-7,CASSSRTYEQYF,5,0,1,5
TRBV6-1,TRBJ2-1,CASSRLANEQFF,5,0,1,5
TRBV3-1,TRBJ1-1,CASSQPQGLAFF,5,0,1,5
TRBV3-1,TRBJ2-5,CASSQGIGTQYF,5,0,1,5
TRBV2,TRBJ1-6,CASRLDSRTPRF,5,0,1,5
TRBV5-4,TRBJ2-3,CASRTDSNTQYF,5,0,1,5
TRBV12-3/4,TRBJ1-5,CASSLLAQPQHF,5,0,1,5
TRBV5-1,TRBJ2-3,CASSSAGDTQYF,5,0,1,5
TRBV20-1,TRBJ1-1,CSVQRKNTEAFF,5,0,1,5
TRBV20-1,TRBJ1-2,CSARSGGKGYTF,5,0,1,5
TRBV20-1,TRBJ1-1,CSARTGVAEAFF,5,0,1,5
TRBV20-1,TRBJ2-1,CSARKGVDEQFF,5,0,1,5
TRBV29-1,TRBJ2-5,CSFYPPEETQYF,5,0,1,5
TRBV29-1,TRBJ2-5,CSVGYRGETQYF,5,0,1,5
TRBV29-1,TRBJ1-2,CSVGQGAMWHTF,5,0,1,5
TRBV29-1,TRBJ2-5,CSVEGGTETQYF,5,0,1,5
TRBV29-1,TRBJ1-1,CSVEKGGDEAFF,5,0,1,5
TRBV29-1,TRBJ1-2,CSVEAQGGGYTF,5,0,1,5
TRBV29-1,TRBJ2-7,CSVSSGGPGQYF,5,0,1,5
TRBV29-1,TRBJ1-5,CSVGDTNQPQHF,5,0,1,5
TRBV29-1,TRBJ1-1,CSALQGNTEAFF,5,0,1,5
TRBV30,TRBJ1-5,CASSVGDRQHF,5,0,1,5
TRBV30,TRBJ2-3,CAWASTDTQYF,5,0,1,5
TRBV30,TRBJ1-6,CAWGGDSSLHF,5,0,1,5
TRBV18,TRBJ2-1,CASSPGYEQFF,5,0,1,5
TRBV18,TRBJ1-1,CASSKSSEAFF,5,0,1,5
TRBV2,TRBJ2-7,CASTADYEQYF,5,0,1,5
TRBV12-3/4,TRBJ1-2,CASSPGYGYTF,5,2,2,7
TRBV12-3/4,TRBJ2-1,CASSHPHEQFF,5,0,1,5
TRBV12-3/4,TRBJ2-7,CASSDRDEQYF,5,0,1,5
TRBV7-9,TRBJ1-6,CASSLDSPLHF,5,0,1,5
TRBV10-2,TRBJ1-2,CASSTGAGYTF,5,0,1,5
TRBV5-1,TRBJ2-5,CASSLDETQYF,5,0,1,5
TRBV20-1,TRBJ2-5,CSASPQETQYF,5,0,1,5
TRBV20-1,TRBJ2-7,CSAKQDYEQYF,5,0,1,5
TRBV29-1,TRBJ1-1,CSVVRNTEAFF,5,0,1,5
TRBV29-1,TRBJ2-7,CSVSSLYEQYF,5,4,2,9
TRBV29-1,TRBJ1-4,CSVEEGLDLVF,5,0,1,5
TRBV29-1,TRBJ2-5,CSAGRTGSQYF,5,0,1,5
TRBV28,TRBJ1-2,CASSRYGYTF,5,0,1,5
TRBV19,TRBJ1-5,CARLYQPQHF,5,0,1,5
TRBV29-1,TRBJ1-1,CSAWNTEAFF,5,0,1,5
TRBV19,TRBJ2-7,CASSTRGQGATRTYEQYF,5,0,1,5
TRBV6-2/3/5/6,TRBJ2-1,CASNQLAGGQSSYNEQFF,5,0,1,5
TRBV5-1,TRBJ1-4,CASSLGWDEPGREKLFF,5,0,1,5
TRBV7-9,TRBJ2-1,CASSLGRTSGNNEQFF,5,0,1,5
TRBV7-6,TRBJ1-2,CANSRTLTGTAYGYTF,5,0,1,5
TRBV20-1,TRBJ2-7,CSARAGVRAQTHEQYF,5,0,1,5
TRBV7-9,TRBJ2-7,CASTNPDGYSYEQYF,5,0,1,5
TRBV5-4,TRBJ1-3,CASSLAGVAGNTIYF,5,0,1,5
TRBV7-9,TRBJ2-5,CASSLGDRGQETQYF,5,2,2,7
TRBV3-1,TRBJ2-4,CASSHGGSLADIQYF,5,0,1,5
TRBV4-2,TRBJ2-5,CASSQVGGGGETQYF,5,0,1,5
TRBV5-1,TRBJ1-2,CACSLEGSTNYGYTF,5,0,1,5
TRBV5-1,TRBJ1-6,CAGSLDQGRASPLHF,5,0,1,5
TRBV20-1,TRBJ2-5,CSARRPGQGLETQYF,5,0,1,5
TRBV7-9,TRBJ1-5,CASSLESSNQPQHF,5,0,1,5
TRBV11-3,TRBJ2-1,CASSPTPAHNEQVF,5,0,1,5
TRBV5-1,TRBJ1-5,CASSTTGGGQPQHF,5,0,1,5
TRBV29-1,TRBJ2-2,CSVHLESRPGELFF,5,0,1,5
TRBV7-3,TRBJ2-1,CASSLSGGLEQFF,5,12,2,17
TRBV12-3/4,TRBJ2-7,CASSWTGGYEQYF,5,0,1,5
TRBV7-9,TRBJ2-3,CASSPRDPDTLYF,5,0,1,5
TRBV7-6,TRBJ1-4,CASSPQGWEKLFF,5,0,1,5
TRBV2,TRBJ1-4,CATRADNEKLFF,5,0,1,5
TRBV19,TRBJ1-1,CASSRRGSEAFF,5,0,1,5
TRBV12-5,TRBJ1-5,CASGPRVGSTANPRRINQPQHF,4,0,1,4
TRBV14,TRBJ2-3,CASSQEIPPGLAGITSTDTQYF,4,0,1,4
TRBV28,TRBJ1-4,CASSFGQPYRAESGGEKLFF,4,0,1,4
TRBV27,TRBJ1-3,CARRTAGTGGVSPSGNTIYF,4,0,1,4
TRBV4-1,TRBJ2-5,CASSQDPVTSSLGRSETQYF,4,0,1,4
TRBV12-5,TRBJ2-1,CASGLVYLAGYSSYNEQFF,4,0,1,4
TRBV10-3,TRBJ2-7,CAISESRIVPGQKPYEQYF,4,0,1,4
TRBV28,TRBJ2-3,CASSFVPGPGQGFTDTQYF,4,0,1,4
TRBV27,TRBJ1-2,CASSSNFRLDGGPNYGYTF,4,0,1,4
TRBV28,TRBJ1-5,CASSHRGWGAEFGNQPQHF,4,0,1,4
TRBV6-4,TRBJ1-5,CASSDIMGQGISSNQPQHF,4,0,1,4
TRBV5-6,TRBJ2-5,CASSLAALAGAMYQETQYF,4,0,1,4
TRBV7-9,TRBJ2-3,CASSLAYSGGAVGTDTQYF,4,0,1,4
TRBV11-2,TRBJ1-1,CASSLRTEGEVMDFVEAFF,4,0,1,4
TRBV7-2,TRBJ1-6,CASSPHPQSLQGTNSPLHF,4,0,1,4
TRBV9,TRBJ2-1,CASSAGLAGGSPSYNEQFF,4,0,1,4
TRBV5-1,TRBJ2-1,CASSLAAASGGASYNEQFF,4,0,1,4
TRBV20-1,TRBJ1-6,CSARDDGQGINSYNSPLHF,4,0,1,4
TRBV12-5,TRBJ1-5,CASGLVYRGVDSNQPQHF,4,0,1,4
TRBV10-3,TRBJ2-6,CAISEGPLTASGANVLTF,4,0,1,4
TRBV28,TRBJ2-3,CASSFQLAGAYPTDTQYF,4,0,1,4
TRBV6-2/3/5/6,TRBJ2-7,CASSYSVDRAGGPYEQYF,4,0,1,4
TRBV11-2,TRBJ1-6,CASSFLVQGSSYNSPLHF,4,0,1,4
TRBV5-6,TRBJ2-3,CASSLMAAGTTSTDTQYF,4,0,1,4
TRBV7-2,TRBJ2-3,CASSLGGLTSGVTDTQYF,4,0,1,4
TRBV4-2,TRBJ2-3,CASSLQGVSDTSTDTQYF,4,0,1,4
TRBV7-9,TRBJ1-6,CASSPLTSRGRANSPLHF,4,0,1,4
TRBV14,TRBJ2-1,CASSRRTSGDSSYNEQFF,4,0,1,4
TRBV4-2,TRBJ2-3,CASSQAGLAGVAGDTQYF,4,0,1,4
TRBV3-1,TRBJ2-1,CASSQRVTGGALNDEQFF,4,0,1,4
TRBV14,TRBJ1-3,CASSQDPGTSSSGNTIYF,4,0,1,4
TRBV7-2,TRBJ1-2,CASSARPGTGTGGYGYTF,4,0,1,4
TRBV5-1,TRBJ2-3,CASSPGGSGGAGTDTQYF,4,0,1,4
TRBV4-1,TRBJ2-5,CASSQDRPDRAIQETQYF,4,0,1,4
TRBV5-1,TRBJ2-7,CASRPRDSPDPLGYEQYF,4,0,1,4
TRBV2,TRBJ2-5,CATLYLSGEGEKETQYF,4,0,1,4
TRBV19,TRBJ2-1,CASTPLSGGHPYNEQFF,4,0,1,4
TRBV19,TRBJ1-5,CASRSLPGQMSNQPQHF,4,0,1,4
TRBV19,TRBJ1-6,CASRRTGASSYNSPLHF,4,0,1,4
TRBV18,TRBJ2-6,CASSGITGSSGANVLTF,4,3,2,7
TRBV12-3/4,TRBJ1-6,CASPYRGGRMGNSPLHF,4,0,1,4
TRBV19,TRBJ1-5,CASPGQGWYGSNQPQHF,4,0,1,4
TRBV6-2/3/5/6,TRBJ1-1,CASSLTPPGWGGAEAFF,4,0,1,4
TRBV28,TRBJ2-7,CASSLNDLGTRNYEQYF,4,0,1,4
TRBV12-3/4,TRBJ1-1,CASSWGTGGPPVAEAFF,4,0,1,4
TRBV6-2/3/5/6,TRBJ2-1,CASSYNPGGPLVNEQFF,4,0,1,4
TRBV6-2/3/5/6,TRBJ1-3,CASSLIGQGFSGNTIYF,4,0,1,4
TRBV27,TRBJ2-3,CASSLAGGGIYTDTQYF,4,0,1,4
TRBV28,TRBJ2-7,CASSPPQGGQGTYEQYF,4,0,1,4
TRBV6-1,TRBJ2-1,CASSEGGTSGAYNEQFF,4,0,1,4
TRBV2,TRBJ2-4,CASSELRAGTYKNIQYF,4,0,1,4
TRBV6-1,TRBJ1-4,CASSEARGRDSSRKLFF,4,0,1,4
TRBV11-2,TRBJ2-5,CASSTSTGTGDQETQYF,4,0,1,4
TRBV5-6,TRBJ1-5,CASSLGLGRGSNQPQHF,4,0,1,4
TRBV7-8,TRBJ1-2,CASSLSVGGQGAHGYTF,4,0,1,4
TRBV7-2,TRBJ1-4,CASSSYFEGATNEKLFF,4,0,1,4
TRBV5-4,TRBJ2-1,CASSSSWASGIVDEQFF,4,0,1,4
TRBV7-8,TRBJ2-1,CASSSQSLAVSYNEQFF,4,0,1,4
TRBV11-2,TRBJ1-6,CASSSLDSTVYNSPLHF,4,0,1,4
TRBV5-5,TRBJ2-7,CASSWGLAGGPSYEQYF,4,0,1,4
TRBV7-9,TRBJ1-4,CASSPWVGTDVNEKLFF,4,0,1,4
TRBV7-3,TRBJ2-3,CASSPGRLAGRTDTQYF,4,0,1,4
TRBV3-1,TRBJ1-1,CASSRDPILRGSIEAFF,4,0,1,4
TRBV3-1,TRBJ2-7,CASSQRDRGPPPGEQNF,4,0,1,4
TRBV3-1,TRBJ2-5,CASSQDFMGTGRETQYF,4,0,1,4
TRBV9,TRBJ2-3,CASSVGARTSGGDTQYF,4,0,1,4
TRBV6-1,TRBJ1-5,CASREGQGVTINQPQHF,4,0,1,4
TRBV27,TRBJ1-6,CASRPLFLSGENSPLHF,4,0,1,4
TRBV5-1,TRBJ2-5,CASSRLAGGPYQETQYF,4,0,1,4
TRBV5-1,TRBJ2-7,CASSFPTSGGSSAEQYF,4,0,1,4
TRBV5-1,TRBJ2-3,CASSLAMGGGAKDTQYF,4,0,1,4
TRBV5-1,TRBJ2-1,CASSLGSGGASYNEQFF,4,0,1,4
TRBV5-1,TRBJ1-3,CASSLGLGVFAGNTIYF,4,0,1,4
TRBV5-1,TRBJ1-2,CASSLTTGRLGPIGYTF,4,0,1,4
TRBV5-1,TRBJ2-3,CASSSDGLAGGTDTQYF,4,0,1,4
TRBV4-1,TRBJ2-7,CASSWAGQGLIIYEQYF,4,0,1,4
TRBV5-1,TRBJ2-3,CASSLAGGVRSTDTQYF,4,0,1,4
TRBV4-1,TRBJ1-4,CASSRRQGWVRGEKLFF,4,0,1,4
TRBV4-1,TRBJ2-7,CASSQDTPDRGVDEQYF,4,0,1,4
TRBV4-1,TRBJ2-3,CASSQEGQGSSTDTQYF,4,0,1,4
TRBV5-1,TRBJ1-1,CASSALWLGGWNTEAFF,4,0,1,4
TRBV5-1,TRBJ1-5,CASSGGSTSGGNQPQHF,4,0,1,4
TRBV20-1,TRBJ2-1,CSARITSSGGLYNEQFF,4,5,2,9
TRBV20-1,TRBJ2-3,CSANQAGPTAGTDTQYF,4,0,1,4
TRBV20-1,TRBJ1-1,CSADPAAQGGTNTEAFF,4,0,1,4
TRBV29-1,TRBJ2-3,CSVEPLAGEMPTDTQYF,4,0,1,4
TRBV29-1,TRBJ2-3,CSVEGTRTGTYTDTQYF,4,0,1,4
TRBV28,TRBJ1-5,FASSFVEVGLNQPQYF,4,0,1,4
TRBV12-5,TRBJ2-6,CASGFTGGSGANVLTF,4,0,1,4
TRBV30,TRBJ1-1,CAWSRHPGQMNTEAFF,4,0,1,4
TRBV24-1,TRBJ2-2,CATQPQDRGQTGELFF,4,0,1,4
TRBV24-1,TRBJ1-5,CATPFPRDRNNQPLHF,4,0,1,4
TRBV24-1,TRBJ2-2,CATSTTGTANTGELFF,4,4,2,8
TRBV15,TRBJ1-5,CATSRAPGDSNQPQHF,4,0,1,4
TRBV19,TRBJ1-1,CASSLNRDTRNTEAFF,4,0,1,4
TRBV19,TRBJ2-1,CASSVNSGGKYNEQFF,4,0,1,4
TRBV19,TRBJ2-1,CASSIRGEGSYNEQFF,4,0,1,4
TRBV19,TRBJ1-3,CASSIQSGTSGNTIYF,4,0,1,4
TRBV19,TRBJ1-6,CASSIVADFPNSPLHF,4,0,1,4
TRBV28,TRBJ1-5,CASSTPDIYSNQPQHF,4,0,1,4
TRBV18,TRBJ2-2,CASSLQTSGNTGELFF,4,0,1,4
TRBV18,TRBJ2-2,CASSPTWSANTGELFF,4,0,1,4
TRBV18,TRBJ1-6,CASSPNTGGIRSPLHF,4,0,1,4
TRBV18,TRBJ1-2,CASSPPATGTNYGYTF,4,0,1,4
TRBV18,TRBJ2-2,CASSTRLFKNTGELFF,4,0,1,4
TRBV27,TRBJ1-1,CASWGQGIWKNTEAFF,4,0,1,4
TRBV7-3,TRBJ2-3,CASPATKPPSTDTQYF,4,0,1,4
TRBV6-4,TRBJ1-1,CASRKSPGTANTEAFF,4,0,1,4
TRBV2,TRBJ1-4,CASIRSMTADNEKLFF,4,0,1,4
TRBV28,TRBJ2-2,CASSFSGGRNTGELFF,4,0,1,4
TRBV6-2/3/5/6,TRBJ2-1,CASSFHTSGWDYEQFF,4,0,1,4
TRBV12-3/4,TRBJ2-2,CASSLSGPTNTGELFF,4,13,2,17
TRBV28,TRBJ1-1,CASSLHLGQVVTEAFF,4,0,1,4
TRBV12-3/4,TRBJ1-6,CASSLGLTSYNSPLHF,4,0,1,4
TRBV6-2/3/5/6,TRBJ2-3,CASSLGGGLSTDTQYF,4,0,1,4
TRBV6-2/3/5/6,TRBJ1-1,CASSLLGSGGEPEAFF,4,0,1,4
TRBV6-2/3/5/6,TRBJ1-4,CASSYSRRSTNEKLFF,4,0,1,4
TRBV28,TRBJ2-1,CASSPLTGQAYNEQFF,4,0,1,4
TRBV11-1,TRBJ2-1,CASSPGQGNSYNEQFW,4,0,1,4
TRBV12-3/4,TRBJ2-3,CASSHPRGGLADTQYF,4,0,1,4
TRBV7-9,TRBJ2-5,CASSVLAGAMGETQYF,4,0,1,4
TRBV6-1,TRBJ2-1,CASSALTGDSYNEQFF,4,0,1,4
TRBV10-3,TRBJ2-7,CASSAHTASGGNEQYF,4,0,1,4
TRBV6-1,TRBJ1-6,CASSEPYRGMNSPLHF,4,0,1,4
TRBV2,TRBJ2-6,CASSEAQGPGANVLTF,4,0,1,4
TRBV2,TRBJ2-6,CASSEAALFRANVLTF,4,0,1,4
TRBV28,TRBJ1-1,CASSIATGTGGTEAFF,4,0,1,4
TRBV6-1,TRBJ2-1,CASSRMGQGPQNEQFF,4,0,1,4
TRBV5-6,TRBJ2-1,CASSLGGTGGPNEQFF,4,0,1,4
TRBV5-6,TRBJ2-1,CASSLETGTIRGEQFF,4,0,1,4
TRBV7-9,TRBJ2-3,CASSLWDAGGRDTQYF,4,0,1,4
TRBV7-3,TRBJ2-2,CASSLPSKANTGELFF,4,0,1,4
TRBV7-9,TRBJ1-2,CASSLRGGTGGLGYTF,4,0,1,4
TRBV11-2,TRBJ2-5,CASSLGASGNQETQYF,4,0,1,4
TRBV7-9,TRBJ2-1,CASSLDGDWETNEQFF,4,0,1,4
TRBV7-8,TRBJ2-5,CASSLEGVGYQETQYF,4,0,1,4
TRBV7-2,TRBJ1-3,CASSLEYPSSGNTIYF,4,0,1,4
TRBV7-2,TRBJ2-3,CASSLMGASSTDTQYF,4,0,1,4
TRBV7-2,TRBJ2-1,CASSLTSGGPIIEQFF,4,0,1,4
TRBV7-9,TRBJ1-1,CASSLKYVTENTEAFF,4,0,1,4
TRBV5-4,TRBJ2-3,CASSSGLAGGSDTQYF,4,0,1,4
TRBV7-9,TRBJ1-2,CASSLPPTGVNYGYTF,4,0,1,4
TRBV7-2,TRBJ1-5,CASSPRGTAGNQPQHF,4,0,1,4
TRBV7-9,TRBJ2-1,CASSPPGSGGYNEQFF,4,0,1,4
TRBV11-2,TRBJ2-2,CASSPPGLAGAGELFF,4,0,1,4
TRBV3-1,TRBJ1-4,CASSPRTGNTNEELFF,4,0,1,4
TRBV14,TRBJ2-2,CASSPTWTGNTGELFF,4,0,1,4
TRBV3-1,TRBJ2-1,CASSHLKGQGSDEQFF,4,0,1,4
TRBV16,TRBJ2-1,CASSQLGSGGNNEQFF,4,0,1,4
TRBV3-1,TRBJ2-5,CASSQVLGQGTETQYF,4,0,1,4
TRBV3-1,TRBJ2-6,CASSQGGGLGANVLTF,4,0,1,4
TRBV4-2,TRBJ2-7,CASSQEPSGPTYEQYF,4,0,1,4
TRBV9,TRBJ1-2,CASSVGSQGVNYGYTF,4,0,1,4
TRBV3-1,TRBJ1-1,CASSGGGTALNTEAFF,4,0,1,4
TRBV3-1,TRBJ2-1,CASSGTTGVIGNEQFF,4,0,1,4
TRBV5-5,TRBJ2-7,CASSTIGQGHTYEQYF,4,0,1,4
TRBV7-2,TRBJ2-7,CASRGYLAGDLMKQYF,4,0,1,4
TRBV5-5,TRBJ2-1,CASNPVGSPRDDEQFF,4,0,1,4
TRBV28,TRBJ2-3,CASKGMRTGATDTQYF,4,0,1,4
TRBV6-2/3/5/6,TRBJ2-3,CASKLRQGQGPDTQYF,4,0,1,4
TRBV3-1,TRBJ1-1,CAKSDREVVVDTEAFF,4,0,1,4
TRBV5-1,TRBJ2-3,CASSFVTSGFSDTQYF,4,0,1,4
TRBV5-1,TRBJ1-3,CASSLDPIASGNTIYF,4,0,1,4
TRBV5-1,TRBJ1-4,CASSWAGTGRNEKLFF,4,13,2,17
TRBV4-1,TRBJ1-2,CASSQGYRDRGDGYTF,4,0,1,4
TRBV4-1,TRBJ1-6,CASSQDGGYGDTPLHF,4,0,1,4
TRBV5-1,TRBJ2-1,CASSGGLAGPSNEQFF,4,0,1,4
TRBV5-1,TRBJ2-3,CASSTGTSGSTDTQYF,4,0,1,4
TRBV5-1,TRBJ2-3,CASSNRDRGRTDTQYF,4,0,1,4
TRBV20-1,TRBJ2-3,CSAGKEPGGLTDTQYF,4,0,1,4
TRBV20-1,TRBJ2-7,CSASSLGQGISYEQYL,4,0,1,4
TRBV20-1,TRBJ2-6,CSASPGIASGANVLTF,4,0,1,4
TRBV20-1,TRBJ1-3,CSARAGTGGIGNTIYF,4,0,1,4
TRBV20-1,TRBJ1-5,CSARDLGFQGDQPQHF,4,3,2,7
TRBV20-1,TRBJ2-7,CSARDLTSGGEYEQYF,4,0,1,4
TRBV20-1,TRBJ2-3,CSARDRRLAVTDAQYF,4,0,1,4
TRBV29-1,TRBJ2-3,CSVAGTLAGATDTQYF,4,0,1,4
TRBV29-1,TRBJ2-1,CSVGNFGAASYNEQFF,4,0,1,4
TRBV29-1,TRBJ2-3,CSVDRGFSGRTDTQYF,4,0,1,4
TRBV29-1,TRBJ2-1,CSVEAGEIWAKIEQFF,4,0,1,4
TRBV29-1,TRBJ2-1,CSVEDQVPGFYNEQFF,4,0,1,4
TRBV29-1,TRBJ2-3,CSVTGLAGVWADTQYF,4,0,1,4
TRBV2,TRBJ2-6,CAGRDRASGANVLTF,4,0,1,4
TRBV12-5,TRBJ1-2,CASGRDRGLIYGYTF,4,0,1,4
TRBV30,TRBJ2-1,CAWTGRGTGYNEQFF,4,0,1,4
TRBV30,TRBJ1-2,CAWTTQGIYTYGYTF,4,0,1,4
TRBV30,TRBJ2-7,CAWSVPSQGQDEQYF,4,0,1,4
TRBV30,TRBJ2-7,CAWSVGGTGGYEQYF,4,0,1,4
TRBV30,TRBJ1-6,CAWSAIRSYNSPLHF,4,0,1,4
TRBV30,TRBJ2-1,CAWSGGLAGVYEQFF,4,0,1,4
TRBV30,TRBJ1-3,CAWRRDASSGNTIYF,4,0,1,4
TRBV2,TRBJ2-3,CAGGGGRGPTDTQYF,4,0,1,4
TRBV10-3,TRBJ2-3,CAISVGKGGTDTQYF,4,0,1,4
TRBV24-1,TRBJ2-5,CATSDQGQWGETQYF,4,0,1,4
TRBV24-1,TRBJ2-2,CATSPGPTNTGELFI,4,0,1,4
TRBV15,TRBJ1-1,CATSQDRGHATEAFF,4,0,1,4
TRBV15,TRBJ1-5,CATSRRGSGNQPQHF,4,0,1,4
TRBV19,TRBJ1-2,CASTGETVANYGYTF,4,0,1,4
TRBV19,TRBJ2-1,CASTRTGGIINEQFF,4,0,1,4
TRBV19,TRBJ1-5,CASSRLTDSNQPQHF,4,0,1,4
TRBV19,TRBJ1-1,CASSIGETGYTEAFF,4,0,1,4
TRBV19,TRBJ1-5,CASSIDAETNQPQHF,4,0,1,4
TRBV19,TRBJ2-1,CASSTPSGGKHEQFF,4,0,1,4
TRBV19,TRBJ2-7,CASSRGQGIPYEQYF,4,0,1,4
TRBV19,TRBJ2-2,CASRIQGRRTGELFF,4,0,1,4
TRBV19,TRBJ1-4,CASNLGTGSYEKLFF,4,0,1,4
TRBV18,TRBJ2-3,CASSPPGSSTDTQYF,4,0,1,4
TRBV5-4,TRBJ2-3,CASSNGGHTTDTQYF,4,0,1,4
TRBV18,TRBJ1-1,CASSPREPIETEAFF,4,0,1,4
TRBV18,TRBJ2-3,CASSPRVGGTDTQYF,4,0,1,4
TRBV18,TRBJ2-7,CASSPGQGDLYKQYF,4,0,1,4
TRBV18,TRBJ2-2,CASSPEGHFTGELFF,4,0,1,4
TRBV18,TRBJ1-5,CASSPTGASDRPQHF,4,0,1,4
TRBV27,TRBJ2-7,CASALAGSFSYEQYF,4,0,1,4
TRBV5-4,TRBJ2-1,CASGLDRAIYNEQFF,4,0,1,4
TRBV2,TRBJ2-6,CASIAGGVGANVLTF,4,0,1,4
TRBV5-6,TRBJ1-1,CASILRGAGNTEAFF,4,0,1,4
TRBV28,TRBJ2-2,CASTSTGYNTGELFF,4,0,1,4
TRBV7-2,TRBJ2-1,CASTLQRGGYNEQFF,4,0,1,4
TRBV12-3/4,TRBJ1-1,CASTLSTGRNTEAFF,4,0,1,4
TRBV6-2/3/5/6,TRBJ2-7,CASSFPQGVSYEQYF,4,0,1,4
TRBV12-3/4,TRBJ1-2,CASSFGPLAYYGYTF,4,0,1,4
TRBV28,TRBJ2-5,CASSFGRGLRETQYF,4,0,1,4
TRBV28,TRBJ1-4,CASSFIQGTNEKLFF,4,0,1,4
TRBV6-2/3/5/6,TRBJ1-6,CASSFPTWAEAPLHF,4,0,1,4
TRBV12-3/4,TRBJ1-2,CASSLWDSAGVGYTF,4,0,1,4
TRBV6-2/3/5/6,TRBJ2-3,CASSLGTGLGDTQYF,4,0,1,4
TRBV6-2/3/5/6,TRBJ1-3,CASSLDRGEGNTIYF,4,0,1,4
TRBV28,TRBJ1-3,CASSLERTSGNTLYF,4,0,1,4
TRBV12-3/4,TRBJ2-3,CASSLSGFGTDTQYF,4,0,1,4
TRBV28,TRBJ1-1,CASSLSGGRVTGAFF,4,0,1,4
TRBV6-2/3/5/6,TRBJ2-5,CASSLSNDLQETQYF,4,0,1,4
TRBV28,TRBJ2-1,CASSLGGFSYNEQFF,4,0,1,4
TRBV12-3/4,TRBJ1-1,CASSLDTTANTEAFF,4,0,1,4
TRBV12-3/4,TRBJ1-5,CASSSQGVGHEPQHF,4,0,1,4
TRBV28,TRBJ2-7,CASSSGGEGSYEQYF,4,0,1,4
TRBV6-2/3/5/6,TRBJ2-3,CASSSSGGSTDTQYF,4,0,1,4
TRBV28,TRBJ1-1,CASSSPPGRNTEAFF,4,0,1,4
TRBV6-2/3/5/6,TRBJ1-1,CASSLFGTVNTEAFF,4,0,1,4
TRBV28,TRBJ2-3,CASSLAGTRRDTQYF,4,0,1,4
TRBV28,TRBJ1-5,CASSLGWGESQPRHF,4,0,1,4
TRBV12-3/4,TRBJ1-2,CASSPLKGTNYGYTF,4,0,1,4
TRBV28,TRBJ2-5,CASSPGLAGTETQYF,4,0,1,4
TRBV11-2,TRBJ2-7,CASSPNGVSYYEQYF,4,0,1,4
TRBV28,TRBJ2-7,CASSPLPGRPYEQYF,4,0,1,4
TRBV6-2/3/5/6,TRBJ2-7,CASSPQRGTSYEQYF,4,0,1,4
TRBV2,TRBJ1-4,CASSRAGGEGEKLFF,4,0,1,4
TRBV28,TRBJ2-7,CASSASGFPTYEQYF,4,0,1,4
TRBV6-1,TRBJ2-2,CASSGAASGEGELFF,4,0,1,4
TRBV2,TRBJ2-3,CASSGGQFNTDTQYF,4,0,1,4
TRBV6-1,TRBJ2-7,CASSEETGGYYEQYF,4,0,1,4
TRBV6-1,TRBJ1-1,CASSEVELLNAEAFF,4,0,1,4
TRBV6-2/3/5/6,TRBJ2-5,CASSIGGFGGETQYF,4,0,1,4
TRBV6-2/3/5/6,TRBJ2-5,CASSTSGGTKETQYF,4,0,1,4
TRBV6-2/3/5/6,TRBJ1-6,CASSTGTPYNSPLHF,4,0,1,4
TRBV12-3/4,TRBJ2-5,CASSTTSGVRETQYF,4,0,1,4
TRBV7-2,TRBJ2-5,CASSFASGYQETQYF,4,0,1,4
TRBV7-2,TRBJ2-7,CASSFRGADTGEQYF,4,0,1,4
TRBV11-2,TRBJ2-7,CASSFRTGLTYEQYF,4,0,1,4
TRBV5-6,TRBJ2-5,CASSLYVGIGETQYF,4,0,1,4
TRBV11-2,TRBJ2-2,CASSLGQKNTGELFF,4,0,1,4
TRBV5-4,TRBJ2-1,CASSLGGQGYNEQFF,4,0,1,4
TRBV5-6,TRBJ1-5,CASSLGDRDGQPQHF,4,0,1,4
TRBV6-2/3/5/6,TRBJ2-2,CASSLDDSRTGELFF,4,0,1,4
TRBV5-6,TRBJ2-7,CASSLEGGHPYEQYF,4,0,1,4
TRBV5-8,TRBJ2-1,CASSLIAGGLNEQFF,4,0,1,4
TRBV7-2,TRBJ1-1,CASSLWGTGNTEAFF,4,0,1,4
TRBV7-9,TRBJ1-6,CASSLHPGDNSPLHF,4,0,1,4
TRBV7-9,TRBJ2-3,CASSLAGLITDTQYF,4,0,1,4
TRBV7-9,TRBJ1-4,CASSLAGQGSEKLFF,4,0,1,4
TRBV11-1,TRBJ2-1,CASSLAWGLANEQFF,4,0,1,4
TRBV7-8,TRBJ2-1,CASSLGFSPGNEQFF,4,0,1,4
TRBV7-2,TRBJ2-3,CASSLGGARTDTQYF,4,0,1,4
TRBV7-2,TRBJ1-3,CASSLGTGSGNTIYF,4,0,1,4
TRBV7-9,TRBJ2-1,CASSLDGGPYNEQFF,4,0,1,4
TRBV11-1,TRBJ2-1,CASSLMTGGDNEQFF,4,0,1,4
TRBV7-3,TRBJ2-1,CASSLTGGTANEQFF,4,0,1,4
TRBV5-8,TRBJ2-5,CASSSYGTLQETQYF,4,0,1,4
TRBV7-9,TRBJ2-7,CASSSGTGVGYEQYF,4,0,1,4
TRBV7-3,TRBJ2-2,CASSSGLGNTGELFF,4,0,1,4
TRBV7-2,TRBJ2-3,CASSSPGGRADTQYF,4,0,1,4
TRBV5-6,TRBJ1-3,CASSSLTGTGNTIYF,4,0,1,4
TRBV11-3,TRBJ2-5,CASSSGLAGDGTQYF,4,0,1,4
TRBV7-2,TRBJ1-2,CASSWKGQGNYGYTF,4,0,1,4
TRBV7-3,TRBJ2-1,CASSYLADAYNEQFF,4,0,1,4
TRBV28,TRBJ2-3,CASSLGTGGTDTQYF,4,0,1,4
TRBV7-6,TRBJ2-3,CASSPIRGGTDTQYF,4,0,1,4
TRBV7-9,TRBJ2-2,CASSPSGGNTGELFF,4,0,1,4
TRBV2,TRBJ2-5,CASSPPRGKEETQYF,4,0,1,4
TRBV28,TRBJ1-5,CASSPPTGGWQPQHF,4,0,1,4
TRBV5-5,TRBJ2-7,CASSPRDRGQNEQYF,4,0,1,4
TRBV7-3,TRBJ2-1,CASSPGGAGYNEQFF,4,0,1,4
TRBV12-3/4,TRBJ1-1,CASSPTGRMNTEAFF,4,0,1,4
TRBV16,TRBJ1-2,CASSPNSGTAGGYTF,4,0,1,4
TRBV5-6,TRBJ2-3,CASSRQGVSTDTQYF,4,0,1,4
TRBV7-9,TRBJ2-1,CASSRTSGARNEQFF,4,0,1,4
TRBV11-2,TRBJ2-1,CASSRTGARDISLVF,4,0,1,4
TRBV5-6,TRBJ2-1,CASSQLDGTYNEQFF,4,0,1,4
TRBV4-2,TRBJ2-1,CASSQDFTVAGEQFF,4,0,1,4
TRBV3-1,TRBJ2-7,CASSQLAGGPYEQYF,4,0,1,4
TRBV7-9,TRBJ2-1,CASSQRGQEYNEQFF,4,0,1,4
TRBV14,TRBJ1-1,CASSQQSTGITEAFF,4,0,1,4
TRBV4-2,TRBJ1-1,CASSQVLAENTEAFF,4,2,2,6
TRBV3-1,TRBJ2-3,CASSQVWQGTDTQYF,4,0,1,4
TRBV3-1,TRBJ1-2,CASSQAPLKGYGYTF,4,0,1,4
TRBV3-1,TRBJ2-1,CASSQGRGVYNEQFF,4,0,1,4
TRBV3-1,TRBJ2-1,CASSQGGGGAYEQFF,4,0,1,4
TRBV3-1,TRBJ2-3,CASSQEAVGMDTQYF,4,0,1,4
TRBV4-2,TRBJ2-5,CASSQEVNREETQYF,4,0,1,4
TRBV3-1,TRBJ2-7,CASSQSFREAYEQYF,4,0,1,4
TRBV9,TRBJ1-2,CASSVAPQGILDYTF,4,2,2,6
TRBV9,TRBJ1-2,CASSVDRGLSGGYTF,4,0,1,4
TRBV5-4,TRBJ2-7,CASSARLEQGPEQYF,4,0,1,4
TRBV9,TRBJ2-7,CASSAAAGGAYERYF,4,0,1,4
TRBV5-4,TRBJ1-2,CASSARGGSGVGYTF,4,0,1,4
TRBV7-2,TRBJ2-1,CASSENGGGYNEQFF,4,0,1,4
TRBV11-2,TRBJ2-1,CASSMSGGAYNEQFF,4,0,1,4
TRBV6-2/3/5/6,TRBJ2-5,CASSTPREGRETQYF,4,0,1,4
TRBV12-3/4,TRBJ2-5,CASSNTRLARETQYF,4,0,1,4
TRBV27,TRBJ1-6,CASRFGGSKWSPLHF,4,0,1,4
TRBV28,TRBJ2-5,CASRGSGTEKETQYF,4,0,1,4
TRBV6-2/3/5/6,TRBJ1-5,CASRGTRATFQPQHF,4,0,1,4
TRBV12-3/4,TRBJ2-7,CASRPPTGARYEQYF,4,4,2,8
TRBV7-9,TRBJ1-1,CASRRGQVRNTEAFF,4,0,1,4
TRBV6-2/3/5/6,TRBJ2-3,CASRQLAGGRDTQYF,4,0,1,4
TRBV28,TRBJ1-4,CASKTGQGRNEKLFF,4,0,1,4
TRBV27,TRBJ1-4,CASSLTAAAPAKLFF,4,0,1,4
TRBV10-2,TRBJ1-1,CASSDHSWGEGEAFF,4,0,1,4
TRBV10-1,TRBJ2-1,CASSESGGSYNEQFF,4,0,1,4
TRBV5-1,TRBJ1-1,CASSFQGAGNTEAFF,4,0,1,4
TRBV5-1,TRBJ1-6,CASSFMPSEDSPLHF,4,0,1,4
TRBV5-1,TRBJ2-1,CASSFQGEIYNEQFF,4,0,1,4
TRBV5-1,TRBJ2-3,CASSLFQASTDTQYF,4,0,1,4
TRBV5-1,TRBJ1-1,CASSLALGGNTEAFF,4,0,1,4
TRBV5-1,TRBJ1-5,CASSLAPGFNQPQHF,4,0,1,4
TRBV5-1,TRBJ1-1,CASSLGNQGSTEAFF,4,0,1,4
TRBV5-1,TRBJ2-7,CASSLGVAGRNERYF,4,0,1,4
TRBV5-1,TRBJ1-6,CASSLDTGSGSPLHF,4,0,1,4
TRBV5-1,TRBJ1-1,CASSLIGSENTEAFF,4,0,1,4
TRBV5-1,TRBJ1-4,CASSLGQTTNEKLFF,4,0,1,4
TRBV5-1,TRBJ1-2,CASSSSKGSNYGYTF,4,0,1,4
TRBV5-1,TRBJ1-1,CASSSLGQGNTEAFF,4,0,1,4
TRBV5-1,TRBJ2-1,CASSLSDPAGNEQFF,4,0,1,4
TRBV5-1,TRBJ2-7,CASSPTDRTYYEQYF,4,0,1,4
TRBV4-1,TRBJ1-3,CASSRTRGAGNTIYF,4,0,1,4
TRBV4-1,TRBJ2-7,CASSRKPGDITEQYF,4,0,1,4
TRBV4-1,TRBJ1-3,CASSQRVFSGNTIYF,4,0,1,4
TRBV4-1,TRBJ2-1,CASSQVKASYNEQFF,4,0,1,4
TRBV5-1,TRBJ1-1,CASSVGQGSGTEAFF,4,0,1,4
TRBV4-1,TRBJ2-5,CASSERQGISETQYF,4,0,1,4
TRBV5-1,TRBJ2-3,CASSMMDVRTDTQYF,4,0,1,4
TRBV5-1,TRBJ1-2,CASSTTGAPSYGYTF,4,0,1,4
TRBV5-1,TRBJ1-1,CASRPDRGLYTEAFF,4,0,1,4
TRBV20-1,TRBJ2-2,CSVWPGNRGTGELFF,4,0,1,4
TRBV20-1,TRBJ1-5,CSATTSEHSNQPQHF,4,0,1,4
TRBV20-1,TRBJ2-3,CSARLSTSGGDTQYF,4,0,1,4
TRBV20-1,TRBJ2-6,CSARTVNSGANVLTF,4,0,1,4
TRBV20-1,TRBJ2-1,CSARGLRGADHEQFF,4,0,1,4
TRBV20-1,TRBJ2-1,CSARDFKTENNEQFF,4,0,1,4
TRBV20-1,TRBJ2-5,CSARDLIQGEETQYF,4,0,1,4
TRBV20-1,TRBJ2-7,CSARDQAGSVYEQYF,4,0,1,4
TRBV20-1,TRBJ1-2,CSARDRTSANYGYTF,4,0,1,4
TRBV20-1,TRBJ2-3,CSAREEAGARDTQYF,4,0,1,4
TRBV20-1,TRBJ2-1,CSARERTGLYNEQFF,4,0,1,4
TRBV20-1,TRBJ2-1,CSPGQGYLVMDEQFF,4,0,1,4
TRBV29-1,TRBJ2-7,CSVASSSGGIYEQYF,4,0,1,4
TRBV29-1,TRBJ2-7,CSVEDIGTGWYEQYF,4,0,1,4
TRBV29-1,TRBJ2-3,CSAALAGDSTDTQYF,4,0,1,4
TRBV29-1,TRBJ2-3,CSGEGDRDAADTQYF,4,0,1,4
TRBV28,TRBJ2-3,YASSFNRGSTDTQYF,4,0,1,4
TRBV12-5,TRBJ2-3,CASGPDTGGDTQYF,4,0,1,4
TRBV7-7,TRBJ2-1,CASSLEGSANEQFF,4,0,1,4
TRBV30,TRBJ1-5,CAWSVGGSNQPQHF,4,0,1,4
TRBV30,TRBJ2-1,CAWSTGGSYNEQFF,4,0,1,4
TRBV30,TRBJ1-5,CAWSRDVSNQPQHF,4,0,1,4
TRBV30,TRBJ2-3,CAWKFPGTPNTQYF,4,0,1,4
TRBV10-3,TRBJ2-5,CAISDTSGARTQYF,4,0,1,4
TRBV10-3,TRBJ2-2,CAISENRGGGELFF,4,0,1,4
TRBV10-3,TRBJ2-5,CAISGGGEKETQYF,4,0,1,4
TRBV28,TRBJ2-4,CATLKGGAKNIQYF,4,0,1,4
TRBV28,TRBJ2-1,CATVTSGGAGEQFF,4,0,1,4
TRBV18,TRBJ1-2,CASSRERLNYGYTF,4,0,1,4
TRBV19,TRBJ2-1,CASSSGGGWHEQFF,4,0,1,4
TRBV19,TRBJ1-5,CASSLPEGNQPQHF,4,0,1,4
TRBV19,TRBJ1-1,CASSILGLDTEAFF,4,0,1,4
TRBV19,TRBJ1-1,CASSIGQGKTEAFF,4,0,1,4
TRBV19,TRBJ1-4,CASSMDPQSEKLFF,4,0,1,4
TRBV19,TRBJ1-6,CASRVGPSNSPLHF,4,3,2,7
TRBV19,TRBJ2-3,CASREQSSTDTQYF,4,0,1,4
TRBV5-4,TRBJ2-2,CASFEGSGTGELFF,4,0,1,4
TRBV18,TRBJ2-7,CASSTSGDYYEQYF,4,0,1,4
TRBV18,TRBJ1-1,CASSPLEGPTEAFF,4,0,1,4
TRBV18,TRBJ1-1,CASSPPSGFTEAFF,4,0,1,4
TRBV18,TRBJ1-1,CASSPPFGNTEAFF,4,0,1,4
TRBV18,TRBJ2-5,CASSPPIGQETQYF,4,0,1,4
TRBV18,TRBJ2-3,CASSPPTVTDTQYF,4,0,1,4
TRBV18,TRBJ2-1,CASSPHGVRNEQFF,4,0,1,4
TRBV28,TRBJ2-3,CASQAGGGADTQYF,4,0,1,4
TRBV7-9,TRBJ1-3,CASQGADFINTIYF,4,0,1,4
TRBV6-2/3/5/6,TRBJ1-4,CASVGGATNEKLFF,4,0,1,4
TRBV6-2/3/5/6,TRBJ2-7,CASGYSGASYEQYF,4,0,1,4
TRBV2,TRBJ1-5,CASGQANGNQPQHF,4,0,1,4
TRBV6-2/3/5/6,TRBJ2-1,CASGRGPQSEEQFF,4,0,1,4
TRBV2,TRBJ2-1,CASILWGAHNEQFF,4,0,1,4
TRBV28,TRBJ2-2,CASMLSLNTGGLFF,4,0,1,4
TRBV11-2,TRBJ2-7,CASTYERGPYEQYF,4,0,1,4
TRBV28,TRBJ2-7,CASTLGIRSYEQYF,4,0,1,4
TRBV28,TRBJ1-2,CASTPGGGLYGYTF,4,0,1,4
TRBV14,TRBJ2-1,CASTRGGGRNEQFF,4,0,1,4
TRBV12-3/4,TRBJ2-1,CASSFFWDPDEQFF,4,0,1,4
TRBV12-3/4,TRBJ1-1,CASSLGRFNTEAFF,4,0,1,4
TRBV6-2/3/5/6,TRBJ2-1,CASSLDTSYNEQFF,4,0,1,4
TRBV12-3/4,TRBJ1-1,CASSLSGAVPEAFF,4,0,1,4
TRBV28,TRBJ1-2,CASSLWKQRDGYTF,4,0,1,4
TRBV12-3/4,TRBJ2-1,CASSLRLAGAEQFF,4,0,1,4
TRBV28,TRBJ2-7,CASSLHRVPPEQYF,4,0,1,4
TRBV12-3/4,TRBJ2-3,CASSLQGFTDTQYF,4,0,1,4
TRBV28,TRBJ2-7,CASSLDTVPYEQYF,4,0,1,4
TRBV28,TRBJ2-3,CASSLILGTDTQYF,4,0,1,4
TRBV12-3/4,TRBJ2-1,CASSLIVTPQEQFF,4,0,1,4
TRBV6-2/3/5/6,TRBJ2-1,CASSLKGNHNEQFF,4,0,1,4
TRBV28,TRBJ2-7,CASSSHGSSYEQYF,4,0,1,4
TRBV6-2/3/5/6,TRBJ1-1,CASSSGPGDTEAFF,4,0,1,4
TRBV6-2/3/5/6,TRBJ2-3,CASSSGLLLDTQYF,4,0,1,4
TRBV28,TRBJ1-5,CASSWGSARQPQHF,4,0,1,4
TRBV7-9,TRBJ1-1,CASSWDLYATEAFF,4,0,1,4
TRBV6-2/3/5/6,TRBJ2-3,CASSYSPEKDTQYF,4,0,1,4
TRBV6-2/3/5/6,TRBJ1-5,CASSYGGNNQPQHF,4,0,1,4
TRBV12-3/4,TRBJ2-1,CASSLAGGYNEQFF,4,0,1,4
TRBV28,TRBJ2-7,CASSLTRAQYEQYF,4,0,1,4
TRBV7-2,TRBJ2-1,CASSPGLARNEQFF,4,0,1,4
TRBV6-2/3/5/6,TRBJ2-4,CASSPTATKNIQYF,4,0,1,4
TRBV27,TRBJ2-7,CASSRRGYSYEQYF,4,0,1,4
TRBV6-2/3/5/6,TRBJ2-5,CASSQGALEETQYF,4,0,1,4
TRBV2,TRBJ1-5,CASSVGQPNQPQHF,4,0,1,4
TRBV2,TRBJ1-5,CASSVQRGPQPQHF,4,0,1,4
TRBV2,TRBJ1-5,CASSASISNQPQHF,4,0,1,4
TRBV6-1,TRBJ1-1,CASSAADRETEAFF,4,0,1,4
TRBV6-1,TRBJ1-5,CASSAQRGPQPQHF,4,0,1,4
TRBV6-1,TRBJ2-7,CASSDRYRDYEQYF,4,0,1,4
TRBV2,TRBJ1-5,CASSEAGLWQPQHF,4,0,1,4
TRBV5-4,TRBJ2-7,CASSETGSSYEQYF,4,0,1,4
TRBV28,TRBJ2-3,CASSTSTNTDTQYF,4,0,1,4
TRBV13,TRBJ2-3,CASSFPENTDTQYF,4,0,1,4
TRBV11-2,TRBJ2-1,CASSFGGPYNEQFF,4,0,1,4
TRBV7-2,TRBJ2-5,CASSFGAGVETQYF,4,0,1,4
TRBV5-6,TRBJ2-3,CASSFPTHTDTQYF,4,3,2,7
TRBV7-2,TRBJ2-1,CASSFGAAGSRKFS,4,0,1,4
TRBV7-9,TRBJ1-1,CASSFGQGGTEAFF,4,0,1,4
TRBV7-9,TRBJ2-5,CASSFRTGVETQYF,4,0,1,4
TRBV5-6,TRBJ2-5,CASSLRGTRETQYF,4,0,1,4
TRBV7-6,TRBJ2-3,CASSLSSGRDTQYF,4,0,1,4
TRBV7-2,TRBJ1-2,CASSLYQGAYGYTF,4,0,1,4
TRBV7-9,TRBJ1-1,CASSLVSRDTEAFF,4,0,1,4
TRBV11-2,TRBJ2-5,CASSLVQGQETQYF,4,0,1,4
TRBV7-6,TRBJ1-3,CASSLVESGNTIYF,4,0,1,4
TRBV11-2,TRBJ2-2,CASSLARNTGELFF,4,0,1,4
TRBV7-9,TRBJ1-2,CASSLGDRWDGYTF,4,0,1,4
TRBV11-2,TRBJ2-1,CASSLDVMGPEQFF,4,4,2,8
TRBV11-2,TRBJ1-4,CASSLEKASEKLFF,4,0,1,4
TRBV7-2,TRBJ1-1,CASSLILGNTEAFF,4,0,1,4
TRBV7-3,TRBJ1-1,CASSLTGVNTEAFF,4,0,1,4
TRBV5-8,TRBJ2-7,CASSLNGYSYEQYF,4,0,1,4
TRBV7-6,TRBJ2-7,CASSSYSGTYEQYF,4,0,1,4
TRBV13,TRBJ1-6,CASSSTGVGSPLHL,4,0,1,4
TRBV5-4,TRBJ1-1,CASSYPDRPGEAFF,4,0,1,4
TRBV7-9,TRBJ2-7,CASSYRDRGDEQYF,4,0,1,4
TRBV2,TRBJ2-7,CASSYAQRGDEQYF,4,0,1,4
TRBV11-2,TRBJ2-7,CASSLSGHNYEQYF,4,0,1,4
TRBV3-1,TRBJ2-3,CASSPSLSTDTQYF,4,0,1,4
TRBV12-3/4,TRBJ2-3,CASSPSGGSDTQYF,4,0,1,4
TRBV9,TRBJ1-1,CASSPRGIGTEAFF,4,0,1,4
TRBV7-9,TRBJ1-2,CASSPSGHSYGYTF,4,0,1,4
TRBV7-6,TRBJ1-2,CASSPPASNYGYTF,4,0,1,4
TRBV7-9,TRBJ2-5,CASSPPGGQETQYF,4,0,1,4
TRBV7-2,TRBJ1-2,CASSPGGPGYGYTF,4,0,1,4
TRBV7-3,TRBJ2-3,CASSPITAGDTQYF,4,0,1,4
TRBV12-3/4,TRBJ2-7,CASSRLGGSYEQYF,4,0,1,4
TRBV6-2/3/5/6,TRBJ2-7,CASSRSYRVVGQYF,4,0,1,4
TRBV7-3,TRBJ2-1,CASSRRDRMNEQFY,4,0,1,4
TRBV5-5,TRBJ2-5,CASSRGQHKETQYF,4,0,1,4
TRBV7-9,TRBJ2-2,CASSQGSRTGELFF,4,0,1,4
TRBV7-2,TRBJ2-3,CASSQDRGPDTQYF,4,0,1,4
TRBV7-2,TRBJ2-6,CASSQESGANVLTF,4,2,2,6
TRBV4-2,TRBJ1-6,CASSQRTNASPLHF,4,0,1,4
TRBV3-1,TRBJ2-2,CASSQAPDAGELFF,4,0,1,4
TRBV3-1,TRBJ2-7,CASSQDPNSYEQYF,4,0,1,4
TRBV3-1,TRBJ1-1,CASSQSQGNTEAFF,4,0,1,4
TRBV9,TRBJ2-7,CASSVGGFLYEQYF,4,0,1,4
TRBV9,TRBJ2-7,CASSVDGTGREQYF,4,2,2,6
TRBV12-3/4,TRBJ2-3,CASSATGSTDTQYF,4,0,1,4
TRBV7-9,TRBJ2-5,CASSSAGSQETQYF,4,0,1,4
TRBV3-1,TRBJ2-5,CASSRNPNTETQYF,4,0,1,4
TRBV11-3,TRBJ2-7,CASSKGFGSGEQYF,4,0,1,4
TRBV27,TRBJ1-1,CASRPQGLNTEAFF,4,0,1,4
TRBV12-3/4,TRBJ1-4,CASRRVATNEKLFF,4,0,1,4
TRBV6-2/3/5/6,TRBJ1-5,CASRRGTGSQPQHF,4,0,1,4
TRBV11-2,TRBJ2-5,CASRAGGGEETQYF,4,0,1,4
TRBV12-3/4,TRBJ2-4,CASREALAKNIQYF,4,0,1,4
TRBV12-3/4,TRBJ2-1,CASRPGSQVNEQFF,4,0,1,4
TRBV28,TRBJ1-6,CASRPGPVGSPLHF,4,0,1,4
TRBV6-2/3/5/6,TRBJ1-5,CASRAPAGNQPQHF,4,0,1,4
TRBV6-4,TRBJ1-4,CASRDRWANEKLFF,4,0,1,4
TRBV2,TRBJ2-5,CASNYGGGKETQYF,4,0,1,4
TRBV2,TRBJ1-5,CASNSGHGNQPQHF,4,0,1,4
TRBV28,TRBJ2-7,CASKIAGGPYELYF,4,0,1,4
TRBV5-1,TRBJ2-1,CASYLAGGYNEQFF,4,0,1,4
TRBV5-1,TRBJ2-5,CASGTGQGRETQYF,4,0,1,4
TRBV10-1,TRBJ2-5,CASSETSSGETQYF,4,0,1,4
TRBV10-1,TRBJ1-6,CASSESTGGSPLHF,4,0,1,4
TRBV5-1,TRBJ2-7,CASSLLGGSGEQYF,4,0,1,4
TRBV5-1,TRBJ1-1,CASSLVPENTEAFF,4,0,1,4
TRBV5-1,TRBJ2-3,CASSLAYSTDTQYF,4,0,1,4
TRBV5-1,TRBJ1-2,CASSLARQGSGYTF,4,0,1,4
TRBV5-1,TRBJ2-5,CASSLAQEDETQYF,4,0,1,4
TRBV5-1,TRBJ2-5,CASSLAGSQETQYF,7,0,1,7
TRBV5-1,TRBJ2-1,CASSLAGDTNEQFF,4,9,2,13
TRBV5-1,TRBJ1-1,CASSLARGYTEAFF,4,0,1,4
TRBV5-1,TRBJ2-7,CASSLGDKIYEQYF,4,0,1,4
TRBV5-1,TRBJ2-2,CASSLEEATGELSF,4,0,1,4
TRBV5-1,TRBJ2-7,CASSLTQGFYEQYF,4,0,1,4
TRBV5-1,TRBJ2-7,CASSLNAVFYEQYL,4,0,1,4
TRBV5-1,TRBJ2-1,CASSSSGVASEQFF,4,0,1,4
TRBV5-1,TRBJ2-1,CASSLENSYNEQFF,4,0,1,4
TRBV5-1,TRBJ2-5,CASSPQGPRETQYF,4,0,1,4
TRBV4-1,TRBJ2-4,CASSPKPHWDIQYF,4,0,1,4
TRBV5-1,TRBJ2-5,CASSRTGSAETQYF,4,0,1,4
TRBV4-1,TRBJ2-7,CASSHSPAGNEQYF,4,0,1,4
TRBV4-1,TRBJ2-7,CASSQQTGVYEQYF,4,0,1,4
TRBV4-1,TRBJ1-1,CASSQAGGGSEAFF,4,0,1,4
TRBV5-1,TRBJ1-1,CASSGLGGRAEAFF,4,0,1,4
TRBV5-1,TRBJ1-1,CASSSRGLGSEAFF,4,0,1,4
TRBV4-1,TRBJ2-5,CASSKGQAQETQYF,4,0,1,4
TRBV20-1,TRBJ2-7,CSAPEWGGSYEQYF,4,0,1,4
TRBV20-1,TRBJ1-5,CSAQDRIISGPQHY,4,0,1,4
TRBV20-1,TRBJ1-5,CSAIGQGGNQPQHF,4,0,1,4
TRBV20-1,TRBJ2-1,CSATYYSSYNEQFF,4,0,1,4
TRBV20-1,TRBJ2-1,CSARLAGGIDEQFF,4,0,1,4
TRBV20-1,TRBJ1-5,CSARGGSQVQPQHF,4,0,1,4
TRBV20-1,TRBJ1-4,CSARGAANNEKLFF,4,0,1,4
TRBV20-1,TRBJ1-5,CSARGGGSNQPQHF,4,0,1,4
TRBV20-1,TRBJ1-4,CSARGREGWEKLFF,4,0,1,4
TRBV20-1,TRBJ1-1,CSARDEFPGFEAYF,4,0,1,4
TRBV20-1,TRBJ2-3,CSASLPGVTDTQYF,4,0,1,4
TRBV20-1,TRBJ1-5,CSAQGGTANQPQHF,4,0,1,4
TRBV29-1,TRBJ1-2,CSVLLAGGGYGYTF,4,0,1,4
TRBV29-1,TRBJ2-1,CSVLHRVSYNEQFF,4,0,1,4
TRBV29-1,TRBJ1-1,CSVGDRESNTEAFF,4,0,1,4
TRBV29-1,TRBJ2-5,CSVDLAGGPETQYF,4,0,1,4
TRBV29-1,TRBJ2-1,CSVEDPYHGNEQFF,4,0,1,4
TRBV29-1,TRBJ2-3,CSVEESDKADTQYF,4,0,1,4
TRBV29-1,TRBJ2-1,CSVITRQLYNEQFF,4,0,1,4
TRBV29-1,TRBJ1-5,CSVDMTDSNQPQHF,4,0,1,4
TRBV29-1,TRBJ2-5,CSVEGQPIGETQYF,4,0,1,4
TRBV29-1,TRBJ1-2,CSAVYRGRDYGYTF,4,0,1,4
TRBV29-1,TRBJ2-2,CSAEIQGNPGELFF,4,0,1,4
TRBV29-1,TRBJ2-7,CSIQRSGDSYEQYF,4,0,1,4
TRBV5-1,TRBJ1-1,WASSYLGGSTEAFF,4,0,1,4
TRBV12-5,TRBJ1-1,CASGLHVNTEAFF,4,0,1,4
TRBV30,TRBJ2-5,CAWSVGGVETQYF,4,0,1,4
TRBV30,TRBJ1-2,CAWSVSFNYGYTF,4,0,1,4
TRBV30,TRBJ1-5,CAWSVQGNQPQHF,4,0,1,4
TRBV30,TRBJ2-7,CAWSVDNSYEQYF,4,0,1,4
TRBV30,TRBJ1-2,CAWSPSQVYGYTF,4,0,1,4
TRBV30,TRBJ2-1,CAWRNRGTNEQFF,4,0,1,4
TRBV30,TRBJ2-7,CAWNVVSSYEQYF,4,0,1,4
TRBV30,TRBJ2-5,CAWKVSGGGTQYF,4,0,1,4
TRBV10-3,TRBJ1-2,CAISENRSGAYTF,4,0,1,4
TRBV24-1,TRBJ1-4,CATAGGPDEKLFF,4,0,1,4
TRBV28,TRBJ1-5,CATQYRGNQPQHF,4,0,1,4
TRBV27,TRBJ1-2,CATGPGAPYGYTF,4,0,1,4
TRBV24-1,TRBJ2-3,CATSDFGTDTQYF,4,0,1,4
TRBV24-1,TRBJ1-5,CATSDFSGGPQHF,4,0,1,4
TRBV15,TRBJ1-3,CATSREGWSTIYF,4,0,1,4
TRBV10-3,TRBJ2-3,CATKGPGGNTQYF,4,0,1,4
TRBV19,TRBJ1-4,CASSSQGSEKLFF,4,0,1,4
TRBV19,TRBJ2-4,CASSSGRKNIQYF,4,6,2,10
TRBV19,TRBJ2-3,CASSSRLQDTQYF,4,0,1,4
TRBV19,TRBJ1-6,CASSRGLGSPLHF,4,0,1,4
TRBV19,TRBJ1-1,CASSVDRNTEAFF,4,0,1,4
TRBV19,TRBJ1-5,CASSINFGQPQHF,4,0,1,4
TRBV19,TRBJ2-3,CASSMVGTDTQYF,4,0,1,4
TRBV19,TRBJ1-2,CASSMRQAHGYTF,4,0,1,4
TRBV19,TRBJ1-1,CASSRDKNTEAFF,4,0,1,4
TRBV19,TRBJ2-5,CASSVTGTETQYF,4,0,1,4
TRBV18,TRBJ2-7,CASSEGQSYEQYF,4,0,1,4
TRBV18,TRBJ1-1,CASSLGTGNEAFF,4,0,1,4
TRBV18,TRBJ2-5,CASSPGVQETQYF,4,0,1,4
TRBV18,TRBJ2-5,CASSPPEGVTQYF,4,0,1,4
TRBV2,TRBJ1-1,CASQTAGGTEAFS,4,0,1,4
TRBV2,TRBJ1-1,CASARRGNTEAFY,4,0,1,4
TRBV6-2/3/5/6,TRBJ1-3,CASGTGGVNTIYL,4,0,1,4
TRBV12-3/4,TRBJ1-5,CASIDREGQPQHF,4,0,1,4
TRBV12-3/4,TRBJ2-7,CASMEGSGGEQYF,4,0,1,4
TRBV28,TRBJ1-3,CASTPETANTIYF,4,0,1,4
TRBV28,TRBJ1-2,CASTPQGSYGYTF,4,0,1,4
TRBV9,TRBJ2-7,CASTKDGMSEQYF,4,0,1,4
TRBV28,TRBJ2-5,CASSFLSLETQYF,4,0,1,4
TRBV12-3/4,TRBJ1-5,CASSFLGGQPQHF,4,0,1,4
TRBV12-3/4,TRBJ1-2,CASSFGGAQGYTF,4,0,1,4
TRBV6-2/3/5/6,TRBJ1-5,CASSFGSNQPQHF,4,0,1,4
TRBV27,TRBJ2-3,CASSLWGEDTQYF,4,0,1,4
TRBV6-2/3/5/6,TRBJ2-5,CASSLGSRETQYF,4,0,1,4
TRBV12-3/4,TRBJ1-1,CASSLAGGSTAFF,4,0,1,4
TRBV12-3/4,TRBJ1-5,CASSLSGNQPQHF,4,7,2,11
TRBV28,TRBJ1-1,CASSSPGDSEAFF,4,0,1,4
TRBV28,TRBJ2-7,CASSSGGLYEQYF,4,0,1,4
TRBV6-2/3/5/6,TRBJ2-7,CASSWITGPEQYF,4,0,1,4
TRBV6-2/3/5/6,TRBJ1-6,CASSYSRDSPLLF,4,0,1,4
TRBV28,TRBJ2-1,CASSLRSYNEQFF,4,0,1,4
TRBV3-1,TRBJ2-3,CASSPLATDTQYF,4,0,1,4
TRBV27,TRBJ1-5,CASSPGQAQPQHF,4,0,1,4
TRBV12-3/4,TRBJ2-1,CASSPDREYEQFF,4,0,1,4
TRBV12-3/4,TRBJ2-2,CASSRRGSGELFF,4,0,1,4
TRBV2,TRBJ2-5,CASSVRYQETQYF,4,0,1,4
TRBV6-1,TRBJ1-1,CASSALLLTEAFF,4,0,1,4
TRBV6-1,TRBJ1-1,CASSGLMNTEAFF,4,0,1,4
TRBV6-1,TRBJ1-5,CASSGEGNQPQHF,4,0,1,4
TRBV2,TRBJ2-3,CASSEYYTDTQYF,4,0,1,4
TRBV25-1,TRBJ2-3,CASSEQGTDTQYF,4,0,1,4
TRBV6-1,TRBJ1-6,CASSEGPGSPLHF,4,0,1,4
TRBV2,TRBJ1-1,CASSETSGTEAFF,4,0,1,4
TRBV2,TRBJ1-1,CASSERVFTEAFF,4,0,1,4
TRBV7-9,TRBJ2-5,CASSTGGAGTQYF,4,0,1,4
TRBV6-4,TRBJ1-1,CASSSRSNTEAFF,4,0,1,4
TRBV11-2,TRBJ1-5,CASSFRQNQPQHF,4,0,1,4
TRBV7-3,TRBJ2-5,CASSFQHQETQYF,4,0,1,4
TRBV5-5,TRBJ1-5,CASSLGGDQPQHF,4,0,1,4
TRBV5-4,TRBJ2-7,CASSLGLNYEQYF,4,0,1,4
TRBV5-4,TRBJ2-7,CASSLERPHEQYF,4,0,1,4
TRBV7-2,TRBJ2-5,CASSLLGQETQYF,4,0,1,4
TRBV7-3,TRBJ2-1,CASSLLLDNEQFF,4,0,1,4
TRBV7-9,TRBJ2-1,CASSLVGYREQFF,4,0,1,4
TRBV7-2,TRBJ1-2,CASSLAGDYGYTF,4,0,1,4
TRBV11-2,TRBJ2-4,CASSLGSKNIQYF,4,0,1,4
TRBV11-3,TRBJ2-1,CASSLGPWDREFF,4,0,1,4
TRBV7-3,TRBJ1-6,CASSLEWGSPLHF,4,0,1,4
TRBV7-9,TRBJ2-7,CASSLRGGYEQYF,4,0,1,4
TRBV7-3,TRBJ2-7,CASSLNPSFEQYF,4,0,1,4
TRBV7-2,TRBJ1-6,CASSSLIGSPLHF,4,0,1,4
TRBV6-2/3/5/6,TRBJ1-2,CASSLSETRSYTF,4,0,1,4
TRBV7-9,TRBJ1-1,CASSLLVGTEAFF,4,4,2,8
TRBV7-2,TRBJ1-5,CASSLGQGQPQHF,4,0,1,4
TRBV11-2,TRBJ2-5,CASSLDRGETQYF,4,0,1,4
TRBV7-3,TRBJ2-7,CASSPSGGYEQYF,4,0,1,4
TRBV12-3/4,TRBJ1-1,CASSPDRYTEAFF,4,0,1,4
TRBV7-3,TRBJ2-7,CASSPSGYGEQYF,4,0,1,4
TRBV7-3,TRBJ2-1,CASSPRQGNEQFF,4,0,1,4
TRBV7-2,TRBJ1-3,CASSPQVGNTIYF,4,0,1,4
TRBV11-2,TRBJ1-2,CASSPGFNYGYTF,4,0,1,4
TRBV7-9,TRBJ1-2,CASSPTAGVGYTF,4,0,1,4
TRBV3-1,TRBJ2-4,CASSRYGGDIQYF,4,0,1,4
TRBV7-9,TRBJ1-5,CASSRAGGQPQHF,4,0,1,4
TRBV7-9,TRBJ2-5,CASSHDSQETQYF,4,0,1,4
TRBV14,TRBJ2-5,CASSHLVQETQYF,4,0,1,4
TRBV3-1,TRBJ2-3,CASSHASADTQYF,4,0,1,4
TRBV28,TRBJ1-4,CASSQGWDEKLFF,4,0,1,4
TRBV3-1,TRBJ2-7,CASSQGDYYEQYF,4,0,1,4
TRBV14,TRBJ2-7,CASSQVTGSEQYF,4,0,1,4
TRBV3-1,TRBJ2-3,CASSQVAGNTQYF,4,0,1,4
TRBV3-1,TRBJ1-1,CASSQAGVPEAFF,4,0,1,4
TRBV14,TRBJ2-7,CASSQGRGVEQYF,4,0,1,4
TRBV14,TRBJ1-5,CASSQERFAPQHF,4,0,1,4
TRBV7-2,TRBJ2-1,CASSADSNNEQFF,4,0,1,4
TRBV7-9,TRBJ1-1,CASSTRANTEAFF,4,0,1,4
TRBV7-9,TRBJ1-2,CASSTRTGAGYTF,4,0,1,4
TRBV6-4,TRBJ2-6,CASRWTGANVLTF,4,0,1,4
TRBV27,TRBJ1-2,CASRPRGLYGYTF,4,0,1,4
TRBV2,TRBJ1-1,CASRTDRGAEAFF,4,0,1,4
TRBV6-2/3/5/6,TRBJ1-1,CASRRGSGTEAFF,4,0,1,4
TRBV12-3/4,TRBJ1-2,CASRLGQAGGCTF,4,0,1,4
TRBV7-9,TRBJ2-7,CASRPGTGYEQYF,4,0,1,4
TRBV6-2/3/5/6,TRBJ1-6,CASRRQVESPLHF,4,0,1,4
TRBV12-3/4,TRBJ2-1,CASRAGPPNEQFF,4,0,1,4
TRBV30,TRBJ2-3,CASEQGETDTQYF,4,0,1,4
TRBV5-1,TRBJ2-1,CASQPSTRDREFF,4,0,1,4
TRBV5-1,TRBJ1-1,CASVQSGDTEAFF,4,0,1,4
TRBV5-1,TRBJ2-1,CASMGVSYNEQFF,4,0,1,4
TRBV10-1,TRBJ2-1,CASSESGTETKVF,4,0,1,4
TRBV5-1,TRBJ2-3,CASSLSQLDTQYF,4,0,1,4
TRBV5-1,TRBJ1-1,CASSLVGGGEAFF,4,0,1,4
TRBV5-1,TRBJ1-5,CASSLDVDQPQHF,4,0,1,4
TRBV5-1,TRBJ2-1,CASSLDSYNEQFF,4,7,2,11
TRBV5-1,TRBJ2-7,CASSLTTGYEQYF,4,0,1,4
TRBV5-1,TRBJ2-7,CASSLLADYEQYF,4,0,1,4
TRBV5-1,TRBJ1-1,CASSLGQGAVAFF,4,0,1,4
TRBV5-1,TRBJ2-7,CASSLGTAYEQYF,4,0,1,4
TRBV5-1,TRBJ1-1,CASSPQGHTEAFF,4,0,1,4
TRBV4-1,TRBJ2-2,CASSPTQTGELFF,4,0,1,4
TRBV5-1,TRBJ1-1,CASSGGGGTEAFF,4,0,1,4
TRBV10-1,TRBJ2-1,CASSRGRLYEQFF,4,0,1,4
TRBV20-1,TRBJ2-5,CSVSGTGYETQYF,4,0,1,4
TRBV20-1,TRBJ2-1,CSALNDILDEQFF,4,0,1,4
TRBV20-1,TRBJ1-5,CSASGGTNQPQHF,4,0,1,4
TRBV20-1,TRBJ2-5,CSARSLTQETQYF,4,0,1,4
TRBV20-1,TRBJ2-3,CSARAPPSATQYF,4,0,1,4
TRBV20-1,TRBJ1-1,CSARAGTGSEAFF,4,0,1,4
TRBV20-1,TRBJ1-1,CSARGERARQTFF,4,0,1,4
TRBV20-1,TRBJ2-7,CSAKGTSDYEQYF,4,0,1,4
TRBV20-1,TRBJ2-3,CSARGGTADTQYF,4,0,1,4
TRBV20-1,TRBJ1-2,CSARPTANYGYTF,4,0,1,4
TRBV20-1,TRBJ2-7,CSAKPGAGDEQYF,4,0,1,4
TRBV29-1,TRBJ2-7,CSVAKGQPYEQYF,4,0,1,4
TRBV29-1,TRBJ2-7,CSVAKDMAYEQYF,4,0,1,4
TRBV29-1,TRBJ2-5,CSVAVGGQETQYF,4,0,1,4
TRBV29-1,TRBJ2-3,CSVDRGGTDTQYF,4,0,1,4
TRBV29-1,TRBJ2-7,CSVESPGSYEQYF,4,0,1,4
TRBV29-1,TRBJ2-2,CSVEVWWGGELFF,4,0,1,4
TRBV29-1,TRBJ2-7,CSVEEGTRFEQFL,4,0,1,4
TRBV29-1,TRBJ2-7,CSVEEGTRFEQYF,4,0,1,4
TRBV29-1,TRBJ2-3,CSVENNLTDTQYF,4,0,1,4
TRBV29-1,TRBJ2-7,CSVISADSYEQYS,4,0,1,4
TRBV29-1,TRBJ1-4,CSVAGSGNEKLFF,4,0,1,4
TRBV29-1,TRBJ2-7,CSVGTSGSYEQYF,4,0,1,4
TRBV29-1,TRBJ1-1,CSVATGGDTEAFF,4,0,1,4
TRBV29-1,TRBJ1-1,CSVAQGSNTEAFF,4,0,1,4
TRBV29-1,TRBJ2-1,CSVTGTGYNEQFF,4,0,1,4
TRBV29-1,TRBJ1-4,CSARRSTNEKLFF,4,0,1,4
TRBV29-1,TRBJ2-1,CSTSSGGDNEQFF,4,0,1,4
TRBV30,TRBJ2-7,CAWMPGQEKQYF,4,0,1,4
TRBV30,TRBJ1-1,CAWSQGSTEAFF,4,7,2,11
TRBV30,TRBJ2-7,CAWSWDTYEQYF,4,0,1,4
TRBV30,TRBJ1-5,CAWSLRRGAQHF,4,0,1,4
TRBV19,TRBJ2-3,CASSMGADTQHF,4,0,1,4
TRBV19,TRBJ2-3,CASSMEGDTQYF,4,0,1,4
TRBV19,TRBJ2-7,CASSREPSEQYF,4,0,1,4
TRBV19,TRBJ1-1,CASRQGATEAFF,4,0,1,4
TRBV6-2/3/5/6,TRBJ2-7,CASSWTGERQYF,4,0,1,4
TRBV18,TRBJ1-1,CASSPLRGEAFF,4,0,1,4
TRBV18,TRBJ2-7,CASSPGDYEEYF,4,0,1,4
TRBV2,TRBJ1-1,CASRGGNTEAFF,4,0,1,4
TRBV27,TRBJ2-7,CASRGDSYEQYF,4,0,1,4
TRBV19,TRBJ2-3,CASGTSTDTQYF,4,0,1,4
TRBV2,TRBJ1-2,CASIDVLGGYTF,4,0,1,4
TRBV2,TRBJ2-5,CASIGYQETQYF,4,0,1,4
TRBV28,TRBJ1-5,CASSLVGQPQHF,4,0,1,4
TRBV28,TRBJ1-5,CASSLLRQPQHF,4,0,1,4
TRBV28,TRBJ1-5,CASSLRVQPQHF,4,0,1,4
TRBV12-3/4,TRBJ1-5,CASSLAGLPQHF,4,0,1,4
TRBV12-3/4,TRBJ2-4,CASSLRGNIQYF,4,0,1,4
TRBV12-3/4,TRBJ2-5,CASSLKGETQYF,4,0,1,4
TRBV6-2/3/5/6,TRBJ2-7,CASSWTDYEQYF,4,0,1,4
TRBV6-2/3/5/6,TRBJ1-1,CASSYWQGEAFF,4,0,1,4
TRBV12-3/4,TRBJ2-7,CASSYGHDEQYF,4,0,1,4
TRBV6-2/3/5/6,TRBJ2-3,CASSQTTDTQYF,4,0,1,4
TRBV2,TRBJ2-2,CASSVGPGELFF,4,0,1,4
TRBV2,TRBJ2-5,CASSGGLETQYF,4,0,1,4
TRBV5-4,TRBJ2-3,CASSLDGVAQYF,4,0,1,4
TRBV7-9,TRBJ2-2,CASSLGPGELFF,4,0,1,4
TRBV7-9,TRBJ1-5,CASSLESQPQHF,4,0,1,4
TRBV7-9,TRBJ1-2,CASSLTEYGYTF,4,0,1,4
TRBV7-9,TRBJ1-1,CASSSSNTEAFF,4,0,1,4
TRBV11-2,TRBJ2-3,CASSWVTDTQYF,4,0,1,4
TRBV7-6,TRBJ1-2,CASSLMNYGYTF,4,0,1,4
TRBV12-3/4,TRBJ2-1,CASSLTGDEQFF,4,0,1,4
TRBV7-9,TRBJ1-2,CASSPSLDGYTF,4,0,1,4
TRBV3-1,TRBJ2-7,CASSQTLYEQYF,4,0,1,4
TRBV7-3,TRBJ2-3,CASSMVGDTQYF,4,0,1,4
TRBV7-9,TRBJ2-3,CASSSEGDTQYF,4,0,1,4
TRBV12-3/4,TRBJ2-7,CASSRDSYEQYL,4,0,1,4
TRBV2,TRBJ2-5,CASRPRQETQYF,4,5,2,9
TRBV6-2/3/5/6,TRBJ2-7,CASNQGAYEQYF,4,2,2,6
TRBV28,TRBJ1-1,CASKGVNTEAFF,4,0,1,4
TRBV5-1,TRBJ1-2,CASSLDNYGYTF,4,0,1,4
TRBV5-1,TRBJ2-5,CASSLEQETQYF,4,0,1,4
TRBV5-1,TRBJ2-3,CASSLGRDTQYF,4,0,1,4
TRBV4-1,TRBJ1-1,CASSQVSGSTFF,4,0,1,4
TRBV29-1,TRBJ1-1,CSLSLQNTEAFF,4,0,1,4
TRBV20-1,TRBJ2-7,CSALPGPYEQYF,4,0,1,4
TRBV20-1,TRBJ1-1,CSASSMGDEAFF,4,0,1,4
TRBV20-1,TRBJ2-7,CSARVGVYEQFF,4,0,1,4
TRBV20-1,TRBJ1-5,CSARDADQPQHF,4,0,1,4
TRBV20-1,TRBJ2-7,CSARIREGGQYF,4,0,1,4
TRBV20-1,TRBJ1-6,CSARQPNSPLHF,4,0,1,4
TRBV29-1,TRBJ2-5,CSLGDIQETQYF,4,0,1,4
TRBV29-1,TRBJ1-2,CSVVGRNYGYTF,4,0,1,4
TRBV29-1,TRBJ2-3,CSVARFGDTQYF,4,0,1,4
TRBV29-1,TRBJ1-1,CSVDQQNTEAFF,4,0,1,4
TRBV29-1,TRBJ2-2,CSVEATVGELFF,4,0,1,4
TRBV29-1,TRBJ1-4,CSVEDGNEKLFF,4,0,1,4
TRBV29-1,TRBJ1-2,CSVRQGAEGYTF,4,0,1,4
TRBV29-1,TRBJ2-5,CSVRTGEETQYF,4,0,1,4
TRBV29-1,TRBJ1-2,CSVSGQNYGYTF,4,0,1,4
TRBV12-3/4,TRBJ1-2,RASTFRAYGYTF,4,0,1,4
TRBV30,TRBJ1-1,CAWSAYTEAFF,4,0,1,4
TRBV19,TRBJ2-1,CASSNVNEQFF,4,0,1,4
TRBV28,TRBJ2-7,CASRDLYAQYF,4,0,1,4
TRBV12-3/4,TRBJ1-2,CASKERDGYTF,4,0,1,4
TRBV2,TRBJ1-1,CASTQGAAAFF,4,0,1,4
TRBV6-2/3/5/6,TRBJ2-5,CASSLQETQYF,4,0,1,4
TRBV28,TRBJ1-5,CASSSDQPQHF,4,0,1,4
TRBV2,TRBJ2-4,CASSEVTIQYF,4,0,1,4
TRBV2,TRBJ2-1,CASSEAEGMFF,4,0,1,4
TRBV5-5,TRBJ2-5,CASSFTETQYF,4,0,1,4
TRBV11-3,TRBJ2-1,CASSSAHEQFF,4,0,1,4
TRBV7-9,TRBJ2-7,CASSSGRSSAF,4,0,1,4
TRBV3-1,TRBJ2-7,CASSYRYEQYF,4,0,1,4
TRBV7-8,TRBJ2-5,CASSLKETQYF,4,6,2,10
TRBV6-2/3/5/6,TRBJ2-5,CASSVRETQYF,4,0,1,4
TRBV2,TRBJ2-3,CASRGADTQYF,4,0,1,4
TRBV6-2/3/5/6,TRBJ2-7,CASRNSYEQYF,4,0,1,4
TRBV12-3/4,TRBJ1-3,CASNLVDTIYF,4,0,1,4
TRBV5-1,TRBJ2-3,CATSRTDTQYF,4,0,1,4
TRBV5-1,TRBJ2-1,CASSFGDEQFF,4,0,1,4
TRBV4-1,TRBJ2-2,CASSQTGELFF,4,0,1,4
TRBV5-1,TRBJ2-1,CASSTGPEQFF,4,0,1,4
TRBV20-1,TRBJ2-1,CSASADHEQFF,4,0,1,4
TRBV29-1,TRBJ1-1,CSVRQNTEAFF,4,0,1,4
TRBV29-1,TRBJ2-2,CSVQDTGELFF,4,0,1,4
TRBV29-1,TRBJ2-1,CSVGGVNEQFF,4,0,1,4
TRBV29-1,TRBJ2-4,CSVEKGLFQYF,4,0,1,4
TRBV29-1,TRBJ2-1,CSAARTNEQFF,4,0,1,4
TRBV29-1,TRBJ1-1,CSAIQNTEAFF,4,0,1,4
TRBV29-1,TRBJ1-2,CSGRQGEGYTF,4,0,1,4
TRBV28,TRBJ2-1,CASWGHEQFF,4,0,1,4
TRBV2,TRBJ2-5,CASGEETQYF,4,0,1,4
TRBV20-1,TRBJ1-2,CSAHSRGYTF,4,0,1,4
TRBV29-1,TRBJ1-1,CSVDPEAFF,4,0,1,4
TRBV15,TRBJ1-1,CATSSPMGQAGNTEAFF,4,0,1,4
TRBV18,TRBJ2-3,CASSALLAGSNADTQYF,4,0,1,4
TRBV14,TRBJ2-1,CASGRTVWQGPYNEQFF,4,0,1,4
TRBV11-2,TRBJ2-3,CASSLGGAGARIDTQYF,4,0,1,4
TRBV4-1,TRBJ1-2,CASSQDPGTGKNYGYTF,4,0,1,4
TRBV5-1,TRBJ1-1,CASRALQVSWVYTEAFF,4,0,1,4
TRBV18,TRBJ2-3,CASSSERDSSTGTQYF,4,0,1,4
TRBV5-6,TRBJ1-2,CASSSVLVPGGYGYTF,4,0,1,4
TRBV5-1,TRBJ2-7,CASSLALTGGTYEQYF,4,0,1,4
TRBV20-1,TRBJ2-7,CSALSTSAVVGYEQYF,4,0,1,4
TRBV5-4,TRBJ1-4,CASSLQQGEEEKLFF,4,0,1,4
TRBV7-9,TRBJ2-6,CASSSPVSGANVLTF,4,0,1,4
TRBV7-3,TRBJ2-1,CASSEAGGLYNELFF,4,0,1,4
TRBV5-1,TRBJ2-2,CASSLGSVITGELFF,4,0,1,4
TRBV4-1,TRBJ1-1,CASSHLTEVNTEAFF,4,0,1,4
TRBV29-1,TRBJ2-1,CGVSGPGPTYNEQFF,4,0,1,4
TRBV20-1,TRBJ1-3,CSARVDSSGNTIYF,4,0,1,4
TRBV9,TRBJ2-2,SASERQNTGELFF,4,0,1,4
TRBV7-8,TRBJ1-5,CASSLSRNQPQHF,4,0,1,4
TRBV12-3/4,TRBJ2-7,CAISLVGWGEQYF,4,0,1,4
TRBV18,TRBJ2-5,CASSRGVQETQYF,4,0,1,4
TRBV7-9,TRBJ2-5,CASSFSSQETQYF,4,0,1,4
TRBV20-1,TRBJ2-1,CSASSLLNEQFF,4,0,1,4
TRBV29-1,TRBJ2-5,CTTFGFSVPGHSSETRVLKETQYF,3,0,1,3
TRBV12-3/4,TRBJ2-1,CASSSIWAPASGGEGYTYEQFF,3,0,1,3
TRBV28,TRBJ2-3,CASSLELPRAYNKGIGTDTQYF,3,0,1,3
TRBV14,TRBJ2-1,CASSQDISGTGYSLSYNEQFF,3,0,1,3
TRBV6-2/3/5/6,TRBJ1-5,CASSLRLGQGWLLFNQPQHF,3,0,1,3
TRBV2,TRBJ1-2,CASSASQGASVNLLNYGYTF,3,0,1,3
TRBV6-1,TRBJ1-2,CASSGSGGIKDPFSNYGYTF,3,0,1,3
TRBV5-6,TRBJ2-3,CASSLRAASGGAGFTDTQYF,3,0,1,3
TRBV3-1,TRBJ2-3,CASSHLGLAGSGAPTDTQYF,3,0,1,3
TRBV4-1,TRBJ2-6,CASSQDPREPRVPGANVLTF,3,0,1,3
TRBV30,TRBJ2-2,CAWSVRGGTGGRGTGELFS,3,0,1,3
TRBV10-3,TRBJ2-7,CAISEGGYGDRAIVGEQYF,3,0,1,3
TRBV19,TRBJ2-1,CASSKGASGQASSYNEQFF,3,0,1,3
TRBV2,TRBJ2-7,CASSYPGDRIIYLSYEQYF,3,0,1,3
TRBV12-3/4,TRBJ2-6,CASSLGLAGGPSGANVLTF,3,0,1,3
TRBV25-1,TRBJ2-1,CASSDPHGQRSQGGNEQFF,3,0,1,3
TRBV7-9,TRBJ1-4,CASSLGGFATSATNEKLFF,3,0,1,3
TRBV11-2,TRBJ2-1,CASSLDGSPGQGVYNEQFF,3,0,1,3
TRBV7-9,TRBJ2-6,CASSTTSQAGASGANVLTF,3,0,1,3
TRBV7-9,TRBJ2-6,CASSTRTSGGSSGANVLTF,3,0,1,3
TRBV15,TRBJ2-3,CATSRVGTAGGLIDTQYF,3,0,1,3
TRBV6-2/3/5/6,TRBJ2-1,CASSFLGVIGDTYNEQFF,3,0,1,3
TRBV12-3/4,TRBJ2-2,CASSPWIGGERNTGELFF,3,0,1,3
TRBV2,TRBJ2-5,CASSDGRLLAFFRETQYF,3,0,1,3
TRBV2,TRBJ2-5,CASSEAWLAGGQQETQYF,3,5,2,8
TRBV7-2,TRBJ1-5,CASSFLSTRDIPYQPQHF,3,0,1,3
TRBV5-4,TRBJ2-5,CASSFTSGGPTYQETQYF,3,0,1,3
TRBV7-2,TRBJ2-5,CASSLAIGSGGAQETQYF,3,0,1,3
TRBV7-9,TRBJ2-3,CASSLTSYRGRYTDTQYF,3,0,1,3
TRBV11-2,TRBJ2-6,CASSPRDSKLSGANVLTF,3,0,1,3
TRBV14,TRBJ2-1,CASSQDKRASGANNEQFL,3,0,1,3
TRBV4-2,TRBJ1-1,CASSQEVAGKLGNTEAFF,3,0,1,3
TRBV10-2,TRBJ1-1,CASSESTQTAGYRTEAFF,3,0,1,3
TRBV5-1,TRBJ1-1,CASSSSGVTGTGTSEAFF,3,0,1,3
TRBV5-1,TRBJ2-3,CASSPSRTSGGITDTQYF,3,3,2,6
TRBV20-1,TRBJ2-3,CSAGAGTSGGSLADTQYF,3,0,1,3
TRBV20-1,TRBJ2-1,CSARGPRTGGIFFNEQFF,3,0,1,3
TRBV20-1,TRBJ1-1,CSARDQVRVGGRATEAFF,3,0,1,3
TRBV7-9,TRBJ2-1,YASRAPGVPSLGWNEQFF,3,0,1,3
TRBV12-5,TRBJ2-1,CASGFHGGGGNYNEQFF,3,0,1,3
TRBV24-1,TRBJ2-2,CATSDPSGGLNTGELFF,3,0,1,3
TRBV19,TRBJ1-5,CASSMRGQGTDNQPQHF,3,0,1,3
TRBV18,TRBJ1-1,CASSPYPVGGANTEAFF,3,0,1,3
TRBV18,TRBJ2-5,CASSPVFAGQYQETQYF,3,0,1,3
TRBV5-6,TRBJ2-5,CASTRFAWNNGEETQYF,3,0,1,3
TRBV12-3/4,TRBJ2-7,CASSFPREGQGLNEQYF,3,0,1,3
TRBV28,TRBJ2-3,CASSLGQGVRGTDTQYF,3,0,1,3
TRBV28,TRBJ1-5,CASSLFLTGGRGQPQHF,3,0,1,3
TRBV12-3/4,TRBJ2-1,CASSLPGLAGDYNEQFF,3,0,1,3
TRBV6-2/3/5/6,TRBJ2-3,CASSLGLGGLISDTQYF,3,0,1,3
TRBV28,TRBJ1-5,CASSYQRRILGNQPQHF,3,0,1,3
TRBV28,TRBJ2-5,CASSPRLAGGPRETQYF,3,0,1,3
TRBV6-4,TRBJ1-5,CASSDPGTGGDNQPQHF,3,0,1,3
TRBV2,TRBJ1-1,CASSEVGGVIMNTEAFF,3,0,1,3
TRBV6-1,TRBJ1-6,CASSEAPGRLLLSPLHF,3,0,1,3
TRBV27,TRBJ2-3,CASSIDLPGPSTDTQYF,3,0,1,3
TRBV7-2,TRBJ2-6,CASSLALRFSGANVLTF,3,0,1,3
TRBV11-2,TRBJ1-6,CASSLDPWQGYNSPLHF,3,0,1,3
TRBV11-3,TRBJ2-1,CASSLEYLRGGDNEQFF,3,0,1,3
TRBV7-9,TRBJ1-4,CASSLIEGAVSNEKLFF,3,0,1,3
TRBV6-2/3/5/6,TRBJ2-1,CASSSVAGSGGAGEQFF,3,0,1,3
TRBV7-9,TRBJ2-5,CASSSRTSGGGEETQYF,3,0,1,3
TRBV7-6,TRBJ2-3,CASSSRKERGFTDTQYF,3,0,1,3
TRBV7-9,TRBJ1-6,CASSSTDYSSYNSPLHF,3,0,1,3
TRBV5-4,TRBJ2-2,CASSWRIDRTNTGELFF,3,0,1,3
TRBV12-3/4,TRBJ1-6,CASSPHTTGSFNSPLHF,3,0,1,3
TRBV7-8,TRBJ2-1,CASSPFTGTGNPNEQFF,3,0,1,3
TRBV9,TRBJ2-1,CASSPTFGGGGHNEQFF,3,0,1,3
TRBV7-2,TRBJ2-3,CASSRGMISRSTDTQYF,3,0,1,3
TRBV2,TRBJ1-3,CASSRGDSYSSGNTIYF,3,0,1,3
TRBV3-1,TRBJ2-3,CASSQPLGGGTTDTQYF,3,0,1,3
TRBV6-2/3/5/6,TRBJ1-5,CASSQHTPTYSNQPQHF,3,0,1,3
TRBV4-2,TRBJ2-3,CASSQRGPGSGTDTQYF,3,0,1,3
TRBV3-1,TRBJ2-3,CASSQRGRGARTDTQYF,3,0,1,3
TRBV3-1,TRBJ2-5,CASSQDGGTSGESTQYF,3,0,1,3
TRBV3-1,TRBJ2-1,CASSGASGGAPYNEQFF,3,0,1,3
TRBV6-2/3/5/6,TRBJ1-1,CASRAGTGAPMNTEAFF,3,0,1,3
TRBV2,TRBJ1-5,CASRRDRGFASNQPQHF,3,0,1,3
TRBV7-8,TRBJ2-3,CASRQQPWGGNTDTQYF,3,0,1,3
TRBV5-1,TRBJ2-7,CASSLARLGQGSYEQYF,3,0,1,3
TRBV5-1,TRBJ2-7,CASSLAPGTSETYEQYF,3,0,1,3
TRBV5-1,TRBJ2-3,CASSLGDQGTREDTQYF,3,0,1,3
TRBV5-1,TRBJ2-4,CASSLEGSLLAKNIQYF,3,0,1,3
TRBV5-1,TRBJ2-3,CASSSRTSGSFTDTQYF,3,0,1,3
TRBV4-1,TRBJ1-5,CASSPTGDSGSNQPQHF,3,0,1,3
TRBV4-1,TRBJ2-1,CASSQVSGGELYNEQFF,3,0,1,3
TRBV4-1,TRBJ2-7,CASSQGNGVLAGSEQYF,3,0,1,3
TRBV4-1,TRBJ1-1,CASSQDFIGQRDWGAFF,3,0,1,3
TRBV4-1,TRBJ2-3,CASSQEVRGGGGDTQYF,3,0,1,3
TRBV4-1,TRBJ1-6,CASSQRGQSSYNSPLHF,3,0,1,3
TRBV20-1,TRBJ1-6,CSARRTGEVYNNSPLHF,3,2,2,5
TRBV20-1,TRBJ1-2,CSARDFVRVIGVPGYTF,3,0,1,3
TRBV29-1,TRBJ2-7,CSVELLEVEQGIYEQYF,3,0,1,3
TRBV29-1,TRBJ1-5,CSVEGSVGGTQNQPQHF,3,0,1,3
TRBV29-1,TRBJ1-1,CSVGEDRGSSSIAEAFF,3,0,1,3
TRBV7-2,TRBJ1-2,SASSLSVGGQGAHGYTF,3,0,1,3
TRBV7-2,TRBJ1-1,CACSLGQGGRRTEAFF,3,0,1,3
TRBV30,TRBJ1-6,CAWSVYSGQDNSPLHF,3,0,1,3
TRBV18,TRBJ1-2,CAGSPVGPQGKYGYTF,3,0,1,3
TRBV10-3,TRBJ1-6,CAISESGQGGNSPLHF,3,0,1,3
TRBV10-3,TRBJ2-7,CAISESGQGGTYEQYF,3,0,1,3
TRBV2,TRBJ2-1,CATQEGRLAGLGEQFF,3,0,1,3
TRBV24-1,TRBJ2-3,CATSAGRGVRTDTQYF,3,0,1,3
TRBV24-1,TRBJ2-6,CATSDGGSSGANVLTF,3,0,1,3
TRBV15,TRBJ2-7,CATSRDLSQVSYEQYF,3,0,1,3
TRBV27,TRBJ2-3,CASEERRAGATDTQYF,3,0,1,3
TRBV19,TRBJ1-5,CASSITTGGGNQPQHF,3,0,1,3
TRBV19,TRBJ1-1,CASSIPGRYVNTEAFF,3,0,1,3
TRBV19,TRBJ2-3,CASSIDSAALRDTQYF,3,0,1,3
TRBV19,TRBJ2-5,CASSMSVADIQETQYF,3,0,1,3
TRBV19,TRBJ2-7,CASSMGGGGVSYEQYF,3,0,1,3
TRBV19,TRBJ2-3,CASSMTSGGITDTQYF,3,5,2,8
TRBV19,TRBJ1-5,CASSTIRDRVIKPQHF,3,0,1,3
TRBV19,TRBJ1-5,CASSRGTGGNNQPQHF,3,0,1,3
TRBV19,TRBJ2-7,CASRPGLADADYEQYF,3,0,1,3
TRBV18,TRBJ2-3,CASSLSPRGATDTQYF,3,0,1,3
TRBV18,TRBJ2-5,CASSPPWTGGGETQYF,3,0,1,3
TRBV18,TRBJ2-4,CASSPAAGGVLNIQYF,3,0,1,3
TRBV18,TRBJ1-1,CASPPGTGRPATEAFF,3,0,1,3
TRBV19,TRBJ1-3,CASRIQGQEAGNTIYF,3,0,1,3
TRBV3-1,TRBJ2-1,CASTLAGGGSYNEQFF,3,0,1,3
TRBV12-3/4,TRBJ1-5,CASSFLRGVSNQPQHF,3,3,2,6
TRBV12-3/4,TRBJ2-6,CASSFALGAGANVLTF,3,0,1,3
TRBV12-3/4,TRBJ1-1,CASSFGTLVMNTEALF,3,0,1,3
TRBV6-2/3/5/6,TRBJ2-4,CASSFPPGIAKNIQYF,3,0,1,3
TRBV28,TRBJ2-2,CASSFRGGVGTGELFF,3,0,1,3
TRBV12-3/4,TRBJ2-1,CASSFGGGPVTNEQFF,3,0,1,3
TRBV28,TRBJ2-1,CASSLGGRGPYNEQFF,3,0,1,3
TRBV28,TRBJ1-5,CASSLGGGAIRQPQHF,3,0,1,3
TRBV27,TRBJ2-5,CASSLGTSGGGETQYF,3,0,1,3
TRBV6-2/3/5/6,TRBJ2-6,CASSLEMGSGANVLTF,3,0,1,3
TRBV28,TRBJ2-1,CASSLTPGQGENEQFF,3,0,1,3
TRBV28,TRBJ1-6,CASSSPGSRSNSPLHF,3,0,1,3
TRBV6-2/3/5/6,TRBJ1-5,CASSSHRVYRNQPQHF,3,0,1,3
TRBV2,TRBJ1-2,CASSSDRGQVGHGYTF,3,0,1,3
TRBV28,TRBJ2-7,CASSSPPGQPSYEQYF,3,0,1,3
TRBV6-2/3/5/6,TRBJ2-7,CASSYSLGLRTYEQYF,3,0,1,3
TRBV6-2/3/5/6,TRBJ2-7,CASSYRQGTPSYEQYF,3,0,1,3
TRBV6-2/3/5/6,TRBJ2-3,CASSYGGAWGTDTQYF,3,0,1,3
TRBV6-2/3/5/6,TRBJ2-2,CASSYDEGSGTGELFF,3,0,1,3
TRBV5-4,TRBJ1-1,CASSPIWGTGNTEAFF,3,0,1,3
TRBV6-1,TRBJ2-5,CASSATGTGGRETQYF,3,0,1,3
TRBV2,TRBJ2-1,CASSGNFRGGPNEQFF,3,0,1,3
TRBV28,TRBJ2-1,CASSGTSGGVYNEQFF,3,0,1,3
TRBV6-1,TRBJ1-5,CASSELVGRGNQPQHF,3,0,1,3
TRBV6-1,TRBJ1-2,CASSEAGVGGNYGYTF,3,0,1,3
TRBV11-2,TRBJ1-6,CASSFSPGQGDSPLHF,3,0,1,3
TRBV11-2,TRBJ2-1,CASSFLDSGGAHEQFF,3,0,1,3
TRBV13,TRBJ2-3,CASSFGTSGYTDTQYF,3,0,1,3
TRBV5-4,TRBJ2-3,CASSFGRDRNTDTQYF,3,0,1,3
TRBV5-5,TRBJ2-1,CASSFLSRGSTDEQFF,3,0,1,3
TRBV7-3,TRBJ2-2,CASSFPDLQGPGELFS,3,0,1,3
TRBV5-6,TRBJ2-7,CASSLPLGTATYEQYF,3,0,1,3
TRBV5-5,TRBJ2-1,CASSLRGLAAHNEQFF,3,0,1,3
TRBV5-6,TRBJ2-1,CASSLGMRMGGNEQFF,3,0,1,3
TRBV7-2,TRBJ2-7,CASSLDRGAIDYEQYF,3,0,1,3
TRBV5-5,TRBJ1-5,CASSLRDREGNQPQHF,3,0,1,3
TRBV7-3,TRBJ2-5,CASSLSAGTGQETQYF,3,0,1,3
TRBV7-3,TRBJ2-6,CASSLRRVSGVNVLTF,3,0,1,3
TRBV11-2,TRBJ2-6,CASSLVGLFGANVLTF,3,0,1,3
TRBV7-3,TRBJ2-1,CASSLVVGGGFNEQFF,3,0,1,3
TRBV7-2,TRBJ2-1,CASSLGAGLSYNEQFF,3,0,1,3
TRBV11-2,TRBJ2-3,CASSLDGLPGTDTQYF,3,0,1,3
TRBV11-2,TRBJ2-1,CASSLDLAGGQGEQFF,3,0,1,3
TRBV11-1,TRBJ2-1,CASSLDGGRGRNEQFF,3,0,1,3
TRBV7-9,TRBJ2-7,CASSSPPGLAGGEQYF,3,0,1,3
TRBV11-2,TRBJ2-7,CASSSRGGRTAYEQYF,3,0,1,3
TRBV7-9,TRBJ2-1,CASSSRQGVTYNEQFF,3,0,1,3
TRBV7-9,TRBJ1-2,CASSSNLHGKNYGYTF,3,0,1,3
TRBV7-9,TRBJ2-3,CASSSGLAGATDTQYF,3,0,1,3
TRBV5-6,TRBJ2-7,CASSWSSGPSSYEQYF,3,0,1,3
TRBV5-4,TRBJ2-3,CASSWGLGTSTDTQYF,3,0,1,3
TRBV7-9,TRBJ2-1,CASSLAGTKTYNEQFF,3,0,1,3
TRBV3-1,TRBJ2-7,CASSLSLAGMTYEQYF,3,0,1,3
TRBV6-2/3/5/6,TRBJ2-3,CASSLKRTRLTDTQYF,3,0,1,3
TRBV7-2,TRBJ1-4,CASSLGPAATNEKLFF,3,0,1,3
TRBV3-1,TRBJ2-5,CASSLLKGPAPETQYF,3,0,1,3
TRBV5-6,TRBJ2-1,CASSLKLAGGPNEQLF,3,0,1,3
TRBV6-2/3/5/6,TRBJ2-1,CASSPLGAGVDNEQFF,3,0,1,3
TRBV7-9,TRBJ2-7,CASSPLGLAGTRKQYF,3,0,1,3
TRBV12-3/4,TRBJ2-3,CASSPPAVSGGDTQYF,3,0,1,3
TRBV7-2,TRBJ2-1,CASSPPGLAVYNEQFF,3,0,1,3
TRBV5-4,TRBJ2-3,CASSPRTGKLTDTQYF,3,0,1,3
TRBV3-1,TRBJ2-6,CASSPGRGDGANVLTF,3,0,1,3
TRBV28,TRBJ2-7,CASSPPRADLAYEQYF,3,0,1,3
TRBV11-3,TRBJ2-1,CASSPAGAGAYNEQFF,3,0,1,3
TRBV5-4,TRBJ2-3,CASSPPQRRSTDTQYF,3,0,1,3
TRBV7-9,TRBJ2-3,CASSPARRGSTDTQYF,3,0,1,3
TRBV3-1,TRBJ2-7,CASSRSRDRVFYEQYF,3,0,1,3
TRBV12-3/4,TRBJ1-1,CASSRLPGQDNTEAFF,3,0,1,3
TRBV3-1,TRBJ2-5,CASSRGDRGHQGTQYF,3,0,1,3
TRBV6-2/3/5/6,TRBJ1-1,CASSRILQGARTEAFF,3,0,1,3
TRBV3-1,TRBJ2-3,CASSHSVGLATDTQYF,3,0,1,3
TRBV7-9,TRBJ2-5,CASSHLSGTVEETQYF,3,0,1,3
TRBV6-2/3/5/6,TRBJ2-3,CASSHRQGLWADTQYF,3,0,1,3
TRBV6-2/3/5/6,TRBJ2-3,CASSQPNRGGTDTQYF,3,0,1,3
TRBV6-2/3/5/6,TRBJ2-6,CASSQVTKTGANVLTF,3,0,1,3
TRBV3-1,TRBJ2-1,CASSQASLAGYNEQFF,3,0,1,3
TRBV4-2,TRBJ1-6,CASSQGVGATNSPLHF,3,0,1,3
TRBV9,TRBJ2-3,CASSVERAIRTDTQYF,3,0,1,3
TRBV9,TRBJ1-3,CASSVGAGLAGNTIYF,3,0,1,3
TRBV9,TRBJ1-1,CASSASPGTSNTEAFF,3,0,1,3
TRBV7-2,TRBJ1-4,CASSAGTIRTNEKLFF,3,0,1,3
TRBV7-3,TRBJ2-1,CASSMVVGGGYNEQFF,3,0,1,3
TRBV7-2,TRBJ2-3,CASSTRLAGGVDTQYF,3,0,1,3
TRBV2,TRBJ2-5,CASRVTGTGGRETQYF,3,0,1,3
TRBV28,TRBJ1-2,CASRIPTGGGGYGYTF,3,0,1,3
TRBV2,TRBJ1-1,CASRVPGQGQNTEAFF,3,3,2,6
TRBV12-3/4,TRBJ1-1,CASRGQGGRLLYEAFF,3,0,1,3
TRBV2,TRBJ2-5,CASRKGLAGEQETQYF,3,0,1,3
TRBV5-1,TRBJ2-1,CASGRTSGTNYNEQFF,3,0,1,3
TRBV10-1,TRBJ2-3,CASSESPGISTDTQYF,3,0,1,3
TRBV5-1,TRBJ2-1,CASSLVGLAGGNEQFF,3,0,1,3
TRBV5-1,TRBJ2-7,CASSLGSLALTYEQYF,3,0,1,3
TRBV5-1,TRBJ2-3,CASSLGSGSSTDTQYF,3,0,1,3
TRBV5-1,TRBJ1-4,CASSLDADRTNEKLFF,3,0,1,3
TRBV5-1,TRBJ2-3,CASSLERPDSTDTQYF,3,0,1,3
TRBV5-1,TRBJ1-2,CASSLEDRVAGYGYTF,3,0,1,3
TRBV5-1,TRBJ1-3,CASSLRTGSSGNTIYF,3,0,1,3
TRBV5-1,TRBJ1-2,CASSSAGEQTNYGYTF,3,0,1,3
TRBV5-1,TRBJ1-5,CASSLGDGYSNQPQHF,3,0,1,3
TRBV5-1,TRBJ1-2,CASSPWGTVGAYGYTF,3,0,1,3
TRBV4-1,TRBJ1-6,CASSPEFGGGNSPLHF,3,0,1,3
TRBV5-1,TRBJ1-4,CASSPTPGSPNEKLFF,3,0,1,3
TRBV5-1,TRBJ2-7,CASSPKSWTGTREQYF,3,0,1,3
TRBV4-1,TRBJ2-7,CASSRGQGAGSYEQYF,3,0,1,3
TRBV4-1,TRBJ2-1,CASSQTKRTGGNEQFF,3,0,1,3
TRBV4-1,TRBJ1-6,CASSQDLNRAGSPLHF,3,0,1,3
TRBV4-1,TRBJ2-3,CASSQDASSSTDTQYF,3,0,1,3
TRBV5-1,TRBJ2-1,CASSRGPGVSYNEQFF,3,0,1,3
TRBV5-1,TRBJ2-2,CASSRGQAANTGELFF,3,0,1,3
TRBV5-1,TRBJ2-5,CARSLSSGGTQETQYF,3,0,1,3
TRBV20-1,TRBJ2-3,CSAPRWTSGGTDTQYF,3,0,1,3
TRBV20-1,TRBJ1-6,CSARDGGSSYNSPLHF,3,0,1,3
TRBV20-1,TRBJ2-7,CSAREDWDAVIHEQYF,3,0,1,3
TRBV20-1,TRBJ2-3,CSASITSGGNTDTQYF,3,0,1,3
TRBV29-1,TRBJ2-3,CSVGSGGTIAADTQYF,3,0,1,3
TRBV29-1,TRBJ2-2,CSVEGTSGGNTGELFF,3,0,1,3
TRBV5-1,TRBJ2-3,SASSLGGTGPTDTQYF,3,0,1,3
TRBV3-1,TRBJ1-1,CASSPTTGQNTEAFF,3,0,1,3
TRBV30,TRBJ1-2,CAWSRIVSDGYGYTF,3,0,1,3
TRBV30,TRBJ2-3,CAWRRQGSGTDTQYF,3,0,1,3
TRBV6-2/3/5/6,TRBJ2-1,CAGSYSAAGDNEQFF,3,0,1,3
TRBV11-2,TRBJ2-7,CAGSLLLAGFGEQYF,3,0,1,3
TRBV10-3,TRBJ2-3,CAISVQGGPTDTQYF,3,0,1,3
TRBV10-3,TRBJ2-7,CAISGAGTGNYEQYF,3,0,1,3
TRBV10-3,TRBJ1-5,CAISEGRNSNQPQHF,3,3,2,6
TRBV10-3,TRBJ1-6,CAIRAGGGESSPLHF,3,0,1,3
TRBV24-1,TRBJ2-7,CATPVRDRGVGEQYF,3,0,1,3
TRBV28,TRBJ2-5,CATGQGASGQETQYF,3,0,1,3
TRBV24-1,TRBJ2-5,CATSDAQAPRETQYF,3,0,1,3
TRBV12-3/4,TRBJ2-2,CATRGRSAVTGELFF,3,0,1,3
TRBV24-1,TRBJ2-2,CATRRTGENTGELFF,3,0,1,3
TRBV19,TRBJ2-7,CASSSLTGSSYEQYF,3,0,1,3
TRBV19,TRBJ1-5,CASTTRDGSNQPQHF,3,0,1,3
TRBV19,TRBJ2-3,CASSSNSGSTDTQYF,3,0,1,3
TRBV19,TRBJ1-2,CASSLRTGGGYGYTF,3,0,1,3
TRBV19,TRBJ2-6,CASSDGTPGANVLTF,3,0,1,3
TRBV19,TRBJ2-1,CASSIAGHNYNEQFF,3,0,1,3
TRBV19,TRBJ2-7,CASSINSGNPYEQYF,3,0,1,3
TRBV19,TRBJ1-2,CASSIGDVLNYGYTF,3,0,1,3
TRBV19,TRBJ1-5,CASSMADYSNQPQHF,3,0,1,3
TRBV19,TRBJ2-2,CASSMGGTDTGVLFF,3,0,1,3
TRBV19,TRBJ1-4,CASSSPRGNNEKLFF,3,0,1,3
TRBV19,TRBJ2-3,CASSGPGGSTDTQYF,3,0,1,3
TRBV18,TRBJ1-1,CASSPGQGMNTEAFF,3,0,1,3
TRBV18,TRBJ1-2,CASSPRQGGDYGYTF,3,0,1,3
TRBV18,TRBJ2-7,CASSPIAQGAYEQYF,3,0,1,3
TRBV18,TRBJ2-1,CASSPSSGNWNEQFF,3,0,1,3
TRBV18,TRBJ2-5,CASSPSGGIQETQYF,3,0,1,3
TRBV18,TRBJ1-1,CASSKDRALNTEAFF,3,0,1,3
TRBV11-2,TRBJ2-3,CASTRTGGSTDTQYF,3,0,1,3
TRBV12-3/4,TRBJ2-7,CASTEGPHTDYEQYF,3,0,1,3
TRBV18,TRBJ2-1,CASTPGLDTRNEQFF,3,0,1,3
TRBV6-2/3/5/6,TRBJ2-5,CASSFFTQGGEAQYF,3,0,1,3
TRBV12-3/4,TRBJ2-5,CASSFVGSGEETQYF,3,0,1,3
TRBV12-3/4,TRBJ1-4,CASSFRTGGYEKLFF,3,0,1,3
TRBV12-3/4,TRBJ1-5,CASSLAVSENQPQHF,3,0,1,3
TRBV6-2/3/5/6,TRBJ2-7,CASSLGLAGSYEQYF,3,0,1,3
TRBV6-2/3/5/6,TRBJ2-7,CASSLGDREDYEQYF,3,0,1,3
TRBV28,TRBJ2-7,CASSSPFSGVYEQYF,3,0,1,3
TRBV28,TRBJ2-3,CASSSSGGGTDTQYF,3,0,1,3
TRBV27,TRBJ1-6,CASSWSWGNGSPLHF,3,0,1,3
TRBV6-2/3/5/6,TRBJ2-3,CASSYGAGSTDTLYF,3,0,1,3
TRBV6-2/3/5/6,TRBJ2-6,CASSYGNSGANVLTF,3,0,1,3
TRBV6-2/3/5/6,TRBJ1-5,CASSLGQSSNQPQHF,3,0,1,3
TRBV28,TRBJ1-4,CASSPWGGLGEKLFF,3,0,1,3
TRBV6-2/3/5/6,TRBJ1-2,CASSPLTPRRGGYTF,3,0,1,3
TRBV12-3/4,TRBJ2-5,CASSPPVGGQETQYF,3,0,1,3
TRBV28,TRBJ2-2,CASSPIAPGVGELFF,3,0,1,3
TRBV6-2/3/5/6,TRBJ1-3,CASSPPRAAGNTIYF,3,0,1,3
TRBV28,TRBJ2-7,CASSPGISNHYEQYF,3,0,1,3
TRBV12-3/4,TRBJ2-3,CASSPGTGGSDTQYF,3,0,1,3
TRBV6-2/3/5/6,TRBJ2-7,CASSPMGGGWYEQYF,3,0,1,3
TRBV2,TRBJ2-5,CASSPGAMFKETQYF,3,0,1,3
TRBV28,TRBJ1-4,CASSRIGQGGEKLFF,3,0,1,3
TRBV12-3/4,TRBJ1-5,CASSRQGANNQPQHF,3,0,1,3
TRBV2,TRBJ2-1,CASSVSSGSYNEQFF,3,0,1,3
TRBV6-1,TRBJ1-4,CASSVGTGGHEKLFF,3,0,1,3
TRBV2,TRBJ1-1,CASSGVGDINTEAFF,3,0,1,3
TRBV7-8,TRBJ2-3,CASSGAGASTDTQYF,3,0,1,3
TRBV25-1,TRBJ1-2,CASSGDRGPVNGYTF,3,0,1,3
TRBV6-4,TRBJ2-1,CASSDSSGGANEQFF,3,0,1,3
TRBV2,TRBJ2-1,CASSDRQGGFNEQFF,3,0,1,3
TRBV25-1,TRBJ1-1,CASSEYWGRNTEAFF,3,0,1,3
TRBV2,TRBJ2-5,CASSEQGVRVETQYF,3,0,1,3
TRBV6-1,TRBJ1-5,CASSEVGISNQPQHF,3,0,1,3
TRBV11-3,TRBJ2-5,CASSFGSLADETQYF,3,0,1,3
TRBV7-9,TRBJ1-6,CASSFNGDSNSPLHF,3,0,1,3
TRBV5-6,TRBJ2-7,CASSFAPGEGYEQYF,3,0,1,3
TRBV3-1,TRBJ2-1,CASSFEGQAYNEQFF,3,0,1,3
TRBV5-5,TRBJ2-1,CASSLSESSYNEQFF,3,0,1,3
TRBV7-9,TRBJ1-3,CASSLGQVSGNTIYF,3,0,1,3
TRBV5-6,TRBJ2-7,CASSLGLAGDCEQYF,3,0,1,3
TRBV5-4,TRBJ2-2,CASSLEGGTTGELFF,3,0,1,3
TRBV7-2,TRBJ2-1,CASSLMLAGGTEQFF,3,4,2,7
TRBV13,TRBJ2-3,CASSLTSGSTDTQYF,3,0,1,3
TRBV5-5,TRBJ2-3,CASSLNGLITDTQYF,3,0,1,3
TRBV11-2,TRBJ1-6,CASSLFRGMNSPLHF,3,3,2,6
TRBV7-2,TRBJ2-2,CASSLYLAVTGELVF,3,0,1,3
TRBV7-8,TRBJ2-3,CASSLLVRATDTQYF,3,0,1,3
TRBV7-9,TRBJ2-3,CASSLVWASTDTQYF,3,0,1,3
TRBV7-9,TRBJ2-1,CASSLVSGRVNEQFF,3,0,1,3
TRBV7-2,TRBJ2-1,CASSLVTGGRYEQFF,3,0,1,3
TRBV7-6,TRBJ1-5,CASSLVSGGNQPQHF,3,0,1,3
TRBV7-9,TRBJ2-5,CASSLVSRGPETQYF,3,0,1,3
TRBV7-9,TRBJ2-7,CASSLASGRGMEQYF,3,0,1,3
TRBV7-9,TRBJ1-3,CASSLAQSSGNTIYF,3,0,1,3
TRBV7-2,TRBJ2-5,CASSLAGRQQETQYF,3,0,1,3
TRBV5-4,TRBJ2-1,CASSLAGGQYNEQFF,3,0,1,3
TRBV11-2,TRBJ1-4,CASSLAGDMDEKLFF,3,0,1,3
TRBV11-2,TRBJ2-5,CASSLGGGIGETQYF,3,0,1,3
TRBV7-9,TRBJ2-3,CASSLGWSGRDTQYF,3,0,1,3
TRBV7-2,TRBJ1-2,CASSLGGDANYGYTF,3,0,1,3
TRBV7-9,TRBJ1-1,CASSLGDPRGTEAFF,3,0,1,3
TRBV7-2,TRBJ2-3,CASSLGWLDTDTQYF,3,0,1,3
TRBV11-2,TRBJ2-5,CASSLDWARRETQYF,3,0,1,3
TRBV7-9,TRBJ1-2,CASSLELGQNYGYTF,3,0,1,3
TRBV11-1,TRBJ2-1,CASSLERSSYNEQFF,3,0,1,3
TRBV7-3,TRBJ2-5,CASSLIGTGQETQYF,3,0,1,3
TRBV11-3,TRBJ2-2,CASSLMGGDTGEPFF,3,0,1,3
TRBV7-9,TRBJ1-3,CASSLTEISGNTIYF,3,0,1,3
TRBV7-9,TRBJ2-7,CASSLTGQLTYEQYF,3,0,1,3
TRBV7-3,TRBJ2-6,CASSLRNSGANVLTF,3,0,1,3
TRBV7-9,TRBJ2-2,CASSLNSAGAGELFF,3,0,1,3
TRBV5-4,TRBJ2-5,CASSSGTGFEETQYF,3,0,1,3
TRBV7-9,TRBJ2-1,CASSSMTGEDNEQFF,3,0,1,3
TRBV7-9,TRBJ1-2,CASSSLQGIGYGYTF,3,0,1,3
TRBV11-2,TRBJ1-1,CASSSYYTANTEAFF,3,0,1,3
TRBV7-9,TRBJ2-7,CASSSPLGGTYEQYF,3,0,1,3
TRBV7-9,TRBJ2-1,CASSSGRSAYNEQFF,3,0,1,3
TRBV7-2,TRBJ2-3,CASSWREPPGDTQYF,3,0,1,3
TRBV5-6,TRBJ2-3,CASSWGTPTTDTQYF,3,0,1,3
TRBV11-2,TRBJ1-1,CASSWRTGQNTEAFF,3,0,1,3
TRBV7-9,TRBJ2-1,CASSYWDRPYNEQFF,3,0,1,3
TRBV7-9,TRBJ2-5,CASSYGLAGEETQYF,3,0,1,3
TRBV7-2,TRBJ2-1,CASSLTRGVGNEQFF,3,0,1,3
TRBV14,TRBJ1-1,CASSLLVGGSTEAFF,3,0,1,3
TRBV3-1,TRBJ2-2,CASSLQGAGTGELFF,3,0,1,3
TRBV4-2,TRBJ2-7,CASSLTTGGQYEQYF,3,0,1,3
TRBV7-2,TRBJ2-3,CASSPWTSRTDTRYF,3,0,1,3
TRBV7-9,TRBJ1-1,CASSPRGGREAEAFF,3,0,1,3
TRBV11-2,TRBJ2-2,CASSPRGANTGELFF,3,0,1,3
TRBV14,TRBJ2-2,CASSPGTSFVGELFF,3,0,1,3
TRBV6-2/3/5/6,TRBJ2-1,CASSPGTSGGNEQFF,3,0,1,3
TRBV7-9,TRBJ2-2,CASSPGTGNTGELFF,3,0,1,3
TRBV5-4,TRBJ2-3,CASSPDMSSTDTQYF,3,0,1,3
TRBV7-2,TRBJ2-3,CASSPNGVGTDTQYL,3,0,1,3
TRBV7-3,TRBJ1-2,CASSPGGLNNYGYTF,3,0,1,3
TRBV5-4,TRBJ2-5,CASSPGIVERKTQYF,3,0,1,3
TRBV7-2,TRBJ2-7,CASSPGQVATYEQYF,3,0,1,3
TRBV12-3/4,TRBJ1-1,CASSPFGGLNTEAFF,3,0,1,3
TRBV7-8,TRBJ2-5,CASSPGTGLAETQYF,3,0,1,3
TRBV7-2,TRBJ1-2,CASSRTGGTNYGYTF,3,0,1,3
TRBV7-3,TRBJ2-2,CASSRDSSNTGELFF,3,0,1,3
TRBV5-4,TRBJ2-3,CASSRGLADTDTQYF,3,0,1,3
TRBV5-4,TRBJ2-1,CASSHSRQGPNEQFF,3,0,1,3
TRBV5-6,TRBJ1-5,CASSHRGGSNQPQHF,3,0,1,3
TRBV14,TRBJ1-3,CASSQFSRAGNTIYF,3,0,1,3
TRBV14,TRBJ1-3,CASSQLWGSGNTIYF,3,0,1,3
TRBV7-8,TRBJ2-1,CASSQPQRGHNEQFF,3,0,1,3
TRBV7-3,TRBJ2-3,CASSQPGGATDTQYF,3,0,1,3
TRBV3-1,TRBJ1-2,CASSQPYPAYYGYTF,3,0,1,3
TRBV3-1,TRBJ1-1,CASSQAFSEGTEAFF,3,0,1,3
TRBV3-1,TRBJ1-1,CASSQADRQNTEAFF,3,0,1,3
TRBV5-5,TRBJ2-3,CASSQAGGPIDTQYF,3,0,1,3
TRBV3-1,TRBJ1-5,CASSQAGQGNQPQHF,3,0,1,3
TRBV3-1,TRBJ1-5,CASSQGTRGNQPQHF,3,0,1,3
TRBV7-6,TRBJ2-3,CASSQGLLDTDTQYF,3,0,1,3
TRBV3-1,TRBJ2-7,CASSQDLGLGYEQYF,3,0,1,3
TRBV3-1,TRBJ2-3,CASSQKGAGTDTQYF,3,0,1,3
TRBV9,TRBJ1-2,CASSVGRGDGYGYTF,3,0,1,3
TRBV2,TRBJ2-4,CASSVSGGPQNIQYF,3,0,1,3
TRBV9,TRBJ2-3,CASSVSGVRQDTQYF,3,0,1,3
TRBV9,TRBJ2-1,CASSVAGVNWDEQFF,3,0,1,3
TRBV7-2,TRBJ1-2,CASSAHTGTNYGYTF,3,0,1,3
TRBV9,TRBJ2-6,CASSGDYSGANVLTF,3,0,1,3
TRBV5-4,TRBJ2-7,CASSDPTLSANEQYF,3,0,1,3
TRBV5-4,TRBJ2-7,CASSDDIESTYEQYF,3,0,1,3
TRBV5-4,TRBJ2-7,CASSTDRATFYEQYF,3,0,1,3
TRBV7-3,TRBJ2-1,CASSTGLAGVNEQFF,3,0,1,3
TRBV7-9,TRBJ2-3,CASSSLGQATDTQYF,3,0,1,3
TRBV6-2/3/5/6,TRBJ2-3,CASSKTSGGADTQYF,3,0,1,3
TRBV12-3/4,TRBJ2-5,CASSKNGQNQETQYF,3,0,1,3
TRBV12-3/4,TRBJ2-5,CASRLAEGHRETQYF,3,0,1,3
TRBV6-2/3/5/6,TRBJ1-1,CASRSWTFPGPEAFF,3,0,1,3
TRBV28,TRBJ2-3,CASRPTGYNTDTQYF,3,0,1,3
TRBV5-6,TRBJ1-2,CASRQIRTSNYGYTF,3,0,1,3
TRBV28,TRBJ2-1,CASRGPGQGRDEQFF,3,0,1,3
TRBV6-4,TRBJ2-1,CASRGDRYSYNEQFF,3,0,1,3
TRBV12-3/4,TRBJ2-1,CASRMDGDSYNEQFF,3,0,1,3
TRBV5-4,TRBJ2-7,CASRLGLGAGGEQYF,3,0,1,3
TRBV6-2/3/5/6,TRBJ2-1,CASRLAGGPGNERFF,3,0,1,3
TRBV6-2/3/5/6,TRBJ1-4,CASRREAGPDEKLFF,3,0,1,3
TRBV2,TRBJ1-3,CASNGPPLSGSTIYF,3,0,1,3
TRBV6-4,TRBJ2-7,CASKLTGTPSYEQYF,3,0,1,3
TRBV11-2,TRBJ2-2,CANSFLQWGTGELFF,3,0,1,3
TRBV28,TRBJ1-1,CANSFRTSGNTEAFF,3,0,1,3
TRBV7-2,TRBJ1-2,CTSSLVMAGSYGYTF,3,0,1,3
TRBV5-1,TRBJ2-7,CAGTLNGGPSYEQYF,3,0,1,3
TRBV18,TRBJ1-6,CASSRDGNGNSPLHF,3,0,1,3
TRBV5-1,TRBJ2-1,CASHFDRGSYNEQFF,3,0,1,3
TRBV4-1,TRBJ1-4,CASTKEGQGAGKLFF,3,0,1,3
TRBV5-1,TRBJ2-3,CASSSFGGATDTQYF,3,0,1,3
TRBV5-1,TRBJ1-2,CASSSSVAQGTGYTF,3,0,1,3
TRBV10-1,TRBJ2-7,CASSESEANPYEQYF,3,0,1,3
TRBV5-1,TRBJ2-7,CASSFYSGPTYEQYF,3,0,1,3
TRBV5-1,TRBJ2-3,CASSFAGRGTDTQYF,3,0,1,3
TRBV5-1,TRBJ2-2,CASSFATGGTGELFF,3,0,1,3
TRBV5-1,TRBJ1-1,CASSFTGVGNTEAFF,3,0,1,3
TRBV5-1,TRBJ1-6,CASSLFSVQNSPLHF,3,0,1,3
TRBV5-1,TRBJ2-4,CASSLSSRQENIQYF,3,0,1,3
TRBV5-1,TRBJ1-5,CASSLSGYSNQPQHF,3,0,1,3
TRBV5-1,TRBJ1-5,CASSLVGHPNQPQHF,3,0,1,3
TRBV5-1,TRBJ2-5,CASSLVTSGDGTQYF,3,0,1,3
TRBV5-1,TRBJ2-3,CASSLVMGATDTQYF,3,0,1,3
TRBV5-1,TRBJ2-1,CASSLAGVFGGEQFF,3,0,1,3
TRBV5-1,TRBJ1-1,CASSLGGQVNTEAFF,3,0,1,3
TRBV5-1,TRBJ2-7,CASSLGSGANYEQYF,3,0,1,3
TRBV5-1,TRBJ2-1,CASSLGQRTYNEQFF,3,0,1,3
TRBV5-1,TRBJ2-1,CASSLDGESYNEQFF,3,0,1,3
TRBV5-1,TRBJ2-2,CASSLETGRTGELFF,3,0,1,3
TRBV5-1,TRBJ2-7,CASSLSRGIPYEQYF,3,0,1,3
TRBV5-1,TRBJ1-6,CASSLTDRRGSPLHF,3,0,1,3
TRBV5-1,TRBJ2-5,CASSSSSGGGETQYF,3,0,1,3
TRBV5-1,TRBJ2-3,CASSSGQYSTDTQYF,3,0,1,3
TRBV5-1,TRBJ2-4,CASSWAAGAKNIQYF,3,0,1,3
TRBV10-2,TRBJ1-2,CASSYRGEGLYGYTF,3,0,1,3
TRBV5-1,TRBJ1-6,CASSYGQWRDSPLHF,3,0,1,3
TRBV5-1,TRBJ2-5,CASSLGLAVQETQYF,3,0,1,3
TRBV5-1,TRBJ2-6,CASSPGVAGANVLTF,3,0,1,3
TRBV5-1,TRBJ2-1,CASSPGQGYHNEQFF,3,0,1,3
TRBV5-1,TRBJ2-3,CASSRADRETDTQYF,3,0,1,3
TRBV5-1,TRBJ2-3,CASSQGDGSTDTQYF,3,0,1,3
TRBV4-1,TRBJ2-1,CASSQSAPSANEQFF,3,0,1,3
TRBV4-1,TRBJ1-5,CASSQVFISNQPQHF,3,0,1,3
TRBV4-1,TRBJ1-5,CASSQGGQGNQPQHF,3,0,1,3
TRBV4-1,TRBJ1-4,CASSQDPGGWAKLFF,3,0,1,3
TRBV4-1,TRBJ1-5,CASSQDRGSNQPQHF,3,0,1,3
TRBV4-1,TRBJ2-7,CASSQEGQGTYEQYF,3,0,1,3
TRBV5-1,TRBJ2-3,CASSTGTPTTDTQYF,3,0,1,3
TRBV5-1,TRBJ2-5,CASSTGVNIEETQYF,3,0,1,3
TRBV5-1,TRBJ1-6,CASSRIGQGNSPLHF,3,0,1,3
TRBV5-1,TRBJ1-1,CASSKGQGRSPEAFF,3,0,1,3
TRBV5-1,TRBJ2-2,CASRAVLSLTGELFF,3,0,1,3
TRBV5-1,TRBJ2-1,CASRERTGLYNEQFF,3,0,1,3
TRBV20-1,TRBJ1-1,CSAPDPGEGATEAFF,3,0,1,3
TRBV20-1,TRBJ2-5,CSAGVENRDFGTQYF,3,0,1,3
TRBV20-1,TRBJ2-1,CSADLTGGPYNEQFF,3,0,1,3
TRBV20-1,TRBJ2-1,CSASLWGRSYNEQFF,3,0,1,3
TRBV20-1,TRBJ2-2,CSASPLIANTGELFF,3,0,1,3
TRBV20-1,TRBJ1-6,CSASGTGVNNSPLHL,3,0,1,3
TRBV20-1,TRBJ2-1,CSARGLAGYNNEQFF,3,0,1,3
TRBV20-1,TRBJ2-2,CSARKGGRVDGELFF,3,0,1,3
TRBV20-1,TRBJ2-1,CSAFSGQGAGDEQFF,3,0,1,3
TRBV20-1,TRBJ1-1,CSGEGGGISNTEAFF,3,0,1,3
TRBV29-1,TRBJ2-2,CSVGQPGQGTGELFF,3,0,1,3
TRBV29-1,TRBJ2-7,CSVEWVGTGSHEQYF,3,0,1,3
TRBV29-1,TRBJ2-1,CSAESVTSSYNEQFF,3,0,1,3
TRBV5-5,TRBJ2-1,GASSLFLAVYNEQFF,3,0,1,3
TRBV7-4,TRBJ2-6,GASSLAPSGANVLTF,3,0,1,3
TRBV19,TRBJ1-1,CASEDSRGDTEAFF,3,0,1,3
TRBV30,TRBJ2-7,CAWASGGGSYEQYF,3,0,1,3
TRBV30,TRBJ1-3,CAWMAASSGNTIYF,3,0,1,3
TRBV30,TRBJ1-5,CAWSPGGSNQPQHF,3,0,1,3
TRBV30,TRBJ1-4,CAWSRGPGGEKLFF,3,0,1,3
TRBV30,TRBJ2-3,CAWSVRGVGDTQYF,3,0,1,3
TRBV30,TRBJ2-5,CAWSARGFRGTQYF,3,0,1,3
TRBV30,TRBJ2-1,CAWSEMDRDNEQFF,3,0,1,3
TRBV30,TRBJ2-2,CAWKRLAITGELFF,3,0,1,3
TRBV30,TRBJ2-3,CAWKRGQGLDTQYF,3,0,1,3
TRBV2,TRBJ2-1,CAGPPGSSYNEQFF,3,0,1,3
TRBV10-3,TRBJ2-7,CAISAIGSVYEQYF,3,0,1,3
TRBV10-3,TRBJ2-7,CAISELGGPYEQYF,3,0,1,3
TRBV10-3,TRBJ1-1,CAIRKQGRDTEAFF,3,0,1,3
TRBV24-1,TRBJ2-3,CATSDWLGTDTQYF,3,0,1,3
TRBV15,TRBJ2-7,CATSRGAGSHGQYF,3,0,1,3
TRBV19,TRBJ1-1,CASGQGGADTEAFF,3,0,1,3
TRBV19,TRBJ2-1,CASSSLAGDNEQFF,3,0,1,3
TRBV19,TRBJ1-5,CASSYRDSNQPQHF,3,0,1,3
TRBV19,TRBJ2-7,CASSDGAETYEQYF,3,0,1,3
TRBV19,TRBJ1-1,CASSIGGVYTEAFF,3,0,1,3
TRBV19,TRBJ1-6,CASSSRDRESPLHF,3,0,1,3
TRBV19,TRBJ2-3,CASRAGPSTDTQYF,3,0,1,3
TRBV19,TRBJ2-1,CASRNYGGADEQFF,3,0,1,3
TRBV18,TRBJ2-7,CASSPGTVSYEQYF,3,0,1,3
TRBV18,TRBJ1-5,CASSPWTGDQPQHF,3,0,1,3
TRBV18,TRBJ1-1,CASSPGQGAAEAFF,3,0,1,3
TRBV18,TRBJ2-5,CASSPTGHRETQYS,3,0,1,3
TRBV7-2,TRBJ2-3,CASAPGGPSDTQYF,3,0,1,3
TRBV28,TRBJ2-1,CASGLSGLYNEQFF,3,0,1,3
TRBV18,TRBJ2-3,CASGGPVRTDTQYF,3,0,1,3
TRBV5-6,TRBJ2-3,CASGVGDLTDTQYF,3,0,1,3
TRBV28,TRBJ2-2,CASGDTGGPGSCFF,3,0,1,3
TRBV2,TRBJ2-1,CASDLAGGQGEQFF,3,0,1,3
TRBV27,TRBJ2-2,CASMLTEHTGELFF,3,0,1,3
TRBV12-3/4,TRBJ1-5,CASTQWGSNQPQHF,3,0,1,3
TRBV18,TRBJ2-2,CASTRTSGTGELFF,3,0,1,3
TRBV6-2/3/5/6,TRBJ1-5,CASSFAMQDQPQHF,3,0,1,3
TRBV6-2/3/5/6,TRBJ2-7,CASSFPPTSYEQYF,3,0,1,3
TRBV12-3/4,TRBJ2-3,CASSFVVNTDTQYF,3,6,2,9
TRBV6-2/3/5/6,TRBJ1-6,CASSFGQGVTPLHF,3,0,1,3
TRBV28,TRBJ1-4,CASSLGGSDEKLFF,3,0,1,3
TRBV28,TRBJ1-4,CASSLGGAGEKLFF,3,0,1,3
TRBV12-3/4,TRBJ2-5,CASSLVGPTRAQYF,3,0,1,3
TRBV28,TRBJ1-1,CASSLTVMNTEAFF,3,0,1,3
TRBV6-2/3/5/6,TRBJ2-7,CASSLRQVSYEQYF,3,0,1,3
TRBV28,TRBJ2-7,CASSLNRVMYEQYF,3,0,1,3
TRBV28,TRBJ2-3,CASSSADYTDTQYF,3,0,1,3
TRBV6-2/3/5/6,TRBJ2-5,CASSSWSEQETQYF,3,0,1,3
TRBV27,TRBJ1-3,CASSSDRAGNTIYF,3,0,1,3
TRBV6-2/3/5/6,TRBJ2-2,CASSSRSGTGELFF,3,0,1,3
TRBV6-2/3/5/6,TRBJ2-7,CASSSGTGAYEQYF,3,0,1,3
TRBV2,TRBJ1-2,CASSSGQLGYGYTF,3,0,1,3
TRBV27,TRBJ2-3,CASSWASGTDTQYF,3,0,1,3
TRBV6-2/3/5/6,TRBJ2-1,CASSYSEGYNEQFF,3,0,1,3
TRBV6-2/3/5/6,TRBJ2-1,CASSYSPNRVEQFF,3,0,1,3
TRBV6-2/3/5/6,TRBJ2-7,CASSYSGEGAEQYF,3,0,1,3
TRBV6-2/3/5/6,TRBJ1-1,CASSYSIGGTEAFF,3,0,1,3
TRBV6-2/3/5/6,TRBJ2-7,CASSLRDRSHEQYF,3,0,1,3
TRBV28,TRBJ1-5,CASSLHSSNQPQHF,3,0,1,3
TRBV28,TRBJ1-2,CASSPTGDGYGYTF,3,0,1,3
TRBV2,TRBJ2-5,CASSPRGFEETQYF,3,0,1,3
TRBV12-3/4,TRBJ1-1,CASSPGAGNTEAFF,3,0,1,3
TRBV6-2/3/5/6,TRBJ1-1,CASSRGWTSPEAFF,3,0,1,3
TRBV7-3,TRBJ2-7,CASSRTSGSYEQYF,3,0,1,3
TRBV6-1,TRBJ1-4,CASSQQGSNEKLFF,3,0,1,3
TRBV2,TRBJ2-7,CASSVTGGTYEQYF,3,0,1,3
TRBV2,TRBJ1-1,CASSAFGRETEAFF,3,0,1,3
TRBV6-4,TRBJ1-1,CASSDWTGITEAFF,3,0,1,3
TRBV2,TRBJ2-7,CASSEGRDFDEQYF,3,0,1,3
TRBV2,TRBJ1-2,CASSEFPGMNGYTF,3,0,1,3
TRBV6-1,TRBJ2-7,CASSEWGDNYEQYF,3,0,1,3
TRBV2,TRBJ1-6,CASSEGTGRSPLHF,3,0,1,3
TRBV6-1,TRBJ2-3,CASSERDSTDTQYF,3,0,1,3
TRBV6-2/3/5/6,TRBJ2-7,CASSTPGGTYEQYF,3,0,1,3
TRBV12-3/4,TRBJ1-4,CASSTHGVREKLFF,3,0,1,3
TRBV5-6,TRBJ1-3,CASSTGSSGNTIYF,3,0,1,3
TRBV6-2/3/5/6,TRBJ2-5,CASSRDYLLETQYF,3,0,1,3
TRBV7-9,TRBJ1-6,CASSFAGPRSPLHF,3,0,1,3
TRBV7-9,TRBJ1-2,CASSFDSTNYGYTF,3,0,1,3
TRBV7-2,TRBJ2-7,CASSFLAGSYEQYF,3,0,1,3
TRBV3-1,TRBJ1-1,CASSFPGGTTEAFF,3,0,1,3
TRBV5-6,TRBJ2-1,CASSFQTQSTEQFF,3,0,1,3
TRBV5-6,TRBJ1-1,CASSLVGDATEAFF,3,0,1,3
TRBV5-4,TRBJ2-3,CASSLDRVTDTHYF,3,0,1,3
TRBV7-3,TRBJ2-3,CASSLMGFTDTQYF,3,0,1,3
TRBV7-2,TRBJ2-7,CASSLWTSGGEQYF,3,0,1,3
TRBV7-9,TRBJ2-3,CASSLPGRADTQYF,3,0,1,3
TRBV7-9,TRBJ2-7,CASSLPQGFAEQYF,3,0,1,3
TRBV7-2,TRBJ2-7,CASSLVGGSYEQYF,3,0,1,3
TRBV7-2,TRBJ2-3,CASSLVASTDPQYF,3,0,1,3
TRBV7-2,TRBJ2-7,CASSLVAGPYEQYF,3,0,1,3
TRBV7-6,TRBJ2-7,CASSLGPQSYEQYF,3,0,1,3
TRBV11-3,TRBJ2-5,CASSLGDSERTQYF,3,0,1,3
TRBV7-9,TRBJ1-1,CASSLGDRGNEAFF,3,0,1,3
TRBV7-3,TRBJ2-3,CASSLIGPTDTQYF,3,0,1,3
TRBV7-3,TRBJ1-5,CASSLMAGNQPQHF,3,0,1,3
TRBV7-3,TRBJ2-5,CASSLTGIGETQYF,3,0,1,3
TRBV7-9,TRBJ2-3,CASSSYGTSDTQYF,3,0,1,3
TRBV5-4,TRBJ2-1,CASSSQGGGNEQFF,3,0,1,3
TRBV3-1,TRBJ1-1,CASSSGTVNTEAFF,3,0,1,3
TRBV7-9,TRBJ1-1,CASSSGSYNPEAFF,3,0,1,3
TRBV5-8,TRBJ2-1,CASSSGLLYNEQFF,3,0,1,3
TRBV7-9,TRBJ2-7,CASSSDRGTYEQYF,3,0,1,3
TRBV5-5,TRBJ1-1,CASSSTGVNTEAFF,3,0,1,3
TRBV7-2,TRBJ2-3,CASSWVRSTDTQYF,3,0,1,3
TRBV5-5,TRBJ2-4,CASSWGLAKNIQYF,3,0,1,3
TRBV7-2,TRBJ1-1,CASSLSGTATRAFF,3,0,1,3
TRBV7-2,TRBJ2-7,CASSLGTGNYEQYF,3,0,1,3
TRBV3-1,TRBJ2-7,CASSLGQASYEQYF,3,0,1,3
TRBV12-3/4,TRBJ2-7,CASSLHRDSYEQYF,3,0,1,3
TRBV7-9,TRBJ1-3,CASSPGQGGNTIYF,3,0,1,3
TRBV11-2,TRBJ2-5,CASSPRTGQETQYF,3,0,1,3
TRBV2,TRBJ2-7,CASSPAGSFYEQYF,3,0,1,3
TRBV7-3,TRBJ1-1,CASSPGDRDSEAFF,3,0,1,3
TRBV5-6,TRBJ2-5,CASSPMRGQETQYF,3,0,1,3
TRBV3-1,TRBJ2-5,CASSPTGGWETQYF,3,0,1,3
TRBV3-1,TRBJ2-7,CASSPRTGPYEQYF,3,0,1,3
TRBV27,TRBJ2-6,CASSPTEGANVLTF,3,0,1,3
TRBV11-2,TRBJ1-5,CASSPTSPGQPQHF,3,0,1,3
TRBV7-2,TRBJ1-1,CASSPLLGNTEAFF,3,0,1,3
TRBV7-3,TRBJ1-2,CASSPQGIGFGYTF,3,0,1,3
TRBV5-8,TRBJ1-5,CASSPTDSNQPQHF,3,0,1,3
TRBV7-3,TRBJ1-2,CASSRDRAQSGYTF,3,0,1,3
TRBV6-2/3/5/6,TRBJ2-3,CASSRTSSPDTQYF,3,0,1,3
TRBV28,TRBJ2-4,CASSRNLPRDIQYF,3,0,1,3
TRBV7-2,TRBJ1-5,CASSRQGLYQPQHF,3,0,1,3
TRBV3-1,TRBJ1-1,CASSHGTDGLEAFF,3,0,1,3
TRBV11-1,TRBJ2-2,CASSHRGNTGELFF,3,0,1,3
TRBV7-3,TRBJ2-5,CASSQGRFQETQYF,3,0,1,3
TRBV14,TRBJ1-1,CASSQYRVVTEAFF,3,0,1,3
TRBV16,TRBJ1-6,CASSQPNSNSPLHF,3,0,1,3
TRBV14,TRBJ1-2,CASSQVTGEYGYTF,3,0,1,3
TRBV3-1,TRBJ2-5,CASSQAPLQETQYF,3,0,1,3
TRBV3-1,TRBJ2-7,CASSQGPGAYEQYF,3,0,1,3
TRBV7-3,TRBJ2-3,CASSQGLAADTQYF,3,0,1,3
TRBV3-1,TRBJ2-1,CASSQDVNANEQFF,3,0,1,3
TRBV9,TRBJ2-1,CASSVLRGSNEQFF,3,0,1,3
TRBV9,TRBJ1-6,CASSVLSENSPLHF,3,0,1,3
TRBV9,TRBJ2-1,CASSVDTDYNEQFF,3,0,1,3
TRBV9,TRBJ1-5,CASSVESGSQPQHF,3,0,1,3
TRBV7-9,TRBJ2-5,CASSGSGGKETQYF,3,0,1,3
TRBV5-4,TRBJ2-1,CASSGGQTYNEQFF,3,0,1,3
TRBV7-2,TRBJ2-5,CASSDDISKETQYF,3,0,1,3
TRBV7-6,TRBJ2-3,CASSMGLAADTQYF,3,0,1,3
TRBV7-9,TRBJ2-2,CASSMGLGAGELFF,3,0,1,3
TRBV28,TRBJ2-7,CASSTQARLYEQYF,3,0,1,3
TRBV9,TRBJ1-1,CASSTQGFGTEAFF,3,0,1,3
TRBV6-2/3/5/6,TRBJ2-7,CASRRDRDHYEQYF,3,0,1,3
TRBV2,TRBJ1-5,CASRADIGNQPQHF,3,0,1,3
TRBV7-9,TRBJ2-7,CASREGTGSYEQYF,3,0,1,3
TRBV2,TRBJ2-7,CASRTGAQNYEQYF,3,0,1,3
TRBV6-2/3/5/6,TRBJ2-5,CASRWQGDQETQYF,3,0,1,3
TRBV6-2/3/5/6,TRBJ2-1,CASRVNRGAGEQFF,3,0,1,3
TRBV12-3/4,TRBJ1-1,CASRVTMENTEAFF,3,0,1,3
TRBV6-2/3/5/6,TRBJ2-7,CASRTARGPYEQYF,3,0,1,3
TRBV5-4,TRBJ2-3,CASNQGTHTDTQYF,3,0,1,3
TRBV2,TRBJ2-1,CASNRDLRYNEQFF,3,0,1,3
TRBV19,TRBJ2-7,CARSPWTGGYEQYF,3,0,1,3
TRBV28,TRBJ2-5,CGSNDIRVVETQYF,3,0,1,3
TRBV20-1,TRBJ2-5,CSVPGAGGQETQYF,3,0,1,3
TRBV5-1,TRBJ2-3,CASSPGQITDTQYF,3,0,1,3
TRBV10-2,TRBJ2-7,CASARGTSSYEQYF,3,0,1,3
TRBV5-1,TRBJ2-3,CASTSGQLLDTQYF,3,0,1,3
TRBV5-1,TRBJ2-2,CASSSGQNTGELFF,3,0,1,3
TRBV5-1,TRBJ2-7,CASSSGTGRYEQYF,3,0,1,3
TRBV12-3/4,TRBJ2-5,CASSSTGGQETQYF,3,0,1,3
TRBV5-1,TRBJ1-6,CASSLRETNSPLHF,3,0,1,3
TRBV5-1,TRBJ2-5,CASSLARGQETQYF,3,0,1,3
TRBV5-1,TRBJ2-1,CASSLALRHPEQFF,3,0,1,3
TRBV5-1,TRBJ1-2,CASSLGAAGQGYTF,3,0,1,3
TRBV5-1,TRBJ1-1,CASSLELTNTEAFF,3,0,1,3
TRBV5-1,TRBJ2-5,CASSLETGQETQYF,3,0,1,3
TRBV5-1,TRBJ2-3,CASSLIDNTDTQYF,3,0,1,3
TRBV5-1,TRBJ1-4,CASSSRTGEGKLFF,3,0,1,3
TRBV5-1,TRBJ1-6,CASSSRGGDEPLHF,3,0,1,3
TRBV5-1,TRBJ1-2,CASSSGTGTYGYTF,3,0,1,3
TRBV5-1,TRBJ2-7,CASSWRTGTYEQYF,3,0,1,3
TRBV5-1,TRBJ1-2,CASSYDGMDYGYTF,3,0,1,3
TRBV5-1,TRBJ2-3,CASSLRKSADTQYF,3,0,1,3
TRBV4-1,TRBJ1-1,CASSPRGAGTEAFF,3,0,1,3
TRBV4-1,TRBJ2-1,CASSPRTSYNEQFF,3,0,1,3
TRBV4-1,TRBJ2-7,CASSRVGKSYEQYF,3,0,1,3
TRBV5-1,TRBJ2-1,CASSQRGGYNEQFF,3,0,1,3
TRBV4-1,TRBJ2-7,CASSQAQGDYEQYF,3,0,1,3
TRBV4-1,TRBJ2-4,CASSQVSPIDIQYF,3,0,1,3
TRBV4-1,TRBJ2-3,CASSQETSADTQYF,3,0,1,3
TRBV4-1,TRBJ1-6,CASSQETAGSPLHF,3,0,1,3
TRBV5-1,TRBJ1-1,CASSTDAGVTEAFF,3,0,1,3
TRBV5-1,TRBJ1-1,CASSRQGEDTEAFF,3,0,1,3
TRBV5-1,TRBJ2-2,CASRYTSGPGELFF,3,0,1,3
TRBV5-1,TRBJ2-1,CASNAGNSYNEQFF,3,0,1,3
TRBV10-2,TRBJ2-3,CASKGTPSTDTQHF,3,0,1,3
TRBV29-1,TRBJ2-3,CTVATSGVVDTQYF,3,0,1,3
TRBV29-1,TRBJ2-7,CSVEIVGNPYEQYF,3,4,2,7
TRBV20-1,TRBJ1-4,CSASRVARGGKLFF,3,0,1,3
TRBV20-1,TRBJ2-7,CSAISPPGLYEQYF,3,0,1,3
TRBV20-1,TRBJ2-3,CSATGQGGSDTQYF,3,0,1,3
TRBV20-1,TRBJ2-7,CSASSNAYSYEQYF,3,0,1,3
TRBV20-1,TRBJ2-1,CSASRAGSNNEQLF,3,0,1,3
TRBV20-1,TRBJ1-4,CSASVGAGTEKLFF,3,0,1,3
TRBV20-1,TRBJ2-1,CSARTSEGANEQFF,3,0,1,3
TRBV20-1,TRBJ1-6,CSARQTGNNSPLHF,3,0,1,3
TRBV20-1,TRBJ1-1,CSARARRANTEAFF,3,0,1,3
TRBV20-1,TRBJ1-1,CSARGTGGDTEAFF,3,0,1,3
TRBV20-1,TRBJ1-2,CSARDTGGDYGYTF,3,0,1,3
TRBV20-1,TRBJ1-1,CSAREEVVGTEAFF,3,0,1,3
TRBV20-1,TRBJ2-7,CSAPRDRSSREQYF,3,0,1,3
TRBV20-1,TRBJ1-5,CSAARGGGNQPQHL,3,0,1,3
TRBV20-1,TRBJ2-5,CSAKAGVRQETQYF,3,0,1,3
TRBV20-1,TRBJ2-3,CSAAGQGGTDTQYF,3,0,1,3
TRBV29-1,TRBJ2-3,CSSRTGMGTDTQYF,3,0,1,3
TRBV29-1,TRBJ2-7,CSVARGGLSYEQYF,3,0,1,3
TRBV29-1,TRBJ2-2,CSVAGSGRTGELFF,3,0,1,3
TRBV29-1,TRBJ2-7,CSVGQDRGLYEQYF,3,0,1,3
TRBV29-1,TRBJ2-1,CSVGGLAGLGEQFF,3,0,1,3
TRBV29-1,TRBJ2-5,CSVEGRTPSETQYF,3,0,1,3
TRBV29-1,TRBJ2-1,CSVEAQGARNEQFF,3,0,1,3
TRBV29-1,TRBJ2-3,CSVRGTLATDTQYF,3,0,1,3
TRBV29-1,TRBJ2-5,CSVKGGVIQETQYF,3,0,1,3
TRBV29-1,TRBJ2-5,CSVKTGALGETQYF,3,0,1,3
TRBV29-1,TRBJ2-2,CSVSRQGGTGELLF,3,0,1,3
TRBV29-1,TRBJ2-7,CSVTTTGSPYEQYF,3,0,1,3
TRBV29-1,TRBJ2-2,CSVPGQGAAGELFF,3,0,1,3
TRBV29-1,TRBJ2-2,CSAGSGGATGELFL,3,0,1,3
TRBV29-1,TRBJ2-5,CSADWTGNQETQYF,3,0,1,3
TRBV29-1,TRBJ2-1,CSAEQDSGVNEQFF,3,0,1,3
TRBV29-1,TRBJ2-5,CSGKPGGASQTQYF,3,0,1,3
TRBV29-1,TRBJ2-3,CSTTSGDGTDTQYF,3,0,1,3
TRBV29-1,TRBJ1-2,RSVEVGQGNYGYTF,3,0,1,3
TRBV30,TRBJ1-2,CAWGSGGDYGYTF,3,0,1,3
TRBV30,TRBJ2-7,CAWGTGTRNEQYF,3,0,1,3
TRBV30,TRBJ1-1,CAWIPRESTEAFF,3,0,1,3
TRBV30,TRBJ2-7,CAWSVNEAYEQYF,3,0,1,3
TRBV30,TRBJ1-5,CAWSLREDQPQHF,3,0,1,3
TRBV30,TRBJ1-1,CAWRGQGRTEAFF,3,0,1,3
TRBV30,TRBJ2-2,CAWRLQRAGELFF,3,0,1,3
TRBV30,TRBJ1-5,CAWNAGGSQPQHF,3,0,1,3
TRBV30,TRBJ2-2,CAERGGLTGELFF,3,0,1,3
TRBV3-1,TRBJ2-5,CATASRGGETQYF,3,0,1,3
TRBV24-1,TRBJ2-3,CATSVRGSDTQYF,3,0,1,3
TRBV28,TRBJ1-1,CATYSGQNTEAFF,3,0,1,3
TRBV27,TRBJ2-5,CATRQGAHETQYF,3,0,1,3
TRBV2,TRBJ1-1,CASLQGAVTEAFF,3,0,1,3
TRBV19,TRBJ2-4,CASSIGPIDIQYF,3,0,1,3
TRBV19,TRBJ1-5,CASSIWSNQPQHF,3,0,1,3
TRBV19,TRBJ2-5,CASSTDREETQYF,3,0,1,3
TRBV19,TRBJ2-2,CASSSAVTGGLFF,3,0,1,3
TRBV19,TRBJ2-7,CASSIQGTYEQYF,3,0,1,3
TRBV18,TRBJ2-5,CASSPYTEETQYF,3,0,1,3
TRBV18,TRBJ2-3,CASSPIYTDTQYF,3,0,1,3
TRBV18,TRBJ1-5,CASSPNSGQPQHF,3,0,1,3
TRBV2,TRBJ2-2,CASSVASTGELFF,3,0,1,3
TRBV18,TRBJ1-2,CASPPQGADGYTF,3,0,1,3
TRBV12-3/4,TRBJ2-1,CASRGADYNEQFF,3,0,1,3
TRBV27,TRBJ2-5,CASRTGVGETQYF,3,0,1,3
TRBV6-4,TRBJ1-1,CASAPRGNTEAFF,3,0,1,3
TRBV9,TRBJ2-3,CASARVTTDTQYF,3,0,1,3
TRBV12-3/4,TRBJ2-5,CASGSGQQETQYF,3,0,1,3
TRBV28,TRBJ2-7,CASGDRVLYEQYF,3,0,1,3
TRBV27,TRBJ1-6,CASEGQLNSPLHF,3,0,1,3
TRBV6-2/3/5/6,TRBJ2-5,CASISSGGGTQYF,3,0,1,3
TRBV6-2/3/5/6,TRBJ1-3,CASTRTAGNTIYF,3,0,1,3
TRBV2,TRBJ1-1,CASTNLWGTEAFF,3,0,1,3
TRBV6-2/3/5/6,TRBJ1-1,CASSLGGRTEAFF,3,0,1,3
TRBV6-2/3/5/6,TRBJ1-5,CASSLDPNQPQHF,3,0,1,3
TRBV12-3/4,TRBJ2-2,CASSLREEGELFF,3,0,1,3
TRBV28,TRBJ1-1,CASSLAGARRAFF,3,0,1,3
TRBV12-3/4,TRBJ2-7,CASSLGQGVQQYF,3,0,1,3
TRBV28,TRBJ1-1,CASSLNFQLEAFF,3,0,1,3
TRBV12-3/4,TRBJ1-5,CASSSPGLQPQHF,3,0,1,3
TRBV2,TRBJ1-4,CASSSGSQEKLFL,3,0,1,3
TRBV6-2/3/5/6,TRBJ1-1,CASSYSLNTEAFF,3,0,1,3
TRBV12-3/4,TRBJ2-3,CASSPSGGDTQYF,3,0,1,3
TRBV12-3/4,TRBJ2-7,CASSPTISYEQYF,3,0,1,3
TRBV11-2,TRBJ2-3,CASSVVGTDTQYF,3,0,1,3
TRBV2,TRBJ2-7,CASSAWDRDEQYF,3,0,1,3
TRBV6-4,TRBJ1-1,CASSAYKNTEAFF,3,0,1,3
TRBV6-1,TRBJ1-3,CASSANNGNTIYF,3,0,1,3
TRBV7-9,TRBJ1-2,CASSGGSGYGYTF,3,0,1,3
TRBV6-4,TRBJ1-6,CASSDLPNSPLHF,3,0,1,3
TRBV6-1,TRBJ2-1,CASSEGTSNEQFF,3,0,1,3
TRBV6-1,TRBJ2-1,CASSKDRGNEQFF,3,0,1,3
TRBV7-9,TRBJ2-7,CASSFGRSSEQYF,3,0,1,3
TRBV7-8,TRBJ2-7,CASSFGTSYEQYF,3,0,1,3
TRBV7-9,TRBJ1-1,CASSFGQNTEAFF,3,0,1,3
TRBV5-4,TRBJ1-5,CASSLGRGQPQHF,3,0,1,3
TRBV5-4,TRBJ2-7,CASSLGGFYEQYF,3,0,1,3
TRBV7-3,TRBJ2-1,CASSLEGLAGGNF,3,0,1,3
TRBV7-9,TRBJ2-7,CASSLSLANEQYF,3,0,1,3
TRBV7-6,TRBJ2-3,CASSLVLADTQYF,3,0,1,3
TRBV7-6,TRBJ2-3,CASSLAGSDTQYF,3,0,1,3
TRBV7-6,TRBJ1-5,CASSLGVFQPQHF,3,0,1,3
TRBV5-6,TRBJ2-6,CASSLTGANVLTF,3,0,1,3
TRBV5-4,TRBJ2-3,CASSSLGPDTQYF,3,0,1,3
TRBV7-9,TRBJ2-7,CASSSTRGNEQYF,3,0,1,3
TRBV5-5,TRBJ2-7,CASSWPGADEQYF,3,0,1,3
TRBV7-3,TRBJ1-1,CASSLLVDTEAFF,3,0,1,3
TRBV7-9,TRBJ1-2,CASSLGTTYGYTF,3,0,1,3
TRBV7-2,TRBJ1-6,CASSLDTNSPLHF,3,0,1,3
TRBV9,TRBJ2-5,CASSPGPGETQYF,3,0,1,3
TRBV5-6,TRBJ2-7,CASSRDRGWEQYF,3,0,1,3
TRBV3-1,TRBJ2-1,CASSHAGFNEQFF,3,0,1,3
TRBV14,TRBJ1-1,CASSQYQNTEAFF,3,0,1,3
TRBV5-6,TRBJ2-7,CASSQRRQREQYF,3,0,1,3
TRBV3-1,TRBJ1-5,CASSQGGNQPQHF,3,0,1,3
TRBV3-1,TRBJ2-7,CASSQTGLDEQYF,3,0,1,3
TRBV9,TRBJ1-5,CASSVSVDQPQHF,3,0,1,3
TRBV6-4,TRBJ2-5,CASSVGAGKTQYF,3,0,1,3
TRBV7-9,TRBJ2-5,CASSADGRGTQYF,3,0,1,3
TRBV3-1,TRBJ1-6,CASSGVSNSPLHF,3,0,1,3
TRBV7-2,TRBJ2-1,CASSMDYYNEQFF,3,0,1,3
TRBV5-6,TRBJ2-4,CASSTGQGMGQYF,3,0,1,3
TRBV7-8,TRBJ2-1,CASSTDRYNEQFF,3,2,2,5
TRBV11-2,TRBJ1-1,CASSKVENTEAFF,3,0,1,3
TRBV28,TRBJ1-2,CASRGDSGNGYTF,3,0,1,3
TRBV7-9,TRBJ1-1,CASRGDRAYEAFF,3,0,1,3
TRBV3-1,TRBJ2-1,CASRGQGLNEQFF,3,0,1,3
TRBV28,TRBJ2-7,CASRDQGPYEQYF,3,0,1,3
TRBV6-4,TRBJ2-6,CASRDSGADVLTF,3,0,1,3
TRBV6-4,TRBJ1-1,CASRDSGNTEAFF,3,0,1,3
TRBV6-2/3/5/6,TRBJ2-1,CASRRTGEDEQFF,3,0,1,3
TRBV6-2/3/5/6,TRBJ2-3,CASRQGGSDTQYF,3,0,1,3
TRBV12-3/4,TRBJ1-5,CASRQGGHQPQHF,3,0,1,3
TRBV7-2,TRBJ2-1,CASRAVGVNEQFF,3,0,1,3
TRBV6-2/3/5/6,TRBJ1-2,CASNTGGGYGYTF,3,0,1,3
TRBV7-3,TRBJ1-1,CASNPRGDTEAFF,3,0,1,3
TRBV7-9,TRBJ2-1,CASNVGRNNEQFF,3,0,1,3
TRBV28,TRBJ2-1,CASNGALVDEQFS,3,0,1,3
TRBV7-9,TRBJ2-3,CASKGPSKDTQYF,3,0,1,3
TRBV12-3/4,TRBJ2-5,CGTAGTGKETQYF,3,0,1,3
TRBV29-1,TRBJ1-1,CCAREGARPEAFF,3,0,1,3
TRBV5-1,TRBJ1-5,CASSLEVNQPQHF,3,0,1,3
TRBV5-1,TRBJ1-1,CASSSQGNTEAFF,3,0,1,3
TRBV10-1,TRBJ2-5,CASSHPQAETQYF,3,0,1,3
TRBV4-1,TRBJ2-7,CASSQVLEYEQYF,3,0,1,3
TRBV5-1,TRBJ2-3,CASSAIRTDTQYF,3,0,1,3
TRBV4-1,TRBJ1-2,CASSGQGGYGYTF,3,0,1,3
TRBV5-1,TRBJ1-2,CASSMDRVGGYTF,3,0,1,3
TRBV5-1,TRBJ2-3,CASREPPADTQYF,3,0,1,3
TRBV10-1,TRBJ1-1,CASRTGRNTEAFF,3,0,1,3
TRBV29-1,TRBJ2-5,CGLRGGGLETQYF,3,0,1,3
TRBV20-1,TRBJ1-1,CSASKSGYTEAFF,3,0,1,3
TRBV20-1,TRBJ1-2,CSAGTGYNYGYTF,3,0,1,3
TRBV20-1,TRBJ1-5,CSAEGQSNQPQHF,3,2,2,5
TRBV20-1,TRBJ2-5,CSATDIVAETQYF,3,0,1,3
TRBV20-1,TRBJ2-7,CSASPISSYEQYF,3,0,1,3
TRBV20-1,TRBJ1-1,CSASRAANTEAFF,3,0,1,3
TRBV20-1,TRBJ2-5,CSARDGGRETQYF,3,0,1,3
TRBV20-1,TRBJ1-5,CSARDRGQQPQHF,3,0,1,3
TRBV20-1,TRBJ2-1,CSARRPGDYEQFF,3,0,1,3
TRBV20-1,TRBJ2-3,CSALQGTTDTQYF,3,0,1,3
TRBV20-1,TRBJ2-5,CSACPGAVETQYF,3,0,1,3
TRBV20-1,TRBJ2-5,CSATYRVSETQYF,3,0,1,3
TRBV29-1,TRBJ1-1,CSSEERADTEAFF,3,0,1,3
TRBV29-1,TRBJ1-1,CSLGGPMNTEAFF,3,0,1,3
TRBV29-1,TRBJ2-3,CSVRGTSTDTQYF,3,0,1,3
TRBV29-1,TRBJ2-5,CSVAPTGGETQYF,3,0,1,3
TRBV29-1,TRBJ2-7,CSVARQGTNEQYF,3,0,1,3
TRBV29-1,TRBJ1-2,CSVATVSGRGYTF,3,0,1,3
TRBV29-1,TRBJ1-1,CSVASQGETEAFF,3,0,1,3
TRBV29-1,TRBJ1-5,CSVAGDSNQPQHF,3,0,1,3
TRBV29-1,TRBJ2-7,CSVGAIETYEQYF,3,0,1,3
TRBV29-1,TRBJ1-2,CSVDVRQELGYTF,3,0,1,3
TRBV29-1,TRBJ1-4,CSVEITPGEKLFF,3,0,1,3
TRBV29-1,TRBJ2-1,CSVESMAYNEQFF,3,0,1,3
TRBV29-1,TRBJ2-7,CSVEVASAYEQYF,3,0,1,3
TRBV29-1,TRBJ1-5,CSVEEGANQPQHF,3,0,1,3
TRBV29-1,TRBJ1-5,CSVRTESNQPQHF,3,0,1,3
TRBV29-1,TRBJ2-7,CSVGLPGDGEQYF,3,0,1,3
TRBV29-1,TRBJ1-1,CSVERTGATEAFF,3,0,1,3
TRBV29-1,TRBJ2-3,CSVAITATDTQYF,3,0,1,3
TRBV29-1,TRBJ2-3,CSAGGGPGDTQYF,3,0,1,3
TRBV29-1,TRBJ2-1,CSARGAPYDEQFF,3,0,1,3
TRBV29-1,TRBJ1-1,CSAQNSLKTEAFF,3,0,1,3
TRBV29-1,TRBJ2-7,CSGGTSGAGEQYF,3,0,1,3
TRBV29-1,TRBJ2-2,CSGYLSEAGELFF,3,0,1,3
TRBV20-1,TRBJ2-3,CSSLGPNTDTQYF,3,0,1,3
TRBV28,TRBJ1-2,SASSYTGVYGYTF,3,0,1,3
TRBV30,TRBJ2-5,CASASGAETQYF,3,0,1,3
TRBV30,TRBJ2-5,CACQRDQETQYF,3,0,1,3
TRBV30,TRBJ1-2,CAWSAWNYGYTF,3,0,1,3
TRBV30,TRBJ1-1,CAWSRRGAEAFF,3,0,1,3
TRBV30,TRBJ1-2,CAWNQGNYGYTF,3,0,1,3
TRBV10-3,TRBJ2-3,CAIMDSTDTQYF,3,0,1,3
TRBV10-3,TRBJ1-4,CAISDKGEKLFF,3,0,1,3
TRBV28,TRBJ2-7,CASGVVSYEQYF,3,0,1,3
TRBV28,TRBJ1-6,CASSPGRSPLHF,3,0,1,3
TRBV18,TRBJ2-3,CASSMYLDTQYF,3,0,1,3
TRBV28,TRBJ2-7,CASAGDAYEQYF,3,0,1,3
TRBV7-9,TRBJ1-5,CASGTDNQPQHF,3,0,1,3
TRBV12-3/4,TRBJ2-7,CASTGETYEQYF,3,0,1,3
TRBV28,TRBJ2-3,CASSLRTDTQYF,3,0,1,3
TRBV28,TRBJ1-5,CASSLGNQPQHF,3,0,1,3
TRBV12-3/4,TRBJ2-3,CASSLTGDTQYF,3,0,1,3
TRBV6-2/3/5/6,TRBJ1-5,CASSLEVQPQHF,3,0,1,3
TRBV12-3/4,TRBJ1-1,CASSLMNTEAFF,3,0,1,3
TRBV6-2/3/5/6,TRBJ2-7,CASSSSRYEQYF,3,0,1,3
TRBV6-2/3/5/6,TRBJ2-3,CASSSSTDTQYF,3,0,1,3
TRBV27,TRBJ2-3,CASSSQSDTQYF,3,0,1,3
TRBV6-2/3/5/6,TRBJ2-7,CASSYPDGEQYF,3,0,1,3
TRBV27,TRBJ2-7,CASSPRPYEQYF,3,0,1,3
TRBV5-6,TRBJ2-1,CASSPDSNEQFF,3,0,1,3
TRBV6-2/3/5/6,TRBJ1-2,CASSQGRGGYTF,3,0,1,3
TRBV6-1,TRBJ1-2,CASSQLDRVDTF,3,0,1,3
TRBV6-1,TRBJ2-3,CASSGGEDTQYF,3,0,1,3
TRBV12-3/4,TRBJ1-1,CASSDGPHEAFF,3,0,1,3
TRBV2,TRBJ2-2,CASSELTGELFF,3,0,1,3
TRBV2,TRBJ2-5,CASSEGGETQYF,3,5,2,8
TRBV25-1,TRBJ2-3,CASSEGLPTQYI,3,0,1,3
TRBV6-1,TRBJ2-5,CASSETSGTQYF,3,0,1,3
TRBV9,TRBJ2-3,CASSTGTEAQYF,3,0,1,3
TRBV5-6,TRBJ2-7,CASSLLGYEQYF,3,0,1,3
TRBV7-3,TRBJ2-1,CASSLIRNEQLF,3,0,1,3
TRBV7-2,TRBJ1-2,CASSLMGLGYTF,3,0,1,3
TRBV5-6,TRBJ2-7,CASSLTIGEQYF,3,0,1,3
TRBV28,TRBJ2-1,CASSSWEFEQFF,3,0,1,3
TRBV5-4,TRBJ1-2,CASSSLDTRSTF,3,0,1,3
TRBV7-6,TRBJ2-3,CASSSSLGTQYF,3,0,1,3
TRBV5-4,TRBJ1-2,CASSWTGGGYTF,3,0,1,3
TRBV5-6,TRBJ2-7,CASSPGTYEQYF,3,0,1,3
TRBV3-1,TRBJ1-5,CASSRDSQPQHF,3,0,1,3
TRBV3-1,TRBJ2-2,CASSHTSGELFF,3,0,1,3
TRBV7-2,TRBJ2-1,CASSHGSNEQFF,3,0,1,3
TRBV3-1,TRBJ2-7,CASSHNSYEQYF,3,0,1,3
TRBV3-1,TRBJ2-5,CASSQLGETQYF,3,0,1,3
TRBV4-2,TRBJ2-5,CASSQETETQYF,3,0,1,3
TRBV3-1,TRBJ2-7,CASSQNLREQYF,3,0,1,3
TRBV9,TRBJ1-4,CASSGGGGKLFF,3,0,1,3
TRBV5-6,TRBJ2-7,CASSEGQSEQYF,3,0,1,3
TRBV12-3/4,TRBJ1-5,CASSNSLGPQHF,3,0,1,3
TRBV28,TRBJ1-6,CASRAPQSPLHF,3,0,1,3
TRBV28,TRBJ2-3,CASRGLADTQYF,3,0,1,3
TRBV6-2/3/5/6,TRBJ2-7,CASRTGGYEQYF,3,0,1,3
TRBV28,TRBJ1-4,CASRTGNEKLFF,3,0,1,3
TRBV6-2/3/5/6,TRBJ1-1,CASRQGDGEAFF,3,11,2,14
TRBV27,TRBJ2-7,CASNSHSYEQYF,3,0,1,3
TRBV2,TRBJ1-1,CASNPWAAEAFF,3,0,1,3
TRBV2,TRBJ1-2,CASNRADYGYTF,3,0,1,3
TRBV5-1,TRBJ1-1,CASRGDNTEAFF,3,0,1,3
TRBV5-1,TRBJ2-7,CASSFGGYEQYF,3,0,1,3
TRBV5-1,TRBJ2-3,CASSLLVDMQYF,3,0,1,3
TRBV5-1,TRBJ2-1,CASSLGYSEQFF,3,0,1,3
TRBV5-1,TRBJ1-1,CASSLDGTEAFF,3,0,1,3
TRBV20-1,TRBJ2-7,CSVERGDLEQYF,3,0,1,3
TRBV20-1,TRBJ1-5,CSASGQQGPQHF,3,0,1,3
TRBV20-1,TRBJ1-2,CSAAGSGYGYTF,3,0,1,3
TRBV20-1,TRBJ2-3,CSASLNTDTQYF,3,0,1,3
TRBV20-1,TRBJ1-5,CSASGGGQPQHF,3,0,1,3
TRBV20-1,TRBJ1-5,CSASVPLGPQHF,3,0,1,3
TRBV20-1,TRBJ1-1,CSARPKNTEAFF,3,0,1,3
TRBV20-1,TRBJ2-1,CSARQALGEQFF,3,5,2,8
TRBV20-1,TRBJ1-1,CSADRGNTEAFF,3,0,1,3
TRBV29-1,TRBJ1-2,CSVVLVFPGYTF,3,0,1,3
TRBV29-1,TRBJ2-7,CSVVDGSYEQYF,3,0,1,3
TRBV29-1,TRBJ1-2,CSVVTGYYGYTF,3,0,1,3
TRBV29-1,TRBJ2-7,CSVGGTVSEQYF,3,0,1,3
TRBV29-1,TRBJ1-1,CSVEAHDVKAFF,3,0,1,3
TRBV29-1,TRBJ1-3,CSVEDVGNTIYF,3,0,1,3
TRBV29-1,TRBJ1-1,CSVDREGTEAFF,3,0,1,3
TRBV29-1,TRBJ2-1,CSAGHQGNEQFF,3,0,1,3
TRBV29-1,TRBJ1-5,CSAGGGSQPQHF,3,0,1,3
TRBV29-1,TRBJ2-7,CSGYRVPHEQYF,3,0,1,3
TRBV3-1,TRBJ1-5,WASSQGGRHKNF,3,0,1,3
TRBV10-3,TRBJ2-7,CASADPYEQYF,3,0,1,3
TRBV30,TRBJ2-5,CAWGQQETQYF,3,0,1,3
TRBV30,TRBJ2-7,CAWSVQEEQYF,3,0,1,3
TRBV30,TRBJ1-2,CAWSVGVGYTF,3,0,1,3
TRBV30,TRBJ1-1,CARQKNTEAFF,3,0,1,3
TRBV10-3,TRBJ2-5,CAISERETQYF,3,0,1,3
TRBV15,TRBJ2-1,CATPLLLALFF,3,0,1,3
TRBV7-8,TRBJ1-1,CATATAAEAFF,3,0,1,3
TRBV19,TRBJ1-1,CASSDRWAAFF,3,0,1,3
TRBV19,TRBJ1-1,CASSIRIEAFF,3,0,1,3
TRBV28,TRBJ2-5,CASIKRETQYL,3,0,1,3
TRBV2,TRBJ2-7,CASTPGYEQYF,3,0,1,3
TRBV6-2/3/5/6,TRBJ2-1,CASSFHNEQFF,3,0,1,3
TRBV28,TRBJ1-1,CASSLNREAFF,3,0,1,3
TRBV2,TRBJ1-1,CASSRRTEAFF,3,0,1,3
TRBV5-6,TRBJ2-1,CASSFISEQFF,3,0,1,3
TRBV5-4,TRBJ2-1,CASSLYNEQFF,3,0,1,3
TRBV7-9,TRBJ2-7,CASSLEGEQYF,3,0,1,3
TRBV7-9,TRBJ2-7,CASSLRDMTYF,3,0,1,3
TRBV4-2,TRBJ2-1,CASSQDGGSHF,3,0,1,3
TRBV3-1,TRBJ2-7,CASSQEYEQYF,3,0,1,3
TRBV12-3/4,TRBJ2-5,CASSTKETQYF,3,0,1,3
TRBV3-1,TRBJ2-5,CASSSQETQYF,3,0,1,3
TRBV28,TRBJ2-3,CASSRTDTQYF,3,0,1,3
TRBV7-6,TRBJ2-7,CASKGWGEQYF,3,0,1,3
TRBV4-1,TRBJ1-4,CASSGMVGLFF,3,0,1,3
TRBV29-1,TRBJ1-1,CSVVAHTEAFF,3,0,1,3
TRBV29-1,TRBJ1-2,CSVAWIYGYTF,3,0,1,3
TRBV29-1,TRBJ2-3,CSVGPTDTQYF,3,0,1,3
TRBV29-1,TRBJ1-2,CSVEKGSGYTF,3,0,1,3
TRBV29-1,TRBJ2-7,CSAAESYEQYF,3,0,1,3
TRBV29-1,TRBJ2-7,CSAIIDNKQYF,3,0,1,3
TRBV29-1,TRBJ2-3,CSAGDPDTQYF,3,0,1,3
TRBV29-1,TRBJ1-2,CSAGQTYGYTF,3,0,1,3
TRBV29-1,TRBJ2-1,CSARGGGLQFF,3,0,1,3
TRBV6-2/3/5/6,TRBJ2-7,CASSPCEQYF,3,0,1,3
TRBV10-1,TRBJ2-7,CASSEFEQYF,3,0,1,3
TRBV27,TRBJ1-5,CASSFHSAEGTGGPTKGQPQHF,2,0,1,2
TRBV10-3,TRBJ2-1,CAISESIWILSSGGRLDEQFF,2,0,1,2
TRBV15,TRBJ1-1,CATSRDPPFQGAMKDGTEAFF,2,0,1,2
TRBV11-2,TRBJ2-3,CASSLDFSLGLAGIHTDTQYF,2,0,1,2
TRBV5-1,TRBJ2-6,CASSLANAPALSDSGANVLTF,2,0,1,2
TRBV6-2/3/5/6,TRBJ2-5,CASTFTRSDGRGLGGETQYF,2,0,1,2
TRBV5-5,TRBJ1-4,CASSLTPNLIQGDQPEKLFS,2,0,1,2
TRBV7-8,TRBJ2-6,CASSPRPRTGRISGANVLTF,2,0,1,2
TRBV7-9,TRBJ2-7,CASSGEEAREGTDSSYEQYF,2,0,1,2
TRBV15,TRBJ2-7,CATSRDGLTGGWKVYEQYF,2,0,1,2
TRBV19,TRBJ2-1,CASSSLEVGTGDSYNEQFF,2,0,1,2
TRBV6-1,TRBJ1-3,CASSARDRLPLDSGNTVYF,2,0,1,2
TRBV11-2,TRBJ2-1,CASSFPGTSGGAHRHEQFF,2,0,1,2
TRBV5-5,TRBJ1-5,CASSLGVGTGFYSNQPQLF,2,0,1,2
TRBV11-2,TRBJ2-7,CASSLTSGGYFRSSYEQYF,2,0,1,2
TRBV7-9,TRBJ2-1,CASSLVHKRGDYMSDEQFF,2,0,1,2
TRBV7-3,TRBJ1-1,CASSPTEQNVGPTNTEAFF,2,0,1,2
TRBV6-2/3/5/6,TRBJ2-6,CASSHIRGDYHSGANVLTF,2,0,1,2
TRBV4-2,TRBJ2-2,CASSQDRSRTGGRTGELFF,2,0,1,2
TRBV10-1,TRBJ2-7,CASSGDPGLAVFGTNEQCF,2,0,1,2
TRBV4-1,TRBJ2-4,CASSQEGRSGAGAKNTQYF,2,0,1,2
TRBV20-1,TRBJ1-5,CSATNYRDRGTYSNQPQHF,2,0,1,2
TRBV10-3,TRBJ2-3,CAISYGQGGGGSTDTQYF,2,0,1,2
TRBV19,TRBJ2-7,CASSSAGAKSPDSYEQYF,2,0,1,2
TRBV19,TRBJ2-2,CASSIPTSGGARPGVLFF,2,0,1,2
TRBV19,TRBJ2-2,CASKVHAGRVTNTGELFL,2,0,1,2
TRBV11-2,TRBJ2-3,CASSITSGVSTSTDTQYF,2,0,1,2
TRBV11-2,TRBJ2-4,CASTPFNDPKIAKNIQYF,2,0,1,2
TRBV28,TRBJ2-5,CASSLFGRTSGGRETQYF,2,0,1,2
TRBV6-2/3/5/6,TRBJ2-3,CASSSGLAGGPGTDTQYF,2,0,1,2
TRBV5-5,TRBJ2-5,CASSYYRDRVILQETQYF,2,0,1,2
TRBV28,TRBJ1-1,CASSPLIPYSALATEAFF,2,0,1,2
TRBV2,TRBJ1-4,CASSEVARGSGTNEKLFF,2,0,1,2
TRBV11-3,TRBJ2-1,CASSLVYSRGRVSNEQFF,2,0,1,2
TRBV7-9,TRBJ2-3,CASSLALTSGPSTDTQYF,2,0,1,2
TRBV7-6,TRBJ1-6,CASSLGFRDTTYNSPLHF,2,0,1,2
TRBV11-2,TRBJ2-3,CASSLDLGFGPATDTQYF,2,0,1,2
TRBV5-5,TRBJ1-5,CASSPGRNRYLGNQPQHF,2,0,1,2
TRBV7-9,TRBJ1-1,CASSPRYGEELMNTKAFF,2,0,1,2
TRBV5-4,TRBJ2-1,CASSPTSGGGRSINEQFF,2,0,1,2
TRBV7-3,TRBJ2-6,CASSPTVRGPSGANVLTF,2,0,1,2
TRBV9,TRBJ2-3,CASSPLGGTSEVTDTQYF,2,0,1,2
TRBV4-2,TRBJ2-2,CASSQFLAGGLYTGELFF,2,0,1,2
TRBV4-2,TRBJ1-4,CASSQVEFRGLANEKLFF,2,0,1,2
TRBV14,TRBJ2-1,CASSQEIGAGATYNEQFS,2,0,1,2
TRBV7-9,TRBJ2-5,CASSATSGTGVFRETQYF,2,0,1,2
TRBV9,TRBJ2-7,CASSEGTSGGGASYEQYF,2,0,1,2
TRBV12-3/4,TRBJ2-5,CASSLALASGGVGQTQYF,2,0,1,2
TRBV5-1,TRBJ2-2,CASSLDLVAGGLTGELFF,2,0,1,2
TRBV5-1,TRBJ1-6,CASSLEGTGRTYNSPLHF,2,0,1,2
TRBV5-1,TRBJ1-5,CASSPPTGNAGCNQPQHF,2,0,1,2
TRBV4-1,TRBJ1-6,CASSRGGQGLRYNSPLHF,2,0,1,2
TRBV5-1,TRBJ1-2,CASSGVPISGAAADGYTF,2,0,1,2
TRBV20-1,TRBJ2-3,CSAPRYSISFVHTDTQYF,2,2,2,4
TRBV20-1,TRBJ2-7,CSASGWSQRGYASYEQYF,2,0,1,2
TRBV20-1,TRBJ2-1,CSARSGLAGSFPYNEQFF,2,0,1,2
TRBV20-1,TRBJ2-5,CSARAGLAGATYQETQYF,2,0,1,2
TRBV29-1,TRBJ2-1,CSVEGSGGPLWSYNEQFF,2,0,1,2
TRBV10-3,TRBJ2-7,CAISGAGTSGGGYEQYF,2,0,1,2
TRBV10-3,TRBJ1-4,CAISESTLDKQPGKLFF,2,0,1,2
TRBV19,TRBJ2-6,CASSIGQGLSGANVLTF,2,0,1,2
TRBV19,TRBJ1-5,CASSIEVWTGANQPQHF,2,0,1,2
TRBV19,TRBJ1-5,CASSTLTGRGINQPQHF,2,0,1,2
TRBV12-3/4,TRBJ1-6,CASCLAFPGSYNSPLHF,2,0,1,2
TRBV27,TRBJ2-3,CASYHKVSISSTDTQYF,2,0,1,2
TRBV11-2,TRBJ1-3,CASGGTRGGPSGNTIYF,2,0,1,2
TRBV28,TRBJ1-2,CASTKPGTGSINYGYTF,2,0,1,2
TRBV27,TRBJ1-2,CASSLSIGPHTNYGYTF,2,6,2,8
TRBV28,TRBJ1-5,CASSLYTGGRSSQPQHF,2,0,1,2
TRBV6-2/3/5/6,TRBJ2-7,CASSLVGRERRDYELYF,2,0,1,2
TRBV6-2/3/5/6,TRBJ2-3,CASSWITAGELTDTQYF,2,0,1,2
TRBV6-2/3/5/6,TRBJ2-7,CASSPTLPPAGTREQYF,2,0,1,2
TRBV2,TRBJ1-3,CASSDARTIGSGNTIYF,2,0,1,2
TRBV2,TRBJ2-5,CASSERPRTSSLETQYF,2,0,1,2
TRBV6-1,TRBJ1-5,CASSEDWAGTVNQPQHF,2,0,1,2
TRBV5-8,TRBJ2-5,CASSFSFGEGPQETQYF,2,0,1,2
TRBV11-2,TRBJ2-1,CASSFSTSGGKDHEQFF,2,0,1,2
TRBV7-2,TRBJ2-5,CASSFQTSGGFQETQYF,2,0,1,2
TRBV7-9,TRBJ2-1,CASSFTRAVSSYNEQFF,2,0,1,2
TRBV5-6,TRBJ2-4,CASSLVGTSGTKNIQYF,2,0,1,2
TRBV5-6,TRBJ1-5,CASSLNLGTYSNQPQHF,2,0,1,2
TRBV5-6,TRBJ2-2,CASSLLYSVPNTGELFS,2,0,1,2
TRBV7-9,TRBJ1-5,CASSLPGDLGLQQPQHF,2,0,1,2
TRBV7-9,TRBJ2-7,CASSLGGGRGPLYEQYF,2,0,1,2
TRBV7-8,TRBJ2-1,CASSLDVVGGRNIEQFF,2,0,1,2
TRBV7-3,TRBJ2-2,CASSLTSGGGVAGELFF,2,0,1,2
TRBV7-9,TRBJ2-3,CASSSAPGLTQGDTQYF,2,0,1,2
TRBV28,TRBJ2-3,CASSSGTSGGATDTQYF,2,0,1,2
TRBV3-1,TRBJ1-6,CASSLSGGTGVNSPLHF,2,0,1,2
TRBV7-9,TRBJ2-3,CASSLGGSGSSTDTQYF,2,0,1,2
TRBV7-2,TRBJ2-1,CASSPQPLAGANLGQFF,2,0,1,2
TRBV3-1,TRBJ2-5,CASSPFVVAGVLETQYF,2,0,1,2
TRBV7-3,TRBJ2-3,CASSPWGSETRTDTQYF,2,0,1,2
TRBV6-2/3/5/6,TRBJ2-6,CASSPGTGISGANVLTF,2,0,1,2
TRBV7-2,TRBJ1-6,CASSPIGGHQTNSPLHF,2,0,1,2
TRBV5-4,TRBJ2-3,CASSPTTGAGGTDTQYF,2,0,1,2
TRBV7-3,TRBJ2-2,CASSPSVEGTMAGELFF,2,0,1,2
TRBV7-9,TRBJ1-2,CASSPWDTQGANYGYTF,2,0,1,2
TRBV11-1,TRBJ1-1,CASSPRSTRGIGTEAFF,2,0,1,2
TRBV7-8,TRBJ2-3,CASSRGMISRSTDTQYS,2,0,1,2
TRBV5-6,TRBJ2-1,CASSRERGSSSYNEQFF,2,0,1,2
TRBV7-9,TRBJ2-6,CASSHRDRGAGANVLTF,2,0,1,2
TRBV4-2,TRBJ1-2,CASSQVSLTAGFNGYTF,2,0,1,2
TRBV3-1,TRBJ2-2,CASSQALARTKAGELFF,2,0,1,2
TRBV4-2,TRBJ2-1,CASSQAVAGGGDNEQFF,2,0,1,2
TRBV3-1,TRBJ2-6,CASSQDLGVAGANVLTF,2,0,1,2
TRBV9,TRBJ1-2,CASSVDGDSLELYGYTF,2,0,1,2
TRBV3-1,TRBJ1-4,CASSAWTGVPTNEKLFF,2,0,1,2
TRBV9,TRBJ1-5,CASSAGGGASSNQPQHF,2,0,1,2
TRBV28,TRBJ1-1,CASRPGTNFRLPTEAFF,2,0,1,2
TRBV5-1,TRBJ1-4,CASSLVVNEGSNEKLFF,2,0,1,2
TRBV5-1,TRBJ1-1,CASSLVGAGLMNTEAFF,2,0,1,2
TRBV5-1,TRBJ2-6,CASSLAAGASGANVLTF,2,0,1,2
TRBV5-1,TRBJ1-6,CASSLATGQGENSPLHF,2,7,2,9
TRBV5-1,TRBJ1-4,CASSLGAGGAGEEKLFF,2,0,1,2
TRBV5-1,TRBJ1-1,CASSLGQGTGGGTEAFF,2,0,1,2
TRBV5-1,TRBJ1-1,CASSLTHRARLNTEAFF,2,0,1,2
TRBV5-1,TRBJ2-6,CASSSDRGLNGANVLTF,2,0,1,2
TRBV5-1,TRBJ1-6,CASSWAMVRDSYSPLHF,2,0,1,2
TRBV4-1,TRBJ2-3,CASSLSPGTPSTDTQYF,2,0,1,2
TRBV4-1,TRBJ2-1,CASSPGLAGPRGNEQFF,2,0,1,2
TRBV5-1,TRBJ1-1,CASSPGEQGMSNTEAFF,2,0,1,2
TRBV4-1,TRBJ1-2,CASSQLPRQDTVGGYTF,2,0,1,2
TRBV4-1,TRBJ2-1,CASSQGPWGGRINEQFY,2,0,1,2
TRBV4-1,TRBJ2-2,CASSQGLLGARTGELFF,2,0,1,2
TRBV4-1,TRBJ1-4,CASSQEVPGPGNEKLFF,2,0,1,2
TRBV5-1,TRBJ2-1,CASRGLAGEPRGNGQFF,2,0,1,2
TRBV20-1,TRBJ2-7,CSARGGGRARMGYEQYF,2,0,1,2
TRBV20-1,TRBJ1-5,CSARDPQQGASNQPQHF,2,4,2,6
TRBV20-1,TRBJ1-5,CSAREGKGSVGNQPQHF,2,0,1,2
TRBV29-1,TRBJ2-3,CSVVVAGTNLYTDTQYF,2,0,1,2
TRBV29-1,TRBJ2-7,CSVEDWRTSGGGYEQYF,2,0,1,2
TRBV29-1,TRBJ2-1,CSVAGAVGSQHYNEQFF,2,0,1,2
TRBV29-1,TRBJ2-3,CSALGLAGGSTTDTQYF,2,0,1,2
TRBV5-6,TRBJ1-6,YAGPGQGCSSYNSPLHF,2,0,1,2
TRBV11-2,TRBJ2-1,CACSPARDPTGDEQFF,2,0,1,2
TRBV30,TRBJ1-1,CAWSSTGIRVNTEAFF,2,0,1,2
TRBV30,TRBJ1-2,CAWSPKQGAIGQGYTF,2,0,1,2
TRBV30,TRBJ1-1,CAWSVHEERGITEAFF,2,0,1,2
TRBV28,TRBJ1-4,CAGSSSGTGIGEKLFF,2,0,1,2
TRBV3-1,TRBJ1-1,CATQPSPGQGSTEAFF,2,0,1,2
TRBV15,TRBJ1-5,CATSREVAYSNQPQHF,2,0,1,2
TRBV15,TRBJ2-5,CATSRAWGGPQETQYF,2,0,1,2
TRBV15,TRBJ2-1,CATSRETGGSYNEQFF,2,3,2,5
TRBV19,TRBJ1-5,CASTRHGASSNQPQHF,2,0,1,2
TRBV19,TRBJ1-5,CASSIIGGIGNQPQHF,2,0,1,2
TRBV19,TRBJ2-3,CASSIPAGPSTDTQYF,2,0,1,2
TRBV19,TRBJ1-6,CASSIRQVWSSSPLHF,2,0,1,2
TRBV19,TRBJ1-1,CASSKIPGQGMVEAFF,2,0,1,2
TRBV19,TRBJ2-3,CASSSPGTGGTDTQYF,2,0,1,2
TRBV18,TRBJ2-3,CASSLGTSGNTDTQYF,2,0,1,2
TRBV18,TRBJ2-7,CASSPSFGTGYYEQYF,2,0,1,2
TRBV18,TRBJ2-1,CASSPGTSGGYNERFF,2,0,1,2
TRBV18,TRBJ2-2,CASSPSPQGSTGELFF,2,0,1,2
TRBV18,TRBJ1-6,CASSPGTGWTNSPLHF,2,0,1,2
TRBV28,TRBJ1-5,CASYGRDRGFNQPQHF,2,0,1,2
TRBV6-2/3/5/6,TRBJ2-6,CASGLPGAPGANVLTF,2,0,1,2
TRBV6-1,TRBJ2-1,CASGVLGGATYNEQFF,2,0,1,2
TRBV3-1,TRBJ1-2,CASGLSGASFSYGYTF,2,0,1,2
TRBV2,TRBJ1-6,CASGDAFRAYNSPLHF,2,0,1,2
TRBV28,TRBJ2-1,CASIDMDGPEGYGQFF,2,0,1,2
TRBV12-3/4,TRBJ1-6,CASSFILGQGGSPLHF,2,0,1,2
TRBV6-2/3/5/6,TRBJ2-7,CASSFFLGGTSYEQYF,2,0,1,2
TRBV28,TRBJ1-4,CASSLYGQGINEKLFF,2,0,1,2
TRBV28,TRBJ2-2,CASSLLDRINTGELFF,2,0,1,2
TRBV12-3/4,TRBJ2-3,CASSLRRAGGTDTQYF,2,0,1,2
TRBV6-2/3/5/6,TRBJ2-1,CASSLGGWTLGNEQFF,2,0,1,2
TRBV27,TRBJ2-7,CASSLNRWTDSAEQYF,2,0,1,2
TRBV12-3/4,TRBJ2-3,CASSSGTSGPTDTQYF,2,0,1,2
TRBV6-2/3/5/6,TRBJ2-5,CASSSFPPAIEETQYF,2,0,1,2
TRBV6-2/3/5/6,TRBJ2-3,CASSYSGGGFPDTQYF,2,0,1,2
TRBV6-2/3/5/6,TRBJ1-2,CASSYSIAGSRYGYTF,2,0,1,2
TRBV6-2/3/5/6,TRBJ2-5,CASSLERGEGQETQYF,2,0,1,2
TRBV27,TRBJ2-3,CASSPRDLWDVNTQYF,2,0,1,2
TRBV27,TRBJ2-1,CASSPVLTSGANEQFF,2,0,1,2
TRBV6-2/3/5/6,TRBJ2-1,CASSRTSGGPYNEQFF,2,0,1,2
TRBV11-2,TRBJ2-5,CASSQRGEVRGETQYF,2,0,1,2
TRBV11-2,TRBJ2-1,CASSQNLAGGQDEQFL,2,0,1,2
TRBV6-1,TRBJ2-4,CASSQLAGLAKNIQYF,2,0,1,2
TRBV12-3/4,TRBJ2-1,CASSGLSGGAANEQFF,2,0,1,2
TRBV6-1,TRBJ1-5,CASSGPTGQSNQPQHF,2,2,2,4
TRBV2,TRBJ1-6,CASSERGPGANSPLYF,2,0,1,2
TRBV6-1,TRBJ2-5,CASSEVAGGYQETQYF,2,0,1,2
TRBV2,TRBJ2-7,CASSERYTSEPYEQYF,2,0,1,2
TRBV6-2/3/5/6,TRBJ2-7,CASSMVAGTPTYEQYF,2,0,1,2
TRBV6-1,TRBJ2-2,CASSRTGTRNTGELFF,2,0,1,2
TRBV11-2,TRBJ1-6,CASSFGPKLYNSPLHF,2,0,1,2
TRBV5-5,TRBJ1-4,CASSLGNSLVNEKPFF,2,0,1,2
TRBV5-4,TRBJ2-2,CASSLGQGVLTGELFF,2,0,1,2
TRBV5-6,TRBJ2-3,CASSLRRGGTTDTQYF,2,0,1,2
TRBV7-9,TRBJ1-1,CASSLLAGGKNTEAFF,2,0,1,2
TRBV7-9,TRBJ2-1,CASSLLRDSATDEQFF,2,0,1,2
TRBV13,TRBJ2-1,CASSLWAGPKRNEQFF,2,0,1,2
TRBV7-9,TRBJ2-3,CASSLWDYRNTDTQYF,2,0,1,2
TRBV7-9,TRBJ1-6,CASSLPSGTVGSPLHF,2,0,1,2
TRBV7-6,TRBJ1-3,CASSLVRGLGGNTIYF,2,0,1,2
TRBV7-9,TRBJ2-3,CASSLVLGGSTDTQYF,2,0,1,2
TRBV7-9,TRBJ2-1,CASSLVSRLPYNEQFF,2,0,1,2
TRBV7-9,TRBJ1-4,CASSLARRGRNEKLFF,2,0,1,2
TRBV7-2,TRBJ1-1,CASSLAGLRRNTEAFF,2,0,1,2
TRBV7-2,TRBJ2-1,CASSLARGGTVNEQFF,2,0,1,2
TRBV7-2,TRBJ1-2,CASSLAGPFLMDGYTF,2,0,1,2
TRBV7-2,TRBJ2-3,CASSLGGRGFTDTQYF,2,0,1,2
TRBV7-2,TRBJ2-5,CASSLGGLPRQETQYF,2,0,1,2
TRBV7-9,TRBJ2-1,CASSLGRYRSYNEKFS,2,0,1,2
TRBV7-8,TRBJ1-5,CASSLGQEYSNQPQHF,2,0,1,2
TRBV7-2,TRBJ1-5,CASSLDQGAIYQPQHF,2,0,1,2
TRBV11-2,TRBJ1-1,CASSLDSIGGMTEAFF,2,0,1,2
TRBV7-3,TRBJ2-1,CASSLTTGGGYNEQFF,2,0,1,2
TRBV11-2,TRBJ2-1,CASSSLRGSSYNEQFF,2,6,2,8
TRBV7-2,TRBJ2-2,CASSSLGNRGRRELFF,2,0,1,2
TRBV7-9,TRBJ2-1,CASSSSLSGGYNEQFF,2,0,1,2
TRBV7-9,TRBJ2-7,CASSSLITGKGGEQYF,2,0,1,2
TRBV11-2,TRBJ2-5,CASSSGTSEEVETQCF,2,0,1,2
TRBV7-2,TRBJ2-3,CASSSGLAGNTDTQYF,2,0,1,2
TRBV12-3/4,TRBJ1-1,CASSYKWTEYNTEAFF,2,0,1,2
TRBV9,TRBJ2-1,CASSLGQGAPYNEQFF,2,0,1,2
TRBV7-6,TRBJ2-5,CASSLSSGGVEETQYF,2,0,1,2
TRBV12-3/4,TRBJ1-3,CASSLYGAPRGNAIYF,2,0,1,2
TRBV7-2,TRBJ2-5,CASSLRLAGGQETQYF,2,0,1,2
TRBV3-1,TRBJ2-5,CASSPFGTSNQETQYF,2,0,1,2
TRBV3-1,TRBJ2-7,CASSPHWTSGVYEQYF,2,0,1,2
TRBV9,TRBJ2-3,CASSPQLRGGPDTQYF,2,0,1,2
TRBV6-2/3/5/6,TRBJ1-5,CASSPGAFYSNQPQHF,2,0,1,2
TRBV11-2,TRBJ2-1,CASSPSGGWDYNEQFF,2,0,1,2
TRBV5-8,TRBJ2-1,CASSPWTSGAYNEQFF,2,0,1,2
TRBV11-2,TRBJ2-7,CASSPYGDRGYYEQYF,2,0,1,2
TRBV7-9,TRBJ2-3,CASSPGWDRSTDTQYF,2,0,1,2
TRBV7-3,TRBJ2-5,CASSPGTSGVTETQYF,2,0,1,2
TRBV7-2,TRBJ2-1,CASSPTAPGSYNEQFF,2,0,1,2
TRBV7-2,TRBJ2-1,CASSPGRGGEYNEQFF,2,0,1,2
TRBV11-2,TRBJ1-4,CASSRGGAGDNEKLFF,2,0,1,2
TRBV3-1,TRBJ2-3,CASSRNSGLPTDTQYF,2,0,1,2
TRBV28,TRBJ2-3,CASSQTSGGTTDTQYF,2,0,1,2
TRBV4-2,TRBJ2-5,CASSQVGGQPSETQYF,2,0,1,2
TRBV3-1,TRBJ2-1,CASSQAGTGDYNEQFF,2,0,1,2
TRBV14,TRBJ2-3,CASSQGPQGILDTQYF,2,0,1,2
TRBV14,TRBJ2-4,CASSQGVLLAKNIQYF,2,0,1,2
TRBV3-1,TRBJ2-5,CASSQGGSGGKETQYF,2,0,1,2
TRBV9,TRBJ2-7,CASSVGVRTGLGEQYF,2,0,1,2
TRBV5-4,TRBJ1-5,CASSVGGGSGRQPQHF,2,0,1,2
TRBV11-2,TRBJ2-3,CASSAWAGGGSDTQHF,2,0,1,2
TRBV7-9,TRBJ2-6,CASSAVGRTGANVLTF,2,0,1,2
TRBV6-2/3/5/6,TRBJ2-7,CASSAKLLAHHYEQYF,2,0,1,2
TRBV2,TRBJ1-2,CASSGLIQGANYGYTF,2,0,1,2
TRBV9,TRBJ2-4,CASSEDTRLAKNIQYF,2,4,2,6
TRBV7-2,TRBJ2-7,CASSTRTGGRSYEQYF,2,0,1,2
TRBV11-2,TRBJ1-3,CASSTGGGLSGNTIYF,2,0,1,2
TRBV12-3/4,TRBJ2-7,CASSRKLDRSFNERYF,2,0,1,2
TRBV5-4,TRBJ2-2,CASRAGQGADTGELFF,2,0,1,2
TRBV20-1,TRBJ2-7,CGARESVGDRPYEQYF,2,0,1,2
TRBV24-1,TRBJ2-1,CTTRTSGGAIIDEQFF,2,0,1,2
TRBV4-1,TRBJ1-6,CAGSRARDTNREPLHF,2,0,1,2
TRBV5-1,TRBJ2-3,CASSNLVGGNTDTQYF,2,0,1,2
TRBV28,TRBJ2-4,CASSLWMGVAKNIQYF,2,0,1,2
TRBV5-1,TRBJ2-2,CASSFKRLDYTGELCF,2,0,1,2
TRBV5-1,TRBJ1-2,CASSLSQVGGNYGYTF,2,0,1,2
TRBV5-1,TRBJ2-1,CASSLLPSGDYNEQFF,2,0,1,2
TRBV5-1,TRBJ2-1,CASSLVGGQGGNEQFF,2,0,1,2
TRBV5-1,TRBJ1-2,CASSLAGNAQVTGYTF,2,0,1,2
TRBV5-1,TRBJ2-3,CASSLAGLARVDTQYF,2,0,1,2
TRBV5-1,TRBJ1-3,CASSLGWGSSGNTICF,2,0,1,2
TRBV5-1,TRBJ1-1,CASSLMLGTGSTEAFF,2,0,1,2
TRBV5-1,TRBJ2-2,CASSLLAGGPTGELFF,2,0,1,2
TRBV5-1,TRBJ1-5,CASSSPDSYSNQPQHI,2,0,1,2
TRBV5-1,TRBJ2-3,CASSSGGLQAIGTQYF,2,0,1,2
TRBV5-1,TRBJ2-2,CASSSSPGLNTGELFF,2,0,1,2
TRBV5-1,TRBJ1-6,CASSLGGGIGLSPLHF,2,0,1,2
TRBV5-1,TRBJ1-6,CASSLTTDAYNSPLHF,2,0,1,2
TRBV5-1,TRBJ2-1,CASSLRTDGSYNEQFF,2,0,1,2
TRBV4-1,TRBJ1-3,CASSLKGQISGNTIYF,2,0,1,2
TRBV5-1,TRBJ2-7,CASSLDGGGSAREQYF,2,0,1,2
TRBV4-1,TRBJ2-1,CASSLERGSSYNEQFF,2,0,1,2
TRBV4-1,TRBJ2-5,CASSPSPSRGGETQYF,2,0,1,2
TRBV5-1,TRBJ2-1,CASSPRPGGVYNEQFF,2,0,1,2
TRBV5-1,TRBJ2-3,CASSPQPSWDTDTQYF,2,0,1,2
TRBV4-1,TRBJ1-1,CASSRQSDRGPTEAFF,2,0,1,2
TRBV5-1,TRBJ2-1,CASSRTGGTGRNEQFF,2,0,1,2
TRBV4-1,TRBJ1-5,CASSRRQNPSNQPQHF,2,0,1,2
TRBV5-1,TRBJ1-6,CASSRIPGQDNSPLHF,2,0,1,2
TRBV5-1,TRBJ2-5,CASSQDAAGGEETQYF,2,0,1,2
TRBV4-1,TRBJ2-1,CASSQGRGGLYNEQFF,2,0,1,2
TRBV4-1,TRBJ1-5,CASSQDGEFSNQPQHF,2,0,1,2
TRBV4-1,TRBJ2-7,CASSQKISGDPYEQYF,2,0,1,2
TRBV5-1,TRBJ1-4,CASSRGNRGANEKLFF,2,0,1,2
TRBV5-1,TRBJ2-5,CASKPLWTGEVETQYF,2,0,1,2
TRBV20-1,TRBJ2-1,CGASLAGGRDYNEQFF,2,0,1,2
TRBV20-1,TRBJ2-2,CSASRLAGEFTGELFF,2,0,1,2
TRBV20-1,TRBJ2-1,CSARGQAGGVYNEQFF,2,3,2,5
TRBV20-1,TRBJ2-1,CSARDLRTRYSGEQFF,2,0,1,2
TRBV20-1,TRBJ2-1,CSALTGLAGGSDEQFF,2,0,1,2
TRBV20-1,TRBJ2-1,CSAGQSSGGVFNEQFF,2,0,1,2
TRBV29-1,TRBJ1-3,CSVDAGTGVSGNTIYF,2,0,1,2
TRBV29-1,TRBJ2-3,CSVEPPLAGGADTRYF,2,0,1,2
TRBV29-1,TRBJ2-1,CSVEFTTGVIGNEQFF,2,0,1,2
TRBV20-1,TRBJ2-7,CRARDSGGTSFYEQYF,2,0,1,2
TRBV6-2/3/5/6,TRBJ1-4,CVSSKRRAANEKLFF,2,0,1,2
TRBV12-5,TRBJ2-7,CASGSSGTVAYEQYF,2,0,1,2
TRBV7-6,TRBJ2-5,CASSLAAGNIETQYF,2,0,1,2
TRBV7-7,TRBJ2-5,CASSLDRGSLETQYF,2,0,1,2
TRBV7-7,TRBJ2-5,CASSAPDRPQETQYF,2,0,1,2
TRBV7-9,TRBJ2-2,CASEYAGGGTGELFF,2,0,1,2
TRBV30,TRBJ1-6,CAWSVLQEYNSPLHF,2,0,1,2
TRBV30,TRBJ2-5,CAWSGDSGAQETQYF,2,0,1,2
TRBV30,TRBJ2-7,CAWSEGSEGVYEQYF,2,0,1,2
TRBV30,TRBJ1-1,CAWSKPGGMNTEAFF,2,0,1,2
TRBV30,TRBJ1-5,CAWSRRGGGNQPQHF,2,0,1,2
TRBV30,TRBJ1-1,CAWSARQGMNTEAFF,2,0,1,2
TRBV30,TRBJ2-7,CAWRGLAGGSYEQYF,2,0,1,2
TRBV30,TRBJ2-1,CAWNGGVSSYNEQFF,2,0,1,2
TRBV18,TRBJ2-1,CAGSPGLDMRNEQFF,2,0,1,2
TRBV25-1,TRBJ1-2,CAGSDPAGESYGYTF,2,0,1,2
TRBV24-1,TRBJ2-2,CATSGPVWSTGELFF,2,0,1,2
TRBV15,TRBJ2-5,CATSGQTSSVETQYF,2,0,1,2
TRBV15,TRBJ2-2,CATSRTGGITGELFF,2,0,1,2
TRBV15,TRBJ2-5,CATSRLAGGQETQYF,2,0,1,2
TRBV15,TRBJ2-5,CATSRRQGFGETQYF,2,0,1,2
TRBV15,TRBJ2-1,CATSRDPQAYNEQFF,2,0,1,2
TRBV19,TRBJ1-5,CASTPGTGRDQPQHF,2,0,1,2
TRBV5-4,TRBJ2-3,CASTWDRGATDTQYF,2,0,1,2
TRBV19,TRBJ2-2,CASSILTGNTGELFF,2,0,1,2
TRBV19,TRBJ2-2,CASSINPGATGELFF,2,0,1,2
TRBV19,TRBJ2-6,CASSMGGPGANVLTF,2,0,1,2
TRBV19,TRBJ1-1,CASSIEWDLNTEAFF,2,0,1,2
TRBV19,TRBJ1-1,CASSIEASRNTEAFF,2,0,1,2
TRBV19,TRBJ2-7,CASSTSGTGAYEQYF,2,0,1,2
TRBV19,TRBJ1-6,CASSSRIGANSPLHF,2,0,1,2
TRBV19,TRBJ2-2,CASKIPGLVAGELFF,2,0,1,2
TRBV18,TRBJ1-2,CASSPQSREREGYTF,2,0,1,2
TRBV18,TRBJ2-1,CASSPGTGLYNEQFF,2,0,1,2
TRBV18,TRBJ2-1,CASSPGTGGGDEQFF,2,0,1,2
TRBV18,TRBJ2-7,CASSPGTGTFYEQYF,2,0,1,2
TRBV18,TRBJ2-5,CASSPLGTDQETQYF,2,0,1,2
TRBV18,TRBJ1-5,CASSPPARAGQPQHF,2,0,1,2
TRBV18,TRBJ2-3,CASSPAQISTDTQYF,2,0,1,2
TRBV28,TRBJ2-2,CASQGRTGDRAELFF,2,0,1,2
TRBV11-2,TRBJ1-3,CASGLLVGGGNTIYF,2,0,1,2
TRBV11-1,TRBJ2-3,CASGGQGINTDTQYF,2,0,1,2
TRBV12-3/4,TRBJ1-6,CASTLGQGAASPLHF,2,0,1,2
TRBV28,TRBJ2-1,CASTLGGSPENEQFF,2,0,1,2
TRBV6-2/3/5/6,TRBJ1-1,CASTPSTGRNTEAFF,2,0,1,2
TRBV7-2,TRBJ2-3,CASTTRGLAADTQYF,2,0,1,2
TRBV7-6,TRBJ2-3,CASTKWGEGTDTQYF,2,0,1,2
TRBV6-2/3/5/6,TRBJ1-2,CASTPRGGSNYGYTF,2,0,1,2
TRBV28,TRBJ1-1,CASSFPSGRNTEAFF,2,0,1,2
TRBV12-3/4,TRBJ2-7,CASSFGPGKAYEQYF,2,0,1,2
TRBV6-2/3/5/6,TRBJ2-1,CASSFSGPPYNEQFF,2,0,1,2
TRBV28,TRBJ2-1,CASSFGGRASEEQFF,2,0,1,2
TRBV12-3/4,TRBJ2-1,CASSLEGGAFNEQFF,2,0,1,2
TRBV27,TRBJ2-1,CASSLSGEPYNEQFF,2,0,1,2
TRBV28,TRBJ2-3,CASSLWGRATDTQYF,2,0,1,2
TRBV6-2/3/5/6,TRBJ2-7,CASSLYRGGAYEQYF,2,0,1,2
TRBV28,TRBJ2-5,CASSLQTAWKETRYF,2,0,1,2
TRBV6-2/3/5/6,TRBJ2-7,CASSLVGGPADEQYF,2,0,1,2
TRBV6-2/3/5/6,TRBJ1-1,CASSLARRGNTEASF,2,0,1,2
TRBV28,TRBJ2-5,CASSLASRGQETQYF,2,0,1,2
TRBV6-2/3/5/6,TRBJ2-3,CASSLGGGAWDTQYF,2,0,1,2
TRBV28,TRBJ2-7,CASSLGTGTGEGQYF,2,0,1,2
TRBV28,TRBJ1-5,CASSLGGQYNQPQHF,2,0,1,2
TRBV12-3/4,TRBJ2-3,CASSLMGGSTDTQYF,2,0,1,2
TRBV28,TRBJ2-4,CASSSSTGAKNIQYF,2,0,1,2
TRBV28,TRBJ2-3,CASSSYYDSRDTQYF,2,0,1,2
TRBV6-2/3/5/6,TRBJ1-4,CASSSLGQENEKLFF,2,0,1,2
TRBV28,TRBJ1-4,CASSSPGQGNEKLFF,2,0,1,2
TRBV13,TRBJ2-7,CASSSHPRGGYEQYF,2,0,1,2
TRBV28,TRBJ2-1,CASSSQGLGYNEQFF,2,0,1,2
TRBV6-2/3/5/6,TRBJ2-7,CASSSAGTGNYEQYF,2,0,1,2
TRBV27,TRBJ2-1,CASSSRGGTYNEQFF,2,0,1,2
TRBV28,TRBJ1-5,CASSSEGPGGQPQHF,2,3,2,5
TRBV28,TRBJ2-3,CASSSAAILPDTQYF,2,0,1,2
TRBV28,TRBJ2-3,CASSWAGRRGDTQYF,2,0,1,2
TRBV6-2/3/5/6,TRBJ2-7,CASSYYRDPTCEQYF,2,0,1,2
TRBV12-3/4,TRBJ1-5,CASSYLDRPNQPQHF,2,0,1,2
TRBV6-2/3/5/6,TRBJ1-5,CASSYSGDSNQPQHF,2,0,1,2
TRBV6-2/3/5/6,TRBJ2-7,CASSYHGTDSYEQYF,2,0,1,2
TRBV12-3/4,TRBJ2-1,CASSLTSGSYNEQFF,2,0,1,2
TRBV5-5,TRBJ2-3,CASSLKQGYTDTQYF,2,0,1,2
TRBV12-3/4,TRBJ2-3,CASSPPRGLTDTQYF,2,0,1,2
TRBV11-2,TRBJ1-1,CASSPGGGRHTEAFF,2,0,1,2
TRBV12-3/4,TRBJ1-1,CASSPRGEGSTEAFF,2,0,1,2
TRBV6-2/3/5/6,TRBJ2-7,CASSRDTTSSYEQYF,2,0,1,2
TRBV5-4,TRBJ1-2,CASSRELGLAYGYTF,2,0,1,2
TRBV27,TRBJ1-1,CASSRRQGLGTEAFF,2,0,1,2
TRBV28,TRBJ1-2,CASSQYIQDGYGYTF,2,0,1,2
TRBV28,TRBJ1-2,CASSVRQGVGAGYTF,2,0,1,2
TRBV28,TRBJ2-7,CASSASGTGAYEQYF,2,0,1,2
TRBV12-3/4,TRBJ1-5,CASSARASTIKPQHF,2,0,1,2
TRBV2,TRBJ2-7,CASSDRAGASYEQYF,2,0,1,2
TRBV25-1,TRBJ1-5,CASSDGRGDNQPQHF,2,0,1,2
TRBV28,TRBJ2-2,CASSDTRGLTGELFF,2,0,1,2
TRBV10-3,TRBJ2-5,CASSESRGGRETQYF,2,0,1,2
TRBV6-1,TRBJ2-7,CASSERGGSSYEQYF,2,0,1,2
TRBV2,TRBJ2-3,CASSEQGGKTDTQYF,2,0,1,2
TRBV2,TRBJ2-2,CASSEQGVDTGELFF,2,0,1,2
TRBV6-1,TRBJ2-1,CASSEQGGSYNEQFF,2,0,1,2
TRBV2,TRBJ1-4,CASSEGRGRNEKLFF,2,0,1,2
TRBV6-1,TRBJ2-1,CASSEGGPRLNEQFF,2,0,1,2
TRBV28,TRBJ2-2,CASSMMTSPTGELFF,2,0,1,2
TRBV6-2/3/5/6,TRBJ2-7,CASSIRSGGPYEQYF,2,0,1,2
TRBV6-1,TRBJ2-4,CASSKGLAGAGVQYF,2,0,1,2
TRBV12-3/4,TRBJ2-5,CASSKGLGFQETQYF,2,0,1,2
TRBV7-9,TRBJ2-7,CASSFGGGASYEQYF,2,0,1,2
TRBV11-3,TRBJ2-1,CASSFLGTRGNEQFF,2,0,1,2
TRBV5-5,TRBJ1-2,CASSFPDWGKYGYTF,2,0,1,2
TRBV12-3/4,TRBJ2-1,CASSFGTGDYNEQFF,2,0,1,2
TRBV11-2,TRBJ2-5,CASSLVGTQEETQYF,2,0,1,2
TRBV5-4,TRBJ2-5,CASSLGGGATETQYF,2,0,1,2
TRBV5-4,TRBJ2-5,CASSLDQGALETQYF,2,0,1,2
TRBV7-3,TRBJ2-1,CASSLTGGSYNEQFF,2,0,1,2
TRBV5-4,TRBJ2-3,CASSLKRGVIDTQYF,2,0,1,2
TRBV7-9,TRBJ2-1,CASSLSVTSYNEQFF,2,0,1,2
TRBV7-2,TRBJ2-7,CASSLLRDRGSEQYF,2,0,1,2
TRBV7-3,TRBJ2-1,CASSLVRGPYNEQFF,2,0,1,2
TRBV7-2,TRBJ1-5,CASSLVDGDHQPQHF,2,0,1,2
TRBV7-9,TRBJ2-4,CASSLVSGVGNIQYF,2,0,1,2
TRBV11-2,TRBJ2-1,CASSLGDRVIDEQFF,2,0,1,2
TRBV7-2,TRBJ2-7,CASSLGTGDSYEQYF,2,2,2,4
TRBV7-3,TRBJ2-5,CASSLGSQGGRTQYF,2,0,1,2
TRBV7-9,TRBJ1-2,CASSLDWGEAYGYTF,2,0,1,2
TRBV7-9,TRBJ2-3,CASSLEGLDTDTQYF,2,0,1,2
TRBV7-2,TRBJ2-3,CASSLIGTYTDTQYF,2,0,1,2
TRBV7-2,TRBJ2-6,CASSLMVSGANVLTF,2,0,1,2
TRBV7-2,TRBJ2-3,CASSLIWGLANTQYF,2,0,1,2
TRBV7-3,TRBJ2-5,CASSLTPGGLETQYL,2,0,1,2
TRBV11-2,TRBJ2-3,CASSLTLAGGYTQYF,2,0,1,2
TRBV7-9,TRBJ2-3,CASSLRAGGEDTQYF,2,0,1,2
TRBV5-4,TRBJ2-3,CASSLRAGSTDTQYF,2,0,1,2
TRBV7-9,TRBJ2-7,CASSSSGTGSPEQYF,2,0,1,2
TRBV12-3/4,TRBJ1-5,CASSSGQGGNQPQHF,2,0,1,2
TRBV7-3,TRBJ1-1,CASSSSGTPNTEAFF,2,0,1,2
TRBV7-9,TRBJ2-1,CASSSSGASFDEQFF,2,0,1,2
TRBV11-2,TRBJ2-1,CASSSGGLSYNEQFF,2,0,1,2
TRBV9,TRBJ2-1,CASSSGTGGYNEQFF,2,0,1,2
TRBV7-9,TRBJ2-3,CASSSTSGGADTQYF,2,0,1,2
TRBV7-9,TRBJ2-2,CASSSRNVAGGELFF,2,0,1,2
TRBV7-9,TRBJ2-7,CASSSGLAVSYEQYF,2,0,1,2
TRBV7-9,TRBJ1-2,CASSSWDGVGYGYTF,2,0,1,2
TRBV28,TRBJ2-3,CASSSRTGRRDTQYF,2,0,1,2
TRBV7-3,TRBJ2-3,CASSSNGGAVDTQYF,2,0,1,2
TRBV7-6,TRBJ2-3,CASSYGPRYTDTQYF,2,0,1,2
TRBV3-1,TRBJ2-1,CASSLFYLTYNEQFF,2,0,1,2
TRBV11-2,TRBJ2-5,CASSLGTVVGETQYF,2,0,1,2
TRBV7-9,TRBJ2-1,CASSLGLAGRDEQFF,2,0,1,2
TRBV7-2,TRBJ2-2,CASSLGLAGAGELFF,2,0,1,2
TRBV7-2,TRBJ1-4,CASSLNGGANEKLFS,2,0,1,2
TRBV7-8,TRBJ2-3,CASSLPGGGGDTQYF,2,0,1,2
TRBV3-1,TRBJ2-3,CASSLTSGRTDTQYF,2,0,1,2
TRBV11-2,TRBJ2-1,CASSPTSGGANEQFF,2,0,1,2
TRBV7-9,TRBJ2-2,CASSPRAQNTGELFF,2,0,1,2
TRBV7-2,TRBJ2-5,CASSPNPGGKETQYF,2,0,1,2
TRBV11-2,TRBJ2-3,CASSPWTSGTDTQYF,2,6,2,8
TRBV9,TRBJ2-5,CASSPRRDIQETQYF,2,0,1,2
TRBV3-1,TRBJ2-5,CASSPRGASQETQYF,2,0,1,2
TRBV3-1,TRBJ2-7,CASSPRTGGAGEQYF,2,0,1,2
TRBV3-1,TRBJ2-7,CASSPRQGGSYEQYF,2,0,1,2
TRBV14,TRBJ2-1,CASSPHRTRDNEQFF,2,0,1,2
TRBV7-9,TRBJ2-7,CASSPDQRGGYEQYF,2,0,1,2
TRBV7-8,TRBJ1-4,CASSPDGGRAEKLFF,2,0,1,2
TRBV7-9,TRBJ1-2,CASSPDRGQGYGYTF,2,0,1,2
TRBV6-2/3/5/6,TRBJ2-3,CASSPKASGADTQYF,2,0,1,2
TRBV3-1,TRBJ1-4,CASSPPGSEGEKLFF,2,0,1,2
TRBV5-4,TRBJ1-2,CASSPPGQGNYGYTF,2,0,1,2
TRBV7-9,TRBJ2-2,CASSPAGTGSGELVF,2,0,1,2
TRBV7-9,TRBJ2-5,CASSPGPGPKETQYF,2,0,1,2
TRBV13,TRBJ2-7,CASSPTRTATYEQYF,2,0,1,2
TRBV11-1,TRBJ1-1,CASSREGSLNTEAFF,2,0,1,2
TRBV11-3,TRBJ2-1,CASSRSGGTYNEQFF,2,0,1,2
TRBV7-9,TRBJ2-1,CASSRDRVSTNEQFF,2,0,1,2
TRBV7-3,TRBJ2-7,CASSRTDAPYVEQYF,2,0,1,2
TRBV9,TRBJ2-2,CASSRTGDPTGELFF,2,0,1,2
TRBV7-2,TRBJ1-2,CASSQAIQSNYGYTF,2,0,1,2
TRBV4-2,TRBJ1-1,CASSQGRQMNTEAFF,2,0,1,2
TRBV3-1,TRBJ2-7,CASSQGQRPWDEQYF,2,0,1,2
TRBV3-1,TRBJ1-2,CASSQGQGRSDGYTF,2,0,1,2
TRBV7-9,TRBJ2-5,CASSQSTGQETSQYF,2,0,1,2
TRBV4-2,TRBJ1-3,CASSQVRSSGNTIYF,2,0,1,2
TRBV3-1,TRBJ2-5,CASSQVGPVVETQYF,2,0,1,2
TRBV3-1,TRBJ2-3,CASSQGRGSTDTQYF,2,0,1,2
TRBV4-2,TRBJ2-1,CASSQDLGLGNEQFF,2,0,1,2
TRBV3-1,TRBJ2-7,CASSQDPAGPREQYF,2,0,1,2
TRBV3-1,TRBJ2-4,CASSQDVRGVNIQYF,2,0,1,2
TRBV3-1,TRBJ1-1,CASSQEGRMGTEAFF,2,0,1,2
TRBV14,TRBJ2-7,CASSQIPGGAGTQYF,2,0,1,2
TRBV3-1,TRBJ2-1,CASSQSGAGFNEQFF,2,0,1,2
TRBV7-3,TRBJ2-1,CASSVLAGGFNEQFF,2,0,1,2
TRBV9,TRBJ2-3,CASSVVAGLTDTQYF,2,0,1,2
TRBV9,TRBJ1-1,CASSVGPGAEAEAFF,2,0,1,2
TRBV6-2/3/5/6,TRBJ2-1,CASSGELSSYNEQFF,2,0,1,2
TRBV9,TRBJ1-1,CASSEGDRGNTEAFF,2,0,1,2
TRBV11-2,TRBJ2-2,CASSILRGNTGEPFF,2,0,1,2
TRBV7-9,TRBJ1-1,CASSTTRFMNTEAFF,2,0,1,2
TRBV7-3,TRBJ1-6,CASSTLGGGSSPLHF,2,0,1,2
TRBV6-4,TRBJ2-3,CASSNSGQASDTQYF,2,0,1,2
TRBV7-9,TRBJ1-4,CASRLRDNPSEKLFF,2,0,1,2
TRBV7-6,TRBJ2-1,CASRRTSGGGNEQFF,2,0,1,2
TRBV12-3/4,TRBJ2-2,CASRQDRLNTGELFF,2,0,1,2
TRBV6-2/3/5/6,TRBJ2-3,CASRGLAGEGGTQYF,2,0,1,2
TRBV6-2/3/5/6,TRBJ2-4,CASRDSGAGKNIQYF,2,0,1,2
TRBV28,TRBJ1-5,CASRPRGRDNQPQHF,2,0,1,2
TRBV6-2/3/5/6,TRBJ2-6,CASRRVASGANVLTF,2,0,1,2
TRBV7-2,TRBJ1-3,CASRRNPGTGNTIYF,2,0,1,2
TRBV7-9,TRBJ2-1,CASRHWELAYNEQFF,2,0,1,2
TRBV7-9,TRBJ1-1,CASRGYRDRGPKAFF,2,0,1,2
TRBV6-2/3/5/6,TRBJ1-5,CASRGGISWAQPQHF,2,0,1,2
TRBV5-5,TRBJ2-1,CASRIAGLANNEQFF,2,0,1,2
TRBV28,TRBJ2-4,CASRITGATGNIQYF,2,0,1,2
TRBV6-2/3/5/6,TRBJ2-3,CASRNIAGGTDTRYF,2,0,1,2
TRBV2,TRBJ2-2,CASKIRQGSTGELFF,2,0,1,2
TRBV5-1,TRBJ2-1,CATTGLGNSYNEQFF,2,0,1,2
TRBV10-1,TRBJ2-2,CASGRDRGLAGELFF,2,0,1,2
TRBV5-1,TRBJ2-3,CASSGTVSYTDTQYF,2,0,1,2
TRBV5-1,TRBJ1-1,CASSSDGRTNTEAFF,2,0,1,2
TRBV4-1,TRBJ2-7,CASSPGGARTYEQYF,2,0,1,2
TRBV4-1,TRBJ2-1,CASSQRTGSHNEQFF,2,0,1,2
TRBV10-1,TRBJ2-5,CASSASSDNQETQYF,2,0,1,2
TRBV10-2,TRBJ1-5,CASSGTDRGYQPQHF,2,0,1,2
TRBV4-1,TRBJ2-7,CASSFGQGEGYEQYF,2,0,1,2
TRBV5-1,TRBJ2-5,CASSFDGALGETQYF,2,0,1,2
TRBV5-1,TRBJ2-1,CASSLLPGGHNEQFF,2,0,1,2
TRBV5-1,TRBJ2-7,CASSLQGQGSYEQYF,2,0,1,2
TRBV5-1,TRBJ2-2,CASSLADPYTGELFF,2,0,1,2
TRBV5-1,TRBJ2-3,CASSLAVEWTDTQYF,2,0,1,2
TRBV5-1,TRBJ2-1,CASSLAASSYNEQFF,2,0,1,2
TRBV5-1,TRBJ2-1,CASSLAGLVGNEQFF,2,0,1,2
TRBV5-1,TRBJ1-6,CASSLDPTYNSPLHF,2,0,1,2
TRBV5-1,TRBJ1-1,CASSLEVREGTEAFF,2,0,1,2
TRBV5-1,TRBJ1-3,CASSLEGVPGNTIYF,2,0,1,2
TRBV5-1,TRBJ2-1,CASSLSGGPYNEQFF,2,0,1,2
TRBV5-1,TRBJ1-4,CASSLSGSTNEKLFF,2,0,1,2
TRBV5-1,TRBJ2-7,CASSLTKTGIDEQYF,2,0,1,2
TRBV7-2,TRBJ2-7,CASSLSSPLAYEQYF,2,0,1,2
TRBV5-1,TRBJ1-1,CASSSLQEAGTEAFF,2,0,1,2
TRBV5-1,TRBJ2-5,CASSSGTSLLETQYF,2,0,1,2
TRBV5-1,TRBJ1-5,CASSSTGTADQPQHF,2,0,1,2
TRBV4-1,TRBJ2-7,CASSLDPGPILMQYF,2,0,1,2
TRBV5-1,TRBJ2-7,CASSLGTGGSYEQYF,2,0,1,2
TRBV5-1,TRBJ1-1,CASSLGGRGGTEAFF,2,0,1,2
TRBV5-1,TRBJ2-3,CASSPSSGPTDTQYF,2,0,1,2
TRBV5-1,TRBJ2-1,CASSPPVGSYNEQFF,2,0,1,2
TRBV4-3,TRBJ2-1,CASSPLAGGPEEQFF,2,0,1,2
TRBV4-1,TRBJ1-2,CASSPGTGNNWGYTF,2,0,1,2
TRBV4-1,TRBJ1-1,CASSQGDRMNTEAFF,2,0,1,2
TRBV4-1,TRBJ2-4,CASSQPTGLGNIQYF,2,0,1,2
TRBV4-1,TRBJ2-3,CASSQASASTDTQYF,2,0,1,2
TRBV4-1,TRBJ2-7,CASSQAYAQSYEQYF,2,0,1,2
TRBV4-1,TRBJ1-4,CASSQADRDNEKLFF,2,0,1,2
TRBV4-1,TRBJ2-7,CASSQGRGTSYEQYF,2,0,1,2
TRBV4-1,TRBJ2-1,CASSQGGTAYNEQFF,2,0,1,2
TRBV4-1,TRBJ2-7,CASSQTGGILYEQYF,2,0,1,2
TRBV5-1,TRBJ1-4,CASSAGQGTNGKLFF,2,0,1,2
TRBV5-1,TRBJ1-2,CASSGRRGSSYGYTF,2,0,1,2
TRBV5-1,TRBJ2-2,CASSIKKPDTGELFF,2,0,1,2
TRBV10-2,TRBJ2-3,CASSTGLAGPDTQYF,2,0,1,2
TRBV5-1,TRBJ2-7,CASRLVMGETYEQYF,2,0,1,2
TRBV5-1,TRBJ1-4,CASRVRDRGYEKLFF,2,0,1,2
TRBV4-1,TRBJ2-6,CASKQEGWGANVLTF,2,0,1,2
TRBV20-1,TRBJ2-5,CSASPYRAGQETQYF,2,0,1,2
TRBV20-1,TRBJ2-1,CSASLAGGRSNEQFF,2,0,1,2
TRBV20-1,TRBJ2-1,CSARVGAFFGNEQFF,2,0,1,2
TRBV20-1,TRBJ2-7,CSARSSSGGSYEQYF,2,0,1,2
TRBV20-1,TRBJ2-1,CSARRPPVAYNEQFF,2,0,1,2
TRBV20-1,TRBJ2-7,CSARQRGSGISEQYF,2,0,1,2
TRBV20-1,TRBJ1-5,CSARAPTVNNQPQHF,2,0,1,2
TRBV20-1,TRBJ1-5,CSARAGTDSNQPQHF,2,0,1,2
TRBV20-1,TRBJ1-5,CSARAPTVSNQPQHF,2,0,1,2
TRBV20-1,TRBJ2-3,CSARGLRGRTDTQYF,2,0,1,2
TRBV20-1,TRBJ2-1,CSARGTSGGANEQFF,2,0,1,2
TRBV20-1,TRBJ2-1,CSARDGRQLVNEQFF,2,0,1,2
TRBV20-1,TRBJ2-5,CSAWSAGRSQETQYF,2,0,1,2
TRBV29-1,TRBJ2-1,CSFMGLAGGPFEQFF,2,0,1,2
TRBV29-1,TRBJ2-7,CSVEGIWGQEYEQYF,2,0,1,2
TRBV29-1,TRBJ2-2,CSAQSQTERTGELFF,2,0,1,2
TRBV3-1,TRBJ2-3,WASSQNWSPQDTQYF,2,0,1,2
TRBV28,TRBJ1-1,RASSSPGLLSTEAFF,2,0,1,2
TRBV30,TRBJ1-4,CACARGGEAEKLFF,2,0,1,2
TRBV30,TRBJ2-3,CAWEQGMSTDTQYF,2,0,1,2
TRBV30,TRBJ2-7,CAWSWWQGPYEQYF,2,0,1,2
TRBV30,TRBJ1-1,CAWSVLRQNTEAFF,2,0,1,2
TRBV30,TRBJ2-4,CAWSVPGSKNIQYF,2,0,1,2
TRBV30,TRBJ2-3,CAWSMGLITDTQYF,2,0,1,2
TRBV30,TRBJ1-5,CAWNPGTINQPQHF,2,0,1,2
TRBV9,TRBJ2-3,CAGSGRGSTDTQYS,2,0,1,2
TRBV2,TRBJ2-5,CAISVVRSQETQYF,2,0,1,2
TRBV10-3,TRBJ2-5,CAISGGSRQETQYF,2,0,1,2
TRBV10-3,TRBJ2-1,CAISGTPDYNEQFF,2,0,1,2
TRBV10-3,TRBJ2-5,CAISGSRNQETQYF,2,0,1,2
TRBV10-3,TRBJ2-4,CAISEDRDKNIQYF,2,0,1,2
TRBV7-9,TRBJ1-1,CAITGGAGNTEAFF,2,0,1,2
TRBV15,TRBJ2-3,CATSGHRDADTQYF,2,0,1,2
TRBV15,TRBJ1-1,CATSGGAPNTEAFF,2,0,1,2
TRBV15,TRBJ2-5,CATSSRGGQETQYF,2,0,1,2
TRBV15,TRBJ1-5,CATSRGSANGPQHF,2,0,1,2
TRBV15,TRBJ2-1,CATSREQGDNEQFF,2,0,1,2
TRBV15,TRBJ2-3,CATSREGSSDTQYF,2,0,1,2
TRBV19,TRBJ2-3,CATKELVSTDTQYF,2,0,1,2
TRBV12-3/4,TRBJ1-1,CASSRSEMNTEAFF,2,0,1,2
TRBV12-3/4,TRBJ1-5,CASRSVASNQPQHF,2,0,1,2
TRBV19,TRBJ2-2,CASVGQGVTGELFF,2,0,1,2
TRBV19,TRBJ2-4,CASSIMWAKNIQNF,2,0,1,2
TRBV19,TRBJ1-5,CASSITGSNQPQHF,2,0,1,2
TRBV19,TRBJ1-2,CASRPTGANYGYTF,2,0,1,2
TRBV19,TRBJ1-2,CASRPRRSNYGYTF,2,0,1,2
TRBV18,TRBJ2-7,CASSPPSGAYEQYF,2,0,1,2
TRBV18,TRBJ1-1,CASSAGVGFTEAFF,2,0,1,2
TRBV18,TRBJ1-6,CASSSNLSNSPLHF,2,0,1,2
TRBV18,TRBJ2-1,CASSPSLASNEQFF,2,0,1,2
TRBV18,TRBJ2-5,CASSPLVREKTQYF,2,0,1,2
TRBV18,TRBJ2-3,CASSAWGATDTQYF,2,0,1,2
TRBV28,TRBJ2-5,CASQDLLRGETQYF,2,0,1,2
TRBV7-9,TRBJ2-5,CASGELGRLETQYF,2,0,1,2
TRBV5-1,TRBJ2-7,CASGTSGGPYEQYF,2,3,2,5
TRBV28,TRBJ2-5,CASGGRGAGETQYF,2,0,1,2
TRBV7-2,TRBJ1-2,CASISSGRYYGYTF,2,0,1,2
TRBV7-9,TRBJ2-6,CASTWGSGANVLTF,2,0,1,2
TRBV28,TRBJ1-1,CASTPGVQNTEAFF,2,0,1,2
TRBV2,TRBJ2-3,CASTRGLAPDTQYF,2,8,2,10
TRBV12-3/4,TRBJ2-3,CASTQDYNTDTQYF,2,0,1,2
TRBV28,TRBJ1-5,CASSFAGRVKPQHF,2,0,1,2
TRBV6-2/3/5/6,TRBJ2-7,CASSFISPTYEQYF,2,0,1,2
TRBV12-3/4,TRBJ2-7,CASSFREKVYEQYF,2,0,1,2
TRBV12-3/4,TRBJ1-1,CASSFGQQPIEAFF,2,0,1,2
TRBV12-3/4,TRBJ2-2,CASSLSGGAGELFF,2,0,1,2
TRBV12-3/4,TRBJ2-7,CASSLFQGAGEQYF,2,0,1,2
TRBV27,TRBJ1-5,CASSLFGFNQPQHF,2,0,1,2
TRBV27,TRBJ2-7,CASSLSAIPYEQYF,2,0,1,2
TRBV12-3/4,TRBJ1-1,CASSLSAGYTEAFF,2,0,1,2
TRBV28,TRBJ1-1,CASSLYRRDAEAFF,2,0,1,2
TRBV27,TRBJ2-1,CASSLLGRSDEQFF,2,0,1,2
TRBV12-3/4,TRBJ2-1,CASSLLALYNEQFF,2,4,2,6
TRBV12-3/4,TRBJ2-7,CASSLRDTLYEQYF,2,0,1,2
TRBV28,TRBJ1-1,CASSLGQGWTEAFF,2,0,1,2
TRBV12-3/4,TRBJ1-5,CASSLGDSNQPQHF,2,0,1,2
TRBV28,TRBJ1-6,CASSSYSYNSPLHF,2,0,1,2
TRBV6-2/3/5/6,TRBJ1-1,CASSSYRVVAEAFF,2,0,1,2
TRBV28,TRBJ1-5,CASSSHSEAQPQHF,2,0,1,2
TRBV28,TRBJ2-5,CASSSGSVVETQYF,2,0,1,2
TRBV28,TRBJ1-2,CASSWAGGNYGYTF,2,0,1,2
TRBV6-2/3/5/6,TRBJ1-2,CASSYSPRSYGYTF,2,0,1,2
TRBV6-2/3/5/6,TRBJ1-1,CASSYPQWGAEAFF,2,0,1,2
TRBV6-2/3/5/6,TRBJ2-6,CASSYVSGANVLTF,2,0,1,2
TRBV6-2/3/5/6,TRBJ1-4,CASSYARANEKLFF,2,0,1,2
TRBV6-2/3/5/6,TRBJ2-3,CASSYGGYTDTQYF,2,0,1,2
TRBV6-2/3/5/6,TRBJ1-6,CASSYEGPYSPLHF,2,0,1,2
TRBV12-3/4,TRBJ1-5,CASSLPGSHQPQHF,2,0,1,2
TRBV28,TRBJ2-5,CASSPAGGQETQYF,2,0,1,2
TRBV6-2/3/5/6,TRBJ2-3,CASSPTGGWDTQYF,2,0,1,2
TRBV11-2,TRBJ2-3,CASSRGGFTDTQYF,2,0,1,2
TRBV7-3,TRBJ2-3,CASSHGGGTDTQYF,2,0,1,2
TRBV2,TRBJ2-1,CASSVTRSGYEQFF,2,0,1,2
TRBV2,TRBJ1-5,CASSVDRDPQPQHL,2,0,1,2
TRBV12-3/4,TRBJ1-5,CASSAGELTQPQHF,2,0,1,2
TRBV28,TRBJ1-5,CASSGGQRNQPQHF,2,0,1,2
TRBV28,TRBJ2-7,CASSGTGSSYEQYF,2,0,1,2
TRBV6-1,TRBJ2-5,CASSDVGSQETQYF,2,0,1,2
TRBV6-1,TRBJ1-5,CASSDGLGNQPQHF,2,0,1,2
TRBV12-3/4,TRBJ1-6,CASSDGGNNSPLHF,2,0,1,2
TRBV6-1,TRBJ1-2,CASSEVTTNYGYTI,2,0,1,2
TRBV25-1,TRBJ2-7,CASSELSGNYEQYF,2,0,1,2
TRBV6-1,TRBJ1-1,CASSEEGGDTEAFF,2,0,1,2
TRBV7-9,TRBJ1-2,CASSSRGPGSGYTF,2,0,1,2
TRBV2,TRBJ1-2,CASSRRGFGYGYTF,2,0,1,2
TRBV6-2/3/5/6,TRBJ2-1,CASSFFTGDNEQFF,2,0,1,2
TRBV11-2,TRBJ1-5,CASSFLGSGQPQHF,2,0,1,2
TRBV7-6,TRBJ1-5,CASSFGGRNQPQHF,2,0,1,2
TRBV5-4,TRBJ1-1,CASSFSLGNTEAFF,2,0,1,2
TRBV7-9,TRBJ2-3,CASSFVGPTDAQYF,2,0,1,2
TRBV7-2,TRBJ1-5,CASSFAREGQPQHF,2,0,1,2
TRBV7-8,TRBJ2-7,CASSFGTGGNEQYF,2,0,1,2
TRBV11-1,TRBJ2-2,CASSFGTGTGELFF,2,0,1,2
TRBV5-6,TRBJ1-2,CASSFGQAQGGYTF,2,0,1,2
TRBV5-4,TRBJ1-1,CASSFTGGRTEAFF,2,0,1,2
TRBV5-4,TRBJ2-1,CASSLSGHYNEQFF,2,0,1,2
TRBV5-5,TRBJ1-1,CASSLWGENPEAFF,2,0,1,2
TRBV11-2,TRBJ2-2,CASSLLQAPGELFF,2,0,1,2
TRBV5-6,TRBJ2-4,CASSLPGGDGIQYF,2,0,1,2
TRBV11-2,TRBJ1-6,CASSLGQGNSPLHF,2,0,1,2
TRBV7-3,TRBJ2-1,CASSLTSGGNEQFF,2,0,1,2
TRBV7-9,TRBJ2-1,CASSLLSAYNEQFF,2,0,1,2
TRBV7-2,TRBJ2-3,CASSLPLGVGTQYF,2,0,1,2
TRBV5-5,TRBJ1-1,CASSLRDVDTEAFF,2,0,1,2
TRBV7-9,TRBJ1-3,CASSLQRSGNTIYF,2,0,1,2
TRBV7-9,TRBJ2-3,CASSLAWGRDTQYF,2,0,1,2
TRBV7-2,TRBJ1-2,CASSLARGTSGYTF,2,0,1,2
TRBV7-9,TRBJ1-2,CASSLAGVDYGYTF,2,0,1,2
TRBV7-8,TRBJ2-7,CASSLGYQRYEQYF,2,0,1,2
TRBV7-8,TRBJ2-5,CASSLGTNQETQYF,2,0,1,2
TRBV7-6,TRBJ1-6,CASSLGQDNSPLHF,2,0,1,2
TRBV7-3,TRBJ2-3,CASSLDDRTDTQYF,2,0,1,2
TRBV11-2,TRBJ2-7,CASSLDVTTYEQYL,2,0,1,2
TRBV7-2,TRBJ2-1,CASSLRQGGGEQFF,2,4,2,6
TRBV11-2,TRBJ2-1,CASSLRPGLYEQFF,2,0,1,2
TRBV7-3,TRBJ2-1,CASSLNWGYNEQFF,2,0,1,2
TRBV7-9,TRBJ1-6,CASSSRDRVAPLHF,2,0,1,2
TRBV11-2,TRBJ1-5,CASSSGQGNQPQHF,2,0,1,2
TRBV5-4,TRBJ1-2,CASSSGQTVYGYTF,2,0,1,2
TRBV7-6,TRBJ2-7,CASSSSGDNYEQYF,2,0,1,2
TRBV5-6,TRBJ2-2,CASSSGVGFGELFF,2,0,1,2
TRBV5-6,TRBJ1-2,CASSSGQGARGYTF,2,4,2,6
TRBV5-6,TRBJ1-1,CASSWQGPNTEAFF,2,0,1,2
TRBV28,TRBJ2-4,CASSYLGVANIQYF,2,0,1,2
TRBV5-4,TRBJ1-1,CASSYQDRDPEAFF,2,0,1,2
TRBV5-5,TRBJ2-7,CASSYGGMGYEQYF,2,0,1,2
TRBV28,TRBJ1-6,CASSYRNPNSPLHF,2,0,1,2
TRBV7-9,TRBJ1-4,CASSLTGAGEKLFF,2,0,1,2
TRBV5-6,TRBJ2-5,CASSLRTLEETQYF,2,0,1,2
TRBV7-9,TRBJ1-1,CASSPGRLNTEAFF,2,0,1,2
TRBV28,TRBJ1-3,CASSPRVSRNTIYF,2,0,1,2
TRBV7-9,TRBJ2-7,CASSPNRGPYEQYF,2,0,1,2
TRBV7-2,TRBJ2-3,CASSPGLAVDAQYF,2,0,1,2
TRBV7-2,TRBJ2-7,CASSPELLPYEQYF,2,0,1,2
TRBV2,TRBJ1-3,CASSPQGGGNTIYF,2,0,1,2
TRBV7-3,TRBJ2-5,CASSPGGGGETQYF,2,0,1,2
TRBV3-1,TRBJ1-4,CASSRGQINEKLFF,2,0,1,2
TRBV5-5,TRBJ2-7,CASSRDPLGYEQYF,2,0,1,2
TRBV7-2,TRBJ1-5,CASSHPGLDQPQHF,2,0,1,2
TRBV3-1,TRBJ2-1,CASSQRTVNNEQFF,2,0,1,2
TRBV14,TRBJ1-4,CASSQDRVNEKLFF,2,0,1,2
TRBV7-9,TRBJ1-1,CASSQQGINTEAFF,2,0,1,2
TRBV4-2,TRBJ2-2,CASSQQEVTGELFF,2,0,1,2
TRBV3-1,TRBJ2-1,CASSQVSAYNEQFF,2,0,1,2
TRBV4-2,TRBJ2-5,CASSQGFGQETQYL,2,0,1,2
TRBV4-2,TRBJ2-2,CASSQDSRTGELFF,2,0,1,2
TRBV3-1,TRBJ2-1,CASSQDGQGFEQFF,2,0,1,2
TRBV3-1,TRBJ2-1,CASSQTPDYNEQFF,2,0,1,2
TRBV16,TRBJ2-7,CASSQTGQGYEQYF,2,0,1,2
TRBV7-9,TRBJ2-5,CASSVPGGWETQYF,2,0,1,2
TRBV9,TRBJ2-3,CASSVVGFTDTQYF,2,0,1,2
TRBV9,TRBJ1-1,CASSAGTVNTEAFF,2,0,1,2
TRBV7-9,TRBJ2-1,CASSGLSSYNEQFF,2,0,1,2
TRBV7-2,TRBJ1-5,CASSGYEYSQPQHF,2,0,1,2
TRBV7-9,TRBJ1-4,CASSGDHSNEKLFF,2,0,1,2
TRBV11-3,TRBJ1-1,CASSERHWSTEAFF,2,0,1,2
TRBV5-4,TRBJ2-5,CASSIYRESETQYF,2,0,1,2
TRBV12-3/4,TRBJ2-7,CASSTGQRVYEQYF,2,0,1,2
TRBV3-1,TRBJ1-4,CASSSGSDNEKLLF,2,0,1,2
TRBV6-2/3/5/6,TRBJ1-2,CASSKDSVWYGYTF,2,0,1,2
TRBV7-3,TRBJ2-2,CASSKGLASGELFF,2,0,1,2
TRBV5-6,TRBJ2-7,CASSKGHAPYEQYF,2,0,1,2
TRBV6-2/3/5/6,TRBJ2-3,CASRLGGGADTQYF,2,0,1,2
TRBV27,TRBJ1-1,CASRPGQFYTEAFF,2,0,1,2
TRBV5-6,TRBJ2-1,CASRRDSFHNDQFF,2,0,1,2
TRBV12-3/4,TRBJ2-3,CASRGIVSTDTQYF,2,0,1,2
TRBV28,TRBJ1-4,CASRGIQGGEKLFF,2,0,1,2
TRBV19,TRBJ1-1,CASRTGEENTEAFF,2,0,1,2
TRBV7-9,TRBJ2-3,CASRNTGERDTQYF,2,0,1,2
TRBV12-3/4,TRBJ2-1,CASRLPGGYNEQFF,2,0,1,2
TRBV6-2/3/5/6,TRBJ2-7,CASRVLATAYEQYF,2,0,1,2
TRBV28,TRBJ2-7,CASNPGQGTHEQYF,2,0,1,2
TRBV28,TRBJ2-7,CASNPTDSPYEQYF,2,0,1,2
TRBV28,TRBJ1-6,CASNTQGRHSPLHF,2,0,1,2
TRBV2,TRBJ1-1,CASKLGTGNTEAFF,2,0,1,2
TRBV5-1,TRBJ1-1,CASSRTGENTEAFF,2,0,1,2
TRBV5-1,TRBJ1-5,CASSSGRGGGPQHF,2,0,1,2
TRBV12-3/4,TRBJ2-7,CASSPGQGNYEQYF,2,0,1,2
TRBV5-1,TRBJ2-5,CASSPGQPGETQYF,2,0,1,2
TRBV5-1,TRBJ2-2,CASSGAANTGGLFF,2,0,1,2
TRBV5-1,TRBJ2-7,CASSFEGQRYEQYF,2,0,1,2
TRBV5-1,TRBJ2-3,CASSLFEPPDTQYF,2,0,1,2
TRBV5-1,TRBJ2-1,CASSLVLDYNEQFF,2,0,1,2
TRBV5-1,TRBJ2-1,CASSLVGPRGEQFF,2,0,1,2
TRBV5-1,TRBJ1-1,CASSLGDTRNVAFF,2,0,1,2
TRBV5-1,TRBJ1-1,CASSLIDGGTEAFF,2,0,1,2
TRBV5-1,TRBJ2-2,CASSLNGGTGELFF,2,0,1,2
TRBV5-1,TRBJ1-2,CASSSRQGNYGYTF,2,0,1,2
TRBV5-1,TRBJ1-2,CASSSTAVGTPGAF,2,0,1,2
TRBV4-1,TRBJ2-5,CASSLVTAAETQYF,2,0,1,2
TRBV5-1,TRBJ2-7,CASSLGQGPYEQYF,2,0,1,2
TRBV5-1,TRBJ1-1,CASSLGGITAEAFF,2,0,1,2
TRBV5-1,TRBJ2-5,CASSLTGGEETQYF,2,0,1,2
TRBV5-1,TRBJ2-1,CASSPLDLYNEQFF,2,0,1,2
TRBV5-1,TRBJ1-1,CASSPDRPNTEAFF,2,0,1,2
TRBV5-1,TRBJ2-1,CASSPGGARDELFF,2,0,1,2
TRBV5-1,TRBJ2-1,CASSPGTPRGEQFF,2,0,1,2
TRBV5-1,TRBJ1-1,CASSHHGQNTEAFF,2,0,1,2
TRBV4-1,TRBJ1-2,CASSHGGSNYGYTF,2,0,1,2
TRBV4-1,TRBJ2-3,CASSQTSGADTQYF,2,0,1,2
TRBV4-1,TRBJ1-1,CASSQYSTHTEAFF,2,0,1,2
TRBV4-1,TRBJ2-1,CASSQDFRGLALHV,2,0,1,2
TRBV4-1,TRBJ2-7,CASSQDGLAPEQYF,2,0,1,2
TRBV4-1,TRBJ2-3,CASSQEKFRDTQYF,2,0,1,2
TRBV5-1,TRBJ2-7,CASSVQGSSYEQYF,2,0,1,2
TRBV4-1,TRBJ2-1,CASSARQGNNEQFF,2,0,1,2
TRBV4-1,TRBJ1-1,CASRQGAGTTEAFF,2,0,1,2
TRBV5-1,TRBJ2-3,CASRRTERTDTQYF,2,0,1,2
TRBV20-1,TRBJ2-2,CGAHGLASTGELFF,2,0,1,2
TRBV5-1,TRBJ2-5,CTSSMGGPRAAQYF,2,0,1,2
TRBV20-1,TRBJ2-3,CSASKQRGADTQYF,2,0,1,2
TRBV20-1,TRBJ2-3,CSAWTSGGTDTQYF,2,0,1,2
TRBV20-1,TRBJ2-1,CSAIISGGANEQFF,2,0,1,2
TRBV20-1,TRBJ1-2,CSASPVLGGSGYTF,2,0,1,2
TRBV20-1,TRBJ1-6,CSASEDSPNSPLRF,2,0,1,2
TRBV20-1,TRBJ2-3,CSARLAGGSDTQYF,2,0,1,2
TRBV20-1,TRBJ2-5,CSARWTSGQETQYF,2,0,1,2
TRBV20-1,TRBJ2-2,CSARVRGADGELFF,2,0,1,2
TRBV20-1,TRBJ1-5,CSARAQGGAQPQHF,2,0,1,2
TRBV20-1,TRBJ2-4,CSANPQGAKNIQYF,2,0,1,2
TRBV20-1,TRBJ1-3,CSAPDRNSGNTIYF,2,0,1,2
TRBV20-1,TRBJ1-5,CSATTGISNQPQHF,2,0,1,2
TRBV29-1,TRBJ2-3,CSVSVGSAGDTQYF,2,0,1,2
TRBV29-1,TRBJ2-2,CSVRASGNTGELFF,2,0,1,2
TRBV29-1,TRBJ2-7,CSVVTVLSSYEQYF,2,0,1,2
TRBV29-1,TRBJ1-1,CSVAQGASVTEAFF,2,0,1,2
TRBV29-1,TRBJ2-5,CSVGVGLWEETQYF,2,0,1,2
TRBV29-1,TRBJ2-3,CSVGRAQSTDTQYF,2,0,1,2
TRBV29-1,TRBJ2-3,CSVGPGTSSDTQYF,2,0,1,2
TRBV29-1,TRBJ2-1,CSVDSMISYDEQFF,2,0,1,2
TRBV29-1,TRBJ1-2,CSVDMDRGVYGYTF,2,0,1,2
TRBV29-1,TRBJ2-2,CSVEQGLNTGELFF,2,0,1,2
TRBV29-1,TRBJ1-5,CSVRLGGPNQPQHF,2,0,1,2
TRBV29-1,TRBJ2-5,CSVYSDTDQETQYF,2,0,1,2
TRBV29-1,TRBJ2-3,CSAPLRGTTDTQYF,2,0,1,2
TRBV29-1,TRBJ2-3,CSARTELSTDTQYF,2,0,1,2
TRBV29-1,TRBJ2-3,CSAQRGIYPDTQYF,2,0,1,2
TRBV29-1,TRBJ2-1,CSAGGPESHNEQFF,2,0,1,2
TRBV29-1,TRBJ1-4,CSATTGGTSEKLFF,2,6,2,8
TRBV29-1,TRBJ1-1,CSGGTPDPDTEAFF,2,0,1,2
TRBV29-1,TRBJ1-1,CSGLFGPSNTEAFF,2,0,1,2
TRBV29-1,TRBJ2-1,CSGVGGSYYNEQFF,2,0,1,2
TRBV29-1,TRBJ2-1,CSGDLATSYNEQFF,2,0,1,2
TRBV3-1,TRBJ2-1,YASSQSRDVGEQFF,2,0,1,2
TRBV9,TRBJ2-3,GASSGRRSTDTQYF,2,0,1,2
TRBV7-2,TRBJ2-5,CASRLAGGKTQYF,2,0,1,2
TRBV12-5,TRBJ2-3,CASGLQLAGAQYY,2,0,1,2
TRBV12-5,TRBJ2-7,CASGRDGPHEQYF,2,0,1,2
TRBV30,TRBJ1-1,CAWDQAANTEAFF,2,0,1,2
TRBV30,TRBJ2-5,CAWSVRVRETQYF,2,0,1,2
TRBV30,TRBJ1-5,CAWSVNADQPQHF,2,0,1,2
TRBV30,TRBJ1-1,CAWSGLANTEAFF,2,0,1,2
TRBV30,TRBJ2-1,CAWSGGTYNEQFF,2,0,1,2
TRBV30,TRBJ2-3,CAWSSGGTDTQYF,2,0,1,2
TRBV30,TRBJ2-1,CAWSRGFDNEQFF,2,0,1,2
TRBV30,TRBJ2-2,CAWKRGSDGELFF,2,0,1,2
TRBV10-3,TRBJ1-5,CAIRDRGNQPQHF,2,4,2,6
TRBV10-3,TRBJ2-1,CAISGSSGDGQFF,2,0,1,2
TRBV2,TRBJ1-3,CATQDLPGNTIYF,2,0,1,2
TRBV24-1,TRBJ2-3,CATDGGYTDTQYF,2,0,1,2
TRBV24-1,TRBJ1-1,CATSDSHRFEAFF,2,0,1,2
TRBV19,TRBJ1-1,CASSFAGEAEAFF,2,0,1,2
TRBV19,TRBJ1-1,CASSPRGGTEAFF,2,0,1,2
TRBV19,TRBJ1-2,CASSIYGGYGYTF,2,0,1,2
TRBV19,TRBJ1-1,CASSIRRGTEAFF,2,0,1,2
TRBV19,TRBJ1-5,CASSIGAPPSQLF,2,0,1,2
TRBV19,TRBJ2-1,CASSTWAYNEQFF,2,0,1,2
TRBV19,TRBJ1-1,CASSTARNTEAFF,2,0,1,2
TRBV19,TRBJ2-2,CASSTDRDGELFF,2,0,1,2
TRBV19,TRBJ2-7,CASSRGTLYEQYF,2,0,1,2
TRBV19,TRBJ2-4,CASSIYRGNIQYF,2,0,1,2
TRBV19,TRBJ1-5,CASRAQGIQPQHF,2,0,1,2
TRBV19,TRBJ1-2,CASNTDRDYGYTF,2,0,1,2
TRBV18,TRBJ1-3,CASSADRGNTIYF,2,0,1,2
TRBV18,TRBJ1-5,CASSTSKNQPQHF,2,0,1,2
TRBV18,TRBJ1-1,CASSLQTNTEAFF,2,0,1,2
TRBV18,TRBJ2-5,CASSPQDQETQYF,2,0,1,2
TRBV18,TRBJ2-3,CASSPVTRDTQYF,2,0,1,2
TRBV18,TRBJ2-5,CASSPGYQETQYF,2,0,1,2
TRBV18,TRBJ1-1,CASSAGTGLEAFF,2,0,1,2
TRBV6-2/3/5/6,TRBJ1-1,CASWSDGNTEAFF,2,0,1,2
TRBV12-3/4,TRBJ2-3,CASLGQGQDTQYF,2,11,2,13
TRBV12-3/4,TRBJ2-7,CASGRQGINELYF,2,0,1,2
TRBV2,TRBJ2-3,CASGGLAGDTQYF,2,0,1,2
TRBV7-9,TRBJ2-1,CASGGQGLNEQFF,2,0,1,2
TRBV12-3/4,TRBJ1-5,CASGTGTNQPQHF,2,0,1,2
TRBV2,TRBJ2-2,CASDGADTGELFF,2,0,1,2
TRBV5-4,TRBJ2-1,CASEAGSYNEQFF,2,0,1,2
TRBV6-1,TRBJ1-1,CASIGQGVTEAFF,2,0,1,2
TRBV28,TRBJ1-2,CASITGAFDGYSF,2,0,1,2
TRBV12-3/4,TRBJ1-3,CASTLVAGNTIYF,2,0,1,2
TRBV28,TRBJ2-3,CASTPTSADTQYF,2,0,1,2
TRBV28,TRBJ1-5,CASSFSSNQPQHF,2,4,2,6
TRBV12-3/4,TRBJ1-1,CASSLIQGTEAFF,2,0,1,2
TRBV12-3/4,TRBJ2-5,CASSLLLAETQYF,2,0,1,2
TRBV12-3/4,TRBJ2-7,CASSLRGAREQYF,2,0,1,2
TRBV12-3/4,TRBJ1-5,CASSLARGQPQHF,2,0,1,2
TRBV7-9,TRBJ1-1,CASSLGVNTEAFF,2,3,2,5
TRBV28,TRBJ1-4,CASSSGGAEKLFF,2,0,1,2
TRBV6-2/3/5/6,TRBJ1-2,CASSSGHTYGYTL,2,0,1,2
TRBV28,TRBJ1-2,CASSYSNQYGYTF,2,0,1,2
TRBV6-2/3/5/6,TRBJ2-7,CASSYSKGYEQYF,2,0,1,2
TRBV6-2/3/5/6,TRBJ1-6,CASSYWGDSHLHF,2,0,1,2
TRBV6-2/3/5/6,TRBJ1-1,CASSYDRNTEAFF,2,0,1,2
TRBV27,TRBJ2-1,CASSLWSDNEQFF,2,0,1,2
TRBV6-2/3/5/6,TRBJ1-2,CASSLAGQGVYTF,2,0,1,2
TRBV28,TRBJ2-2,CASSPQPTGELFF,2,0,1,2
TRBV12-3/4,TRBJ1-2,CASSEGQGTGYTF,2,0,1,2
TRBV6-1,TRBJ2-1,CASSEGRRGEQFF,2,0,1,2
TRBV28,TRBJ1-5,CASSETGLQPQHF,2,0,1,2
TRBV28,TRBJ2-5,CASSTDAGETQYF,2,0,1,2
TRBV12-3/4,TRBJ1-1,CASSTYTNTEAFF,2,0,1,2
TRBV12-3/4,TRBJ1-1,CASSKNRDAEAFF,2,0,1,2
TRBV5-6,TRBJ1-1,CASSFWVDTEAFF,2,0,1,2
TRBV11-2,TRBJ1-1,CASSFQGRNEAFF,2,0,1,2
TRBV11-2,TRBJ2-7,CASSFDFGQEQYF,2,0,1,2
TRBV11-3,TRBJ2-1,CASSFSSGDEQFF,2,0,1,2
TRBV7-9,TRBJ2-2,CASSFKITGELFF,2,0,1,2
TRBV7-9,TRBJ2-2,CASSLLNTGELFF,2,0,1,2
TRBV5-6,TRBJ2-1,CASSLGGDNEQFF,2,0,1,2
TRBV5-6,TRBJ1-2,CASSLSVNSVYTF,2,0,1,2
TRBV7-2,TRBJ2-7,CASSLYTGYEQYF,2,0,1,2
TRBV7-3,TRBJ2-1,CASSLPSSDEQFF,2,0,1,2
TRBV11-2,TRBJ1-5,CASSLPGNQPQHF,2,0,1,2
TRBV7-9,TRBJ2-3,CASSLPTSFAQYF,2,0,1,2
TRBV11-2,TRBJ2-2,CASSLRRAGELFF,2,0,1,2
TRBV7-9,TRBJ2-7,CASSLAQGYEQYF,2,0,1,2
TRBV7-9,TRBJ2-7,CASSLGEGGSLHF,2,0,1,2
TRBV7-2,TRBJ1-2,CASSLGAVYVYTF,2,0,1,2
TRBV11-2,TRBJ2-1,CASSLGAQREQFF,2,0,1,2
TRBV7-9,TRBJ1-6,CASSLEYNSPLHF,2,0,1,2
TRBV7-3,TRBJ1-1,CASSLSPNTEAFF,2,0,1,2
TRBV6-2/3/5/6,TRBJ2-5,CASSSRLQETQYF,2,0,1,2
TRBV7-3,TRBJ1-1,CASSSGMNTEAFF,2,0,1,2
TRBV11-1,TRBJ1-1,CASSLDLNTDAFL,2,0,1,2
TRBV7-9,TRBJ1-2,CASSLDRNYGYTF,2,0,1,2
TRBV7-9,TRBJ2-5,CASSLIGAETQYF,2,0,1,2
TRBV7-3,TRBJ2-7,CASSPRQGDEQYL,2,0,1,2
TRBV13,TRBJ2-7,CASSPQGGDEQYF,2,0,1,2
TRBV7-8,TRBJ2-5,CASSPLSSWVQYF,2,0,1,2
TRBV7-9,TRBJ1-2,CASSPQKDRGYTF,2,0,1,2
TRBV7-2,TRBJ2-7,CASSPRYEGEQYF,2,0,1,2
TRBV7-3,TRBJ2-5,CASSPRPQETQYF,2,0,1,2
TRBV14,TRBJ1-6,CASSPMAGSSLHF,2,0,1,2
TRBV7-9,TRBJ2-7,CASSPIPGLEQYF,2,0,1,2
TRBV3-1,TRBJ1-2,CASSRPYPYGYTF,2,0,1,2
TRBV7-9,TRBJ2-1,CASSRGTASEQFF,2,0,1,2
TRBV14,TRBJ2-7,CASSRAGLSEQYF,2,0,1,2
TRBV6-2/3/5/6,TRBJ2-7,CASSRDGGYEQYF,2,0,1,2
TRBV6-2/3/5/6,TRBJ2-1,CASSRDRNNEQFF,2,0,1,2
TRBV7-6,TRBJ1-1,CASSHDLNTEAFF,2,0,1,2
TRBV28,TRBJ1-1,CASSQLMNTEAFF,2,0,1,2
TRBV16,TRBJ1-1,CASSQPSGSEAFF,2,0,1,2
TRBV14,TRBJ1-5,CASSQEGGQPQHF,2,0,1,2
TRBV7-9,TRBJ1-1,CASSVGTATEAFF,2,0,1,2
TRBV9,TRBJ1-3,CASSVDRLDTIYL,2,0,1,2
TRBV11-2,TRBJ1-4,CASSAQGSEKLFF,2,0,1,2
TRBV9,TRBJ2-7,CASSAGGLGEQYF,2,0,1,2
TRBV7-3,TRBJ1-2,CASSAERQYGYTF,2,8,2,10
TRBV9,TRBJ1-2,CASSETGGYGYTF,2,0,1,2
TRBV7-6,TRBJ1-1,CASSTRQGFTAFF,2,0,1,2
TRBV11-2,TRBJ2-7,CASSTEREREQYF,2,0,1,2
TRBV7-2,TRBJ2-7,CASSSGGAYEQYF,2,0,1,2
TRBV28,TRBJ2-2,CASRSGFTGELFF,2,0,1,2
TRBV6-2/3/5/6,TRBJ2-7,CASRRQVAYEQYF,2,0,1,2
TRBV6-2/3/5/6,TRBJ1-2,CASRMDQNYGYTF,2,0,1,2
TRBV28,TRBJ2-5,CASRNAEAETQYF,2,0,1,2
TRBV2,TRBJ1-5,CASRPDSLQPQHF,2,0,1,2
TRBV6-2/3/5/6,TRBJ1-6,CASRPGPGSPLHF,2,0,1,2
TRBV7-9,TRBJ1-2,CASRGGQGHGYTF,2,0,1,2
TRBV3-1,TRBJ1-2,CASRKTAGGGYTY,2,0,1,2
TRBV2,TRBJ2-4,CASNGQTKNIQYF,2,0,1,2
TRBV4-1,TRBJ1-1,CASRLAGGPEAFF,2,0,1,2
TRBV4-1,TRBJ2-7,CASTHRGAYEQYF,2,0,1,2
TRBV4-1,TRBJ2-2,CASSPSQFGELFF,2,0,1,2
TRBV5-1,TRBJ2-3,CASSQGSTDTQYF,2,0,1,2
TRBV10-2,TRBJ2-7,CASSAGQALEQYF,2,0,1,2
TRBV10-2,TRBJ1-5,CASSDPGAQPQHF,2,0,1,2
TRBV5-1,TRBJ1-1,CASSFNRNTEAFF,2,0,1,2
TRBV5-1,TRBJ1-5,CASSFGTDQPQHF,2,0,1,2
TRBV5-1,TRBJ1-2,CASSLFEGYGYTF,2,0,1,2
TRBV5-1,TRBJ2-2,CASSLALREELFF,2,0,1,2
TRBV5-1,TRBJ1-2,CASSLDRDYGYTF,2,0,1,2
TRBV5-1,TRBJ2-7,CASSLTQEYEQYF,2,0,1,2
TRBV5-1,TRBJ2-4,CASSSLAKNIQYF,2,0,1,2
TRBV5-1,TRBJ1-1,CASSWGENTEAFF,2,0,1,2
TRBV5-1,TRBJ1-6,CASSRDSNSPLHF,2,0,1,2
TRBV4-1,TRBJ2-1,CASSQDRDTSVFF,2,0,1,2
TRBV4-1,TRBJ2-1,CASSQELAREQFF,2,0,1,2
TRBV4-1,TRBJ2-1,CASSQIDPPEQFF,2,0,1,2
TRBV5-1,TRBJ2-7,CASSVADRGEQYF,2,0,1,2
TRBV10-1,TRBJ1-5,CASSGSGDQPQHF,2,0,1,2
TRBV5-1,TRBJ2-3,CASSGTSTDTQYF,2,0,1,2
TRBV5-1,TRBJ1-1,CASSGGQGTEAFF,2,0,1,2
TRBV5-1,TRBJ2-7,CASSGDREGEQYF,2,0,1,2
TRBV5-1,TRBJ2-6,CASSIDGANVLTF,2,0,1,2
TRBV5-1,TRBJ2-7,CASRGTGRYEQYF,2,0,1,2
TRBV29-1,TRBJ1-1,CTTRAAANTEAFF,2,0,1,2
TRBV20-1,TRBJ2-3,CSVDRQGADTQYF,2,0,1,2
TRBV20-1,TRBJ1-5,CSAARQGNQPQHF,2,0,1,2
TRBV20-1,TRBJ1-5,CSAGWDRHQPLHF,2,0,1,2
TRBV20-1,TRBJ2-7,CSAEGDGSYEQYF,2,0,1,2
TRBV20-1,TRBJ1-2,CSAIPRGGYGHTF,2,0,1,2
TRBV20-1,TRBJ2-1,CSATWSGVDEQFF,2,0,1,2
TRBV20-1,TRBJ2-3,CSATTGITDTQYF,2,0,1,2
TRBV20-1,TRBJ2-1,CSASGLAEDEQFF,2,0,1,2
TRBV20-1,TRBJ1-1,CSASTQMNTEAFF,2,0,1,2
TRBV20-1,TRBJ1-6,CSARTGDDSPLHF,2,0,1,2
TRBV20-1,TRBJ1-2,CSARFTGAGGYTF,2,0,1,2
TRBV20-1,TRBJ2-5,CSARLGFQETQYF,2,0,1,2
TRBV20-1,TRBJ2-7,CSARLGQTNEQYF,2,0,1,2
TRBV20-1,TRBJ1-1,CSARDLLNTEAFF,2,0,1,2
TRBV20-1,TRBJ1-4,CSAKGAGDEKLFF,2,0,1,2
TRBV20-1,TRBJ1-2,CSAPRAPSDGYTF,2,0,1,2
TRBV20-1,TRBJ1-2,CSAERQGATGYTF,2,0,1,2
TRBV29-1,TRBJ2-3,CSSRGQNTDTQYF,2,0,1,2
TRBV29-1,TRBJ2-7,CSVYRDSTYEQYF,2,0,1,2
TRBV29-1,TRBJ2-1,CSVLQARGNEQFF,2,0,1,2
TRBV29-1,TRBJ1-1,CSVVRALNTEAFF,2,0,1,2
TRBV29-1,TRBJ2-1,CSVGSGEDNEQFF,2,0,1,2
TRBV29-1,TRBJ2-7,CSVGYGEGYEQYF,2,0,1,2
TRBV29-1,TRBJ2-1,CSVGLATINEQFF,2,0,1,2
TRBV29-1,TRBJ1-3,CSVGGGVGNTIYF,2,0,1,2
TRBV29-1,TRBJ2-5,CSVGKQEQETQYF,2,0,1,2
TRBV29-1,TRBJ1-4,CSVDEQGGEKLFF,2,0,1,2
TRBV29-1,TRBJ1-4,CSVEAVGSGKLFF,2,0,1,2
TRBV29-1,TRBJ2-1,CSVEEGAWNEQFF,2,0,1,2
TRBV29-1,TRBJ1-4,CSVEEGAEEKLFF,2,0,1,2
TRBV29-1,TRBJ2-7,CSVSNQAGYEQYF,2,0,1,2
TRBV29-1,TRBJ2-1,CSVPLGGLNEQFF,2,0,1,2
TRBV29-1,TRBJ2-7,CSVNARTGTEQYF,2,0,1,2
TRBV29-1,TRBJ2-7,CSVTDRTFYEQYF,2,0,1,2
TRBV29-1,TRBJ2-5,CSVHRRQRGTQYF,2,0,1,2
TRBV29-1,TRBJ1-1,CSVGQGANTEAFF,2,0,1,2
TRBV29-1,TRBJ1-1,CSVRTDPNTEAFF,2,0,1,2
TRBV29-1,TRBJ1-5,CSAGTGDGQPQHF,2,0,1,2
TRBV29-1,TRBJ1-1,CSAPGTAGTEAFF,2,0,1,2
TRBV29-1,TRBJ2-1,CSAGTSHSNEQFF,2,0,1,2
TRBV29-1,TRBJ2-7,CSAGTLHSYEQYF,2,0,1,2
TRBV29-1,TRBJ2-6,CSADTGTADVLTF,2,0,1,2
TRBV29-1,TRBJ2-7,CSAGNQEPYEQYF,2,2,2,4
TRBV29-1,TRBJ1-1,CSGWTGVNTEAFF,2,0,1,2
TRBV29-1,TRBJ2-5,CSGGTAHGETQYF,2,0,1,2
TRBV20-1,TRBJ2-3,CRAGQGKTDTQYF,2,0,1,2
TRBV11-2,TRBJ2-1,RASSLDQVNEQFF,2,0,1,2
TRBV30,TRBJ1-2,CAWSGGNYGYTF,2,0,1,2
TRBV30,TRBJ1-6,CAWRGSRSPLHF,2,0,1,2
TRBV10-3,TRBJ1-4,CAMGDPNEKLFF,2,0,1,2
TRBV28,TRBJ2-7,CATSWGFYEQYF,2,0,1,2
TRBV24-1,TRBJ2-1,CATSDVYNEQFF,2,0,1,2
TRBV19,TRBJ1-2,CASSPGTGVYTF,2,0,1,2
TRBV19,TRBJ1-4,CASSVPPEKLFF,2,0,1,2
TRBV19,TRBJ2-3,CASSIVTGAQYF,2,0,1,2
TRBV18,TRBJ2-7,CASSLPGNEQYF,2,0,1,2
TRBV18,TRBJ1-3,CASSRATGTIYF,2,0,1,2
TRBV18,TRBJ1-5,CASSPRDGPQHF,2,0,1,2
TRBV18,TRBJ2-3,CASSPYADTQYF,2,0,1,2
TRBV18,TRBJ1-1,CASSPPRGEAFF,2,0,1,2
TRBV7-2,TRBJ2-5,CASGRGQETQYF,2,0,1,2
TRBV5-4,TRBJ1-1,CASGWQNTEAFF,2,0,1,2
TRBV28,TRBJ1-3,CASTQNGDTIYF,2,0,1,2
TRBV12-3/4,TRBJ2-5,CASSLWQETQYF,2,0,1,2
TRBV6-2/3/5/6,TRBJ2-7,CASSLPGYEQYF,2,0,1,2
TRBV7-3,TRBJ2-1,CASSSSGVEQFF,2,0,1,2
TRBV6-2/3/5/6,TRBJ2-7,CASSYSLREQYF,2,0,1,2
TRBV6-2/3/5/6,TRBJ1-1,CASSYDLREAFL,2,0,1,2
TRBV28,TRBJ2-1,CASSPSSANPFF,2,0,1,2
TRBV2,TRBJ2-1,CASSVLGDEQFF,2,0,1,2
TRBV28,TRBJ2-1,CASSGPLRGPFF,2,0,1,2
TRBV2,TRBJ2-3,CASSGGTDTQYF,2,0,1,2
TRBV6-4,TRBJ2-7,CASSESGYEQYF,2,0,1,2
TRBV6-1,TRBJ1-4,CASSEMGEKLFF,2,0,1,2
TRBV6-2/3/5/6,TRBJ2-7,CASSSVGREQYF,2,0,1,2
TRBV28,TRBJ2-1,CASSRRGNEQFF,2,0,1,2
TRBV7-9,TRBJ1-1,CASSFDRAEAFF,2,0,1,2
TRBV5-5,TRBJ1-5,CASSFPNQPQHF,2,0,1,2
TRBV5-8,TRBJ2-1,CASSLVGVEQFF,2,0,1,2
TRBV5-8,TRBJ2-1,CASSLGGNEQFF,2,0,1,2
TRBV5-6,TRBJ2-1,CASSLEVNEQFF,2,0,1,2
TRBV5-6,TRBJ2-7,CASSLSFYEQYF,2,0,1,2
TRBV7-9,TRBJ1-2,CASSLRSYGYTF,2,0,1,2
TRBV7-9,TRBJ2-5,CASSLVGETQYF,2,2,2,4
TRBV11-2,TRBJ2-1,CASSLGGDEQFF,2,0,1,2
TRBV7-9,TRBJ2-7,CASSLGSHEQYF,2,2,2,4
TRBV7-9,TRBJ1-2,CASSLDVSGYTF,2,0,1,2
TRBV7-3,TRBJ2-1,CASSLDLNEQFF,2,0,1,2
TRBV11-2,TRBJ2-2,CASSLTRSELFF,2,0,1,2
TRBV7-9,TRBJ2-7,CASSSFGHEQYF,2,0,1,2
TRBV7-9,TRBJ1-5,CASSSNDQPQHF,2,0,1,2
TRBV5-6,TRBJ1-2,CASSLDAGGYTF,2,0,1,2
TRBV3-1,TRBJ2-3,CASSLERYTQYF,2,0,1,2
TRBV7-9,TRBJ2-1,CASSLIINEQFF,2,0,1,2
TRBV7-2,TRBJ2-3,CASSPRTDTQYF,2,0,1,2
TRBV7-9,TRBJ1-5,CASSRGDQPQHF,2,0,1,2
TRBV7-9,TRBJ1-6,CASSRRGSPLHF,2,0,1,2
TRBV3-1,TRBJ2-7,CASSHGEGRGYF,2,0,1,2
TRBV3-1,TRBJ2-1,CASSQGNNEQFF,2,0,1,2
TRBV9,TRBJ2-3,CASSVDGDTQYF,2,0,1,2
TRBV2,TRBJ2-1,CASSEVLNEQFF,2,0,1,2
TRBV6-2/3/5/6,TRBJ2-7,CASSRDSYEQYF,2,0,1,2
TRBV28,TRBJ2-7,CASRTGVFEQYF,2,0,1,2
TRBV2,TRBJ1-2,CASRQGGYGYTF,2,0,1,2
TRBV27,TRBJ2-2,CASRTGAGELFF,2,0,1,2
TRBV28,TRBJ1-5,CASNQGNQPQHF,2,0,1,2
TRBV6-2/3/5/6,TRBJ1-5,CASKRINQPQHF,2,0,1,2
TRBV10-1,TRBJ2-7,CASSDRNYEQYF,2,0,1,2
TRBV5-1,TRBJ2-3,CASSLATDTQYF,2,0,1,2
TRBV5-1,TRBJ2-1,CASSLGGREQFF,2,0,1,2
TRBV5-1,TRBJ2-2,CASSLDVGELFF,2,0,1,2
TRBV5-1,TRBJ2-7,CASSLDRGEQYF,2,0,1,2
TRBV5-1,TRBJ2-3,CASSSRGDTQYF,2,0,1,2
TRBV4-1,TRBJ2-5,CASSQDRETQYF,2,0,1,2
TRBV4-1,TRBJ2-7,CASSQEWGEQYF,2,0,1,2
TRBV20-1,TRBJ1-2,CSAIPSLYGYTF,2,0,1,2
TRBV20-1,TRBJ1-5,CSASPGGKPQHF,2,0,1,2
TRBV20-1,TRBJ1-2,CSAPRGADGYTF,2,0,1,2
TRBV20-1,TRBJ1-4,CSAPYPNEKLFF,2,0,1,2
TRBV20-1,TRBJ2-3,CSAARSRDTQYF,2,0,1,2
TRBV20-1,TRBJ1-4,CSAPSQGEKLFF,2,0,1,2
TRBV29-1,TRBJ1-2,CSSGQGDYGYTF,2,0,1,2
TRBV29-1,TRBJ2-4,CSVYPGRNIQYF,2,0,1,2
TRBV29-1,TRBJ1-1,CSVAPGFTEAFF,2,0,1,2
TRBV29-1,TRBJ1-2,CSVEGVGAGYTF,2,0,1,2
TRBV29-1,TRBJ2-3,CSVLPDTDTQYF,2,0,1,2
TRBV29-1,TRBJ1-5,CSVGGQGQPQHF,2,0,1,2
TRBV29-1,TRBJ2-1,CSVRILAGEQFF,2,0,1,2
TRBV29-1,TRBJ2-5,CSAYQGGQTQYF,2,0,1,2
TRBV29-1,TRBJ2-5,CSAAGFGETQYF,2,0,1,2
TRBV20-1,TRBJ2-3,CSIAPSTDTQYF,2,0,1,2
TRBV29-1,TRBJ2-1,CSTGQGINEQFL,2,0,1,2
TRBV19,TRBJ1-2,CVSVTLYGYTF,2,0,1,2
TRBV12-5,TRBJ2-1,CASGFGNEQFF,2,0,1,2
TRBV30,TRBJ1-4,CACSIREKLFF,2,0,1,2
TRBV30,TRBJ1-1,CAWRGNTEAFF,2,0,1,2
TRBV19,TRBJ1-1,CATRTVHVAFL,2,0,1,2
TRBV2,TRBJ2-4,CASSAKNIQYF,2,0,1,2
TRBV7-9,TRBJ2-7,CASGRGYEQYF,2,0,1,2
TRBV6-2/3/5/6,TRBJ2-7,CASTIGNEQYF,2,0,1,2
TRBV2,TRBJ2-4,CASTQGNIQYF,2,0,1,2
TRBV6-2/3/5/6,TRBJ2-3,CASSFLDTQYY,2,0,1,2
TRBV28,TRBJ1-1,CASSLTGGAFF,2,0,1,2
TRBV12-3/4,TRBJ2-1,CASSGGVEQFF,2,0,1,2
TRBV2,TRBJ1-1,CASSILLEAFF,2,0,1,2
TRBV5-6,TRBJ2-1,CASSLGNEQFF,2,0,1,2
TRBV7-2,TRBJ2-7,CASSLALEQYF,2,0,1,2
TRBV7-2,TRBJ1-6,CASSLISPLHF,2,0,1,2
TRBV7-9,TRBJ2-7,CASSLTYEQYF,2,2,2,4
TRBV14,TRBJ2-7,CASSWGEEQYF,2,0,1,2
TRBV6-2/3/5/6,TRBJ2-1,CASSRHNEQFF,2,0,1,2
TRBV3-1,TRBJ2-7,CASSQAVEQYF,2,0,1,2
TRBV20-1,TRBJ2-1,CSVEGDRRQFF,2,0,1,2
TRBV29-1,TRBJ1-2,CSVETKNGYTF,2,0,1,2
TRBV29-1,TRBJ1-2,CSVGQPYGYTF,2,0,1,2
TRBV29-1,TRBJ2-1,CSGRRRDEQFF,2,0,1,2
TRBV30,TRBJ2-1,CAWSFDEQFF,2,0,1,2
TRBV6-2/3/5/6,TRBJ1-1,CASTGTEAFF,2,0,1,2
TRBV6-2/3/5/6,TRBJ1-4,CASSSEKLFF,2,0,1,2
TRBV20-1,TRBJ2-5,CSANSGAQYF,2,0,1,2
TRBV29-1,TRBJ2-1,CSVYQDEQFF,2,0,1,2
TRBV29-1,TRBJ2-5,CSVGEETQYF,2,0,1,2
TRBV7-3,TRBJ1-5,CAVGGPQHF,2,0,1,2
TRBV3-1,TRBJ2-2,CANTGELFF,2,0,1,2
TRBV27,TRBJ2-2,CASSLMATGGLGELFF,0,22,1,22
TRBV3-1,TRBJ1-5,CASSPGQGGQPQHF,0,21,1,21
TRBV20-1,TRBJ1-1,CSASSGTEAFF,0,21,1,21
TRBV19,TRBJ2-4,CASSRGANKNIQYF,0,21,1,21
TRBV19,TRBJ2-7,CASSGQISYEQYF,0,20,1,20
TRBV19,TRBJ1-1,CASSLGPNTEAFF,0,20,1,20
TRBV19,TRBJ1-1,CASSSRTDLNTEAFF,0,19,1,19
TRBV3-1,TRBJ2-5,CASSPQWGQETQYF,0,19,1,19
TRBV7-2,TRBJ2-7,CASSSVSYEQYF,0,19,1,19
TRBV19,TRBJ2-6,CASSIEQGAYGANVLTF,0,18,1,18
TRBV19,TRBJ2-7,CASSIRVGVKQYF,0,18,1,18
TRBV6-4,TRBJ1-2,CASTYGNYGYTF,0,18,1,18
TRBV5-1,TRBJ2-3,CASALERDTQYF,0,18,1,18
TRBV16,TRBJ2-4,CASSQTGGQNIQYF,0,18,1,18
TRBV3-1,TRBJ1-6,CASSQGQGYSSPLHF,0,17,1,17
TRBV19,TRBJ1-4,CASSIDRPRGKLFF,0,17,1,17
TRBV19,TRBJ2-5,CASSTGKQETQYF,0,17,1,17
TRBV29-1,TRBJ1-1,CSVLLARVGEAFF,0,17,1,17
TRBV14,TRBJ1-2,CASSRTGYGYTF,0,17,1,17
TRBV12-3/4,TRBJ2-2,CASSYLNSPNTGELFF,0,16,1,16
TRBV20-1,TRBJ2-3,CSARKAGVSTDTQYF,0,16,1,16
TRBV25-1,TRBJ2-2,CASSEQGFTRELFF,0,16,1,16
TRBV11-2,TRBJ2-1,CASSITSVNEQFF,0,16,1,16
TRBV12-3/4,TRBJ2-7,CASTRESYEQYF,0,16,1,16
TRBV7-3,TRBJ2-3,CASSQSGSGRGTDTQYF,0,15,1,15
TRBV20-1,TRBJ2-3,CSGTIGGGAGTDTQYF,0,15,1,15
TRBV2,TRBJ2-4,CASSLGPDTADIQYF,0,15,1,15
TRBV19,TRBJ1-5,CASSIRRGLLNQPQHF,0,15,1,15
TRBV7-8,TRBJ1-4,CASSLEGRGPTNEKLFF,0,15,1,15
TRBV2,TRBJ2-4,CASSSDSRLAKNIQYF,0,15,1,15
TRBV12-3/4,TRBJ1-1,CASSPRGSLDTEAFF,0,15,1,15
TRBV12-3/4,TRBJ1-1,CASSFEGFTEAFF,0,15,1,15
TRBV29-1,TRBJ1-4,CAGDFSEKLFF,0,15,1,15
TRBV7-3,TRBJ1-5,CGRSNQPQHF,0,15,1,15
TRBV18,TRBJ2-7,CASSPQGHTNYEQYF,0,15,1,15
TRBV19,TRBJ2-1,CASSIQARRDEQFF,0,15,1,15
TRBV19,TRBJ1-2,CASTGDSALGYGYTF,0,14,1,14
TRBV11-2,TRBJ1-1,CASSLEGGGLQKLFF,0,14,1,14
TRBV29-1,TRBJ1-1,CSVAGVKMNTEAFF,0,14,1,14
TRBV19,TRBJ2-7,CASSIRLDGPYEQYF,0,14,1,14
TRBV29-1,TRBJ2-5,CSVEVMGQGIRETQYF,0,14,1,14
TRBV29-1,TRBJ2-1,CSVTGLAGAQYNEQFF,0,14,1,14
TRBV28,TRBJ1-4,CASSFRQAPNEKLFF,0,14,1,14
TRBV5-6,TRBJ1-5,CASSIWTDHQPQHF,0,14,1,14
TRBV7-2,TRBJ1-1,CASSFHRDTEAFF,0,14,1,14
TRBV7-9,TRBJ1-5,CANEDAGQGINQPQHF,0,13,1,13
TRBV20-1,TRBJ2-3,CSASLHRGGLMDTQYF,0,13,1,13
TRBV20-1,TRBJ1-1,CSATYDRARNTEAFF,0,13,1,13
TRBV19,TRBJ1-1,CASSPQGWDTEAFF,0,13,1,13
TRBV18,TRBJ1-5,CASSASQGDQPQHF,0,13,1,13
TRBV20-1,TRBJ1-4,CSASQGFTNEKLFF,0,13,1,13
TRBV18,TRBJ1-1,CASSPFSNTEAFF,0,13,1,13
TRBV2,TRBJ2-2,CARGDRDTGELFF,0,13,1,13
TRBV29-1,TRBJ2-3,CSVVPGSTDTQYF,0,13,1,13
TRBV29-1,TRBJ1-2,CSVVLGQGSGYTF,0,13,1,13
TRBV7-3,TRBJ2-1,CASSLLGNEQFF,0,13,1,13
TRBV6-2/3/5/6,TRBJ2-1,CASSPDREQFF,0,13,1,13
TRBV5-4,TRBJ1-2,CASTPDRALYGYTF,0,13,1,13
TRBV5-6,TRBJ1-3,CASSTGFSGNTMYF,0,13,1,13
TRBV5-1,TRBJ1-5,CASSELGGSNQPQHF,0,13,1,13
TRBV7-9,TRBJ1-5,CASSLETGDQPQHF,0,13,1,13
TRBV19,TRBJ1-2,CASSLSDPADRAIYGYTF,0,12,1,12
TRBV5-1,TRBJ2-2,CASRVTGSNTGELFF,0,12,1,12
TRBV2,TRBJ1-2,CASAPHRGIVGYTF,0,12,1,12
TRBV3-1,TRBJ2-5,CASSGLAGLQTQYF,0,12,1,12
TRBV10-2,TRBJ1-1,CASSESPGQGEAFF,0,12,1,12
TRBV5-1,TRBJ1-6,CASSGGQPNSPLHF,0,12,1,12
TRBV29-1,TRBJ1-4,CSVKTGGHNEKLFF,0,12,1,12
TRBV19,TRBJ1-5,CATSQVSNQPQHF,0,12,1,12
TRBV18,TRBJ2-3,CASSPFTGDTQYF,0,12,1,12
TRBV5-1,TRBJ1-1,CASSSDRGREAFF,0,12,1,12
TRBV20-1,TRBJ2-7,CSARETGRYEQYF,0,12,1,12
TRBV5-6,TRBJ1-2,CASSLGVRDPTF,0,12,1,12
TRBV20-1,TRBJ2-4,CSANPEGVLKNIQYF,0,12,1,12
TRBV30,TRBJ2-3,CAWSVGLAGYTDTQYF,0,12,1,12
TRBV3-1,TRBJ1-2,CASSRLGRTYGYTF,0,12,1,12
TRBV2,TRBJ1-3,CASRQHLSRAGNTIHF,0,12,1,12
TRBV7-9,TRBJ1-3,CASGQTGSDTIYF,0,12,1,12
TRBV5-8,TRBJ1-1,CASSLGTGVFTEAFF,0,12,1,12
TRBV5-6,TRBJ2-1,CASSSFGTGASGRLEEQFF,0,11,1,11
TRBV5-8,TRBJ1-3,CASSSGTVYRPRGNTIYF,0,11,1,11
TRBV19,TRBJ2-7,CASSEGQPESSYEQYF,0,11,1,11
TRBV5-5,TRBJ2-5,CASSLSVQGVVETQYF,0,11,1,11
TRBV18,TRBJ2-2,CASSPGGYYTGELFF,0,11,1,11
TRBV28,TRBJ2-7,CASSLIAGGTYEQYF,0,11,1,11
TRBV27,TRBJ1-5,CASSPGRGYGQPQHF,0,11,1,11
TRBV5-4,TRBJ1-2,CASSRKQQGGYGYTF,0,11,1,11
TRBV6-1,TRBJ1-3,CASSAGRAGQDTIYF,0,11,1,11
TRBV5-1,TRBJ2-3,CASSFYRGGTDTQYF,0,11,1,11
TRBV20-1,TRBJ1-1,CSARLTGGRNTEAFF,0,11,1,11
TRBV3-1,TRBJ1-5,CASSLGGIGQPQHF,0,11,1,11
TRBV4-1,TRBJ2-7,CASSLRDSHYEQYF,0,11,1,11
TRBV20-1,TRBJ2-7,CSAPMTSGVNEQYF,0,11,1,11
TRBV29-1,TRBJ1-4,CSVDLQGSSEKLFF,0,11,1,11
TRBV30,TRBJ1-5,CAWSEGSGWPQHF,0,11,1,11
TRBV19,TRBJ2-2,CASSGGLAGELFF,0,11,1,11
TRBV6-1,TRBJ2-7,CASSEQGTYEQYF,0,11,1,11
TRBV3-1,TRBJ2-3,CASSQASDGSQYF,0,11,1,11
TRBV12-3/4,TRBJ1-5,CASNQQSNQPQHF,0,11,1,11
TRBV5-1,TRBJ2-7,CASSGGASYEQYF,0,11,1,11
TRBV29-1,TRBJ2-7,CSVDLAGGNEQYF,0,11,1,11
TRBV19,TRBJ1-1,CASSTRDRRAFF,0,11,1,11
TRBV7-9,TRBJ2-1,CASSLDWNEQFF,0,11,1,11
TRBV4-2,TRBJ2-3,CASSLSADTQYF,0,11,1,11
TRBV3-1,TRBJ1-2,CASSHGTYGYTF,0,11,1,11
TRBV28,TRBJ1-2,CASKEGYGYTF,0,11,1,11
TRBV7-3,TRBJ1-1,CASSLTLNTEAFF,0,11,1,11
TRBV5-1,TRBJ1-3,CASSLVGDQSLGNTIYF,0,11,1,11
TRBV18,TRBJ2-3,CASSLGQSTDTQYF,0,11,1,11
TRBV18,TRBJ1-5,CASSPPPLGQPQHF,0,11,1,11
TRBV29-1,TRBJ2-7,CRVEAAGTGAMGQYF,0,11,1,11
TRBV2,TRBJ2-7,CASSSQGSSYEQYF,0,10,1,10
TRBV12-5,TRBJ2-1,CASGLGTSNEQFF,0,10,1,10
TRBV20-1,TRBJ1-1,CSARETGGTEVFF,0,10,1,10
TRBV5-1,TRBJ1-4,CASSLDSANEKLFF,0,10,1,10
TRBV5-1,TRBJ2-3,CASSFFRVRDTQYF,0,10,1,10
TRBV5-8,TRBJ1-5,CASSSLRDQPQHF,0,10,1,10
TRBV19,TRBJ1-5,CASSKDRTIRGGGNQPQHF,0,10,1,10
TRBV16,TRBJ2-7,CASSEGLAGAPSYEQYF,0,10,1,10
TRBV19,TRBJ1-1,CASTIEGGTGNTEAFF,0,10,1,10
TRBV18,TRBJ1-1,CASSPSYASSYTEAFF,0,10,1,10
TRBV12-3/4,TRBJ2-7,CASSLSLAGGPYEQYF,0,10,1,10
TRBV11-2,TRBJ2-5,CASSSGTSEEVETQYF,0,10,1,10
TRBV2,TRBJ2-3,CARPGLAGGITDTQYF,0,10,1,10
TRBV20-1,TRBJ2-2,CSARDPDRGAGGELFF,0,10,1,10
TRBV10-3,TRBJ1-6,CAISGGGDSNSPLHF,0,10,1,10
TRBV7-2,TRBJ2-3,CASDWSSGGKDTQYF,0,10,1,10
TRBV28,TRBJ2-4,CASSDRSWAKNIQYF,0,10,1,10
TRBV11-2,TRBJ1-2,CASSLGSGRDYGYTF,0,10,1,10
TRBV7-9,TRBJ1-2,CASSADRGRNYGYTF,0,10,1,10
TRBV10-2,TRBJ1-3,CASSESGLFGNTIYF,0,10,1,10
TRBV20-1,TRBJ1-1,CSATPGQGASTEAFF,0,10,1,10
TRBV19,TRBJ1-6,CASSMRIYNSPLHF,0,10,1,10
TRBV18,TRBJ2-3,CASSPAGNTDTQYF,0,10,1,10
TRBV19,TRBJ1-5,CASGRGQSNQPQHF,0,10,1,10
TRBV2,TRBJ2-1,CASTETGGPYEQFF,0,10,1,10
TRBV7-2,TRBJ1-2,CASSFGTGMYGCTF,0,10,1,10
TRBV5-6,TRBJ1-2,CASSQSTGLYGYTF,0,10,1,10
TRBV2,TRBJ1-4,CASSAGGANEKLFF,0,10,1,10
TRBV7-9,TRBJ1-5,CASRSSYSNQPQHF,0,10,1,10
TRBV10-2,TRBJ2-7,CASGPSPGRYEQYF,0,10,1,10
TRBV5-1,TRBJ1-1,CASSLWTTNTEAFF,0,10,1,10
TRBV5-1,TRBJ1-2,CASSLDGQGRGYTF,0,10,1,10
TRBV4-1,TRBJ2-7,CASSPGQGVYEQYF,0,10,1,10
TRBV20-1,TRBJ1-4,CSAPRGGGGEKLFF,0,10,1,10
TRBV20-1,TRBJ2-5,CSARSSGGQETQYF,0,10,1,10
TRBV20-1,TRBJ1-2,CSALRGGGFYGYTF,0,10,1,10
TRBV29-1,TRBJ1-4,CSARGTADNEKLFF,0,10,1,10
TRBV12-5,TRBJ2-7,CASGFGRAYEQYF,0,10,1,10
TRBV19,TRBJ2-5,CASSPSSQETQYF,0,10,1,10
TRBV18,TRBJ1-1,CASSPQEGTEAYF,0,10,1,10
TRBV6-2/3/5/6,TRBJ2-5,CASSLLGEETQYF,0,10,1,10
TRBV7-2,TRBJ1-3,CASSLTRGNTIYF,0,10,1,10
TRBV5-1,TRBJ2-1,CASSLGWGHEQFF,0,10,1,10
TRBV11-2,TRBJ1-5,CASSGQGSQPQHF,0,10,1,10
TRBV5-1,TRBJ2-7,CASRWAEAYEQYF,0,10,1,10
TRBV29-1,TRBJ2-5,CSVSLTGWETQYF,0,10,1,10
TRBV29-1,TRBJ2-1,CSVVSTGYNEQFF,0,10,1,10
TRBV29-1,TRBJ1-2,CSVESPGTHGYTF,0,10,1,10
TRBV29-1,TRBJ2-7,CSVEDGGSYEQYF,0,10,1,10
TRBV29-1,TRBJ2-7,CSVIRDSTYEQYF,0,10,1,10
TRBV29-1,TRBJ1-1,CSVGVGGQGEAFF,0,10,1,10
TRBV29-1,TRBJ1-5,CSGRTDRDQPQHF,0,10,1,10
TRBV18,TRBJ1-1,CASSPMNTEAFF,0,10,1,10
TRBV7-9,TRBJ1-2,CASSLDTYGYTF,0,10,1,10
TRBV14,TRBJ2-4,CASSQGWTGQYF,0,10,1,10
TRBV5-1,TRBJ2-3,CASSLAPDTQYF,0,10,1,10
TRBV5-6,TRBJ2-1,CASSLGLAGIIEQFF,0,9,1,9
TRBV29-1,TRBJ2-1,CSVEGRRIYNEQFF,0,9,1,9
TRBV12-3/4,TRBJ2-5,CASSPPGLAVKETQYF,0,9,1,9
TRBV28,TRBJ2-3,CASSLLLAGGLSSAADTQYF,0,9,1,9
TRBV3-1,TRBJ1-6,CASSQEEPFIGWSGSPLHF,0,9,1,9
TRBV7-9,TRBJ1-2,CASSLPPDRVLDYGYTF,0,9,1,9
TRBV29-1,TRBJ2-3,CSVEGTTKNLNTDTQYF,0,9,1,9
TRBV19,TRBJ1-2,CASRPWDSPSLYGYTF,0,9,1,9
TRBV5-4,TRBJ2-1,CASIKAGGRSYNEQFF,0,9,1,9
TRBV28,TRBJ2-3,CASSSAGTGGWNTQYF,0,9,1,9
TRBV12-3/4,TRBJ2-7,CASSAGTGSRGYEQYF,0,9,1,9
TRBV20-1,TRBJ2-7,CSASPSGGLFSYEQYF,0,9,1,9
TRBV28,TRBJ2-1,CASSTAGTGRNEQFF,0,9,1,9
TRBV7-8,TRBJ1-2,CASSSYRLTNYGYTF,0,9,1,9
TRBV3-1,TRBJ1-5,CASSLGVGGNQPQHF,0,9,1,9
TRBV7-2,TRBJ2-1,CASSLTSGVGNEQFF,0,9,1,9
TRBV3-1,TRBJ1-1,CASSQDVHRNTEAFF,0,9,1,9
TRBV5-1,TRBJ2-7,CASSLGSGESYEQYF,0,9,1,9
TRBV5-1,TRBJ1-4,CASSLEAATNEKLFF,0,9,1,9
TRBV12-5,TRBJ2-3,CASGFEGRSDTQYF,0,9,1,9
TRBV18,TRBJ1-1,CASSQNRGQTEAFF,0,9,1,9
TRBV12-3/4,TRBJ2-7,CASSSWTGINEQYF,0,9,1,9
TRBV7-2,TRBJ1-5,CASSLWDNNQPQHF,0,9,1,9
TRBV3-1,TRBJ2-7,CASSQREGYDEQYF,0,9,1,9
TRBV14,TRBJ2-5,CASSQVSVKETQYF,0,9,1,9
TRBV3-1,TRBJ1-1,CASSQDSGGDGAFF,0,9,1,9
TRBV9,TRBJ2-3,CASNVRGGTNTQYF,0,9,1,9
TRBV10-2,TRBJ1-3,CASREQGFGDTIYF,0,9,1,9
TRBV20-1,TRBJ2-3,CSARVAGFLDTQYF,0,9,1,9
TRBV20-1,TRBJ2-5,CSAIRASGRETQYF,0,9,1,9
TRBV29-1,TRBJ2-3,CSVVTPEDVYTQYF,0,9,1,9
TRBV7-2,TRBJ2-7,CASSWARTYEQYF,0,9,1,9
TRBV3-1,TRBJ2-1,CASSQDSPGEQFF,0,9,1,9
TRBV5-1,TRBJ1-6,CASRDTENSPLHF,0,9,1,9
TRBV20-1,TRBJ2-2,CSASDRNTGELFF,0,9,1,9
TRBV20-1,TRBJ1-4,CSASTGDHEKLFF,0,9,1,9
TRBV7-2,TRBJ2-7,CASSSPGGEQYF,0,9,1,9
TRBV5-1,TRBJ2-1,CASSQTSDEQFF,0,9,1,9
TRBV29-1,TRBJ2-3,CSVQGSTDTQYF,0,9,1,9
TRBV29-1,TRBJ1-1,CSVEDLSDRLSL,0,9,1,9
TRBV20-1,TRBJ1-3,CRARGPGNTIYF,0,9,1,9
TRBV20-1,TRBJ2-7,CSARDHGPTVAGEQYF,0,9,1,9
TRBV10-1,TRBJ2-1,CASSPGTSGANEQFF,0,9,1,9
TRBV7-9,TRBJ1-1,CASNTVAGNTEAFF,0,9,1,9
TRBV5-1,TRBJ1-1,CASSLDGVNTEAFF,0,9,1,9
TRBV7-3,TRBJ2-5,CASSLGYRETQCF,0,9,1,9
TRBV29-1,TRBJ2-1,CSVEVGLADLTFF,0,9,1,9
TRBV2,TRBJ1-5,CASRGMGLSNQPQHF,0,9,1,9
TRBV4-1,TRBJ2-5,CASSQVSQFQETQYF,0,9,1,9
TRBV19,TRBJ2-7,CASSIGAGAYEQYF,0,9,1,9
TRBV14,TRBJ1-1,CASSQEARQKAFF,0,9,1,9
TRBV20-1,TRBJ1-2,CSARVYFFQQGPGLGGYTF,0,8,1,8
TRBV28,TRBJ1-6,CASSLSLGYASYNSPLHF,0,8,1,8
TRBV28,TRBJ1-4,CASSPPRGGESTDEKLFF,0,8,1,8
TRBV2,TRBJ2-5,CASSEAWLAGGGETQYF,0,8,1,8
TRBV5-6,TRBJ1-1,CASSLVVRGEGDTEAFF,0,8,1,8
TRBV28,TRBJ2-1,CASSHLSWTTTYNEQFF,0,8,1,8
TRBV2,TRBJ1-5,CASSEGQGGGSNQPQHF,0,8,1,8
TRBV5-1,TRBJ2-6,CASSLAAGTSGANVLTF,0,8,1,8
TRBV5-1,TRBJ2-4,CASSLRPFGEVLKIQYF,0,8,1,8
TRBV29-1,TRBJ2-3,CSVEDGRDTSGTDTQYF,0,8,1,8
TRBV11-3,TRBJ2-3,CASSLDKTGGADTQYF,0,8,1,8
TRBV28,TRBJ1-5,CASSSSQGIQGQPQHF,0,8,1,8
TRBV3-1,TRBJ2-7,CASSQAVGSGVHEQYF,0,8,1,8
TRBV3-1,TRBJ2-1,CASSQGWRGTYNEQFF,0,8,1,8
TRBV12-3/4,TRBJ2-7,CASSALGLAPDYEQYF,0,8,1,8
TRBV6-2/3/5/6,TRBJ2-1,CASRIKSGGSYNEQFF,0,8,1,8
TRBV29-1,TRBJ2-1,CSVSSRGQGYYNEQFF,0,8,1,8
TRBV29-1,TRBJ2-1,CSVEGTSGGAIDEQFF,0,8,1,8
TRBV7-7,TRBJ2-1,CASSLDWDSYNEQFF,0,8,1,8
TRBV19,TRBJ2-4,CASSLGQGAYNIQYF,0,8,1,8
TRBV19,TRBJ2-7,CASSDIGTGSYEQYF,0,8,1,8
TRBV19,TRBJ2-7,CASSIRRSSSYEQYF,0,8,1,8
TRBV19,TRBJ2-5,CASKAGGGPQETQYF,0,8,1,8
TRBV7-8,TRBJ2-3,CASIPGTGFWGTQYF,0,8,1,8
TRBV6-2/3/5/6,TRBJ2-3,CASSLGRGSTDTQYF,0,8,1,8
TRBV28,TRBJ1-6,CASSLNRPGNSPLHF,0,8,1,8
TRBV2,TRBJ2-2,CASSEARVGAGELFF,0,8,1,8
TRBV11-2,TRBJ1-6,CASSFTGVSRSPLHF,0,8,1,8
TRBV5-6,TRBJ1-2,CASSLPAGTGYGYTF,0,8,1,8
TRBV5-4,TRBJ1-2,CASSLNTVLNYGYTF,0,8,1,8
TRBV28,TRBJ1-4,CASSLLPGINEKLFF,0,8,1,8
TRBV3-1,TRBJ1-2,CASSLGDFFNYGYTF,0,8,1,8
TRBV9,TRBJ1-2,CASSPSSERIYGYTF,0,8,1,8
TRBV10-2,TRBJ2-7,CASTLGGWGSYEQYF,0,8,1,8
TRBV5-1,TRBJ1-5,CASSPGQEGDQPQHF,0,8,1,8
TRBV5-1,TRBJ1-3,CASSDWGVNGNTIYF,0,8,1,8
TRBV5-1,TRBJ1-5,CASSLGGSSNQPQHF,0,8,1,8
TRBV5-1,TRBJ2-7,CASSLRSGAVPEQYF,0,8,1,8
TRBV20-1,TRBJ2-3,CSAIRTGGEADTQYF,0,8,1,8
TRBV18,TRBJ1-2,CASSPGTGIEFDTF,0,8,1,8
TRBV18,TRBJ1-4,CASSPRQVNEKLFF,0,8,1,8
TRBV19,TRBJ2-5,CASSKQGPQETQYF,0,8,1,8
TRBV12-3/4,TRBJ1-5,CASTGSVSNQPQHF,0,8,1,8
TRBV2,TRBJ1-1,CASTMTAMETEAFF,0,8,1,8
TRBV28,TRBJ2-7,CASSFEGQPYEQHF,0,8,1,8
TRBV27,TRBJ1-1,CASSLGWSNTEAFF,0,8,1,8
TRBV2,TRBJ1-5,CASSGGQGYQPQHF,0,8,1,8
TRBV3-1,TRBJ2-3,CASSKAGNTDTQYF,0,8,1,8
TRBV7-2,TRBJ1-6,CASSSRVTGSPLHF,0,8,1,8
TRBV3-1,TRBJ2-7,CASSHRDRSYEQYF,0,8,1,8
TRBV3-1,TRBJ2-5,CASSQSAGQETQYF,0,8,1,8
TRBV10-2,TRBJ2-3,CASSEGERTDTQYF,0,8,1,8
TRBV5-1,TRBJ2-1,CASSLVEGRGEQFF,0,8,1,8
TRBV5-1,TRBJ1-2,CASSLDVYSRGYTF,0,8,1,8
TRBV5-1,TRBJ1-5,CASSPGTSNQPQHF,0,8,1,8
TRBV20-1,TRBJ1-1,CSAPRRTVNTEAFF,0,8,1,8
TRBV20-1,TRBJ1-6,CSAAPQVGNSPLHF,0,8,1,8
TRBV29-1,TRBJ1-1,CSVGPQGSNTEAFF,0,8,1,8
TRBV29-1,TRBJ2-2,CSVKGASMAGELFF,0,8,1,8
TRBV27,TRBJ2-7,CASSLAGTYEQYF,0,8,1,8
TRBV7-9,TRBJ1-1,CASSLVERTEAFF,0,8,1,8
TRBV11-2,TRBJ2-1,CASSLAFYNEQFF,0,8,1,8
TRBV7-9,TRBJ2-1,CASSLGQAFGQFF,0,8,1,8
TRBV5-6,TRBJ1-4,CASSWAPNEKLFF,0,8,1,8
TRBV2,TRBJ2-3,CASSPPFTDTQYF,0,8,1,8
TRBV5-6,TRBJ2-6,CASSRLGANVLTF,0,8,1,8
TRBV5-1,TRBJ1-1,CASSSIDRGEAFF,0,8,1,8
TRBV20-1,TRBJ2-7,CSAPGTGDLEQYF,0,8,1,8
TRBV20-1,TRBJ1-1,CSATNSLNTEAFF,0,8,1,8
TRBV29-1,TRBJ2-1,CSVRLDNPNEQFF,0,8,1,8
TRBV29-1,TRBJ1-1,CSVEDGLNTEAFF,0,8,1,8
TRBV28,TRBJ1-6,CATRGANSPLHF,0,8,1,8
TRBV6-2/3/5/6,TRBJ1-6,CASSYGDSPLHF,0,8,1,8
TRBV3-1,TRBJ2-3,CASSQLGDTQYF,0,8,1,8
TRBV20-1,TRBJ1-4,CSVRGRGEKLFF,0,8,1,8
TRBV29-1,TRBJ2-2,CSVRPYTGELFF,0,8,1,8
TRBV29-1,TRBJ1-1,CSVIQGNTEAFF,0,8,1,8
TRBV7-9,TRBJ2-1,CATSLGVEQFF,0,8,1,8
TRBV5-1,TRBJ2-7,CASRQGNRQYF,0,8,1,8
TRBV19,TRBJ2-3,CASPSSEGDDSDTQYF,0,8,1,8
TRBV19,TRBJ2-6,CASSMDSSGANVLTF,0,8,1,8
TRBV19,TRBJ2-2,CASSRGLAGGWDTGELFF,0,8,1,8
TRBV11-1,TRBJ2-1,CASSLAGASGYNEQFF,0,8,1,8
TRBV12-5,TRBJ1-1,CASGFGAGVGTEAFF,0,8,1,8
TRBV11-1,TRBJ1-1,CASSLAFTGWTEAFY,0,8,1,8
TRBV12-5,TRBJ1-6,CASGLRGQNPPLHF,0,8,1,8
TRBV5-4,TRBJ2-1,CASSLGGINEQFF,0,8,1,8
TRBV19,TRBJ2-3,CASSRPTGGLDTQYF,0,8,1,8
TRBV20-1,TRBJ2-3,CSAIAREKGTDTQYF,0,8,1,8
TRBV18,TRBJ1-1,CASSHAKGTEAFF,0,8,1,8
TRBV20-1,TRBJ2-5,CSARLAVLETQYF,0,8,1,8
TRBV5-5,TRBJ2-3,CASRGEPDTQYF,0,8,1,8
TRBV9,TRBJ2-7,CASSPSADQQTSEQYF,0,7,1,7
TRBV20-1,TRBJ1-1,CSARRGGRGLRVAFF,0,7,1,7
TRBV5-6,TRBJ2-1,CASSAGLAATEQFF,0,7,1,7
TRBV20-1,TRBJ2-7,CSARRPGTAYEQYF,0,7,1,7
TRBV29-1,TRBJ2-5,CSVTPPILGETQYF,0,7,1,7
TRBV19,TRBJ1-1,CASSLQGNTEAFF,0,7,1,7
TRBV2,TRBJ2-1,CASSAGPNNEQFF,0,7,1,7
TRBV29-1,TRBJ1-4,CSVEDRGARGVFF,0,7,1,7
TRBV6-1,TRBJ2-1,CASSGLGAHSTSSYNEQFF,0,7,1,7
TRBV6-2/3/5/6,TRBJ2-1,CASSYSIYAGTSYNEQFF,0,7,1,7
TRBV28,TRBJ1-1,CASSPLRRTGYNTEAFF,0,7,1,7
TRBV7-2,TRBJ2-7,CASSLVVAAGAYEQYF,0,7,1,7
TRBV5-1,TRBJ2-5,CASDASPGGGAETQYF,0,7,1,7
TRBV5-1,TRBJ2-3,CASSLNWGGITDTQYF,0,7,1,7
TRBV2,TRBJ1-3,CATKYGGYSGNTIYF,0,7,1,7
TRBV18,TRBJ1-2,CASSPSTGHNYGYTF,0,7,1,7
TRBV9,TRBJ2-3,CASSEGSGSTDTQYF,0,7,1,7
TRBV20-1,TRBJ1-1,CSARDWAGENTEAFF,0,7,1,7
TRBV30,TRBJ1-3,CAWSRDSSGNTIYF,0,7,1,7
TRBV7-2,TRBJ2-7,CANSPTGQGHGQYF,0,7,1,7
TRBV5-1,TRBJ2-7,CASSLERSSYEQCF,0,7,1,7
TRBV20-1,TRBJ1-5,CSATPDSSNQPQHF,0,7,1,7
TRBV2,TRBJ1-1,CASAKNTEAFF,0,7,1,7
TRBV12-3/4,TRBJ1-6,CASSRWRFDGKNSPLHHHLHF,0,7,1,7
TRBV19,TRBJ1-5,CASSTPSGDSHYSNQPQHF,0,7,1,7
TRBV3-1,TRBJ2-1,CASSPRTSGGIFYNEQFF,0,7,1,7
TRBV6-4,TRBJ1-1,CASSGEGQGSPWGTEAFF,0,7,1,7
TRBV5-1,TRBJ1-3,CASSLGRPSSVSGNTIYF,0,7,1,7
TRBV4-1,TRBJ2-4,CASSLSNGGSKAKNIQYF,0,7,1,7
TRBV5-1,TRBJ2-1,CASSRTSGGPTIYNEQFF,0,7,1,7
TRBV20-1,TRBJ2-1,CSARDRMAGGSSYNEQFF,0,7,1,7
TRBV7-9,TRBJ2-3,CASSSWDRGRQTDTQYF,0,7,1,7
TRBV12-3/4,TRBJ2-3,CASSPRAGGVRTDTQYF,0,7,1,7
TRBV6-1,TRBJ1-5,CASSRIPGQIANQPQHF,0,7,1,7
TRBV7-2,TRBJ2-1,CASSLGGSGGAHNEQLF,0,7,1,7
TRBV7-2,TRBJ1-1,CASSLIGGVNTNTEAFF,0,7,1,7
TRBV11-2,TRBJ2-5,CASSIGTSGGAAETQYF,0,7,1,7
TRBV28,TRBJ2-4,CASRGAGGALAKNIQYF,0,7,1,7
TRBV5-1,TRBJ1-1,CASSLPKGRFWDTEAFF,0,7,1,7
TRBV20-1,TRBJ2-5,CSARALSSGGDSETQYF,0,7,1,7
TRBV12-5,TRBJ1-4,CASGLSRGFTNEKLVF,0,7,1,7
TRBV19,TRBJ2-4,CASSIGGGWSKNIQYF,0,7,1,7
TRBV5-6,TRBJ2-4,CASTTTGMLAKNIQYF,0,7,1,7
TRBV6-2/3/5/6,TRBJ1-5,CASTGPGSYSNQPQHF,0,7,1,7
TRBV6-2/3/5/6,TRBJ2-2,CASSLSGPTNAGELFF,0,7,1,7
TRBV6-2/3/5/6,TRBJ1-2,CASSSPDLLRSYGYTF,0,7,1,7
TRBV6-2/3/5/6,TRBJ2-7,CASSRGNAGTEYEQYF,0,7,1,7
TRBV11-2,TRBJ2-7,CASSLVRAVTSYEQYL,0,7,1,7
TRBV7-3,TRBJ2-3,CASSLISSGGRYTQYF,0,7,1,7
TRBV3-1,TRBJ2-1,CASSSPLAETYNEQFF,0,7,1,7
TRBV5-1,TRBJ2-3,CASSLSLAGGTDTQYF,0,7,1,7
TRBV20-1,TRBJ1-2,CSARNPVGATLYGYTF,0,7,1,7
TRBV10-3,TRBJ2-5,CAISESGGSGETQYF,0,7,1,7
TRBV10-3,TRBJ2-3,CAISESTINPDTQYF,0,7,1,7
TRBV19,TRBJ2-2,CASSSLPGNTGELFF,0,7,1,7
TRBV18,TRBJ2-6,CASSPLGSGANVLTF,0,7,1,7
TRBV18,TRBJ1-1,CASSHKQGLNTEAFF,0,7,1,7
TRBV28,TRBJ2-3,CASSFSTSSIDTQYF,0,7,1,7
TRBV12-3/4,TRBJ2-1,CASSLLPNSYNEQFF,0,7,1,7
TRBV6-2/3/5/6,TRBJ2-5,CASSLDGTGKETQYF,0,7,1,7
TRBV12-3/4,TRBJ2-2,CASSYDRGRPGELFF,0,7,1,7
TRBV6-2/3/5/6,TRBJ2-1,CASSYHRGRGVEQFF,0,7,1,7
TRBV28,TRBJ2-6,CASSPNRAGANVLTF,0,7,1,7
TRBV2,TRBJ2-1,CASSEGLAGANEQFF,0,7,1,7
TRBV7-2,TRBJ1-6,CASSFRDRGNSPLHF,0,7,1,7
TRBV11-2,TRBJ2-2,CASSLTSGAVGELFF,0,7,1,7
TRBV7-9,TRBJ1-4,CASSLELATNEKLFF,0,7,1,7
TRBV7-9,TRBJ2-7,CASSSPGQGTYEQYF,0,7,1,7
TRBV7-2,TRBJ1-1,CASSLETGQGTEAFF,0,7,1,7
TRBV3-1,TRBJ2-3,CASSPTGQGAFTQYF,0,7,1,7
TRBV3-1,TRBJ2-3,CASSHRGGGTDTQYF,0,7,1,7
TRBV3-1,TRBJ2-7,CASSHGSAGAYEQYF,0,7,1,7
TRBV3-1,TRBJ2-1,CASSQARSSYNEQFF,0,7,1,7
TRBV12-3/4,TRBJ2-5,CASRPTSGGQETQYF,0,7,1,7
TRBV12-3/4,TRBJ1-6,CASRPDRGANSPLHF,0,7,1,7
TRBV18,TRBJ1-5,CASSPPGGLNQPQHF,0,7,1,7
TRBV5-1,TRBJ1-1,CASSYLTGAGTEAFF,0,7,1,7
TRBV4-1,TRBJ1-1,CASSQPIRGNTEAFF,0,7,1,7
TRBV20-1,TRBJ2-7,CSAREGPPKAYEQYF,0,7,1,7
TRBV20-1,TRBJ2-2,CSARVGGAQTGELFF,0,7,1,7
TRBV29-1,TRBJ1-5,CSVEVTGDSNQPQHF,0,7,1,7
TRBV29-1,TRBJ2-1,CSVETSGGSYNEQFF,0,7,1,7
TRBV29-1,TRBJ2-3,CSVRQGDGSTDTQYF,0,7,1,7
TRBV29-1,TRBJ2-3,CSAGTGGWSTDTQYF,0,7,1,7
TRBV19,TRBJ1-1,CASSLHNGNTEAFF,0,7,1,7
TRBV19,TRBJ1-5,CASSIARSNQPQHF,0,7,1,7
TRBV2,TRBJ2-1,CASLGYLSYNEQFF,0,7,1,7
TRBV18,TRBJ2-5,CASSPWAPQEAQYF,0,7,1,7
TRBV18,TRBJ2-3,CASSPPGGSDTQYF,0,7,1,7
TRBV5-6,TRBJ2-7,CASASPDRTYEQYF,0,7,1,7
TRBV28,TRBJ2-7,CASGGLAPLREQYF,0,7,1,7
TRBV12-3/4,TRBJ2-7,CASSFRTGGGEQYF,0,7,1,7
TRBV28,TRBJ1-1,CASSLWTVNTEAFF,0,7,1,7
TRBV6-2/3/5/6,TRBJ2-7,CASSLGLEVYEQYF,0,7,1,7
TRBV12-3/4,TRBJ2-3,CASSSGTVKDTQYF,0,7,1,7
TRBV12-3/4,TRBJ1-1,CASSPQGTNTEAFF,0,7,1,7
TRBV6-1,TRBJ2-3,CASSVLGSSDTQYF,0,7,1,7
TRBV7-8,TRBJ1-2,CASSRTGTSYGYTF,0,7,1,7
TRBV5-4,TRBJ2-7,CASSFGGPSYEQYF,0,7,1,7
TRBV5-4,TRBJ2-3,CASSLATGTDTQYF,0,7,1,7
TRBV5-6,TRBJ2-7,CASSLEGFPYEQYF,0,7,1,7
TRBV11-2,TRBJ1-5,CASSLVPLGQPQHF,0,7,1,7
TRBV28,TRBJ2-5,CASSPPGNLKTQYF,0,7,1,7
TRBV3-1,TRBJ1-4,CASSQRQPNEKLFF,0,7,1,7
TRBV2,TRBJ2-7,CASRGDRESYEQYF,0,7,1,7
TRBV10-2,TRBJ2-3,CASTLAGGADTQYF,0,7,1,7
TRBV5-1,TRBJ2-5,CASSLATIGETQYF,0,7,1,7
TRBV5-1,TRBJ2-7,CASSLGNRGDEQYF,0,7,1,7
TRBV4-1,TRBJ2-1,CASSQVNAGDKQFF,0,7,1,7
TRBV5-1,TRBJ2-5,CASSAADRGKTQYF,0,7,1,7
TRBV5-1,TRBJ2-1,CASSIRDSYNEQFF,0,7,1,7
TRBV5-1,TRBJ2-7,CASRATDDTYEQYF,0,7,1,7
TRBV20-1,TRBJ2-1,CSARVAGTHGEQFF,0,7,1,7
TRBV20-1,TRBJ2-4,CSARDPRGAVIQYF,0,7,1,7
TRBV2,TRBJ2-5,CASLRDSRGTQYF,0,7,1,7
TRBV18,TRBJ1-1,CASSPTVNTEAFF,0,7,1,7
TRBV18,TRBJ2-3,CASSPPLVMPQYF,0,7,1,7
TRBV18,TRBJ1-5,CASSPTWNQPQHF,0,7,1,7
TRBV2,TRBJ1-2,CASMQGVNYGYTF,0,7,1,7
TRBV12-3/4,TRBJ1-2,CASSLAISYGYTF,0,7,1,7
TRBV28,TRBJ2-7,CASSSDRGQRLLF,0,7,1,7
TRBV6-2/3/5/6,TRBJ1-2,CASSSSTADGYTF,0,7,1,7
TRBV6-2/3/5/6,TRBJ1-1,CASSYSDRGWAFF,0,7,1,7
TRBV6-2/3/5/6,TRBJ2-2,CASSYGFAGELFF,0,7,1,7
TRBV7-9,TRBJ2-5,CASSFVGVETQYF,0,7,1,7
TRBV7-9,TRBJ2-2,CASSRINTGELFF,0,7,1,7
TRBV14,TRBJ1-1,CASSQDPQGRAFF,0,7,1,7
TRBV5-4,TRBJ1-2,CASSGTGAVGYTF,0,7,1,7
TRBV10-1,TRBJ1-1,CATAPFSSSRTFF,0,7,1,7
TRBV5-1,TRBJ1-1,CASSDIRGTEAFF,0,7,1,7
TRBV5-1,TRBJ2-1,CASSLLVYNEQFF,0,7,1,7
TRBV20-1,TRBJ1-5,CSASRGINQPQHF,0,7,1,7
TRBV20-1,TRBJ1-1,CSARSGRNTEAFF,0,7,1,7
TRBV20-1,TRBJ1-5,CSARGQNNQPQHF,0,7,1,7
TRBV29-1,TRBJ2-7,CSVVSGVSYEQYF,0,7,1,7
TRBV29-1,TRBJ2-2,CSVRTGTTGELFF,0,7,1,7
TRBV29-1,TRBJ1-1,CSTALQGNTEAFF,0,7,1,7
TRBV30,TRBJ2-6,CAVGSGANVLTF,0,7,1,7
TRBV10-3,TRBJ1-1,CAISESGGQAFF,0,7,1,7
TRBV24-1,TRBJ1-2,CATSDRGSGYTF,0,7,1,7
TRBV28,TRBJ2-3,CASWGGTDTQYF,0,7,1,7
TRBV12-3/4,TRBJ2-5,CASRDFQETQYF,0,7,1,7
TRBV27,TRBJ2-1,CASSSRTGGEFF,0,7,1,7
TRBV6-2/3/5/6,TRBJ1-2,CASSSSSLPYTF,0,7,1,7
TRBV6-1,TRBJ1-5,CASSEPNQPQHF,0,7,1,7
TRBV5-4,TRBJ2-5,CASSLGEGTQYF,0,7,1,7
TRBV11-3,TRBJ2-1,CASSLISEEQFF,0,7,1,7
TRBV28,TRBJ1-1,CASSWAGTRAFF,0,7,1,7
TRBV3-1,TRBJ2-7,CASSRRTGLKYF,0,7,1,7
TRBV16,TRBJ1-1,CASSQTGTETFF,0,7,1,7
TRBV10-1,TRBJ2-7,CATSTGSLEQYF,0,7,1,7
TRBV20-1,TRBJ2-7,CSAWTRSYEQYF,0,7,1,7
TRBV29-1,TRBJ1-1,CSVDSVYTEAFL,0,7,1,7
TRBV29-1,TRBJ1-2,CSVEVAQSGYTF,0,7,1,7
TRBV29-1,TRBJ2-3,CSARLTGSTQYF,0,7,1,7
TRBV28,TRBJ2-1,CASIQFNEQFF,0,7,1,7
TRBV12-3/4,TRBJ2-1,CASSLMAVPSF,0,7,1,7
TRBV29-1,TRBJ2-3,CSVETRSKQYF,0,7,1,7
TRBV18,TRBJ2-3,CASSPKATWARTDTQYF,0,6,1,6
TRBV7-2,TRBJ2-7,CASSFLGRGSSSYEQYF,0,6,1,6
TRBV6-2/3/5/6,TRBJ2-3,CASSLDGGAETDTQYF,0,6,1,6
TRBV11-1,TRBJ2-1,CASSLAWGLADEQFF,0,6,1,6
TRBV7-9,TRBJ2-5,CASSSRAGARETQYF,0,6,1,6
TRBV3-1,TRBJ2-7,CASSPRDSSNYEQYF,0,6,1,6
TRBV5-1,TRBJ2-3,CASSSAGESTDTQYF,0,6,1,6
TRBV2,TRBJ2-1,CASTWDRGANEQFF,0,6,1,6
TRBV4-1,TRBJ1-2,CASSQPTGLGGYTF,0,6,1,6
TRBV2,TRBJ2-1,CASSGVGGNEQFF,0,6,1,6
TRBV20-1,TRBJ1-5,CSARPLGIGDLISYSNQPQHF,0,6,1,6
TRBV28,TRBJ2-4,CASSLGRAQVGRPKNIQYF,0,6,1,6
TRBV6-2/3/5/6,TRBJ2-6,CASSLGLAGGPSGANILTF,0,6,1,6
TRBV5-1,TRBJ1-1,CASSLPPFPRRRQVPEAFF,0,6,1,6
TRBV19,TRBJ2-2,CASTPRLAGGPNTGELFF,0,6,1,6
TRBV19,TRBJ2-1,CASSIDLPSGGVYNEQFF,0,6,1,6
TRBV12-3/4,TRBJ2-5,CASSLRLAGDTLQGTQYF,0,6,1,6
TRBV7-2,TRBJ2-3,CASSSDPLYGARTDTQYF,0,6,1,6
TRBV5-1,TRBJ1-1,CASSSLISGTGSGTEAFF,0,6,1,6
TRBV4-1,TRBJ2-6,CASSQDRGQGPGANVLTF,0,6,1,6
TRBV4-1,TRBJ1-5,CASSNRDMGFGFNQPQHF,0,6,1,6
TRBV5-1,TRBJ2-3,CASNPGLAGGLSTDTQYF,0,6,1,6
TRBV29-1,TRBJ1-1,CSVPPDRGEAGENTEAFF,0,6,1,6
TRBV10-3,TRBJ1-5,CAISESLSGADNQPQHF,0,6,1,6
TRBV18,TRBJ1-5,CASSPFETEYSNQPQHF,0,6,1,6
TRBV18,TRBJ2-5,CASSPPLGQLWQETQYF,0,6,1,6
TRBV18,TRBJ1-6,CASSPPNMGSPNSPLHF,0,6,1,6
TRBV18,TRBJ1-6,CASTEPDRYFYNSPLHF,0,6,1,6
TRBV7-9,TRBJ2-5,CASSYNVAGGLRETQYF,0,6,1,6
TRBV11-2,TRBJ2-5,CASSSTRTGGTQETQYF,0,6,1,6
TRBV7-9,TRBJ2-2,CASRPRLAAANTGELFF,0,6,1,6
TRBV4-1,TRBJ1-5,CASSEDWGGVLGQPQHF,0,6,1,6
TRBV29-1,TRBJ2-4,CSVGLGQARLPKNIQYF,0,6,1,6
TRBV29-1,TRBJ2-3,CSVENLKASASTDTQYF,0,6,1,6
TRBV12-5,TRBJ1-4,CASGFYHRGAHEKLFF,0,6,1,6
TRBV12-5,TRBJ1-1,CASGRRTGSMNTEAFF,0,6,1,6
TRBV10-3,TRBJ2-1,CAISEVGGGARDEQFF,0,6,1,6
TRBV19,TRBJ1-5,CASSTRPQAGNQPQHF,0,6,1,6
TRBV18,TRBJ2-1,CASSPFGTGDYNEQFF,0,6,1,6
TRBV12-3/4,TRBJ2-2,CASSLDSGGPPGELFF,0,6,1,6
TRBV6-2/3/5/6,TRBJ2-5,CASSYRLTGGPETQYF,0,6,1,6
TRBV28,TRBJ1-2,CASSPPGQGLNYGYTF,0,6,1,6
TRBV27,TRBJ2-7,CASSPSIGQGFYEQYF,0,9,1,9
TRBV3-1,TRBJ2-3,CASSFRTGARTDTQYF,0,6,1,6
TRBV7-2,TRBJ1-5,CASSLFPPYSNQPQHF,0,6,1,6
TRBV13,TRBJ2-3,CASSLRAGTRTDTQYF,0,6,1,6
TRBV7-9,TRBJ2-1,CASSYRPGDRNNEQFF,0,6,1,6
TRBV5-1,TRBJ2-3,CASSFGASGGTDTQYF,0,6,1,6
TRBV5-1,TRBJ1-6,CASSLAGEAYNSPLHF,0,6,1,6
TRBV5-1,TRBJ2-3,CASSRLGGTNTDTQYF,0,6,1,6
TRBV5-1,TRBJ2-1,CASSVGLAGGVHEQFF,0,6,1,6
TRBV29-1,TRBJ2-1,CSVGGVGGATYNEQFF,0,6,1,6
TRBV20-1,TRBJ1-3,CSASKGVSQAGNTIYF,0,6,1,6
TRBV7-6,TRBJ2-3,CASSPGLAAADTQYF,0,6,1,6
TRBV15,TRBJ2-5,CATSRDRQGAQTQYF,0,6,1,6
TRBV19,TRBJ1-1,CASIGSGRVFPEAFF,0,6,1,6
TRBV19,TRBJ1-2,CASSSSDRGNYGYTF,0,6,1,6
TRBV19,TRBJ2-3,CASSTGTSRTDTQYF,0,6,1,6
TRBV19,TRBJ2-2,CASKRTSGFTGELFF,0,6,1,6
TRBV18,TRBJ2-7,CASSPTLTGTYEQYF,0,6,1,6
TRBV18,TRBJ1-5,CASSPWEGENQPQHF,0,6,1,6
TRBV18,TRBJ1-4,CASSPSTGVDEKLFF,0,6,1,6
TRBV28,TRBJ1-5,CASISSLGDNQPQHF,0,6,1,6
TRBV6-2/3/5/6,TRBJ1-2,CASSFAGHPNYGYTF,0,6,1,6
TRBV28,TRBJ2-3,CASSFNRGATDTQYF,0,6,1,6
TRBV12-3/4,TRBJ1-5,CASSSQGALNQPQHF,0,6,1,6
TRBV6-2/3/5/6,TRBJ1-5,CASSYSRGSNQPQHF,0,6,1,6
TRBV6-2/3/5/6,TRBJ1-2,CASSPSGDGIYGYTF,0,6,1,6
TRBV6-1,TRBJ2-5,CASSELAGGQETQYF,0,6,1,6
TRBV28,TRBJ2-1,CASSTLAGGVNEQFF,0,6,1,6
TRBV5-5,TRBJ2-2,CASSLVSRVPGELFF,0,6,1,6
TRBV5-5,TRBJ1-1,CASSLGGTDNTEAFF,0,6,1,6
TRBV7-2,TRBJ1-2,CASSLSTGSNYGYTF,0,6,1,6
TRBV13,TRBJ2-7,CASSLVGVGSYEQYF,0,6,1,6
TRBV7-2,TRBJ2-1,CASSLGLLVYNEQFF,0,6,1,6
TRBV7-3,TRBJ2-3,CASSSSGGVADTQYF,0,6,1,6
TRBV28,TRBJ2-3,CASSWVRSSTDTQYF,0,6,1,6
TRBV5-6,TRBJ2-3,CASSPGLAGTDTQYF,0,6,1,6
TRBV7-3,TRBJ2-1,CASSRIGSSYNEQFF,0,6,1,6
TRBV3-1,TRBJ2-3,CASSQGGLSADTQYF,0,6,1,6
TRBV16,TRBJ1-1,CASSQFDSPHTEAFF,0,6,1,6
TRBV14,TRBJ2-1,CASSQVASSYNEQFF,0,6,1,6
TRBV11-2,TRBJ2-3,CASSQASGLGNTQYF,0,6,1,6
TRBV3-1,TRBJ1-5,CASSQDWHSNQPQHF,0,6,1,6
TRBV4-2,TRBJ2-1,CASSQDKTGYNEQFF,0,6,1,6
TRBV7-9,TRBJ2-1,CASSILAGGLNEQFF,0,6,1,6
TRBV7-3,TRBJ2-4,CASSTSASAKNIQYF,0,6,1,6
TRBV7-9,TRBJ1-4,CASSTGGATNEKLFF,0,6,1,6
TRBV28,TRBJ1-1,CASSNRGSANTEAFF,0,6,1,6
TRBV7-9,TRBJ1-1,CASRGQGSPDTEAFF,0,6,1,6
TRBV6-2/3/5/6,TRBJ1-3,CASRGTQGARNTIYF,0,6,1,6
TRBV19,TRBJ2-1,CASSSGTGGWNEQFV,0,6,1,6
TRBV5-1,TRBJ2-3,CASSLGHYSTDTQYF,0,6,1,6
TRBV5-1,TRBJ1-1,CASSLRTGLNTESFF,0,6,1,6
TRBV5-1,TRBJ2-7,CASSEGTGRTYEQYF,0,6,1,6
TRBV20-1,TRBJ1-5,CSAAEGAYRRQPQHF,0,6,1,6
TRBV20-1,TRBJ1-4,CSAMGYGTLNEKLFF,0,6,1,6
TRBV20-1,TRBJ1-6,CSATPGGAGNSPLHF,0,6,1,6
TRBV20-1,TRBJ2-7,CSASHLGVLKYEQYF,0,6,1,6
TRBV20-1,TRBJ2-5,CSARRGSGDQETQYF,0,6,1,6
TRBV20-1,TRBJ2-5,CSAREAGGIQETQYF,0,6,1,6
TRBV29-1,TRBJ2-6,CSVGGPVGGANVLTF,0,6,1,6
TRBV29-1,TRBJ1-4,CSVETSGWNGEKLFF,0,6,1,6
TRBV29-1,TRBJ1-5,CSVDAGVVGNQPQHF,0,6,1,6
TRBV29-1,TRBJ2-6,CSAGVGHGEANVLTF,0,6,1,6
TRBV19,TRBJ1-1,CASIPTGVYTEAFF,0,6,1,6
TRBV19,TRBJ1-4,CASTDRESNEKLFF,0,6,1,6
TRBV19,TRBJ1-1,CASSPRQASVPAFF,0,6,1,6
TRBV18,TRBJ2-5,CASSPRRDQETQYF,0,6,1,6
TRBV27,TRBJ1-3,CASARVGAGNTIYF,0,6,1,6
TRBV2,TRBJ2-5,CASIKGPLTETQYF,0,6,1,6
TRBV2,TRBJ2-3,CASTRTSGTDTQYF,0,6,1,6
TRBV12-3/4,TRBJ2-7,CASSFWGASYEQYF,0,6,1,6
TRBV12-3/4,TRBJ2-7,CASSFNEGQSFTYF,0,6,1,6
TRBV6-2/3/5/6,TRBJ2-7,CASSFLTGGYEQYF,0,6,1,6
TRBV12-3/4,TRBJ1-6,CASSFGRDNSPLHF,0,6,1,6
TRBV28,TRBJ1-5,CASSLSLGLQPQHF,0,6,1,6
TRBV2,TRBJ1-5,CASSSSWGNQPQHF,0,6,1,6
TRBV6-2/3/5/6,TRBJ2-1,CASSSTDRYNEQFF,0,6,1,6
TRBV2,TRBJ1-1,CASSYYRAGAEAFF,0,6,1,6
TRBV6-1,TRBJ1-1,CASSVRQPNTEAFF,0,6,1,6
TRBV5-4,TRBJ2-3,CASSLAGATDTQYF,0,6,1,6
TRBV5-5,TRBJ1-1,CASSLDSGHTEALF,0,6,1,6
TRBV7-2,TRBJ2-3,CASSLVHRTSGGPE,0,6,1,6
TRBV7-9,TRBJ1-5,CASSLEAGNQPQHF,0,6,1,6
TRBV7-9,TRBJ1-1,CASSLELMNTEAFF,0,6,1,6
TRBV11-2,TRBJ2-3,CASSLGLSTDTQYF,0,8,1,8
TRBV12-3/4,TRBJ1-1,CASSRDTQDTEAFF,0,6,1,6
TRBV12-3/4,TRBJ2-1,CASSRQGPYNEQFF,0,6,1,6
TRBV5-5,TRBJ2-4,CASSQVIAKNIQYF,0,6,1,6
TRBV3-1,TRBJ1-6,CASSQASVDSPLHF,0,6,1,6
TRBV3-1,TRBJ2-7,CASSQGPTGTEQYF,0,6,1,6
TRBV3-1,TRBJ2-5,CASSQGLAAKTQYF,0,6,1,6
TRBV3-1,TRBJ2-2,CASSQEGATGELFF,0,6,1,6
TRBV9,TRBJ2-3,CASSVAEAGDTQYF,0,6,1,6
TRBV5-4,TRBJ2-4,CASSARTGGNIQYF,0,6,1,6
TRBV6-1,TRBJ1-2,CASSETGGTYGYTF,0,6,1,6
TRBV28,TRBJ1-2,CASSKTGGGWGYTF,0,6,1,6
TRBV28,TRBJ2-7,CASRLQGGNHEQYF,0,6,1,6
TRBV12-3/4,TRBJ2-7,CAKGLAGLTYEQYF,0,6,1,6
TRBV5-1,TRBJ1-4,CASSLTVGNEKLFF,0,6,1,6
TRBV5-1,TRBJ2-6,CASSLASGANVLTF,0,6,1,6
TRBV5-1,TRBJ1-6,CASSSDRGDSPLHF,0,6,1,6
TRBV5-1,TRBJ2-3,CASSPRTVSDTQYF,0,6,1,6
TRBV5-1,TRBJ1-1,CASSPQTGDTEAFF,0,6,1,6
TRBV5-1,TRBJ1-1,CASSAGVWGTEAFF,0,6,1,6
TRBV20-1,TRBJ2-5,CSARLPGGQETQYF,0,6,1,6
TRBV20-1,TRBJ2-5,CSARPGTEVKTQYF,0,6,1,6
TRBV20-1,TRBJ1-6,CSAREDRGNSPLHF,0,6,1,6
TRBV20-1,TRBJ1-1,CSAPDGGVNTEAFF,0,6,1,6
TRBV20-1,TRBJ2-7,CSAIVWDSTYEQYF,0,6,1,6
TRBV20-1,TRBJ2-3,CSAKGIAGTDTRYF,0,6,1,6
TRBV29-1,TRBJ2-7,CSVVDRAFSYEQYF,0,6,1,6
TRBV29-1,TRBJ1-3,CSVDPAGTGNTIYF,0,6,1,6
TRBV29-1,TRBJ2-1,CSVAGLPGVNEQFF,0,6,1,6
TRBV20-1,TRBJ2-3,CSARTSGGTDTQYF,0,6,1,6
TRBV29-1,TRBJ1-1,CSAELTAANTEAFF,0,6,1,6
TRBV29-1,TRBJ1-5,CSASGQNSNQPQHF,0,6,1,6
TRBV30,TRBJ2-7,CAWSGDRGREQYF,0,6,1,6
TRBV15,TRBJ1-6,CATSLNPGSPLHF,0,6,1,6
TRBV2,TRBJ1-5,CATKTGVGQPQHF,0,6,1,6
TRBV19,TRBJ2-1,CASSYGLYNEQFF,0,6,1,6
TRBV19,TRBJ2-7,CASSMGQNYEQYF,0,6,1,6
TRBV12-3/4,TRBJ2-3,CASLAGGTDTQYF,0,6,1,6
TRBV2,TRBJ2-1,CASTAGPYNEQFF,0,6,1,6
TRBV27,TRBJ1-1,CASSFRGGTEAFF,0,6,1,6
TRBV28,TRBJ1-5,CASSLRGNQPQHF,0,6,1,6
TRBV27,TRBJ1-1,CASSTTVYSEAFF,0,6,1,6
TRBV7-2,TRBJ2-7,CASSLAGSLGQYF,0,6,1,6
TRBV5-5,TRBJ2-5,CASSWAAEETQYF,0,6,1,6
TRBV6-2/3/5/6,TRBJ2-7,CASSLRTAYEQYF,0,6,1,6
TRBV16,TRBJ2-7,CASSQGGSYEQYF,0,6,1,6
TRBV5-6,TRBJ1-2,CASSGQGTYGYTF,0,6,1,6
TRBV11-2,TRBJ1-2,CASSENVEYGYTF,0,6,1,6
TRBV28,TRBJ2-5,CASRSTGKETQYF,0,6,1,6
TRBV2,TRBJ2-3,CASRGTSVDTQYF,0,6,1,6
TRBV6-2/3/5/6,TRBJ2-7,CASKDRGAYEQYF,0,6,1,6
TRBV5-1,TRBJ2-1,CASSLGSAGTRFF,0,6,1,6
TRBV20-1,TRBJ2-3,CSARRSSTDTQYF,0,6,1,6
TRBV20-1,TRBJ1-1,CSARDRGETEAFF,0,6,1,6
TRBV29-1,TRBJ2-5,CSVGGGLGETQYF,0,6,1,6
TRBV29-1,TRBJ2-3,CSVEWQSTDTQYF,0,6,1,6
TRBV29-1,TRBJ2-1,CSMGTATYNEQFF,0,6,1,6
TRBV10-3,TRBJ2-5,CAIRGREETQYF,0,6,1,6
TRBV6-2/3/5/6,TRBJ1-1,CASRQGGTEAFF,0,6,1,6
TRBV12-3/4,TRBJ2-2,CASGSDGGELFF,0,6,1,6
TRBV6-2/3/5/6,TRBJ1-5,CASSLFASAQHF,0,6,1,6
TRBV28,TRBJ1-2,CASSLPVYGYTF,0,6,1,6
TRBV6-4,TRBJ1-6,CASSLSDSPLHF,0,6,1,6
TRBV2,TRBJ2-5,CASSDRVETQYF,0,6,1,6
TRBV28,TRBJ1-6,CASSDTGAPLHF,0,6,1,6
TRBV2,TRBJ2-7,CASSEGAAEQYF,0,6,1,6
TRBV6-2/3/5/6,TRBJ1-5,CASSSQGQPQHF,0,6,1,6
TRBV7-9,TRBJ2-3,CASSLVGDTQYF,0,6,1,6
TRBV7-2,TRBJ1-5,CASSLESSTQHF,0,6,1,6
TRBV7-9,TRBJ2-7,CASSPRGDEQYF,0,6,1,6
TRBV28,TRBJ1-1,CASRTGFTEAFF,0,6,1,6
TRBV3-1,TRBJ2-1,CASKLPGGTQFF,0,6,1,6
TRBV10-2,TRBJ2-7,CASSGTSYEQYF,0,6,1,6
TRBV5-1,TRBJ2-3,CASSLGSDTQYF,0,6,1,6
TRBV20-1,TRBJ1-4,CSATENNEKLFF,0,6,1,6
TRBV20-1,TRBJ2-5,CSAKAQARGQYF,0,6,1,6
TRBV29-1,TRBJ1-1,CSALRWNTEAFF,0,6,1,6
TRBV29-1,TRBJ2-4,CSIVPDRNIQYF,0,6,1,6
TRBV28,TRBJ2-1,CASGYSFEQFF,0,6,1,6
TRBV6-2/3/5/6,TRBJ2-1,CASSFSNEQFF,0,6,1,6
TRBV2,TRBJ2-7,CASSVFYEQYF,0,6,1,6
TRBV6-1,TRBJ2-7,CASSALYEQYF,0,6,1,6
TRBV7-2,TRBJ2-3,CASSLESLAAF,0,6,1,6
TRBV5-4,TRBJ2-7,CASSSPRRQYF,0,6,1,6
TRBV5-1,TRBJ1-1,CASSGGAEAFF,0,6,1,6
TRBV29-1,TRBJ2-1,CSVYSYNEQFF,0,6,1,6
TRBV29-1,TRBJ2-1,CSHLRGHEQFF,0,6,1,6
TRBV5-1,TRBJ1-2,CASSSYRGRDFYYGYTF,0,6,1,6
TRBV11-2,TRBJ2-1,CASSLGGGQFNEQFF,0,6,1,6
TRBV20-1,TRBJ2-7,CSARPLFGGQHEQYF,0,6,1,6
TRBV20-1,TRBJ1-1,CSARDAQGGNTEAFF,0,6,1,6
TRBV19,TRBJ1-1,CASSISPGNTEAFF,0,6,1,6
TRBV5-5,TRBJ2-7,CASSLQGDSYEQYF,0,6,1,6
TRBV20-1,TRBJ2-2,CSARPPRGTGELFF,0,6,1,6
TRBV30,TRBJ2-3,CAWSVQTADTQYF,0,6,1,6
TRBV28,TRBJ1-4,CASSLTNEKLFF,0,6,1,6
TRBV16,TRBJ2-4,CASSPDKNIQCF,0,6,1,6
TRBV29-1,TRBJ2-7,CSVDGGQF,0,6,1,6
TRBV6-2/3/5/6,TRBJ1-1,CASSYSPDREGLADTEAFF,0,5,1,5
TRBV5-1,TRBJ2-2,CASSLVLAGGLGFSGELFF,0,5,1,5
TRBV28,TRBJ2-5,CAGSLIGRMRDLQETQYF,0,5,1,5
TRBV19,TRBJ1-5,CASSPSRTSSYSNQPQHF,0,5,1,5
TRBV6-2/3/5/6,TRBJ2-3,CASTSRPPTSGGAYTQYF,0,5,1,5
TRBV28,TRBJ2-6,CASSFPGQGPSGANVLTF,0,5,1,5
TRBV2,TRBJ2-7,CASSEGPSGGLFSYEQYF,0,5,1,5
TRBV5-6,TRBJ1-1,CASSLGQGAPVWSTEAFF,0,5,1,5
TRBV7-8,TRBJ2-1,CASSLGSERGAKRNEQFF,0,5,1,5
TRBV14,TRBJ1-5,CASSLLLGRDYSNQPQHF,0,5,1,5
TRBV7-2,TRBJ2-1,CASSPGLAGVSSYNEQFF,0,5,1,5
TRBV5-1,TRBJ2-7,CASSSGISGGATRTEQYF,0,5,1,5
TRBV4-1,TRBJ2-3,CASSQPRGSFTSTDTQYF,0,5,1,5
TRBV5-6,TRBJ2-1,CSSSLGVWTSGGNEQFF,0,5,1,5
TRBV12-5,TRBJ1-1,CASGLVPGTGSVTEAFF,0,5,1,5
TRBV30,TRBJ2-2,CAWNKALQRANTGELFF,0,5,1,5
TRBV19,TRBJ1-5,CASGDLGVPGRDQPQHF,0,5,1,5
TRBV19,TRBJ1-1,CASSIGHWVEAKTEAFF,0,5,1,5
TRBV19,TRBJ2-2,CASSMIAPSQGTGELFF,0,5,1,5
TRBV2,TRBJ2-3,CASGGGGVSESTDTQYF,0,5,1,5
TRBV6-2/3/5/6,TRBJ2-2,CASSLSLMQVTAGELFF,0,5,1,5
TRBV6-2/3/5/6,TRBJ2-3,CASSLEGLAGGRDTQYF,0,5,1,5
TRBV6-2/3/5/6,TRBJ1-6,CASSSTGLGPSNSPLHF,0,5,1,5
TRBV6-2/3/5/6,TRBJ2-6,CASSSRMGATGANVLTF,0,5,1,5
TRBV6-2/3/5/6,TRBJ2-7,CASSYIQWGQGSYEQYF,0,5,1,5
TRBV28,TRBJ1-2,CASSEASQGNFNYGYTF,0,5,1,5
TRBV7-2,TRBJ1-5,CASSFGADKGIHQPQHF,0,5,1,5
TRBV7-9,TRBJ1-1,CASSFRASHLRLAEAFF,0,5,1,5
TRBV14,TRBJ2-1,CASSRTVWQGPYNEQFF,0,5,1,5
TRBV28,TRBJ2-2,CASSTVEGTGGPGELFF,0,5,1,5
TRBV7-3,TRBJ2-6,CASSKTGLSSGANVLTF,0,5,1,5
TRBV10-1,TRBJ2-1,CASSKGTGGPLGNEQFF,0,5,1,5
TRBV5-1,TRBJ2-7,CASSSIGTEGPPYEQYF,0,5,1,5
TRBV20-1,TRBJ2-3,CSAPRPGGTSLTDTQYF,0,5,1,5
TRBV4-2,TRBJ2-2,YASSPAGLAGQTGELFF,0,5,1,5
TRBV10-3,TRBJ2-2,CAISRDSVPNTGELFF,0,5,1,5
TRBV24-1,TRBJ2-3,CATSDTDRSGSDTQYF,0,5,1,5
TRBV15,TRBJ1-5,CATSRDGRGINQPQHF,0,5,1,5
TRBV19,TRBJ1-5,CASISEPKDSNQPQHF,0,5,1,5
TRBV19,TRBJ2-7,CASRIGGQGSEYEQYF,0,5,1,5
TRBV19,TRBJ2-1,CASRAPTSSSYNEQFF,0,5,1,5
TRBV18,TRBJ2-1,CASSPLIDFQRNEQFF,0,5,1,5
TRBV18,TRBJ2-6,CASSPGVLSGANVLTF,0,5,1,5
TRBV18,TRBJ1-3,CASSPGGYHSGNTIYF,0,5,1,5
TRBV18,TRBJ2-3,CASSPNRGQGLKGQYF,0,5,1,5
TRBV18,TRBJ2-1,CASSSTGVFSYNEQFF,0,5,1,5
TRBV6-1,TRBJ2-1,CASLHPLAGTGNEQFF,0,5,1,5
TRBV12-3/4,TRBJ2-5,CASSPRTSGYKETQYF,0,5,1,5
TRBV2,TRBJ1-2,CASSGPGTGVNYGYTF,0,5,1,5
TRBV7-9,TRBJ1-4,CASSFSQEATNEKLFF,0,5,1,5
TRBV7-2,TRBJ2-3,CASSLEALAGVDTQYF,0,5,1,5
TRBV7-3,TRBJ2-6,CASSLSSVPGANVLTF,0,5,1,5
TRBV7-3,TRBJ2-2,CASSLRQGARTGELFF,0,5,1,5
TRBV7-3,TRBJ1-2,CASSSPNTTRFYGYTF,0,5,1,5
TRBV5-5,TRBJ2-7,CASSWAGQGVLYEQYF,0,5,1,5
TRBV11-2,TRBJ2-3,CASSPTGGWAADTQYF,0,5,1,5
TRBV4-2,TRBJ2-1,CASSPGLLYDYNEQFF,0,5,1,5
TRBV14,TRBJ2-1,CASSRDRGLGYNEQFF,0,5,1,5
TRBV5-6,TRBJ2-7,CASSRPGTGEFYEQYF,0,5,1,5
TRBV28,TRBJ1-5,CASSRQELGSRQPQHF,0,5,1,5
TRBV3-1,TRBJ2-5,CASSQERRQRQETQYF,0,5,1,5
TRBV7-3,TRBJ2-2,CASSAGTGGTAGELFF,0,5,1,5
TRBV12-3/4,TRBJ2-1,CASRTPDYQSYNEQFF,0,5,1,5
TRBV6-2/3/5/6,TRBJ2-1,CASKRTGQGSYNEQFF,0,5,1,5
TRBV10-2,TRBJ2-1,CASSESGDSRRGEQFF,0,5,1,5
TRBV5-1,TRBJ2-7,CASSLVLSGIAYEQYF,0,5,1,5
TRBV5-1,TRBJ2-3,CASSPGGTVIGDTQYF,0,5,1,5
TRBV5-1,TRBJ2-3,CASSPLPGPSTDTQYF,0,5,1,5
TRBV5-1,TRBJ1-1,CASSGGNRFTNTEAFF,0,5,1,5
TRBV29-1,TRBJ2-3,CSVGPGQIFTTDTQYF,0,5,1,5
TRBV29-1,TRBJ2-7,CSVEFRMGQRSYEQYF,0,5,1,5
TRBV28,TRBJ2-5,YASSSAGLAGGETQYF,0,5,1,5
TRBV30,TRBJ1-4,CAWSVQLGHGEKLFF,0,5,1,5
TRBV10-3,TRBJ1-4,CAISESGQGYEKLFF,0,5,1,5
TRBV10-3,TRBJ2-3,CAISPLAGGTDTQYF,0,5,1,5
TRBV19,TRBJ1-4,CASSSPGEPNEKLFF,0,5,1,5
TRBV19,TRBJ2-1,CASSISQRDGNEQFF,0,5,1,5
TRBV19,TRBJ1-1,CASSIVAGVATEAFF,0,5,1,5
TRBV19,TRBJ2-1,CASSTGTYSYNEQFF,0,5,1,5
TRBV19,TRBJ1-6,CASSRDTYQFSPLHF,0,5,1,5
TRBV19,TRBJ2-2,CASRPSGLNTGELFF,0,5,1,5
TRBV9,TRBJ1-6,CASNDRGRRDSPLHF,0,5,1,5
TRBV18,TRBJ1-3,CASSPSGTQGNTIYF,0,5,1,5
TRBV18,TRBJ1-4,CASSPPGGAIEKLFF,0,5,1,5
TRBV28,TRBJ1-5,CASAPGGAGDPAQHF,0,5,1,5
TRBV19,TRBJ2-1,CASGRGGVSYNEQFF,0,5,1,5
TRBV6-2/3/5/6,TRBJ2-3,CASIELAGGLDTQYF,0,5,1,5
TRBV12-3/4,TRBJ2-3,CASTPFQGLTDTQYF,0,5,1,5
TRBV6-2/3/5/6,TRBJ1-5,CASSLGRAGNQPQHF,0,5,1,5
TRBV27,TRBJ1-1,CASSLSRGMNTEAFF,0,5,1,5
TRBV6-2/3/5/6,TRBJ1-2,CASSLWAGGADGYTF,0,5,1,5
TRBV28,TRBJ1-1,CASSLRDRGNTEAFF,0,5,1,5
TRBV12-3/4,TRBJ1-2,CASSLAPAGHYGYTF,0,5,1,5
TRBV12-3/4,TRBJ2-2,CASSLARGRTGELFF,0,5,1,5
TRBV28,TRBJ1-4,CASSLGGQGDEKLFF,0,5,1,5
TRBV12-3/4,TRBJ2-5,CASSSSGGVMETQYF,0,5,1,5
TRBV12-3/4,TRBJ1-5,CASSSLPEANQPQHF,0,5,1,5
TRBV12-3/4,TRBJ1-5,CASSSGQEYNQPQHF,0,5,1,5
TRBV28,TRBJ2-5,CASSSLSAIKETQYF,0,5,1,5
TRBV6-2/3/5/6,TRBJ2-3,CASSYLSGTTDTQYF,0,5,1,5
TRBV6-2/3/5/6,TRBJ2-3,CASSYSPGGTDTQYF,0,5,1,5
TRBV6-2/3/5/6,TRBJ2-7,CASSYGTDRSHEQYI,0,5,1,5
TRBV5-4,TRBJ2-2,CASSREYGGTGELFF,0,5,1,5
TRBV6-2/3/5/6,TRBJ1-1,CASSRIVDDYEGAFF,0,5,1,5
TRBV6-1,TRBJ2-3,CASSRRAGVTDTQYS,0,5,1,5
TRBV6-4,TRBJ2-7,CASSRQGVSSYEQYF,0,5,1,5
TRBV6-1,TRBJ2-5,CASSQTTGKQETRYF,0,5,1,5
TRBV6-1,TRBJ1-5,CASSEGDRVGQPQHF,0,5,1,5
TRBV27,TRBJ1-1,CASSTPSGQNTEAFF,0,5,1,5
TRBV7-2,TRBJ2-3,CASSFGPSRTDTQYF,0,5,1,5
TRBV3-1,TRBJ2-5,CASSFGQGRRETQYF,0,5,1,5
TRBV5-6,TRBJ1-1,CASSLSIWGNTEAFF,0,5,1,5
TRBV5-4,TRBJ2-1,CASSLSSGGVRAQFF,0,5,1,5
TRBV5-4,TRBJ2-6,CASSLSGSGANVLTF,0,5,1,5
TRBV5-4,TRBJ2-5,CASSLAPTLQETQYF,0,5,1,5
TRBV7-3,TRBJ2-2,CASSLHGPNTGELFF,0,5,1,5
TRBV11-2,TRBJ2-1,CASSLVETQYNEQFF,0,5,1,5
TRBV7-2,TRBJ1-2,CASSLEAQTPYGYTF,0,5,1,5
TRBV6-1,TRBJ2-1,CASSLSGFSDNEQFF,0,5,1,5
TRBV5-6,TRBJ2-7,CASSYRDRHSYEQYF,0,5,1,5
TRBV6-2/3/5/6,TRBJ1-6,CASSLDRGWDSPLHF,0,5,1,5
TRBV7-2,TRBJ2-5,CASSLGGQPEETQYF,0,5,1,5
TRBV28,TRBJ2-7,CASSPLGARFYEQYF,0,5,1,5
TRBV7-8,TRBJ1-3,CASSPGTGAGNTIYF,0,5,1,5
TRBV3-1,TRBJ1-6,CASSPPGRKNSPLHF,0,5,1,5
TRBV3-1,TRBJ2-7,CASSPRQYLSYEQYF,0,5,1,5
TRBV6-2/3/5/6,TRBJ2-1,CASSPGAGAYDEQFF,0,5,1,5
TRBV6-2/3/5/6,TRBJ1-1,CASSHPGEVNTEAFF,0,5,1,5
TRBV3-1,TRBJ2-3,CASSHRNPSTDTQYF,0,5,1,5
TRBV3-1,TRBJ1-6,CASSQSQGVNSPLHF,0,5,1,5
TRBV9,TRBJ2-1,CASSARDRSYNEQFF,0,5,1,5
TRBV11-2,TRBJ2-3,CASSAYLAGTDTQYF,0,5,1,5
TRBV2,TRBJ2-5,CASSTGAGGQETQYF,0,5,1,5
TRBV7-8,TRBJ1-3,CASRPDGISGNTIYF,0,5,1,5
TRBV2,TRBJ2-5,CASRGRVAYQETQYF,0,5,1,5
TRBV5-1,TRBJ1-2,CASSLAAGMNYGYTF,0,5,1,5
TRBV5-1,TRBJ2-1,CASSSTGSSYNEQFF,0,5,1,5
TRBV5-1,TRBJ2-1,CASSSTGTSVREQFF,0,5,1,5
TRBV5-1,TRBJ2-2,CASSLTGVGTGELFF,0,5,1,5
TRBV5-1,TRBJ2-1,CASSAQPGPENEQFF,0,5,1,5
TRBV5-1,TRBJ2-3,CASSTSSGGADTQYF,0,5,1,5
TRBV20-1,TRBJ2-1,CSAPSRGTGPGEQFF,0,5,1,5
TRBV20-1,TRBJ2-3,CSAQLTSASTDTQYF,0,5,1,5
TRBV20-1,TRBJ2-3,CSATLAGGPSDTQYF,0,5,1,5
TRBV20-1,TRBJ2-3,CSASLTSGAADTQYF,0,5,1,5
TRBV20-1,TRBJ1-5,CSARGRGLGNQPQHF,0,5,1,5
TRBV20-1,TRBJ2-5,CSARDFKDYQETQYF,0,5,1,5
TRBV20-1,TRBJ2-7,CSARDSQRGIYEQYF,0,5,1,5
TRBV20-1,TRBJ1-5,CSARDLGEGNQPQHF,0,5,1,5
TRBV20-1,TRBJ2-1,CSARELAGGGNEQFF,0,5,1,5
TRBV20-1,TRBJ2-1,CSAPLAGGFYNEQFF,0,5,1,5
TRBV20-1,TRBJ2-1,CSATGLAGDYNEQFF,0,5,1,5
TRBV29-1,TRBJ2-7,CSVEYGDRAPYEQYF,0,5,1,5
TRBV29-1,TRBJ2-3,CSVERLAGVTDTQYF,0,5,1,5
TRBV29-1,TRBJ1-1,CSVEGTLDRRFEAFF,0,5,1,5
TRBV29-1,TRBJ2-1,CSAGKWGSNYNEQFF,0,5,1,5
TRBV5-4,TRBJ1-1,CACSLGQENTEAFF,0,5,1,5
TRBV30,TRBJ2-7,CAWNREAGAYEQYF,0,5,1,5
TRBV18,TRBJ2-7,CARSPGSGEYEQYF,0,5,1,5
TRBV10-3,TRBJ2-7,CAIMRTGPSYEQYF,0,5,1,5
TRBV19,TRBJ1-1,CATADPGGITEAFF,0,5,1,5
TRBV15,TRBJ1-2,CATSRQGDNYGYTF,0,5,1,5
TRBV19,TRBJ1-6,CASSSLKETSPLHF,0,5,1,5
TRBV19,TRBJ1-1,CASSYRVRNTEAFF,0,5,1,5
TRBV19,TRBJ1-5,CASSIVDIYQPQHF,0,5,1,5
TRBV18,TRBJ2-5,CASSPSGVQETQYF,0,5,1,5
TRBV18,TRBJ2-5,CASSRRQDRETQYF,0,5,1,5
TRBV18,TRBJ2-3,CASSTGQDPDTQYF,0,5,1,5
TRBV11-2,TRBJ2-7,CASCLTGGRYEQYF,0,5,1,5
TRBV28,TRBJ2-2,CASWDRANTGELFF,0,5,1,5
TRBV2,TRBJ2-7,CASVKGLAGYEQYF,0,5,1,5
TRBV5-5,TRBJ2-3,CASTSWGGTDTQYF,0,5,1,5
TRBV28,TRBJ2-5,CASTSSHALETQYF,0,5,1,5
TRBV6-2/3/5/6,TRBJ1-5,CASTLTGGGQPQHF,0,5,1,5
TRBV2,TRBJ2-7,CASTTRGLGGEQYF,0,5,1,5
TRBV3-1,TRBJ1-3,CASTTQHSGITIYF,0,5,1,5
TRBV6-4,TRBJ1-1,CASTTGPMNTEAFF,0,5,1,5
TRBV28,TRBJ1-5,CASSLYRSNQPQHF,0,5,1,5
TRBV28,TRBJ1-4,CASSLSSPLTQLFF,0,5,1,5
TRBV6-2/3/5/6,TRBJ1-1,CASSSQGAGTEAFF,0,5,1,5
TRBV12-3/4,TRBJ1-6,CASSSGGNNSPLHF,0,5,1,5
TRBV27,TRBJ2-5,CASSSSGGLETQYF,0,5,1,5
TRBV6-2/3/5/6,TRBJ2-3,CASSYSGRGDTQYF,0,5,1,5
TRBV6-2/3/5/6,TRBJ1-2,CASSLLSANYGYTF,0,5,1,5
TRBV2,TRBJ1-2,CASSLQGPDYGYTF,0,5,1,5
TRBV12-3/4,TRBJ1-2,CASSPLTGNYGYTF,0,5,1,5
TRBV12-3/4,TRBJ2-3,CASSRQDLTDTQYF,0,5,1,5
TRBV6-1,TRBJ2-2,CASSGQGSTGELFF,0,5,1,5
TRBV2,TRBJ2-3,CASSELAGADTQYF,0,5,1,5
TRBV2,TRBJ2-1,CASSEMVVYNEQFF,0,5,1,5
TRBV28,TRBJ2-7,CASSTPGPNNEQYF,0,5,1,5
TRBV7-3,TRBJ1-2,CASSLPGVDYGYTF,0,5,1,5
TRBV7-9,TRBJ2-5,CASSLVPGVETQYF,0,5,1,5
TRBV11-2,TRBJ2-7,CASSLGGRPYEQYF,0,5,1,5
TRBV7-9,TRBJ2-1,CASSLEPGYNEQFF,0,5,1,5
TRBV7-3,TRBJ2-1,CASSSPGVYNEQFF,0,5,1,5
TRBV7-2,TRBJ1-1,CASSSPGHSTEAFF,0,5,1,5
TRBV11-1,TRBJ2-1,CASSSGPPRYEQFF,0,5,1,5
TRBV7-2,TRBJ2-5,CASSSDRVEETQYF,0,5,1,5
TRBV5-6,TRBJ2-3,CASSWGTSTDTQYF,0,5,1,5
TRBV13,TRBJ1-4,CASSPLSTNEKLFF,0,5,1,5
TRBV3-1,TRBJ1-1,CASSPTGLDTEAFF,0,5,1,5
TRBV11-1,TRBJ1-1,CASSPTRTRTEAFF,0,5,1,5
TRBV3-1,TRBJ1-1,CASSREYSYLEAFF,0,5,1,5
TRBV11-2,TRBJ1-2,CASSRNRDSYGYTF,0,5,1,5
TRBV3-1,TRBJ2-7,CASSRGGTTYEQYF,0,5,1,5
TRBV7-8,TRBJ2-7,CASSRIQGAYEQYF,0,5,1,5
TRBV14,TRBJ2-5,CASSQAQPPETQYF,0,5,1,5
TRBV3-1,TRBJ1-1,CASSQAKQNTVAFF,0,5,1,5
TRBV14,TRBJ2-7,CASSQDRGTYEQYF,0,5,1,5
TRBV6-4,TRBJ2-3,CASSDRGSEDTQYF,0,5,1,5
TRBV5-4,TRBJ2-7,CASSENDRDYEQYF,0,5,1,5
TRBV7-2,TRBJ2-3,CASSITGISDTQYF,0,5,1,5
TRBV28,TRBJ2-7,CASRVAGVIYEQYF,0,5,1,5
TRBV12-3/4,TRBJ2-2,CASRMTGPTGELFF,0,9,1,9
TRBV28,TRBJ1-1,CASNQAAVNTEAFF,0,5,1,5
TRBV5-1,TRBJ1-1,CASTFGTEGAEAFF,0,5,1,5
TRBV5-1,TRBJ1-4,CASSFTSGTENLFF,0,5,1,5
TRBV5-1,TRBJ1-5,CASSLGGSNQPQHF,0,5,1,5
TRBV5-1,TRBJ2-5,CASSLDTGQETQHF,0,5,1,5
TRBV5-1,TRBJ2-3,CASSLEASGYTQYF,0,5,1,5
TRBV5-1,TRBJ1-5,CASSLTGGEQPQHF,0,5,1,5
TRBV5-1,TRBJ2-1,CASSYDYSYNEQFF,0,5,1,5
TRBV5-1,TRBJ1-2,CASSPAEGRDGYTF,0,5,1,5
TRBV5-1,TRBJ1-2,CASSPDSGNYGYTF,0,5,1,5
TRBV5-1,TRBJ2-6,CASSRQSGANVLTF,0,5,1,5
TRBV5-1,TRBJ1-1,CASSKGQRDTEAFF,0,5,1,5
TRBV20-1,TRBJ2-7,CSAGGQGAAYEQYF,0,5,1,5
TRBV20-1,TRBJ2-7,CSARAFTGGDEQYF,0,5,1,5
TRBV20-1,TRBJ2-7,CSARDLGGHDEQYF,0,5,1,5
TRBV20-1,TRBJ2-7,CSAREAGGPYEQYF,0,5,1,5
TRBV20-1,TRBJ2-3,CSADRDRSTDTQYF,0,5,1,5
TRBV29-1,TRBJ2-3,CSFTGTSSTDTQYF,0,5,1,5
TRBV29-1,TRBJ1-3,CSVVIPVSGNTIYF,0,5,1,5
TRBV29-1,TRBJ2-1,CSVAQGAYYNEQFF,0,5,1,5
TRBV29-1,TRBJ1-2,CSVARDILGYGYTF,0,5,1,5
TRBV30,TRBJ2-5,CAWSVSGGKTQYF,0,5,1,5
TRBV10-3,TRBJ1-1,CAIGDRGDTEAFF,0,5,1,5
TRBV10-3,TRBJ2-5,CAISSTSRETQYF,0,5,1,5
TRBV10-3,TRBJ1-1,CAISRGANTEAFF,0,5,1,5
TRBV10-3,TRBJ1-1,CAIREQPNTEAFF,0,5,1,5
TRBV19,TRBJ2-1,CASSGLSYNEQFF,0,5,1,5
TRBV19,TRBJ1-5,CASSRDSLEPQHF,0,5,1,5
TRBV19,TRBJ2-7,CASSEGGTYEQYF,0,5,1,5
TRBV19,TRBJ2-3,CASRQASTDTQYF,0,5,1,5
TRBV19,TRBJ1-1,CASNRAENTEAFF,0,5,1,5
TRBV18,TRBJ1-1,CASSLHKDTEAFF,0,5,1,5
TRBV18,TRBJ1-2,CASSLALNYGYTF,0,5,1,5
TRBV18,TRBJ2-1,CASSPPEGTEQFF,0,5,1,5
TRBV28,TRBJ2-1,CASRPTGDNEQFF,0,5,1,5
TRBV2,TRBJ1-2,CASRSSPSYGYTF,0,5,1,5
TRBV6-2/3/5/6,TRBJ2-3,CASSFFGADTQYF,0,5,1,5
TRBV6-2/3/5/6,TRBJ1-1,CASSFSGGTEAFF,0,5,1,5
TRBV28,TRBJ1-5,CASSFGHGQPQHF,0,5,1,5
TRBV27,TRBJ2-3,CASSFGIGDTQYF,0,5,1,5
TRBV12-3/4,TRBJ2-1,CASSLLGSNEQFF,0,5,1,5
TRBV12-3/4,TRBJ2-5,CASSLGTAETQYF,0,5,1,5
TRBV12-3/4,TRBJ1-1,CASSSQGGTEAFF,0,5,1,5
TRBV6-2/3/5/6,TRBJ1-1,CASSYGTLGEAFF,0,5,1,5
TRBV6-2/3/5/6,TRBJ2-5,CASSYTDQETQYF,0,5,1,5
TRBV28,TRBJ2-7,CASSLRQAYEQYF,0,5,1,5
TRBV12-3/4,TRBJ1-5,CASSLSGDQPQHF,0,5,1,5
TRBV6-4,TRBJ2-7,CASSDDKTYEQYF,0,5,1,5
TRBV5-5,TRBJ2-1,CASSFLDYNEQFF,0,5,1,5
TRBV7-6,TRBJ1-1,CASSFTLNTEAFF,0,5,1,5
TRBV5-6,TRBJ2-5,CASSLDSEETQYF,0,5,1,5
TRBV7-2,TRBJ2-3,CASSLPHQSTQYF,0,5,1,5
TRBV7-2,TRBJ2-1,CASSLPIRTEQFF,0,5,1,5
TRBV5-6,TRBJ2-7,CASSLHLAGEQYF,0,5,1,5
TRBV11-3,TRBJ2-1,CASSLGGGNEQFF,0,5,1,5
TRBV11-2,TRBJ2-3,CASSLGVGDTQYF,0,5,1,5
TRBV11-2,TRBJ2-6,CASSLTDGDVLTF,0,5,1,5
TRBV6-2/3/5/6,TRBJ2-7,CASSPDNLYEQYF,0,5,1,5
TRBV7-6,TRBJ2-5,CASSPPAQETQYF,0,5,1,5
TRBV5-4,TRBJ2-3,CASSRLAGARQYF,0,5,1,5
TRBV3-1,TRBJ2-7,CASSQGRESEQYF,0,5,1,5
TRBV3-1,TRBJ2-7,CASSQDRTGEQYF,0,5,1,5
TRBV3-1,TRBJ2-1,CASSQEGANEQFF,0,5,1,5
TRBV11-1,TRBJ2-1,CASRMSSSNEQFF,0,5,1,5
TRBV5-4,TRBJ2-4,CASRGGAVDIQYF,0,5,1,5
TRBV6-2/3/5/6,TRBJ1-6,CASNQGFNSPLHL,0,5,1,5
TRBV5-1,TRBJ1-1,CASSTQLNTEAFF,0,5,1,5
TRBV5-1,TRBJ2-7,CASSLEANYEQYF,0,5,1,5
TRBV5-1,TRBJ2-3,CASSSKRTDTQYF,0,5,1,5
TRBV4-1,TRBJ1-2,CASSQGTVYGYTF,0,5,1,5
TRBV29-1,TRBJ2-3,CSLNPTRADTQYF,0,5,1,5
TRBV20-1,TRBJ1-1,CSVETTGGVEAFF,0,5,1,5
TRBV20-1,TRBJ2-3,CSAGTSSTDTQYF,0,5,1,5
TRBV20-1,TRBJ1-1,CSASVTKNTEAFF,0,5,1,5
TRBV20-1,TRBJ1-1,CSARPRMNTEAFF,0,5,1,5
TRBV20-1,TRBJ2-1,CSARGGSGDEQFF,0,5,1,5
TRBV20-1,TRBJ2-3,CSAPKAGTDTQYF,0,5,1,5
TRBV29-1,TRBJ2-7,CSAPGQGTYEQYF,0,5,1,5
TRBV20-1,TRBJ2-7,CSARVGGFYEQYF,0,5,1,5
TRBV29-1,TRBJ2-7,CSVLDPYSYEQYF,0,5,1,5
TRBV29-1,TRBJ2-2,CSVAFQGTGELFF,0,5,1,5
TRBV29-1,TRBJ1-2,CSVDLDRVSGYTF,0,5,1,5
TRBV29-1,TRBJ1-5,CSVEGPLGQPQHF,0,5,1,5
TRBV29-1,TRBJ2-1,CSVEDRTGFEQFF,0,5,1,5
TRBV29-1,TRBJ1-1,CSAGQGDDTEAFF,0,5,1,5
TRBV29-1,TRBJ1-3,CSAYETPGNTIYF,0,5,1,5
TRBV19,TRBJ1-1,CASTSQGRGASF,0,5,1,5
TRBV19,TRBJ1-5,CASSVGNQPQHF,0,5,1,5
TRBV18,TRBJ1-2,CASSPKQGGNTF,0,5,1,5
TRBV18,TRBJ2-7,CASSQRTGEQYF,0,5,1,5
TRBV6-2/3/5/6,TRBJ1-1,CASGVRDTEAFF,0,5,1,5
TRBV28,TRBJ1-2,CASSSFRYGYTF,0,5,1,5
TRBV6-2/3/5/6,TRBJ2-7,CASSYFPSEQYF,0,5,1,5
TRBV28,TRBJ1-1,CASSPRRTEAFF,0,5,1,5
TRBV28,TRBJ1-4,CASSPANEKLFF,0,5,1,5
TRBV12-3/4,TRBJ2-7,CASSHGTYEQYF,0,5,1,5
TRBV5-4,TRBJ2-3,CASSFDSDTQYF,0,5,1,5
TRBV7-9,TRBJ2-7,CASSLSSYEQYF,0,5,1,5
TRBV11-2,TRBJ2-5,CASSLYQETQYF,0,9,1,9
TRBV7-2,TRBJ1-1,CASSLVRVGAFF,0,5,1,5
TRBV7-9,TRBJ1-5,CASSLDNQPQHF,0,5,1,5
TRBV3-1,TRBJ2-2,CASSPDDGELFF,0,5,1,5
TRBV28,TRBJ2-7,CASRKDGVGQYF,0,5,1,5
TRBV5-1,TRBJ2-3,CACSLDPDTQYF,0,5,1,5
TRBV10-2,TRBJ1-5,CASSTSGQPQHF,0,5,1,5
TRBV20-1,TRBJ2-3,CSARAATNTQYF,0,5,1,5
TRBV20-1,TRBJ2-7,CSASGVFYEQYF,0,5,1,5
TRBV29-1,TRBJ2-7,CSVAPSSYEQYF,0,5,1,5
TRBV29-1,TRBJ2-3,CSVEGSTDTQYF,0,5,1,5
TRBV29-1,TRBJ2-3,CSVGPRGDTQYF,0,5,1,5
TRBV29-1,TRBJ2-5,CSAGTDKETQYF,0,5,1,5
TRBV29-1,TRBJ1-1,RSVVEQGTEAFF,0,5,1,5
TRBV18,TRBJ2-5,CASSQQETQYF,0,5,1,5
TRBV28,TRBJ1-4,CASSLREKLFF,0,5,1,5
TRBV5-4,TRBJ2-5,CASSFRETQYF,0,5,1,5
TRBV7-9,TRBJ1-1,CASSLDTEAFF,0,5,1,5
TRBV5-1,TRBJ2-3,CASTSTDTQYF,0,5,1,5
TRBV20-1,TRBJ2-7,CSASLDTQQYF,0,5,1,5
TRBV20-1,TRBJ1-1,CSARDLSEAFF,0,5,1,5
TRBV29-1,TRBJ2-5,CSTRGSETQYF,0,5,1,5
TRBV19,TRBJ2-5,CASSTPRKRGVYQETQYF,0,5,1,5
TRBV11-2,TRBJ2-1,CASSFAPPGQGLDNERFF,0,5,1,5
TRBV19,TRBJ1-5,CASSRGGGQVGNQPQHF,0,5,1,5
TRBV14,TRBJ1-1,CASSQDALQGKATEAFF,0,5,1,5
TRBV19,TRBJ1-4,CASSGYASLGGEKLFF,0,5,1,5
TRBV3-1,TRBJ2-3,CASSQDMGGGTDTQYF,0,5,1,5
TRBV29-1,TRBJ2-7,CSVGLEDRSPSYEQYF,0,5,1,5
TRBV10-3,TRBJ2-3,CAISYLAGRTGTQYF,0,5,1,5
TRBV19,TRBJ1-4,CASSTSGQTNEKLFF,0,5,1,5
TRBV28,TRBJ1-5,CASSFLSNSNQPQHF,0,5,1,5
TRBV28,TRBJ2-1,CASSPLTDRHNELFF,0,5,1,5
TRBV2,TRBJ1-2,CASSDVWDTNYGYTF,0,5,1,5
TRBV5-5,TRBJ2-1,CASSLEGGNNNEQFF,0,5,1,5
TRBV5-1,TRBJ2-2,CASSLDLGNTGELFF,0,5,1,5
TRBV5-1,TRBJ1-6,CASSWRTGGNSPLHF,0,5,1,5
TRBV5-1,TRBJ2-3,CASSPGTGITDTQCF,0,5,1,5
TRBV18,TRBJ2-7,CASSRDREFDEQYF,0,5,1,5
TRBV2,TRBJ1-5,CASSGSTAHQPQHF,0,5,1,5
TRBV7-9,TRBJ2-5,CASSLAGAQETQYF,0,5,1,5
TRBV5-1,TRBJ2-5,CASSLLGVQETQYF,0,5,1,5
TRBV12-5,TRBJ1-5,CASGLARYRGPRDGYSNQPQHF,0,4,1,4
TRBV28,TRBJ1-2,CASSLSTDRPSSNLQANYGYTF,0,4,1,4
TRBV7-3,TRBJ2-5,CASSSTRDRASSGSELETQYF,0,4,1,4
TRBV6-2/3/5/6,TRBJ2-1,CASSLSDLLAGGFDYNEQFF,0,4,1,4
TRBV28,TRBJ1-1,CASSLPTGAGAGGWTEAFF,0,4,1,4
TRBV28,TRBJ1-5,CASSSLTGWGGYSNQPQHF,0,4,1,4
TRBV5-5,TRBJ2-6,CASSSRTSGVPSGANVLTF,0,4,1,4
TRBV7-2,TRBJ2-4,CASSSGTSGGFLAKNIQYF,0,4,1,4
TRBV7-9,TRBJ2-6,CASSPSRQGALAGANVLTF,0,4,1,4
TRBV5-8,TRBJ2-1,CASSKKASGGAGTYNEQFF,0,4,1,4
TRBV5-1,TRBJ2-3,CASSLTPGTSEVSTDTQYF,0,4,1,4
TRBV20-1,TRBJ2-5,CSGRDLRRGLFRFQETQYF,0,4,1,4
TRBV29-1,TRBJ2-2,CSVEEFRGFDGRWTGELFF,0,4,1,4
TRBV30,TRBJ2-1,CAWSVLKSGLKNPNEQFF,0,4,1,4
TRBV19,TRBJ1-6,CASSSAGTLWGRNSPLHF,0,4,1,4
TRBV6-1,TRBJ1-1,CASSQPAGQGVVNTEAFF,0,4,1,4
TRBV7-8,TRBJ2-1,CASSFLAGGQKAYNEQFF,0,4,1,4
TRBV7-8,TRBJ2-1,CASSLAISGGGTYNEQFF,0,4,1,4
TRBV11-2,TRBJ2-1,CASSLRFSGTRRYNEQFF,0,4,1,4
TRBV5-4,TRBJ2-1,CASSPRTSGVARYNEQFF,0,4,1,4
TRBV3-1,TRBJ1-1,CASSPWKTQGRANTEAFF,0,4,1,4
TRBV7-8,TRBJ2-1,CASSPLAGTTYSYNEQFF,0,4,1,4
TRBV14,TRBJ2-7,CASSPYETQPNTSYEQYF,0,4,1,4
TRBV28,TRBJ1-1,CASSHFRFRGRMDTEAFF,0,4,1,4
TRBV5-1,TRBJ2-3,CASSLGTSSGGVSDTQYF,0,4,1,4
TRBV5-1,TRBJ2-3,CASRVPVDAFVATDTQYF,0,4,1,4
TRBV20-1,TRBJ1-6,CSAAGNRGDSSYNSPLHF,0,4,1,4
TRBV20-1,TRBJ2-1,CSARAPGLAGETYNEQFF,0,4,1,4
TRBV15,TRBJ1-5,CATSRDSRMRGNQPQHF,0,4,1,4
TRBV6-4,TRBJ2-1,CASGLAGAPSSYNEQFF,0,4,1,4
TRBV7-9,TRBJ1-1,CASTHPGTGSWYTEAFF,0,4,1,4
TRBV6-2/3/5/6,TRBJ1-2,CASSLRISRAAGYGYTF,0,4,1,4
TRBV3-1,TRBJ2-7,CASSLGSPGGGGLEQYF,0,4,1,4
TRBV28,TRBJ2-3,CASSPPLTGTSTDTQYF,0,4,1,4
TRBV7-9,TRBJ2-3,CASSPGTSGIYQDTQYF,0,4,1,4
TRBV12-3/4,TRBJ1-2,CASSPPRRDTQNYGYTF,0,4,1,4
TRBV7-9,TRBJ2-1,CASSPRDGMAVGNEQFF,0,4,1,4
TRBV14,TRBJ2-1,CASSPGTNSFPYNEQFF,0,4,1,4
TRBV7-9,TRBJ2-3,CASSPPRLAGQTDTQYF,0,4,1,4
TRBV12-3/4,TRBJ2-5,CASSRSPLAQPRETQYF,0,4,1,4
TRBV3-1,TRBJ2-3,CASSQVPGGGRADTQYF,0,4,1,4
TRBV3-1,TRBJ2-5,CASSQVALAGGVETQYF,0,4,1,4
TRBV4-2,TRBJ1-3,CASSQDQGGNTRNTIYF,0,4,1,4
TRBV4-2,TRBJ2-2,CASSQTDRGGGIGELFF,0,4,1,4
TRBV9,TRBJ2-3,CASSERERVLSTDTQYF,0,4,1,4
TRBV7-9,TRBJ1-1,CASSEWGGQGPNTEAFF,0,4,1,4
TRBV11-1,TRBJ2-5,CASSMGHSGSPQETQYF,0,4,1,4
TRBV10-2,TRBJ2-1,CASSELSGASSYNEQFF,0,4,1,4
TRBV5-1,TRBJ2-1,CASSLARTGQLDNEQFF,0,4,1,4
TRBV5-1,TRBJ2-3,CASSLARDSPSTDTQYF,0,4,1,4
TRBV5-1,TRBJ2-6,CASSLAAGSTGANVLTF,0,4,1,4
TRBV5-1,TRBJ1-3,CASSLEAGLSSGNTIYF,0,4,1,4
TRBV5-1,TRBJ2-1,CASSRTSGGAVYNEQFF,0,4,1,4
TRBV5-1,TRBJ2-5,CASRDTLNSKIQETQYF,0,4,1,4
TRBV20-1,TRBJ2-6,CSAPSGTVSSGANVLTF,0,4,1,4
TRBV29-1,TRBJ2-2,CSVGTSGGAVDTGELFF,0,4,1,4
TRBV29-1,TRBJ2-3,CSVDGLAGGPKADTQYF,0,4,1,4
TRBV29-1,TRBJ2-1,CSAGAGNQVGNYNEQFF,0,4,1,4
TRBV28,TRBJ1-2,CACILFPDRIIVCYTF,0,4,1,4
TRBV10-3,TRBJ1-1,CAISESSDSVNTEAFF,0,4,1,4
TRBV10-3,TRBJ2-5,CAIRSSIGRGKETQYF,0,4,1,4
TRBV19,TRBJ1-2,CASSYRDRTSHYGYTF,0,4,1,4
TRBV19,TRBJ2-1,CASSRLPGQGLVLEFF,0,4,1,4
TRBV19,TRBJ2-1,CASSILGPSSYNEQFF,0,4,1,4
TRBV19,TRBJ2-1,CASSIYGRGPQDEQFF,0,4,1,4
TRBV19,TRBJ2-3,CASSIDLSGVTDTQYF,0,4,1,4
TRBV18,TRBJ2-1,CASSPPPSGRANEQFF,0,4,1,4
TRBV18,TRBJ1-4,CASSQFGGGHNEKLFF,0,4,1,4
TRBV28,TRBJ2-1,CASSFETSGIDNEQFF,0,4,1,4
TRBV12-3/4,TRBJ2-3,CASSLDPDPSTDMQYF,0,4,1,4
TRBV27,TRBJ2-5,CASSLYLAGNQETQYF,0,4,1,4
TRBV28,TRBJ1-5,CASSLATGTRNKPQHF,0,4,1,4
TRBV6-2/3/5/6,TRBJ2-3,CASSLIGGGSTDTQYF,0,4,1,4
TRBV28,TRBJ1-1,CASSSPTGNLNTEAFF,0,4,1,4
TRBV6-2/3/5/6,TRBJ2-1,CASSPSQGASYNEQFF,0,4,1,4
TRBV12-3/4,TRBJ2-2,CASSGLGLPNTGELFF,0,4,1,4
TRBV28,TRBJ2-7,CASSDFGQGEFREQYF,0,4,1,4
TRBV25-1,TRBJ1-1,CASSEPGRGLGTEAFF,0,4,1,4
TRBV2,TRBJ2-7,CASSEAPRQATYEQYF,0,4,1,4
TRBV6-1,TRBJ2-3,CASSEGASTGSDTQYF,0,4,1,4
TRBV28,TRBJ2-1,CASSTTSGGAYNEQFF,0,4,1,4
TRBV5-6,TRBJ1-5,CASSFGAGQGNQPQHF,0,4,1,4
TRBV7-2,TRBJ2-4,CASSFSALGPKNIQYF,0,4,1,4
TRBV5-6,TRBJ2-1,CASSLARRARGHEQFF,0,4,1,4
TRBV5-6,TRBJ2-1,CASSLSAGGRNNEQFF,0,4,1,4
TRBV7-2,TRBJ2-7,CASSLVAGMVSYEQYF,0,4,1,4
TRBV7-2,TRBJ2-1,CASSLGGGVTNNEQFF,0,4,1,4
TRBV7-2,TRBJ2-1,CASSLGPGTASIEQFF,0,4,1,4
TRBV7-9,TRBJ2-3,CASSLDWVGSTDTQYF,0,4,1,4
TRBV11-2,TRBJ2-4,CASSSISGDKSGIQYF,0,4,1,4
TRBV9,TRBJ2-3,CASSSSSGGYADTQYF,0,4,1,4
TRBV28,TRBJ1-5,CASSPPGTARNQPQHF,0,4,1,4
TRBV7-2,TRBJ2-3,CASSPRTSGGADTQYF,0,4,1,4
TRBV7-2,TRBJ2-3,CASSPRLAGATGTQYF,0,4,1,4
TRBV3-1,TRBJ2-1,CASSRSLAVEYNEQFF,0,4,1,4
TRBV27,TRBJ2-1,CASSHDRDSVYNEQFF,0,4,1,4
TRBV3-1,TRBJ1-1,CASSQRAGMRNTEAFF,0,4,1,4
TRBV3-1,TRBJ2-6,CASSQFASAGANVLTF,0,4,1,4
TRBV3-1,TRBJ1-1,CASSQQRGVVNTEAFF,0,4,1,4
TRBV3-1,TRBJ1-1,CASSQGTGGPGTEAFF,0,4,1,4
TRBV14,TRBJ1-5,CASSQIRRGANQPQHF,0,4,1,4
TRBV9,TRBJ2-5,CASSVGPDYRQETQYF,0,4,1,4
TRBV7-6,TRBJ2-2,CASRSSPNRDSGELFF,0,4,1,4
TRBV28,TRBJ2-7,CASRLTPGPTGSEQYF,0,4,1,4
TRBV6-1,TRBJ1-5,CASNGVGRLNFQPQHF,0,4,1,4
TRBV6-2/3/5/6,TRBJ2-3,CASNYLGGVDTDTQYF,0,4,1,4
TRBV5-1,TRBJ1-4,CASSSGTDSTNEKLFF,0,4,1,4
TRBV10-2,TRBJ2-7,CASSEISGTSSYEQYF,0,4,1,4
TRBV5-1,TRBJ2-1,CASSLFGQGASNEQFF,0,4,1,4
TRBV5-1,TRBJ1-4,CASSLVAQAPNEKLFF,0,4,1,4
TRBV5-1,TRBJ2-1,CASSLAAGALGNEQFF,0,4,1,4
TRBV5-1,TRBJ2-5,CASSLEGRGVQETQYF,0,4,1,4
TRBV5-1,TRBJ2-5,CASSLMFGVGQETQYF,0,4,1,4
TRBV5-1,TRBJ2-1,CASSLSGSGGAAEQLF,0,4,1,4
TRBV5-1,TRBJ2-2,CASSLSASGNTGELFF,0,4,1,4
TRBV4-1,TRBJ2-1,CASSHRGQAQDNEQFF,0,4,1,4
TRBV20-1,TRBJ2-3,CSATRLAGGRTDTLYF,0,4,1,4
TRBV20-1,TRBJ2-1,CSARRGRTEGGNEQFF,0,4,1,4
TRBV20-1,TRBJ2-7,CSARVSGADISYEQYF,0,4,1,4
TRBV20-1,TRBJ2-7,CSARGQFRVRPYEQYF,0,4,1,4
TRBV20-1,TRBJ2-5,CSAELPIAAYQETQYF,0,4,1,4
TRBV20-1,TRBJ2-1,CSALGTSGMIYNEQFF,0,4,1,4
TRBV29-1,TRBJ2-1,CSVEVGAGVRYNEQFF,0,4,1,4
TRBV7-9,TRBJ2-1,RASSLGAGTGGNEQFF,0,4,1,4
TRBV12-5,TRBJ2-1,CASGLLRGGYNEQFF,0,4,1,4
TRBV30,TRBJ2-1,CAWSVRDGHIGEQFF,0,4,1,4
TRBV30,TRBJ1-3,CAWSAGTTSGNTIYF,0,4,1,4
TRBV28,TRBJ2-7,CAISAGGILSYEQYF,0,4,1,4
TRBV10-3,TRBJ1-6,CAISWDKGNNSPLHF,0,4,1,4
TRBV24-1,TRBJ2-2,CATSDAGQGTGELFF,0,4,1,4
TRBV15,TRBJ1-5,CATSKTGKGYQPQHF,0,4,1,4
TRBV15,TRBJ1-2,CATSRDERGNYGYTF,0,4,1,4
TRBV15,TRBJ1-3,CATRAWGLSGNTIYF,0,4,1,4
TRBV19,TRBJ2-7,CASSSDRGEVSEQYF,0,4,1,4
TRBV19,TRBJ2-1,CASTRMRGGDNEQFF,0,4,1,4
TRBV19,TRBJ2-7,CASSSGTGIHYEQYF,0,4,1,4
TRBV19,TRBJ2-2,CASSPQGANTGELFF,0,4,1,4
TRBV19,TRBJ2-7,CASSELESGPYEQYF,0,4,1,4
TRBV19,TRBJ1-4,CASSIGEGAAGKLFF,0,4,1,4
TRBV19,TRBJ2-5,CASSIRAGDQETQYF,0,4,1,4
TRBV19,TRBJ1-6,CASSSTADYNSPLHF,0,4,1,4
TRBV19,TRBJ2-3,CASRTGAEGTDTQYF,0,4,1,4
TRBV19,TRBJ1-5,CASRKTDNSNQPQHF,0,4,1,4
TRBV18,TRBJ1-4,CASSPEDRVLEKLFF,0,4,1,4
TRBV18,TRBJ2-5,CASSPLGQSQETQYF,0,4,1,4
TRBV28,TRBJ2-2,CASYAGGPLTGELFF,0,4,1,4
TRBV19,TRBJ1-1,CASAKHVGLYGEAFF,0,4,1,4
TRBV28,TRBJ2-7,CASETSGTGSYEQYF,0,4,1,4
TRBV28,TRBJ2-3,CASMPLAESTDTQYS,0,4,1,4
TRBV28,TRBJ2-7,CASTQSGGDPYEQYF,0,4,1,4
TRBV6-2/3/5/6,TRBJ1-1,CASSFTGLDMVEAFF,0,4,1,4
TRBV28,TRBJ1-4,CASSFGARRYEKLFF,0,4,1,4
TRBV2,TRBJ2-7,CASSFTGGDGYEQYF,0,4,1,4
TRBV28,TRBJ1-3,CASSLSDRAGNTIYF,0,4,1,4
TRBV12-3/4,TRBJ1-5,CASSLGQGAIQPQHF,0,4,1,4
TRBV12-3/4,TRBJ2-5,CASSLNRRPQETQYF,0,4,1,4
TRBV28,TRBJ1-5,CASSLWGASNQLQHF,0,4,1,4
TRBV12-3/4,TRBJ2-1,CASSLPGASYNEQFF,0,4,1,4
TRBV6-2/3/5/6,TRBJ1-5,CASSLVGNSNQPQHF,0,4,1,4
TRBV12-3/4,TRBJ1-1,CASSLAPLFDTEAFF,0,4,1,4
TRBV12-3/4,TRBJ1-6,CASSLGTSLWSPLHF,0,4,1,4
TRBV28,TRBJ1-5,CASSLGGRSNQPQHF,0,4,1,4
TRBV6-2/3/5/6,TRBJ2-1,CASSLGDRVINEQFF,0,4,1,4
TRBV28,TRBJ1-3,CASSSPTFSGNTIYF,0,4,1,4
TRBV6-2/3/5/6,TRBJ1-5,CASSYSSGHNQPQHF,0,4,1,4
TRBV13,TRBJ2-7,CASSYRDRGTYEQYF,0,4,1,4
TRBV6-2/3/5/6,TRBJ2-5,CASSYRAGGQETQYF,0,4,1,4
TRBV12-3/4,TRBJ2-1,CASSPDRTSYNEQFF,0,4,1,4
TRBV27,TRBJ2-7,CASSRDHAGTREQYF,0,4,1,4
TRBV28,TRBJ2-3,CASSRDGRSTDTQYF,0,4,1,4
TRBV3-1,TRBJ1-4,CASSQDSGIIEKLFF,0,4,1,4
TRBV6-1,TRBJ2-3,CASSGTSGRTDTQYF,0,4,1,4
TRBV6-1,TRBJ1-1,CASSGTGMRTTKAFF,0,4,1,4
TRBV2,TRBJ1-5,CASSGGTGNGTPQHF,0,4,1,4
TRBV6-1,TRBJ2-3,CASSETSGGADTQYF,0,4,1,4
TRBV2,TRBJ1-5,CASSEARGRGQPQHF,0,4,1,4
TRBV12-3/4,TRBJ2-6,CASSTTGAGANVLTF,0,4,1,4
TRBV28,TRBJ2-7,CASSTSGRSSYEQYF,0,4,1,4
TRBV5-6,TRBJ2-7,CASSLGTSGGAEQYF,0,4,1,4
TRBV11-2,TRBJ2-1,CASSLDRGHYNEQFF,0,4,1,4
TRBV7-2,TRBJ2-1,CASSLIGTGGNEQFF,0,4,1,4
TRBV5-6,TRBJ1-1,CASSLTVTSNTEAFF,0,4,1,4
TRBV11-2,TRBJ2-1,CASSLSSGGAGEQFF,0,4,1,4
TRBV7-2,TRBJ1-6,CASSLWGDRESPLHF,0,4,1,4
TRBV7-2,TRBJ2-3,CASSLLAGEVDTQYF,0,4,1,4
TRBV7-8,TRBJ2-4,CASSLAGRAKNIQYF,0,4,1,4
TRBV7-9,TRBJ1-4,CASSLAGTVNEKLFF,0,4,1,4
TRBV11-2,TRBJ2-5,CASSLGAGPGETQYF,0,4,1,4
TRBV7-9,TRBJ2-3,CASSLGGGSTDTQYF,0,4,1,4
TRBV7-3,TRBJ2-3,CASSLNPHGGDTQYF,0,4,1,4
TRBV7-9,TRBJ2-3,CASSLHGEVTDTQYF,0,4,1,4
TRBV3-1,TRBJ1-6,CASSLRQGENSPLHF,0,4,1,4
TRBV11-2,TRBJ2-5,CASSLRDSLQETQYF,0,4,1,4
TRBV2,TRBJ1-1,CASSLNRVSNTEAFF,0,4,1,4
TRBV5-8,TRBJ1-6,CASSLGQGGNSPLHF,0,4,1,4
TRBV14,TRBJ2-1,CASSPEWGGLNEQFF,0,4,1,4
TRBV7-9,TRBJ2-5,CASSPETRLGETQYF,0,4,1,4
TRBV3-1,TRBJ2-3,CASSPGTAFTDTQYF,0,4,1,4
TRBV5-6,TRBJ2-7,CASSPPTGWSYEQYF,0,4,1,4
TRBV7-9,TRBJ1-1,CASSPGTPWSTEAFF,0,4,1,4
TRBV5-4,TRBJ1-2,CASSPDATVPYGYTF,0,4,1,4
TRBV5-4,TRBJ2-5,CASSPDGTSVETQYF,0,4,1,4
TRBV28,TRBJ2-7,CASSRVLRGEYEQYF,0,4,1,4
TRBV11-3,TRBJ1-4,CASSRTGGTNGKLFF,0,4,1,4
TRBV7-9,TRBJ1-5,CASSHDRGPNQPQHF,0,4,1,4
TRBV11-3,TRBJ2-5,CASSQWWDRGETQYF,0,4,1,4
TRBV6-2/3/5/6,TRBJ1-2,CASSQVARTNYGYTF,0,4,1,4
TRBV3-1,TRBJ1-5,CASSQGRAENQPQHF,0,4,1,4
TRBV3-1,TRBJ1-5,CASSQDYGVGQPQHF,0,4,1,4
TRBV3-1,TRBJ2-4,CASSQDTGRHNIQYF,0,4,1,4
TRBV3-1,TRBJ2-1,CASSQERGGYNEQFF,0,4,1,4
TRBV9,TRBJ2-5,CASSVGGTTQETQYF,0,4,1,4
TRBV5-4,TRBJ1-6,CASSASGTRSSPLHF,0,4,1,4
TRBV9,TRBJ2-3,CASSAHRGSTDTQYF,0,4,1,4
TRBV7-3,TRBJ2-2,CASSEQGANGGELFF,0,4,1,4
TRBV7-3,TRBJ2-1,CASSTSPDSYNEQFF,0,4,1,4
TRBV27,TRBJ1-5,CASRLEDVRNQPQHF,0,4,1,4
TRBV6-2/3/5/6,TRBJ1-5,CASRRQGAAGEPQHF,0,4,1,4
TRBV6-2/3/5/6,TRBJ1-6,CASRQQGADNSPLHF,0,4,1,4
TRBV2,TRBJ2-1,CASRVTGSYANEQFF,0,4,1,4
TRBV28,TRBJ2-5,CASRTASGNVETQYF,0,4,1,4
TRBV12-3/4,TRBJ1-2,CASNCRAREGYGYTF,0,4,1,4
TRBV19,TRBJ1-6,CASNEAGIGISPLHF,0,4,1,4
TRBV6-2/3/5/6,TRBJ2-7,CASNKRGTGAYEQYF,0,4,1,4
TRBV6-2/3/5/6,TRBJ2-5,CASKRGVGSVETQYF,0,4,1,4
TRBV9,TRBJ2-7,CARARPAAHSYEQYF,0,4,1,4
TRBV5-1,TRBJ2-3,CAPERGTLVSVTQYF,0,4,1,4
TRBV5-1,TRBJ1-4,CASTPGPATNEKLFF,0,4,1,4
TRBV5-1,TRBJ2-2,CASSFGTSGTGELFF,0,4,1,4
TRBV5-1,TRBJ1-1,CASSFWDTLNTEAFF,0,4,1,4
TRBV5-1,TRBJ2-3,CASSLQRGRADSQYF,0,4,1,4
TRBV5-1,TRBJ1-5,CASSLEGTGNQPQHF,0,4,1,4
TRBV5-1,TRBJ2-1,CASSLTYGFYNEQFF,0,4,1,4
TRBV5-1,TRBJ2-5,CASSWGGNPQETQYF,0,4,1,4
TRBV5-1,TRBJ1-5,CASSLGVGSNQPQHF,0,4,1,4
TRBV5-1,TRBJ2-7,CASSPFGLGQGEQYF,0,4,1,4
TRBV4-1,TRBJ2-7,CASSPRGQGDHEQYF,0,4,1,4
TRBV5-1,TRBJ1-2,CASSRSLDPNYGYTS,0,4,1,4
TRBV4-1,TRBJ2-1,CASSQATGGVSEQFF,0,4,1,4
TRBV4-1,TRBJ2-7,CASSQDVGVVYEQYF,0,4,1,4
TRBV4-1,TRBJ2-1,CASSEAPTAYNEQFF,0,4,1,4
TRBV5-1,TRBJ1-4,CASRPRSATNEKLFF,0,4,1,4
TRBV20-1,TRBJ1-3,CSARTGQGAGNTIYF,0,4,1,4
TRBV20-1,TRBJ2-3,CSATGLAGETDTQYF,0,4,1,4
TRBV20-1,TRBJ1-1,CSASRAGTMNTEAFF,0,4,1,4
TRBV20-1,TRBJ1-6,CSARAQGADNSPLHF,0,4,1,4
TRBV29-1,TRBJ1-3,CSVGDPPMPGNTIYF,0,4,1,4
TRBV29-1,TRBJ2-7,CSVGQDRDEPAGQYF,0,4,1,4
TRBV18,TRBJ2-1,RASSIAGGRHNEQFF,0,4,1,4
TRBV3-1,TRBJ2-7,CACSQQDRGGEQYF,0,4,1,4
TRBV30,TRBJ2-2,CAWSRQGGTGELFF,0,4,1,4
TRBV30,TRBJ1-2,CAWSVLGRNYGYTF,0,4,1,4
TRBV10-3,TRBJ1-6,CAVSELETNSPLHF,0,4,1,4
TRBV10-3,TRBJ2-7,CAITPDRGRQQQYF,0,4,1,4
TRBV19,TRBJ1-6,CATHSDTGPAPLHF,0,4,1,4
TRBV15,TRBJ2-2,CATSTTSGTGELFF,0,4,1,4
TRBV19,TRBJ2-1,CASSSTLQGGEQFF,0,4,1,4
TRBV19,TRBJ1-2,CASSIDTGQDRYTF,0,4,1,4
TRBV19,TRBJ1-5,CASSTGLSNQPQHF,0,4,1,4
TRBV19,TRBJ1-2,CASSTNRDTTYYTF,0,4,1,4
TRBV19,TRBJ1-5,CASSKTGTNQPQHF,0,4,1,4
TRBV18,TRBJ2-5,CASSPSDRTETQYF,0,4,1,4
TRBV18,TRBJ2-1,CASSPLGAHNEQFF,0,4,1,4
TRBV5-5,TRBJ1-4,CASRLWQGNEKLFF,0,4,1,4
TRBV3-1,TRBJ2-2,CASRGVGNTGELFF,0,4,1,4
TRBV12-3/4,TRBJ2-1,CASAGQGQDNEQFF,0,4,1,4
TRBV27,TRBJ1-2,CASGLDGIVYGYTF,0,4,1,4
TRBV5-8,TRBJ2-7,CASTWTSVTYEQYF,0,4,1,4
TRBV2,TRBJ1-2,CASTRDRGVYGYTF,0,4,1,4
TRBV6-2/3/5/6,TRBJ2-7,CASTATGMPYEQYF,0,4,1,4
TRBV28,TRBJ1-2,CASTEGLANYGYTF,0,4,1,4
TRBV7-8,TRBJ1-6,CASTTGGAYSPLHF,0,4,1,4
TRBV5-4,TRBJ2-7,CASTNGGGNYEQYF,0,4,1,4
TRBV12-3/4,TRBJ1-4,CASSFRQGDEKLFF,0,4,1,4
TRBV12-3/4,TRBJ2-7,CASSLFGGTYEQYF,0,4,1,4
TRBV28,TRBJ1-4,CASSLPGFNEKLFF,0,4,1,4
TRBV28,TRBJ2-5,CASSLSGGRETQYF,0,4,1,4
TRBV28,TRBJ1-6,CASSLRTGGSPLHF,0,4,1,4
TRBV12-3/4,TRBJ1-1,CASSSFSGSTEAFF,0,4,1,4
TRBV6-2/3/5/6,TRBJ2-3,CASSYWASTDTQYL,0,4,1,4
TRBV6-4,TRBJ1-2,CASSPLGADYGYTF,0,4,1,4
TRBV28,TRBJ2-5,CASSPWDYQETQYF,0,4,1,4
TRBV12-3/4,TRBJ1-2,CASSPPGRLYGYTF,0,4,1,4
TRBV6-2/3/5/6,TRBJ1-4,CASSRRGRTEKLFF,0,4,1,4
TRBV3-1,TRBJ1-5,CASSHGNRGKPQHF,0,4,1,4
TRBV6-1,TRBJ2-2,CASSVGRFTGELFF,0,4,1,4
TRBV6-1,TRBJ2-5,CASSGAGEVETQYF,0,4,1,4
TRBV2,TRBJ1-6,CASSDLTGNQPLHF,0,4,1,4
TRBV6-1,TRBJ2-3,CASSDGRAPDTQYF,0,4,1,4
TRBV2,TRBJ1-5,CASSEVSAIQPQHF,0,4,1,4
TRBV2,TRBJ2-7,CASSEGGRSYEQYF,0,4,1,4
TRBV2,TRBJ2-3,CASSRGLAGDTQYF,0,4,1,4
TRBV28,TRBJ1-1,CASSRTGGNTEAFF,0,4,1,4
TRBV5-4,TRBJ1-1,CASSFSTGNTEAIF,0,4,1,4
TRBV7-8,TRBJ2-3,CASSFGTSTDTQYF,0,4,1,4
TRBV7-2,TRBJ1-1,CASSLHGQGTEAFF,0,4,1,4
TRBV5-4,TRBJ2-3,CASSLMSVADTQYF,0,4,1,4
TRBV7-8,TRBJ2-3,CASSLPPPTGAVYF,0,4,1,4
TRBV7-9,TRBJ1-1,CASSLPGDHTEAFF,0,4,1,4
TRBV3-1,TRBJ2-1,CASSLQGLHNEQFF,0,4,1,4
TRBV7-8,TRBJ1-2,CASSLVVDLSGYTF,0,4,1,4
TRBV7-6,TRBJ1-1,CASSLAHLNTEAFF,0,4,1,4
TRBV11-2,TRBJ1-1,CASSLDRRGAEAFF,0,4,1,4
TRBV11-3,TRBJ2-5,CASSLDRATETQYF,0,4,1,4
TRBV7-2,TRBJ2-5,CASSLRQGQETQYF,0,4,1,4
TRBV7-2,TRBJ2-7,CASSLNGGTYEQYF,0,4,1,4
TRBV5-6,TRBJ2-7,CASSSGTGEGEQYF,0,4,1,4
TRBV11-2,TRBJ2-3,CASSLGTSTSTQYF,0,4,1,4
TRBV7-8,TRBJ2-3,CASSPSAGGDTQYF,0,4,1,4
TRBV7-3,TRBJ1-1,CASSQRGRWAEAFF,0,4,1,4
TRBV3-1,TRBJ2-1,CASSQVTGAGEQFF,0,4,1,4
TRBV3-1,TRBJ1-5,CASSQVSAQGPQHF,0,4,1,4
TRBV3-1,TRBJ2-3,CASSQAGATDTQYF,0,4,1,4
TRBV3-1,TRBJ2-3,CASSQDRTTDTQYF,0,4,1,4
TRBV9,TRBJ2-7,CASSASYGPYEQYF,0,4,1,4
TRBV6-1,TRBJ1-4,CASSDTGTDEKLFF,0,4,1,4
TRBV6-2/3/5/6,TRBJ1-4,CASSDRDTNEKLFF,0,4,1,4
TRBV9,TRBJ2-7,CASSEGDSAYEQYF,0,4,1,4
TRBV7-2,TRBJ2-7,CASSTPLATYEQYF,0,4,1,4
TRBV11-2,TRBJ1-1,CASSKDTWNTEAFF,0,4,1,4
TRBV12-3/4,TRBJ2-2,CASRSGTQGGELFF,0,4,1,4
TRBV2,TRBJ1-1,CASRGDLPNTEAFF,0,4,1,4
TRBV6-4,TRBJ1-5,CASRTGPRGEPQHF,0,4,1,4
TRBV5-6,TRBJ2-5,CASRSPQGPPTQYF,0,4,1,4
TRBV6-2/3/5/6,TRBJ1-1,CASNPAGWNTEAFF,0,4,1,4
TRBV28,TRBJ2-7,CASNPTGASYEQYF,0,4,1,4
TRBV7-9,TRBJ1-3,CASKREGGRNTIYF,0,4,1,4
TRBV7-9,TRBJ1-1,CTSSHTRAVTEAFF,0,4,1,4
TRBV5-1,TRBJ1-1,CASSFFNGNTEAFF,0,4,1,4
TRBV5-1,TRBJ2-7,CASSFMDGSVEQYF,0,4,1,4
TRBV5-1,TRBJ1-2,CASSLSPPNYGYTF,0,4,1,4
TRBV5-1,TRBJ2-3,CASSLGSSTDTQYF,0,4,1,4
TRBV5-1,TRBJ1-2,CASSLDGANYGYTF,0,4,1,4
TRBV5-1,TRBJ1-1,CASSSGDRFTETFF,0,4,1,4
TRBV5-1,TRBJ1-5,CASSPEGINQPQHF,0,4,1,4
TRBV5-1,TRBJ1-5,CASSDEGGDQPQHF,0,4,1,4
TRBV5-1,TRBJ2-1,CASSMAGAYNEQFF,0,4,1,4
TRBV5-1,TRBJ2-5,CASSTTGTEETQYF,0,4,1,4
TRBV5-1,TRBJ2-7,CASRPHGGSNEQYF,0,4,1,4
TRBV20-1,TRBJ2-7,CSAHSGVSSYEQYF,0,4,1,4
TRBV20-1,TRBJ2-2,CSAMKGSNTGELFF,0,4,1,4
TRBV20-1,TRBJ2-7,CSATPLASVYEQYF,0,4,1,4
TRBV20-1,TRBJ2-5,CSATARAGYETQYF,0,4,1,4
TRBV20-1,TRBJ2-3,CSASLRWATDTQYF,0,4,1,4
TRBV20-1,TRBJ1-5,CSARGGHKNQPQHF,0,4,1,4
TRBV20-1,TRBJ2-3,CSARIAGTADTQYF,0,4,1,4
TRBV20-1,TRBJ1-5,CSARVGPYNQPQHF,0,4,1,4
TRBV20-1,TRBJ1-5,CSARAQGLNQPQHF,0,4,1,4
TRBV20-1,TRBJ2-7,CSARDPRASDEQYF,0,4,1,4
TRBV20-1,TRBJ2-1,CSARDSIHKNEQFF,0,4,1,4
TRBV29-1,TRBJ1-1,CSVFYQGWNTEAFF,0,4,1,4
TRBV29-1,TRBJ2-1,CSVSRTQGYNEQFF,0,4,1,4
TRBV29-1,TRBJ1-5,CSVVVSGPNQPQHF,0,4,1,4
TRBV29-1,TRBJ2-7,CSVVDRGSSYEQYF,0,4,1,4
TRBV29-1,TRBJ2-1,CSVAFLRGDTEQFF,0,4,1,4
TRBV29-1,TRBJ2-7,CSVGGTGIDYEQYF,0,4,1,4
TRBV29-1,TRBJ1-1,CSVGRGSMNTEAFF,0,4,1,4
TRBV29-1,TRBJ1-2,CSVEDGVSRYGYTF,0,4,1,4
TRBV29-1,TRBJ2-7,CSVRTSGGAYEQYF,0,4,1,4
TRBV29-1,TRBJ2-3,CSVDWGRGTDTQYF,0,4,1,4
TRBV29-1,TRBJ2-1,CSATTGGIYNEQFF,0,4,1,4
TRBV28,TRBJ1-4,CAGRGTANEKLFF,0,4,1,4
TRBV12-5,TRBJ2-1,CASGSDRVNEQFF,0,4,1,4
TRBV18,TRBJ1-5,CACSPGPAQPQHF,0,4,1,4
TRBV30,TRBJ2-7,CAWRKDRLNEQYF,0,4,1,4
TRBV30,TRBJ1-2,CAWSVQGDGGYTF,0,4,1,4
TRBV10-3,TRBJ2-5,CAIGVGGKETQYF,0,4,1,4
TRBV10-3,TRBJ1-5,CAISDNPYQPQHF,0,4,1,4
TRBV19,TRBJ2-1,CATWTASYNEQFF,0,4,1,4
TRBV15,TRBJ2-1,CATSRVGTNEQFF,0,4,1,4
TRBV2,TRBJ2-1,CASGTGAGNEQFF,0,4,1,4
TRBV19,TRBJ1-1,CASSLRANTEAFF,0,4,1,4
TRBV19,TRBJ1-1,CASSIGWGTEAFS,0,4,1,4
TRBV19,TRBJ2-1,CASSIDELSEQFF,0,4,1,4
TRBV19,TRBJ1-2,CASSIRTPRGYTF,0,4,1,4
TRBV19,TRBJ1-5,CASRKTVNQPQHF,0,4,1,4
TRBV18,TRBJ2-7,CASSEHPAYEQYF,0,4,1,4
TRBV18,TRBJ1-1,CASSGVLRREAFF,0,4,1,4
TRBV6-2/3/5/6,TRBJ1-2,CASLTEGDYGYTF,0,4,1,4
TRBV28,TRBJ1-6,CASQGGYNSPLHF,0,4,1,4
TRBV11-2,TRBJ2-1,CASTQGNYNEQFF,0,4,1,4
TRBV12-3/4,TRBJ2-7,CASTTGLDYGQYF,0,4,1,4
TRBV6-2/3/5/6,TRBJ1-5,CASSLAVNQPQHF,0,4,1,4
TRBV27,TRBJ1-5,CASSLGRFQPQHF,0,4,1,4
TRBV27,TRBJ1-1,CASSLKGNTEAFF,0,4,1,4
TRBV6-2/3/5/6,TRBJ1-2,CASSSGIVYGYTF,0,4,1,4
TRBV6-2/3/5/6,TRBJ1-4,CASSYASFLRLFF,0,4,1,4
TRBV2,TRBJ2-3,CASSPPSTDTQYF,0,4,1,4
TRBV27,TRBJ1-2,CASSPQGARGYTF,0,4,1,4
TRBV12-3/4,TRBJ2-7,CASSRLAGYEQYF,0,4,1,4
TRBV6-1,TRBJ1-5,CASSVHSNQPQHF,0,4,1,4
TRBV2,TRBJ2-3,CASSGTSGDTQYF,0,4,1,4
TRBV2,TRBJ1-5,CASSEPVNQPQRF,0,4,1,4
TRBV25-1,TRBJ2-2,CASSERNTGEPFF,0,4,1,4
TRBV12-3/4,TRBJ1-2,CASSTGANYGYTF,0,4,1,4
TRBV7-6,TRBJ1-5,CASSFSLNQPQHF,0,4,1,4
TRBV5-8,TRBJ2-7,CASSFGLGTEQYF,0,4,1,4
TRBV11-3,TRBJ2-3,CASSLSPTDTQYF,0,4,1,4
TRBV7-3,TRBJ1-1,CASSLYLNTEAFF,0,4,1,4
TRBV7-9,TRBJ2-7,CASSLVPPVGQYF,0,4,1,4
TRBV7-6,TRBJ1-1,CASSLAMNTEAFF,0,4,1,4
TRBV7-2,TRBJ2-4,CASSLAPENIQYF,0,4,1,4
TRBV11-3,TRBJ2-7,CASSLGLAYEQYF,0,4,1,4
TRBV11-2,TRBJ2-1,CASSLGLYNEQLF,0,4,1,4
TRBV27,TRBJ2-7,CASSSSGAREQYF,0,4,1,4
TRBV5-6,TRBJ1-1,CASSYNGRPEAFF,0,4,1,4
TRBV16,TRBJ1-2,CASSPDRDYGYTF,0,4,1,4
TRBV3-1,TRBJ1-1,CASSPLRPGEAFF,0,4,1,4
TRBV5-6,TRBJ2-2,CASSPPAAGELFF,0,4,1,4
TRBV13,TRBJ1-2,CASSPTGGYGYTF,0,4,1,4
TRBV7-9,TRBJ1-2,CASSRRTGNGYTF,0,4,1,4
TRBV7-9,TRBJ2-7,CASSQSGGGEQYF,0,4,1,4
TRBV3-1,TRBJ1-5,CASSQDGGGPQHF,0,4,1,4
TRBV7-8,TRBJ2-1,CASSQTSGGEQFF,0,4,1,4
TRBV28,TRBJ2-1,CASSQTSDDEQFF,0,4,1,4
TRBV4-2,TRBJ1-2,CASSQEKIYGYTF,0,4,1,4
TRBV7-8,TRBJ1-1,CASSATGVTEAFF,0,4,1,4
TRBV5-6,TRBJ2-3,CASSTPGGDTQYF,0,4,1,4
TRBV11-3,TRBJ2-7,CASSTGLASEQYF,0,4,1,4
TRBV6-2/3/5/6,TRBJ2-7,CASRLSIAYEQYF,0,4,1,4
TRBV12-3/4,TRBJ1-5,CASRETSLGPQHF,0,4,1,4
TRBV7-9,TRBJ2-5,CASRSPYQETQYF,0,4,1,4
TRBV7-9,TRBJ1-5,CASRLGTGQPQHF,0,4,1,4
TRBV2,TRBJ1-1,CASRGTGNTEAFF,0,4,1,4
TRBV12-3/4,TRBJ2-7,CASRDSQGGEQYF,0,4,1,4
TRBV11-2,TRBJ2-3,CASNLGYTDTQYF,0,4,1,4
TRBV10-1,TRBJ2-2,CASAMGGTGELFF,0,4,1,4
TRBV2,TRBJ1-6,CASSLRTDSPLHF,0,4,1,4
TRBV5-1,TRBJ2-7,CASSLSRGSEQYF,0,4,1,4
TRBV5-1,TRBJ2-1,CASSLGQVNEQFF,0,4,1,4
TRBV5-1,TRBJ2-1,CASSLDRSNEQFF,0,4,1,4
TRBV5-1,TRBJ2-1,CASSLEVRDEQFF,0,4,1,4
TRBV5-1,TRBJ1-4,CASSSGQLEKLFF,0,4,1,4
TRBV5-1,TRBJ2-1,CASSLWVDNEQFF,0,4,1,4
TRBV10-1,TRBJ1-6,CASSEDLDSPLHF,0,4,1,4
TRBV20-1,TRBJ2-1,CSARGLLYNEQFF,0,4,1,4
TRBV20-1,TRBJ2-7,CSASLGQGYEQYF,0,4,1,4
TRBV20-1,TRBJ1-5,CSASEGPNQPQHF,0,4,1,4
TRBV20-1,TRBJ2-3,CSARHLSTDTQYF,0,4,1,4
TRBV20-1,TRBJ1-2,CSALLTGVDGYTF,0,4,1,4
TRBV20-1,TRBJ2-5,CSADRGGRETQYF,0,4,1,4
TRBV20-1,TRBJ1-1,CSAAGGTKTEAFF,0,4,1,4
TRBV29-1,TRBJ2-7,CSVVKGSSYEQYF,0,4,1,4
TRBV29-1,TRBJ1-1,CSVVDGGNTEAFF,0,4,1,4
TRBV29-1,TRBJ2-7,CSVVTGGTYEQYF,0,4,1,4
TRBV29-1,TRBJ2-5,CSVAETGGETQYF,0,4,1,4
TRBV29-1,TRBJ2-1,CSVGNGLDNEQFF,0,4,1,4
TRBV29-1,TRBJ2-7,CSVGRALKPEQYF,0,4,1,4
TRBV29-1,TRBJ1-1,CSVDRGGDTEAFF,0,4,1,4
TRBV29-1,TRBJ2-7,CSVDGDRTYEQYF,0,4,1,4
TRBV29-1,TRBJ2-3,CSVTPLVPDTQYF,0,4,1,4
TRBV29-1,TRBJ1-1,CSVKGQRNTEAFF,0,4,1,4
TRBV29-1,TRBJ1-1,CSVDRGPGTEAFF,0,4,1,4
TRBV29-1,TRBJ2-7,CSVSETASYEQYF,0,4,1,4
TRBV29-1,TRBJ2-7,CSVTGQGDYEQYF,0,4,1,4
TRBV29-1,TRBJ1-1,CSAPDKTSTEAFF,0,4,1,4
TRBV29-1,TRBJ2-2,CSAIQANTGELFF,0,4,1,4
TRBV19,TRBJ1-5,CVWGLGEQPQHF,0,4,1,4
TRBV28,TRBJ1-5,CVSSFSNQPQHF,0,4,1,4
TRBV30,TRBJ1-2,CAWIKDNYGYTF,0,4,1,4
TRBV11-2,TRBJ2-5,CATEDRSETQYF,0,4,1,4
TRBV19,TRBJ2-7,CASSPRGHEQYF,0,4,1,4
TRBV19,TRBJ2-3,CASSMGGDTQYF,0,4,1,4
TRBV18,TRBJ1-2,CASSPLGRSYTF,0,4,1,4
TRBV18,TRBJ2-7,CASSPQGREQYF,0,4,1,4
TRBV28,TRBJ1-5,CASSFLRQPQHF,0,4,1,4
TRBV28,TRBJ1-2,CASSLSNYGYTF,0,4,1,4
TRBV28,TRBJ1-2,CASSLGGYGYTF,0,4,1,4
TRBV6-2/3/5/6,TRBJ1-1,CASSLRGTEAFF,0,4,1,4
TRBV12-3/4,TRBJ1-1,CASSWGHTEAFF,0,4,1,4
TRBV2,TRBJ2-5,CASSVVGETQYF,0,4,1,4
TRBV2,TRBJ2-7,CASSDSYSKQYF,0,4,1,4
TRBV6-2/3/5/6,TRBJ1-1,CASSTQGSEAFF,0,4,1,4
TRBV11-3,TRBJ1-1,CASSFSGGRTFF,0,4,1,4
TRBV5-6,TRBJ2-7,CASSLYRGEQYF,0,4,1,4
TRBV13,TRBJ2-2,CASSLYTGELFF,0,4,1,4
TRBV7-9,TRBJ1-1,CASSLRGAEAFF,0,4,1,4
TRBV7-9,TRBJ1-5,CASSSQNQPQHF,0,4,1,4
TRBV3-1,TRBJ2-3,CASSLVRDTQYF,0,4,1,4
TRBV14,TRBJ2-1,CASSRVEDRQFF,0,4,1,4
TRBV3-1,TRBJ2-7,CASSQAVNEQYF,0,4,1,4
TRBV3-1,TRBJ2-2,CASSQRAGELFF,0,4,1,4
TRBV6-2/3/5/6,TRBJ2-1,CASSQSVHEQFF,0,4,1,4
TRBV3-1,TRBJ2-1,CASSQVRGLSSF,0,4,1,4
TRBV12-3/4,TRBJ2-7,CASSKGVDEQYF,0,4,1,4
TRBV28,TRBJ2-1,CASRGTGREQFF,0,4,1,4
TRBV27,TRBJ1-2,CASKGFNYGYTF,0,4,1,4
TRBV5-1,TRBJ2-1,CASSLEGNEQFF,0,4,1,4
TRBV5-1,TRBJ2-2,CASSLPPGELFF,0,4,1,4
TRBV20-1,TRBJ1-1,CSAYGQGTEAFF,0,4,1,4
TRBV20-1,TRBJ1-5,CSASSSNQPQHF,0,4,1,4
TRBV20-1,TRBJ1-1,CSASPGNTEAFF,0,4,1,4
TRBV20-1,TRBJ2-5,CSARSGQETQYF,0,4,1,4
TRBV29-1,TRBJ2-7,CSVVNFSGEQYF,0,4,1,4
TRBV29-1,TRBJ1-1,CSVVGEGTEAFF,0,4,1,4
TRBV29-1,TRBJ2-7,CSVGSGDYEQYF,0,4,1,4
TRBV29-1,TRBJ1-1,CSVEAVGTEAFF,0,4,1,4
TRBV29-1,TRBJ2-1,CSVRLPSNEQFF,0,4,1,4
TRBV29-1,TRBJ1-1,CSATGGSTEAFF,0,4,1,4
TRBV29-1,TRBJ2-3,CSAREGSDTQYF,0,4,1,4
TRBV29-1,TRBJ2-5,CSARTGEETQYF,0,4,1,4
TRBV20-1,TRBJ1-1,CSGGWQNTEAFF,0,4,1,4
TRBV29-1,TRBJ2-3,CSGLPSTDTQYF,0,4,1,4
TRBV29-1,TRBJ2-5,CSGTGGQETQYF,0,4,1,4
TRBV30,TRBJ2-5,CACGQQETQYF,0,4,1,4
TRBV30,TRBJ2-3,CAWSAADTQYF,0,4,1,4
TRBV10-3,TRBJ2-1,CAAGRFNEQFF,0,4,1,4
TRBV18,TRBJ1-1,CASSRGAEAFF,0,4,1,4
TRBV2,TRBJ1-2,CASTEDYGYTF,0,4,1,4
TRBV2,TRBJ2-7,CASSEVVEQYF,0,4,1,4
TRBV7-9,TRBJ2-3,CASSFQGTQYF,0,4,1,4
TRBV7-9,TRBJ2-2,CASSFAGELFF,0,4,1,4
TRBV2,TRBJ1-4,CASSLGGGVFF,0,4,1,4
TRBV11-2,TRBJ2-1,CASSSLIEQFF,0,4,1,4
TRBV7-6,TRBJ2-7,CASSSHYEQYF,0,4,1,4
TRBV28,TRBJ1-4,CASREVEKLFF,0,4,1,4
TRBV20-1,TRBJ2-5,CSAALQETQYF,0,4,1,4
TRBV20-1,TRBJ1-2,CSAPEAYGYTF,0,4,1,4
TRBV29-1,TRBJ2-1,CSVARPHEQFF,0,4,1,4
TRBV29-1,TRBJ2-3,CSAASTDTQYF,0,4,1,4
TRBV20-1,TRBJ2-5,CSARMETQYF,0,4,1,4
TRBV29-1,TRBJ2-7,CSVRTYEQYF,0,4,1,4
TRBV29-1,TRBJ1-2,CSVRQGGYTF,0,4,1,4
TRBV19,TRBJ2-1,CASSIRGGETSGGGYEQFF,0,4,1,4
TRBV5-6,TRBJ1-4,CASTLGPRQLNEKLFF,0,4,1,4
TRBV11-2,TRBJ2-1,CASSLVRGPSFNEQFF,0,4,1,4
TRBV12-3/4,TRBJ2-3,CACSLEGTSTDTQYF,0,4,1,4
TRBV6-2/3/5/6,TRBJ1-1,CASSYSTGLGTEAFF,0,4,1,4
TRBV11-3,TRBJ2-1,CASSSYSGGGSEQFF,0,4,1,4
TRBV7-2,TRBJ2-7,CASSVNPGLDYEQYF,0,4,1,4
TRBV12-3/4,TRBJ2-1,CASRSRDYPLNEQFF,0,4,1,4
TRBV5-1,TRBJ1-1,CASSLELQDGTEASF,0,4,1,4
TRBV5-1,TRBJ2-1,CASSSSGGSYNEQFF,0,4,1,4
TRBV6-2/3/5/6,TRBJ1-1,CASTTGPMNAGAFF,0,4,1,4
TRBV2,TRBJ1-2,CASSGQGVGYGYTF,0,4,1,4
TRBV4-1,TRBJ2-5,CACSRLALETQYF,0,4,1,4
TRBV29-1,TRBJ2-7,CSVASDSFNEQYF,0,4,1,4
TRBV13,TRBJ2-5,CASSEATTSQGRSSSSGNQYF,0,3,1,3
TRBV6-2/3/5/6,TRBJ2-3,CASSYLQGSSGISSTDTQYF,0,3,1,3
TRBV6-2/3/5/6,TRBJ2-5,CASSYHQGSGGTILGETQYF,0,3,1,3
TRBV12-3/4,TRBJ2-6,CASSYGIGGLLSSGANVLTF,0,3,1,3
TRBV7-8,TRBJ2-1,CASSLGVAGGHWSPYNEQFF,0,3,1,3
TRBV13,TRBJ1-2,CASSPTGTAGWGLVNYGYTF,0,3,1,3
TRBV7-9,TRBJ2-7,CASSPPLSGTENLLPHEQYF,0,3,1,3
TRBV10-3,TRBJ2-6,CAISESMGTLRTGANVLTF,0,3,1,3
TRBV7-2,TRBJ2-1,CASSLLGPSTSGIFNEQFF,0,3,1,3
TRBV3-1,TRBJ2-1,CASSRLAGGPESSYNEQFF,0,3,1,3
TRBV4-2,TRBJ2-3,CASSQETSGGALNTDTQYF,0,3,1,3
TRBV5-6,TRBJ2-5,CASSMGVGGIRPYGETQYF,0,3,1,3
TRBV12-3/4,TRBJ2-6,CARRGQGPLTYSGANVLTF,0,3,1,3
TRBV4-1,TRBJ2-3,CASSHLGLAGGPGADTQYF,0,3,1,3
TRBV30,TRBJ1-1,CAWSPPIAVGGWNTEAFS,0,3,1,3
TRBV28,TRBJ1-1,CASSLLVWQRSMNTEAFF,0,3,1,3
TRBV6-2/3/5/6,TRBJ2-1,CASSLSGRWDRDYNEQFF,0,3,1,3
TRBV2,TRBJ1-4,CASSSGQGWLVRGEKLFF,0,3,1,3
TRBV6-2/3/5/6,TRBJ2-5,CASSYSSQTGGRRETQYF,0,3,1,3
TRBV2,TRBJ1-2,CASSLTGTGTLAIYGYTF,0,3,1,3
TRBV6-2/3/5/6,TRBJ1-5,CASSPSTFGQGGNQPQHF,0,3,1,3
TRBV6-1,TRBJ2-2,CASSAEGPRTVNTGELFF,0,3,1,3
TRBV6-1,TRBJ2-3,CASSGAGGTGEGTDTQYF,0,3,1,3
TRBV7-2,TRBJ1-3,CASSFLGGGAHSGNTIYF,0,3,1,3
TRBV4-2,TRBJ2-6,CASSQDLAGGAGANVLTF,0,3,1,3
TRBV5-1,TRBJ1-6,CASSLSGSQGMGVSPLHF,0,3,1,3
TRBV5-1,TRBJ2-1,CASSLGQGAVSSYNEQFF,0,3,1,3
TRBV5-1,TRBJ2-3,CASSYRQVAGGNTDTQYF,0,3,1,3
TRBV5-1,TRBJ2-1,CASSHHGPGGSSYNEQFF,0,3,1,3
TRBV20-1,TRBJ2-3,CSSKRQGASSLLTDTQYF,0,3,1,3
TRBV20-1,TRBJ2-5,CSARDFLAGSLTQETQYF,0,3,1,3
TRBV20-1,TRBJ2-3,CSAPGLAGALTSTDTQYF,0,3,1,3
TRBV29-1,TRBJ1-1,CSVENPPDGYSPRPEAFF,0,3,1,3
TRBV2,TRBJ2-1,CASAGAGGKPAYNEQFF,0,3,1,3
TRBV24-1,TRBJ2-6,CATSAPGPSSGANVLTF,0,3,1,3
TRBV19,TRBJ1-2,CASSRMGQSAYLRGYTF,0,3,1,3
TRBV19,TRBJ2-1,CASSIVSGRGIYNEQFF,0,3,1,3
TRBV19,TRBJ1-1,CASSTQGRAPLNTEAFF,0,3,1,3
TRBV19,TRBJ1-5,CASSIIENWDSNQPQHF,0,3,1,3
TRBV18,TRBJ2-3,CASSPLLTDRGTDTQYF,0,3,1,3
TRBV18,TRBJ1-4,CASSQGTAVTTNEKPFF,0,3,1,3
TRBV28,TRBJ2-3,CASPPSEGSPSTDTQYF,0,3,1,3
TRBV6-2/3/5/6,TRBJ2-6,CASTLRTGGTGANVLTF,0,3,1,3
TRBV28,TRBJ1-5,CASSFPVEGTTLQPQYF,0,3,1,3
TRBV28,TRBJ2-7,CASSFPITGGSSYEQYF,0,3,1,3
TRBV6-9,TRBJ2-7,CASSLPFVGLSSYEQYF,0,3,1,3
TRBV6-2/3/5/6,TRBJ2-6,CASSYFVSGSGANVLTF,0,3,1,3
TRBV6-2/3/5/6,TRBJ2-2,CASSYSPTGLRTGELFF,0,3,1,3
TRBV2,TRBJ2-2,CASSEVGRTVNTGELFF,0,3,1,3
TRBV6-1,TRBJ1-3,CASSNRGGANSGNTIYF,0,3,1,3
TRBV5-6,TRBJ2-5,CASSFTSGTGGRKTQYF,0,3,1,3
TRBV5-6,TRBJ2-7,CASSLMWSRGPSYEQYF,0,3,1,3
TRBV11-1,TRBJ2-1,CASSLAGGMGGYNEQFF,0,3,1,3
TRBV13,TRBJ2-5,CASSLGWPSGEQETQYF,0,3,1,3
TRBV7-9,TRBJ1-5,CASSSVLQGASNQPQHF,0,3,1,3
TRBV5-6,TRBJ2-7,CASSSVILRHKAYEQYF,0,3,1,3
TRBV7-2,TRBJ2-5,CASSSTLLGGGLKTQYF,0,3,1,3
TRBV9,TRBJ2-3,CASSLRAGDPFKDTQYF,0,3,1,3
TRBV3-1,TRBJ2-3,CASSPSYQATYTDTQYF,0,3,1,3
TRBV12-3/4,TRBJ2-3,CASSHLQGRGATDTQYF,0,3,1,3
TRBV7-2,TRBJ2-1,CASSQRLGARGYNEQFF,0,3,1,3
TRBV3-1,TRBJ2-7,CASSQDLSPGYSYEQYF,0,3,1,3
TRBV4-2,TRBJ1-3,CASSQDSGRDRGNTIYF,0,3,1,3
TRBV14,TRBJ1-2,CASSQDASTGINYGYTF,0,3,1,3
TRBV7-9,TRBJ2-1,CASSGQTSGAVGNEQFF,0,3,1,3
TRBV7-9,TRBJ1-5,CASSNSGGGRGNQPQHF,0,3,1,3
TRBV11-2,TRBJ2-6,CASRPGTGGGGANVLTF,0,3,1,3
TRBV5-4,TRBJ2-2,CASRPTSGGADTGELFF,0,3,1,3
TRBV5-1,TRBJ1-6,CASGLTAGTGVNSPLHF,0,3,1,3
TRBV5-1,TRBJ2-5,CASSFGVAGLAYETQYF,0,3,1,3
TRBV5-1,TRBJ2-2,CASSFLPSGTGTGELFF,0,3,1,3
TRBV5-1,TRBJ2-1,CASSLFRERGGYNEQFF,0,3,1,3
TRBV5-1,TRBJ2-7,CASSLSGLPGTGYEQYF,0,3,1,3
TRBV5-1,TRBJ1-2,CASSPDRGFDLIYGYTF,0,3,1,3
TRBV4-1,TRBJ2-5,CASSQDRPGTEQETQYF,0,3,1,3
TRBV20-1,TRBJ2-3,CSASDALRGSAPDTQYF,0,3,1,3
TRBV29-1,TRBJ2-1,CSVGGTSGTRGLNELFF,0,3,1,3
TRBV29-1,TRBJ2-5,CSVEGDYRGEIQETQYF,0,3,1,3
TRBV30,TRBJ2-4,CAWSVLHRIAKNIQYF,0,3,1,3
TRBV10-3,TRBJ2-2,CAISDSGVANTGELFF,0,3,1,3
TRBV10-3,TRBJ2-3,CAISDQKTPSTDTQYF,0,3,1,3
TRBV15,TRBJ1-5,CATSRELRDRNQPQHF,0,3,1,3
TRBV19,TRBJ1-1,CATTKLQGVVNTEAFF,0,3,1,3
TRBV19,TRBJ2-1,CASSAGTSGGSSEQFF,0,3,1,3
TRBV19,TRBJ1-5,CASSMARGGANQPQHF,0,3,1,3
TRBV19,TRBJ2-1,CASSMMKGARGVEQFF,0,3,1,3
TRBV19,TRBJ2-5,CASSTRTSGGERTQYF,0,3,1,3
TRBV19,TRBJ1-5,CASRDDLGGGNQPQHF,0,3,1,3
TRBV18,TRBJ2-3,CASSVYAGEKTDTQYF,0,3,1,3
TRBV18,TRBJ1-1,CASSPQTGTVNTEAFF,0,3,1,3
TRBV18,TRBJ2-7,CASSPLVGAGIHEQYF,0,3,1,3
TRBV18,TRBJ2-3,CASSQPGQGVPDTQYF,0,3,1,3
TRBV18,TRBJ2-1,CASARGRASSYNEQFF,0,3,1,3
TRBV2,TRBJ2-3,CASGTGVRTGTDTQYI,0,3,1,3
TRBV11-2,TRBJ2-3,CASTYTGYTSTDTQYF,0,3,1,3
TRBV28,TRBJ2-5,CASSLWVSGGQETQYF,0,3,1,3
TRBV6-2/3/5/6,TRBJ2-3,CASSLLAGGVTDTQYF,0,3,1,3
TRBV28,TRBJ2-1,CASSLGTDTSYNEQFF,0,3,1,3
TRBV6-2/3/5/6,TRBJ1-2,CASSYSDDQADYGYTF,0,3,1,3
TRBV6-2/3/5/6,TRBJ1-1,CASSYPGQALNTEAFF,0,3,1,3
TRBV6-2/3/5/6,TRBJ2-1,CASSYDSIYSYNEQFF,0,3,1,3
TRBV6-2/3/5/6,TRBJ2-5,CASSLGGGGGQETQYF,0,3,1,3
TRBV6-2/3/5/6,TRBJ2-7,CASSPSSGTAPYEQYF,0,3,1,3
TRBV12-3/4,TRBJ2-1,CASSQQGLAGDNEQFF,0,3,1,3
TRBV6-1,TRBJ1-5,CASSVRVSAGNQPQHF,0,3,1,3
TRBV6-1,TRBJ2-3,CASSAGTSGYTDTQYF,0,3,1,3
TRBV6-1,TRBJ2-7,CASSEALAGAAYEQYF,0,3,1,3
TRBV2,TRBJ1-1,CASSEADRGWNTEAFF,0,3,1,3
TRBV7-9,TRBJ1-4,CASSFPRGGTNEKLFF,0,3,1,3
TRBV5-6,TRBJ1-5,CASSLLGRATDQPQHF,0,3,1,3
TRBV5-6,TRBJ2-7,CASSLWAGVSSYEQYF,0,3,1,3
TRBV5-4,TRBJ2-4,CASSLRGSLAKNIQYF,0,3,1,3
TRBV11-2,TRBJ2-5,CASSLDSGLNQETQYF,0,3,1,3
TRBV5-4,TRBJ2-2,CASSLNRGGNTGELFF,0,3,1,3
TRBV7-3,TRBJ2-3,CASSLLGGAVADTQYF,0,3,1,3
TRBV11-2,TRBJ1-1,CASSLSQYLMNTEAFF,0,3,1,3
TRBV7-9,TRBJ1-5,CASSLVLWGRGEPQHF,0,3,1,3
TRBV7-2,TRBJ2-1,CASSLVGGGTYNEQFF,0,3,1,3
TRBV7-2,TRBJ1-5,CASSLAGGRGNQPQHI,0,3,1,3
TRBV7-9,TRBJ2-7,CASSLAEDKPLQEQYF,0,3,1,3
TRBV7-8,TRBJ1-1,CASSLARGDSGTEAFF,0,3,1,3
TRBV11-1,TRBJ2-3,CASSLGVGLAVDTQYF,0,3,1,3
TRBV7-9,TRBJ1-5,CASSLDSGASNQPQHF,0,3,1,3
TRBV11-2,TRBJ2-3,CASSLTGSTLGDTQYF,0,3,1,3
TRBV7-3,TRBJ2-3,CASSLSRSGGADTQYF,0,3,1,3
TRBV7-3,TRBJ2-7,CASSLNSPGTLSEQYF,0,3,1,3
TRBV7-3,TRBJ2-1,CASSSDRPSSYNEQFF,0,3,1,3
TRBV3-1,TRBJ2-5,CASSSFLGGSGETQYF,0,3,1,3
TRBV5-6,TRBJ1-2,CASSSTWTGRSGGYTF,0,3,1,3
TRBV6-2/3/5/6,TRBJ2-1,CASSSALAGVYNEQFF,0,3,1,3
TRBV6-2/3/5/6,TRBJ1-5,CASSLKAAYSNQPQHF,0,3,1,3
TRBV3-1,TRBJ2-5,CASSLRVEWGQETQYF,0,3,1,3
TRBV5-5,TRBJ2-3,CASSLQGLPSTDTQYF,0,3,1,3
TRBV7-2,TRBJ2-7,CASSPTPTTEPREQYF,0,3,1,3
TRBV7-9,TRBJ2-3,CASSPNPHRRADTQYF,0,3,1,3
TRBV3-1,TRBJ2-2,CASSPQAGQDSGELFF,0,3,1,3
TRBV11-2,TRBJ1-6,CASSPGSSSYNSPLHF,0,3,1,3
TRBV11-3,TRBJ2-1,CASSPGGLAVGNEQFL,0,3,1,3
TRBV5-4,TRBJ2-1,CASSPGTAGSYNEQFF,0,3,1,3
TRBV3-1,TRBJ2-7,CASSPIPGQGTYEQYF,0,3,1,3
TRBV7-3,TRBJ1-5,CASSPFSEQINQPQHF,0,3,1,3
TRBV3-1,TRBJ2-3,CASSRASALALDTQYF,0,3,1,3
TRBV3-1,TRBJ2-1,CASSHLAGGFYNEQSF,0,3,1,3
TRBV3-1,TRBJ2-1,CASSQPTSGYYNEQFF,0,3,1,3
TRBV3-1,TRBJ2-3,CASSQWKAGGPDTQYF,0,3,1,3
TRBV3-1,TRBJ2-1,CASSQAPSVLYNEQLF,0,3,1,3
TRBV14,TRBJ2-2,CASSQATGKITGELFF,0,3,1,3
TRBV3-1,TRBJ2-3,CASSQGRDRSTDTQYF,0,3,1,3
TRBV4-2,TRBJ2-1,CASSQGLAGTYNEQFF,0,3,1,3
TRBV14,TRBJ2-5,CASSQDSWPFQETQYF,0,3,1,3
TRBV14,TRBJ2-1,CASSQEESTIYNEQFF,0,3,1,3
TRBV5-4,TRBJ2-2,CASSVGLAFNTGELFF,0,3,1,3
TRBV7-8,TRBJ2-1,CASSVGASVGGFTQFL,0,3,1,3
TRBV9,TRBJ2-3,CASSVGGAYGTDTQYF,0,3,1,3
TRBV9,TRBJ2-3,CASSVDPGHATDTQYF,0,3,1,3
TRBV14,TRBJ2-2,CASSEAGVENTGELFF,0,3,1,3
TRBV5-5,TRBJ1-5,CASSTSLDRGGQPQHF,0,3,1,3
TRBV6-2/3/5/6,TRBJ2-3,CASSTTSGVSTDTQYF,0,3,1,3
TRBV5-4,TRBJ1-1,CASRVDLTAMNTEAFF,0,3,1,3
TRBV6-2/3/5/6,TRBJ2-3,CASRLGGTNPAYTQYF,0,3,1,3
TRBV5-1,TRBJ2-5,CASSWGLAGDLETQYF,0,3,1,3
TRBV5-1,TRBJ2-7,CASRRSSGGETYEQYF,0,3,1,3
TRBV12-3/4,TRBJ1-5,CASSFLLGDSNQPQHF,0,3,1,3
TRBV5-1,TRBJ2-7,CASSLAFLAGAYEQYF,0,3,1,3
TRBV5-1,TRBJ2-7,CASSLARTGFSYEQYF,0,3,1,3
TRBV5-1,TRBJ1-2,CASSLEGTVHYYGYTF,0,3,1,3
TRBV5-1,TRBJ2-3,CASSSGLAGGRGTQYF,0,3,1,3
TRBV5-1,TRBJ2-3,CASSSGLAGAIDTQYF,0,3,1,3
TRBV4-1,TRBJ1-1,CASSQSRGQGNTEAFF,0,3,1,3
TRBV4-1,TRBJ2-7,CASSQAGSFSSYEQYF,0,3,1,3
TRBV4-1,TRBJ2-7,CASSQGRTLSSYEQYF,0,3,1,3
TRBV4-1,TRBJ1-5,CASSQDAGAGNQPQHF,0,3,1,3
TRBV4-1,TRBJ2-2,CASSQNPSGGTGGAVF,0,3,1,3
TRBV5-1,TRBJ1-1,CASSTRDSSMNTEAYF,0,3,1,3
TRBV5-1,TRBJ2-4,CASRATPGQGFDIQYF,0,3,1,3
TRBV20-1,TRBJ1-5,CSASAPGLGSNQPQHF,0,3,1,3
TRBV20-1,TRBJ1-5,CSARDEGSESNQPQHF,0,3,1,3
TRBV20-1,TRBJ1-1,CSARDTTGYSNTVAFF,0,3,1,3
TRBV20-1,TRBJ1-5,CSAREPSRGSNQPQHF,0,3,1,3
TRBV6-1,TRBJ2-5,WASSAGTGGAGETQYF,0,3,1,3
TRBV7-9,TRBJ2-3,CAITYDGGLADTQYF,0,3,1,3
TRBV30,TRBJ2-3,CAWSVTSGSTDTQYF,0,3,1,3
TRBV30,TRBJ2-2,CAWSNQGLAHGELFF,0,3,1,3
TRBV30,TRBJ1-1,CAWSKGGPGNTEAFF,0,3,1,3
TRBV30,TRBJ1-5,CAWSHRRDSYQPQHF,0,3,1,3
TRBV30,TRBJ1-5,CAWSRDRGNNQPQHF,0,3,1,3
TRBV24-1,TRBJ1-5,CATPTGGHSNQPQHF,0,3,1,3
TRBV19,TRBJ1-1,CASTLGQGTNTEAFF,0,3,1,3
TRBV19,TRBJ1-2,CASSSDRGWDYGYTF,0,3,1,3
TRBV19,TRBJ1-5,CASSHRDRFNQPQHF,0,3,1,3
TRBV19,TRBJ2-1,CASSISGVSYNEQFF,0,3,1,3
TRBV19,TRBJ2-7,CASSMGRAADYEQYF,0,3,1,3
TRBV19,TRBJ2-5,CASSMDRRLGETQYF,0,3,1,3
TRBV19,TRBJ2-1,CASSIEPGLANEQFF,0,3,1,3
TRBV19,TRBJ1-1,CASSPGGGGGTEAFF,0,3,1,3
TRBV19,TRBJ2-3,CASSPTSAGADTQYF,0,3,1,3
TRBV28,TRBJ2-3,CASSISDMDTDTQYF,0,3,1,3
TRBV10-3,TRBJ2-5,CASSPLAGGQETQYF,0,3,1,3
TRBV18,TRBJ2-3,CASSPGTGGRDTQYF,0,3,1,3
TRBV18,TRBJ1-3,CASSPTDDPGNTIYF,0,3,1,3
TRBV18,TRBJ1-1,CASSPPVVLNTEAFF,0,3,1,3
TRBV18,TRBJ1-1,CASSPPGTGNTEAFS,0,3,1,3
TRBV18,TRBJ1-1,CASSPPGQGGTEAFF,0,3,1,3
TRBV18,TRBJ2-7,CASSHGGQGVYEQYF,0,3,1,3
TRBV6-4,TRBJ1-5,CASVRGPSGNQPQHF,0,3,1,3
TRBV2,TRBJ1-5,CASGGQGFSNQPQHF,0,3,1,3
TRBV12-3/4,TRBJ2-7,CASTPGGGFDYEQYF,0,3,1,3
TRBV28,TRBJ2-7,CASTPTGLGPYEQYF,0,3,1,3
TRBV7-6,TRBJ1-1,CASTARWGSNTEAFF,0,3,1,3
TRBV18,TRBJ1-5,CASTTGKGNNQPQHF,0,3,1,3
TRBV18,TRBJ2-1,CASTKGGPPYNEQFF,0,3,1,3
TRBV27,TRBJ1-4,CASSFRRATNEKLFF,0,3,1,3
TRBV12-3/4,TRBJ2-7,CASSFDSGLGGEQYF,0,3,1,3
TRBV28,TRBJ2-3,CASSFPGLAKDTQYF,0,3,1,3
TRBV12-3/4,TRBJ1-4,CASSFATGDNENLFF,0,3,1,3
TRBV12-3/4,TRBJ1-5,CASSFGAGQGQPQHF,0,3,1,3
TRBV28,TRBJ1-6,CASSLRTVIDSPLHF,0,3,1,3
TRBV28,TRBJ2-7,CASSLLAGATREQYF,0,3,1,3
TRBV27,TRBJ1-3,CASSLQGVSGNTIYF,0,3,1,3
TRBV12-3/4,TRBJ2-7,CASSLTFQGMDEQYF,0,3,1,3
TRBV7-2,TRBJ1-4,CASSSVTEGREKLFF,0,3,1,3
TRBV6-2/3/5/6,TRBJ2-5,CASSSADRGRATQYF,0,3,1,3
TRBV28,TRBJ2-7,CASSSPFSGVYEQYS,0,3,1,3
TRBV6-2/3/5/6,TRBJ2-7,CASSSRQAIGDEQYF,0,3,1,3
TRBV6-2/3/5/6,TRBJ2-3,CASSYFLGRTDTQYF,0,3,1,3
TRBV6-2/3/5/6,TRBJ2-6,CASSYSNTGANVLTF,0,3,1,3
TRBV6-2/3/5/6,TRBJ2-6,CASSYSAYGANVLTF,0,3,1,3
TRBV6-2/3/5/6,TRBJ2-7,CASSLLRTGRYEQYF,0,3,1,3
TRBV6-2/3/5/6,TRBJ1-1,CASSLSGLLNTEAFF,0,3,1,3
TRBV6-4,TRBJ2-3,CASSLGLAGADTQYF,0,3,1,3
TRBV2,TRBJ1-5,CASSPWQAANQPQHF,0,3,1,3
TRBV6-2/3/5/6,TRBJ1-6,CASSPDRAANSPLHF,0,3,1,3
TRBV7-9,TRBJ2-1,CASSRPSVPDNEQFF,0,3,1,3
TRBV28,TRBJ2-1,CASSRLAGLYNEQFF,0,3,1,3
TRBV11-1,TRBJ2-7,CASSQAGLYSYEQYF,0,3,1,3
TRBV6-1,TRBJ2-4,CASSGQQGAKNIQYF,0,3,1,3
TRBV2,TRBJ1-2,CASSDTGAQGYGYTF,0,3,1,3
TRBV2,TRBJ1-5,CASSESGGSNQPQHF,0,3,1,3
TRBV25-1,TRBJ2-7,CASSEWKRGSYEQYF,0,3,1,3
TRBV6-1,TRBJ1-1,CASSEYGQLNTEAFF,0,3,1,3
TRBV2,TRBJ1-1,CASSEAGGFYTEAFF,0,3,1,3
TRBV6-1,TRBJ2-5,CASSEMAGGQETQYF,0,3,1,3
TRBV6-2/3/5/6,TRBJ1-6,CASSTRTGDNSPLHF,0,3,1,3
TRBV2,TRBJ2-5,CASSNPGGGKETQYF,0,3,1,3
TRBV5-5,TRBJ2-2,CASSFYDDDTGELFF,0,3,1,3
TRBV7-2,TRBJ1-2,CASSFGAGDVGGYTF,0,3,1,3
TRBV5-6,TRBJ1-5,CASSLVGESNQPQHF,0,3,1,3
TRBV5-4,TRBJ1-2,CASSLAQGFNYGYTF,0,3,1,3
TRBV7-3,TRBJ2-3,CASSLGLRGTDTQYF,0,3,1,3
TRBV5-5,TRBJ2-1,CASSLSQGFYNEQFF,0,3,1,3
TRBV7-9,TRBJ2-1,CASSLLGAAYNEQFF,0,3,1,3
TRBV11-3,TRBJ2-1,CASSLSASLGNEQFF,0,3,1,3
TRBV7-2,TRBJ1-1,CASSLVGGMNTEAFF,0,3,1,3
TRBV11-2,TRBJ2-1,CASSLVTGGHNEQFF,0,3,1,3
TRBV11-2,TRBJ2-1,CASSLATGEHNEQFF,0,3,1,3
TRBV7-9,TRBJ2-3,CASSLARRGTDTQYF,0,3,1,3
TRBV7-6,TRBJ2-5,CASSLAVQPQETQYF,0,3,1,3
TRBV7-9,TRBJ2-5,CASSLDLARQETQYF,0,3,1,3
TRBV11-2,TRBJ1-1,CASSLDGGMDTEAFF,0,3,1,3
TRBV7-9,TRBJ2-5,CASSLDMEGRETQYF,0,3,1,3
TRBV5-4,TRBJ2-2,CASSLDNTNTGELFF,0,3,1,3
TRBV7-9,TRBJ2-3,CASSLEGQVADTQYF,0,3,1,3
TRBV7-2,TRBJ2-3,CASSLETGGTDTQYF,0,3,1,3
TRBV7-2,TRBJ2-7,CASSLIASPKDEQCI,0,3,1,3
TRBV7-9,TRBJ2-3,CASSLTGFFADTQYF,0,3,1,3
TRBV11-2,TRBJ2-7,CASSLRPGQGREQYF,0,3,1,3
TRBV11-2,TRBJ2-1,CASSSRDTTYNEQFF,0,3,1,3
TRBV7-9,TRBJ2-3,CASSSLSGVTDTQYF,0,3,1,3
TRBV7-2,TRBJ2-3,CASSSQQGITDMQYF,0,3,1,3
TRBV7-9,TRBJ2-7,CASSSASRYPYEQYF,0,3,1,3
TRBV7-2,TRBJ2-3,CASSLSGGAGDTQYF,0,3,1,3
TRBV7-9,TRBJ2-1,CASSLTGVSYNEQFF,0,3,1,3
TRBV5-4,TRBJ2-1,CASSLERGRYNEQFF,0,3,1,3
TRBV11-1,TRBJ2-3,CASSLKLASTDTQYF,0,3,1,3
TRBV7-9,TRBJ1-6,CASSPSGTANSPLHY,0,3,1,3
TRBV5-4,TRBJ2-1,CASSPLRDHPNEQFF,0,3,1,3
TRBV7-2,TRBJ2-3,CASSPGYLNTDTQYF,0,3,1,3
TRBV6-2/3/5/6,TRBJ2-1,CASSPGASALGEQFF,0,3,1,3
TRBV7-3,TRBJ2-1,CASSPGLAGYNEQFF,0,3,1,3
TRBV28,TRBJ1-3,CASSPEGLSGNTIYF,0,3,1,3
TRBV28,TRBJ1-5,CASSPRGIGDQPQHF,0,3,1,3
TRBV7-9,TRBJ2-7,CASSPMGARQGEQYF,0,3,1,3
TRBV7-9,TRBJ1-4,CASSPSSRLNEKLFF,0,3,1,3
TRBV7-3,TRBJ2-3,CASSRGGATTNTQYF,0,3,1,3
TRBV3-1,TRBJ2-7,CASSRTGGPSYEQYF,0,3,1,3
TRBV7-9,TRBJ2-1,CASSRGRGGTDEQFF,0,3,1,3
TRBV5-6,TRBJ1-2,CASSRTPGPTYGYTF,0,3,1,3
TRBV3-1,TRBJ1-2,CASSHPGQSYYGYTF,0,3,1,3
TRBV5-5,TRBJ1-4,CASSQGPTGSEKLFF,0,3,1,3
TRBV3-1,TRBJ2-2,CASSQHGGGTGELFF,0,3,1,3
TRBV3-1,TRBJ2-7,CASSQAGTGFYEQYF,0,3,1,3
TRBV4-2,TRBJ2-7,CASSQGLAGLYEQYF,0,3,1,3
TRBV3-1,TRBJ1-1,CASSQGGTGLTEAFF,0,3,1,3
TRBV3-1,TRBJ2-5,CASSQGSLIQETQYF,0,3,1,3
TRBV3-1,TRBJ2-7,CASSQDVSRTSEQYF,0,3,1,3
TRBV3-1,TRBJ2-5,CASSQDIGSRETQYF,0,3,1,3
TRBV3-1,TRBJ2-7,CASSQEGGRSYEQYF,0,3,1,3
TRBV7-2,TRBJ2-1,CASSVLAGALNEQFF,0,3,1,3
TRBV9,TRBJ1-6,CASSVALGFASPLHF,0,3,1,3
TRBV11-2,TRBJ2-7,CASSDTSGGAYEQYF,0,3,1,3
TRBV12-3/4,TRBJ2-7,CASSMIQGSSYEQYF,0,3,1,3
TRBV7-9,TRBJ2-7,CASSTRSMPLYEQYF,0,3,1,3
TRBV13,TRBJ2-7,CASSTGQGATYEQYF,0,3,1,3
TRBV7-9,TRBJ1-3,CASSRAGGIGNTIYF,0,3,1,3
TRBV11-2,TRBJ2-3,CASSNMGRGTDTQYF,0,3,1,3
TRBV7-9,TRBJ2-3,CASSKRRIGTDTQYF,0,3,1,3
TRBV11-2,TRBJ2-7,CASRKWGGVLDEQYF,0,3,1,3
TRBV7-3,TRBJ2-7,CASRPGLAGTNEQYF,0,3,1,3
TRBV11-2,TRBJ2-1,CASRPGTGTYNEQFF,0,3,1,3
TRBV7-8,TRBJ2-7,CASREGVTSSYEQYF,0,3,1,3
TRBV7-3,TRBJ1-1,CASRKSQAMNTEAFF,0,3,1,3
TRBV7-9,TRBJ2-2,CASNHATPRTGELFF,0,3,1,3
TRBV6-4,TRBJ2-7,CASNERGTGAYEQYF,0,3,1,3
TRBV5-1,TRBJ2-7,CPSSSGDKILDEQYF,0,3,1,3
TRBV5-1,TRBJ2-1,CASCYAAGGPDEQFF,0,3,1,3
TRBV5-1,TRBJ1-5,CASATGGVGNQPQHF,0,3,1,3
TRBV10-1,TRBJ2-7,CASSESGRSSYEQYF,0,3,1,3
TRBV5-1,TRBJ2-7,CASSSPAGGRDEQYF,0,3,1,3
TRBV5-1,TRBJ2-5,CASSLYGIGQETQYF,0,3,1,3
TRBV5-1,TRBJ2-5,CASSLVSGGEQTQYF,0,3,1,3
TRBV5-1,TRBJ1-1,CASSLASAGNTEAFF,0,3,1,3
TRBV5-1,TRBJ1-6,CASSLAGTSRSPLLF,0,3,1,3
TRBV5-1,TRBJ2-3,CASSLRQAGTDTQYF,0,3,1,3
TRBV5-1,TRBJ1-6,CASSLEGGGNSPLHF,0,3,1,3
TRBV5-1,TRBJ2-1,CASSSSGGIAHEQFF,0,3,1,3
TRBV5-1,TRBJ2-6,CASSWTVSGANVLTF,0,3,1,3
TRBV4-1,TRBJ2-1,CASSLESAVWDEQFF,0,3,1,3
TRBV4-1,TRBJ2-5,CASSLRDTTSETQYF,0,3,1,3
TRBV5-1,TRBJ2-3,CASSPLAGGPDTQYF,0,3,1,3
TRBV5-1,TRBJ2-1,CASSQRTGNSVGWFF,0,3,1,3
TRBV4-1,TRBJ1-1,CASSQAIGAGTEAFF,0,3,1,3
TRBV4-1,TRBJ1-3,CASSAWTGTRNTIYF,0,3,1,3
TRBV5-1,TRBJ2-7,CASSEGLAGYNEQYF,0,3,1,3
TRBV5-1,TRBJ2-1,CASSTTSGGGDEQFF,0,3,1,3
TRBV5-1,TRBJ2-2,CASRIGGANTGELFF,0,3,1,3
TRBV20-1,TRBJ2-1,CSALGGGGSYNEQFF,0,3,1,3
TRBV20-1,TRBJ2-7,CSATNPGAGLNEQYF,0,3,1,3
TRBV20-1,TRBJ2-7,CSASSAGGLYYEQYF,0,3,1,3
TRBV20-1,TRBJ2-5,CSARDEGGARETQYF,0,3,1,3
TRBV20-1,TRBJ2-1,CSARDTGGPINEQFF,0,3,1,3
TRBV20-1,TRBJ2-5,CSARDEGGAQETQYF,0,3,1,3
TRBV20-1,TRBJ2-6,CSARATETGANVLTF,0,3,1,3
TRBV29-1,TRBJ2-5,CSVGEGSEVQETQYF,0,3,1,3
TRBV29-1,TRBJ2-3,CSVESGSGGTDTQYF,0,3,1,3
TRBV29-1,TRBJ2-1,CSVEKDSEINNEQFF,0,3,1,3
TRBV29-1,TRBJ2-1,CSVGGKRDRYNEQFF,0,3,1,3
TRBV10-3,TRBJ1-5,RAISADRVGKQPQHF,0,3,1,3
TRBV18,TRBJ2-1,RASPPSINSYNEQFF,0,3,1,3
TRBV29-1,TRBJ2-1,RSVESRGNAYKEQFF,0,3,1,3
TRBV28,TRBJ2-3,CAIGASGGADTQYF,0,3,1,3
TRBV12-5,TRBJ2-1,CASGFGGLKGEQFF,0,3,1,3
TRBV30,TRBJ1-1,CASKGGSQNTEAFF,0,3,1,3
TRBV30,TRBJ2-2,CASTRGLDTGELFF,0,3,1,3
TRBV30,TRBJ1-4,CAWSFDSVNEKLFF,0,3,1,3
TRBV30,TRBJ1-2,CAWSPDHRGSGYTF,0,3,1,3
TRBV30,TRBJ1-1,CAWSVTGSSTEAFF,0,3,1,3
TRBV30,TRBJ2-3,CAWSGQGRTDTQYF,0,3,1,3
TRBV28,TRBJ1-1,CAVNGGGRVTEAFF,0,3,1,3
TRBV30,TRBJ2-7,CAGGMTGGPYEQYF,0,3,1,3
TRBV10-3,TRBJ2-3,CAITSGGHTDTQYF,0,3,1,3
TRBV10-3,TRBJ1-6,CAIRQGEHNSPLHF,0,3,1,3
TRBV10-3,TRBJ2-1,CAIRENDSPNEQFF,0,3,1,3
TRBV11-2,TRBJ2-7,CATRIAGSSYEQYF,0,3,1,3
TRBV15,TRBJ2-5,CATSRGEAQETQYF,0,3,1,3
TRBV19,TRBJ2-7,CASSPPGQFYEQYF,0,3,1,3
TRBV19,TRBJ1-5,CASSIRQGSQPQHF,0,3,1,3
TRBV19,TRBJ1-5,CASSTFPGNQPQHF,0,3,1,3
TRBV19,TRBJ2-3,CASSSGGGTDTQYF,0,3,1,3
TRBV19,TRBJ2-7,CASSAGLFLYEQYF,0,3,1,3
TRBV12-3/4,TRBJ2-1,CASSREGSRNEQFF,0,3,1,3
TRBV18,TRBJ2-5,CASSSGLNQETQYF,0,3,1,3
TRBV18,TRBJ2-2,CASSPRDGTGELFF,0,3,1,3
TRBV18,TRBJ1-3,CASSPDTSGNTIYF,0,3,1,3
TRBV18,TRBJ2-7,CASSPRGVGSEQYF,0,3,1,3
TRBV18,TRBJ2-5,CASSALGYQETQYF,0,3,1,3
TRBV12-3/4,TRBJ1-1,CASRDRLVNTEAFF,0,3,1,3
TRBV28,TRBJ1-4,CASHRAGRNEKLFF,0,3,1,3
TRBV4-2,TRBJ2-3,CASGTSGGSDTQYF,0,3,1,3
TRBV6-2/3/5/6,TRBJ2-5,CASIRHLNQETQYF,0,3,1,3
TRBV3-1,TRBJ2-5,CASIDRGKGETQYF,0,3,1,3
TRBV6-1,TRBJ1-4,CASTAGTGNEKLLF,0,3,1,3
TRBV7-9,TRBJ1-2,CASTVSRVNYGYTF,0,3,1,3
TRBV12-3/4,TRBJ2-7,CASSFGQGPSLQYF,0,3,1,3
TRBV28,TRBJ2-1,CASSLGYSYNEQFF,0,3,1,3
TRBV6-2/3/5/6,TRBJ2-1,CASSLLAGNNEQFF,0,3,1,3
TRBV27,TRBJ2-7,CASSLRQGSYEQYF,0,3,1,3
TRBV12-3/4,TRBJ1-5,CASSLQGGGQPQHF,0,3,1,3
TRBV12-3/4,TRBJ2-3,CASSLGGSTDTQYF,0,3,1,3
TRBV6-2/3/5/6,TRBJ2-7,CASSLERGDNEQYF,0,3,1,3
TRBV2,TRBJ2-7,CASSSTGGDYEQYF,0,3,1,3
TRBV12-3/4,TRBJ2-3,CASSWAGDTDTQYF,0,3,1,3
TRBV28,TRBJ1-5,CASSWDRTGQPQHF,0,3,1,3
TRBV6-2/3/5/6,TRBJ2-7,CASSYTSTRAGQYF,0,3,1,3
TRBV6-2/3/5/6,TRBJ2-3,CASSYTGSTDTQYF,0,3,1,3
TRBV28,TRBJ1-1,CASSPLTSGTEAFF,0,3,1,3
TRBV6-2/3/5/6,TRBJ2-5,CASSRTLSGETQYF,0,3,1,3
TRBV6-4,TRBJ2-7,CASSALGQTYEQYF,0,3,1,3
TRBV6-1,TRBJ2-1,CASSGTNPYNEQFF,0,3,1,3
TRBV2,TRBJ1-4,CASSDRGMDEKLFF,0,3,1,3
TRBV2,TRBJ2-5,CASSEAWTQETQYF,0,3,1,3
TRBV2,TRBJ1-2,CASSEGEFNYGYTF,0,3,1,3
TRBV6-1,TRBJ1-4,CASSEDGINEKLFF,0,3,1,3
TRBV12-3/4,TRBJ1-2,CASSIRYMSYGYTF,0,3,1,3
TRBV7-9,TRBJ2-1,CASSFWQGPNEQFF,0,3,1,3
TRBV7-6,TRBJ2-1,CASSFGGDGYEQFF,0,3,1,3
TRBV7-9,TRBJ1-4,CASSFGTTNENLFF,0,3,1,3
TRBV5-5,TRBJ1-5,CASSLWQGEQPQHF,0,3,1,3
TRBV5-4,TRBJ2-5,CASSLASAGETQYF,0,3,1,3
TRBV5-5,TRBJ1-3,CASSLGPGGNTIYF,0,3,1,3
TRBV7-9,TRBJ2-7,CASSLMDSSYEQYF,0,3,1,3
TRBV5-6,TRBJ2-7,CASSLTGGTYEQYF,0,3,1,3
TRBV28,TRBJ1-1,CASSLQGQNTEAFF,0,3,1,3
TRBV7-9,TRBJ2-7,CASSLVGTEDEQYF,0,3,1,3
TRBV7-2,TRBJ1-2,CASSLMGQNYGYTF,0,3,1,3
TRBV7-3,TRBJ2-5,CASSLTGIGETQNF,0,3,1,3
TRBV7-9,TRBJ2-7,CASSSTLILYEQYF,0,3,1,3
TRBV13,TRBJ2-7,CASSSPSTPYEQYF,0,3,1,3
TRBV7-9,TRBJ1-1,CASSSGRANTEAFF,0,3,1,3
TRBV7-3,TRBJ2-4,CASSSGQGEDIQYF,0,3,1,3
TRBV7-2,TRBJ2-7,CASSLGGHSYEQYF,0,3,1,3
TRBV3-1,TRBJ2-4,CASSLTSQRNIQYF,0,3,1,3
TRBV5-4,TRBJ2-7,CASSLGDNSYEQYF,0,3,1,3
TRBV7-2,TRBJ1-1,CASSLGRRATEAFF,0,3,1,3
TRBV3-1,TRBJ1-5,CASSPRTGNQPQHF,0,3,1,3
TRBV5-4,TRBJ2-3,CASSPGQRTDTQYF,0,3,1,3
TRBV28,TRBJ2-7,CASSPDPGQSEQYF,0,3,1,3
TRBV3-1,TRBJ2-1,CASSPEGRGSEQFF,0,3,1,3
TRBV3-1,TRBJ1-5,CASSPRQSNQPQHF,0,3,1,3
TRBV6-2/3/5/6,TRBJ2-4,CASSPRSGENIQYF,0,3,1,3
TRBV3-1,TRBJ2-7,CASSPRTSRGEQYF,0,3,1,3
TRBV7-8,TRBJ1-1,CASSPTGGNTEAFF,0,3,1,3
TRBV14,TRBJ2-1,CASSPSLVIYEQFF,0,3,1,3
TRBV3-1,TRBJ1-4,CASSPAGGGEKLFF,0,3,1,3
TRBV2,TRBJ2-3,CASSPTPILDTQYF,0,3,1,3
TRBV12-3/4,TRBJ2-7,CASSRGTYTYEQYF,0,3,1,3
TRBV7-6,TRBJ1-1,CASSRGGEHTEAFF,0,3,1,3
TRBV2,TRBJ1-2,CASSRTGDHYGYTF,0,3,1,3
TRBV7-9,TRBJ1-5,CASSRQNSNQPQHF,0,3,1,3
TRBV3-1,TRBJ2-2,CASSRTGYTGELFF,0,3,1,3
TRBV4-2,TRBJ2-1,CASSHDHSYNEQFF,0,3,1,3
TRBV5-5,TRBJ2-7,CASSHRGRTYEQYF,0,3,1,3
TRBV7-8,TRBJ1-1,CASSHREGSTEAFF,0,3,1,3
TRBV3-1,TRBJ1-5,CASSQDPSNQPQHF,0,3,1,3
TRBV4-2,TRBJ1-5,CASSQEVSGQPQHF,0,3,1,3
TRBV3-1,TRBJ2-1,CASSQEGTDGQQFF,0,3,1,3
TRBV9,TRBJ2-7,CASSQTGAPYEQYF,0,3,1,3
TRBV3-1,TRBJ1-1,CASSQSLRNTEAFF,0,3,1,3
TRBV7-9,TRBJ1-1,CASSVGQGNTEAFF,0,3,1,3
TRBV13,TRBJ1-1,CASSADRTVHEAFF,0,3,1,3
TRBV7-6,TRBJ2-5,CASSGWTFQETQYF,0,3,1,3
TRBV28,TRBJ2-3,CASSGGAYTDTQYF,0,3,1,3
TRBV7-9,TRBJ2-5,CASSDPGGLETQYF,0,3,1,3
TRBV12-3/4,TRBJ1-5,CASSDIYSNQPQHF,0,3,1,3
TRBV5-6,TRBJ2-7,CASSIPGQDYEQYF,0,3,1,3
TRBV9,TRBJ2-5,CASSRTSNQETQYF,0,3,1,3
TRBV6-2/3/5/6,TRBJ2-3,CASSRAGSTDTQYF,0,3,1,3
TRBV7-2,TRBJ2-5,CASSNAGGQETQYF,0,3,1,3
TRBV7-9,TRBJ1-1,CASRWDRGATEAFF,0,3,1,3
TRBV6-2/3/5/6,TRBJ1-5,CASRLTGGRQPQHF,0,3,1,3
TRBV6-2/3/5/6,TRBJ2-1,CASRPWGQNNEQFF,0,3,1,3
TRBV12-3/4,TRBJ1-5,CASRQTRGLQPQHF,0,3,1,3
TRBV2,TRBJ2-2,CASRGRTNTGELFF,0,3,1,3
TRBV2,TRBJ2-7,CASRGRGHSYEQYF,0,3,1,3
TRBV12-3/4,TRBJ2-1,CASRGLAGFDEQFF,0,3,1,3
TRBV2,TRBJ1-2,CASRDLTGSYGYTF,0,3,1,3
TRBV28,TRBJ2-7,CASRRAGGDCEQYF,0,3,1,3
TRBV6-2/3/5/6,TRBJ2-7,CASRQDRVHYEQYF,0,3,1,3
TRBV12-3/4,TRBJ2-3,CASNEGPFTDTQYF,0,3,1,3
TRBV28,TRBJ2-2,CASKFQGNTGELFF,0,3,1,3
TRBV28,TRBJ2-2,CASKVAWKGGQLFF,0,3,1,3
TRBV2,TRBJ2-7,CASKPTQGSYEQYF,0,3,1,3
TRBV5-6,TRBJ2-2,CDSSFTRNTGELFF,0,3,1,3
TRBV18,TRBJ2-5,CASSPPGIQETQYF,0,3,1,3
TRBV5-1,TRBJ2-7,CASRPGLADYEQYF,0,3,1,3
TRBV5-1,TRBJ2-1,CASATGQRVSEQFF,0,3,1,3
TRBV5-1,TRBJ2-7,CASSWDRPQYEQYF,0,3,1,3
TRBV5-1,TRBJ1-5,CASSFTGMDQPQHF,0,3,1,3
TRBV5-1,TRBJ1-4,CASSFSGGDEKLFF,0,3,1,3
TRBV5-1,TRBJ1-1,CASSLQRASGAAFF,0,3,1,3
TRBV5-1,TRBJ1-1,CASSLVPGDTEAFF,0,3,1,3
TRBV5-1,TRBJ2-7,CASSLAGTSYEQYF,0,3,1,3
TRBV5-1,TRBJ1-5,CASSLAGEGQPQHF,0,3,1,3
TRBV5-1,TRBJ2-5,CASSLASTQETQYF,0,3,1,3
TRBV5-1,TRBJ1-2,CASSLGDSNYGYTF,0,3,1,3
TRBV5-1,TRBJ2-7,CASSLSDQSYEQYF,0,3,1,3
TRBV5-1,TRBJ1-4,CASSPQSLNEKLFF,0,3,1,3
TRBV5-1,TRBJ2-7,CASSPGQVSYEQYF,0,3,1,3
TRBV5-1,TRBJ1-1,CASSPWVTNTEAFF,0,3,1,3
TRBV5-1,TRBJ1-1,CASSPGGGVTEAFF,0,3,1,3
TRBV4-1,TRBJ2-7,CASSPSGSTYEQYF,0,3,1,3
TRBV5-1,TRBJ2-5,CASSQQTSGETQYF,0,3,1,3
TRBV4-1,TRBJ1-5,CASSQTGVAQPQHF,0,3,1,3
TRBV5-1,TRBJ1-1,CASSVTGTSTEAFF,0,3,1,3
TRBV5-1,TRBJ2-5,CASRPMGVQETQYF,0,3,1,3
TRBV20-1,TRBJ2-2,CGALGTINTGELFF,0,3,1,3
TRBV20-1,TRBJ2-2,CSVVRDREGGELFF,0,3,1,3
TRBV20-1,TRBJ2-5,CSAPPGQGQETQYF,0,3,1,3
TRBV20-1,TRBJ1-5,CSASLGMGNQPQHF,0,3,1,3
TRBV20-1,TRBJ1-4,CSASVSGTGEKLFF,0,3,1,3
TRBV20-1,TRBJ2-1,CSARDRLAGGPLFF,0,3,1,3
TRBV20-1,TRBJ1-6,CSARWDGGDSPLHF,0,3,1,3
TRBV20-1,TRBJ2-3,CSARPSGGTYTQYF,0,3,1,3
TRBV20-1,TRBJ1-1,CSARVLEANTEAFF,0,3,1,3
TRBV20-1,TRBJ2-3,CSARDRGGTDTQYF,0,3,1,3
TRBV20-1,TRBJ1-6,CSAREGSLRSPLHF,0,3,1,3
TRBV20-1,TRBJ2-4,CSARSRGFQNIQYF,0,3,1,3
TRBV20-1,TRBJ2-4,CSALGGAALYIQYF,0,3,1,3
TRBV20-1,TRBJ2-5,CSADAGPGKETQYF,0,3,1,3
TRBV20-1,TRBJ2-3,CSAGVFSPTDTQYF,0,3,1,3
TRBV29-1,TRBJ1-1,CSVVGGELNTEAFF,0,3,1,3
TRBV29-1,TRBJ1-5,CSVVAGTGDQPQHF,0,3,1,3
TRBV29-1,TRBJ1-2,CSVGLGQGAYGYTF,0,3,1,3
TRBV29-1,TRBJ2-1,CSVGGLSSYNEQFF,0,3,1,3
TRBV29-1,TRBJ2-3,CSVEGRGAPDTQYF,0,3,1,3
TRBV29-1,TRBJ2-7,CSVERGYTPAEQYF,0,3,1,3
TRBV29-1,TRBJ2-5,CSVERTGRRETQYF,0,3,1,3
TRBV29-1,TRBJ2-6,CSVSSLSGANVLTF,0,3,1,3
TRBV29-1,TRBJ2-7,CSVRLGDFFDEQYF,0,3,1,3
TRBV29-1,TRBJ2-7,CSVALSGVAYEQYF,0,3,1,3
TRBV18,TRBJ1-5,WASSPGQGNQPQHF,0,3,1,3
TRBV7-9,TRBJ2-7,RASSLAGTTYEQYF,0,3,1,3
TRBV7-2,TRBJ2-3,RASSPGTNPDTQYF,0,3,1,3
TRBV29-1,TRBJ2-7,GSATSGLRTGEQYF,0,3,1,3
TRBV7-8,TRBJ2-1,CVTRRRDYNEQFF,0,3,1,3
TRBV7-7,TRBJ2-3,CASSLQGTDTQYF,0,3,1,3
TRBV30,TRBJ1-2,CASTTGVNYGYTF,0,3,1,3
TRBV30,TRBJ2-7,CAWTMAGGDEQYF,0,3,1,3
TRBV30,TRBJ1-4,CAWTIQGDEKLFF,0,3,1,3
TRBV15,TRBJ2-5,CATSTGEKETQYF,0,3,1,3
TRBV19,TRBJ2-7,CASSSPTRYEQYF,0,3,1,3
TRBV6-2/3/5/6,TRBJ2-1,CASFNRISNEQFF,0,3,1,3
TRBV18,TRBJ2-5,CASSPNSHETQYF,0,3,1,3
TRBV18,TRBJ1-5,CASSPQGDQPQHF,0,3,1,3
TRBV18,TRBJ2-3,CASSTSGTDTQYF,0,3,1,3
TRBV2,TRBJ2-3,CASCNREADTQYF,0,3,1,3
TRBV11-2,TRBJ1-1,CASQRAGKSEAFF,0,3,1,3
TRBV14,TRBJ1-1,CASGPHLNTEAFF,0,3,1,3
TRBV12-3/4,TRBJ1-2,CASGGRGGYGYTF,0,3,1,3
TRBV28,TRBJ2-5,CASIDQWEETQYF,0,3,1,3
TRBV12-3/4,TRBJ1-2,CASTPSGLYGYTF,0,3,1,3
TRBV7-2,TRBJ1-2,CASTPWGVYGYTF,0,3,1,3
TRBV7-9,TRBJ2-3,CASTPRDTDTQYF,0,3,1,3
TRBV6-2/3/5/6,TRBJ2-7,CASSFPPLYEQYF,0,3,1,3
TRBV12-3/4,TRBJ2-3,CASSFGSTDTQYF,0,3,1,3
TRBV11-2,TRBJ2-5,CASSFTEQETQYC,0,3,1,3
TRBV28,TRBJ2-5,CASSLSGQETQYF,0,3,1,3
TRBV12-3/4,TRBJ2-1,CASSLGQLNEQFF,0,3,1,3
TRBV27,TRBJ1-1,CASSLRIFHEAFF,0,3,1,3
TRBV6-2/3/5/6,TRBJ2-7,CASSYSRGNEQYF,0,3,1,3
TRBV28,TRBJ2-7,CASSYLQGIEQYF,0,3,1,3
TRBV6-2/3/5/6,TRBJ1-2,CASSLTGSLGYTF,0,3,1,3
TRBV28,TRBJ2-7,CASSPPQVYEQYF,0,3,1,3
TRBV6-1,TRBJ1-5,CASSRTPTPPQHF,0,3,1,3
TRBV6-2/3/5/6,TRBJ2-7,CASSQGSSYEQYF,0,3,1,3
TRBV11-1,TRBJ2-1,CASSVTGYNEQFF,0,3,1,3
TRBV2,TRBJ1-6,CASSAWVNSPLHF,0,3,1,3
TRBV12-3/4,TRBJ2-4,CASSGLAKNIQYF,0,3,1,3
TRBV25-1,TRBJ2-3,CASSEYTGTAQYF,0,3,1,3
TRBV6-1,TRBJ1-2,CASSSSGIYGYTF,0,3,1,3
TRBV11-2,TRBJ1-1,CASSFEGANEAFF,0,3,1,3
TRBV11-2,TRBJ2-3,CASSFSGTDTQYF,0,3,1,3
TRBV6-2/3/5/6,TRBJ1-1,CASSFGTGSEAFF,0,3,1,3
TRBV11-3,TRBJ2-5,CASSFGTEETQYF,0,3,1,3
TRBV7-2,TRBJ2-1,CASSLFWTDEQFF,0,3,1,3
TRBV7-8,TRBJ2-3,CASSLEGTDTQYF,0,3,1,3
TRBV7-2,TRBJ2-1,CASSLMGYNEQFF,0,3,1,3
TRBV7-9,TRBJ1-5,CASSLQGDQPQHF,0,3,1,3
TRBV11-3,TRBJ2-3,CASSLGRADTQYF,0,3,1,3
TRBV11-2,TRBJ1-5,CASSLDISQPQHF,0,3,1,3
TRBV7-3,TRBJ1-6,CASSLDSNSPLHF,0,3,1,3
TRBV7-9,TRBJ2-5,CASSLEGRETQYF,0,3,1,3
TRBV7-9,TRBJ2-1,CASSLTGEYEQFF,0,3,1,3
TRBV7-3,TRBJ2-1,CASSLTTYNEQFF,0,3,1,3
TRBV7-3,TRBJ2-6,CASSSSGANVLTF,0,3,1,3
TRBV11-2,TRBJ1-1,CASSSVEGSEAFF,0,3,1,3
TRBV11-2,TRBJ2-1,CASSSDDYNEQFF,0,3,1,3
TRBV12-3/4,TRBJ1-5,CASSSDEKGAQHF,0,3,1,3
TRBV7-8,TRBJ2-5,CASSSGRWAPEYF,0,3,1,3
TRBV7-2,TRBJ2-3,CASSYSLADTQYF,0,3,1,3
TRBV3-1,TRBJ2-7,CASSLWSTGEQYF,0,3,1,3
TRBV3-1,TRBJ1-5,CASSLQGFEPQHF,0,3,1,3
TRBV7-3,TRBJ2-3,CASSPRGADTQYF,0,3,1,3
TRBV7-2,TRBJ2-7,CASSPATGEEQYF,0,3,1,3
TRBV14,TRBJ1-1,CASSPGLEVEAFF,0,3,1,3
TRBV6-2/3/5/6,TRBJ1-5,CASSRDLNQPQHF,0,3,1,3
TRBV3-1,TRBJ2-7,CASSREGTYEQYF,0,3,1,3
TRBV3-1,TRBJ1-1,CASSQGNTVEAFF,0,3,1,3
TRBV14,TRBJ2-7,CASSQTVLGQQYF,0,3,1,3
TRBV3-1,TRBJ2-2,CASSQYGSEALFF,0,3,1,3
TRBV3-1,TRBJ1-5,CASSQVGNQPQHF,0,3,1,3
TRBV12-3/4,TRBJ2-1,CASSVLELGEQFF,0,3,1,3
TRBV7-3,TRBJ1-1,CASSAQGNTEAFS,0,3,1,3
TRBV7-6,TRBJ2-3,CASSGFGAQAQYF,0,3,1,3
TRBV7-9,TRBJ1-4,CASSEVTDEKLFF,0,3,1,3
TRBV28,TRBJ1-2,CASSEQGARGYTF,0,3,1,3
TRBV13,TRBJ2-7,CASSTSWGIEQYF,0,3,1,3
TRBV3-1,TRBJ1-2,CASSKQGLNGYTF,0,3,1,3
TRBV28,TRBJ2-7,CASRPTGRYEQYF,0,3,1,3
TRBV5-4,TRBJ2-1,CASRVVSYNEQFF,0,3,1,3
TRBV7-9,TRBJ1-3,CASRGGAGNTIYF,0,3,1,3
TRBV11-2,TRBJ2-7,CASRNQTGYEQYF,0,3,1,3
TRBV12-3/4,TRBJ1-2,CASRHGQIDGYTF,0,3,1,3
TRBV6-4,TRBJ1-2,CASRDRDIYGYTF,0,3,1,3
TRBV12-3/4,TRBJ1-6,CASNQGFNSPLHF,0,3,1,3
TRBV12-3/4,TRBJ2-3,CASKLQGTDTQYF,0,3,1,3
TRBV12-3/4,TRBJ2-1,CANSLPTSVEQFF,0,3,1,3
TRBV7-6,TRBJ1-1,CASMRGRNTEAFF,0,3,1,3
TRBV28,TRBJ1-4,CASSLSTVEKLFF,0,3,1,3
TRBV5-1,TRBJ2-3,CASSIDNTDTQYF,0,3,1,3
TRBV5-1,TRBJ1-1,CASSLVENTEAFF,0,3,1,3
TRBV5-1,TRBJ1-1,CASSLAGTVEAFF,0,3,1,3
TRBV5-1,TRBJ1-5,CASSLDTDQPQHF,0,3,1,3
TRBV5-1,TRBJ1-1,CASSLERNTEAFF,0,3,1,3
TRBV5-1,TRBJ1-1,CASSLGQGELAFF,0,3,1,3
TRBV5-1,TRBJ2-1,CASSSGRVNEQFF,0,3,1,3
TRBV4-1,TRBJ2-3,CASSPLDPRAQYF,0,3,1,3
TRBV4-1,TRBJ1-1,CASSRQGATEAFF,0,3,1,3
TRBV4-1,TRBJ1-5,CASSQDLGQPQHF,0,3,1,3
TRBV10-2,TRBJ2-2,CASKQGYTGELFF,0,3,1,3
TRBV20-1,TRBJ1-5,CSAVAVSNQPQHF,0,3,1,3
TRBV20-1,TRBJ1-3,CSAMAEAGNTIYF,0,3,1,3
TRBV20-1,TRBJ1-5,CSASLQVSQPQHF,0,3,1,3
TRBV20-1,TRBJ2-5,CSARVGAVETQYF,0,3,1,3
TRBV20-1,TRBJ2-7,CSARGQGEYEQYF,0,3,1,3
TRBV20-1,TRBJ1-1,CSARRQLNTEAFF,0,3,1,3
TRBV20-1,TRBJ1-4,CSARGLSDEKLLF,0,3,1,3
TRBV20-1,TRBJ2-7,CSAPSGGHYEQYF,0,3,1,3
TRBV20-1,TRBJ2-5,CSAVRDRAKTQYF,0,3,1,3
TRBV20-1,TRBJ2-7,CSAGAGLANEQYF,0,3,1,3
TRBV29-1,TRBJ2-7,CSVVVGGSYEQYF,0,3,1,3
TRBV29-1,TRBJ1-1,CSVADRLNTEAFF,0,3,1,3
TRBV29-1,TRBJ1-5,CSVANRENQPQHF,0,3,1,3
TRBV29-1,TRBJ2-7,CSVDETGADEQYF,0,3,1,3
TRBV29-1,TRBJ1-5,CSVESGRDQPQHF,0,3,1,3
TRBV29-1,TRBJ1-3,CSVEVLSGNTIYF,0,3,1,3
TRBV29-1,TRBJ1-2,CSVGTGGDYGYTF,0,3,1,3
TRBV29-1,TRBJ2-5,CSVTSGDQETQYF,0,3,1,3
TRBV29-1,TRBJ1-1,CSVATGAGTEAFS,0,3,1,3
TRBV29-1,TRBJ1-1,CSVGDLGITEAFF,0,3,1,3
TRBV29-1,TRBJ2-5,CSIERGGKETQYF,0,3,1,3
TRBV5-1,TRBJ2-7,YASRQDVIYEQYF,0,3,1,3
TRBV30,TRBJ1-1,CACRQGNTEAFF,0,3,1,3
TRBV30,TRBJ2-2,CAWSDNTGELFF,0,3,1,3
TRBV30,TRBJ2-7,CAWSERPGEQYF,0,3,1,3
TRBV30,TRBJ2-7,CAWRGQGNEQYF,0,3,1,3
TRBV10-3,TRBJ2-3,CAIAGGKATQYF,0,3,1,3
TRBV19,TRBJ2-1,CASSTPGQGEFF,0,3,1,3
TRBV19,TRBJ1-2,CASRGPSYGYTF,0,3,1,3
TRBV18,TRBJ2-7,CASSPAPYEQYF,0,3,1,3
TRBV19,TRBJ1-1,CASGGHLTEAFF,0,3,1,3
TRBV6-2/3/5/6,TRBJ1-5,CASTGGNQPQHF,0,3,1,3
TRBV28,TRBJ1-1,CASSFYRTEAFF,0,3,1,3
TRBV6-2/3/5/6,TRBJ1-5,CASSLDSQPQHF,0,3,1,3
TRBV12-3/4,TRBJ2-5,CASSLDKETQYF,0,3,1,3
TRBV12-3/4,TRBJ2-5,CASSLLGETQYF,0,3,1,3
TRBV12-3/4,TRBJ2-1,CASSLWYGERFF,0,3,1,3
TRBV28,TRBJ2-1,CASSLQLNEQFF,0,3,1,3
TRBV28,TRBJ1-1,CASSLVNTEAFF,0,3,1,3
TRBV12-3/4,TRBJ2-5,CASSLGQETQYF,0,3,1,3
TRBV6-2/3/5/6,TRBJ2-5,CASSSDGGTQYF,0,3,1,3
TRBV6-2/3/5/6,TRBJ2-1,CASSYPGRKQFF,0,3,1,3
TRBV6-2/3/5/6,TRBJ2-7,CASSYMRGEQYF,0,3,1,3
TRBV7-9,TRBJ1-1,CASSPRGSEAFF,0,3,1,3
TRBV2,TRBJ2-5,CASSDVLETQYF,0,3,1,3
TRBV12-3/4,TRBJ2-7,CASSRGLPEQYF,0,3,1,3
TRBV11-2,TRBJ2-7,CASSFSIYEQYF,0,3,1,3
TRBV7-9,TRBJ2-7,CASSLGGYEQYF,0,3,1,3
TRBV7-9,TRBJ1-5,CASSLEAQPQHF,0,3,1,3
TRBV28,TRBJ1-2,CASSSSAYGYTF,0,3,1,3
TRBV11-2,TRBJ2-4,CASSSRGQGVEF,0,3,1,3
TRBV6-2/3/5/6,TRBJ2-7,CASSYGTYEQYF,0,3,1,3
TRBV7-9,TRBJ2-7,CASSPSSYEQYF,0,3,1,3
TRBV12-3/4,TRBJ1-5,CASSPPFQPQHF,0,3,1,3
TRBV7-9,TRBJ1-1,CASSQWNTEAFF,0,3,1,3
TRBV14,TRBJ1-2,CASSQQNGGYTF,0,3,1,3
TRBV28,TRBJ2-7,CASRRSSYEQYF,0,3,1,3
TRBV12-3/4,TRBJ1-6,CASRVNNSPLHF,0,3,1,3
TRBV12-3/4,TRBJ2-7,CASRRGSYEQHF,0,3,1,3
TRBV3-1,TRBJ1-1,CASRGQTGEAFF,0,3,1,3
TRBV28,TRBJ1-5,CASRSSNQPQHF,0,3,1,3
TRBV11-3,TRBJ2-3,CASGQRTDTQYS,0,3,1,3
TRBV5-1,TRBJ2-5,CASSGDQETQYF,0,3,1,3
TRBV10-1,TRBJ2-7,CASSAGTYEQYF,0,3,1,3
TRBV5-1,TRBJ1-2,CASSGRDYGYTF,0,3,1,3
TRBV10-2,TRBJ2-3,CASSEWADTQYF,0,3,1,3
TRBV5-1,TRBJ2-7,CASSFTGTEQYF,0,3,1,3
TRBV5-1,TRBJ2-1,CASSLGLNEQFF,0,3,1,3
TRBV5-1,TRBJ1-1,CASSLDRAEAFF,0,3,1,3
TRBV5-1,TRBJ2-7,CASRSDAYEQYF,0,3,1,3
TRBV10-2,TRBJ2-3,CASKASTDTQYF,0,3,1,3
TRBV20-1,TRBJ2-3,CSAALGTDTQYF,0,3,1,3
TRBV20-1,TRBJ2-1,CSASKGGGEQFF,0,3,1,3
TRBV20-1,TRBJ2-3,CSARANTDTQYF,0,3,1,3
TRBV20-1,TRBJ2-7,CSARDSTYEQYF,0,3,1,3
TRBV29-1,TRBJ1-2,CSSRRGEEGYTF,0,3,1,3
TRBV29-1,TRBJ2-7,CSVRISSYEQYF,0,3,1,3
TRBV29-1,TRBJ2-7,CSVVGASYEQYF,0,3,1,3
TRBV29-1,TRBJ2-7,CSVGGSGDEQYF,0,3,1,3
TRBV29-1,TRBJ2-3,CSVEEPRDTQYF,0,3,1,3
TRBV29-1,TRBJ2-7,CSVRAAGREQYF,0,3,1,3
TRBV29-1,TRBJ2-7,CSVKEGVSEQYF,0,3,1,3
TRBV29-1,TRBJ1-1,CSAGHLNTEAFF,0,3,1,3
TRBV29-1,TRBJ2-2,CSAGSSTGELFF,0,3,1,3
TRBV29-1,TRBJ1-1,CSGGQMNTEAFF,0,3,1,3
TRBV19,TRBJ2-1,CATAGLNGQFF,0,3,1,3
TRBV24-1,TRBJ1-1,CATSVGGEAFF,0,3,1,3
TRBV3-1,TRBJ1-3,CASSIGNTIYF,0,3,1,3
TRBV28,TRBJ2-1,CASQALARQFF,0,3,1,3
TRBV18,TRBJ2-7,CASSQRDEQYF,0,3,1,3
TRBV18,TRBJ1-1,CASSPGPEASF,0,3,1,3
TRBV7-9,TRBJ1-4,CASCFREKLFF,0,3,1,3
TRBV28,TRBJ1-2,CASMRDGGYTF,0,3,1,3
TRBV7-9,TRBJ1-2,CASTPDYGYTF,0,3,1,3
TRBV28,TRBJ1-2,CASSGQASYTF,0,3,1,3
TRBV10-2,TRBJ1-2,CASSSYYGYTF,0,3,1,3
TRBV20-1,TRBJ1-1,CSAGRGTEAFF,0,3,1,3
TRBV20-1,TRBJ2-7,CSARETYEQYF,0,3,1,3
TRBV29-1,TRBJ2-1,CSVGGGREQFF,0,3,1,3
TRBV29-1,TRBJ2-7,CSVEVGTSRYF,0,3,1,3
TRBV29-1,TRBJ2-7,CSVEGQAKQYF,0,3,1,3
TRBV29-1,TRBJ2-1,CSDSSYNEQFF,0,3,1,3
TRBV20-1,TRBJ1-2,CRPTDSYGYTF,0,3,1,3
TRBV12-5,TRBJ1-2,CASGLGGYTF,0,3,1,3
TRBV12-3/4,TRBJ2-1,CASSLTRTIF,0,3,1,3
TRBV7-9,TRBJ1-1,CASSGGGAFF,0,3,1,3
TRBV29-1,TRBJ2-1,CSVQRVEQFF,0,3,1,3
TRBV5-1,TRBJ2-7,CASSLAQRTGFEGLVPFPLEQYF,0,2,1,2
TRBV28,TRBJ2-3,CASTTPLIGLALRDGDTQYF,0,2,1,2
TRBV6-2/3/5/6,TRBJ2-1,CASSYHQGSGGTILGETQFF,0,2,1,2
TRBV7-2,TRBJ2-7,CASSLIRWPNNGTSSYEQYF,0,2,1,2
TRBV14,TRBJ2-7,CASGQDPSTGGFLAYEQYF,0,2,1,2
TRBV28,TRBJ2-6,CASSLRSGTGSSGANVLTF,0,2,1,2
TRBV6-2/3/5/6,TRBJ2-7,CASSYSEPADQETGYEQYF,0,2,1,2
TRBV7-9,TRBJ2-3,CASSLMDPRLEVRTDTQYF,0,2,1,2
TRBV9,TRBJ2-2,CASSVSSASGRSNTGELFF,0,2,1,2
TRBV5-1,TRBJ2-1,CASSLFPSPGQGGYNEQFF,0,2,1,2
TRBV5-1,TRBJ2-1,CASSPGGAVRGGPYNEQFF,0,2,1,2
TRBV4-1,TRBJ2-1,CASSQLTRAATGRYNEQFF,0,2,1,2
TRBV4-1,TRBJ2-3,CASSQDSSGWTVGTDTQYF,0,2,1,2
TRBV4-1,TRBJ1-5,CASSQDLGFRDIRNQPQHF,0,2,1,2
TRBV12-5,TRBJ2-7,CASGLGGAESASNYEQYF,0,2,1,2
TRBV19,TRBJ2-3,CASSWDRPFPASTDTQYF,0,2,1,2
TRBV19,TRBJ2-6,CASSILWRPPSGANVLTF,0,2,1,2
TRBV19,TRBJ2-3,CASSIGPTSGKLTDTQYF,0,2,1,2
TRBV11-2,TRBJ2-6,CASIRVVQRGSGANVLTF,0,2,1,2
TRBV28,TRBJ2-7,CASSLSLAGGGYSYEQYF,0,2,1,2
TRBV28,TRBJ2-1,CASSLPLGSGGDPHKQFF,0,2,1,2
TRBV28,TRBJ2-1,CASSLGNIWGSSYNEQFF,0,2,1,2
TRBV6-2/3/5/6,TRBJ1-6,CASSYSVGTGELNSPLHF,0,2,1,2
TRBV28,TRBJ2-3,CASSILRGGAPWSVTQYF,0,2,1,2
TRBV11-2,TRBJ2-5,CASSLFPHVEGELETQYF,0,2,1,2
TRBV11-2,TRBJ2-1,CASSLPPTRLARDNEQFF,0,2,1,2
TRBV5-4,TRBJ2-2,CASSSTRPGQGRTGELFF,0,2,1,2
TRBV11-1,TRBJ2-1,CASSLTSGGAASYNEQFF,0,2,1,2
TRBV7-8,TRBJ1-6,CASSPFGATSSYNSPLHF,0,2,1,2
TRBV3-1,TRBJ1-2,CASSPSTGTGTTNYGYTF,0,2,1,2
TRBV2,TRBJ2-3,CASSPRLAGWVGTDTQYF,0,2,1,2
TRBV6-2/3/5/6,TRBJ1-1,CASSHFKSRGRMDTEAFF,0,2,1,2
TRBV3-1,TRBJ2-3,CASSQDPGRNLWDHTQYF,0,2,1,2
TRBV3-1,TRBJ2-1,CASRPSSGDFSFPNEQFF,0,2,1,2
TRBV9,TRBJ2-6,CASRNPGHSVSGANVLTF,0,2,1,2
TRBV3-1,TRBJ2-1,CGSSHLLSTSGGVGEQFF,0,2,1,2
TRBV5-1,TRBJ2-5,CASSLGLAGGYGQETQYF,0,2,1,2
TRBV4-1,TRBJ1-2,CASSPRPGQGVFGRGYTF,0,2,1,2
TRBV5-1,TRBJ2-5,CASRQRLAGAFSQETQYF,0,2,1,2
TRBV20-1,TRBJ2-7,CSATWDRGNVFMSYEQYF,0,2,1,2
TRBV20-1,TRBJ2-1,CSARDMRGQGAMSNEQFF,0,2,1,2
TRBV29-1,TRBJ2-1,CSVEDPQGAKSSYNEQFL,0,2,1,2
TRBV4-1,TRBJ2-5,RASSQDWYGGGPRETQYF,0,2,1,2
TRBV12-5,TRBJ2-1,CASGLVLGGVSYNEQFF,0,2,1,2
TRBV10-3,TRBJ2-1,CAISEPDGTEVYNEQFF,0,2,1,2
TRBV24-1,TRBJ2-3,CATSDLLLVTSGQRQYF,0,2,1,2
TRBV19,TRBJ1-1,CASSIPQQYSGNTEAYF,0,2,1,2
TRBV19,TRBJ2-5,CASSKGRGSGGGETQYF,0,2,1,2
TRBV3-1,TRBJ2-6,CASCQFSGILGANVLTF,0,2,1,2
TRBV27,TRBJ2-1,CASAGTSGGITYNEQSF,0,2,1,2
TRBV7-8,TRBJ2-1,CASGIQRGLAGSNEQFF,0,2,1,2
TRBV6-2/3/5/6,TRBJ2-3,CASSFQRGGVSTDAQYF,0,2,1,2
TRBV27,TRBJ2-6,CASSLSGAYSSANVLTF,0,2,1,2
TRBV6-2/3/5/6,TRBJ2-2,CASSLFFTGDITGELFF,0,2,1,2
TRBV28,TRBJ2-1,CASSLPTSGGLFNEQFF,0,2,1,2
TRBV12-3/4,TRBJ1-2,CASSLVWHMGTNYGYTF,0,2,1,2
TRBV27,TRBJ1-6,CASSLIPSSSYNSPLHF,0,2,1,2
TRBV12-3/4,TRBJ2-2,CASSSPLTSANTGELFF,0,2,1,2
TRBV27,TRBJ2-3,CASSSRKSGAGTDTQYF,0,2,1,2
TRBV6-2/3/5/6,TRBJ2-4,CASSYASGALAKNIQYF,0,2,1,2
TRBV6-2/3/5/6,TRBJ1-2,CASSYSEWGRVGYGYTF,0,2,1,2
TRBV6-2/3/5/6,TRBJ1-3,CASSYRPTGGDGNTIYF,0,2,1,2
TRBV2,TRBJ2-5,CASSPRWTSGEQETQYF,0,2,1,2
TRBV7-9,TRBJ2-2,CASSPQEASANTGELFF,0,2,1,2
TRBV28,TRBJ1-5,CASSPVRTGGFNQPQHF,0,2,1,2
TRBV7-9,TRBJ2-3,CASSPPPGEGYTDTQYF,0,2,1,2
TRBV7-9,TRBJ1-3,CASSFNPGQLSGNTIYF,0,2,1,2
TRBV5-5,TRBJ2-7,CASSFLNPGQGLVEQYF,0,2,1,2
TRBV7-8,TRBJ1-4,CASSLRGQGATNEELFF,0,2,1,2
TRBV7-9,TRBJ2-7,CASSLVGGQGVSREQYF,0,2,1,2
TRBV7-9,TRBJ2-1,CASSLALTLNSYNEQFF,0,2,1,2
TRBV7-2,TRBJ1-6,CASSLAGGGAGFLSLHF,0,2,1,2
TRBV7-6,TRBJ1-5,CASSLGSGTGNNQPQHF,0,2,1,2
TRBV7-9,TRBJ2-3,CASSLGGTSGATDTQYF,0,2,1,2
TRBV7-9,TRBJ2-7,CASSLGTEGVYSYEQYF,0,2,1,2
TRBV11-2,TRBJ2-6,CASSLEYGGSGANVLTF,0,2,1,2
TRBV11-2,TRBJ2-5,CASSLTRGAAEQETQYF,0,2,1,2
TRBV7-3,TRBJ2-1,CASSLSRESGAAIEQFF,0,2,1,2
TRBV7-9,TRBJ1-2,CASSLKAQAGNNYGYTF,0,2,1,2
TRBV7-9,TRBJ2-5,CASSSSGASGPTETQYF,0,2,1,2
TRBV28,TRBJ1-5,CASSYTGTGATNQPQHF,0,2,1,2
TRBV7-3,TRBJ2-3,CASSLSSGGAATDTQYF,0,2,1,2
TRBV7-3,TRBJ2-5,CASSLMGGVRVGETQYF,0,2,1,2
TRBV5-6,TRBJ2-5,CASSRTINREREETQYF,0,2,1,2
TRBV6-2/3/5/6,TRBJ2-7,CASSRTSGGARGYEQYF,0,2,1,2
TRBV14,TRBJ2-2,CASSQVWPPGPTGELFF,0,2,1,2
TRBV3-1,TRBJ2-7,CASSQAFRGGDPYEQYF,0,2,1,2
TRBV4-2,TRBJ2-5,CASSQGNGGASQETQYF,0,2,1,2
TRBV11-2,TRBJ2-3,CASSERLASGGPDTQYF,0,2,1,2
TRBV7-2,TRBJ1-3,CASRKREGFHSGNTIYF,0,2,1,2
TRBV10-1,TRBJ2-3,CASSESQARLFGDTQYF,0,2,1,2
TRBV5-1,TRBJ2-2,CASSLASLGPNTGELFF,0,2,1,2
TRBV5-1,TRBJ2-5,CASSLGAQITWQETQYF,0,2,1,2
TRBV5-1,TRBJ2-7,CASSLGDSEVSSYEQYF,0,2,1,2
TRBV5-1,TRBJ1-2,CASSLTGTGVLNYGYTF,0,2,1,2
TRBV5-1,TRBJ2-1,CASSLRRSEGAYYEQFF,0,2,1,2
TRBV4-1,TRBJ1-1,CASSHLTPGQGLIEAFF,0,2,1,2
TRBV4-1,TRBJ1-5,CASSQDRGRGLSQPQHF,0,2,1,2
TRBV4-1,TRBJ2-7,CASSQMEPGLAGYEQYF,0,2,1,2
TRBV5-1,TRBJ2-7,CASRMSGGPPTTYEQYF,0,2,1,2
TRBV20-1,TRBJ1-5,CSAAPGHHKQSNQPQHF,0,2,1,2
TRBV20-1,TRBJ2-7,CSARGSQVASSSYEQYF,0,2,1,2
TRBV20-1,TRBJ2-3,CSARGPTSGGAEGTQYF,0,2,1,2
TRBV20-1,TRBJ2-3,CSARDRVGGGGTDTQYF,0,2,1,2
TRBV20-1,TRBJ2-7,CSARDRGPGLAGREQYF,0,2,1,2
TRBV20-1,TRBJ2-5,CSARDLRLAGGQETQYF,0,2,1,2
TRBV5-1,TRBJ2-6,RATRPGQFGSGANVLTF,0,2,1,2
TRBV2,TRBJ1-1,CADRGEPGRSSTEAFF,0,2,1,2
TRBV30,TRBJ1-5,CAWSGETLRGNQPQRF,0,2,1,2
TRBV30,TRBJ1-3,CAWSIRRGRSGNTIYF,0,2,1,2
TRBV10-3,TRBJ1-3,CAISEPGQSSGNTIYF,0,2,1,2
TRBV19,TRBJ2-6,CASSPHGQGGANVLTF,0,2,1,2
TRBV19,TRBJ2-2,CASSPWTSGGWGELFF,0,2,1,2
TRBV19,TRBJ2-3,CASSVLPGQGSDTQYF,0,2,1,2
TRBV19,TRBJ2-1,CASSIRVRAPRNEQFF,0,2,1,2
TRBV19,TRBJ1-5,CASSISSPGGRQPQHF,0,2,1,2
TRBV18,TRBJ1-1,CASSSLRDRTNTEAFF,0,2,1,2
TRBV18,TRBJ2-3,CASSPGQGSFADTQYS,0,2,1,2
TRBV18,TRBJ1-1,CASSPPDRTRGTVAFF,0,2,1,2
TRBV18,TRBJ2-3,CASHEKGQASTDTQYF,0,2,1,2
TRBV28,TRBJ2-4,CASGQVVILAKNIQYF,0,2,1,2
TRBV28,TRBJ2-5,CASSFSSGGRGETQYF,0,2,1,2
TRBV12-3/4,TRBJ2-1,CASSFPTGRLYNEQFF,0,2,1,2
TRBV7-3,TRBJ1-5,CASSFILTSRNQPQHF,0,2,1,2
TRBV6-2/3/5/6,TRBJ2-3,CASSFASGGPTDTQYF,0,2,1,2
TRBV28,TRBJ1-3,CASSLGGQGSGNTIYF,0,2,1,2
TRBV28,TRBJ2-6,CASSLPTGVGANVLTF,0,2,1,2
TRBV27,TRBJ1-4,CASSLDTEGTNEKLFF,0,2,1,2
TRBV28,TRBJ1-4,CASSSLGQGAREKLFF,0,2,1,2
TRBV6-2/3/5/6,TRBJ1-5,CASSYSRDSSNQPQHF,0,2,1,2
TRBV6-2/3/5/6,TRBJ1-2,CASSYSAGTGGYGYTF,0,2,1,2
TRBV6-2/3/5/6,TRBJ2-6,CASSYVAGVGANVLTS,0,2,1,2
TRBV28,TRBJ1-5,CASSYNLRGRYQPQHF,0,2,1,2
TRBV6-2/3/5/6,TRBJ2-7,CASSLRQNRGTYEQYF,0,2,1,2
TRBV28,TRBJ2-7,CASSLGQLALSYEQYF,0,2,1,2
TRBV28,TRBJ1-6,CASSPPGKARGSPLHF,0,2,1,2
TRBV12-3/4,TRBJ2-7,CASSPRVVLVSYEQYF,0,2,1,2
TRBV7-9,TRBJ1-3,CASSRARDYSGNTIYF,0,2,1,2
TRBV6-1,TRBJ2-3,CASSQDGGAETDTQYF,0,2,1,2
TRBV6-1,TRBJ2-7,CASSEDVDELGHEQYF,0,2,1,2
TRBV6-1,TRBJ2-1,CASSEWRGPGYNEQFF,0,2,1,2
TRBV6-1,TRBJ2-7,CASSEALKGRGTGIYF,0,2,1,2
TRBV6-1,TRBJ2-5,CASSEGGTALGETQYF,0,2,1,2
TRBV2,TRBJ2-7,CASSEGALAVPYEQYF,0,2,1,2
TRBV6-1,TRBJ1-5,CASSEDSPYSNQPQHF,0,2,1,2
TRBV2,TRBJ2-3,CASSERTQHPSGTQYF,0,2,1,2
TRBV28,TRBJ2-5,CASSTTRTGLQETQYF,0,2,1,2
TRBV5-5,TRBJ1-6,CASSFRDRSYNSPLHF,0,2,1,2
TRBV11-2,TRBJ2-1,CASSFQGASPYNEQFF,0,2,1,2
TRBV5-6,TRBJ2-1,CASSLAGGRVGNEQFF,0,2,1,2
TRBV7-3,TRBJ2-5,CASSLSGGADQETQYF,0,2,1,2
TRBV5-4,TRBJ2-5,CASSLKSGAHQETQYF,0,2,1,2
TRBV7-2,TRBJ2-5,CASSLHLAGPQETQYF,0,2,1,2
TRBV7-3,TRBJ2-1,CASSLVVGSPYNEQFF,0,2,1,2
TRBV7-2,TRBJ2-7,CASSLAAGGRLYEQYF,0,2,1,2
TRBV7-2,TRBJ2-5,CASSLAISGGQETQYF,0,2,1,2
TRBV7-6,TRBJ2-6,CASSLGFSSGANVLTF,0,2,1,2
TRBV11-2,TRBJ2-5,CASSLGLAGGGETQYF,0,2,1,2
TRBV11-2,TRBJ2-4,CASSLEVSGDKNIQYF,0,2,1,2
TRBV7-6,TRBJ2-5,CASSLNVRGAGETQYF,0,2,1,2
TRBV7-9,TRBJ2-3,CASSSTLGRGTDTQYF,0,2,1,2
TRBV7-2,TRBJ1-4,CASSWTRTGPGEKLFF,0,2,1,2
TRBV7-9,TRBJ2-7,CASSPSEGLPSYEQYF,0,2,1,2
TRBV27,TRBJ1-5,CASSPRTGHSNQPQHF,0,2,1,2
TRBV7-9,TRBJ2-1,CASSPPAGGTYNEQFF,0,2,1,2
TRBV5-8,TRBJ2-6,CASSPAYISGANVLTF,0,2,1,2
TRBV5-4,TRBJ2-1,CASSPTAQTGNNEQFF,0,2,1,2
TRBV4-2,TRBJ2-3,CASSPLDRGSTDTQYF,0,2,1,2
TRBV12-3/4,TRBJ2-5,CASSPGLADYQETQYF,0,2,1,2
TRBV6-2/3/5/6,TRBJ1-6,CASSPRGRGADSPPHF,0,2,1,2
TRBV13,TRBJ2-3,CASSRGTSGGLDTQYF,0,2,1,2
TRBV5-4,TRBJ2-3,CASSRELAGGRDTQYF,0,2,1,2
TRBV28,TRBJ2-3,CASSQTSGGTTDTQYL,0,2,1,2
TRBV3-1,TRBJ1-2,CASSQSDSRSVYGYTF,0,2,1,2
TRBV14,TRBJ2-4,CASSQLSTGGYDIQYF,0,2,1,2
TRBV3-1,TRBJ2-2,CASSQVPSSNTGELFF,0,2,1,2
TRBV3-1,TRBJ1-1,CASSQGPGQGNTEAFF,0,2,1,2
TRBV4-2,TRBJ2-2,CASSQDSAGDAGELFF,0,2,1,2
TRBV4-2,TRBJ1-1,CASSQDRGGGSAEAFF,0,2,1,2
TRBV14,TRBJ2-7,CASSQDGPYWGYEQYF,0,2,1,2
TRBV4-2,TRBJ1-4,CASSQEARPTNEKLFF,0,2,1,2
TRBV9,TRBJ2-1,CASSVGLAGKRGEQFF,0,2,1,2
TRBV9,TRBJ2-5,CASSVAGQGGQETQYF,0,2,1,2
TRBV6-2/3/5/6,TRBJ2-7,CASSALGLAADYEQYF,0,2,1,2
TRBV9,TRBJ2-7,CASSAGTSGELYEQYF,0,2,1,2
TRBV2,TRBJ2-6,CASREEQVSGASVLTF,0,2,1,2
TRBV2,TRBJ1-5,CASRAHRGRSNQPQHF,0,2,1,2
TRBV7-2,TRBJ1-3,CASNPAGGSGGNTIYF,0,2,1,2
TRBV28,TRBJ2-5,CASKRLAGGPGETQYF,0,2,1,2
TRBV7-9,TRBJ1-5,CTSSPGDRGRNQPQHF,0,2,1,2
TRBV5-1,TRBJ1-1,CASSFGTGGLNTEAFF,0,2,1,2
TRBV5-1,TRBJ2-5,CASSFLGDRRGETQYF,0,2,1,2
TRBV5-1,TRBJ1-1,CASSFGHGQGYTEAFF,0,2,1,2
TRBV5-1,TRBJ1-3,CASSLSPRTTGNTIYF,0,2,1,2
TRBV5-1,TRBJ1-2,CASSLGLYRAMDGYTF,0,2,1,2
TRBV5-1,TRBJ2-5,CASSLGAGAFQETQYF,0,2,1,2
TRBV5-1,TRBJ2-3,CASSLGGTGPTDTQYF,0,2,1,2
TRBV5-1,TRBJ2-5,CASSLGTAHDGETQYF,0,2,1,2
TRBV5-1,TRBJ2-1,CASSLELGGSYNEQFF,0,2,1,2
TRBV5-1,TRBJ2-3,CASSLNQRGPTDTQYF,0,2,1,2
TRBV5-1,TRBJ1-1,CASSSAIDGVNTEAFF,0,2,1,2
TRBV5-1,TRBJ2-3,CASSLAGGRGTDTQYL,0,2,1,2
TRBV4-1,TRBJ1-4,CASSQVLGQRNEKLFF,0,2,1,2
TRBV4-1,TRBJ2-1,CASSQVETATYNEQFF,0,2,1,2
TRBV4-1,TRBJ2-3,CASSQGNSGNTDTQYF,0,2,1,2
TRBV4-1,TRBJ2-7,CASSQDWASGGIEQYF,0,2,1,2
TRBV4-1,TRBJ1-4,CASSQDLYSSSEKLFF,0,2,1,2
TRBV4-1,TRBJ1-6,CASSQDWFAVNSPLHF,0,2,1,2
TRBV4-1,TRBJ1-1,CASSQEPDGGLTEAFF,0,2,1,2
TRBV5-1,TRBJ2-1,CASSTSLGGGHNEQFF,0,2,1,2
TRBV5-1,TRBJ2-3,CASSTRLAGNADTQYF,0,2,1,2
TRBV7-6,TRBJ2-2,CASRPPGGGNTGELFF,0,2,1,2
TRBV5-1,TRBJ2-2,CASRRGSTTNTGELFF,0,2,1,2
TRBV20-1,TRBJ2-2,CSALAPGQSPGGELFF,0,2,1,2
TRBV20-1,TRBJ2-7,CSARSPGQGKSYEQYF,0,2,1,2
TRBV20-1,TRBJ2-4,CSARVPGGASKDIQYF,0,2,1,2
TRBV20-1,TRBJ2-1,CSARDRLAGFYNEQFF,0,2,1,2
TRBV20-1,TRBJ1-2,CSARENRGGLEHGYTF,0,2,1,2
TRBV20-1,TRBJ2-1,CSARTSGESSYNEQFF,0,2,1,2
TRBV20-1,TRBJ1-3,CSASGTGDTSGNTIYF,0,2,1,2
TRBV29-1,TRBJ2-3,CSSLGGLAGGKDTQYF,0,2,1,2
TRBV29-1,TRBJ2-1,CSVPKRPLGPYNEQFF,0,2,1,2
TRBV29-1,TRBJ1-2,CSVDYLDRDLNYGYTF,0,2,1,2
TRBV18,TRBJ2-6,SASSFRGKAGANVLTF,0,2,1,2
TRBV10-3,TRBJ2-2,CASRAGQLNTGELFF,0,2,1,2
TRBV30,TRBJ2-2,CAWSVGGANTGELFF,0,2,1,2
TRBV30,TRBJ2-6,CAWSVDLSGANVLTF,0,2,1,2
TRBV30,TRBJ1-4,CAWSVNPTGWSEKLF,0,2,1,2
TRBV30,TRBJ2-2,CAWRLAGAATGELFF,0,2,1,2
TRBV10-3,TRBJ2-5,CAVSEAQGNGETQYF,0,2,1,2
TRBV11-2,TRBJ2-7,CAGSLGSGAPYEQYF,0,2,1,2
TRBV10-3,TRBJ2-1,CAISGQGNSYNEQFF,0,2,1,2
TRBV10-3,TRBJ1-6,CAISESGGSNSPLHF,0,2,1,2
TRBV15,TRBJ2-5,CATSQNRGRRETQYF,0,2,1,2
TRBV19,TRBJ1-5,CASSIWEGPYQPQHF,0,2,1,2
TRBV19,TRBJ1-5,CASSIYQGGNQPQRF,0,2,1,2
TRBV19,TRBJ2-5,CASSIPAGSQETQYF,0,2,1,2
TRBV19,TRBJ2-1,CASSISSGGYNEQFF,0,2,1,2
TRBV19,TRBJ1-1,CASSIVGQAYTEAFF,0,2,1,2
TRBV19,TRBJ2-7,CASSIGVGTSGGQYF,0,2,1,2
TRBV19,TRBJ1-1,CASSIDGQLNTEAFF,0,2,1,2
TRBV19,TRBJ1-6,CASSTQQGSISPLHF,0,2,1,2
TRBV19,TRBJ1-2,CASSLAANRIYGYAF,0,2,1,2
TRBV18,TRBJ1-5,CASSSTGRSNQPQHF,0,2,1,2
TRBV18,TRBJ2-1,CASSPAENRPHEQFF,0,2,1,2
TRBV18,TRBJ1-5,CASSPVRASNQPQHF,0,2,1,2
TRBV18,TRBJ2-7,CASSPGGQGDYEQYF,0,2,1,2
TRBV18,TRBJ2-3,CASSRTGQSPDTQYF,0,2,1,2
TRBV27,TRBJ2-1,CASYRTSGGYNEQFF,0,2,1,2
TRBV18,TRBJ2-3,CASQARTASPDTQYF,0,2,1,2
TRBV12-3/4,TRBJ1-5,CASGPGHPSNQPQHF,0,2,1,2
TRBV2,TRBJ2-7,CASGRRNSGAYEQYF,0,2,1,2
TRBV7-9,TRBJ2-5,CASILQRGQQEIQYF,0,2,1,2
TRBV2,TRBJ2-3,CASIRAGRLTDTQYF,0,2,1,2
TRBV27,TRBJ2-7,CASITDRQYSYEQYF,0,2,1,2
TRBV5-6,TRBJ1-5,CASTLTGFPIEGQHF,0,2,1,2
TRBV2,TRBJ2-3,CASTRTSPSTDTQYF,0,2,1,2
TRBV12-3/4,TRBJ1-3,CASTAGQPPGNTIYF,0,2,1,2
TRBV6-2/3/5/6,TRBJ1-1,CASTEGDISYTEAFF,0,2,1,2
TRBV27,TRBJ2-7,CASSFRQGSSYEQYF,0,2,1,2
TRBV6-2/3/5/6,TRBJ2-5,CASSFVAGESETQYF,0,2,1,2
TRBV12-3/4,TRBJ1-5,CASSLFTGGNQPQHF,0,2,1,2
TRBV6-2/3/5/6,TRBJ2-1,CASSLPGASYYEQFF,0,2,1,2
TRBV28,TRBJ1-5,CASSLVRNSNQPQHF,0,2,1,2
TRBV12-3/4,TRBJ2-7,CASSLVGTGVYEQYF,0,2,1,2
TRBV12-3/4,TRBJ2-7,CASSLGQAGLAEQYF,0,2,1,2
TRBV12-3/4,TRBJ2-7,CASSLGGGGRYEQYF,0,2,1,2
TRBV6-2/3/5/6,TRBJ1-2,CASSYSPGQFYGYTF,0,2,1,2
TRBV6-2/3/5/6,TRBJ2-1,CASSYSGGGPNEQFF,0,2,1,2
TRBV6-2/3/5/6,TRBJ2-7,CASSYSSGLGNEQYF,0,2,1,2
TRBV6-2/3/5/6,TRBJ1-1,CASSYATGGWTEAFF,0,2,1,2
TRBV6-2/3/5/6,TRBJ1-4,CASSYGYRGREKLFF,0,2,1,2
TRBV12-3/4,TRBJ1-3,CASSLPLGTGNTIYF,0,2,1,2
TRBV7-2,TRBJ2-7,CASSLGLAISYEQYF,0,2,1,2
TRBV6-2/3/5/6,TRBJ1-5,CASSPGGGLNQPQHF,0,2,1,2
TRBV12-3/4,TRBJ1-5,CASSPGTGGNQPQHF,0,2,1,2
TRBV12-3/4,TRBJ1-5,CASSPQGALSQPQHF,0,2,1,2
TRBV2,TRBJ2-7,CASSPTSGGAHEQYF,0,2,1,2
TRBV28,TRBJ1-6,CASSRVVGQNSPLHF,0,2,1,2
TRBV2,TRBJ1-6,CASSVDSSYNSPLHF,0,2,1,2
TRBV6-1,TRBJ2-7,CASSAGTGVSYEQYF,0,2,1,2
TRBV28,TRBJ2-5,CASSAGQGRGETQYF,0,2,1,2
TRBV6-1,TRBJ2-7,CASSGAGTRAEEQYF,0,2,1,2
TRBV6-1,TRBJ2-7,CASSGLAGARGEQYF,0,2,1,2
TRBV25-1,TRBJ1-1,CASSDRKGVEDEAFF,0,2,1,2
TRBV6-1,TRBJ2-3,CASSDSGGAFDTQYF,0,2,1,2
TRBV6-4,TRBJ2-3,CASSDPQGRTDTQYF,0,2,1,2
TRBV6-1,TRBJ1-4,CASSEYGLSNEKLFF,0,2,1,2
TRBV6-1,TRBJ2-3,CASSESSDRADTQYF,0,2,1,2
TRBV2,TRBJ1-4,CASSEPWLGNEKLFF,0,2,1,2
TRBV6-1,TRBJ2-7,CASSEPVAFPYEQYF,0,2,1,2
TRBV2,TRBJ2-3,CASSEQGGGPDTQYF,0,2,1,2
TRBV6-1,TRBJ1-1,CASSEARQATTEAFF,0,2,1,2
TRBV2,TRBJ2-5,CASSEGLTLVETQYF,0,2,1,2
TRBV28,TRBJ1-6,CASSTPQGVNSPLHF,0,2,1,2
TRBV6-1,TRBJ1-6,CASSKGTAYNSPLHF,0,2,1,2
TRBV7-2,TRBJ2-3,CASSFGLAETDTQYF,0,2,1,2
TRBV7-3,TRBJ2-2,CASSFSDSFTGELFF,0,2,1,2
TRBV5-5,TRBJ2-7,CASSLVWRASYEQYF,0,2,1,2
TRBV7-9,TRBJ2-5,CASSLDGGWTETQYF,0,2,1,2
TRBV7-2,TRBJ2-1,CASSLQGDSYNEQFF,0,2,1,2
TRBV7-9,TRBJ1-4,CASSLVPGASEKLFF,0,2,1,2
TRBV7-9,TRBJ1-4,CASSLVPGRRRKLFF,0,2,1,2
TRBV7-2,TRBJ2-7,CASSLVRGPSYEQYF,0,2,1,2
TRBV7-8,TRBJ1-1,CASSLAPRGLTEAFF,0,2,1,2
TRBV7-9,TRBJ1-5,CASSLAGEDNQPQHF,0,2,1,2
TRBV7-9,TRBJ2-3,CASSLGPTVRDTQYL,0,2,1,2
TRBV11-3,TRBJ2-7,CASSLGGPFSYEQYF,0,2,1,2
TRBV11-2,TRBJ1-1,CASSLGDRVGAEAFF,0,2,1,2
TRBV7-2,TRBJ1-6,CASSLGTGRLAPLHF,0,2,1,2
TRBV7-2,TRBJ2-3,CASSLDQGSTDTQYF,0,2,1,2
TRBV7-9,TRBJ1-3,CASSLDAGPGNTIYF,0,2,1,2
TRBV7-2,TRBJ2-7,CASSLDPWTYHEQYF,0,2,1,2
TRBV7-3,TRBJ2-1,CASSLTRDLDNEQFF,0,2,1,2
TRBV7-9,TRBJ2-7,CASSLTGQLTCEQYF,0,2,1,2
TRBV7-9,TRBJ2-2,CASSLRAGAPGELFF,0,2,1,2
TRBV11-2,TRBJ2-3,CASSSSGGAGNTQYF,0,2,1,2
TRBV7-9,TRBJ2-1,CASSSRSSSYNEQFF,0,2,1,2
TRBV5-4,TRBJ2-7,CASSSYLGGGYEQYF,0,2,1,2
TRBV7-9,TRBJ2-5,CASSSPDRHQETQYF,0,2,1,2
TRBV7-9,TRBJ2-3,CASSSKPTGTDTQYF,0,2,1,2
TRBV12-3/4,TRBJ1-4,CASSSDGGTNEKLFF,0,2,1,2
TRBV11-1,TRBJ1-1,CASSWDRLPNTEAFF,0,2,1,2
TRBV7-2,TRBJ2-3,CASSYTSGDTDTQYF,0,2,1,2
TRBV7-9,TRBJ1-6,CASSYEGQGDSPLHF,0,2,1,2
TRBV12-3/4,TRBJ2-7,CASSLTETGAYEQYF,0,2,1,2
TRBV11-2,TRBJ2-5,CASSLSFREQETQYF,0,2,1,2
TRBV7-6,TRBJ2-1,CASSLSAPSYNEQFF,0,2,1,2
TRBV5-4,TRBJ2-5,CASSLAGTSQETQYF,0,2,1,2
TRBV7-3,TRBJ2-7,CASSLNGGPSYEQYF,0,2,1,2
TRBV3-1,TRBJ1-6,CASSPWAGPGSPLHF,0,2,1,2
TRBV11-1,TRBJ2-1,CASSPGYYLYNEQFF,0,2,1,2
TRBV7-2,TRBJ2-7,CASSPLDRDNYEQYF,0,2,1,2
TRBV28,TRBJ1-1,CASSPPDVVNTEAFF,0,2,1,2
TRBV7-2,TRBJ2-7,CASSPPPAVTYEQYF,0,2,1,2
TRBV7-9,TRBJ1-1,CASSPRRAGQTEAFF,0,2,1,2
TRBV14,TRBJ2-3,CASSPHAGWTDTQYF,0,2,1,2
TRBV11-1,TRBJ2-3,CASSPQGSGTDTQYF,0,2,1,2
TRBV7-3,TRBJ2-5,CASSPVLANLETQYF,0,2,1,2
TRBV7-2,TRBJ2-1,CASSPGTGIYNEQFF,0,2,1,2
TRBV28,TRBJ2-1,CASSPTGAGSNEQFF,0,2,1,2
TRBV7-9,TRBJ2-7,CASSPGQGLSYEQYF,0,2,1,2
TRBV3-1,TRBJ2-7,CASSPGQGVGDEQYF,0,2,1,2
TRBV5-6,TRBJ2-5,CASSPNGGQVFPSYF,0,2,1,2
TRBV7-2,TRBJ2-3,CASSPRGRSTDTQYF,0,2,1,2
TRBV14,TRBJ2-5,CASSRYRGFQETQYF,0,2,1,2
TRBV3-1,TRBJ2-3,CASSRSGGAPDTQYF,0,2,1,2
TRBV5-6,TRBJ1-4,CASSRPGATNEKLFF,0,2,1,2
TRBV28,TRBJ2-7,CASSRGGTGINEQYF,0,2,1,2
TRBV16,TRBJ2-7,CASSHYRDRAGEQYF,0,2,1,2
TRBV7-9,TRBJ1-5,CASSQGQGFGQPQHF,0,2,1,2
TRBV3-1,TRBJ2-3,CASSQVGGPTDTQYF,0,2,1,2
TRBV3-1,TRBJ2-5,CASSQGLRGQETQYF,0,2,1,2
TRBV3-1,TRBJ2-3,CASSQDVRGADTQYF,0,2,1,2
TRBV11-3,TRBJ2-3,CASSAGTSVTDTQYF,0,2,1,2
TRBV7-9,TRBJ1-4,CASSGPGTGGEKLFF,0,2,1,2
TRBV3-1,TRBJ2-1,CASSGRGRQDNEQFF,0,2,1,2
TRBV28,TRBJ1-1,CASRLPGFRNTEAFF,0,2,1,2
TRBV2,TRBJ2-3,CASRALAGSTDTQYF,0,2,1,2
TRBV2,TRBJ2-1,CASRLGQGHYNGQFF,0,2,1,2
TRBV12-3/4,TRBJ2-5,CASRPRQGAGETQYF,0,2,1,2
TRBV28,TRBJ1-4,CASRPSGQGGEKLFF,0,2,1,2
TRBV28,TRBJ1-4,CASRHRATTNEKLFF,0,2,1,2
TRBV6-2/3/5/6,TRBJ1-1,CASRATGFGGTEAFF,0,2,1,2
TRBV28,TRBJ2-3,CASRRGRVKDGTQYF,0,2,1,2
TRBV28,TRBJ1-2,CASRKVQGADYGYAF,0,2,1,2
TRBV28,TRBJ2-7,CASNTLGQGMREQYF,0,2,1,2
TRBV12-3/4,TRBJ2-7,CASKGGGGGYYEQYF,0,2,1,2
TRBV6-2/3/5/6,TRBJ1-3,CTSSSPTFSGNTIYF,0,2,1,2
TRBV7-6,TRBJ1-5,CPSQGVTYSNQPQHF,0,2,1,2
TRBV5-1,TRBJ2-2,CASSLVSAFTGELFF,0,2,1,2
TRBV5-1,TRBJ1-1,CASSFQGRMNTEAFF,0,2,1,2
TRBV5-1,TRBJ2-3,CASSLAPGSPDTQYF,0,2,1,2
TRBV5-1,TRBJ2-3,CASSLAGGETDTQYF,0,2,1,2
TRBV5-1,TRBJ1-6,CASSLGQQNNSPLHL,0,2,1,2
TRBV5-1,TRBJ1-2,CASSLDVAGHYGYTF,0,2,1,2
TRBV5-1,TRBJ2-3,CASSLDRGITDTQYF,0,2,1,2
TRBV5-1,TRBJ2-1,CASSLEAGVHNEQFF,0,2,1,2
TRBV5-1,TRBJ1-4,CASSLTTGFDEKLFF,0,2,1,2
TRBV5-1,TRBJ2-1,CASSLPPGQSREQFF,0,2,1,2
TRBV5-1,TRBJ2-1,CASSLRQGLYNELFF,0,2,1,2
TRBV5-1,TRBJ2-1,CASSSWPSSYNEQFF,0,2,1,2
TRBV5-1,TRBJ2-1,CASSSGTSGVNEQFF,0,2,1,2
TRBV5-1,TRBJ1-1,CASSWGEALGTEAFF,0,2,1,2
TRBV4-1,TRBJ2-1,CASSLGLAGVRQQFF,0,2,1,2
TRBV5-1,TRBJ2-7,CASSLTGQGVIEQYF,0,2,1,2
TRBV5-1,TRBJ1-3,CASSPLVRSANTIYF,0,2,1,2
TRBV4-1,TRBJ2-7,CASSPAMGASYEQYF,0,2,1,2
TRBV5-1,TRBJ2-6,CASSPGDSSSNVLTF,0,2,1,2
TRBV4-1,TRBJ2-7,CASSQSDGEFREQYF,0,2,1,2
TRBV4-1,TRBJ2-1,CASSQVYFGENEQFF,0,2,1,2
TRBV4-1,TRBJ1-4,CASSQDPGGGEKLFF,0,2,1,2
TRBV4-1,TRBJ2-1,CASSQRDADYNEQFF,0,2,1,2
TRBV5-1,TRBJ1-6,CASSDGRSYNSPLHF,0,2,1,2
TRBV5-1,TRBJ2-7,CASSITGQLIYEQCF,0,2,1,2
TRBV5-1,TRBJ1-5,CASSIGPDHNQPQHF,0,2,1,2
TRBV4-1,TRBJ1-2,CASSTQGPTNYGYTF,0,2,1,2
TRBV5-1,TRBJ1-6,CASSRANFYNSPLHF,0,2,1,2
TRBV5-1,TRBJ2-7,CASRGTSGTSFEQYF,0,2,1,2
TRBV10-1,TRBJ2-7,CASRNRVRFSYEQYF,0,2,1,2
TRBV20-1,TRBJ2-7,CGATGTVWSDYEQYF,0,2,1,2
TRBV29-1,TRBJ2-5,CGVSPSGAYQETQYF,0,2,1,2
TRBV20-1,TRBJ2-1,CSAPPLAGGPHEQFF,0,2,1,2
TRBV20-1,TRBJ1-5,CSATGTDYSNQPQHF,0,2,1,2
TRBV20-1,TRBJ1-2,CSARPGTGANYGYTF,0,2,1,2
TRBV20-1,TRBJ2-5,CSARPPLAEQETQYF,0,2,1,2
TRBV20-1,TRBJ2-5,CSARGLGGYQETQYF,0,2,1,2
TRBV20-1,TRBJ2-7,CSARDPIAGAFEQYF,0,2,1,2
TRBV20-1,TRBJ2-1,CSARDPGGSYNEQFF,0,2,1,2
TRBV20-1,TRBJ2-7,CSAREGTSGNYEQYF,0,2,1,2
TRBV20-1,TRBJ2-7,CSAREIAGGRYEQYF,0,2,1,2
TRBV20-1,TRBJ2-1,CSIPGRDWSYNEQFF,0,2,1,2
TRBV29-1,TRBJ2-5,CSVPSRIQYQETQYF,0,2,1,2
TRBV29-1,TRBJ1-1,CSVEEPGQRNTEAFF,0,2,1,2
TRBV29-1,TRBJ2-7,CSVSHLGQVICEQYF,0,2,1,2
TRBV29-1,TRBJ1-1,CSVIRQGGVATEAFF,0,2,1,2
TRBV29-1,TRBJ2-3,CSALWSGVSTDTQYF,0,2,1,2
TRBV5-6,TRBJ2-1,RASSTPLGNYNEQFF,0,2,1,2
TRBV12-3/4,TRBJ1-4,RASSKGQGVVEKLFF,0,2,1,2
TRBV5-1,TRBJ1-4,RASSLGVAANEKLFF,0,2,1,2
TRBV7-9,TRBJ2-1,CPSSLAGQNNEQFF,0,2,1,2
TRBV11-2,TRBJ1-1,CASSLDRGGTEAFF,0,2,1,2
TRBV30,TRBJ1-6,CAWCGTDLNSPLHF,0,2,1,2
TRBV30,TRBJ2-1,CAWGTSAGPHEQFF,0,2,1,2
TRBV30,TRBJ1-2,CAWSFLRDGDGYTF,0,2,1,2
TRBV30,TRBJ1-5,CAWSVPHSNQPQHF,0,2,1,2
TRBV30,TRBJ2-7,CAWSVLAGPYEQYF,0,2,1,2
TRBV30,TRBJ1-5,CAWSAGGLNQPQHF,0,2,1,2
TRBV30,TRBJ1-1,CAWSEPQFFAKAFF,0,2,1,2
TRBV30,TRBJ1-2,CAWSLVGTGVGYTF,0,2,1,2
TRBV30,TRBJ2-6,CAWKQRSGANVLTF,0,2,1,2
TRBV30,TRBJ2-3,CARSVGGSADTQYF,0,2,1,2
TRBV18,TRBJ2-5,CAGSLGPTQETQYF,0,2,1,2
TRBV28,TRBJ2-1,CAISGAGGLNEQFF,0,2,1,2
TRBV10-3,TRBJ2-7,CAISQSDTPYEQYF,0,2,1,2
TRBV2,TRBJ2-3,CATCGGRHTDTQYF,0,2,1,2
TRBV24-1,TRBJ2-2,CATSATGSTGELFF,0,2,1,2
TRBV15,TRBJ2-7,CATSRGGDSYEQYF,0,2,1,2
TRBV15,TRBJ2-2,CATRDGLNTGELFF,0,2,1,2
TRBV19,TRBJ2-5,CASSPRGLGETQYF,0,2,1,2
TRBV12-5,TRBJ2-1,CASVGGQGYNEQFF,0,2,1,2
TRBV19,TRBJ2-1,CASGIQQGHNEQFF,0,2,1,2
TRBV2,TRBJ2-1,CASMGQGYYNEQFF,0,2,1,2
TRBV19,TRBJ2-7,CASTLTGTSVEQYF,0,2,1,2
TRBV19,TRBJ2-7,CASSLDSNSYEQYF,0,2,1,2
TRBV19,TRBJ2-7,CASSISGATYEQYF,0,2,1,2
TRBV19,TRBJ2-2,CASSIGLETGELFF,0,2,1,2
TRBV19,TRBJ1-5,CASSSSGSAQPQHF,0,2,1,2
TRBV19,TRBJ1-1,CASRWDARYTEAFF,0,2,1,2
TRBV18,TRBJ1-5,CASSPRQEHQPQHF,0,2,1,2
TRBV18,TRBJ1-4,CASSPQGGNEKLFF,0,2,1,2
TRBV18,TRBJ1-6,CASSQAAYNSPLHF,0,2,1,2
TRBV18,TRBJ1-5,CASPPKGGNQPQHF,0,2,1,2
TRBV18,TRBJ2-3,CASRESGGADTQYF,0,2,1,2
TRBV18,TRBJ1-4,CASQSSQGTEKLFF,0,2,1,2
TRBV28,TRBJ1-2,CASQRTGENYGYTF,0,2,1,2
TRBV28,TRBJ2-1,CASASRVAIDEQFF,0,2,1,2
TRBV6-4,TRBJ2-6,CASARVSGANVLTF,0,2,1,2
TRBV6-2/3/5/6,TRBJ1-1,CASGYTGGRTEAFF,0,2,1,2
TRBV27,TRBJ1-4,CASGETGATERLFF,0,2,1,2
TRBV28,TRBJ2-5,CASGLSGGQETQYF,0,2,1,2
TRBV6-2/3/5/6,TRBJ1-1,CASGNQDRNTEAFF,0,2,1,2
TRBV28,TRBJ2-3,CASIPGQNTDTQYF,0,2,1,2
TRBV2,TRBJ2-3,CASIEAGAPDTQYF,0,2,1,2
TRBV2,TRBJ2-7,CASTRRASTEEQYF,0,2,1,2
TRBV12-3/4,TRBJ2-6,CASTRGAGANVLTF,0,2,1,2
TRBV2,TRBJ1-1,CASTGGALNTEAFF,0,2,1,2
TRBV6-2/3/5/6,TRBJ1-5,CASSFGSGGQPQHF,0,2,1,2
TRBV12-3/4,TRBJ1-1,CASSFDTRNTEAFF,0,2,1,2
TRBV12-3/4,TRBJ1-1,CASSFSQGITEAFF,0,2,1,2
TRBV5-6,TRBJ2-1,CASSFPNPSNEQFF,0,2,1,2
TRBV28,TRBJ1-5,CASSFRQANQPQHF,0,2,1,2
TRBV12-3/4,TRBJ2-4,CASSFGEAKNIQYF,0,2,1,2
TRBV12-3/4,TRBJ2-5,CASSLTSGAATQYF,0,2,1,2
TRBV28,TRBJ1-5,CASSLSQGGRPQHS,0,2,1,2
TRBV12-3/4,TRBJ1-1,CASSLVQANTEAFF,0,2,1,2
TRBV12-3/4,TRBJ1-1,CASSLAGGNTEAFF,0,2,1,2
TRBV6-2/3/5/6,TRBJ1-6,CASSLDRGGSPLHF,0,2,1,2
TRBV12-3/4,TRBJ2-3,CASSLDPSTDTQYF,0,2,1,2
TRBV6-2/3/5/6,TRBJ2-7,CASSLRSRENEQYF,0,2,1,2
TRBV12-3/4,TRBJ1-1,CASSSGERVTEAFF,0,2,1,2
TRBV12-3/4,TRBJ2-1,CASSSSGKWNEQFF,0,2,1,2
TRBV28,TRBJ1-6,CASSSAGTGSPLHF,0,2,1,2
TRBV6-2/3/5/6,TRBJ2-1,CASSSRSKNNEQFF,0,2,1,2
TRBV6-2/3/5/6,TRBJ2-3,CASSYSASTDTQYF,0,2,1,2
TRBV7-2,TRBJ2-7,CASSPEDRTYEQYF,0,2,1,2
TRBV6-2/3/5/6,TRBJ2-5,CASSPTGIGETQYF,0,2,1,2
TRBV28,TRBJ2-3,CASSPPTSTDTQYF,0,2,1,2
TRBV7-9,TRBJ1-1,CASSRPGRGTEAFF,0,2,1,2
TRBV28,TRBJ2-7,CASSRDRGLVEQYF,0,2,1,2
TRBV6-1,TRBJ1-5,CASSVIYSNQPQHF,0,2,1,2
TRBV28,TRBJ2-3,CASSGGQVTDTQYF,0,2,1,2
TRBV2,TRBJ1-1,CASSDDRVLAEAFF,0,2,1,2
TRBV6-1,TRBJ2-3,CASSEPGSTDTQYF,0,2,1,2
TRBV6-1,TRBJ1-5,CASSEGQGAQPQHF,0,2,1,2
TRBV28,TRBJ2-5,CASSMAAAQETQYF,0,2,1,2
TRBV5-6,TRBJ2-5,CASSSGPIPETQYF,0,2,1,2
TRBV11-2,TRBJ1-1,CASSFLAGGTEAFF,0,2,1,2
TRBV7-2,TRBJ2-1,CASSFSSVYNEQFF,0,2,1,2
TRBV7-9,TRBJ2-3,CASSFLGGTDTQYF,0,2,1,2
TRBV7-2,TRBJ2-5,CASSFGTDQETQYF,0,2,1,2
TRBV5-5,TRBJ2-2,CASSLAVLAGELFF,0,2,1,2
TRBV7-2,TRBJ1-2,CASSLGGGSYGYTF,0,2,1,2
TRBV7-9,TRBJ2-7,CASSLGTGSYEQYF,0,2,1,2
TRBV5-6,TRBJ2-3,CASSLDQGTDTQYF,0,2,1,2
TRBV7-3,TRBJ1-1,CASSLTGGSAEAFF,0,2,1,2
TRBV7-2,TRBJ2-7,CASSLSGLIYEQYF,0,2,1,2
TRBV7-2,TRBJ1-1,CASSLVPGPHKAFF,0,2,1,2
TRBV7-9,TRBJ1-2,CASSLATLNYGYTF,0,2,1,2
TRBV7-2,TRBJ1-2,CASSLAMPSYGYTF,0,2,1,2
TRBV7-2,TRBJ2-7,CASSLGQGWYEQYF,0,2,1,2
TRBV7-3,TRBJ2-2,CASSLGWNTGELFF,0,2,1,2
TRBV7-2,TRBJ1-6,CASSLGRGDWALHF,0,2,1,2
TRBV11-3,TRBJ2-5,CASSLDLAQETQYF,0,2,1,2
TRBV7-2,TRBJ1-1,CASSLEQGNTEAFF,0,2,1,2
TRBV11-2,TRBJ2-7,CASSLRVGSYGQYF,0,2,1,2
TRBV7-8,TRBJ2-2,CASSSWTYTGELFF,0,2,1,2
TRBV7-2,TRBJ1-1,CASSSLGQATVAFF,0,2,1,2
TRBV7-3,TRBJ2-7,CASSSGTGDYEQYF,0,2,1,2
TRBV5-4,TRBJ2-7,CASSSPAGDLEQYF,0,2,1,2
TRBV6-2/3/5/6,TRBJ1-6,CASSSQGANSPLHF,0,2,1,2
TRBV7-2,TRBJ1-1,CASSSGFMITEAFF,0,2,1,2
TRBV9,TRBJ2-1,CASSWRGEGNEQFF,0,2,1,2
TRBV11-2,TRBJ2-5,CASSLGTTQETQYF,0,2,1,2
TRBV28,TRBJ1-4,CASSLQGRKEKLFF,0,2,1,2
TRBV7-9,TRBJ2-4,CASSPGRDQNIQYF,0,2,1,2
TRBV3-1,TRBJ2-5,CASSPRTSGETQYF,0,2,1,2
TRBV7-9,TRBJ2-7,CASSPYRASYERYF,0,2,1,2
TRBV7-6,TRBJ1-5,CASSPGQTNQPQHF,0,2,1,2
TRBV12-3/4,TRBJ2-7,CASSPWRDPYEQYF,0,2,1,2
TRBV3-1,TRBJ2-5,CASSPTSRRETQYF,0,2,1,2
TRBV4-2,TRBJ2-7,CASSQYVTSYEQYF,0,2,1,2
TRBV28,TRBJ1-2,CASSQYGFNYGYTF,0,2,1,2
TRBV3-1,TRBJ2-7,CASSQGQWVYEQYF,0,2,1,2
TRBV28,TRBJ2-7,CASSQPYVPRTEYF,0,2,1,2
TRBV3-1,TRBJ1-5,CASSQVIGGQPQHF,0,2,1,2
TRBV3-1,TRBJ2-5,CASSQASSEKTQYF,0,2,1,2
TRBV3-1,TRBJ2-3,CASSQEAGRNTQYF,0,2,1,2
TRBV3-1,TRBJ1-3,CASSQTPFGTDVNF,0,2,1,2
TRBV3-1,TRBJ1-2,CASSQRTGFYGYTF,0,2,1,2
TRBV5-4,TRBJ2-7,CASSVTGRGDEQYF,0,2,1,2
TRBV9,TRBJ1-6,CASSVGDPSGSLHF,0,2,1,2
TRBV9,TRBJ2-7,CASSAQGDRDEQYF,0,2,1,2
TRBV7-9,TRBJ1-6,CASSEGAGVSPLHF,0,2,1,2
TRBV7-9,TRBJ2-1,CASSIMWRDHEQFF,0,2,1,2
TRBV2,TRBJ1-1,CASSMSGVNTEAFF,0,2,1,2
TRBV2,TRBJ1-5,CASSTLNEGQPQHF,0,2,1,2
TRBV7-3,TRBJ1-2,CASSTSGTVSGYTF,0,2,1,2
TRBV7-3,TRBJ2-2,CASSKAGDTGELFF,0,2,1,2
TRBV7-9,TRBJ1-4,CASSKVGYNEKLFF,0,2,1,2
TRBV7-2,TRBJ2-3,CASRRGSHTDTQYF,0,2,1,2
TRBV2,TRBJ1-1,CASRRYAGPTEAFF,0,2,1,2
TRBV12-3/4,TRBJ1-4,CASKETQGNEKLFF,0,2,1,2
TRBV28,TRBJ1-6,CASKWTGGNSPLHF,0,2,1,2
TRBV6-2/3/5/6,TRBJ2-1,CASKAGGPLDEQFF,0,2,1,2
TRBV12-3/4,TRBJ2-7,CAGLAGIPPHEQYF,0,2,1,2
TRBV5-5,TRBJ2-1,CTSSLAISKDEQFF,0,2,1,2
TRBV5-1,TRBJ2-1,CASFEGGSYNEQIF,0,2,1,2
TRBV5-1,TRBJ2-5,CASRHPGVRETQYF,0,2,1,2
TRBV5-1,TRBJ1-1,CASGPGQEDTEAFF,0,2,1,2
TRBV5-1,TRBJ2-2,CASEDRGDTGELFF,0,2,1,2
TRBV5-1,TRBJ2-2,CASTREGEGGELFF,0,2,1,2
TRBV5-1,TRBJ1-2,CASSSGPGIYTYTF,0,2,1,2
TRBV5-1,TRBJ2-3,CASSLFGRRDTQYF,0,2,1,2
TRBV5-1,TRBJ2-7,CASSLARGLYEQYF,0,2,1,2
TRBV5-1,TRBJ1-2,CASSLAGSGGSYTF,0,2,1,2
TRBV5-1,TRBJ1-1,CASSLATTGAEAFF,0,2,1,2
TRBV7-2,TRBJ2-1,CASSLKVGGNEQFF,0,2,1,2
TRBV5-1,TRBJ2-1,CASSYGTSTDEQFF,0,2,1,2
TRBV5-1,TRBJ2-3,CASSLGGGTDTQYF,0,2,1,2
TRBV4-1,TRBJ2-7,CASSLAGGPYEQYF,0,2,1,2
TRBV5-1,TRBJ2-3,CASSPGRSSDTQYF,0,2,1,2
TRBV4-1,TRBJ1-3,CASSHPDKGNTIYF,0,2,1,2
TRBV4-1,TRBJ2-5,CASSQAPNQETQYF,0,2,1,2
TRBV3-1,TRBJ2-1,CASSQDTLPSEQFF,0,2,1,2
TRBV5-1,TRBJ1-3,CASSVLGTGNTIYF,0,2,1,2
TRBV5-1,TRBJ1-4,CASSAGQLNEKLFF,0,2,1,2
TRBV5-1,TRBJ1-1,CASSGGGANTEAFF,0,2,1,2
TRBV4-1,TRBJ2-1,CASSGAGGLNEQFF,0,2,1,2
TRBV5-1,TRBJ2-3,CASSIRTRTDTQYF,0,2,1,2
TRBV5-1,TRBJ2-3,CASSMTSGTDTQYF,0,2,1,2
TRBV20-1,TRBJ2-7,CSAWVSGGSYEQYF,0,2,1,2
TRBV20-1,TRBJ1-2,CSATDGRGLYGYTF,0,2,1,2
TRBV20-1,TRBJ2-1,CSASDRDGMDEQFF,0,2,1,2
TRBV20-1,TRBJ1-1,CSASETGESAEAFF,0,2,1,2
TRBV20-1,TRBJ1-2,CSARYLGGNYGYTF,0,2,1,2
TRBV20-1,TRBJ1-1,CSARVRAWSTEAFF,0,2,1,2
TRBV20-1,TRBJ2-7,CSARGVLGTNEQYF,0,2,1,2
TRBV20-1,TRBJ1-3,CSARDQSSGNTIYF,0,2,1,2
TRBV20-1,TRBJ1-2,CSARDIQGDYGYTF,0,2,1,2
TRBV20-1,TRBJ2-7,CSARELAGAYEQYF,0,2,1,2
TRBV20-1,TRBJ1-1,CSARSGTVNTEAFF,0,2,1,2
TRBV20-1,TRBJ2-5,CSAKIPASRETQYF,0,2,1,2
TRBV20-1,TRBJ2-1,CSASGQISYKEQFF,0,2,1,2
TRBV20-1,TRBJ1-1,CSAVLRGMNTEALF,0,2,1,2
TRBV20-1,TRBJ2-1,CSADNSGGANEQFF,0,2,1,2
TRBV29-1,TRBJ2-7,CSVLSPRGVNEQYF,0,2,1,2
TRBV29-1,TRBJ2-5,CSVLRRDREETQYF,0,2,1,2
TRBV29-1,TRBJ1-5,CSVLQGGLNQPQHF,0,2,1,2
TRBV29-1,TRBJ2-3,CSVDGVGDTDTQYF,0,2,1,2
TRBV29-1,TRBJ2-3,CSVDLTGSTDTQYF,0,2,1,2
TRBV29-1,TRBJ2-3,CSVEGGAATDTQYF,0,2,1,2
TRBV29-1,TRBJ1-1,CSVEVRVGDAEAFF,0,2,1,2
TRBV29-1,TRBJ1-1,CSVEESGGGTEAFF,0,2,1,2
TRBV29-1,TRBJ2-5,CSVETSGAGETQYF,0,2,1,2
TRBV29-1,TRBJ2-3,CSVESSGATDTQYF,0,2,1,2
TRBV29-1,TRBJ2-1,CSVERGGRGNEQFF,0,2,1,2
TRBV2,TRBJ2-1,RASTIEALYNEQFF,0,2,1,2
TRBV5-5,TRBJ1-3,RASSLDISGNTIYF,0,2,1,2
TRBV12-5,TRBJ2-1,CASGRDRGNEQFF,0,2,1,2
TRBV7-7,TRBJ2-1,CASSSDSYNEQFF,0,2,1,2
TRBV30,TRBJ1-2,CACATGGDYGYTF,0,2,1,2
TRBV7-9,TRBJ1-1,CACSFGTGGEAFF,0,2,1,2
TRBV30,TRBJ2-3,CAWSVLGTDTQYF,0,2,1,2
TRBV30,TRBJ1-2,CAWSVSGDGGYTF,0,2,1,2
TRBV30,TRBJ1-5,CAWSVQGDQPQHF,0,2,1,2
TRBV30,TRBJ2-1,CAWSVGSENEQFF,0,2,1,2
TRBV30,TRBJ1-1,CAWSVIGNTKAFF,0,2,1,2
TRBV30,TRBJ1-5,CAWNSALDQPQHF,0,2,1,2
TRBV30,TRBJ2-2,CAWNNQGAGELFF,0,2,1,2
TRBV5-6,TRBJ1-2,CAPVNDILGGYTF,0,2,1,2
TRBV19,TRBJ2-5,CAGSTGQKETQYF,0,2,1,2
TRBV11-2,TRBJ2-4,CAIPNYIKNIQYF,0,2,1,2
TRBV19,TRBJ2-1,CATGLGGNNEQFF,0,2,1,2
TRBV12-3/4,TRBJ1-1,CATSLGSAGEAFF,0,2,1,2
TRBV15,TRBJ2-3,CATSRVIQDTQYF,0,2,1,2
TRBV15,TRBJ2-5,CATSRDLEETQYF,0,2,1,2
TRBV28,TRBJ1-1,CASSFYSQGVAFF,0,2,1,2
TRBV19,TRBJ1-2,CASSPQGNYGYTF,0,2,1,2
TRBV19,TRBJ2-7,CASSRQGTNEQYF,0,2,1,2
TRBV19,TRBJ1-5,CASSIRNNQPQHF,0,2,1,2
TRBV19,TRBJ1-5,CASSRYRAQPQHF,0,2,1,2
TRBV2,TRBJ1-5,CASSLEAGQPQHF,0,4,1,4
TRBV19,TRBJ1-1,CASSWTVNTEAFF,0,2,1,2
TRBV18,TRBJ1-1,CASLTGVDTEAFF,0,2,1,2
TRBV28,TRBJ2-7,CASSFGGLYEQYF,0,2,1,2
TRBV18,TRBJ1-1,CASSPSQDTEAFF,0,2,1,2
TRBV18,TRBJ2-7,CASSPGRLYEQYF,0,2,1,2
TRBV18,TRBJ2-5,CASSPPGYETQYF,0,2,1,2
TRBV18,TRBJ2-7,CASSPEGLYEQYF,0,2,1,2
TRBV18,TRBJ2-5,CASRTGNGETQYF,0,2,1,2
TRBV28,TRBJ1-1,CASVPGIDTEAFF,0,2,1,2
TRBV12-3/4,TRBJ1-3,CASGPLGGNTIYF,0,2,1,2
TRBV5-6,TRBJ2-5,CASGTPGRETQYF,0,2,1,2
TRBV3-1,TRBJ2-2,CASIAGGIGELFF,0,2,1,2
TRBV2,TRBJ1-5,CASMRGGNQPQHF,0,2,1,2
TRBV28,TRBJ2-1,CASTPPEHNEQFF,0,2,1,2
TRBV6-2/3/5/6,TRBJ2-7,CASTIGGLYEQYF,0,2,1,2
TRBV7-9,TRBJ2-1,CASTLAGGDEQFF,0,2,1,2
TRBV6-2/3/5/6,TRBJ2-3,CASTGVARDTQYF,0,2,1,2
TRBV12-3/4,TRBJ1-1,CASTRRGGAAAFF,0,2,1,2
TRBV27,TRBJ2-5,CASSFGVRETQYF,0,2,1,2
TRBV6-2/3/5/6,TRBJ2-7,CASSFDISYEQYF,0,2,1,2
TRBV12-3/4,TRBJ1-5,CASSFTGTQPQHF,0,2,1,2
TRBV12-3/4,TRBJ2-5,CASSLWLKETQYF,0,2,1,2
TRBV12-3/4,TRBJ1-2,CASSLDRAYGYTF,0,2,1,2
TRBV6-2/3/5/6,TRBJ1-2,CASSLFGSYGYTF,0,2,1,2
TRBV28,TRBJ2-7,CASSLQGAYEQYF,0,2,1,2
TRBV6-2/3/5/6,TRBJ1-1,CASSLVVGGPAFF,0,2,1,2
TRBV28,TRBJ1-1,CASSLDRWAEAFF,0,2,1,2
TRBV28,TRBJ1-1,CASSWVQNTEAFF,0,2,1,2
TRBV6-2/3/5/6,TRBJ2-7,CASSWTSGYEQYF,0,2,1,2
TRBV12-3/4,TRBJ2-7,CASSWTGVHEQYF,0,2,1,2
TRBV12-3/4,TRBJ1-5,CASSWRVYQPQHF,0,2,1,2
TRBV6-2/3/5/6,TRBJ1-5,CASSYGAYQPQHF,0,2,1,2
TRBV6-2/3/5/6,TRBJ2-6,CASSLSGANVLTF,0,2,1,2
TRBV6-2/3/5/6,TRBJ1-5,CASSPLSNQPQHF,0,2,1,2
TRBV12-3/4,TRBJ1-1,CASSAGARAEVFF,0,2,1,2
TRBV12-3/4,TRBJ2-7,CASSDQGFHGQYF,0,2,1,2
TRBV2,TRBJ2-3,CASSEALQSTQYF,0,2,1,2
TRBV6-1,TRBJ2-7,CASSEGAFYEQYF,0,2,1,2
TRBV6-1,TRBJ2-1,CASSETQGNEQFF,0,2,1,2
TRBV2,TRBJ1-5,CASSIGSPRPQHF,0,2,1,2
TRBV7-2,TRBJ1-2,CASSFDRVWGYTF,0,2,1,2
TRBV7-6,TRBJ2-5,CASSFSRQETQYF,0,2,1,2
TRBV7-2,TRBJ1-3,CASSFRPRDTIYF,0,2,1,2
TRBV7-9,TRBJ1-2,CASSFAASAGYTF,0,2,1,2
TRBV6-2/3/5/6,TRBJ1-1,CASSLEYGTEAFF,0,2,1,2
TRBV7-6,TRBJ1-2,CASSLTVADGYTF,0,2,1,2
TRBV7-2,TRBJ2-1,CASSLSWSTTQFF,0,2,1,2
TRBV7-2,TRBJ1-5,CASSLRQNQPQHF,0,2,1,2
TRBV7-6,TRBJ2-1,CASSLVQTSEQFF,0,2,1,2
TRBV11-3,TRBJ1-1,CASSLAENTEAFF,0,2,1,2
TRBV7-9,TRBJ1-2,CASSLGQLLGYTF,0,2,1,2
TRBV11-1,TRBJ2-1,CASSLDRNNEQFF,0,2,1,2
TRBV7-2,TRBJ2-5,CASSLIGQETQYF,0,2,1,2
TRBV7-2,TRBJ1-2,CASSLIGGHGYTF,0,2,1,2
TRBV7-2,TRBJ2-7,CASSLTPPYEQYF,0,2,1,2
TRBV7-3,TRBJ1-5,CASSLSTDQPQHF,0,2,1,2
TRBV7-9,TRBJ2-1,CASSLSRANEQFF,0,2,1,2
TRBV28,TRBJ2-2,CASSSPNTGELFF,0,2,1,2
TRBV7-3,TRBJ1-6,CASSSQPNSPLHF,0,2,1,2
TRBV7-2,TRBJ2-1,CASSSGLAGEQFF,0,2,1,2
TRBV5-6,TRBJ1-4,CASSWAPNEKLFL,0,2,1,2
TRBV11-3,TRBJ2-1,CASSYRDSGEQFF,0,2,1,2
TRBV5-4,TRBJ1-2,CASSYGRGHGYTF,0,2,1,2
TRBV11-2,TRBJ1-5,CASSLGSNQPQHF,0,2,1,2
TRBV2,TRBJ2-5,CASSLGYPETQYF,0,2,1,2
TRBV12-3/4,TRBJ1-5,CASSPLGNQPQHF,0,2,1,2
TRBV7-3,TRBJ2-5,CASSPSGQETQYF,0,2,1,2
TRBV11-2,TRBJ2-7,CASSPRTYYEQYF,0,2,1,2
TRBV7-3,TRBJ1-1,CASSPAGGTEAFF,0,2,1,2
TRBV28,TRBJ2-5,CASSPGVAKTQYF,0,2,1,2
TRBV14,TRBJ1-2,CASSPGTAYGYTF,0,2,1,2
TRBV6-2/3/5/6,TRBJ1-2,CASSPGQIYGYTF,0,2,1,2
TRBV5-5,TRBJ1-6,CASSPWDSRALHF,0,2,1,2
TRBV7-6,TRBJ2-7,CASSPGSSYEQYF,0,2,1,2
TRBV28,TRBJ2-7,CASSPETGREQYF,0,2,1,2
TRBV14,TRBJ1-1,CASSRQGASEAFF,0,2,1,2
TRBV7-6,TRBJ2-7,CASSHGADYEQYF,0,2,1,2
TRBV3-1,TRBJ2-7,CASSHLGVYEQYF,0,2,1,2
TRBV11-2,TRBJ2-1,CASSQAANNEQFF,0,2,1,2
TRBV27,TRBJ1-4,CASSQGFNEKLFF,0,2,1,2
TRBV3-1,TRBJ2-5,CASSQGPQETQYF,0,2,1,2
TRBV4-2,TRBJ1-5,CASSQDTGQPQHF,0,2,1,2
TRBV9,TRBJ2-7,CASSVATGGEQYF,0,2,1,2
TRBV9,TRBJ1-1,CASSVAMYAEAFF,0,2,1,2
TRBV9,TRBJ1-1,CASSVASAGKAFF,0,2,1,2
TRBV9,TRBJ2-1,CASSGQGYNEQFF,0,2,1,2
TRBV28,TRBJ2-7,CASSKGSTGEQYF,0,2,1,2
TRBV5-4,TRBJ2-5,CASRFWVGETQYF,0,2,1,2
TRBV28,TRBJ2-5,CASRSGGQETQYF,0,2,1,2
TRBV2,TRBJ1-5,CASRASSNQPQHF,0,2,1,2
TRBV9,TRBJ2-2,CASRGGNAGELFF,0,2,1,2
TRBV7-9,TRBJ1-1,CASRDRGGTEAFF,0,2,1,2
TRBV6-2/3/5/6,TRBJ2-7,CASRSQGAYEQYF,0,2,1,2
TRBV5-4,TRBJ2-5,CASKTGRQETQYF,0,2,1,2
TRBV10-2,TRBJ2-1,CASSSGGPYEQFF,0,2,1,2
TRBV5-1,TRBJ1-6,CASITYREDPLHF,0,2,1,2
TRBV5-1,TRBJ1-1,CASTLGVNTEAFF,0,2,1,2
TRBV5-1,TRBJ2-5,CASSLGDGETQYF,0,2,1,2
TRBV5-1,TRBJ2-2,CASSLSGTGELFF,0,2,1,2
TRBV4-1,TRBJ1-1,CASSYWTGVEAFF,0,2,1,2
TRBV5-1,TRBJ2-3,CASSLDFGDTQYF,0,2,1,2
TRBV5-1,TRBJ1-2,CASSPAGTEGYTF,0,2,1,2
TRBV4-1,TRBJ2-3,CASSDRGLDTQYF,0,2,1,2
TRBV4-1,TRBJ2-1,CASRPDGYNEQFF,0,2,1,2
TRBV20-1,TRBJ2-7,CSLKGTGIYEQYF,0,2,1,2
TRBV20-1,TRBJ2-1,CSASPAGYNEQFF,0,2,1,2
TRBV20-1,TRBJ2-3,CSASGVGTDTQYF,0,2,1,2
TRBV20-1,TRBJ2-7,CSARGGFSYEQYF,0,2,1,2
TRBV20-1,TRBJ2-7,CSARGDSVYEQYF,0,2,1,2
TRBV20-1,TRBJ2-5,CSARGLAGETQYF,0,2,1,2
TRBV20-1,TRBJ1-2,CSAPDREYYGYTF,0,2,1,2
TRBV20-1,TRBJ2-5,CSATPGGEETQYF,0,2,1,2
TRBV20-1,TRBJ2-5,CSALDRAGETQYF,0,2,1,2
TRBV20-1,TRBJ1-5,CSARQGDGQPQHF,0,2,1,2
TRBV20-1,TRBJ2-2,CSIHSGVTGELFF,0,2,1,2
TRBV29-1,TRBJ1-1,CSPQKVANTEAFF,0,2,1,2
TRBV29-1,TRBJ1-1,CSVLDRGDTEAFF,0,2,1,2
TRBV29-1,TRBJ1-6,CSVSDGGNSPLHF,0,2,1,2
TRBV29-1,TRBJ2-3,CSVRLVGADTQYF,0,2,1,2
TRBV29-1,TRBJ2-5,CSVGTSGGETQYF,0,2,1,2
TRBV29-1,TRBJ2-1,CSVGSGEDSEQFF,0,2,1,2
TRBV29-1,TRBJ2-3,CSVDQTSTDTQYF,0,2,1,2
TRBV29-1,TRBJ1-1,CSVDRQLNTEAFF,0,2,1,2
TRBV29-1,TRBJ1-4,CSVDRVTNEKLFF,0,2,1,2
TRBV29-1,TRBJ1-4,CSVESGSGEKLFF,0,2,1,2
TRBV29-1,TRBJ2-3,CSVEQLGTDTQYF,0,2,1,2
TRBV29-1,TRBJ1-1,CSVEQDSNTEAFF,0,2,1,2
TRBV29-1,TRBJ1-1,CSVEVVLNTEAFF,0,2,1,2
TRBV29-1,TRBJ1-3,CSVEVGTGNTIYF,0,2,1,2
TRBV29-1,TRBJ2-3,CSVEGQDQDTQYS,0,2,1,2
TRBV29-1,TRBJ2-5,CSVSGDGGETQYF,0,2,1,2
TRBV29-1,TRBJ2-7,CSVEVYLLGEQYF,0,2,1,2
TRBV29-1,TRBJ2-5,CSVEPGQKETQYF,0,2,1,2
TRBV29-1,TRBJ1-2,CSAREYGIQDYTF,0,2,1,2
TRBV29-1,TRBJ2-4,CSAKGRGFDIQDF,0,2,1,2
TRBV29-1,TRBJ1-1,CSGFTGRSTEAFF,0,2,1,2
TRBV29-1,TRBJ2-1,YSVGRQGVGVWFF,0,2,1,2
TRBV7-9,TRBJ2-1,CVSSSNLNEQFF,0,2,1,2
TRBV30,TRBJ2-1,CACERGGDEQFF,0,2,1,2
TRBV30,TRBJ2-3,CAWSVRGDTQYF,0,2,1,2
TRBV30,TRBJ2-3,CAWSVRGNTQYF,0,2,1,2
TRBV30,TRBJ2-3,CAWSKVSDTQYF,0,2,1,2
TRBV10-3,TRBJ2-5,CAIGETEETQYF,0,2,1,2
TRBV10-3,TRBJ1-2,CAISGDNYGYTF,0,2,1,2
TRBV24-1,TRBJ2-1,CATSRTDNEQFS,0,2,1,2
TRBV19,TRBJ1-5,CASSIWRQPQHF,0,2,1,2
TRBV18,TRBJ2-3,CASSTTSGSQYF,0,2,1,2
TRBV2,TRBJ2-2,CASGLDTGELFF,0,2,1,2
TRBV28,TRBJ1-5,CASGRQNQPQHF,0,2,1,2
TRBV6-2/3/5/6,TRBJ2-7,CASSFLDRAQYF,0,2,1,2
TRBV12-3/4,TRBJ2-7,CASSFSNYEQYF,0,2,1,2
TRBV12-3/4,TRBJ2-5,CASSFLGETQYF,0,2,1,2
TRBV12-3/4,TRBJ2-3,CASSFSTDTQYF,0,2,1,2
TRBV28,TRBJ1-5,CASSLLGQPQHF,0,2,1,2
TRBV28,TRBJ2-7,CASSLAGDEQYF,0,2,1,2
TRBV12-3/4,TRBJ1-1,CASSLKATEAFF,0,2,1,2
TRBV12-3/4,TRBJ1-2,CASSSSPFSYTF,0,2,1,2
TRBV6-2/3/5/6,TRBJ1-6,CASSWTNSPLHF,0,2,1,2
TRBV28,TRBJ2-7,CASSLRGDEQYF,0,2,1,2
TRBV28,TRBJ2-5,CASSPGEETQYF,0,2,1,2
TRBV28,TRBJ2-1,CASSQTSVEQFF,0,2,1,2
TRBV7-3,TRBJ2-1,CASSVVGDEQFF,0,2,1,2
TRBV25-1,TRBJ2-7,CASSEYLYEQYF,0,2,1,2
TRBV9,TRBJ1-2,CASSRTDYGYTF,0,2,1,2
TRBV11-2,TRBJ1-1,CASSFGAVEAFF,0,2,1,2
TRBV7-9,TRBJ2-3,CASSFSGDAQYF,0,2,1,2
TRBV7-9,TRBJ2-7,CASSFRTYEQYF,0,2,1,2
TRBV11-2,TRBJ2-5,CASSLRSGDQYF,0,2,1,2
TRBV7-9,TRBJ2-5,CASSLGQETQHF,0,2,1,2
TRBV7-9,TRBJ1-2,CASSLTEYGYTS,0,2,1,2
TRBV5-5,TRBJ2-7,CASSPLAYEQYF,0,2,1,2
TRBV7-9,TRBJ2-7,CASSPGGYEQYF,0,2,1,2
TRBV3-1,TRBJ2-7,CASSQVPNEQYF,0,2,1,2
TRBV3-1,TRBJ1-6,CASSQARAPLHF,0,2,1,2
TRBV7-9,TRBJ1-1,CASSQTPGGAFF,0,2,1,2
TRBV6-2/3/5/6,TRBJ2-3,CASSQGGLTQYF,0,2,1,2
TRBV9,TRBJ2-6,CASSGGANVLTF,0,2,1,2
TRBV7-2,TRBJ1-1,CASSGQGLRGFF,0,2,1,2
TRBV7-9,TRBJ2-1,CASSGEYNEQFF,0,2,1,2
TRBV6-2/3/5/6,TRBJ2-5,CASSIYESLPYF,0,2,1,2
TRBV7-3,TRBJ2-1,CASSNIEGRQFF,0,2,1,2
TRBV2,TRBJ2-5,CASRGSGATQYF,0,2,1,2
TRBV6-4,TRBJ1-4,CASRTDKEKLFF,0,2,1,2
TRBV2,TRBJ1-2,CASNQGIGGYTF,0,2,1,2
TRBV12-3/4,TRBJ2-3,CANGQSTDTQYF,0,2,1,2
TRBV28,TRBJ2-5,CDNGGSPETQYF,0,2,1,2
TRBV5-1,TRBJ2-1,CASRDSYNEQFF,0,2,1,2
TRBV5-1,TRBJ2-5,CASRNEKGTQYF,0,2,1,2
TRBV5-1,TRBJ2-7,CASSLDYYEQYF,0,2,1,2
TRBV5-1,TRBJ2-3,CASSYTGKPQYF,0,2,1,2
TRBV4-1,TRBJ2-3,CASSQDLYTQYF,0,2,1,2
TRBV29-1,TRBJ2-1,CTQGLANNEQFF,0,2,1,2
TRBV20-1,TRBJ2-7,CSALTVPYEQYF,0,2,1,2
TRBV20-1,TRBJ2-7,CSAIRTNYEQYF,0,2,1,2
TRBV20-1,TRBJ1-1,CSARGGVTEAFF,0,2,1,2
TRBV20-1,TRBJ2-3,CSAGRSIDTQYF,0,2,1,2
TRBV29-1,TRBJ2-3,CSLTVSTDTQYF,0,2,1,2
TRBV29-1,TRBJ2-3,CSVVQGEDTQYF,0,2,1,2
TRBV29-1,TRBJ1-4,CSVGGYGEKLFF,0,2,1,2
TRBV29-1,TRBJ2-7,CSVESGGREQYF,0,2,1,2
TRBV29-1,TRBJ2-5,CSVEARGETQYF,0,2,1,2
TRBV29-1,TRBJ2-3,CSVEGVTDTQYF,0,2,1,2
TRBV29-1,TRBJ1-1,CSVEDRADEAFF,0,2,1,2
TRBV29-1,TRBJ2-7,CSVEEGAVEPYF,0,2,1,2
TRBV29-1,TRBJ2-5,CSVESPKWETYF,0,2,1,2
TRBV29-1,TRBJ2-5,CSVTRGQETQYF,0,2,1,2
TRBV29-1,TRBJ2-5,CSVLEVGKTQYF,0,2,1,2
TRBV29-1,TRBJ2-5,CSAHTAQETQYF,0,2,1,2
TRBV20-1,TRBJ2-7,CSGGQGPYEQYY,0,2,1,2
TRBV29-1,TRBJ2-2,CSIGMNTGELFF,0,2,1,2
TRBV28,TRBJ2-1,CASRAEHEQFF,0,2,1,2
TRBV10-3,TRBJ2-3,CAIRYGDTQYF,0,2,1,2
TRBV7-9,TRBJ1-1,CAIVRYTEAFF,0,2,1,2
TRBV18,TRBJ1-6,CASRFDSPLHF,0,2,1,2
TRBV12-3/4,TRBJ2-7,CASGFMYEQYF,0,2,1,2
TRBV7-6,TRBJ2-1,CASGVYNEQFF,0,2,1,2
TRBV6-2/3/5/6,TRBJ1-1,CASEEGTEAFP,0,2,1,2
TRBV3-1,TRBJ2-2,CASMLAGELFF,0,2,1,2
TRBV28,TRBJ1-2,CASSLAYGYTF,0,2,1,2
TRBV12-3/4,TRBJ2-5,CASSLRETQYF,0,2,1,2
TRBV12-3/4,TRBJ1-1,CASSSWTEAFF,0,2,1,2
TRBV2,TRBJ1-2,CASSVTGGYTF,0,2,1,2
TRBV6-1,TRBJ1-2,CASSGEYGYTF,0,2,1,2
TRBV11-1,TRBJ2-5,CASSFQETQYF,0,2,1,2
TRBV7-9,TRBJ1-3,CASSLVNTIYF,0,2,1,2
TRBV7-9,TRBJ1-2,CASSLALGYTF,0,2,1,2
TRBV5-6,TRBJ2-1,CASSSGLAEIT,0,2,1,2
TRBV3-1,TRBJ2-1,CASSQGSEQFF,0,2,1,2
TRBV7-9,TRBJ2-1,CASSAGGEQFF,0,2,1,2
TRBV7-9,TRBJ1-2,CASSGGGGYTF,0,2,1,2
TRBV7-3,TRBJ2-4,CASRRGNIQYF,0,2,1,2
TRBV5-1,TRBJ1-2,CASRASYGYTF,0,2,1,2
TRBV5-1,TRBJ2-7,CASSGQGEQYF,0,2,1,2
TRBV4-1,TRBJ2-2,CASSNTGEPFF,0,2,1,2
TRBV20-1,TRBJ1-1,CSARLNFEAFF,0,2,1,2
TRBV20-1,TRBJ2-7,CSATTSYEQYF,0,2,1,2
TRBV20-1,TRBJ2-5,CSARDWETQYF,0,2,1,2
TRBV29-1,TRBJ1-1,CSVGVDSGAFF,0,2,1,2
TRBV20-1,TRBJ2-1,CSVGGWNEQFF,0,2,1,2
TRBV29-1,TRBJ2-1,CSVEVGNEQFF,0,2,1,2
TRBV29-1,TRBJ2-3,CSVETWDTQYF,0,2,1,2
TRBV29-1,TRBJ2-7,CSVEDPNEQYF,0,2,1,2
TRBV29-1,TRBJ1-1,CSVERGTEAFF,0,2,1,2
TRBV29-1,TRBJ1-2,CSVTRVGGYTF,0,2,1,2
TRBV28,TRBJ2-5,CASGRETQYF,0,2,1,2
TRBV20-1,TRBJ2-3,CSASEDTQYF,0,2,1,2
TRBV29-1,TRBJ1-2,CSVDADGYTF,0,2,1,2
TRBV29-1,TRBJ2-5,CSAGDETQYF,0,2,1,2
