v_hit,j_hit,cdr3,S2-10ng_S7,S2-10ng_S19,freq,count_sum
TRAV23DV6,TRAJ56,CAASGGGANSKLTF,115,145,2,260
TRAV12-3,TRAJ30,CAIPPMNRDDKIIF,85,172,2,257
TRAV9-2,TRAJ49,CALSEAGNQFYF,80,155,2,235
TRAV36DV7,TRAJ23,CAVEALNQGGKLIF,76,116,2,192
TRAV3,TRAJ6,CAPRGSGGSYIPTF,61,75,2,136
TRAV13-2,TRAJ3,CAKPGYSSASKIIF,58,54,2,112
TRAV12-3,TRAJ37,CAMSLWVSNTGKLIF,47,0,1,47
TRAV14DV4,TRAJ37,CAMREGSSNTGKLIF,36,13,2,49
TRAV27,TRAJ33,CLGSNYQLIW,36,0,1,36
TRAV4,TRAJ27,CLVGDIGNAGKSTF,34,69,2,103
TRAV17,TRAJ54,CATSRGAQKLVF,33,24,2,57
TRAV26-2,TRAJ21,CILEYNFNKFYF,31,0,1,31
TRAV21,TRAJ15,CAVRAQAGTALIF,30,22,2,52
TRAV12-2,TRAJ23,CAVDYNQGGKLIF,28,73,2,101
TRAV14DV4,TRAJ12,CAMREGLDSSYKLIF,28,0,1,28
TRAV16,TRAJ37,CALCTSNTGKLIF,27,0,1,27
TRAV13-1,TRAJ11,CAARRYSTLTF,26,24,2,50
TRAV12-3,TRAJ13,CASSGGYQKVTF,25,14,2,39
TRAV5,TRAJ6,CAVPPGGSYIPTF,24,8,2,32
TRAV12-2,TRAJ34,CAVRKLIF,24,28,2,52
TRAV29DV5,TRAJ53,CAAKGSGGSNYKLTF,24,30,2,54
TRAV27,TRAJ23,CAGTLDTQGGKLIF,23,0,1,23
TRAV12-1,TRAJ23,CVVTRDQGGKLIF,23,0,1,23
TRAV23DV6,TRAJ49,CAPSNTGNQFYF,23,15,2,38
TRAV26-2,TRAJ44,CILRALTGTASKLTF,22,2,2,24
TRAV38-1,TRAJ34,CAFMKLHNTDKLIF,22,0,1,22
TRAV12-1,TRAJ38,CVVNLNAGNNRKLIW,21,0,1,21
TRAV20,TRAJ11,CAGFSGYSTLTF,21,0,1,21
TRAV17,TRAJ54,CATERLLINQGAQKLVF,20,0,1,20
TRAV36DV7,TRAJ52,CAVGGGTSYGKLTF,20,59,2,79
TRAV12-2,TRAJ31,CAVANARLMF,20,5,2,25
TRAV19,TRAJ39,CALSPSMNNNAGNMLTF,20,5,2,25
TRAV20,TRAJ9,CAVQADGGFKTIF,20,39,2,59
TRAV19,TRAJ30,CALSDPRDDKIIF,19,0,1,19
TRAV17,TRAJ56,CASTGANSKLTF,19,4,2,23
TRAV12-2,TRAJ49,CAVVRAGNQFYF,19,5,2,24
TRAV12-3,TRAJ52,CAMSGAGGTSYGKLTF,19,0,1,19
TRAV12-1,TRAJ52,CVVNQANAGGTSYGKLTF,18,0,1,18
TRAV9-2,TRAJ15,CALSPYQAGTALIF,18,0,1,18
TRAV14DV4,TRAJ47,CAMRLMEYGNKLVF,18,8,2,26
TRAV3,TRAJ6,CAVREVGSYIPTF,18,0,1,18
TRAV17,TRAJ39,CAPNNAGNMLTF,18,13,2,31
TRAV27,TRAJ12,CAGVKDSSYKLIF,17,10,2,27
TRAV5,TRAJ49,CAERPSNQFYF,17,16,2,33
TRAV13-1,TRAJ37,CAAETGKLIF,17,0,1,17
TRAV12-2,TRAJ39,CAVNINNAGNMLTF,17,0,1,17
TRAV3,TRAJ8,CAVRANTGFQKLVF,16,33,2,49
TRAV21,TRAJ13,CAVGFSGGYQKVTF,16,6,2,22
TRAV12-3,TRAJ3,CAMTPYSSASKIIF,16,0,1,16
TRAV12-2,TRAJ23,CAVLGDQGGKLIF,16,16,2,32
TRAV38-2DV8,TRAJ49,CAYSPGNQFYF,16,0,1,16
TRAV8-3,TRAJ48,CGDFGNEKLTF,16,0,1,16
TRAV12-3,TRAJ49,CAMTRAQVYF,16,0,1,16
TRAV9-2,TRAJ9,CAPHTGGFKTIF,16,0,1,16
TRAV20,TRAJ20,CAVQAYDYKLSF,16,0,1,16
TRAV5,TRAJ10,CAEIFTGGGNKLTF,15,0,1,15
TRAV26-2,TRAJ58,CILRDAYGSGSRLTF,15,0,1,15
TRAV2,TRAJ27,CAVAYNTNAGKSTF,15,26,2,41
TRAV13-1,TRAJ37,CAALRSSNTGKLIF,15,0,1,15
TRAV20,TRAJ36,CAVPGPGANNLFF,15,5,2,20
TRAV17,TRAJ34,CATDATNTDKLIF,15,0,1,15
TRAV27,TRAJ31,CAGAGQNNARLMF,15,0,1,15
TRAV2,TRAJ34,CAPRDTDKLIF,15,0,1,15
TRAV9-2,TRAJ45,CALSPGYSGGGADGLTF,14,0,1,14
TRAV13-1,TRAJ27,CAASIQNNTNAGKSTF,14,0,1,14
TRAV25,TRAJ52,CAGRRTGGTSYGKLTF,14,0,1,14
TRAV12-1,TRAJ28,CVVTVIPPGSYQLTF,14,2,2,16
TRAV19,TRAJ40,CALSGHLPGTYKYIF,14,0,1,14
TRAV16,TRAJ29,CALRNSGNTPLVF,14,3,2,17
TRAV3,TRAJ20,CAVRDSNDYKLSF,14,0,1,14
TRAV25,TRAJ43,CAGRDNDMRF,14,0,1,14
TRAV4,TRAJ48,CLVGPNFGNEKLTF,14,0,1,14
TRAV17,TRAJ24,CALTDSGGKLQF,14,0,1,14
TRAV12-3,TRAJ42,CAMRSLNYGGSQGNLIF,13,0,1,13
TRAV9-2,TRAJ28,CALSPISGAGSYQLTF,13,0,1,13
TRAV9-2,TRAJ3,CALSDGRSSVSKIIF,13,0,1,13
TRAV21,TRAJ12,CAVRMDSSYKLIF,13,2,2,15
TRAV13-2,TRAJ37,CAEIPFRPGKLIF,13,0,1,13
TRAV38-2DV8,TRAJ33,CACMDSNYQLIW,13,0,1,13
TRAV13-1,TRAJ3,CAASIGPPASKIIF,13,0,1,13
TRAV20,TRAJ29,CAVQARSGNTPLVF,13,0,1,13
TRAV10,TRAJ42,CVVNLNYGGSQGNLIF,13,0,1,13
TRAV14DV4,TRAJ45,CAMREGHLKEGGADGLTF,12,0,1,12
TRAV13-1,TRAJ28,CAAPSLPGAGSYQLTF,12,0,1,12
TRAV39,TRAJ42,CAVPSYGGSQGNLIF,12,0,1,12
TRAV9-2,TRAJ13,CALSPSGGYQKVTF,12,0,1,12
TRAV21,TRAJ34,CAVKGGYNTDKLIF,12,0,1,12
TRAV24,TRAJ29,CASARRSGNTPLVF,12,0,1,12
TRAV21,TRAJ17,CAVPQAAGNKLTF,12,0,1,12
TRAV8-3,TRAJ9,CAVGNTGGFKTIF,12,16,2,28
TRAV12-2,TRAJ40,CAVEPSGTYKYIF,12,0,1,12
TRAV13-1,TRAJ29,CAASMAGNTPLVF,12,0,1,12
TRAV38-1,TRAJ43,CAFTFNNNDMRF,12,0,1,12
TRAV2,TRAJ39,CATDNAGNMLTF,12,4,2,16
TRAV23DV6,TRAJ10,CAATGGGNKLTF,12,0,1,12
TRAV21,TRAJ26,CAVIGRNYGQNFVF,12,0,1,12
TRAV14DV4,TRAJ53,CAMREGRSGGSDYKLTF,12,0,1,12
TRAV13-1,TRAJ45,CAASRSGGGADGLTF,12,0,1,12
TRAV29DV5,TRAJ44,CAASETGTASKLTF,12,0,1,12
TRAV14DV4,TRAJ20,CAMREAAGDYKLSF,12,0,1,12
TRAV17,TRAJ26,CATADNYGQNFVF,12,0,1,12
TRAV3,TRAJ37,CAVRVTSNTGKLIF,12,0,1,12
TRAV4,TRAJ9,CLVGGNTGGFKTIF,11,0,1,11
TRAV21,TRAJ16,CAVERDGQKLLF,11,0,1,11
TRAV38-2DV8,TRAJ52,CAYRAAINAGGTSYGKLTF,11,0,1,11
TRAV13-1,TRAJ10,CAASLGILTGGGNKLTF,11,0,1,11
TRAV20,TRAJ6,CAVQAGSAGGSYIPTF,11,37,2,48
TRAV8-3,TRAJ12,CAVGGTRMDSSYKLIF,11,0,1,11
TRAV2,TRAJ3,CAVELGSSASKIIF,11,0,1,11
TRAV13-2,TRAJ48,CAEKGKLGNEKLTF,11,0,1,11
TRAV21,TRAJ21,CAVTLYNFNKFYF,11,0,1,11
TRAV8-3,TRAJ30,CAVAQNRDDKIIF,11,0,1,11
TRAV8-3,TRAJ44,CAVAYGTASKLTF,11,6,2,17
TRAV13-1,TRAJ6,CAVISGGSYIPTF,11,0,1,11
TRAV5,TRAJ29,CAESRSGNTPLVF,11,0,1,11
TRAV34,TRAJ22,CGADSGSARQLTF,11,0,1,11
TRAV8-3,TRAJ20,CAVAPNDYKLSF,11,0,1,11
TRAV22,TRAJ27,CAVLYAGKSTF,11,0,1,11
TRAV20,TRAJ43,CAVQEVYDMRF,11,0,1,11
TRAV4,TRAJ5,CLVGDRDTGRRALTF,11,0,1,11
TRAV8-3,TRAJ10,CAVGPDILTGGGNKLTF,10,0,1,10
TRAV36DV7,TRAJ58,CAVESLNQETSGSRLTF,10,0,1,10
TRAV3,TRAJ18,CAVSRHRGSTLGRLYF,10,33,2,43
TRAV12-1,TRAJ30,CVVVQVRDRDDKIIF,10,0,1,10
TRAV12-1,TRAJ36,CVATKAQTGANNLFF,10,0,1,10
TRAV16,TRAJ37,CALSGDSSNTGKLIF,10,8,2,18
TRAV8-3,TRAJ3,CAVGAGYSSASKIIF,10,0,1,10
TRAV27,TRAJ37,CAGTYGSSNTGKLIF,10,0,1,10
TRAV12-3,TRAJ9,CAMSAGGTGGFKTIF,10,0,1,10
TRAV14DV4,TRAJ42,CAMRGYGGSQGNLIF,10,0,1,10
TRAV38-2DV8,TRAJ45,CAPRGGGGADGLTF,10,2,2,12
TRAV22,TRAJ57,CAVEWAGGSEKLVF,10,0,1,10
TRAV12-2,TRAJ12,CAVISGDSSYKLIF,10,0,1,10
TRAV8-1,TRAJ33,CAVRLMDSNYQLIW,10,0,1,10
TRAV13-2,TRAJ49,CAENRGRTGNQFYF,10,0,1,10
TRAV12-2,TRAJ9,CVFPGTGGFKTIF,10,0,1,10
TRAV16,TRAJ49,CALKPNTGNQFYF,10,0,1,10
TRAV2,TRAJ21,CAVEDYNFNKFYF,10,0,1,10
TRAV12-2,TRAJ49,CAVNIRGGNQFYF,10,0,1,10
TRAV25,TRAJ54,CAGQIQGAQKLVF,10,0,1,10
TRAV13-2,TRAJ20,CAEISPNDYKLSF,10,0,1,10
TRAV26-1,TRAJ16,CIVSLSDGQKLLF,10,0,1,10
TRAV10,TRAJ40,CVVRSGTYKYIF,10,0,1,10
TRAV12-2,TRAJ5,CALYTGRRALTF,10,0,1,10
TRAV14DV4,TRAJ27,CAMVSNAGKSTF,10,0,1,10
TRAV12-1,TRAJ20,CVVNIGELSF,10,0,1,10
TRAV20,TRAJ18,CAVQAGRGSTLGRLYF,10,0,1,10
TRAV8-3,TRAJ37,CAVGGSSNTGKLIF,10,7,2,17
TRAV4,TRAJ28,CLVGAYSGAGSYQLTF,10,3,2,13
TRAV27,TRAJ54,CAGLRFQGAQKLVF,10,0,1,10
TRAV29DV5,TRAJ40,CAASAVTSGTYKYIF,10,3,2,13
TRAV26-2,TRAJ39,CILRDYNNAGNMLTF,10,0,1,10
TRAV30,TRAJ17,CGTESTAGNKLTF,10,0,1,10
TRAV8-3,TRAJ39,CAVGAKNAGNMLTF,10,0,1,10
TRAV12-2,TRAJ12,CAVNNKDSSYKLIF,10,0,1,10
TRAV4,TRAJ37,CLFPSSNTGKLIF,10,0,1,10
TRAV13-1,TRAJ43,CAASPGDMRF,10,0,1,10
TRAV13-2,TRAJ21,CAENMGPVGDNFNKFYF,9,0,1,9
TRAV13-1,TRAJ13,CAATPRNSGGYQKVTF,9,0,1,9
TRAV13-1,TRAJ53,CAASRNSGGSNYKLTF,9,0,1,9
TRAV14DV4,TRAJ52,CAMSPKRGTSYGKLTF,9,9,2,18
TRAV9-2,TRAJ23,CALRGIYNQGGKLIF,9,0,1,9
TRAV20,TRAJ44,CAVRRNTGTASKLTF,9,0,1,9
TRAV20,TRAJ6,CAVQAVAGGSYIPTF,9,0,1,9
TRAV36DV7,TRAJ57,CAVGRSQGGSEKLVF,9,0,1,9
TRAV13-1,TRAJ37,CAASRAPSNTGKLIF,9,0,1,9
TRAV4,TRAJ36,CLVGDMSIGANNLFF,9,0,1,9
TRAV4,TRAJ28,CLVGGSGAGSYQLTF,9,0,1,9
TRAV30,TRAJ24,CGTEYSTDSWGKLQF,9,0,1,9
TRAV9-2,TRAJ10,CALRVTGGGNKLTF,9,0,1,9
TRAV20,TRAJ15,CAVPLNQAGTALIF,9,18,2,27
TRAV8-3,TRAJ15,CAVAPNQAGTALIF,9,0,1,9
TRAV8-3,TRAJ5,CAVAIDTGRRALTF,9,10,2,19
TRAV21,TRAJ39,CAVRPGNAGNMLTF,9,10,2,19
TRAV13-2,TRAJ13,CAETAPPGYQKVTF,9,0,1,9
TRAV14DV4,TRAJ29,CAMRDAPGNTPLVF,9,0,1,9
TRAV38-2DV8,TRAJ48,CAYEGFGNEKLTF,9,0,1,9
TRAV38-2DV8,TRAJ30,CAYRSAGDDKIIF,9,0,1,9
TRAV9-2,TRAJ4,CALSSGGYNKLIF,9,0,1,9
TRAV9-2,TRAJ41,CALTENSGYALNF,9,0,1,9
TRAV36DV7,TRAJ38,CAVDAGNNRKLIW,9,0,1,9
TRAV3,TRAJ16,CAVSAPDGQKLLF,9,0,1,9
TRAV13-1,TRAJ20,CAASISGDYKLSF,9,0,1,9
TRAV13-2,TRAJ40,CAETGSGTYKYIF,9,0,1,9
TRAV34,TRAJ33,CGGLPDSNYQLIW,9,0,1,9
TRAV4,TRAJ9,CLVGGSGGFKTIF,9,0,1,9
TRAV26-1,TRAJ12,CIARMDSSYKLIF,9,0,1,9
TRAV34,TRAJ29,CVSRSGNTPLVF,9,0,1,9
TRAV13-1,TRAJ9,CAAYTGGFKTIF,9,0,1,9
TRAV14DV4,TRAJ43,CAMRERGNDMRF,9,0,1,9
TRAV30,TRAJ20,CGTERNDYKLSF,9,0,1,9
TRAV16,TRAJ40,CALPGTYKYIF,9,0,1,9
TRAV9-2,TRAJ27,CALVFAGKSTF,9,3,2,12
TRAV20,TRAJ43,CAVQAIGDMRF,9,8,2,17
TRAV26-2,TRAJ43,CILRDNDMRF,9,0,1,9
TRAV26-2,TRAJ53,CILRGGGGSNYKLTF,9,0,1,9
TRAV17,TRAJ20,CATGRSNDYKLSF,9,0,1,9
TRAV12-1,TRAJ27,CVVNTNAGKSTF,9,11,2,20
TRAV12-3,TRAJ9,CASHTGGFKTIF,9,0,1,9
TRAV12-2,TRAJ3,CAVNDYSSASKIIF,9,0,1,9
TRAV5,TRAJ4,CAESISGGYNKLIF,9,0,1,9
TRAV12-3,TRAJ37,CAMSISSNTGKLIF,9,0,1,9
TRAV30,TRAJ57,CGTVATKRPATQGGSEKLVF,8,0,1,8
TRAV38-1,TRAJ53,CAFMGSSNSGGSNYKLTF,8,6,2,14
TRAV26-2,TRAJ42,CILRDVGYGGSQGNLIF,8,0,1,8
TRAV41,TRAJ45,CAVRYGSGGGADGLTF,8,0,1,8
TRAV22,TRAJ42,CAVERGYGGSQGNLIF,8,0,1,8
TRAV21,TRAJ29,CAVSGPAISGNTPLVF,8,0,1,8
TRAV3,TRAJ6,CAVRDGASGGSYIPTF,8,0,1,8
TRAV12-1,TRAJ28,CVVKGSGAGSYQLTF,8,0,1,8
TRAV38-2DV8,TRAJ39,CAYRTGNNAGNMLTF,8,0,1,8
TRAV9-2,TRAJ38,CALEPHAGNNRKLIW,8,0,1,8
TRAV21,TRAJ57,CAVSGAQGGSEKLVF,8,0,1,8
TRAV3,TRAJ33,CAVRDLVDSNYQLIW,8,0,1,8
TRAV12-2,TRAJ50,CAVNSRETSYDKVIF,8,0,1,8
TRAV13-1,TRAJ20,CAATRTPSNDYKLSF,8,0,1,8
TRAV26-1,TRAJ39,CIVRAFNNAGNMLTF,8,0,1,8
TRAV16,TRAJ28,CALYSGAGSYQLTF,8,0,1,8
TRAV9-2,TRAJ9,CALTGRAGGFKTIF,8,3,2,11
TRAV9-2,TRAJ44,CALSVPGTASKLTF,8,0,1,8
TRAV16,TRAJ58,CALSGQNSGSRLTF,8,0,1,8
TRAV16,TRAJ23,CALSGRNQGGKLIF,8,0,1,8
TRAV16,TRAJ9,CALRVNTGGFKTIF,8,0,1,8
TRAV8-3,TRAJ6,CAVGTSGGSYIPTF,8,0,1,8
TRAV24,TRAJ48,CAFISNFGNEKLTF,8,0,1,8
TRAV23DV6,TRAJ10,CAAKHGGGGNKLTF,8,0,1,8
TRAV4,TRAJ3,CLVGERGGASKIIF,8,0,1,8
TRAV26-2,TRAJ9,CILSLDTGGFKTIF,8,0,1,8
TRAV26-2,TRAJ58,CTLIKETSGSRLTF,8,0,1,8
TRAV13-1,TRAJ49,SAASTNTGNQFYF,8,0,1,8
TRAV16,TRAJ6,CALRGGGSYIPTF,8,0,1,8
TRAV2,TRAJ22,CAVFSGSARQLTF,8,0,1,8
TRAV29DV5,TRAJ49,CAVVSDTGNQFYF,8,0,1,8
TRAV8-3,TRAJ37,CAVGDRNTGKLIF,8,0,1,8
TRAV2,TRAJ34,CAVEDNDTDKLIF,8,0,1,8
TRAV3,TRAJ31,CAVRGPNDARLMF,8,0,1,8
TRAV24,TRAJ57,CASTQGGSEKLVF,8,29,2,37
TRAV12-2,TRAJ21,CAVNPDGFNKFYF,8,0,1,8
TRAV12-1,TRAJ30,CADEGNRDDKIIF,8,0,1,8
TRAV13-1,TRAJ37,CAARLGDTGKLIF,8,0,1,8
TRAV13-1,TRAJ20,CAATKRGDYKLSF,8,0,1,8
TRAV13-1,TRAJ16,CAAISSDGQKLLF,8,0,1,8
TRAV13-1,TRAJ13,CAASIAGYQKVTF,8,0,1,8
TRAV12-3,TRAJ6,CATPPGGSYIPTF,8,0,1,8
TRAV12-1,TRAJ5,CKIMDTGRRALTF,8,0,1,8
TRAV4,TRAJ33,CLVGESSNYQLIW,8,0,1,8
TRAV12-1,TRAJ37,CVVISNTGKLIF,8,3,2,11
TRAV3,TRAJ9,CAVNTGGFKTIF,8,2,2,10
TRAV12-2,TRAJ35,CAALGFGNVLHC,8,0,1,8
TRAV36DV7,TRAJ26,CAGFYYGQNFVF,8,0,1,8
TRAV12-2,TRAJ3,CAVYSSASKIIF,8,0,1,8
TRAV27,TRAJ42,CAGGGSQGNLIF,8,0,1,8
TRAV5,TRAJ36,CAEKTGANNPFF,8,0,1,8
TRAV4,TRAJ36,CLVVGGANNLFF,8,3,2,11
TRAV30,TRAJ21,CGTENNFNKFYF,8,0,1,8
TRAV16,TRAJ43,CALSPNNDMRF,8,0,1,8
TRAV36DV7,TRAJ27,CAVLNAGKSTF,8,0,1,8
TRAV21,TRAJ6,CAVGGSYIPTF,8,0,1,8
TRAV21,TRAJ43,CAVKNNNDMRF,8,0,1,8
TRAV17,TRAJ23,CAAQEGGKLIF,8,0,1,8
TRAV27,TRAJ21,CAAYNFNKFYF,8,3,2,11
TRAV23DV6,TRAJ37,CAAHNTGKLIF,8,0,1,8
TRAV26-1,TRAJ37,CITSNTGKLIF,8,0,1,8
TRAV12-2,TRAJ23,CAVLGGKLIF,8,0,1,8
TRAV36DV7,TRAJ43,CAACDNDMRF,8,0,1,8
TRAV26-2,TRAJ52,CETSYGKLTF,8,0,1,8
TRAV26-2,TRAJ38,CILRGLIW,8,0,1,8
TRAV14DV4,TRAJ52,CAMREGTAGGTSYGKLTF,8,0,1,8
TRAV2,TRAJ40,CAVEDNSGTYKYIF,8,0,1,8
TRAV9-2,TRAJ52,CALGRFGTSYGKLTF,7,0,1,7
TRAV16,TRAJ37,CALSSTGSNTGKLIF,7,0,1,7
TRAV4,TRAJ9,CLVGGSNTGGFKTIF,7,0,1,7
TRAV21,TRAJ15,CAVSANQAGTALIF,7,0,1,7
TRAV23DV6,TRAJ34,CAASSNYNTDKLIF,7,0,1,7
TRAV12-3,TRAJ20,CAMSSANDYKLSF,7,0,1,7
TRAV9-2,TRAJ57,CALSQGQGGSEKLVF,7,0,1,7
TRAV38-1,TRAJ54,CAFMRIQGAQKLVF,7,0,1,7
TRAV3,TRAJ7,CAVRDSIGNNRLAF,7,0,1,7
TRAV12-3,TRAJ34,CAMSLYNTDKLIF,7,0,1,7
TRAV20,TRAJ26,CAVQDYGQNFVF,7,0,1,7
TRAV5,TRAJ34,CAESGDTDKLIF,7,0,1,7
TRAV26-2,TRAJ52,CILRPAGGTSYGKLTF,7,9,2,16
TRAV9-2,TRAJ42,CALSDMNYGGSQGNLIF,7,0,1,7
TRAV12-1,TRAJ11,CVVNMSQNSGYSTPTF,7,0,1,7
TRAV9-2,TRAJ5,CALSDLGGTGRRALTF,7,0,1,7
TRAV8-3,TRAJ53,CAVATRGGGSNYKLTF,7,0,1,7
TRAV13-1,TRAJ11,CAAAGVLNSGYSTLTF,7,0,1,7
TRAV4,TRAJ27,CLVGDMGYTNAGKSTF,7,0,1,7
TRAV26-2,TRAJ29,CILRDVGKTGNTPLVF,7,0,1,7
TRAV26-1,TRAJ57,CIVRVALQGGSEKLVF,7,0,1,7
TRAV10,TRAJ39,CVVSAFRNAGNMLTF,7,0,1,7
TRAV38-2DV8,TRAJ48,CAYRSAGFGNEKLTF,7,0,1,7
TRAV19,TRAJ47,CALSEAEEYGNKLVF,7,0,1,7
TRAV19,TRAJ30,CALSEKENRDDKIIF,7,0,1,7
TRAV20,TRAJ31,CAVHPRDYNNARLMF,7,0,1,7
TRAV20,TRAJ42,CAVQATRGSQGNLIF,7,0,1,7
TRAV21,TRAJ53,CAVSSSGGSNYKLTF,7,0,1,7
TRAV13-1,TRAJ49,CAATPRTNTGNQFYF,7,0,1,7
TRAV29DV5,TRAJ53,CAASALRGSNYKLTF,7,0,1,7
TRAV5,TRAJ42,CAEILYGGSQGNLIF,7,0,1,7
TRAV13-2,TRAJ23,CAETGGNNQGGKLIF,7,44,2,51
TRAV12-3,TRAJ10,CAMVRLTGGGNKLTF,7,0,1,7
TRAV14DV4,TRAJ41,CAMREGGNSGYALNF,7,0,1,7
TRAV4,TRAJ36,CLVGADQTGANNLFF,7,0,1,7
TRAV26-2,TRAJ4,CILRAHSGGYNKLIF,7,0,1,7
TRAV10,TRAJ29,CVVSSYSGNTPLVF,7,0,1,7
TRAV12-1,TRAJ21,CVVNGADNFNKFYF,7,0,1,7
TRAV12-1,TRAJ5,CVVNRGTGRRALTF,7,0,1,7
TRAV16,TRAJ29,CALTPYSGNTPLVF,7,0,1,7
TRAV9-2,TRAJ50,CALTTETSYDKVIF,7,0,1,7
TRAV9-2,TRAJ45,CALSDRGGADGLTF,7,0,1,7
TRAV6,TRAJ39,CALAPNNAGNMLTF,7,0,1,7
TRAV6,TRAJ46,CALDEGSSGDKLTF,7,0,1,7
TRAV21,TRAJ21,CAVGSWDNFSKFYF,7,0,1,7
TRAV8-3,TRAJ10,CAVDPGGGGNKLTF,7,0,1,7
TRAV2,TRAJ16,CAVEDGSDGQKLLF,7,0,1,7
TRAV3,TRAJ30,CAVSRMNRDDKIIF,7,0,1,7
TRAV3,TRAJ45,CAVRRGGGADGLTF,7,0,1,7
TRAV12-1,TRAJ37,CAFFPPSNTGKLIF,7,0,1,7
TRAV24,TRAJ41,CAFIQENSGYALNF,7,0,1,7
TRAV8-1,TRAJ5,CAVNAGPGRRALTF,7,0,1,7
TRAV12-2,TRAJ39,CAVNGDNAGNMLTF,7,0,1,7
TRAV13-1,TRAJ11,CAAAPMEGYSTLTF,7,0,1,7
TRAV13-1,TRAJ13,CAASIREGYQKVTF,7,0,1,7
TRAV13-1,TRAJ15,CAASRHQAGTALIF,7,0,1,7
TRAV13-1,TRAJ40,CAASKGSGTYKYIF,7,0,1,7
TRAV27,TRAJ15,CAGYNNQAGTALIF,7,9,2,16
TRAV12-3,TRAJ17,CAMSGEAAGNKLTF,7,0,1,7
TRAV4,TRAJ40,CLVAHTSGTYKYIF,7,0,1,7
TRAV4,TRAJ18,CLVGPRGTLGRLYF,7,0,1,7
TRAV4,TRAJ10,CLVGGTGGGNKLTF,7,0,1,7
TRAV12-1,TRAJ26,CVVNQEYGQNFVF,7,0,1,7
TRAV12-1,TRAJ21,CVVNPGNFNKFYF,7,0,1,7
TRAV2,TRAJ21,CASPEYNFNKFYF,7,0,1,7
TRAV9-2,TRAJ48,CALSNFGNEKLTF,7,0,1,7
TRAV16,TRAJ48,CALDDFGNEKLTF,7,0,1,7
TRAV16,TRAJ33,CALSGDSNYQLIW,7,0,1,7
TRAV16,TRAJ29,CALRRSGNTPLVF,7,0,1,7
TRAV8-4,TRAJ22,CAVSDGSARQLTF,7,0,1,7
TRAV12-2,TRAJ50,CAVRETSYDKVIF,7,0,1,7
TRAV3,TRAJ20,CAVKGTSDYKLSF,7,0,1,7
TRAV23DV6,TRAJ12,CAPGMDSSYKLIF,7,0,1,7
TRAV12-2,TRAJ48,CAVEVFGNERLTF,7,0,1,7
TRAV29DV5,TRAJ27,CAASDDNAGKSTF,7,0,1,7
TRAV13-1,TRAJ50,CAARATSYDKVIF,7,0,1,7
TRAV27,TRAJ32,CAGYGGATNKLIF,7,2,2,9
TRAV13-2,TRAJ33,CAEKGNSNYQLIW,7,8,2,15
TRAV14DV4,TRAJ9,CAMSPTGGFKTIF,7,3,2,10
TRAV36DV7,TRAJ38,CTIHAGNNRKLIW,7,4,2,11
TRAV30,TRAJ17,CGTAKAAGNKLTF,7,0,1,7
TRAV26-1,TRAJ50,CIVTWTSYDKVIF,7,0,1,7
TRAV38-2DV8,TRAJ34,CAYRSNTDKLIF,7,0,1,7
TRAV38-2DV8,TRAJ49,CAYRRSGNQFYF,7,0,1,7
TRAV16,TRAJ53,CALRGSNYKLTF,7,0,1,7
TRAV9-2,TRAJ4,CALKGGYNKLIF,7,0,1,7
TRAV8-3,TRAJ40,CAVASGTYKYVF,7,0,1,7
TRAV8-3,TRAJ34,CAVGEDTDKLIF,7,0,1,7
TRAV8-3,TRAJ40,CAVGSGTYKYIF,7,2,2,9
TRAV12-2,TRAJ21,CAVRNNFNKFYF,7,2,2,9
TRAV12-2,TRAJ9,CAVEDGGFKTIF,7,0,1,7
TRAV25,TRAJ10,CAAGGGGNKLTF,7,0,1,7
TRAV29DV5,TRAJ40,CAASPGTYKYIF,7,0,1,7
TRAV13-1,TRAJ8,CAASRSFQKLVF,7,0,1,7
TRAV12-3,TRAJ20,CAMSSNDYKLSF,7,0,1,7
TRAV26-2,TRAJ49,CILSATGNQFYF,7,0,1,7
TRAV16,TRAJ47,CALRGLNKLVF,7,0,1,7
TRAV9-2,TRAJ34,CAPEGTDKLIF,7,0,1,7
TRAV21,TRAJ20,CAVNHDYKLSF,7,0,1,7
TRAV12-3,TRAJ20,CAMSDDYKLSF,7,0,1,7
TRAV9-2,TRAJ20,CAPNDYKLSF,7,0,1,7
TRAV13-1,TRAJ31,CAASMDRLMF,7,0,1,7
TRAV27,TRAJ37,CAIHPGKLIF,7,0,1,7
TRAV24,TRAJ43,CAFNNDMRF,7,0,1,7
TRAV13-1,TRAJ53,CAANSGGSNYKLTF,6,0,1,6
TRAV21,TRAJ52,CAVSSPPYAGGTSYGKLTF,6,2,2,8
TRAV12-3,TRAJ52,CAMKLANAGGTSYGKLTF,6,0,1,6
TRAV38-1,TRAJ42,CAFMKPYFGGSQGNLIF,6,0,1,6
TRAV38-1,TRAJ38,CAFMKPVNAGNNRKLIW,6,0,1,6
TRAV19,TRAJ57,CALSGPLIQGGSEKLVF,6,0,1,6
TRAV13-1,TRAJ52,CAASQGAGGTSYGKLTF,6,0,1,6
TRAV14DV4,TRAJ10,CAMREVILTGGGNKPTF,6,0,1,6
TRAV41,TRAJ48,CAVVECPNFGNEKLTF,6,0,1,6
TRAV36DV7,TRAJ52,CAVPDAGGTSYGKLTF,6,0,1,6
TRAV12-2,TRAJ37,CAVNDWGSSNTGKLIF,6,0,1,6
TRAV13-1,TRAJ5,CASLAPGGTGRRALTF,6,0,1,6
TRAV5,TRAJ32,CAESRWYGGATNKLIF,6,0,1,6
TRAV12-1,TRAJ23,CVVTSFYNQGGKLIF,6,0,1,6
TRAV12-1,TRAJ18,CVVNDRGSTLGRLYF,6,9,2,15
TRAV38-1,TRAJ42,CAFMSYGGSQGNLIF,6,0,1,6
TRAV19,TRAJ6,CALSAAGGGSYIPTF,6,0,1,6
TRAV9-2,TRAJ6,CALSVASGGSYIPTF,6,0,1,6
TRAV9-2,TRAJ32,CALRLYGGATNKLIF,6,0,1,6
TRAV9-2,TRAJ37,CALRRGSSNTGKLIF,6,0,1,6
TRAV23DV6,TRAJ45,CAPPKGGGGADGLTF,6,0,1,6
TRAV22,TRAJ28,CAVPYSGAGSYQLTF,6,0,1,6
TRAV12-3,TRAJ30,CAVWNPMNRDDKIIF,6,0,1,6
TRAV22,TRAJ24,CAVYGTTDSWGKLQF,6,0,1,6
TRAV20,TRAJ32,CAVQENGGATNKLIF,6,0,1,6
TRAV20,TRAJ37,CAVAQGSSNTGKLIF,6,0,1,6
TRAV36DV7,TRAJ18,CAVEDRGSTLGRLYF,6,0,1,6
TRAV8-4,TRAJ40,CAVTLTTSGTYKYIF,6,0,1,6
TRAV3,TRAJ22,CAVSSYSGSARQLTF,6,0,1,6
TRAV21,TRAJ10,CAVSPKGGGGNKLTF,6,0,1,6
TRAV29DV5,TRAJ57,CAASSTQGGSEKLVF,6,0,1,6
TRAV35,TRAJ24,CAGHPAPDSWGKLQF,6,7,2,13
TRAV35,TRAJ37,CAGQLRSSNTGKLIF,6,0,1,6
TRAV41,TRAJ45,CAVSYSGGGADGLTF,6,16,2,22
TRAV39,TRAJ48,CAVDMSNFGNEKLTF,6,0,1,6
TRAV13-1,TRAJ10,CASDILTGGGNKLTF,6,0,1,6
TRAV12-3,TRAJ21,CAPVSKAGNFNKFYF,6,0,1,6
TRAV13-1,TRAJ45,CAAIFPGGGADGLTF,6,0,1,6
TRAV13-1,TRAJ13,CAASIGSGGYQKVTF,6,0,1,6
TRAV23DV6,TRAJ39,CAARSGHNAGNMLTF,6,0,1,6
TRAV23DV6,TRAJ52,CAAKGGGTSYGKLTF,6,0,1,6
TRAV27,TRAJ18,CAGVSRGSTLGRLYF,6,0,1,6
TRAV13-2,TRAJ48,CAERRSNFGNEKLTF,6,0,1,6
TRAV12-3,TRAJ37,CAMSVRNSNTGKLIF,6,0,1,6
TRAV12-3,TRAJ6,CAMSAGSGGSYIPTF,6,23,2,29
TRAV14DV4,TRAJ49,CAMREAPNTGNQFYF,6,0,1,6
TRAV14DV4,TRAJ47,CAMREGTEYGNKLVF,6,0,1,6
TRAV12-3,TRAJ28,CAIPNSGAGSYQLTF,6,7,2,13
TRAV34,TRAJ37,CVVIPSSNTGKLIF,6,0,1,6
TRAV10,TRAJ47,CVVSLMEYGNKLVF,6,0,1,6
TRAV36DV7,TRAJ39,CAFSPGNAGNMLTF,6,0,1,6
TRAV38-2DV8,TRAJ54,CAYRDLQGAQKLVF,6,0,1,6
TRAV9-2,TRAJ11,CALTTNSGYSTLTF,6,4,2,10
TRAV9-2,TRAJ9,CALSSNTGGFKTIF,6,0,1,6
TRAV20,TRAJ24,CAVRTSDSWGKLQF,6,0,1,6
TRAV20,TRAJ24,CAVRATDSWGKLQF,6,0,1,6
TRAV20,TRAJ9,CAVQAVSGGFKTIF,6,0,1,6
TRAV20,TRAJ20,CAVQAGSKDYKLSF,6,0,1,6
TRAV8-3,TRAJ10,CAVGLTGGGNKLTF,6,0,1,6
TRAV36DV7,TRAJ15,CAVGLNQAGTALIF,6,0,1,6
TRAV2,TRAJ36,CAVEVGAGANNLFF,6,0,1,6
TRAV2,TRAJ6,CAVEKSGGSYIPTF,6,0,1,6
TRAV35,TRAJ17,CAGQLKAAGNKLTF,6,0,1,6
TRAV35,TRAJ41,CAGRDTNSGYALNF,6,30,2,36
TRAV36DV7,TRAJ48,CALISNFGNEKLTF,6,0,1,6
TRAV14DV4,TRAJ52,CALAGGTSYGKLTF,6,0,1,6
TRAV12-2,TRAJ13,CAVFYSGGYQKVTF,6,0,1,6
TRAV12-2,TRAJ20,CAVIFLGNDYKLSF,6,0,1,6
TRAV8-1,TRAJ3,CAVSPYSSASKIIF,6,0,1,6
TRAV12-2,TRAJ36,CAVNSRTGANNLFF,6,12,2,18
TRAV23DV6,TRAJ8,CAALGITGFQKLVF,6,0,1,6
TRAV13-1,TRAJ3,CAAGISSSASKIIF,6,0,1,6
TRAV41,TRAJ57,CAATAQGGPEKLVF,6,0,1,6
TRAV13-1,TRAJ10,CAASFTGGGNKLTF,6,0,1,6
TRAV13-1,TRAJ20,CAASHQLSDYKLSF,6,0,1,6
TRAV13-1,TRAJ29,CAASPNSGNTPLVF,6,0,1,6
TRAV27,TRAJ58,CAGAKETSGSRLTF,6,0,1,6
TRAV5,TRAJ3,CAESTYSSASKIIF,6,0,1,6
TRAV13-2,TRAJ39,CAENSGNAGNMLTF,6,0,1,6
TRAV12-3,TRAJ56,CAMSLSGANSKLTF,6,0,1,6
TRAV12-3,TRAJ11,CAMSWNSGYSTLTF,6,0,1,6
TRAV4,TRAJ15,CLVRSNQAGTALIF,6,0,1,6
TRAV4,TRAJ13,CLVVKSGGYQKVTF,6,0,1,6
TRAV4,TRAJ8,CLVAQNTGFQKLVF,6,0,1,6
TRAV4,TRAJ11,CLVGAPSGYSTLTF,6,2,2,8
TRAV4,TRAJ4,CLVDDPGGYNKLIF,6,0,1,6
TRAV26-1,TRAJ39,RIVRANNAGNMLTF,6,0,1,6
TRAV12-1,TRAJ24,CVVISDSWGKLQF,6,0,1,6
TRAV10,TRAJ15,CVVTGQAGTALIF,6,0,1,6
TRAV10,TRAJ33,CVVSARSNYQLIW,6,0,1,6
TRAV12-1,TRAJ12,CVVKKDSSYKLIF,6,0,1,6
TRAV9-2,TRAJ48,CALNPGGNEKLTF,6,0,1,6
TRAV8-3,TRAJ7,CAVGAYGNNRLAF,6,0,1,6
TRAV8-3,TRAJ44,CAVGAGTASKLTF,6,0,1,6
TRAV36DV7,TRAJ29,CAVGWSGNTPLVF,6,0,1,6
TRAV21,TRAJ30,CAVIYARDDKIIF,6,0,1,6
TRAV12-2,TRAJ36,CAVMQTGANNLFF,6,0,1,6
TRAV3,TRAJ20,CAVRDMRDYKLSF,6,0,1,6
TRAV2,TRAJ33,CAAGRDSNYQLIW,6,0,1,6
TRAV36DV7,TRAJ49,CAATRREGNQFYF,6,0,1,6
TRAV35,TRAJ26,CAGHRNYGQNFVF,6,0,1,6
TRAV23DV6,TRAJ57,CASTQGGSEKLVL,6,0,1,6
TRAV21,TRAJ10,CAVFTGGGNKLTF,9,0,1,9
TRAV12-3,TRAJ33,CAVPGDSNYQLIW,6,0,1,6
TRAV12-2,TRAJ48,CAARNFGNEKLTF,6,0,1,6
TRAV13-1,TRAJ21,CAAARDNFNKFYF,6,0,1,6
TRAV13-1,TRAJ12,CAASMDSSYKLIF,6,0,1,6
TRAV23DV6,TRAJ16,CAASGRDGQKLLF,6,0,1,6
TRAV23DV6,TRAJ34,CAARRSTADKLIF,6,0,1,6
TRAV25,TRAJ8,CAGTGTGFQKLVF,6,0,1,6
TRAV27,TRAJ22,CAGFSGSARQLTF,6,0,1,6
TRAV27,TRAJ27,CAGELPHAGKSTF,6,0,1,6
TRAV13-2,TRAJ48,CAENSFGNEKLTF,6,0,1,6
TRAV12-3,TRAJ48,CAIGSFGNEKLTF,6,0,1,6
TRAV14DV4,TRAJ43,CAMREDANNDMRF,6,0,1,6
TRAV4,TRAJ7,CLVGDHGNNRLAF,6,0,1,6
TRAV38-2DV8,TRAJ56,CSVGGANSKLTF,6,0,1,6
TRAV12-1,TRAJ20,CVVIPNDYKLSF,6,0,1,6
TRAV38-1,TRAJ5,CASTTGRRALTF,6,0,1,6
TRAV16,TRAJ52,CALIVSYGKLTF,6,0,1,6
TRAV22,TRAJ15,CAPHQAGTALIF,6,0,1,6
TRAV8-3,TRAJ5,CAVDTGRRVLTF,6,0,1,6
TRAV20,TRAJ37,CAVRVDTGKLIF,6,0,1,6
TRAV8-3,TRAJ34,CAVGYNTDKLIF,6,0,1,6
TRAV21,TRAJ20,CAARSNDYKLSF,6,0,1,6
TRAV24,TRAJ3,CAFYSSASKIIF,6,0,1,6
TRAV25,TRAJ29,CAPNSGNTPLVF,6,0,1,6
TRAV38-1,TRAJ41,CARSNPGYALNF,6,0,1,6
TRAV20,TRAJ58,CAQETSGSRLTF,6,0,1,6
TRAV8-6,TRAJ53,CAVGGSNYKLTF,6,12,2,18
TRAV6,TRAJ13,CAISGGYQKVTF,6,0,1,6
TRAV13-1,TRAJ26,CAASNYGQNFVF,6,0,1,6
TRAV29DV5,TRAJ54,CAASQGAQKLVF,6,0,1,6
TRAV27,TRAJ11,CAGDPGYSTLTF,6,0,1,6
TRAV27,TRAJ27,CAGRTNAGKSTF,6,0,1,6
TRAV13-2,TRAJ49,CAERQWGNQFYF,6,0,1,6
TRAV13-2,TRAJ12,CAERKSSYKLIF,6,0,1,6
TRAV27,TRAJ58,CKGETSGSRLTF,6,0,1,6
TRAV3,TRAJ39,CASNAGNMLTF,6,0,1,6
TRAV9-2,TRAJ31,CALIVTARLMF,6,0,1,6
TRAV23DV6,TRAJ20,CAFSDDYKLSF,6,0,1,6
TRAV16,TRAJ47,CALQNGNKLVF,6,0,1,6
TRAV12-2,TRAJ20,CAVGYDYKLSF,6,0,1,6
TRAV12-2,TRAJ43,CAVTGNNDMRF,6,0,1,6
TRAV13-1,TRAJ49,CAANSGNQFYF,6,0,1,6
TRAV27,TRAJ29,CAGEGNTPLVF,6,0,1,6
TRAV14DV4,TRAJ16,CAMTDGQKLLF,6,0,1,6
TRAV4,TRAJ24,CPLGSWGKLQF,6,0,1,6
TRAV20,TRAJ22,CAVRPRQLTF,6,0,1,6
TRAV3,TRAJ20,CAVREGKLSF,6,0,1,6
TRAV4,TRAJ3,CLVGASKIIF,6,0,1,6
TRAV16,TRAJ11,PPTLTF,6,0,1,6
TRAV14DV4,TRAJ41,CAMREQQLRNSGYALSF,6,0,1,6
TRAV13-1,TRAJ13,CAASKNSGGYQKVTF,6,0,1,6
TRAV12-3,TRAJ57,CAMSEAQGGSEKLVF,6,0,1,6
TRAV4,TRAJ23,CLVGDAYNQGGKLIF,6,0,1,6
TRAV13-1,TRAJ3,CAASIDSSASKIIF,6,0,1,6
TRAV12-1,TRAJ22,CVVPPGSARLLTF,6,0,1,6
TRAV23DV6,TRAJ47,CAANLEYGNKLVF,6,0,1,6
TRAV13-2,TRAJ5,CAENDTGRRALTF,6,0,1,6
TRAV23DV6,TRAJ31,CAASRGNARLMF,6,0,1,6
TRAV35,TRAJ12,CAGRSSYKLIF,6,0,1,6
TRAV24,TRAJ18,CAPDRGSTLGRLYF,5,0,1,5
TRAV5,TRAJ10,CAETPPRGGNKLTF,5,0,1,5
TRAV12-3,TRAJ44,CAMSKTGTASKLTF,5,0,1,5
TRAV12-1,TRAJ27,CVVILNAGKSTF,5,0,1,5
TRAV12-1,TRAJ37,CVVASNTGKLIF,5,18,2,23
TRAV2,TRAJ16,CAVEDSGRKLLF,5,0,1,5
TRAV25,TRAJ31,CTRNNNARLMF,5,0,1,5
TRAV9-2,TRAJ21,CAPNNFNKFYF,5,0,1,5
TRAV19,TRAJ53,CALSEAHLESGGSNYKLTF,5,0,1,5
TRAV13-1,TRAJ52,CAASNRGNAGGTSYGKLTF,5,0,1,5
TRAV38-2DV8,TRAJ42,CAYRSAQNYGGSQGNLIF,5,0,1,5
TRAV12-3,TRAJ52,CAMRASNAGGTSYGKLTF,5,0,1,5
TRAV14DV4,TRAJ4,CAMREGGYPSGGYNKLIF,5,0,1,5
TRAV12-1,TRAJ52,CVVNVNAGGTSYGKLTF,5,0,1,5
TRAV9-2,TRAJ32,CALSALNYGGATNKLIF,5,0,1,5
TRAV12-2,TRAJ52,CAVNGRAGGTSYGKLTF,5,0,1,5
TRAV13-2,TRAJ42,CAENGGNYGGSQGNLIF,5,0,1,5
TRAV12-3,TRAJ53,CAMGAWNSGGSNYKLTF,5,0,1,5
TRAV12-3,TRAJ28,CAMTAGYSGAGSYQLTF,5,0,1,5
TRAV12-3,TRAJ53,CAMSGGYSGGSNYKLTF,5,0,1,5
TRAV14DV4,TRAJ37,CAMRGLHGSSNTGKLIF,5,0,1,5
TRAV14DV4,TRAJ52,CAMRESAGGTSYGKLTF,5,0,1,5
TRAV4,TRAJ28,CLVGDKYSGAGSYQLTF,5,0,1,5
TRAV4,TRAJ42,CLVGEGLYGGSQGNLIF,5,0,1,5
TRAV38-1,TRAJ26,CAFMKQGYNYGQNFVF,5,0,1,5
TRAV19,TRAJ31,CALSEANGNNNARLMF,5,0,1,5
TRAV20,TRAJ57,CAVRDPSQGGSEKLVF,5,0,1,5
TRAV8-3,TRAJ45,CAVGSYSGGGADGLTF,5,0,1,5
TRAV2,TRAJ22,CAVEVTPSGSARQLTF,5,0,1,5
TRAV3,TRAJ23,CAVRDLDYNQGGKLIF,5,6,2,11
TRAV3,TRAJ38,CAVRDTLAGNNRKLIW,5,0,1,5
TRAV39,TRAJ52,CASSNAGGTSYGKLTF,5,0,1,5
TRAV13-1,TRAJ18,CAATPRRGSTLGRLYF,5,0,1,5
TRAV23DV6,TRAJ53,CAASMNSGGSNYKLTF,5,5,2,10
TRAV14DV4,TRAJ52,CAMREWRGTSYGKLTF,5,0,1,5
TRAV12-3,TRAJ53,CAMNREGGGSNYKLTF,5,0,1,5
TRAV4,TRAJ4,CLVGPRGSGGYNKLIF,5,0,1,5
TRAV4,TRAJ37,CLVGDNGSSNTGKLIF,5,0,1,5
TRAV12-1,TRAJ45,CVVSMAGGGADGLTF,5,0,1,5
TRAV16,TRAJ10,CALSGLTGGGNKLTF,5,0,1,5
TRAV20,TRAJ3,CAVHDVHSSASKIIF,5,0,1,5
TRAV2,TRAJ37,CAVEKGSSNTGKLIF,5,0,1,5
TRAV3,TRAJ6,CAVTIATGGSCIPTF,5,0,1,5
TRAV3,TRAJ29,CAVRDSNSGNTPLVF,5,0,1,5
TRAV3,TRAJ13,CAVRDLSGGYQKVTF,5,0,1,5
TRAV3,TRAJ13,CAVRDGPGGYQKVTF,5,0,1,5
TRAV3,TRAJ4,CAVRDMGGGYNKLIF,5,0,1,5
TRAV3,TRAJ15,CAVRDTHQAGTALIF,5,0,1,5
TRAV3,TRAJ17,CAVRDKGAAGNKLTF,5,0,1,5
TRAV20,TRAJ37,CAALLGSSNTGKLIF,5,0,1,5
TRAV17,TRAJ3,CATAPPYSSASKIIF,5,0,1,5
TRAV8-1,TRAJ6,CAVRLASGGSYIPTF,5,0,1,5
TRAV29DV5,TRAJ54,CAATSSIQGAQKLVF,5,0,1,5
TRAV29DV5,TRAJ29,CAASDFLSGNTPLVF,5,0,1,5
TRAV27,TRAJ53,CAGSNSGGSNYKLTF,5,0,1,5
TRAV5,TRAJ45,CAEAVGGGGADGLTF,5,0,1,5
TRAV5,TRAJ13,CAESRDSGGYQKVTF,5,0,1,5
TRAV12-3,TRAJ37,CAMSFFSSNTGKLIF,5,0,1,5
TRAV14DV4,TRAJ36,CAMREGETGANNLFF,5,0,1,5
TRAV12-3,TRAJ24,CASGGTTDSWGKLQF,5,0,1,5
TRAV4,TRAJ8,CLVGDLRTGFQKLVF,5,0,1,5
TRAV30,TRAJ40,CGTGKSTSGTYKYIF,5,0,1,5
TRAV26-1,TRAJ39,CIVRVENNAGNMLTF,5,0,1,5
TRAV12-1,TRAJ3,CVVLPYSSASKIIF,5,0,1,5
TRAV12-1,TRAJ48,CVVILAFGNEKLTF,5,0,1,5
TRAV12-1,TRAJ3,CVVRIYSSASKIIF,5,0,1,5
TRAV12-1,TRAJ45,CVVNSGGGADGLTF,5,14,2,19
TRAV38-2DV8,TRAJ34,CAYRSAGNTDKLIF,5,0,1,5
TRAV9-2,TRAJ52,CALIGGTSYGKLTF,5,0,1,5
TRAV9-2,TRAJ30,CALSYLNRDDKIIF,5,0,1,5
TRAV9-2,TRAJ38,CALSDRGNNRKLIW,5,13,2,18
TRAV16,TRAJ3,CALTSRSSASKIIF,5,33,2,38
TRAV16,TRAJ39,CALSADNAGNMLTF,5,0,1,5
TRAV16,TRAJ18,CALKGGSTLGRLYF,5,0,1,5
TRAV2,TRAJ8,CAVPMNTGFQKLVF,5,0,1,5
TRAV41,TRAJ47,CAVASMEYGNKLVF,5,0,1,5
TRAV22,TRAJ40,CAVGLTSGTYKYIF,5,0,1,5
TRAV20,TRAJ43,CAVQARGNNNDMRF,5,0,1,5
TRAV8-3,TRAJ28,CAVGPGAGSYQLTF,5,0,1,5
TRAV12-1,TRAJ40,CAVTGTSGTYKYIF,5,0,1,5
TRAV21,TRAJ50,CAAPGRASYDKVIF,5,0,1,5
TRAV35,TRAJ48,CAGRSNFGNEKLTF,5,0,1,5
TRAV35,TRAJ42,CAGQDGGSQGNLIF,5,0,1,5
TRAV17,TRAJ6,CATVLSGGSYIPTF,5,4,2,9
TRAV17,TRAJ9,CATAPSGGGFKTIF,5,0,1,5
TRAV24,TRAJ6,CAFRGSGGSYIPTF,5,0,1,5
TRAV24,TRAJ50,CAFNGKTSYDKVIF,5,0,1,5
TRAV12-2,TRAJ49,CAPRGGNTGNQFYF,5,0,1,5
TRAV12-2,TRAJ50,CAVGPQTSYDKVIF,5,0,1,5
TRAV12-2,TRAJ48,CAVISNFGNEKLTF,5,0,1,5
TRAV12-2,TRAJ33,CAVRDPDSNYQLIW,5,0,1,5
TRAV12-2,TRAJ13,CAVKSRGGYQKVTF,5,0,1,5
TRAV12-2,TRAJ9,CAVKLLTGGFKTIF,5,0,1,5
TRAV13-1,TRAJ38,CAPSNGGNNRKLIW,5,0,1,5
TRAV13-1,TRAJ29,CAAPGRSGNTPLVF,5,0,1,5
TRAV29DV5,TRAJ50,CAATSKTSYDKVIF,5,0,1,5
TRAV13-1,TRAJ40,CAASPASGTYKYIF,5,0,1,5
TRAV13-1,TRAJ6,CAASEGGGSYIPTF,5,0,1,5
TRAV13-1,TRAJ29,CAASRFAGNTPLVF,5,0,1,5
TRAV23DV6,TRAJ12,CAASSGDSSCKLIF,5,0,1,5
TRAV27,TRAJ50,CAGERGASYDKVIF,5,0,1,5
TRAV27,TRAJ24,CAGEDSDGWGKLQF,5,0,1,5
TRAV5,TRAJ37,CAEFGSSNTGKLIF,5,0,1,5
TRAV5,TRAJ8,CAEDLNTGFQKLVF,5,0,1,5
TRAV13-2,TRAJ15,CAETLNQAGTALIF,5,0,1,5
TRAV5,TRAJ39,CAESLNNAGNMLTF,5,0,1,5
TRAV5,TRAJ13,CAERPSGGYQKVTF,5,0,1,5
TRAV13-2,TRAJ23,CAEKWSHQGGKLIF,5,4,2,9
TRAV12-3,TRAJ53,CAIHSGGSNYKLTS,5,0,1,5
TRAV14DV4,TRAJ11,CAMRIPSGYSTLTF,5,0,1,5
TRAV34,TRAJ40,CGADNRSGTYKYIF,5,0,1,5
TRAV4,TRAJ7,CLVPPTHGNNRLAF,5,0,1,5
TRAV4,TRAJ11,CLVASNSGYSTLTF,5,0,1,5
TRAV21,TRAJ57,CAVRTQGGSEKLVF,5,3,2,8
TRAV12-1,TRAJ5,CVVKDTGRRALTF,5,0,1,5
TRAV10,TRAJ33,CVVLKDSNYQLIW,5,0,1,5
TRAV38-2DV8,TRAJ49,CAYRRRTGNQFYF,5,0,1,5
TRAV9-2,TRAJ30,CALSARRDDKIIF,5,0,1,5
TRAV6,TRAJ34,CALAGYNTDKLIF,5,0,1,5
TRAV6,TRAJ9,CALGETGGFKTIF,5,0,1,5
TRAV16,TRAJ34,CALSPGNTDKLIF,5,0,1,5
TRAV16,TRAJ12,CALRGDSSYKLIF,5,0,1,5
TRAV17,TRAJ30,CAPRRMGDDKIIF,5,0,1,5
TRAV3,TRAJ4,CAVFSGGYNKLIF,5,0,1,5
TRAV22,TRAJ6,CAVLSGGSYIPTF,5,3,2,8
TRAV20,TRAJ48,CAVRGFGNEKLTF,5,0,1,5
TRAV20,TRAJ38,CAVQAGNNRKLIW,5,0,1,5
TRAV20,TRAJ47,CAVQAPYGNKLVF,5,0,1,5
TRAV22,TRAJ17,CAVVLAAGNKLTL,5,0,1,5
TRAV8-3,TRAJ11,CAVGGQGYSTLTF,5,0,1,5
TRAV8-3,TRAJ13,CAVGGLPGQKVTF,5,0,1,5
TRAV8-3,TRAJ49,CAVGRVTGNQFYF,5,0,1,5
TRAV2,TRAJ6,CAVEKGGSYIPTF,5,0,1,5
TRAV12-2,TRAJ40,CAVITSGTYKYIF,5,0,1,5
TRAV21,TRAJ58,CAVTETSGSRLTF,5,0,1,5
TRAV3,TRAJ34,CAVSRYNTDKLIF,5,0,1,5
TRAV3,TRAJ43,CAVRGWDNNDMRF,5,0,1,5
TRAV3,TRAJ20,CAVRDGNDYKLSF,5,7,2,12
TRAV36DV7,TRAJ31,CAGPLNNNARLMF,5,0,1,5
TRAV35,TRAJ49,CAGEPNTGNQFYF,5,0,1,5
TRAV17,TRAJ39,CATEDNAGNMLTF,5,0,1,5
TRAV12-2,TRAJ37,CASLSSNTGKLIF,5,0,1,5
TRAV41,TRAJ58,CALHRTSGSRLTF,5,0,1,5
TRAV12-2,TRAJ20,CAVIRSNDYKLSF,5,0,1,5
TRAV12-2,TRAJ34,CAVRLYNTDKLIF,5,0,1,5
TRAV12-2,TRAJ22,CAVTSGSARQLTF,5,0,1,5
TRAV25,TRAJ23,CAGHYNQGGKLIF,5,0,1,5
TRAV12-3,TRAJ34,CASRSYNTDKLIF,5,0,1,5
TRAV39,TRAJ13,CASNSGGYQKVTF,5,0,1,5
TRAV12-3,TRAJ22,CACSSGSARQLTF,5,0,1,5
TRAV13-1,TRAJ15,CAALNQAGTALIF,5,0,1,5
TRAV13-1,TRAJ4,CAAPSGGYNKLIF,5,0,1,5
TRAV13-1,TRAJ40,CAAQDPGTYKYIF,5,0,1,5
TRAV23DV6,TRAJ57,CAATQGGSEKLVF,5,0,1,5
TRAV23DV6,TRAJ15,CAATSRAGTALIF,5,4,2,9
TRAV13-1,TRAJ47,CAATMEYGNKLVF,5,0,1,5
TRAV13-1,TRAJ45,CAASGGGADGLTF,5,0,1,5
TRAV13-1,TRAJ40,CAASITGTYKYIF,5,0,1,5
TRAV13-1,TRAJ9,CAASKTGGFKTIF,5,0,1,5
TRAV23DV6,TRAJ21,CAASRGNFNKFYF,5,0,1,5
TRAV27,TRAJ35,CAGSIGFGNVLHC,5,0,1,5
TRAV25,TRAJ29,CAGRRPGNTPLVF,5,0,1,5
TRAV25,TRAJ27,CAGINTNAGKSTF,5,0,1,5
TRAV25,TRAJ39,CAGRDNAGNMLTF,5,0,1,5
TRAV5,TRAJ5,CAESIAGRRALTF,5,0,1,5
TRAV14DV4,TRAJ39,CAMRGNAGNMLTF,5,0,1,5
TRAV4,TRAJ17,CLVGDGGGNKLTF,5,0,1,5
TRAV4,TRAJ23,CLVDFNQGGKLIF,5,0,1,5
TRAV4,TRAJ27,CLAEGTNAGKSTF,5,0,1,5
TRAV26-1,TRAJ43,CIVRSYNNNDMRF,5,0,1,5
TRAV26-1,TRAJ41,CIDHSNSGYALNF,5,0,1,5
TRAV12-3,TRAJ3,YAMSGSSASKIIF,5,0,1,5
TRAV12-1,TRAJ34,CVVNTYTDKLIF,5,0,1,5
TRAV21,TRAJ8,CASHTGFQKLVF,5,0,1,5
TRAV9-2,TRAJ26,CALLDYGQSFVF,5,0,1,5
TRAV9-2,TRAJ5,CALGRGRRALTF,5,0,1,5
TRAV9-2,TRAJ47,CALSGGGNKLVF,5,0,1,5
TRAV20,TRAJ16,CAVLDGGQKLLF,5,0,1,5
TRAV2,TRAJ49,CAVSNTGNQFYF,5,2,2,7
TRAV2,TRAJ9,CAVFTGGFKTIF,5,0,1,5
TRAV8-3,TRAJ39,CAVGNAGNMLTF,5,0,1,5
TRAV21,TRAJ45,CAVGGGADGLTF,5,5,2,10
TRAV22,TRAJ30,CAVDVADDKIIF,5,0,1,5
TRAV8-6,TRAJ21,CAVSAPFNKFYF,5,0,1,5
TRAV3,TRAJ33,CAVRYSNYQLIW,5,0,1,5
TRAV22,TRAJ26,CAAAARGQNFVF,5,0,1,5
TRAV35,TRAJ48,CAGDFGNEKLTF,5,0,1,5
TRAV13-1,TRAJ48,CAFHFGNEKLTF,5,0,1,5
TRAV23DV6,TRAJ5,CASGTGRRALTF,5,0,1,5
TRAV41,TRAJ54,CALRRGAQKLVF,5,0,1,5
TRAV6,TRAJ39,CAPLEAGNMLTF,5,0,1,5
TRAV39,TRAJ47,CAVDIWGNKLVF,5,0,1,5
TRAV13-1,TRAJ37,CAAPLDTGKLIF,5,0,1,5
TRAV39,TRAJ27,CAAALLGGKSTF,5,0,1,5
TRAV23DV6,TRAJ34,CAASYNTDKLIF,5,0,1,5
TRAV27,TRAJ34,CAGDPNTDKLIF,5,0,1,5
TRAV27,TRAJ7,CAGARGNNRLAF,5,0,1,5
TRAV14DV4,TRAJ31,CAMWGIRARLMF,5,0,1,5
TRAV14DV4,TRAJ12,CAMRAGSYKLIF,5,0,1,5
TRAV14DV4,TRAJ27,CAMRDRAGKSTF,5,0,1,5
TRAV14DV4,TRAJ49,CAMREYGNQFYF,5,0,1,5
TRAV26-2,TRAJ9,CILNTGGFKTIF,5,0,1,5
TRAV26-2,TRAJ47,CILRGYGNKLVF,5,0,1,5
TRAV12-1,TRAJ20,CAVGGDYKLSF,5,0,1,5
TRAV22,TRAJ33,CAVDTNYQLIW,5,0,1,5
TRAV2,TRAJ20,CAVEDDYKFSF,5,0,1,5
TRAV21,TRAJ16,CAVRGGQKLLF,5,0,1,5
TRAV20,TRAJ43,CAVNNNNDMRF,5,0,1,5
TRAV21,TRAJ40,CAAGGTYKYIF,5,0,1,5
TRAV35,TRAJ43,CAGSNNNDMRF,5,0,1,5
TRAV12-2,TRAJ16,CAPSDGQKLLF,5,0,1,5
TRAV13-1,TRAJ13,CAPGGYQKVTF,5,0,1,5
TRAV25,TRAJ43,CAPKRNNDMRF,5,0,1,5
TRAV13-1,TRAJ33,CAADSNYQLIW,5,4,2,9
TRAV13-1,TRAJ30,CAARRDDKIIF,5,0,1,5
TRAV13-2,TRAJ52,CAENIPPKLTF,5,0,1,5
TRAV4,TRAJ49,CLGTFGNQFYF,5,0,1,5
TRAV26-1,TRAJ43,CIVRVLGDMRF,5,0,1,5
TRAV38-2DV8,TRAJ43,CAPPPRDMRF,5,0,1,5
TRAV2,TRAJ34,CAVRTDKLIF,5,0,1,5
TRAV13-1,TRAJ20,CAANDYKLSF,10,7,2,17
TRAV24,TRAJ58,CALGGSRLTF,5,0,1,5
TRAV13-1,TRAJ30,CAAPKGKIIF,5,0,1,5
TRAV4,TRAJ20,CPSDYKLSF,5,0,1,5
TRAV34,TRAJ21,CAGAVTHF,5,0,1,5
TRAV38-1,TRAJ52,CAFMKRLRAGGTSYGKLTF,4,0,1,4
TRAV5,TRAJ38,CAETPPAHNAGNNRKLIW,4,15,2,19
TRAV26-2,TRAJ53,CILRDEWRSGGSNYKLTF,4,0,1,4
TRAV12-1,TRAJ37,CVVNLPRSSSNTGKLIF,4,0,1,4
TRAV16,TRAJ53,CALRALNSGGSNYKLTF,4,0,1,4
TRAV41,TRAJ57,CAVTHLGAQGGSEKLVF,4,0,1,4
TRAV41,TRAJ58,CAVRYWALETSGSRLTF,4,0,1,4
TRAV22,TRAJ18,CAVGAADRGSTLGRLYF,4,0,1,4
TRAV3,TRAJ36,CAVRPREGRTGANNLFF,4,0,1,4
TRAV24,TRAJ38,CAFIWSGNAGNNRKLIW,4,0,1,4
TRAV29DV5,TRAJ37,CAATMLYGSSNTGKLIF,4,0,1,4
TRAV14DV4,TRAJ12,CAMREGGEKGSSYKLIF,4,0,1,4
TRAV4,TRAJ32,CLVGDINYGGATNKLIF,4,0,1,4
TRAV26-1,TRAJ42,CIVRVGPYGGSQGNLIF,4,0,1,4
TRAV26-1,TRAJ48,CIVRVDPSNFGNEKLTF,4,0,1,4
TRAV12-1,TRAJ23,CVVDLHPYNQGGKLIF,4,0,1,4
TRAV12-1,TRAJ37,CVVSRLGSSNTGKLIF,4,0,1,4
TRAV38-2DV8,TRAJ32,CAYRSNYGGATNKLIF,4,0,1,4
TRAV38-2DV8,TRAJ26,CAYRSGDRNYGQNFVF,4,0,1,4
TRAV19,TRAJ4,CALWIRGSGGYNKLIF,4,0,1,4
TRAV3,TRAJ37,CAVRDIGSSNTGKLIF,4,0,1,4
TRAV3,TRAJ26,CAVRDKADNYGQNFVF,4,0,1,4
TRAV12-2,TRAJ45,CAAGMYSGGGADGLTF,4,0,1,4
TRAV8-1,TRAJ3,CAVNDPRDSSASKIIF,4,0,1,4
TRAV12-2,TRAJ52,CAVNISGGTSYGKLTF,4,0,1,4
TRAV8-1,TRAJ40,CAVKGEGTSGTYKYIF,4,0,1,4
TRAV13-1,TRAJ52,CAATLWRGTSYGKLTF,4,0,1,4
TRAV23DV6,TRAJ52,CAASGAGGTSYGKLTF,4,0,1,4
TRAV29DV5,TRAJ53,CAARGNSGGSNYKLTF,4,0,1,4
TRAV13-1,TRAJ40,CAAKAPSTSGTYKYIL,4,0,1,4
TRAV27,TRAJ20,CAGAVAPRASWETLSF,4,8,2,12
TRAV5,TRAJ44,CAESISPSGTASKLTF,4,0,1,4
TRAV12-3,TRAJ22,CAMSPVEAGSARQLTF,4,0,1,4
TRAV14DV4,TRAJ15,CAMRVAGGQAGTALIF,4,0,1,4
TRAV14DV4,TRAJ4,CAMREVFSGGYNKLIF,4,0,1,4
TRAV14DV4,TRAJ6,CAMREGPAGGSYIPTF,4,0,1,4
TRAV4,TRAJ42,CLFLGDYGGSQGNLIF,4,0,1,4
TRAV26-2,TRAJ13,CILRDMNSGGYQKVTF,4,0,1,4
TRAV26-1,TRAJ40,CIVRVGTTSGTYKYIF,4,5,2,9
TRAV12-1,TRAJ18,CVVLDRGSTLGRPYF,4,0,1,4
TRAV10,TRAJ15,CVVTSFNQAGTALIF,4,0,1,4
TRAV10,TRAJ46,CVVSWKKSSGDKLTF,4,0,1,4
TRAV12-1,TRAJ13,CVVNVNSGGYQKVTF,4,0,1,4
TRAV12-1,TRAJ41,CVVNTLSNSGYALNF,4,0,1,4
TRAV9-2,TRAJ7,CALRLPYYGNNRLAF,4,0,1,4
TRAV9-2,TRAJ44,CALSDLTGTASKLTF,4,0,1,4
TRAV9-2,TRAJ48,CALSKSNFGNEKLTF,4,0,1,4
TRAV9-2,TRAJ53,CALRNSGGSNYKLTF,4,0,1,4
TRAV16,TRAJ37,CALHHGSSNTGKLIF,4,0,1,4
TRAV16,TRAJ57,CALSPTQGGSEKLVF,4,0,1,4
TRAV16,TRAJ26,CALKLGDNYGQNFVF,4,0,1,4
TRAV23DV6,TRAJ50,CAVVRMKTSYDKVIF,4,0,1,4
TRAV20,TRAJ17,CAVQAVEAAGNKLTF,4,0,1,4
TRAV20,TRAJ18,CAVQERGSTLGRLYF,4,0,1,4
TRAV8-3,TRAJ13,CAVGAGSGGYQKVTF,4,0,1,4
TRAV8-3,TRAJ4,CAVGPVSGGYNKLIF,4,0,1,4
TRAV2,TRAJ36,CAVEWIPTGANNLFF,4,0,1,4
TRAV12-2,TRAJ42,CAVTTSGGSQGNLIF,4,0,1,4
TRAV8-3,TRAJ27,CAVSPYNTNAGKSTF,4,0,1,4
TRAV3,TRAJ44,CAVRDDTGTASKLTF,4,0,1,4
TRAV3,TRAJ21,CAVRDILYNFNKFYF,4,12,2,16
TRAV3,TRAJ18,CAVRDRGSTLGRLYF,4,17,2,21
TRAV12-2,TRAJ18,CALCGGGSTLGRLYF,4,0,1,4
TRAV8-1,TRAJ37,CAVIPGSSNTGKLIF,4,0,1,4
TRAV12-2,TRAJ13,CAVNSWDGGYQKVTF,4,2,2,6
TRAV12-2,TRAJ38,CAVNMYAGNNRKLIW,4,0,1,4
TRAV12-2,TRAJ20,CAVNTPFPNDYKLSF,4,0,1,4
TRAV14DV4,TRAJ12,CAMRGPMDSSYKLIF,4,0,1,4
TRAV13-1,TRAJ24,CAASIKSDSWGKLQF,4,0,1,4
TRAV23DV6,TRAJ13,CAASLQTGGYQKVTF,4,0,1,4
TRAV13-1,TRAJ26,CAASPFHNYGQNFVF,4,0,1,4
TRAV29DV5,TRAJ45,CAASATGGGADGLTF,4,0,1,4
TRAV29DV5,TRAJ52,CAASGSGTSYGKLTF,4,0,1,4
TRAV29DV5,TRAJ58,CAASGGETSGSRLTF,4,0,1,4
TRAV23DV6,TRAJ34,CAASKDPPNTDKLIF,4,0,1,4
TRAV23DV6,TRAJ40,CAARDVQAGTYKYIF,4,0,1,4
TRAV13-2,TRAJ32,CAETTPFGATNKLIF,4,0,1,4
TRAV13-2,TRAJ49,CAETGAKGTGNQFYF,4,0,1,4
TRAV13-2,TRAJ4,CAENGFSGGYNKLIF,4,0,1,4
TRAV13-2,TRAJ45,CAENESGGGADGLTF,4,0,1,4
TRAV14DV4,TRAJ41,CAMRSISNSGYALNF,4,0,1,4
TRAV14DV4,TRAJ22,CAMRGFSGSARQLTF,4,0,1,4
TRAV14DV4,TRAJ9,CAMREGPGGGFKTIF,4,6,2,10
TRAV14DV4,TRAJ53,CAMREGGGSNYKLTF,4,0,1,4
TRAV4,TRAJ3,CLVAPEESSASKIIF,4,0,1,4
TRAV4,TRAJ48,CLVGDYNFGNEKLTF,4,0,1,4
TRAV4,TRAJ9,CLVGDPYTGGFKTIF,4,27,2,31
TRAV4,TRAJ41,CLVGDMTGSGYALNF,4,0,1,4
TRAV4,TRAJ4,CLVGVISGGYNKLIF,4,0,1,4
TRAV26-2,TRAJ49,CILRDEEGTGNQFYF,4,0,1,4
TRAV26-2,TRAJ3,CILREEYSSASKIIF,4,0,1,4
TRAV26-1,TRAJ32,CIVRAKGGATNKLIF,4,0,1,4
TRAV12-1,TRAJ7,CVVTIRYGNNRLAF,4,0,1,4
TRAV12-1,TRAJ9,CVVNFGTGGFKTIF,4,0,1,4
TRAV12-1,TRAJ21,CVVNEGNNFNKFYF,4,0,1,4
TRAV9-2,TRAJ48,CALMRDFGNEKLTF,4,0,1,4
TRAV9-2,TRAJ42,CALTLGRSQGNLIF,4,0,1,4
TRAV9-2,TRAJ16,CALSDGTDGQKLLF,4,0,1,4
TRAV19,TRAJ12,CALSERDSSYKLIF,4,0,1,4
TRAV6,TRAJ6,CALEDTGGSYIPTF,4,0,1,4
TRAV16,TRAJ15,CALTSIQAGTALIF,4,0,1,4
TRAV16,TRAJ57,CAPCTQGGSERLVF,4,3,2,7
TRAV8-3,TRAJ39,CAVLNNNAGNMLTF,4,0,1,4
TRAV12-2,TRAJ45,CAVDSGGGADGLTF,4,0,1,4
TRAV20,TRAJ15,CAVRDNQAGTALIF,4,0,1,4
TRAV20,TRAJ26,CAVQARNYGQNFVF,4,0,1,4
TRAV20,TRAJ20,CAVQAPSNDYKLSF,4,0,1,4
TRAV22,TRAJ11,CAVVDGSGYSTLTF,4,0,1,4
TRAV8-3,TRAJ40,CAVVTTSGTYKYIF,4,0,1,4
TRAV8-3,TRAJ4,CAVALSGGYNKLIF,4,0,1,4
TRAV8-3,TRAJ6,CAVGAEGGSYIPTF,4,0,1,4
TRAV8-3,TRAJ42,CAVGKGGSQGNLIF,4,0,1,4
TRAV22,TRAJ45,CAVGAGGGTDGLTF,4,0,1,4
TRAV36DV7,TRAJ26,CAVEPDNYGQNFVF,4,0,1,4
TRAV2,TRAJ13,CAVEDWGGYQKVTF,4,0,1,4
TRAV3,TRAJ40,CAVSSFSGTYKYIF,4,0,1,4
TRAV35,TRAJ42,CAGLPGGSQGNLIF,4,0,1,4
TRAV12-2,TRAJ52,CAVLGGTSYGKLTF,4,0,1,4
TRAV12-2,TRAJ33,CAVMNRDSNYQLIW,4,0,1,4
TRAV8-1,TRAJ28,CAVSTGAGSYQLTF,4,0,1,4
TRAV8-1,TRAJ9,CAVNAYTGGFKTIF,4,0,1,4
TRAV12-2,TRAJ33,CAVNFRDSNYQLIW,4,0,1,4
TRAV12-2,TRAJ10,CAVNGAGGGNKLTF,4,0,1,4
TRAV12-2,TRAJ27,CAVNTHTNAGKSTF,4,0,1,4
TRAV12-2,TRAJ49,CAVNKRNTGNQFYF,4,0,1,4
TRAV13-1,TRAJ15,CAPTANQAGTALIF,4,3,2,7
TRAV23DV6,TRAJ13,CAARRAGGYQKVTF,4,0,1,4
TRAV13-1,TRAJ6,CAAAPLRGSYIPTF,4,0,1,4
TRAV23DV6,TRAJ21,CAALTTGNFNKFYF,4,0,1,4
TRAV13-1,TRAJ42,CAASWGGSQGNLIF,4,0,1,4
TRAV13-1,TRAJ7,CAASYGYGNNRLAF,4,0,1,4
TRAV23DV6,TRAJ47,CAASSMEYGNKLVF,4,0,1,4
TRAV29DV5,TRAJ39,CAASENNAGNMLTF,4,0,1,4
TRAV36DV7,TRAJ53,CAGGSGGSNYKLTF,4,3,2,7
TRAV27,TRAJ18,CAGGRGSTLGRLYF,4,2,2,6
TRAV27,TRAJ40,CAGARASGTYKYIF,4,0,1,4
TRAV5,TRAJ34,CAEPGDYNTDKLIF,4,0,1,4
TRAV5,TRAJ9,CAETFGTGGFKTIF,4,0,1,4
TRAV12-3,TRAJ5,CAMAGDTGRRALTF,4,0,1,4
TRAV12-3,TRAJ10,CAMSFTGGGNKLTF,4,0,1,4
TRAV12-3,TRAJ6,CAMSAGGGSYIPTF,4,0,1,4
TRAV12-3,TRAJ27,CAMSDGTNAGKSTF,4,0,1,4
TRAV14DV4,TRAJ30,CAMREPNRDDKIIF,4,0,1,4
TRAV14DV4,TRAJ29,CAMREFQGNTPLVF,4,0,1,4
TRAV4,TRAJ40,CLVGVASGTYKYIF,4,0,1,4
TRAV4,TRAJ22,CLVGGLGSARQLTF,4,0,1,4
TRAV4,TRAJ43,CLVGDPLPYNDMRF,4,0,1,4
TRAV26-2,TRAJ48,CILTPPFGNEKLTF,4,0,1,4
TRAV26-1,TRAJ39,CIVRGDNAGNMLTL,4,0,1,4
TRAV26-1,TRAJ29,CIVRPHSGNTPLVF,4,0,1,4
TRAV26-1,TRAJ40,CIVRASSGTYKYIF,4,0,1,4
TRAV12-1,TRAJ49,CVVDTNTGNQFYF,4,0,1,4
TRAV12-1,TRAJ21,CVVNLYNFNKFYF,4,0,1,4
TRAV12-1,TRAJ37,CVVNPSNTGKLIF,4,0,1,4
TRAV38-1,TRAJ43,CAFMKGNNNDMRF,4,0,1,4
TRAV38-2DV8,TRAJ44,CAYRTGTASKLTF,4,0,1,4
TRAV16,TRAJ40,CALLTSGTYKYIF,4,0,1,4
TRAV9-2,TRAJ23,CALVYNQGGKLIF,4,0,1,4
TRAV9-2,TRAJ49,CALGLFTGNQFYF,4,0,1,4
TRAV16,TRAJ16,CALGLSDGQKLLF,4,0,1,4
TRAV9-2,TRAJ27,CALNPTHAGKSTF,4,0,1,4
TRAV12-2,TRAJ10,CAVFTGGGNKLTL,4,0,1,4
TRAV3,TRAJ20,CAVLSSNDYKLSF,4,0,1,4
TRAV21,TRAJ48,CAVPDFGNEKLTF,4,0,1,4
TRAV20,TRAJ8,CAVQSRGFQKLVF,4,0,1,4
TRAV20,TRAJ17,CAVVEAAGNKLTF,4,0,1,4
TRAV20,TRAJ12,CAVGLDSSYKLIF,4,0,1,4
TRAV8-3,TRAJ7,CAVGNYGNNRLAF,4,0,1,4
TRAV2,TRAJ47,CAVEVLYGNKLVF,4,0,1,4
TRAV2,TRAJ16,CAVEGPDGQKLLF,4,0,1,4
TRAV2,TRAJ13,CAVEDRGYQKVTF,4,0,1,4
TRAV21,TRAJ35,CAVMIGFGNVLHC,4,0,1,4
TRAV12-3,TRAJ50,CAVTKTSYDKVIF,4,0,1,4
TRAV21,TRAJ33,CAVTGDSNYQLIW,4,0,1,4
TRAV3,TRAJ29,CAVRDSGNTPLVF,4,0,1,4
TRAV3,TRAJ12,CAVRDDSSYKLIF,4,0,1,4
TRAV3,TRAJ43,CAVRDDNNNDMRF,4,0,1,4
TRAV21,TRAJ44,CAVKAGTASKLTF,4,0,1,4
TRAV12-2,TRAJ39,CAGNNNAGNMLTF,4,0,1,4
TRAV24,TRAJ34,CAFHPWNTDKLIF,4,0,1,4
TRAV24,TRAJ39,CAFTGNAGNMLTF,4,0,1,4
TRAV24,TRAJ12,CAFAMDSSYKLIF,4,0,1,4
TRAV12-2,TRAJ27,CAVGDTNAGKSTF,4,0,1,4
TRAV12-2,TRAJ30,CAVTSNRDDKIIF,4,0,1,4
TRAV12-2,TRAJ47,CAVTPSYGNKLVF,4,0,1,4
TRAV12-2,TRAJ53,CAVKRGSNYKLTF,4,0,1,4
TRAV12-2,TRAJ22,CAALSGSARQLTF,4,0,1,4
TRAV12-2,TRAJ32,CAIHGGATNKLIF,4,0,1,4
TRAV25,TRAJ26,CAGPDNYGQNFVF,4,0,1,4
TRAV12-3,TRAJ28,CAASGAGSYQLTF,4,0,1,4
TRAV29DV5,TRAJ54,CAASVPGAQKLVF,4,0,1,4
TRAV29DV5,TRAJ21,CAASEENFNKFYF,4,0,1,4
TRAV23DV6,TRAJ48,CAARSFGNEKLTF,4,0,1,4
TRAV27,TRAJ20,CAGTDSNDYKLSF,4,6,2,10
TRAV5,TRAJ16,CAEKGSDGQKLLF,4,0,1,4
TRAV14DV4,TRAJ16,CAMSSTDGQKLLF,4,0,1,4
TRAV12-3,TRAJ43,CAMSAEDNNDMRF,4,0,1,4
TRAV12-3,TRAJ9,CAMSGSGGFKTIF,4,0,1,4
TRAV12-3,TRAJ58,CAMSETSGSRLTF,4,0,1,4
TRAV12-3,TRAJ23,CAMSRNQGGKLIF,4,0,1,4
TRAV14DV4,TRAJ12,CAMNVDSSYKLIF,4,30,2,34
TRAV12-2,TRAJ50,CTVNRILYDKVIF,4,0,1,4
TRAV4,TRAJ13,CLVGDRGYQKVTF,4,0,1,4
TRAV4,TRAJ4,CLVGDRGYNKLIF,4,5,2,9
TRAV4,TRAJ8,CLVGNTGFQKLVF,4,0,1,4
TRAV26-1,TRAJ31,CIVPRNNNARLMF,4,36,2,40
TRAV12-1,TRAJ30,CVVEQGGDKIIF,4,0,1,4
TRAV12-1,TRAJ7,CVVNGGNNRLAF,4,0,1,4
TRAV13-1,TRAJ45,CVAGGGADGLTF,4,0,1,4
TRAV38-2DV8,TRAJ34,CAYRGNTDKLIF,4,0,1,4
TRAV16,TRAJ48,CALLGGNEKLTF,4,0,1,4
TRAV9-2,TRAJ26,CALDNYGQNFVF,4,0,1,4
TRAV2,TRAJ20,CAVHSNDYKLSF,4,0,1,4
TRAV21,TRAJ22,CAVYGSARQLTF,4,0,1,4
TRAV41,TRAJ54,CAVRPGAQKLVF,4,0,1,4
TRAV22,TRAJ27,CAVGTNAGKSTF,4,0,1,4
TRAV36DV7,TRAJ57,CAVEPLSEKLVF,4,0,1,4
TRAV2,TRAJ8,CAVEEGFQKLVF,4,0,1,4
TRAV3,TRAJ7,CAVREWDNRLAF,4,0,1,4
TRAV12-2,TRAJ36,CAVNAGANNLFF,4,0,1,4
TRAV34,TRAJ35,CAAIGFGNVLHC,4,0,1,4
TRAV12-2,TRAJ31,CATLNNNARLMF,4,0,1,4
TRAV17,TRAJ5,CATDTGRRALTF,4,11,2,15
TRAV24,TRAJ9,CAFRTGGFKTIF,4,0,1,4
TRAV2,TRAJ23,CAVYNQGGKLIF,4,3,2,7
TRAV12-2,TRAJ20,CAVNFNDYKLSF,4,0,1,4
TRAV12-2,TRAJ49,CAVNEFGNQFYF,4,0,1,4
TRAV12-3,TRAJ13,CAPGWGYQKVTF,4,0,1,4
TRAV13-1,TRAJ49,CAVTPSGNQFYF,4,0,1,4
TRAV5,TRAJ41,CAVSNSGYALNF,4,0,1,4
TRAV13-1,TRAJ40,CAAQSRTYKYIF,4,0,1,4
TRAV13-1,TRAJ27,CAAIENAGKSTF,4,0,1,4
TRAV13-1,TRAJ12,CAASTSSYKLIF,4,0,1,4
TRAV13-1,TRAJ16,CAASKDGQKLLF,4,0,1,4
TRAV23DV6,TRAJ49,CAASSSGNQFYF,4,0,1,4
TRAV29DV5,TRAJ43,CAASRGGNDMRF,4,0,1,4
TRAV29DV5,TRAJ34,CAASVGTDKLIF,4,0,1,4
TRAV29DV5,TRAJ20,CAASANDYKLSF,4,0,1,4
TRAV27,TRAJ34,CAGRYNTDKLIF,4,0,1,4
TRAV25,TRAJ54,CAGCRGAQKLVF,4,0,1,4
TRAV25,TRAJ13,CAESGGYQKVTF,4,0,1,4
TRAV13-2,TRAJ20,CAENRSDYKLSF,4,0,1,4
TRAV12-3,TRAJ54,CAMAQGAQKLVF,4,0,1,4
TRAV12-3,TRAJ23,CAMGLQGGKLIF,4,0,1,4
TRAV12-3,TRAJ3,CAMDSSASKIIF,4,0,1,4
TRAV12-3,TRAJ50,CAMKTSYDKVIF,4,0,1,4
TRAV12-3,TRAJ43,CAIGRNNNDMRF,4,0,1,4
TRAV34,TRAJ57,CGAKGGSEKLVF,4,0,1,4
TRAV4,TRAJ34,CLVGYNTDKLIF,4,0,1,4
TRAV23DV6,TRAJ37,CHKRSNTGKLIF,4,0,1,4
TRAV8-3,TRAJ50,VTSETSYDKVIF,4,0,1,4
TRAV13-2,TRAJ32,SAGGATNKLIF,4,0,1,4
TRAV38-1,TRAJ54,CAFPGAQKLVF,4,0,1,4
TRAV12-3,TRAJ9,CALDGGFKTIF,4,0,1,4
TRAV36DV7,TRAJ57,CAQGGSEKLVF,4,0,1,4
TRAV21,TRAJ20,CAVRNDYKLSF,4,2,2,6
TRAV20,TRAJ43,CAVGNNNDMRF,4,0,1,4
TRAV21,TRAJ43,CAGYNNNDMRF,4,3,2,7
TRAV22,TRAJ43,CAGHNNNDMRF,4,0,1,4
TRAV17,TRAJ43,CATDGVNDMRF,4,0,1,4
TRAV17,TRAJ43,CATDINNDMRF,4,0,1,4
TRAV17,TRAJ20,CATDSDYKLSF,4,0,1,4
TRAV12-2,TRAJ37,CAVSNTGKLIF,4,5,2,9
TRAV12-2,TRAJ26,CAVNSGQNFVF,4,0,1,4
TRAV13-1,TRAJ5,CAVTPGRALTF,4,0,1,4
TRAV25,TRAJ9,CAAPGGFKTIF,4,0,1,4
TRAV13-1,TRAJ34,CAASSTDKLIF,4,0,1,4
TRAV12-3,TRAJ43,CAMSPAEDMRF,4,0,1,4
TRAV4,TRAJ30,CLVGPRDKIIF,4,0,1,4
TRAV9-2,TRAJ43,CALSVDDMRF,4,0,1,4
TRAV36DV7,TRAJ43,CAVDDNDMRF,4,0,1,4
TRAV12-2,TRAJ31,CAVRAARLMF,4,0,1,4
TRAV35,TRAJ43,CAGREYDMRF,4,0,1,4
TRAV13-2,TRAJ22,CAEAARQLTF,4,0,1,4
TRAV39,TRAJ32,CAVENKLIF,4,0,1,4
TRAV3,TRAJ15,CRAGTALIF,4,0,1,4
TRAV25,TRAJ23,WGKLIF,4,0,1,4
TRAV8-2,TRAJ32,CVVSDGYGGATSKLIF,4,0,1,4
TRAV21,TRAJ52,CAAHNAGGASYGKLTF,4,0,1,4
TRAV13-1,TRAJ27,CAASTGTNAGKSTF,4,0,1,4
TRAV41,TRAJ32,CAVGGGPTNKLIF,4,0,1,4
TRAV13-2,TRAJ45,CAEKGGGADGLTF,4,0,1,4
TRAV38-2DV8,TRAJ57,CAYRIPIITQGGSEKLVF,3,0,1,3
TRAV41,TRAJ52,CAVSGTDAGGTSYGKLTF,3,0,1,3
TRAV3,TRAJ45,CAVRALMYSGGGADGLTF,3,0,1,3
TRAV12-2,TRAJ18,CAVNKEADRGSTLGRLYF,3,0,1,3
TRAV29DV5,TRAJ45,CAATQTEYSGGGADGLTF,3,0,1,3
TRAV25,TRAJ28,CAGSSPPYSGAGSYQLTF,3,0,1,3
TRAV14DV4,TRAJ56,CAMREVTYYTGANSKLTF,3,10,2,13
TRAV10,TRAJ18,CVVSSADRGSTLGRLYF,3,0,1,3
TRAV38-1,TRAJ40,CAFMSTISTSGTYKYIF,3,0,1,3
TRAV38-1,TRAJ38,CAFTFPVNAGNNRKLIW,3,0,1,3
TRAV3,TRAJ18,CAVRDMYRGSTLGRLYF,3,0,1,3
TRAV12-2,TRAJ42,CAVNMGQYGGSQGNLIF,3,0,1,3
TRAV12-2,TRAJ48,CAVKGRISNFGNEKLTF,3,0,1,3
TRAV29DV5,TRAJ42,CAASGAYYGGSQGNLIF,3,0,1,3
TRAV13-1,TRAJ13,CAANPPPESGGYQKVTF,3,0,1,3
TRAV13-2,TRAJ45,CAENIGNSGGGADGLTF,3,0,1,3
TRAV12-3,TRAJ37,CAMSASHGSSNAGKLIF,3,0,1,3
TRAV14DV4,TRAJ10,CAMRELQLTGGGNKLTF,3,0,1,3
TRAV34,TRAJ45,CGADKIAVGGGADGLTF,3,0,1,3
TRAV4,TRAJ37,CLVGDHYGSSNTGKLIF,3,0,1,3
TRAV4,TRAJ17,CLVGDMAVKAAGNKLTF,3,0,1,3
TRAV4,TRAJ39,CLVGDRYTNNAGNMLTF,3,0,1,3
TRAV12-1,TRAJ48,CVVSRGSNFGNEKLTL,3,0,1,3
TRAV38-2DV8,TRAJ37,CAYGPRGSSNTGKLIF,3,8,2,11
TRAV38-2DV8,TRAJ45,CAYRWYSGGGADGLTF,3,0,1,3
TRAV38-2DV8,TRAJ40,CAYRSASTSGTYKYIF,3,0,1,3
TRAV9-1,TRAJ16,CALSGPRFSDGQKLLF,3,0,1,3
TRAV9-2,TRAJ42,CALSLNYGGSQGNLIF,3,0,1,3
TRAV9-2,TRAJ52,CALRGAGGTSYGKLTF,3,0,1,3
TRAV21,TRAJ45,CAVPMYSGGGADGLTF,3,5,2,8
TRAV8-3,TRAJ16,CAVAAVSFSDGQKLLF,3,0,1,3
TRAV8-3,TRAJ42,CAVGALPGGSQGNLIF,3,0,1,3
TRAV36DV7,TRAJ28,CAVEGYSGAGSYQLTF,3,0,1,3
TRAV2,TRAJ37,CAVEDWGSSNTGKLIF,3,0,1,3
TRAV3,TRAJ38,CAVSLPNAGNNRKLIW,3,3,2,6
TRAV21,TRAJ45,CAVRMYSGGGADGLTF,3,0,1,3
TRAV3,TRAJ4,CAVRDSISGGYNKLIF,3,0,1,3
TRAV3,TRAJ4,CAVRDVFSGGYNKLIF,3,0,1,3
TRAV3,TRAJ40,CAVRDMSASGTYKYIF,3,0,1,3
TRAV3,TRAJ20,CAVRDTPLSNDYKLSF,3,0,1,3
TRAV35,TRAJ53,CAGQLGSGGSNYKLTF,3,0,1,3
TRAV39,TRAJ57,CAVDSYTQGGSEKLVF,3,0,1,3
TRAV12-2,TRAJ10,CAVRGRLTGGGNKLTF,3,0,1,3
TRAV13-1,TRAJ15,CAADEGANQAGTALIF,3,0,1,3
TRAV29DV5,TRAJ53,CAASSNSGGSNYKLTF,3,0,1,3
TRAV25,TRAJ52,CAGVGAGGTSYGKLTF,3,0,1,3
TRAV5,TRAJ42,CAEGGNYGGSQGNLIF,3,0,1,3
TRAV5,TRAJ44,CAESPLREGTASKLTF,3,0,1,3
TRAV13-2,TRAJ28,CAENLMPGAGSYQLTF,3,0,1,3
TRAV14DV4,TRAJ22,CAMSHWDSGSARQLTF,3,0,1,3
TRAV14DV4,TRAJ49,CAMREGGRGTGNQFYF,3,0,1,3
TRAV14DV4,TRAJ26,CAMREGGDNYGQNFVF,3,0,1,3
TRAV4,TRAJ44,CLVGEVNTGTASKLTF,3,0,1,3
TRAV26-1,TRAJ44,CIVRVVRPGTASKLTF,3,0,1,3
TRAV26-1,TRAJ13,CIVRVEDSGGYQKVTF,3,0,1,3
TRAV26-1,TRAJ53,CIVRASSGGSNYKLTF,3,0,1,3
TRAV10,TRAJ13,CVVSPNSGGYQKVTF,3,0,1,3
TRAV12-1,TRAJ32,CVVNLYGGATNELIF,3,0,1,3
TRAV38-2DV8,TRAJ28,CASVHSGAGSYQLTF,3,0,1,3
TRAV38-2DV8,TRAJ28,CAYRTSGAGSYQLTF,3,0,1,3
TRAV29DV5,TRAJ54,CALTPNLQGAQKLVF,3,0,1,3
TRAV9-2,TRAJ22,CALSALSGSARQLTF,3,0,1,3
TRAV9-2,TRAJ44,CALSDAPGTASKLTF,3,0,1,3
TRAV9-2,TRAJ54,CALSEVIQGAQKLVF,3,0,1,3
TRAV41,TRAJ54,CAVFPIIQGAQKLVF,3,0,1,3
TRAV21,TRAJ53,CAVPYSGGSNYKLTF,3,0,1,3
TRAV21,TRAJ28,CAVSYSGAGSYQLTF,3,0,1,3
TRAV41,TRAJ22,CAVRISSGSARQLTF,3,4,2,7
TRAV20,TRAJ42,CAVRGYGGSQGNLIF,3,0,1,3
TRAV20,TRAJ4,CAVQLFSGGYNKLIF,3,0,1,3
TRAV20,TRAJ13,CAVQAGSGGYQKVTF,3,0,1,3
TRAV20,TRAJ21,CAVQDEGYNFNKFYF,3,21,2,24
TRAV8-3,TRAJ22,CAVVSTSGSARQLTF,3,0,1,3
TRAV8-3,TRAJ17,CAVGSYGAAGNKLTF,3,0,1,3
TRAV8-3,TRAJ10,CAVGAWKGGGNKLTF,3,0,1,3
TRAV8-3,TRAJ39,CAVGAQNNAGNMLTF,3,0,1,3
TRAV8-3,TRAJ42,CAVGGYGGSQGNLIF,3,0,1,3
TRAV2,TRAJ29,CAVESPYSGNTPLVF,3,0,1,3
TRAV2,TRAJ39,CAVEDENNAGNMLTF,3,0,1,3
TRAV8-6,TRAJ12,CAVSVAMDSSYKLIF,3,0,1,3
TRAV21,TRAJ6,CAVRPPSGGSYIPTF,3,0,1,3
TRAV20,TRAJ39,CAVKSPNNAGNMLTF,3,0,1,3
TRAV8-3,TRAJ38,CAAGAEAGNNRKLIW,3,0,1,3
TRAV35,TRAJ42,CAGPNYGGSQGNLIF,3,0,1,3
TRAV17,TRAJ37,CATGHGSSNTGKLIF,3,0,1,3
TRAV17,TRAJ45,CATDLSGGGADGLTF,3,0,1,3
TRAV12-2,TRAJ37,CAVTGGSSNTGKLIF,3,0,1,3
TRAV8-1,TRAJ40,CAVNAQDSGTYKYIF,3,0,1,3
TRAV12-2,TRAJ48,CAVNRPNFGNEKLTF,3,0,1,3
TRAV12-2,TRAJ42,CAARGAGGSQGNLIF,3,0,1,3
TRAV13-1,TRAJ13,CAASMTSGGYQKVTL,3,0,1,3
TRAV13-1,TRAJ36,CAASSAVAGANNLFF,3,0,1,3
TRAV13-1,TRAJ48,CAANPPNFGNEKLTF,3,0,1,3
TRAV25,TRAJ37,CAGPFGSSNTGKLIF,3,0,1,3
TRAV27,TRAJ53,CAGENSGGSNYKLTF,3,0,1,3
TRAV27,TRAJ53,CAGAYRGGSNYKLTF,3,0,1,3
TRAV13-2,TRAJ10,CAEISLTGGGNKLTF,3,0,1,3
TRAV13-2,TRAJ3,CAENIGYSSASKIIF,3,0,1,3
TRAV14DV4,TRAJ9,CAMREANTGGFKTIF,3,0,1,3
TRAV14DV4,TRAJ6,CAMREGGGGSYIPTF,3,0,1,3
TRAV23DV6,TRAJ10,CATSILTGGGNKLTF,3,0,1,3
TRAV4,TRAJ3,CLVGAKYSSASKIIF,3,0,1,3
TRAV4,TRAJ16,CLVGDRFSDGQKLLF,3,0,1,3
TRAV26-2,TRAJ22,CILRGLSGSARQLTF,3,0,1,3
TRAV26-1,TRAJ23,CIVRVGNNQGGKLIF,3,0,1,3
TRAV26-1,TRAJ48,CIVRVGNFGNEKLTF,3,0,1,3
TRAV8-2,TRAJ13,CVVSYSGGYQKVTF,3,4,2,7
TRAV36DV7,TRAJ31,CVISDRNNNARLMF,3,0,1,3
TRAV12-1,TRAJ10,CVVILTGGGNKLTF,3,0,1,3
TRAV12-1,TRAJ23,CVVTPYNQGGKLIF,3,0,1,3
TRAV10,TRAJ15,CVVSAWQAGTALIF,3,7,2,10
TRAV12-1,TRAJ4,CVVRGSGGYNKLIF,3,11,2,14
TRAV12-1,TRAJ3,CVVRRGSSASKIIF,3,9,2,12
TRAV12-1,TRAJ4,CVVNPAGGYNKLIF,3,0,1,3
TRAV38-2DV8,TRAJ39,CAFMGYGAGNMLTF,3,0,1,3
TRAV38-2DV8,TRAJ53,CAFPSGGSNYKLTF,3,0,1,3
TRAV17,TRAJ50,CASYKKTSYDKVIF,3,3,2,6
TRAV9-2,TRAJ28,CALTSGAGSYHLTF,3,0,1,3
TRAV9-2,TRAJ15,CALSFNQAGTALIF,3,0,1,3
TRAV9-2,TRAJ20,CALSLIRNDYKLSF,3,0,1,3
TRAV19,TRAJ34,CALSEPHNTDKLIF,3,0,1,3
TRAV9-2,TRAJ39,CALSTNNAGNMLTF,3,0,1,3
TRAV19,TRAJ40,CALRFRNGTYKYIF,3,0,1,3
TRAV16,TRAJ15,CALSGSQAGTALIF,3,0,1,3
TRAV9-2,TRAJ35,CAPCRGGFGNVLHC,3,0,1,3
TRAV2,TRAJ23,CAVLIYNQGGKLIF,3,0,1,3
TRAV8-3,TRAJ10,CAVLLTGGGNKLTF,3,0,1,3
TRAV41,TRAJ45,CAVRLGGGADGLTF,3,0,1,3
TRAV8-3,TRAJ30,CAVVPMNRDDKIIF,3,4,2,7
TRAV2,TRAJ5,CAVAADTGRRALTF,3,0,1,3
TRAV8-3,TRAJ40,CAVGSAAGTYKYIF,3,0,1,3
TRAV8-3,TRAJ9,CAVGALDGGFKTIF,3,0,1,3
TRAV2,TRAJ23,CAVGGYNQGGKLIF,3,0,1,3
TRAV22,TRAJ56,CAVGVTGANSKLTF,3,0,1,3
TRAV21,TRAJ37,CAVDGSSNTGKLIF,3,0,1,3
TRAV36DV7,TRAJ40,CAVERYSGTYKYIF,3,0,1,3
TRAV2,TRAJ9,CAVEDPTGGFKTIF,3,0,1,3
TRAV2,TRAJ6,CAVEEGGGSYIPTF,3,0,1,3
TRAV3,TRAJ3,CAVTRYSSASKIIF,3,0,1,3
TRAV8-4,TRAJ48,CAVTTIFGNEKLTF,3,0,1,3
TRAV8-4,TRAJ4,CAVSFSGGYNKLIF,3,0,1,3
TRAV3,TRAJ36,CAVRDQTGANNLFF,3,0,1,3
TRAV3,TRAJ22,CAVRDRGSARQLTF,3,0,1,3
TRAV3,TRAJ41,CAVRDNYSGYALNF,3,0,1,3
TRAV3,TRAJ3,CAALSEGSASKIIF,3,0,1,3
TRAV41,TRAJ42,CAARSEGSQGNLIF,3,0,1,3
TRAV22,TRAJ53,CAAGAGGSNYKLTF,3,0,1,3
TRAV17,TRAJ43,CATDAIVNNNDMRF,3,0,1,3
TRAV12-2,TRAJ17,CAPMIKAAGNKLTF,3,0,1,3
TRAV36DV7,TRAJ57,CARLTQGGSEKLVF,3,0,1,3
TRAV39,TRAJ40,CAVAGTSGTYKYIF,3,0,1,3
TRAV12-2,TRAJ50,CAVIIETSYDKVIF,3,0,1,3
TRAV12-2,TRAJ15,CAVKSLQAGTALIF,3,0,1,3
TRAV12-2,TRAJ27,CAVKGHTNAGKSTF,3,0,1,3
TRAV12-2,TRAJ10,CAAPRSGGGNKLTF,3,0,1,3
TRAV12-2,TRAJ40,CAATGVSGTYKCIF,3,0,1,3
TRAV20,TRAJ22,CALWWGGSARQLTF,3,0,1,3
TRAV13-2,TRAJ54,CASPVYGGAQKLVF,3,0,1,3
TRAV25,TRAJ42,CAVSDGGSQGNLIF,3,0,1,3
TRAV23DV6,TRAJ13,CAASRSGGYQKVTF,3,0,1,3
TRAV13-1,TRAJ45,CAAPQGGGADGLTF,3,0,1,3
TRAV23DV6,TRAJ10,CAATPTGGGNKLTF,3,0,1,3
TRAV13-1,TRAJ48,CAALSNFGNEKLTF,3,0,1,3
TRAV13-1,TRAJ15,CAATLNQAGTALIF,3,0,1,3
TRAV29DV5,TRAJ54,CAATPGQGAQKLVF,3,0,1,3
TRAV29DV5,TRAJ43,CAATELHNNNDMRF,3,0,1,3
TRAV13-1,TRAJ48,CAASPVFGNEKLTF,3,0,1,3
TRAV13-1,TRAJ57,CAASNVGGSEKLVF,3,0,1,3
TRAV21,TRAJ4,CAASLSGGYNKLIF,3,0,1,3
TRAV29DV5,TRAJ40,CAASAISGTYKYIF,3,0,1,3
TRAV29DV5,TRAJ27,CAASGRTNAGKSTF,3,0,1,3
TRAV29DV5,TRAJ45,CAASEGGGADGLTF,3,0,1,3
TRAV13-1,TRAJ13,CAARYSGGYQKVTF,3,9,2,12
TRAV23DV6,TRAJ26,CAAKTGNYGQNFVF,3,0,1,3
TRAV27,TRAJ22,CAGAIRGSARQLTF,3,0,1,3
TRAV13-2,TRAJ4,CAERSSGGYNKLIF,3,0,1,3
TRAV5,TRAJ41,CAERFVNSGYALNF,3,35,2,38
TRAV13-2,TRAJ6,CAENPSGGSYIPTF,3,0,1,3
TRAV13-2,TRAJ6,CAENIAGGSYIPTF,3,0,1,3
TRAV12-3,TRAJ18,CAMDRGSTLGRLYF,3,0,1,3
TRAV12-3,TRAJ12,CAMSPMDSSYKLIF,3,0,1,3
TRAV12-3,TRAJ50,CAMSAKTSYDKVIF,3,0,1,3
TRAV14DV4,TRAJ42,CAMRPGGSQGNLIF,3,0,1,3
TRAV14DV4,TRAJ35,CAMRGLGFGNVLHC,3,0,1,3
TRAV14DV4,TRAJ7,CAMRTPYGNIRLAF,3,0,1,3
TRAV12-3,TRAJ32,CATRNGGATNKLIF,3,0,1,3
TRAV4,TRAJ29,CLVVGPLGNTPLVF,3,0,1,3
TRAV4,TRAJ17,CLVGVITAGNKLTF,3,0,1,3
TRAV4,TRAJ13,CLVGDRGGYQKVTF,3,0,1,3
TRAV4,TRAJ40,CLVGTGSGTYKYIF,3,0,1,3
TRAV4,TRAJ3,CLVGEYSSASKIIF,3,0,1,3
TRAV26-2,TRAJ45,CIPRSGGGADGLTF,3,0,1,3
TRAV12-1,TRAJ35,CVVDIGFGNVLHC,3,0,1,3
TRAV10,TRAJ40,CVVIGSGTYKYIF,3,0,1,3
TRAV39,TRAJ48,CVVRPFGNEKLTF,3,0,1,3
TRAV12-1,TRAJ42,CVVNGGSQGNLII,3,0,1,3
TRAV12-1,TRAJ24,CVVNKSSWGKLQF,3,0,1,3
TRAV12-1,TRAJ43,CVVKAYNNNDMRF,3,0,1,3
TRAV10,TRAJ52,CVVGGTSYGKLTF,3,0,1,3
TRAV38-2DV8,TRAJ20,CAYRSAGDYKLSF,3,0,1,3
TRAV16,TRAJ35,CALGGGFGNVLHC,3,0,1,3
TRAV19,TRAJ40,CALTTSGTYKYIF,3,0,1,3
TRAV9-2,TRAJ31,CALGRNNNARLMF,3,0,1,3
TRAV9-2,TRAJ20,CALTVSNDYKLSF,3,0,1,3
TRAV9-2,TRAJ35,CALSEGFGNVLHC,3,0,1,3
TRAV9-2,TRAJ50,CALRTTSYDKVIF,3,0,1,3
TRAV16,TRAJ11,CALTNSGYSTLTF,3,0,1,3
TRAV16,TRAJ5,CALRGTGRRALTF,3,0,1,3
TRAV6,TRAJ29,CAPLNSGNTPLVF,3,0,1,3
TRAV9-2,TRAJ5,CAPMDTGRRALTF,3,0,1,3
TRAV38-2DV8,TRAJ29,CARADSGNTPLVF,3,0,1,3
TRAV12-2,TRAJ38,CAVYAGNNRKLIW,3,0,1,3
TRAV41,TRAJ43,CAVLPYNNNDMRF,3,0,1,3
TRAV21,TRAJ15,CAVLNQAGTALIF,3,0,1,3
TRAV3,TRAJ9,CAVLNTGGFKTIF,3,0,1,3
TRAV21,TRAJ49,CAVYGRAGNQFYF,3,18,2,21
TRAV20,TRAJ36,CAVQAAGANNLFF,3,0,1,3
TRAV20,TRAJ6,CAVQSGGSYIPTF,3,0,1,3
TRAV8-3,TRAJ6,CAVGAGGSYIPTF,3,2,2,5
TRAV8-3,TRAJ24,CAVGEILWGKLQF,3,0,1,3
TRAV2,TRAJ13,CAVGSGGYQKVTF,3,0,1,3
TRAV20,TRAJ5,CAVGRTGRRALTF,3,0,1,3
TRAV2,TRAJ15,CAVESQAGTALIF,3,0,1,3
TRAV21,TRAJ40,CAVEGSGTYKYIF,3,0,1,3
TRAV12-2,TRAJ58,CAVEETSGSRLTF,3,0,1,3
TRAV3,TRAJ40,CAVSPSGTYKYIF,3,0,1,3
TRAV12-2,TRAJ38,CAVRAGNNRKLIW,5,0,1,5
TRAV3,TRAJ11,CAVRAPGYSTLTF,3,0,1,3
TRAV3,TRAJ8,CAVRDIRFQKLAL,3,0,1,3
TRAV20,TRAJ15,CAVTNQAGTALIF,3,0,1,3
TRAV21,TRAJ39,CAASNNAGNMLTF,3,0,1,3
TRAV8-6,TRAJ33,CAAGMDSNYQLIW,3,0,1,3
TRAV21,TRAJ20,CAALYSNDYKLSF,3,0,1,3
TRAV12-2,TRAJ57,CAGAQGGSEKLVF,3,0,1,3
TRAV2,TRAJ38,CAGGAGNNRKLIW,3,0,1,3
TRAV17,TRAJ17,CATVKAAGNKLTF,3,0,1,3
TRAV17,TRAJ17,CATIKAAGNKLTF,3,0,1,3
TRAV8-3,TRAJ27,CASLYPNAGKSTF,3,0,1,3
TRAV3,TRAJ37,CAVDSSNTGKLIF,3,0,1,3
TRAV12-2,TRAJ34,CAVQSYNTDKLIF,3,0,1,3
TRAV12-2,TRAJ43,CAVELRGNNDMRF,3,0,1,3
TRAV12-2,TRAJ11,CAVNRVMDSTLTF,3,0,1,3
TRAV21,TRAJ26,CACETDYGQNFVF,3,0,1,3
TRAV27,TRAJ33,CAGVMDSNYQLIW,3,0,1,3
TRAV27,TRAJ22,CADFSGSARQLTF,3,0,1,3
TRAV5,TRAJ13,CAVHSGGYQKVTF,3,0,1,3
TRAV12-3,TRAJ10,CAAHTGGGNKLTF,3,0,1,3
TRAV23DV6,TRAJ40,CAAGPSGTYKYIF,3,0,1,3
TRAV29DV5,TRAJ37,CAASYGNTGKLIF,3,0,1,3
TRAV23DV6,TRAJ37,CAARRENTGKLIF,3,0,1,3
TRAV13-1,TRAJ17,CAASSAAGNKLTF,3,0,1,3
TRAV13-1,TRAJ9,CAASEAGGFKTIF,3,0,1,3
TRAV13-1,TRAJ26,CAASMGYGQNFVF,3,0,1,3
TRAV29DV5,TRAJ53,CAASGRSNYKLTF,3,0,1,3
TRAV23DV6,TRAJ29,CAASMIRNTPLVF,3,0,1,3
TRAV13-1,TRAJ9,CAARNTGGFKTIF,3,0,1,3
TRAV13-1,TRAJ8,CAARNTGFQKLVF,3,0,1,3
TRAV27,TRAJ37,CAGLPSNTGKLIF,3,0,1,3
TRAV25,TRAJ40,CAGPSSGTYKYIF,3,0,1,3
TRAV25,TRAJ34,CAGTHIGTDKLIF,3,0,1,3
TRAV27,TRAJ33,CAGPLDSNYQLIW,3,0,1,3
TRAV27,TRAJ37,CAGESGNTGKLIF,3,0,1,3
TRAV5,TRAJ15,CAERGQAGTALIF,3,0,1,3
TRAV13-2,TRAJ11,CAENYSGYSTLTF,3,0,1,3
TRAV13-2,TRAJ21,CAENMNNFNKFYF,3,0,1,3
TRAV13-2,TRAJ6,CAENIGGSYIPTF,3,0,1,3
TRAV12-3,TRAJ24,CAMGKGSWGKLQF,3,0,1,3
TRAV12-3,TRAJ37,CAMDSSNTGELIF,3,0,1,3
TRAV12-3,TRAJ9,CAMMATGGFKTIF,3,0,1,3
TRAV12-3,TRAJ40,CAMSVGGTYKNIF,3,0,1,3
TRAV12-3,TRAJ21,CAMSAGNFNKFYF,3,0,1,3
TRAV12-3,TRAJ17,CAMRKAAGNKLTF,3,0,1,3
TRAV14DV4,TRAJ21,CAMRVGDFNKFYF,3,0,1,3
TRAV12-3,TRAJ7,CATSVYGNNRLAF,3,0,1,3
TRAV4,TRAJ5,CLVVATGRRALTF,3,0,1,3
TRAV4,TRAJ9,CLVGVNGGFKTIF,3,0,1,3
TRAV4,TRAJ26,CLVGDNYGQNFVF,3,0,1,3
TRAV4,TRAJ34,CLVGDRYTDKLIF,3,0,1,3
TRAV4,TRAJ21,CLVGDSYFNKFYF,3,0,1,3
TRAV30,TRAJ28,CGTLRAGSYQLTF,3,0,1,3
TRAV30,TRAJ15,CGTSNQAGTALIF,3,4,2,7
TRAV26-2,TRAJ40,CILTTSGTYKYIF,3,0,1,3
TRAV26-2,TRAJ56,CILLSGANSKLTF,3,0,1,3
TRAV26-2,TRAJ37,CILRKGNTGKLIF,3,0,1,3
TRAV38-1,TRAJ43,CAFMKGSNDMRF,3,0,1,3
TRAV8-3,TRAJ9,CALGTGGFKTIF,3,0,1,3
TRAV6,TRAJ11,CALPSGYSTLTF,3,0,1,3
TRAV9-2,TRAJ26,CALSLYGQNFVF,3,0,1,3
TRAV6,TRAJ49,CALDLGGNQFYF,3,0,1,3
TRAV6,TRAJ33,CALETSNYQLIW,3,0,1,3
TRAV3,TRAJ24,CAPADSWGKLQL,3,0,1,3
TRAV9-2,TRAJ31,CAPRNNNARLMF,3,0,1,3
TRAV2,TRAJ5,CAVDTGRRALTF,3,0,1,3
TRAV2,TRAJ27,CAVRLNAGKTTF,3,0,1,3
TRAV3,TRAJ20,CAVRSNDYKLSF,3,0,1,3
TRAV20,TRAJ30,CAVQAGDDKIIF,3,0,1,3
TRAV20,TRAJ34,CAVQGDTDKLIF,3,0,1,3
TRAV8-3,TRAJ26,CAVENYGQNFVF,3,0,1,3
TRAV22,TRAJ21,CAVIYNFNKFYF,3,0,1,3
TRAV3,TRAJ34,CAVRGKTEKLIF,3,0,1,3
TRAV17,TRAJ29,CATASGNTPLVF,3,0,1,3
TRAV17,TRAJ20,CATDGNDYKLSF,3,0,1,3
TRAV17,TRAJ29,CATELGNTPLVF,3,14,2,17
TRAV24,TRAJ26,CAFNNYGQNFVF,3,0,1,3
TRAV2,TRAJ36,CAPLTGANNLFF,3,0,1,3
TRAV24,TRAJ42,CARERSQGNLIF,3,0,1,3
TRAV39,TRAJ48,CAVLFGNEKLTF,3,0,1,3
TRAV12-2,TRAJ39,CAVIWAGNMLTF,3,0,1,3
TRAV12-2,TRAJ43,CAVIPNNNDMRF,3,0,1,3
TRAV2,TRAJ6,CAASGGSYIPTF,3,0,1,3
TRAV13-1,TRAJ9,CAAPTGGFKTIF,3,0,1,3
TRAV29DV5,TRAJ43,CAANGNNNDMRF,3,0,1,3
TRAV13-1,TRAJ44,CAAAGTASKLTF,3,0,1,3
TRAV13-1,TRAJ6,CAALRGSYVPTF,3,0,1,3
TRAV13-1,TRAJ39,CAASGAGNMLTF,3,0,1,3
TRAV13-1,TRAJ31,CAATINNARLMF,3,0,1,3
TRAV13-1,TRAJ9,CAASTGGFKTIF,3,0,1,3
TRAV27,TRAJ7,CAGFYGNNRLAF,3,0,1,3
TRAV25,TRAJ48,CAGNFGNEKLTF,3,3,2,6
TRAV5,TRAJ20,CAEAANDYKLSF,3,0,1,3
TRAV13-2,TRAJ10,CAEGGGGNKLTF,3,0,1,3
TRAV14DV4,TRAJ37,CAMVGNTGKLIF,3,0,1,3
TRAV12-3,TRAJ34,CAMTEHTDKLIF,3,0,1,3
TRAV12-3,TRAJ49,CAMSVAGNQFYF,3,0,1,3
TRAV25,TRAJ18,CGRGSTLGRLYF,3,0,1,3
TRAV4,TRAJ21,CLVGDNFNKFYF,3,0,1,3
TRAV26-2,TRAJ36,CIPNTGANNLFF,3,0,1,3
TRAV26-1,TRAJ12,CIVADSSYKLIF,3,0,1,3
TRAV26-1,TRAJ43,CIVRVANNDMRF,3,0,1,3
TRAV26-1,TRAJ52,CTGGTSYGKLTF,3,20,2,23
TRAV6,TRAJ23,CALAQGGKLIF,3,0,1,3
TRAV16,TRAJ8,CALRGFQKLVF,3,0,1,3
TRAV41,TRAJ49,CAVFTGNQFYF,3,0,1,3
TRAV2,TRAJ24,CAVVFWGKLQF,3,0,1,3
TRAV12-3,TRAJ49,CAVDTGNQFYF,3,0,1,3
TRAV12-2,TRAJ20,CAVIKDYKLSF,3,0,1,3
TRAV12-1,TRAJ47,CAAEYGNKLVF,3,0,1,3
TRAV20,TRAJ43,CAAYNNNDMRF,3,0,1,3
TRAV12-2,TRAJ6,CAAGGSYIPTF,3,0,1,3
TRAV24,TRAJ49,CAPNTGNQFYF,3,2,2,5
TRAV39,TRAJ15,CAVDTGTALIF,3,0,1,3
TRAV12-2,TRAJ49,CAVNRGNQFYF,3,0,1,3
TRAV39,TRAJ12,CAADSSYKLIF,3,0,1,3
TRAV23DV6,TRAJ34,CAASHTDKLIF,3,0,1,3
TRAV25,TRAJ43,CAGPDNNDMRF,3,0,1,3
TRAV25,TRAJ21,CAGRNFNKFYF,3,0,1,3
TRAV27,TRAJ49,CAGVSGNQFYF,3,17,2,20
TRAV12-3,TRAJ20,CAMSSDYKLSF,3,0,1,3
TRAV12-3,TRAJ56,CATGANSKLTF,3,0,1,3
TRAV4,TRAJ8,CLVGGFQKLVF,3,0,1,3
TRAV26-1,TRAJ34,CIAPLGDKLIF,3,0,1,3
TRAV13-1,TRAJ39,CVWAGNMLTF,3,0,1,3
TRAV9-2,TRAJ9,CALSGFKTIF,3,0,1,3
TRAV3,TRAJ30,CARAGDKIIF,3,0,1,3
TRAV12-2,TRAJ20,CAVRNYKLSF,3,0,1,3
TRAV12-2,TRAJ28,CASGSYQLTF,3,0,1,3
TRAV29DV5,TRAJ37,CAADTGKLIF,3,0,1,3
TRAV13-1,TRAJ47,CAASRHKLVF,3,3,2,6
TRAV29DV5,TRAJ49,CAASGNQFYF,3,0,1,3
TRAV25,TRAJ34,CAGPSDKLIF,3,0,1,3
TRAV25,TRAJ20,CAGTDYKLSF,3,0,1,3
TRAV25,TRAJ31,CADNNARLMF,3,12,2,15
TRAV25,TRAJ11,CADRYSTLTF,3,0,1,3
TRAV14DV4,TRAJ34,CAMITDKLIF,3,0,1,3
TRAV23DV6,TRAJ49,CEVTGNQFYF,3,0,1,3
TRAV4,TRAJ27,CLVVAGKSTF,3,0,1,3
TRAV26-2,TRAJ40,CISGTYKYIF,3,0,1,3
TRAV23DV6,TRAJ43,CAVNNDMRF,3,0,1,3
TRAV12-2,TRAJ29,CAVNTPLVF,3,0,1,3
TRAV12-2,TRAJ43,CAVNYDMRF,3,0,1,3
TRAV16,TRAJ20,CAQGDKLSF,3,0,1,3
TRAV12-3,TRAJ49,CAMRNQFYF,3,0,1,3
TRAV12-1,TRAJ23,ALGGGKLIF,3,0,1,3
TRAV21,TRAJ22,CFSRQLTF,3,0,1,3
TRAV38-1,TRAJ52,CAFMKHESYGGTSYGKLTF,2,0,1,2
TRAV14DV4,TRAJ52,CAMSPSHAAGGTSYGKLTF,2,0,1,2
TRAV9-2,TRAJ54,CALSDSPYPGQGAQKLVF,2,0,1,2
TRAV9-2,TRAJ42,CALSDRWGYGGSQGNLIF,2,0,1,2
TRAV38-1,TRAJ30,CAFMKQTIMNRDDKIIF,2,0,1,2
TRAV38-2DV8,TRAJ45,CAYRSSYSGGGADGLTF,2,0,1,2
TRAV36DV7,TRAJ42,CAVEAEDYGGSQGNLIF,2,6,2,8
TRAV2,TRAJ39,CAVEDRHNNNAGNMLTF,2,0,1,2
TRAV12-2,TRAJ39,CAVNIRPSNNAGNMLTF,2,0,1,2
TRAV13-1,TRAJ45,CAASIYGSGGGADGLTF,2,0,1,2
TRAV13-1,TRAJ53,CAASSGNSGGSNYKLTF,2,0,1,2
TRAV23DV6,TRAJ22,CAASRDGTSGSARQLTF,2,0,1,2
TRAV27,TRAJ32,CAGASFLGGGATNKLIF,2,0,1,2
TRAV27,TRAJ37,CAGDRPKGSSNTGKLIF,2,0,1,2
TRAV12-3,TRAJ52,CAMSANAGGTSYGKLTF,2,0,1,2
TRAV12-1,TRAJ37,CVVTSPLSSNTGKLIF,2,0,1,2
TRAV10,TRAJ20,CVVSLALVVNDYKLSF,2,0,1,2
TRAV38-2DV8,TRAJ41,CAYRRADPNSGYALNF,2,0,1,2
TRAV9-2,TRAJ9,CALYPTRNTGGFKTIF,2,0,1,2
TRAV9-2,TRAJ52,CALILAGGTSYGKLTF,2,0,1,2
TRAV9-2,TRAJ10,CALIPILTGGGNKLTF,2,0,1,2
TRAV29DV5,TRAJ44,CALSFINTGTASKLTF,2,0,1,2
TRAV9-2,TRAJ32,CALRGGVEGATNKLIF,2,0,1,2
TRAV6,TRAJ38,CALGSPNAGNNRKLIW,2,0,1,2
TRAV41,TRAJ42,CAVVMNYGGSQGNLIF,2,0,1,2
TRAV8-3,TRAJ10,CAVGDSLTGGGNKLTF,2,0,1,2
TRAV8-4,TRAJ38,CAVSGLGAGNNRKLIW,2,0,1,2
TRAV8-4,TRAJ52,CAVSLLGGTSYGKLTF,2,0,1,2
TRAV12-2,TRAJ42,CAVSIDYGGSQGNLIF,2,0,1,2
TRAV8-4,TRAJ48,CAVRSPSNFGNEKLTF,2,0,1,2
TRAV41,TRAJ45,CAAAVPSGGGADGLTF,2,0,1,2
TRAV17,TRAJ22,CATLPGSSGSARQLTF,2,0,1,2
TRAV17,TRAJ18,CATDSRRGSTLGRLYF,2,0,1,2
TRAV9-2,TRAJ22,CALIRISSGSARQLAF,2,0,1,2
TRAV12-2,TRAJ52,CAVGNAGGTSYGKLTF,2,0,1,2
TRAV14DV4,TRAJ50,CAVRESSKTSYDKVIF,2,0,1,2
TRAV13-1,TRAJ42,CAASNAYGGSQGNLIF,2,0,1,2
TRAV13-2,TRAJ52,CAESYAGGTSYGKLTF,2,0,1,2
TRAV12-3,TRAJ10,CAMSGWGTGGGNKLTF,2,0,1,2
TRAV14DV4,TRAJ26,CAMREGPNNYGQNFVF,2,0,1,2
TRAV14DV4,TRAJ28,CAMRENSGAGSYQLTF,2,0,1,2
TRAV12-3,TRAJ52,CATPGAGGTSYGKLTF,2,0,1,2
TRAV34,TRAJ8,CGADPIPDTGFQKLVF,2,0,1,2
TRAV26-2,TRAJ26,CILRDGGDNYGQNFVF,2,0,1,2
TRAV25,TRAJ18,CSGFDRGSTLGRLYF,2,0,1,2
TRAV10,TRAJ42,CVVVGYGGSQGSLIF,2,0,1,2
TRAV12-1,TRAJ42,CVVMNYGGSQGNLIF,2,0,1,2
TRAV12-1,TRAJ6,CVVNPSSGGSYIPTF,2,0,1,2
TRAV12-1,TRAJ35,CVVNIPGGFGNVLHC,2,0,1,2
TRAV38-1,TRAJ48,CAFMTSNFGNEKLTF,2,0,1,2
TRAV38-2DV8,TRAJ43,CAYRTPLLQNNDMRF,2,0,1,2
TRAV38-2DV8,TRAJ54,CAYRSEIQGAQKLVF,2,0,1,2
TRAV38-2DV8,TRAJ31,CAYRSAPRDNARLMF,2,0,1,2
TRAV9-2,TRAJ24,CALIPPTDSWGKLQF,2,0,1,2
TRAV9-2,TRAJ49,CALREGANTGNQFYF,2,0,1,2
TRAV21,TRAJ28,CAPLYSGAGSYQLTF,2,0,1,2
TRAV41,TRAJ42,CAVCRLGGSQGNLIF,2,0,1,2
TRAV8-3,TRAJ42,CAVLNYGGSQGNLIF,2,8,2,10
TRAV41,TRAJ50,CAVSTVETSYDKVIF,2,0,1,2
TRAV41,TRAJ45,CAVRSGGGGADGLTF,2,0,1,2
TRAV41,TRAJ58,CAVRNLETSGSRLTF,2,0,1,2
TRAV34,TRAJ42,CAVSNYGGSQGNLIF,2,0,1,2
TRAV20,TRAJ11,CAVQARNSGYSTLTF,2,0,1,2
TRAV22,TRAJ48,CAVAISNFGNEKLTF,2,0,1,2
TRAV2,TRAJ32,CAVETGSGATNKLIF,2,0,1,2
TRAV12-2,TRAJ38,CAVTGNAGNNRKLIW,2,0,1,2
TRAV8-4,TRAJ17,CAVSPGEAAGNKLTF,2,0,1,2
TRAV8-4,TRAJ13,CAVSVRSGGYQKVTF,2,0,1,2
TRAV12-2,TRAJ42,CAVSPRGGSQGNLIF,2,0,1,2
TRAV8-4,TRAJ22,CAVRFFSGSARQLTF,2,0,1,2
TRAV21,TRAJ40,CAVRPGTSGTYKYIF,2,0,1,2
TRAV3,TRAJ40,CAVRVTTSGTYKYIF,2,0,1,2
TRAV3,TRAJ21,CAVRDSGGNFNKFYF,2,0,1,2
TRAV3,TRAJ26,CAVRDLVYYGQNFVF,2,0,1,2
TRAV12-2,TRAJ42,CAVKNYGGSRGNLIF,2,0,1,2
TRAV24,TRAJ42,CAFRNYGGSQGNLIF,2,0,1,2
TRAV12-2,TRAJ28,CAFRNSGAGSYQLTF,2,0,1,2
TRAV8-1,TRAJ42,CAVNNYGGSQGNLIF,2,0,1,2
TRAV25,TRAJ53,CAALDSGGSNYKLTF,2,0,1,2
TRAV23DV6,TRAJ45,CAARYSGGGADGLTF,2,0,1,2
TRAV29DV5,TRAJ28,CAAPLSGAGSYQLTF,2,0,1,2
TRAV13-1,TRAJ22,CAASPLSGSARQLTF,2,0,1,2
TRAV13-1,TRAJ57,CAASPLQGGSEKLVF,2,0,1,2
TRAV13-1,TRAJ3,CAASKGYSSASKIIF,2,0,1,2
TRAV13-1,TRAJ8,CAASLMNTGFQKLVF,2,0,1,2
TRAV29DV5,TRAJ29,CAASGLNSGNTPLVF,2,0,1,2
TRAV23DV6,TRAJ40,CAASTATSGTYKYIF,2,0,1,2
TRAV27,TRAJ52,CAGNAGGTSYGKLTF,2,0,1,2
TRAV13-2,TRAJ53,CAEILSGGSNYKLTF,2,0,1,2
TRAV12-3,TRAJ42,CAMVDYGGSQGNLIF,2,0,1,2
TRAV4,TRAJ3,CLRRGPYSSASKIIF,2,0,1,2
TRAV4,TRAJ5,CLVPPRNTGRRALTF,2,0,1,2
TRAV4,TRAJ11,CLVGDMNSGYSTLTF,2,0,1,2
TRAV4,TRAJ15,CLVGERNQAGTALIF,2,0,1,2
TRAV26-2,TRAJ42,CILENYGGSQGNLIF,2,0,1,2
TRAV26-2,TRAJ23,CILRDVYNQGGKLIF,2,0,1,2
TRAV8-2,TRAJ6,CVVTRSGGSYIPTF,2,0,1,2
TRAV12-1,TRAJ17,CVVIVKAAGNKLTF,2,0,1,2
TRAV10,TRAJ40,CVVTPASGTYKYIF,2,0,1,2
TRAV12-1,TRAJ15,CVVSLNQAGTALIF,2,0,1,2
TRAV12-1,TRAJ35,CVVSPIGFGNVLHC,2,0,1,2
TRAV12-1,TRAJ15,CVVNPSQAGTALIF,2,0,1,2
TRAV12-1,TRAJ29,CVVNPNSGNTPLVF,2,0,1,2
TRAV12-1,TRAJ31,CVVNTGGNNARLMF,2,0,1,2
TRAV38-1,TRAJ31,CAFMASSNNARLMF,2,0,1,2
TRAV38-2DV8,TRAJ12,CAYSPMDSSYKLIF,2,0,1,2
TRAV38-2DV8,TRAJ56,CAYRSTGANSKLTF,2,0,1,2
TRAV38-2DV8,TRAJ41,CAYRRLNSGYALNF,2,0,1,2
TRAV38-2DV8,TRAJ21,CAYRGVYNFNKFYF,2,0,1,2
TRAV38-2DV8,TRAJ49,CAYRSANTGNQFYF,2,0,1,2
TRAV6,TRAJ44,CALANTGTASKLTF,2,0,1,2
TRAV6,TRAJ10,CALILTGGGNKLTF,2,0,1,2
TRAV6,TRAJ37,CALAGSSNTGKLIF,2,0,1,2
TRAV9-2,TRAJ15,CALIPQQAGTALIF,2,0,1,2
TRAV9-2,TRAJ50,CALSLKTSYDKVIF,2,0,1,2
TRAV9-2,TRAJ9,CALSGLTGGFKTIF,2,0,1,2
TRAV9-2,TRAJ49,CALSETNTGNQFYF,2,0,1,2
TRAV6,TRAJ27,CALVPNTNAGKSTF,2,0,1,2
TRAV6,TRAJ49,CALDIGNTGNQFYF,2,0,1,2
TRAV16,TRAJ58,CALSRTLSGSRLTF,2,0,1,2
TRAV36DV7,TRAJ42,CAPYVGGSRGNLIF,2,0,1,2
TRAV21,TRAJ38,CAVHNAGNNRKLIW,2,0,1,2
TRAV41,TRAJ18,CAVTRGSTLGRLYF,2,0,1,2
TRAV41,TRAJ58,CAVNLRTSGSRLTF,2,0,1,2
TRAV22,TRAJ4,CAVPFSGGYNKLIF,2,0,1,2
TRAV20,TRAJ40,CAVRPYSGTYKYIF,2,0,1,2
TRAV36DV7,TRAJ58,CAVVKETSGSRLTF,2,6,2,8
TRAV22,TRAJ22,CAVAASGSARQLTF,2,0,1,2
TRAV8-3,TRAJ23,CAVGLYNQGGKLIF,2,0,1,2
TRAV8-3,TRAJ30,CAVGVGNRDDKIIF,2,0,1,2
TRAV8-3,TRAJ38,CAVGVTGNNRKLIW,2,0,1,2
TRAV8-3,TRAJ47,CAVGDMEYGNKLVF,2,0,1,2
TRAV20,TRAJ22,CAVGRAGSARQLTF,2,9,2,11
TRAV12-2,TRAJ26,CAVTGGNYGQNFVF,2,0,1,2
TRAV8-4,TRAJ27,CAVSLNTNAGKSTF,2,0,1,2
TRAV8-4,TRAJ29,CAVSEIAGNTPLVF,2,0,1,2
TRAV3,TRAJ21,CAVSGPYNFNKFYF,2,0,1,2
TRAV21,TRAJ53,CAVRPEGSNYKLTF,2,0,1,2
TRAV12-3,TRAJ29,CAVRRNSGITPLVF,2,0,1,2
TRAV12-2,TRAJ45,CAVRQGGGADGLTF,2,0,1,2
TRAV3,TRAJ34,CAVRVFLNTDKLIF,2,0,1,2
TRAV3,TRAJ31,CAVRDSLNNARLMF,2,0,1,2
TRAV3,TRAJ29,CAVRDFRGNTPLVF,2,0,1,2
TRAV3,TRAJ5,CAVRDLGGRRALTF,2,0,1,2
TRAV3,TRAJ11,CAVRDMTGYSTLTF,2,8,2,10
TRAV35,TRAJ35,CAGYVIGFGNVLHC,2,0,1,2
TRAV17,TRAJ16,CATARFSDGQKLLF,2,0,1,2
TRAV17,TRAJ54,CATGGIQGAQKLVF,2,0,1,2
TRAV6,TRAJ54,CASTRSGGAQKLVF,2,0,1,2
TRAV13-1,TRAJ52,CAPAGGTSYGKLTF,2,0,1,2
TRAV6,TRAJ38,CAPTGAGNNRKLIW,2,0,1,2
TRAV23DV6,TRAJ45,CAPDSGGGADGLTF,2,0,1,2
TRAV39,TRAJ50,CAVRDITSYDKVTF,2,0,1,2
TRAV39,TRAJ24,CAVGRTDSWGKLQF,2,0,1,2
TRAV29DV5,TRAJ23,CAVRIYNQGGKLIF,2,0,1,2
TRAV8-1,TRAJ33,CAVNDKDSNYQLIW,2,0,1,2
TRAV12-2,TRAJ3,CAVNSYSSASKVIF,2,0,1,2
TRAV12-2,TRAJ30,CAVNIMNRDDKIIF,2,0,1,2
TRAV13-1,TRAJ26,CAVLTGGYGQNFVF,2,0,1,2
TRAV25,TRAJ52,CAVAGGTSYGKLTF,2,0,1,2
TRAV13-1,TRAJ11,CAAPLFSGYSTLTF,2,0,1,2
TRAV13-1,TRAJ6,CAAPPPGGSYIPTF,2,0,1,2
TRAV13-1,TRAJ48,CAAPRPFGNEKLTF,2,0,1,2
TRAV23DV6,TRAJ44,CAATVTGTASKLTF,2,7,2,9
TRAV23DV6,TRAJ36,CAARGETGANNLFF,2,0,1,2
TRAV13-1,TRAJ3,CAASQGSSASKIIF,2,0,1,2
TRAV13-1,TRAJ44,CAASISGTASKLTF,2,0,1,2
TRAV13-1,TRAJ16,CAASILSDGQKLLF,2,0,1,2
TRAV13-1,TRAJ8,CAASINTGFQKLVF,2,0,1,2
TRAV13-1,TRAJ9,CAASTRGGGFKTIF,2,0,1,2
TRAV23DV6,TRAJ57,CAASTGGGSEKLVF,2,0,1,2
TRAV13-1,TRAJ13,CAASKAGGYQKVTF,2,0,1,2
TRAV29DV5,TRAJ41,CAASVADSGYALNF,2,0,1,2
TRAV29DV5,TRAJ57,CAASEQGGSEKLVF,2,2,2,4
TRAV12-3,TRAJ30,CAAKREYRDDRIIF,2,0,1,2
TRAV23DV6,TRAJ30,CAAKREYRDDKIIF,2,0,1,2
TRAV27,TRAJ17,CAGKNKAAGNKLTF,2,0,1,2
TRAV13-2,TRAJ49,CADYPTNTGNQFYF,2,0,1,2
TRAV5,TRAJ29,CAEIPNSGNTPLVF,2,0,1,2
TRAV5,TRAJ9,CAETSNTGGFKTIF,2,0,1,2
TRAV5,TRAJ9,CAESLNTGGFKAIF,2,0,1,2
TRAV13-2,TRAJ15,CAEKIRQAGTALIF,2,0,1,2
TRAV12-3,TRAJ26,CAMTYYNYGQNFVF,2,0,1,2
TRAV34,TRAJ10,CAMSVKGGGNKLTF,2,0,1,2
TRAV12-3,TRAJ40,CAMSADSGTYKYIF,2,0,1,2
TRAV14DV4,TRAJ44,CAMRPTGTASKLTF,2,0,1,2
TRAV14DV4,TRAJ26,CAMREDDYGQNFVF,2,0,1,2
TRAV17,TRAJ28,CGATKGAGSYQLTF,2,0,1,2
TRAV4,TRAJ6,CLVALSGGSYIPTF,2,0,1,2
TRAV4,TRAJ5,CLVGDDTGRRALTF,2,0,1,2
TRAV4,TRAJ39,CLVTRKNAGNMLTF,2,0,1,2
TRAV3,TRAJ17,CAVREGGAGNKLTF,2,0,1,2
TRAV26-2,TRAJ22,CILTVAGSARQLTF,2,0,1,2
TRAV3,TRAJ28,CVHSGAGSYQLTF,2,0,1,2
TRAV8-2,TRAJ33,CVVSGGSNYQLIW,2,0,1,2
TRAV10,TRAJ42,CVVPRGSQGNLIF,2,0,1,2
TRAV12-1,TRAJ16,CVVIVSDGQKLLF,2,0,1,2
TRAV12-1,TRAJ26,CVVRDNYGQNFVF,2,0,1,2
TRAV12-1,TRAJ41,CVVNMNSGYALNF,2,0,1,2
TRAV12-1,TRAJ5,CVVNRAGRRALTF,2,0,1,2
TRAV12-1,TRAJ5,CVVKGTGRRALTF,2,0,1,2
TRAV38-1,TRAJ48,CAFKNDGNEKLTF,2,0,1,2
TRAV38-2DV8,TRAJ45,CAYLSGGADGLTF,2,0,1,2
TRAV38-2DV8,TRAJ43,CAYRSAGFDDMRF,2,0,1,2
TRAV9-2,TRAJ40,CALFTSGTYKYIF,2,0,1,2
TRAV16,TRAJ52,CALRGTSYGKLTF,2,0,1,2
TRAV16,TRAJ48,CALGSFGNERLTF,2,0,1,2
TRAV9-2,TRAJ40,CALGNSGTYKYIF,2,0,1,2
TRAV9-2,TRAJ12,CALSDDSSYKLIF,2,0,1,2
TRAV9-2,TRAJ30,CALSEVGDDKIIF,2,0,1,2
TRAV9-2,TRAJ58,CALRETSGSRLTF,2,0,1,2
TRAV6,TRAJ45,CALGEGGADGLTS,2,0,1,2
TRAV6,TRAJ40,CALDMGGTYKYIF,2,0,1,2
TRAV16,TRAJ49,CALRSPTGNQFYF,2,0,1,2
TRAV2,TRAJ39,CAPVRNAGNMLTF,2,0,1,2
TRAV23DV6,TRAJ44,CAQNTGTASKLTF,2,0,1,2
TRAV20,TRAJ13,CAVLSGGYQKVTF,2,0,1,2
TRAV2,TRAJ6,CAVASGGSYIPTF,2,0,1,2
TRAV12-2,TRAJ30,CAVSLNRDDKIIF,2,0,1,2
TRAV12-2,TRAJ34,CAVQFYNTDKLIF,2,0,1,2
TRAV41,TRAJ53,CAVGGGSNYKLTF,2,0,1,2
TRAV41,TRAJ48,CAVISFGNEKLTF,2,3,2,5
TRAV12-2,TRAJ42,CAVLGGSQGNLIF,2,0,1,2
TRAV20,TRAJ20,CAVQPSNDYKLSF,2,0,1,2
TRAV20,TRAJ22,CAVQGGSARQLTF,2,0,1,2
TRAV2,TRAJ24,CAVVTDSWGKLQF,2,0,1,2
TRAV8-3,TRAJ8,CAVGPTGFQKLVF,2,0,1,2
TRAV8-3,TRAJ39,CAVGPGAGNMLTF,2,0,1,2
TRAV8-3,TRAJ41,CAVGARSGYALNF,2,0,1,2
TRAV8-3,TRAJ3,CAVGYSSASKIIF,2,0,1,2
TRAV20,TRAJ9,CAVGGTGGFKTIF,2,0,1,2
TRAV12-2,TRAJ43,CAVTFYNNNDMRF,2,0,1,2
TRAV8-4,TRAJ36,CAVTQTGANNLFF,2,0,1,2
TRAV8-6,TRAJ49,CAVSSNSGNQFYF,2,0,1,2
TRAV12-2,TRAJ45,CAVRPQGADGLTF,2,0,1,2
TRAV3,TRAJ8,CAVRGGSFQKLVF,2,0,1,2
TRAV21,TRAJ15,CAVNDQAGTALIF,2,0,1,2
TRAV12-2,TRAJ20,CAAGLSNDYKLSF,2,0,1,2
TRAV35,TRAJ39,CAGHNNAGNMLTF,2,0,1,2
TRAV41,TRAJ34,CAGGGDNTDKLVF,2,0,1,2
TRAV23DV6,TRAJ57,CAEFQGGSEKLVF,2,0,1,2
TRAV8-3,TRAJ48,CAISNFGNEKLTF,2,0,1,2
TRAV17,TRAJ58,CATEETSGSRLTF,2,0,1,2
TRAV13-1,TRAJ36,CASQGPGANNLFF,2,0,1,2
TRAV29DV5,TRAJ40,CAVSTSGTYKYIF,2,0,1,2
TRAV2,TRAJ41,CAVNSNSGYALNF,2,8,2,10
TRAV12-2,TRAJ33,CAVNPDSNYQLIW,2,7,2,9
TRAV12-2,TRAJ21,CAVNANNFDKFYF,2,0,1,2
TRAV12-2,TRAJ34,CAVNTGNTDKLIF,2,0,1,2
TRAV12-2,TRAJ39,CAVKDNAGNMLTF,2,0,1,2
TRAV12-2,TRAJ41,CAVKIDSGYALNF,2,0,1,2
TRAV12-2,TRAJ39,CAARRGAGNMLTF,2,0,1,2
TRAV12-2,TRAJ17,CAAHKAAGNKLTF,2,0,1,2
TRAV36DV7,TRAJ53,CAEGGGSNYKLTF,2,0,1,2
TRAV24,TRAJ6,CAILSGGSYIPTF,2,0,1,2
TRAV12-3,TRAJ3,CASPYSSASKIIF,2,0,1,2
TRAV25,TRAJ32,CASNGGATNKLIF,2,0,1,2
TRAV12-3,TRAJ50,CAPSGTSYDKVIF,2,0,1,2
TRAV13-1,TRAJ49,CAAHPPPGNQFYF,2,0,1,2
TRAV23DV6,TRAJ37,CAAGSSNTGKLIF,2,0,1,2
TRAV13-1,TRAJ40,CAAIPSGTYKYIF,2,0,1,2
TRAV13-1,TRAJ40,CAASTSGTYKYTF,2,0,1,2
TRAV13-1,TRAJ42,CAASRRSQGNLIF,2,0,1,2
TRAV23DV6,TRAJ42,CAASGGSQGNLIF,2,0,1,2
TRAV23DV6,TRAJ48,CAASMLGNEKLTF,2,0,1,2
TRAV25,TRAJ6,CAGPAGGSYIPTF,2,0,1,2
TRAV25,TRAJ3,CAGGNSSASKIIF,2,0,1,2
TRAV27,TRAJ39,CAGPFNAGNMLTF,2,0,1,2
TRAV27,TRAJ37,CAGGSSNTGKLIF,2,4,2,6
TRAV25,TRAJ37,CADGSSNTGKLIF,2,3,2,5
TRAV13-2,TRAJ34,CAETFYNTDKLIF,2,0,1,2
TRAV13-2,TRAJ43,CAENLPPYNDMRF,2,0,1,2
TRAV12-3,TRAJ30,CAMSMNRDDKIIF,2,0,1,2
TRAV12-3,TRAJ13,CAMSYGGYQKVTF,2,0,1,2
TRAV12-3,TRAJ30,CAMSVGRDDKIIF,2,0,1,2
TRAV12-3,TRAJ17,CAMSAAAGNKLTF,2,0,1,2
TRAV12-3,TRAJ4,CAMRVWGYNKLIF,2,0,1,2
TRAV14DV4,TRAJ29,CAMREGPGTPLVF,2,0,1,2
TRAV14DV4,TRAJ3,CAMREGSASKIIF,2,0,1,2
TRAV12-3,TRAJ6,CAMKPGGSYIPTF,2,0,1,2
TRAV12-3,TRAJ35,CATLIGFGNVLHC,2,0,1,2
TRAV34,TRAJ9,CGERDTGGFKTIF,2,0,1,2
TRAV4,TRAJ40,CLVGVEGTYKYIF,2,0,1,2
TRAV4,TRAJ43,CLVGDFSNNDMRF,2,0,1,2
TRAV12-3,TRAJ45,CAYSGGGADGLTF,2,0,1,2
TRAV26-2,TRAJ49,CILRPRAGNQFYF,2,0,1,2
TRAV26-2,TRAJ29,CILRDSGNTPLVF,2,0,1,2
TRAV26-2,TRAJ17,CIRYKAAGNKLTF,2,0,1,2
TRAV26-1,TRAJ23,CIVRVGQGGKLIF,2,0,1,2
TRAV26-1,TRAJ37,CIDGSSNTGKLIF,2,0,1,2
TRAV12-1,TRAJ23,CVVSNQGGKLIF,2,0,1,2
TRAV12-1,TRAJ9,CVVNTGGFKTIF,2,0,1,2
TRAV9-2,TRAJ27,CALSVIAGKSTF,2,0,1,2
TRAV1-2,TRAJ33,CAPKDSNYQLIW,2,0,1,2
TRAV23DV6,TRAJ10,CAQTGGGNKLTF,2,0,1,2
TRAV12-2,TRAJ57,CAVQGGSEKLVF,2,2,2,4
TRAV8-6,TRAJ40,CAVSPGTYKYIF,2,0,1,2
TRAV41,TRAJ54,CAVLAGAQKLVF,2,0,1,2
TRAV41,TRAJ26,CAVRPYGQNFVF,2,0,1,2
TRAV41,TRAJ49,CAVRGAGNQFYF,2,0,1,2
TRAV8-3,TRAJ3,CAVGAGASKIIF,2,0,1,2
TRAV12-2,TRAJ40,CAVILRTYKYIF,2,0,1,2
TRAV36DV7,TRAJ33,CAVMDSNYQLIW,2,13,2,15
TRAV8-4,TRAJ43,CAVSGNNNDMRF,2,0,1,2
TRAV8-4,TRAJ34,CAVSDNTDKLIF,2,0,1,2
TRAV23DV6,TRAJ11,CAVSSGYSTLTF,2,0,1,2
TRAV12-2,TRAJ43,CAVRPNNNDMRF,2,0,1,2
TRAV1-2,TRAJ33,CAVRDSNCQLIW,2,0,1,2
TRAV3,TRAJ31,CAVRDGNARLMF,2,0,1,2
TRAV22,TRAJ29,CAGPSGNTPLVF,2,2,2,4
TRAV17,TRAJ49,CATGGTGNQFYF,2,0,1,2
TRAV24,TRAJ30,CAFTNRDDKIIF,2,0,1,2
TRAV23DV6,TRAJ34,CAPRGNTDKLIF,2,0,1,2
TRAV12-2,TRAJ9,CAVGPGGFKTIF,2,0,1,2
TRAV8-1,TRAJ47,CAVNSYGNKLVF,2,0,1,2
TRAV12-2,TRAJ49,CAVNQIGNQFYF,2,0,1,2
TRAV8-1,TRAJ27,CAVNTNAGKSTF,2,0,1,2
TRAV23DV6,TRAJ26,CATDNYGQNFVF,2,0,1,2
TRAV23DV6,TRAJ29,CAKVSGNTPLVF,2,0,1,2
TRAV17,TRAJ24,CALTDSWGKLQF,2,21,2,23
TRAV23DV6,TRAJ24,CAAWEGWGKLQF,2,0,1,2
TRAV13-1,TRAJ40,CAAYSGTYKYIF,2,0,1,2
TRAV23DV6,TRAJ33,CAAEDSSYQLIW,2,0,1,2
TRAV13-1,TRAJ33,CAASRSYYQLIW,2,0,1,2
TRAV29DV5,TRAJ31,CAASEMNARLMF,2,0,1,2
TRAV25,TRAJ58,CAGRASGSRLTF,2,0,1,2
TRAV25,TRAJ9,CAGGTGGFKTIF,2,0,1,2
TRAV12-3,TRAJ43,CAGDHNNNDMRF,2,0,1,2
TRAV12-3,TRAJ52,CARPASYGKLTF,2,0,1,2
TRAV26-1,TRAJ11,CIPPEGYSTLTF,2,0,1,2
TRAV26-1,TRAJ34,CIVRVDGDKLIF,2,0,1,2
TRAV9-2,TRAJ32,WAGGGATNKLIF,2,0,1,2
TRAV12-1,TRAJ20,CVVNNDYKLSF,2,0,1,2
TRAV9-2,TRAJ23,CALNAGGKLIF,2,0,1,2
TRAV16,TRAJ52,CAPSGYGKLTF,2,0,1,2
TRAV41,TRAJ34,CAVRFADKLTF,2,0,1,2
TRAV8-3,TRAJ20,CAVGDDYKVSF,2,0,1,2
TRAV8-6,TRAJ43,CAVSDQDDVRF,2,0,1,2
TRAV12-2,TRAJ17,CAEAAGNKLTF,2,0,1,2
TRAV24,TRAJ20,CAFIGDYKLSF,2,0,1,2
TRAV12-2,TRAJ20,CAVWNDYKLSF,2,0,1,2
TRAV39,TRAJ30,CAVEVDDKIIF,2,0,1,2
TRAV8-1,TRAJ27,CAVMNAGKSTF,2,0,1,2
TRAV12-2,TRAJ43,CAVNSGNDMRF,2,0,1,2
TRAV16,TRAJ36,CAGGGANNLFF,2,0,1,2
TRAV29DV5,TRAJ49,CAARTGNQFYF,2,0,1,2
TRAV13-1,TRAJ7,CAASTINRLAF,2,0,1,2
TRAV13-1,TRAJ13,CAARGYQKVTF,2,0,1,2
TRAV13-1,TRAJ12,CAARLSYKLIF,2,0,1,2
TRAV25,TRAJ49,CAGWTGNQFYF,2,0,1,2
TRAV27,TRAJ47,CAGEYGNKLVF,2,0,1,2
TRAV5,TRAJ35,CAEGLGNVLHC,2,0,1,2
TRAV29DV5,TRAJ52,CAMASYGKLTF,2,0,1,2
TRAV13-2,TRAJ52,CGCTSYGKLTF,2,0,1,2
TRAV9-2,TRAJ21,CTLNNFNKFYF,2,0,1,2
TRAV4,TRAJ20,CLVSVDYKLSF,2,0,1,2
TRAV26-2,TRAJ43,CILRENNDMRF,2,0,1,2
TRAV38-2DV8,TRAJ41,CAYNGYALNF,2,0,1,2
TRAV6,TRAJ6,CALSGYIPTF,2,0,1,2
TRAV9-2,TRAJ31,CALSGDRLMF,2,0,1,2
TRAV36DV7,TRAJ43,CAVPVNDMRF,2,0,1,2
TRAV12-2,TRAJ54,CAINWQELVF,2,0,1,2
TRAV12-3,TRAJ20,CAMYDYKLSF,2,0,1,2
TRAV17,TRAJ34,CGRNTDKLIF,2,0,1,2
TRAV12-1,TRAJ54,CGWGAQKLVF,2,0,1,2
TRAV8-3,TRAJ45,CAVGFDGLTF,2,0,1,2
TRAV12-2,TRAJ43,CAVRGDMRF,2,0,1,2
TRAV25,TRAJ20,RGYRYKLSF,2,0,1,2
TRAV26-2,TRAJ40,CIAMEYIF,2,0,1,2
TRAV13-1,TRAJ29,CASHF,2,0,1,2
TRAV14DV4,TRAJ37,CAMREGAGSSNTGKLIF,0,57,1,57
TRAV13-1,TRAJ46,QKSSGDKLTF,0,40,1,40
TRAV22,TRAJ48,CAVVSNFGNEKLTF,0,37,1,37
TRAV13-2,TRAJ13,CAEEESYQKVTF,0,36,1,36
TRAV8-1,TRAJ20,CAVNPRASNDYKLSF,0,34,1,34
TRAV5,TRAJ10,CAEMYTGGGNKLTF,0,31,1,31
TRAV9-2,TRAJ28,CALSYSGAGSYQLTF,0,29,1,29
TRAV6,TRAJ22,CALEKGSARQLTF,0,27,1,27
TRAV20,TRAJ13,CAVYSGGYQKVTF,0,26,1,26
TRAV21,TRAJ52,CAGLNAGGTSYGKLTF,0,25,1,25
TRAV16,TRAJ53,CALKGIGGSNYKLTF,0,25,1,25
TRAV13-1,TRAJ4,FSGGYNKLIF,0,24,1,24
TRAV38-2DV8,TRAJ57,CAYRRVQGGSEKLVF,0,24,1,24
TRAV14DV4,TRAJ3,CAMREGGSSASKIIF,0,24,1,24
TRAV9-2,TRAJ20,CALSEGDYKLSF,0,24,1,24
TRAV23DV6,TRAJ57,CAAIQGGSEKLVF,0,20,1,20
TRAV23DV6,TRAJ26,CAATLNYGQNFVF,0,20,1,20
TRAV6,TRAJ11,CALDPPDSTLTF,0,19,1,19
TRAV14DV4,TRAJ6,CAMREGISGGSYIPTF,0,19,1,19
TRAV13-1,TRAJ45,CAASIAPGGGADGLTF,0,19,1,19
TRAV38-2DV8,TRAJ15,CAYKGSNQAGTALIF,0,19,1,19
TRAV9-2,TRAJ8,CALSDITGFQKLVF,0,19,1,19
TRAV21,TRAJ28,CAAYSGAGSYQLTF,0,24,1,24
TRAV2,TRAJ26,CAVPDNYGQNFVF,0,19,1,19
TRAV12-1,TRAJ49,CVVSNTGNQFYF,0,19,1,19
TRAV14DV4,TRAJ42,CAMREGFYYGGSQGNLIF,0,18,1,18
TRAV22,TRAJ4,CAVGSGGYNKLIF,0,18,1,18
TRAV13-1,TRAJ16,CAPYARFSDGQKLLF,0,18,1,18
TRAV13-1,TRAJ49,CAASVDNQFYF,0,18,1,18
TRAV8-3,TRAJ30,CAVGAVGRDDKIIF,0,18,1,18
TRAV39,TRAJ49,CAVDLDTGNQFYF,0,18,1,18
TRAV9-2,TRAJ42,CALSPNYGGSQGNLIF,0,18,1,18
TRAV17,TRAJ9,CATDTGGFKTIF,0,18,1,18
TRAV13-1,TRAJ22,CAASSGSARQLTF,0,18,1,18
TRAV25,TRAJ44,CAGRTGTASKLTF,0,25,1,25
TRAV2,TRAJ29,CAVNSGNTPLVF,0,18,1,18
TRAV9-2,TRAJ48,CALSQEGNEKLTF,0,17,1,17
TRAV14DV4,TRAJ7,CATSRGGNNRLAF,0,17,1,17
TRAV2,TRAJ33,CAVEGNYQLIW,0,21,1,21
TRAV9-2,TRAJ45,CALSPYSGGGADGLTF,0,17,1,17
TRAV13-1,TRAJ39,CAASDNNAGNMLTF,0,17,1,17
TRAV4,TRAJ18,CLVGDRGSTLGRLYF,0,16,1,16
TRAV9-2,TRAJ20,CALRNDYKLSF,0,16,1,16
TRAV8-3,TRAJ4,CAVGPLSGGYNKLIF,0,16,1,16
TRAV14DV4,TRAJ20,CAMRGPLDGSNDYKLSF,0,16,1,16
TRAV14DV4,TRAJ11,CAMREGNSGYSTLTF,0,16,1,16
TRAV38-2DV8,TRAJ49,CAYGGTGNQFYF,0,16,1,16
TRAV16,TRAJ34,CALGGTDKLIF,0,16,1,16
TRAV8-3,TRAJ13,CAVVLSNSGGYQKVTF,0,16,1,16
TRAV12-1,TRAJ4,CVVSPSGGYNKLIF,0,16,1,16
TRAV13-1,TRAJ10,CAATTGGGNKLTF,0,16,1,16
TRAV20,TRAJ52,CAVQPGVINAGGTSYGKLTF,0,16,1,16
TRAV14DV4,TRAJ32,CAMRELNYGGATNKLIF,0,16,1,16
TRAV9-2,TRAJ42,CALNYGGSQGNLIF,0,15,1,15
TRAV17,TRAJ27,CATDAGHNTNAGKSTF,0,15,1,15
TRAV27,TRAJ39,CAGVPNNNAGNMLTF,0,15,1,15
TRAV12-1,TRAJ5,CVVYFDTGRRALTF,0,15,1,15
TRAV20,TRAJ57,CAVQRGGGSEKLVF,0,15,1,15
TRAV21,TRAJ11,CAVKRLGGYSTLTF,0,15,1,15
TRAV17,TRAJ4,CATALSGGYNKLIF,0,15,1,15
TRAV9-2,TRAJ39,CALMDNAGNMLTF,0,15,1,15
TRAV12-2,TRAJ21,CAVKDNFNKFYF,0,15,1,15
TRAV14DV4,TRAJ20,CASNDYKLSF,0,15,1,15
TRAV17,TRAJ54,CATDDRGAQKLVF,0,15,1,15
TRAV16,TRAJ57,CALTTQGGSEKLVF,0,15,1,15
TRAV17,TRAJ57,CATAQGGSEKLVF,0,15,1,15
TRAV21,TRAJ58,CAVSRETSGSRLTF,0,15,1,15
TRAV27,TRAJ32,CAGEDGGATNKLIF,0,14,1,14
TRAV12-1,TRAJ42,CVVTNYGGSQGNLIF,0,14,1,14
TRAV25,TRAJ38,CAGSNAGNNRKLIW,0,14,1,14
TRAV2,TRAJ4,CAVEDGSGGYNKLIF,0,14,1,14
TRAV20,TRAJ15,CAVQGNQAGTALIF,0,14,1,14
TRAV17,TRAJ11,CATDLNSGYSTLTF,0,14,1,14
TRAV9-2,TRAJ11,CALMNSGYSTLTF,0,16,1,16
TRAV23DV6,TRAJ35,CAYRGGFGNVLHC,0,14,1,14
TRAV12-3,TRAJ10,CAMSEGGGNKLTF,0,14,1,14
TRAV26-2,TRAJ39,CIAKRNAGNMLTF,0,14,1,14
TRAV2,TRAJ9,CAVDTGGFKTIF,0,14,1,14
TRAV25,TRAJ29,CAGRGNTPLVF,0,14,1,14
TRAV17,TRAJ34,CATDALSTDKLIF,0,14,1,14
TRAV26-2,TRAJ18,CILLDRGSTLGRLYF,0,14,1,14
TRAV21,TRAJ6,CAVSGGSYIPTF,0,14,1,14
TRAV8-1,TRAJ48,CAALISNFGNEKLTF,0,13,1,13
TRAV23DV6,TRAJ17,CAASKEIKAAGNKLTF,0,13,1,13
TRAV26-2,TRAJ57,CILRDLQGGSEKLVF,0,13,1,13
TRAV38-2DV8,TRAJ48,CAYRTSNFGNEKLTF,0,13,1,13
TRAV12-2,TRAJ10,CAVRELTGGGNKLTF,0,13,1,13
TRAV23DV6,TRAJ57,CAAPYQGGSEKLVF,0,13,1,13
TRAV12-1,TRAJ38,CVVTPNAGNNRKLIW,0,13,1,13
TRAV4,TRAJ40,CLVAVSTSGTYKYIF,0,13,1,13
TRAV6,TRAJ33,CALAHMDSNYQLIW,0,13,1,13
TRAV8-3,TRAJ18,CAVGRGSTLGRLYF,0,13,1,13
TRAV8-1,TRAJ6,CAVISSGGSYIPTF,0,13,1,13
TRAV12-2,TRAJ9,CAVNKGTGGFKTIF,0,13,1,13
TRAV13-1,TRAJ15,CAASIGQAGTALIF,0,13,1,13
TRAV9-2,TRAJ34,CALSDRNTDKLIF,0,13,1,13
TRAV8-3,TRAJ40,CAVAISGTYKYIF,0,13,1,13
TRAV4,TRAJ31,CLVGEGNNARLMF,0,13,1,13
TRAV8-3,TRAJ7,CAVLYGNNRLAF,0,13,1,13
TRAV13-1,TRAJ58,CAASFSGLTF,0,13,1,13
TRAV26-2,TRAJ37,CFLSSSNTGKLIF,0,12,1,12
TRAV12-2,TRAJ40,CAVHTTSGTYKYIF,0,12,1,12
TRAV3,TRAJ28,CAVRDRHSGAGSYQLTF,0,12,1,12
TRAV6,TRAJ41,CALDLPLPNSGYALNF,0,12,1,12
TRAV12-3,TRAJ48,CAMSARSNFGNEKLTF,0,12,1,12
TRAV41,TRAJ50,CAVKWTSYDKVIF,0,12,1,12
TRAV9-2,TRAJ15,CALIPNQAGTALIF,0,12,1,12
TRAV4,TRAJ10,CLVGGHILTGGGNKLTF,0,12,1,12
TRAV26-1,TRAJ52,CIVSFNAGGTSYGKLTF,0,12,1,12
TRAV12-1,TRAJ45,CVVTLYSGGGADGLTF,0,12,1,12
TRAV3,TRAJ4,CAMRDWGTGGYNKPIF,0,12,1,12
TRAV12-2,TRAJ52,CAVRRPGGTSYGKLTF,0,12,1,12
TRAV12-2,TRAJ29,CAVNSLGRSGNTPLVF,0,12,1,12
TRAV38-1,TRAJ39,CAFMKGEDAGNMLTF,0,12,1,12
TRAV38-2DV8,TRAJ40,CAYRSSVSGTYKYIF,0,12,1,12
TRAV30,TRAJ23,CGTENGHNQGGKLIF,0,12,1,12
TRAV12-1,TRAJ9,CVVTAGTGGFKTIF,0,12,1,12
TRAV38-1,TRAJ5,CAFMKRAGRRALTF,0,12,1,12
TRAV8-3,TRAJ43,CAVVRPYNNNDMRF,0,12,1,12
TRAV3,TRAJ33,CAVRAFYSNYQLIW,0,12,1,12
TRAV12-3,TRAJ40,CAMSATSGTYKYIF,0,12,1,12
TRAV12-3,TRAJ54,CAMSANQGAQKLVF,0,12,1,12
TRAV14DV4,TRAJ13,CAMRDPGGYQKVTF,0,12,1,12
TRAV4,TRAJ10,CLVAVTGGGNKLTF,0,12,1,12
TRAV12-1,TRAJ11,CVVNTPGYSTLTF,0,12,1,12
TRAV8-3,TRAJ13,CAVGALGYQKVTF,0,12,1,12
TRAV41,TRAJ17,CAHSAAGNKLTF,0,12,1,12
TRAV8-3,TRAJ33,CAVGPNYQLIW,0,12,1,12
TRAV9-2,TRAJ58,CALSPRVASGSRLTF,0,12,1,12
TRAV23DV6,TRAJ42,CAASNYGGSQGNLIF,0,12,1,12
TRAV21,TRAJ41,CAVRYPNSGYALNF,0,12,1,12
TRAV12-2,TRAJ15,CAVNNQAGTALIF,0,22,1,22
TRAV23DV6,TRAJ40,CAAGTSGTYKYIF,0,12,1,12
TRAV9-2,TRAJ58,CALSGGETSGSRLTF,0,12,1,12
TRAV12-1,TRAJ10,CVVKVLTGGGNKLTF,0,11,1,11
TRAV12-1,TRAJ9,CVVNHGTGGFKTIF,0,11,1,11
TRAV16,TRAJ32,CALRHGGATTKLIF,0,11,1,11
TRAV26-2,TRAJ39,CILRDVPGNMLTS,0,11,1,11
TRAV36DV7,TRAJ37,CVGSSNTGKLIF,0,11,1,11
TRAV21,TRAJ15,CAVDQAGTALIF,0,11,1,11
TRAV39,TRAJ43,CAVDMTDDMRF,0,11,1,11
TRAV3,TRAJ42,CAVRGFLFGGSQGNLIF,0,11,1,11
TRAV13-1,TRAJ42,CAASRMNYGGSQGNLIF,0,11,1,11
TRAV12-1,TRAJ28,CVVNEYSGAGSYQLTF,0,11,1,11
TRAV9-2,TRAJ4,CALSARLSGGYNKLIF,0,11,1,11
TRAV14DV4,TRAJ28,CAMSLTSGAGSYQLTF,0,11,1,11
TRAV12-3,TRAJ42,CAMSEGYGGSQGNLIF,0,11,1,11
TRAV8-3,TRAJ4,CAVGAFSGGYNKLIF,0,11,1,11
TRAV3,TRAJ10,CAVRLLTGGGNKLTF,0,11,1,11
TRAV14DV4,TRAJ3,CAMRVPWSSASKIIF,0,11,1,11
TRAV3,TRAJ24,CAVTSTDSWGKLQF,0,11,1,11
TRAV2,TRAJ9,CAVTNTGGFKTIF,0,11,1,11
TRAV12-2,TRAJ6,CAAASGGSYIPTF,0,11,1,11
TRAV2,TRAJ29,CAVESGNTPLVF,0,11,1,11
TRAV24,TRAJ48,CALNFGNEKLTF,0,14,1,14
TRAV13-2,TRAJ9,CAENTGGFKTIF,0,11,1,11
TRAV38-2DV8,TRAJ54,CAYRRSQKLVF,0,11,1,11
TRAV21,TRAJ49,CAVSAGNQFYF,0,11,1,11
TRAV17,TRAJ49,CATGAGNQFYF,0,11,1,11
TRAV12-2,TRAJ16,CAVNGGQKLLF,0,11,1,11
TRAV4,TRAJ33,CLMDSNYQLIW,0,14,1,14
TRAV9-2,TRAJ30,CALRDDKIIF,0,11,1,11
TRAV36DV7,TRAJ20,CAPDYKLSF,0,11,1,11
TRAV17,TRAJ43,CATDARGRF,0,11,1,11
TRAV14DV4,TRAJ45,CAMSPASSSGGGADGLTF,0,11,1,11
TRAV25,TRAJ43,CAERDNNDMRF,0,11,1,11
TRAV26-1,TRAJ22,CIVRFPISSGSARQLTF,0,11,1,11
TRAV23DV6,TRAJ5,CAASVGTGRRALTF,0,11,1,11
TRAV12-3,TRAJ5,CAMRGDTGRRALTF,0,11,1,11
TRAV22,TRAJ42,CAVLEGSQGNLIF,0,11,1,11
TRAV8-3,TRAJ42,CAVGAGSQGNLIF,0,11,1,11
TRAV13-1,TRAJ27,CAASSNAGKSTF,0,11,1,11
TRAV25,TRAJ11,CAGFRGYSTLTF,0,11,1,11
TRAV13-1,TRAJ18,CAASINRKDRGSTLGRLYF,0,11,1,11
TRAV38-2DV8,TRAJ28,CAYRSATYSGAGCYQLTF,0,11,1,11
TRAV13-1,TRAJ12,CAASKADSSYKLIF,0,11,1,11
TRAV34,TRAJ53,CGADTVGSNYKLTF,0,11,1,11
TRAV9-2,TRAJ45,CALSDPYSGGGADGLTF,0,10,1,10
TRAV8-3,TRAJ41,CAVALSGNSNSGYALNF,0,10,1,10
TRAV38-1,TRAJ22,CAFMKLPSGSARQLTF,0,10,1,10
TRAV8-3,TRAJ37,CAVGAHGSSNTGKLIF,0,10,1,10
TRAV3,TRAJ32,CAVRDTRGGATNKLIF,0,10,1,10
TRAV8-1,TRAJ17,CAAGHGIKAAGNKLTF,0,10,1,10
TRAV38-2DV8,TRAJ42,CAYRNYGGSQGNLIF,0,10,1,10
TRAV9-2,TRAJ32,CALSFYGGATNKLIF,0,10,1,10
TRAV17,TRAJ45,CATRGPGGGADGLTF,0,10,1,10
TRAV5,TRAJ3,CAESSPYSSASKIIF,0,10,1,10
TRAV5,TRAJ3,CAESPLGSSASKIIF,0,10,1,10
TRAV13-2,TRAJ48,CAERKSNFGNEKLTF,0,10,1,10
TRAV14DV4,TRAJ49,CAMREGFLHGNQFYF,0,10,1,10
TRAV34,TRAJ9,CGAAALGTGGFKTIF,0,10,1,10
TRAV17,TRAJ29,CALRTNSGNTPLVF,0,10,1,10
TRAV3,TRAJ13,CAVRNSGGYQKVTF,0,10,1,10
TRAV29DV5,TRAJ40,CAAITTSGTYKYIF,0,10,1,10
TRAV23DV6,TRAJ41,CAASSLNSGYALNF,0,10,1,10
TRAV13-2,TRAJ45,CAENIGGGADGLTF,0,10,1,10
TRAV5,TRAJ42,CGLRDGGSQGNLIF,0,10,1,10
TRAV26-2,TRAJ42,CILNYGGSQGNLIF,0,10,1,10
TRAV12-1,TRAJ34,CVVNIGDTDKLIF,0,10,1,10
TRAV38-1,TRAJ39,CAFQDGAGNMLTF,0,10,1,10
TRAV16,TRAJ30,CALGPNRDDKIIF,0,10,1,10
TRAV5,TRAJ6,CAPSSGGSYIPTF,0,10,1,10
TRAV2,TRAJ34,CAVEGRNTDKLIF,0,10,1,10
TRAV2,TRAJ43,CAVEDLDNNDMRF,0,10,1,10
TRAV2,TRAJ26,CAVEERDGQNFVF,0,10,1,10
TRAV2,TRAJ37,CAVRSSNTGKLIF,0,10,1,10
TRAV6,TRAJ41,CATPSNSGYALNF,0,10,1,10
TRAV5,TRAJ20,CAESRQDDYKLSF,0,10,1,10
TRAV12-3,TRAJ6,CASLKGGSYIPTF,0,10,1,10
TRAV12-1,TRAJ22,CVVNDSARQLTF,0,10,1,10
TRAV8-3,TRAJ31,CAVGAANARLMF,0,10,1,10
TRAV24,TRAJ39,CAFNNAGNMLTF,0,10,1,10
TRAV12-3,TRAJ29,CACHSGNTPLVF,0,10,1,10
TRAV17,TRAJ20,CAPFNDYELSF,0,10,1,10
TRAV9-2,TRAJ20,CALHDYKLSF,0,10,1,10
TRAV27,TRAJ20,CVGNKLSF,0,10,1,10
TRAV16,TRAJ23,CALGGPFYNQGGKLIF,0,10,1,10
TRAV25,TRAJ53,CAGRASGGSNYKLTF,0,10,1,10
TRAV16,TRAJ32,CALSGRGATNKLIF,0,10,1,10
TRAV12-1,TRAJ36,CVVQTGANNLFF,0,10,1,10
TRAV9-2,TRAJ32,CALSVWDYGGATNKLIF,0,10,1,10
TRAV2,TRAJ16,CAVEDSGQKLLF,0,10,1,10
TRAV12-2,TRAJ52,CAVKSAGGTSYGKLTF,0,10,1,10
TRAV26-2,TRAJ44,CILRDWTGTASKLTF,0,10,1,10
TRAV9-2,TRAJ22,CALTTYVVSSGSARQLTF,0,10,1,10
TRAV14DV4,TRAJ39,CAMRENNNAGNKLTF,0,10,1,10
TRAV2,TRAJ26,CAVDRDNYGQNFVF,0,10,1,10
TRAV3,TRAJ7,CAVRAFYGNNRLAF,0,10,1,10
TRAV13-1,TRAJ39,CAASVPRGSNMLTF,0,10,1,10
TRAV13-1,TRAJ3,CAASIGSSASKIIF,0,10,1,10
TRAV23DV6,TRAJ37,CAASISNTGKLIF,0,10,1,10
TRAV17,TRAJ34,CATDRNTDKLIF,0,10,1,10
TRAV3,TRAJ42,CAVRDFGGSQGNLIF,0,10,1,10
TRAV9-2,TRAJ17,CALSDLVKAAGNKLTF,0,9,1,9
TRAV4,TRAJ37,CLVGPLGSSNTGKLIF,0,9,1,9
TRAV41,TRAJ23,CAVSRGNQGGKLIF,0,9,1,9
TRAV3,TRAJ9,CAVRANTGGFKTIF,0,9,1,9
TRAV25,TRAJ44,CAGPNTGTASKLTF,0,9,1,9
TRAV24,TRAJ27,CAFINTNAGKSTF,0,9,1,9
TRAV12-3,TRAJ34,CAMRLYNTDKLIF,0,9,1,9
TRAV9-2,TRAJ8,CALNTGFQKLVF,0,9,1,9
TRAV13-1,TRAJ49,CAASIVGTGNQFYF,0,9,1,9
TRAV4,TRAJ13,CLVGGGYQKVTF,0,9,1,9
TRAV6,TRAJ10,CALGPLLYDILTGGGNKLTF,0,9,1,9
TRAV26-2,TRAJ52,CILRGFNAGGTSYGKLTF,0,9,1,9
TRAV38-2DV8,TRAJ37,CAYRSAYGSSNTGKLIF,0,9,1,9
TRAV9-2,TRAJ52,CALRRSAGGTSYGKLTF,0,9,1,9
TRAV26-1,TRAJ33,CIVRASIAWDSNYQLIW,0,9,1,9
TRAV38-1,TRAJ33,CAFRGLTMDSNYQLIW,0,9,1,9
TRAV19,TRAJ56,CALSEKATGANSKLTF,0,9,1,9
TRAV8-3,TRAJ52,CAVTNAGGTSYGKLTF,0,9,1,9
TRAV12-2,TRAJ28,CAVSPYSGAGSYQLTF,0,9,1,9
TRAV13-1,TRAJ6,CAASSPSGGGSYIPTF,0,9,1,9
TRAV27,TRAJ10,CAGGDGLTGGGNKLTF,0,9,1,9
TRAV14DV4,TRAJ40,CAMREIIASGTYKYIF,0,9,1,9
TRAV12-1,TRAJ42,CSAGDYGGSQGNLIF,0,9,1,9
TRAV12-1,TRAJ5,CVVNPSVTGRRALTF,0,9,1,9
TRAV21,TRAJ10,CAVLILTGGGNKLTF,0,9,1,9
TRAV20,TRAJ42,CAVPNYGGSQGNLIF,0,12,1,12
TRAV8-3,TRAJ48,CAVGPPNFGNEKLTF,0,9,1,9
TRAV2,TRAJ38,CAVEVYAGNNRKLIW,0,9,1,9
TRAV2,TRAJ3,CAVESRDSSASKIIF,0,9,1,9
TRAV3,TRAJ42,CAVRPGGGSQGNLIF,0,9,1,9
TRAV25,TRAJ45,CAGTRSGGGADGLTF,0,9,1,9
TRAV14DV4,TRAJ3,CAMREGVLSASKIIF,0,9,1,9
TRAV12-1,TRAJ44,CVVSTTGTASKLTF,0,9,1,9
TRAV38-1,TRAJ39,CAFMKGNAGNMLTF,0,9,1,9
TRAV38-1,TRAJ45,CAFTSGGGADGLTF,0,9,1,9
TRAV9-2,TRAJ48,CALVLGFGNEKLTF,0,9,1,9
TRAV9-2,TRAJ12,CALSDPDSSYKLIF,0,9,1,9
TRAV9-2,TRAJ5,CALSKSTGRRALTF,0,9,1,9
TRAV6,TRAJ26,CALDMGNYGQNFVF,0,9,1,9
TRAV20,TRAJ48,CAVLSDFGNEKLTF,0,9,1,9
TRAV8-3,TRAJ21,CAVGAPRGFNKFYF,0,9,1,9
TRAV22,TRAJ30,CAVEPMNRDDKIIF,0,9,1,9
TRAV2,TRAJ10,CAVEVSGGGNKLTF,0,9,1,9
TRAV12-2,TRAJ5,CAVEEDTGRRALTF,0,9,1,9
TRAV3,TRAJ11,CAVRGNSGYSTLTF,0,9,1,9
TRAV13-1,TRAJ37,CATGGSSNTGKLIF,0,9,1,9
TRAV12-2,TRAJ30,CAVKGVNRGDKIIL,0,9,1,9
TRAV13-1,TRAJ10,CAASIAGGGNKFTF,0,9,1,9
TRAV27,TRAJ52,CAGAGGTSYGKLTF,0,9,1,9
TRAV25,TRAJ6,CAGPKEGGSYIPTF,0,9,1,9
TRAV13-2,TRAJ42,CAENYGGSQGNLIF,0,9,1,9
TRAV13-2,TRAJ27,CAENRRTNAGKSTF,0,9,1,9
TRAV30,TRAJ44,CGTENTGTASKLTF,0,9,1,9
TRAV26-2,TRAJ6,CILRSSGGSYIPTF,0,9,1,9
TRAV12-1,TRAJ20,CVVNPSNDYKLSF,0,9,1,9
TRAV12-1,TRAJ22,CVVNKGSARQLTF,0,9,1,9
TRAV38-2DV8,TRAJ56,CAYKSGANSKLTF,0,9,1,9
TRAV9-2,TRAJ6,CALLSGGSYIPTF,0,9,1,9
TRAV16,TRAJ20,CALSGSNDYKLSF,0,9,1,9
TRAV17,TRAJ13,CATDAGGYQKVTF,0,9,1,9
TRAV17,TRAJ11,CATDGEGYSTLTF,0,9,1,9
TRAV12-2,TRAJ13,CAVGAGGYQKVTF,0,9,1,9
TRAV8-1,TRAJ34,CAVNSFNTDKLIF,0,9,1,9
TRAV27,TRAJ23,CAGFYNQGGKLIF,0,9,1,9
TRAV5,TRAJ49,CADQRDTGNQFYF,0,9,1,9
TRAV13-2,TRAJ21,CAETSSHFNKFYF,0,9,1,9
TRAV5,TRAJ29,CAESMRGNTPLVF,0,9,1,9
TRAV14DV4,TRAJ43,CAMRPNSGNDMRF,0,9,1,9
TRAV14DV4,TRAJ11,CAMRDPGYSTLTF,0,9,1,9
TRAV26-2,TRAJ41,CARLRYSGYALNF,0,9,1,9
TRAV38-1,TRAJ43,CASRFNNNDMRF,0,9,1,9
TRAV16,TRAJ42,CALRGSQGNLIF,0,9,1,9
TRAV6,TRAJ13,CAPAGGYQKVTF,0,9,1,9
TRAV2,TRAJ3,CAVVSSASKIIF,0,9,1,9
TRAV21,TRAJ43,CAVIYNNNDMRF,0,11,1,11
TRAV21,TRAJ21,CAVRYNFDKFYF,0,9,1,9
TRAV17,TRAJ9,CALYTGGFKTIF,0,15,1,15
TRAV29DV5,TRAJ37,CAASSNTGKLIF,0,13,1,13
TRAV23DV6,TRAJ29,CAAKARNTPLVF,0,9,1,9
TRAV13-2,TRAJ10,CAEKGGGNKLTF,0,9,1,9
TRAV4,TRAJ43,CLVGPINNDMRF,0,9,1,9
TRAV26-2,TRAJ43,CILRRDNNDMRF,0,9,1,9
TRAV26-2,TRAJ23,CILRDERGKLIF,0,9,1,9
TRAV26-1,TRAJ57,CIVRGGSEKLVF,0,9,1,9
TRAV17,TRAJ57,CVPGGSEKLVF,0,9,1,9
TRAV9-2,TRAJ21,CALSDFNKFYF,0,9,1,9
TRAV17,TRAJ31,CATLNNARLMF,0,9,1,9
TRAV8-1,TRAJ20,CAVNGDYKLSF,0,9,1,9
TRAV27,TRAJ43,CAATNNNDMRF,0,9,1,9
TRAV26-1,TRAJ20,CMERNDYKLSF,0,9,1,9
TRAV8-6,TRAJ23,CADQGGKLIF,0,9,1,9
TRAV14DV4,TRAJ31,SDRGARLMF,0,9,1,9
TRAV21,TRAJ31,CAVLPRLMF,0,9,1,9
TRAV4,TRAJ37,CLVGAAHGSSNTGKLNF,0,9,1,9
TRAV26-2,TRAJ8,CILRDFLNTGFQKLVF,0,9,1,9
TRAV21,TRAJ34,CAVSLYVYNTDKLIF,0,9,1,9
TRAV9-2,TRAJ57,CALRKQGGSEELVF,0,9,1,9
TRAV12-3,TRAJ29,CAMSYSGNTPLVF,0,9,1,9
TRAV4,TRAJ26,CLVGDRSNYGQNFVF,0,9,1,9
TRAV26-1,TRAJ38,CIAFAWAGINRTLIW,0,9,1,9
TRAV9-2,TRAJ35,CALSGGDFGNVLHC,0,9,1,9
TRAV41,TRAJ42,CAVDYGGSQGNLIF,0,9,1,9
TRAV9-2,TRAJ8,CALRDTGFRKLVF,0,9,1,9
TRAV13-1,TRAJ20,CAATLVRDYKLSF,0,9,1,9
TRAV26-2,TRAJ49,CILRDTGNQFYF,0,9,1,9
TRAV14DV4,TRAJ44,CAMREGRGGTGTASKLTF,0,8,1,8
TRAV8-3,TRAJ10,CAVVGLTGGGNKLTF,0,8,1,8
TRAV12-3,TRAJ45,CAMSVSGGGADGLTF,0,8,1,8
TRAV4,TRAJ6,CLVGDQPGGSYIPTF,0,8,1,8
TRAV4,TRAJ5,CLAPPEDTGRRALTF,0,8,1,8
TRAV16,TRAJ33,CALSGWDSNYQLIW,0,8,1,8
TRAV3,TRAJ37,CAVRPPSNTGKLIF,0,8,1,8
TRAV23DV6,TRAJ8,CAADMNTGFQKLVF,0,8,1,8
TRAV5,TRAJ13,CAEGPSGGYQKVTF,0,8,1,8
TRAV14DV4,TRAJ30,CAMGLRDDKIIF,0,8,1,8
TRAV14DV4,TRAJ43,CAMREDNNDMRF,0,8,1,8
TRAV16,TRAJ40,CALPGTCKYIF,0,8,1,8
TRAV9-2,TRAJ22,CALSDRAFSSGSARQLTF,0,8,1,8
TRAV41,TRAJ45,CAVGDEMYSGGGADGLTF,0,8,1,8
TRAV23DV6,TRAJ57,CAANSSHLQGGSEKLVF,0,8,1,8
TRAV4,TRAJ52,CLVGDPAGGTSYGKLTF,0,8,1,8
TRAV38-2DV8,TRAJ15,CAYRSASGQAGTALIF,0,8,1,8
TRAV9-2,TRAJ53,CALSDPGGGSNYKLTF,0,8,1,8
TRAV12-2,TRAJ52,CAVPNAGGTSYGKLTF,0,8,1,8
TRAV2,TRAJ20,CAVDPRRHFNDYKLSF,0,8,1,8
TRAV3,TRAJ45,CAVRDIRRGGADGLTF,0,8,1,8
TRAV8-3,TRAJ44,CAEGEGQDGTASKLTF,0,8,1,8
TRAV12-2,TRAJ42,CAVNRGYGGSQGNLIF,0,8,1,8
TRAV23DV6,TRAJ35,CAASGPMVGFGNVLHC,0,8,1,8
TRAV27,TRAJ45,CAGDGNSGGGADGLTF,0,8,1,8
TRAV27,TRAJ44,CAGGGLRAGTASKLTF,0,8,1,8
TRAV14DV4,TRAJ41,CAMREPSGYSGYALNF,0,8,1,8
TRAV14DV4,TRAJ49,CAMREGRFDTGNQFYF,0,8,1,8
TRAV26-2,TRAJ49,CILRDVGFTTGNQFYF,0,8,1,8
TRAV12-1,TRAJ28,CVVFLSGAGSYQLTF,0,8,1,8
TRAV21,TRAJ52,CAFLPGGTSYGKLTS,0,8,1,8
TRAV9-2,TRAJ53,CALSNSGGSNYKLTF,0,8,1,8
TRAV16,TRAJ56,CALSTYTGANSKLTF,0,8,1,8
TRAV8-3,TRAJ48,CAVGSINFGNEKLTF,0,8,1,8
TRAV22,TRAJ42,CAVEGDGGSQGNLIF,0,8,1,8
TRAV17,TRAJ53,CATDRSGGSNYKLTF,0,8,1,8
TRAV12-2,TRAJ52,CAASAGGTSYGKLTF,0,8,1,8
TRAV23DV6,TRAJ48,CAASGANFGNEKLTF,0,8,1,8
TRAV25,TRAJ42,CAGSNYGGSQGNLIF,0,8,1,8
TRAV14DV4,TRAJ23,CAMRFPYNQGGKLIF,0,8,1,8
TRAV12-3,TRAJ10,CAMKQAAGGGNKLTF,0,8,1,8
TRAV12-3,TRAJ39,CAILQLKDAGNMLTF,0,8,1,8
TRAV4,TRAJ5,CLVGGPGTGRRALTF,0,8,1,8
TRAV26-1,TRAJ23,CIVRTYYNQGGKLIF,0,8,1,8
TRAV26-1,TRAJ40,CIVRLFTSGTYKYIF,0,8,1,8
TRAV26-1,TRAJ23,CIVRVIYNQGGKLIF,0,8,1,8
TRAV16,TRAJ29,CALSRNSGNTPLVF,0,8,1,8
TRAV20,TRAJ57,CAVQAPGGSEKLVF,0,8,1,8
TRAV8-3,TRAJ17,CAVGARAAGNKLTF,0,8,1,8
TRAV21,TRAJ42,CAVSSRGSQGNLIF,0,8,1,8
TRAV17,TRAJ39,CATVDNNAGNMLTF,0,8,1,8
TRAV17,TRAJ27,CATGQNTNAGKSTF,0,8,1,8
TRAV13-1,TRAJ10,CAAEFTGGGNKLTF,0,8,1,8
TRAV13-1,TRAJ17,CAASPWAAGNKLTF,0,8,1,8
TRAV23DV6,TRAJ48,CAARGDFGNEKLTF,0,8,1,8
TRAV27,TRAJ50,CAGAKATSYDKVIF,0,8,1,8
TRAV5,TRAJ21,CAEPYTGNFNKFYF,0,8,1,8
TRAV5,TRAJ6,CAEDASGGSYIPTF,0,8,1,8
TRAV12-3,TRAJ5,CAMSAHTGRRALTF,0,8,1,8
TRAV14DV4,TRAJ40,CAMREGRGTYKYIF,0,8,1,8
TRAV26-2,TRAJ13,CILTNSGGYQKVTF,0,8,1,8
TRAV26-2,TRAJ58,CILMKETSGSRLTF,0,8,1,8
TRAV9-2,TRAJ43,CALSSSNNNDMRF,0,8,1,8
TRAV9-2,TRAJ56,CALRHGANSKLTF,0,8,1,8
TRAV9-2,TRAJ43,CARIQRDNNDMRF,0,8,1,8
TRAV3,TRAJ26,CAVRDNYGQNFVF,0,8,1,8
TRAV21,TRAJ40,CAVGVGGTYKYIF,0,8,1,8
TRAV2,TRAJ34,CAVELPNTDKLIF,0,8,1,8
TRAV21,TRAJ49,CAVSFVTGNQFYF,0,8,1,8
TRAV17,TRAJ41,CATDENSGYALNF,0,8,1,8
TRAV24,TRAJ50,CAFIETSYDKVIF,0,8,1,8
TRAV12-2,TRAJ7,CAVLDYGNNRLAF,0,8,1,8
TRAV12-2,TRAJ21,CAVNPYNFNKFYF,0,8,1,8
TRAV8-1,TRAJ37,CAVKSGNTGKLIF,0,8,1,8
TRAV21,TRAJ58,CAAKETSGSRLTF,0,12,1,12
TRAV13-1,TRAJ17,CAASTAAGNKLTF,0,8,1,8
TRAV13-1,TRAJ13,CAASKGGYQKVTF,0,8,1,8
TRAV27,TRAJ22,CAGGSGSARQLTF,0,8,1,8
TRAV27,TRAJ22,CAGARGSARQLTF,0,8,1,8
TRAV12-3,TRAJ7,CAMEAYGNNRLAF,0,8,1,8
TRAV14DV4,TRAJ43,CAMRDGNNNDMRF,0,8,1,8
TRAV4,TRAJ31,CLVGTNNNARLMF,0,8,1,8
TRAV9-2,TRAJ6,CVSPGGSYIPTF,0,8,1,8
TRAV9-2,TRAJ49,CALGFTGNQFYF,0,8,1,8
TRAV21,TRAJ9,CAVYTGGFKTIF,0,8,1,8
TRAV25,TRAJ15,CAVNQAGTALIF,0,8,1,8
TRAV29DV5,TRAJ49,CAADLTGNQFYF,0,8,1,8
TRAV23DV6,TRAJ11,CAARRGYSTLTF,0,8,1,8
TRAV23DV6,TRAJ49,CAAKGTGNQFYF,0,8,1,8
TRAV27,TRAJ30,CAGLWGDDKIIF,0,8,1,8
TRAV38-2DV8,TRAJ26,CAYNYGQNFVF,0,8,1,8
TRAV21,TRAJ20,CAVLLDYKLSF,0,8,1,8
TRAV17,TRAJ22,CATGSARQLTF,0,8,1,8
TRAV17,TRAJ24,CATDSWGKLQF,0,8,1,8
TRAV16,TRAJ7,CGYYGNNRLAF,0,8,1,8
TRAV5,TRAJ47,CAENGNKLVF,0,8,1,8
TRAV13-1,TRAJ20,SAAESGKLSF,0,8,1,8
TRAV27,TRAJ53,CAGAESGDSNYKLTF,0,8,1,8
TRAV8-3,TRAJ20,CAVGARSNDYKLSS,0,8,1,8
TRAV2,TRAJ42,CAVEDGGSQGNLIF,0,8,1,8
TRAV12-2,TRAJ42,CAVNYGGSQGNLIF,0,8,1,8
TRAV16,TRAJ26,CALSGYGQNFVF,0,8,1,8
TRAV2,TRAJ23,CAVRDQGGKLIF,0,8,1,8
TRAV26-2,TRAJ52,CIPFNAGGTSYGKLTF,0,8,1,8
TRAV8-4,TRAJ40,CAVSSYTSGTYKYIF,0,8,1,8
TRAV12-1,TRAJ10,CVVTLTGGGNKLTF,0,8,1,8
TRAV27,TRAJ23,CAGTLDIQGGKLIF,0,8,1,8
TRAV23DV6,TRAJ22,CAARPISSGSARQLTF,0,7,1,7
TRAV3,TRAJ23,CAVRDRYNQGGKLIF,0,7,1,7
TRAV38-2DV8,TRAJ49,CAYRSKNTGNQFYF,0,7,1,7
TRAV8-6,TRAJ58,CAVRETSGSRLTF,0,7,1,7
TRAV17,TRAJ17,CATIKAAGDKLTF,0,7,1,7
TRAV9-2,TRAJ29,CALRTRAPLVF,0,7,1,7
TRAV13-2,TRAJ6,CAENGATGNQFYFGTGTSLTVIPRGSYIPTF,0,7,1,7
TRAV13-2,TRAJ52,CAENANEVPNAGGTSYGKLTF,0,7,1,7
TRAV26-1,TRAJ10,CIVRVPLGLTGGGNKLTF,0,7,1,7
TRAV38-1,TRAJ28,CAFMKLYSGAGSYQLTF,0,7,1,7
TRAV8-3,TRAJ6,CAVGALPTSGGSYIPTF,0,7,1,7
TRAV13-1,TRAJ32,CAASRGNYGGATNKLIF,0,7,1,7
TRAV25,TRAJ45,CADAAPDSGGGADGLTF,0,7,1,7
TRAV26-1,TRAJ39,CIVRVEVVGNAGNMLTF,0,7,1,7
TRAV12-1,TRAJ17,CVVMAMIKAAGNKLTF,0,7,1,7
TRAV10,TRAJ42,CVVSEDYGGSQGNLIF,0,7,1,7
TRAV23DV6,TRAJ42,CASYMNYGGSQGNLIF,0,7,1,7
TRAV16,TRAJ44,CALEGSNTGTASKLTF,0,7,1,7
TRAV9-2,TRAJ4,CALTDRVSGGYNKLIF,0,7,1,7
TRAV8-3,TRAJ4,CAVVSIFSGGYNKLIF,0,7,1,7
TRAV8-3,TRAJ44,CAVVLPNTGTASKLTF,0,7,1,7
TRAV8-3,TRAJ42,CAVGDPYGGSQGNLIF,0,7,1,7
TRAV3,TRAJ3,CAVRVVPGGSASKIIF,0,7,1,7
TRAV14DV4,TRAJ57,CAMRAYSQGGSEKLVF,0,7,1,7
TRAV4,TRAJ23,CLVGRGLYNQGGKLIF,0,7,1,7
TRAV4,TRAJ28,CHSTLYSGAGSYQLTF,0,7,1,7
TRAV26-2,TRAJ28,CILRGLSGAGSYQLTF,0,7,1,7
TRAV26-1,TRAJ38,CIVRAYNAGNNRKLIW,0,7,1,7
TRAV26-1,TRAJ22,CIVRVGSSGSARQLTF,0,7,1,7
TRAV27,TRAJ40,FLTPLHGHGTYKYIF,0,7,1,7
TRAV12-1,TRAJ4,CVVTLFSGGYNKLIF,0,7,1,7
TRAV12-1,TRAJ30,CVVNSAMNRDDKIIF,0,7,1,7
TRAV38-1,TRAJ30,CAFMIPPNRDDKIIF,0,7,1,7
TRAV9-2,TRAJ42,CALMNYGGSQGNLIF,0,7,1,7
TRAV9-2,TRAJ44,CALTALTGTASKLTF,0,7,1,7
TRAV9-2,TRAJ6,CALSAASGGSYIPTF,0,7,1,7
TRAV9-2,TRAJ27,CALSDPRTNAGKSTF,0,7,1,7
TRAV20,TRAJ37,CAVLRGSSNTGKLIF,0,7,1,7
TRAV22,TRAJ18,CAVPDRGSTLGRLYF,0,7,1,7
TRAV21,TRAJ58,CAVVLQETSGSRLTL,0,7,1,7
TRAV8-3,TRAJ42,CAVGSYGGSQGNLIF,0,7,1,7
TRAV2,TRAJ13,CAVEPPSGGYQKVTF,0,7,1,7
TRAV3,TRAJ39,CAVRDGGNAGNMLTF,0,7,1,7
TRAV17,TRAJ34,CATDLRSYNTDKLIF,0,7,1,7
TRAV8-3,TRAJ18,CALAGRGSTLGRLYF,0,7,1,7
TRAV12-1,TRAJ45,CAPSYSGGGADGLTF,0,7,1,7
TRAV12-2,TRAJ3,CAAPLSYSSASKIIF,0,7,1,7
TRAV13-1,TRAJ8,CAALDPNTGFQKLVF,0,7,1,7
TRAV29DV5,TRAJ40,CAATPDTSGTYKYIF,0,7,1,7
TRAV23DV6,TRAJ22,CAASPPGGSARQLTF,0,7,1,7
TRAV13-1,TRAJ44,CAASTGTGTASKLTF,0,7,1,7
TRAV25,TRAJ45,CAGPKSGGGADGLTF,0,7,1,7
TRAV27,TRAJ37,CAGARSSSNTGKLIF,0,7,1,7
TRAV14DV4,TRAJ29,CAMRESLSGNTPLVF,0,7,1,7
TRAV26-2,TRAJ48,CILTFRDFGNEKLTF,0,7,1,7
TRAV26-2,TRAJ45,CILPNSGGGADGLTF,0,7,1,7
TRAV26-1,TRAJ48,CIAPESNFGNEKLTF,0,7,1,7
TRAV26-1,TRAJ33,RIVRVRGDSNYQLIW,0,7,1,7
TRAV10,TRAJ9,CVVSLNTGGFKTIF,0,7,1,7
TRAV12-1,TRAJ5,CVVNMGTGRRALTF,0,7,1,7
TRAV38-2DV8,TRAJ37,CAYRRGGNTGKLIF,0,7,1,7
TRAV9-2,TRAJ6,CALLASGGSYIPTF,0,7,1,7
TRAV8-3,TRAJ4,CAVSLSGGYNKLIF,0,7,1,7
TRAV20,TRAJ16,CAVHLFENGQKLLF,0,7,1,7
TRAV8-3,TRAJ40,CAVASTSGTYKYIF,0,7,1,7
TRAV8-3,TRAJ27,CAVGHNTNAGKSTF,0,7,1,7
TRAV8-3,TRAJ39,CAVGDNNAGNMLTF,0,7,1,7
TRAV2,TRAJ34,CAVEALVRTDKLIF,0,7,1,7
TRAV12-2,TRAJ36,CAVREKTGANNLFF,0,7,1,7
TRAV41,TRAJ33,CAAGTMDSNYQLIW,0,7,1,7
TRAV35,TRAJ41,CAGPHSNSGYALNF,0,7,1,7
TRAV12-2,TRAJ27,CAVRRGTNAGKSTF,0,7,1,7
TRAV12-2,TRAJ13,CAVSPPGGYQKVTF,0,7,1,7
TRAV12-2,TRAJ21,CAVITLYNFNKFYF,0,7,1,7
TRAV36DV7,TRAJ17,CAASIKAAGNKLTF,0,7,1,7
TRAV29DV5,TRAJ42,CAPNYGGSQGNLIF,0,7,1,7
TRAV23DV6,TRAJ21,CAACGVYNFNKFYF,0,7,1,7
TRAV13-1,TRAJ43,CAATITYNNNDMRF,0,7,1,7
TRAV13-1,TRAJ10,CAASITGGGNKLTF,0,7,1,7
TRAV13-1,TRAJ49,CAASLLFTGNQFYF,0,7,1,7
TRAV23DV6,TRAJ34,CAASPTYNTDKLIF,0,7,1,7
TRAV29DV5,TRAJ41,CAARGPNSGYALNF,0,7,1,7
TRAV25,TRAJ13,CAGSISGGYQKVTF,0,7,1,7
TRAV12-3,TRAJ9,CAMTHITGGFKTIF,0,7,1,7
TRAV12-3,TRAJ21,CAMRSRNNFNKFYF,0,7,1,7
TRAV4,TRAJ29,CLVAERSGNTPLVF,0,7,1,7
TRAV26-1,TRAJ49,CIVRVKGTGNQFYF,0,7,1,7
TRAV12-1,TRAJ49,CVVNTNTGNQFYF,0,7,1,7
TRAV38-2DV8,TRAJ43,CAFLSYNNNDMRF,0,7,1,7
TRAV38-1,TRAJ31,CAFIDNNNARLMF,0,7,1,7
TRAV38-2DV8,TRAJ29,CAYRNSGNTPLVF,0,7,1,7
TRAV38-2DV8,TRAJ37,CAHGSSNTGKLIF,0,7,1,7
TRAV8-3,TRAJ7,CAVPYYGNSRLAF,0,7,1,7
TRAV21,TRAJ17,CAVPQAAGNKLTS,0,7,1,7
TRAV8-3,TRAJ9,CAVGATGGFKTIF,0,7,1,7
TRAV2,TRAJ16,CAVEVLDGQKLLF,0,7,1,7
TRAV8-3,TRAJ39,CAVINNAGNMLTF,0,7,1,7
TRAV21,TRAJ57,CAVTLGGSEKLVF,0,7,1,7
TRAV21,TRAJ36,CAVRDPGANNLFF,0,7,1,7
TRAV12-2,TRAJ39,CAVNNNAGNMLTF,0,7,1,7
TRAV21,TRAJ37,CAVCSSNTGKLIF,0,7,1,7
TRAV21,TRAJ40,CAASTSGTYKYIF,0,7,1,7
TRAV35,TRAJ49,CAGQQNTGNQFYF,0,7,1,7
TRAV17,TRAJ37,CATDASNTGKLIF,0,7,1,7
TRAV2,TRAJ39,CAVDNNAGNMLTF,0,7,1,7
TRAV13-2,TRAJ3,CAAMYSSASKIIF,0,7,1,7
TRAV13-1,TRAJ6,CAALKGGSYIPTF,0,7,1,7
TRAV29DV5,TRAJ13,CAALAGGYQKVTF,0,7,1,7
TRAV13-1,TRAJ27,CAASPTNAGKSTF,0,7,1,7
TRAV13-1,TRAJ33,CAASNWGNYQLIW,0,7,1,7
TRAV13-1,TRAJ41,CAASKNSGYALNF,0,7,1,7
TRAV23DV6,TRAJ40,CAASWAGTYKYIF,0,7,1,7
TRAV13-1,TRAJ20,CAASRPNDYKLSF,0,7,1,7
TRAV23DV6,TRAJ33,CAASMLSNYQLIW,0,7,1,7
TRAV27,TRAJ42,CAGAGGSQGNLIF,0,7,1,7
TRAV27,TRAJ36,CAGDQTGANNLFF,0,7,1,7
TRAV25,TRAJ12,CAEPMDSSYKLIF,0,7,1,7
TRAV12-3,TRAJ10,CAMTTGGGNKLTF,0,7,1,7
TRAV12-2,TRAJ38,CATHAGNNRKLIW,0,7,1,7
TRAV4,TRAJ15,CLVGNQAGTALIF,0,7,1,7
TRAV30,TRAJ43,CGTERYNNNDMRF,0,7,1,7
TRAV26-1,TRAJ44,CIPQDGTASKLTF,0,7,1,7
TRAV25,TRAJ6,CPASGGSYIPTF,0,7,1,7
TRAV38-1,TRAJ43,CAFMKHADDMRF,0,7,1,7
TRAV6,TRAJ11,CALDPPGSTLTF,0,7,1,7
TRAV12-2,TRAJ21,CAVLYNFNKFYF,0,7,1,7
TRAV41,TRAJ29,CAVRSGNTPLVF,0,7,1,7
TRAV20,TRAJ26,CAVQNYGQNFVF,0,7,1,7
TRAV21,TRAJ49,CAVSSTGNQFYF,0,7,1,7
TRAV35,TRAJ49,CAGSTTGNQFYF,0,7,1,7
TRAV17,TRAJ45,CATSGGADGLTF,0,7,1,7
TRAV17,TRAJ4,CATDPSYNKLIF,0,7,1,7
TRAV12-2,TRAJ34,CAVNIPADKLIF,0,7,1,7
TRAV12-2,TRAJ43,CAVKNNNNDMRF,0,7,1,7
TRAV13-1,TRAJ43,CAASSHNNDMRF,0,7,1,7
TRAV13-1,TRAJ16,CAASVDGQKLLL,0,7,1,7
TRAV27,TRAJ33,CAGVGAAYQLIW,0,7,1,7
TRAV13-2,TRAJ20,CAENKSDYKLSF,0,7,1,7
TRAV12-3,TRAJ46,CAMKSSGDKLTF,0,7,1,7
TRAV13-1,TRAJ9,CATYTGGFKTIF,0,7,1,7
TRAV30,TRAJ43,CGTAYNNNDMRF,0,7,1,7
TRAV26-2,TRAJ29,CILRDRNTPLVF,0,7,1,7
TRAV26-1,TRAJ39,CIANNAGNMLTF,0,7,1,7
TRAV12-1,TRAJ43,CVALNNNDMRF,0,7,1,7
TRAV38-1,TRAJ24,CASESWGKLQF,0,7,1,7
TRAV12-3,TRAJ49,CAASRGNQFYF,0,7,1,7
TRAV12-2,TRAJ34,CAVGGTDKLIF,0,7,1,7
TRAV12-2,TRAJ20,CAAFNDYKLSF,0,7,1,7
TRAV27,TRAJ43,CADHNDMRF,0,7,1,7
TRAV16,TRAJ15,CALPAFNQAGTALIF,0,7,1,7
TRAV12-1,TRAJ37,CVVNISSNTGKLIF,0,7,1,7
TRAV5,TRAJ42,CAESNGGSQGNLIF,0,7,1,7
TRAV12-1,TRAJ22,CVVPPGSARQLTF,0,7,1,7
TRAV13-1,TRAJ9,CAASRDGGFKTIF,0,7,1,7
TRAV17,TRAJ45,CATDAFPDGLTF,0,7,1,7
TRAV20,TRAJ15,CAVQGRAEGDQAGTALIF,0,6,1,6
TRAV14DV4,TRAJ52,CAMREGHAGGTSYGKLTF,0,6,1,6
TRAV26-2,TRAJ52,CILRDENAGGTSYGKLTF,0,6,1,6
TRAV8-3,TRAJ42,CAVGGRPYGGSQGNLIF,0,6,1,6
TRAV3,TRAJ18,CAVGEPDRGSTLGRLYF,0,6,1,6
TRAV17,TRAJ28,CATAALYSGAGSYQLTF,0,6,1,6
TRAV29DV5,TRAJ53,CAATPGVGGGSNYKLTF,0,6,1,6
TRAV13-1,TRAJ45,CAASPMYSGGGADGLTF,0,6,1,6
TRAV14DV4,TRAJ40,CAMREGPRASGTYKYIF,0,6,1,6
TRAV26-1,TRAJ52,CIVRANAGGTSYGKLTF,0,6,1,6
TRAV38-2DV8,TRAJ32,CAYRVGYGGATNKLIF,0,6,1,6
TRAV20,TRAJ32,CAVQPNYGGATNKLIF,0,6,1,6
TRAV8-3,TRAJ18,CAVGTDRGSTLGRLYF,0,6,1,6
TRAV3,TRAJ18,CAVRDTRGSTLGRLYF,0,6,1,6
TRAV3,TRAJ5,CAVRDSPRTGRRALTF,0,6,1,6
TRAV23DV6,TRAJ53,CAASRSSGGSNYKLTF,0,6,1,6
TRAV14DV4,TRAJ46,CAMSPKKKSSGDKLTF,0,6,1,6
TRAV14DV4,TRAJ53,CAMREVIGGSNYKLTF,0,6,1,6
TRAV14DV4,TRAJ17,CAMREGLGAAGNKLTF,0,6,1,6
TRAV14DV4,TRAJ42,CAMREGLGGSQGNLIF,0,6,1,6
TRAV26-2,TRAJ45,CILRRPQGGGADGLTF,0,6,1,6
TRAV26-2,TRAJ45,CILRDVSGGGADGLTF,0,6,1,6
TRAV10,TRAJ48,CVVSSKAFGNEKLTF,0,6,1,6
TRAV12-1,TRAJ15,CVVNIVTQAGTALIF,0,6,1,6
TRAV38-2DV8,TRAJ56,CAYRTRTGANSKLTF,0,6,1,6
TRAV38-2DV8,TRAJ29,CAYRSAYSGNTPLVF,0,6,1,6
TRAV38-2DV8,TRAJ33,CAYRRSQDSNYQLIW,0,6,1,6
TRAV21,TRAJ10,CALLILTGGGNKLTF,0,6,1,6
TRAV19,TRAJ56,CALSRVTGANSKLTF,0,6,1,6
TRAV9-2,TRAJ6,CALSDLVGGSYIPTF,0,6,1,6
TRAV9-2,TRAJ45,CALRHSGGGADGLTF,0,6,1,6
TRAV9-2,TRAJ32,CALRNYGGATNKLIF,0,6,1,6
TRAV6,TRAJ4,CALAPFSGGYNKLIF,0,6,1,6
TRAV16,TRAJ27,CALSGSRTNAGKSTF,0,6,1,6
TRAV27,TRAJ54,CAPYEGIGGAQKLVF,0,6,1,6
TRAV20,TRAJ3,CAVLSGYSSASKIIF,0,6,1,6
TRAV41,TRAJ45,CAVNGRRGGADGLTF,0,6,1,6
TRAV20,TRAJ42,CAVQADRGSQGNLIF,0,6,1,6
TRAV8-3,TRAJ36,CAVGPSQTGANNLFF,0,6,1,6
TRAV8-3,TRAJ34,CAVGAASGNTDKLIF,0,6,1,6
TRAV3,TRAJ3,CAVRASYSSASKIIF,0,6,1,6
TRAV3,TRAJ4,CAVRDISGDYNKLIF,0,6,1,6
TRAV21,TRAJ53,CAVGFRGGSNYKLTF,0,6,1,6
TRAV12-2,TRAJ42,CAAMNYGGSQGNLIF,0,6,1,6
TRAV17,TRAJ8,CATEKVNTGFQKLVF,0,6,1,6
TRAV12-2,TRAJ48,CAAPGGGFGNEKLTF,0,6,1,6
TRAV13-1,TRAJ15,CAASPTNQAGTALIF,0,6,1,6
TRAV29DV5,TRAJ10,CAASWGPGGGNKLTF,0,6,1,6
TRAV29DV5,TRAJ32,CAASAWRGATNKLIF,0,6,1,6
TRAV23DV6,TRAJ45,CAASIGRGGADGLTF,0,6,1,6
TRAV27,TRAJ47,CAGDRGMEYGNKLVF,0,6,1,6
TRAV13-2,TRAJ22,CAERGLSGSARQLTF,0,6,1,6
TRAV14DV4,TRAJ9,CAMREARRGGFKTIF,0,6,1,6
TRAV14DV4,TRAJ3,CAMRERYSSASKIIF,0,6,1,6
TRAV26-2,TRAJ28,CILRDSGAGSYQLTS,0,6,1,6
TRAV10,TRAJ3,CVVTVYSSASKIIF,0,6,1,6
TRAV38-1,TRAJ36,CAFESATGANNLFF,0,6,1,6
TRAV19,TRAJ38,CALVNAGNNRKLIW,0,6,1,6
TRAV9-2,TRAJ52,CALLGGTSYGKLTF,0,6,1,6
TRAV9-2,TRAJ13,CALGPSGGYQKVTF,0,6,1,6
TRAV19,TRAJ31,CALSEASNNARLMF,0,6,1,6
TRAV6,TRAJ3,CALDGYSSASKIIF,0,6,1,6
TRAV16,TRAJ15,CALSAVQAGTALIF,0,6,1,6
TRAV9-2,TRAJ53,CALRSGGSNYNLTF,0,6,1,6
TRAV21,TRAJ5,CAVGMDTGRRALTF,0,6,1,6
TRAV41,TRAJ42,CAVRSGGSQGNLIF,0,6,1,6
TRAV2,TRAJ13,CAVEDLGGYQKVTF,0,6,1,6
TRAV21,TRAJ26,CAVSSDNYGQNFVF,0,6,1,6
TRAV3,TRAJ35,CAVRAIGFGNVLHC,0,6,1,6
TRAV3,TRAJ21,CAVRDIDNFNKFYF,0,6,1,6
TRAV17,TRAJ42,CATPFKGSQGNLIF,0,6,1,6
TRAV17,TRAJ16,CATAGFSDGQKLLF,0,6,1,6
TRAV17,TRAJ29,CATDAGSGNTPLVF,0,6,1,6
TRAV24,TRAJ54,CAFNLIQGAQKLVF,0,6,1,6
TRAV6,TRAJ31,CAPPEGENNARLMF,0,6,1,6
TRAV39,TRAJ22,CAVDRSGSARQLTF,0,6,1,6
TRAV39,TRAJ6,CAVDTTGGSYIPTF,0,6,1,6
TRAV8-1,TRAJ10,CAVISTGGGNKLTF,0,6,1,6
TRAV23DV6,TRAJ23,CAASRDNQGGKLIF,0,6,1,6
TRAV13-1,TRAJ57,CAAYYQGGSEKLVF,0,6,1,6
TRAV23DV6,TRAJ10,CAAVITGGGNKLTF,0,6,1,6
TRAV23DV6,TRAJ13,CAARHSGGYQKVTF,0,6,1,6
TRAV23DV6,TRAJ11,CAAALNPGYSTLTF,0,6,1,6
TRAV23DV6,TRAJ29,CAAGEFSGNTPLVF,0,6,1,6
TRAV13-1,TRAJ15,CAATDYQAGTALIF,0,6,1,6
TRAV29DV5,TRAJ41,CAASHLSSGYALNF,0,6,1,6
TRAV29DV5,TRAJ42,CAASDSRSQGNLIF,0,6,1,6
TRAV29DV5,TRAJ40,CAASESAGTYKYIF,0,6,1,6
TRAV29DV5,TRAJ23,CAASMNNQGGKLIF,0,6,1,6
TRAV23DV6,TRAJ37,CAASSPSNTGKLIF,0,6,1,6
TRAV29DV5,TRAJ47,CAARTREYGNKLVF,0,6,1,6
TRAV13-2,TRAJ40,CAEERTSGTYKYIF,0,6,1,6
TRAV13-2,TRAJ15,CAETPNQAGTALIF,0,6,1,6
TRAV13-2,TRAJ5,CAENKRTGRRALTF,0,6,1,6
TRAV12-3,TRAJ16,CAMSSFSDGQKLLF,0,6,1,6
TRAV12-3,TRAJ7,CAMSSYYGNNRLAF,0,6,1,6
TRAV12-3,TRAJ35,CAMSKGGFGNVLHC,0,6,1,6
TRAV12-3,TRAJ41,CAMRSTDSGYALNF,0,6,1,6
TRAV14DV4,TRAJ48,CAMRGPSGNEKLTF,0,6,1,6
TRAV14DV4,TRAJ30,CAMREILEDDKVIL,0,6,1,6
TRAV12-3,TRAJ17,CAMNIKAAGNKLTF,0,6,1,6
TRAV34,TRAJ29,CGAVVYSGNTPLVF,0,6,1,6
TRAV26-2,TRAJ37,CILKVSSNTGKLIF,0,6,1,6
TRAV26-1,TRAJ43,CIVRPRGGNNDMRF,0,6,1,6
TRAV26-1,TRAJ26,CIVRVMDYGQNFVF,0,6,1,6
TRAV10,TRAJ48,CVPSNFGNEKLTF,0,6,1,6
TRAV12-1,TRAJ8,CVVTPTGFQKLVF,0,6,1,6
TRAV10,TRAJ15,CVVSSQAGTALIF,0,6,1,6
TRAV12-1,TRAJ32,CVVNGGATNKLIF,0,6,1,6
TRAV12-1,TRAJ39,CVVKENAGNMLTF,0,6,1,6
TRAV38-2DV8,TRAJ54,CAYRKQGAQKLVF,0,6,1,6
TRAV9-2,TRAJ4,CALSKGGYNKLIF,0,6,1,6
TRAV6,TRAJ7,CALGSWSNNRLAF,0,6,1,6
TRAV6,TRAJ30,CALDEGRDDKIIF,0,6,1,6
TRAV16,TRAJ34,CALSGYNTDKLIF,0,6,1,6
TRAV20,TRAJ37,CAVGGGNTGKLIF,0,6,1,6
TRAV36DV7,TRAJ26,CAVSPLEGQNFVF,0,6,1,6
TRAV21,TRAJ45,CAVPPPGADGLTF,0,6,1,6
TRAV3,TRAJ9,CAVRNTGGFKTIF,0,12,1,12
TRAV2,TRAJ22,CAVVSGSARQLTF,0,6,1,6
TRAV2,TRAJ42,CAVVGGSQGNLIF,0,6,1,6
TRAV8-3,TRAJ9,CAVASTGGFKTIF,0,6,1,6
TRAV8-3,TRAJ36,CAVGAGGANNLFF,0,6,1,6
TRAV22,TRAJ6,CAVGSGGSYIPTF,0,6,1,6
TRAV22,TRAJ57,CAVEGGASEKLVF,0,6,1,6
TRAV22,TRAJ36,CAVRWAGANNLFF,0,6,1,6
TRAV12-3,TRAJ39,CAVRGNAGNMLTF,0,6,1,6
TRAV3,TRAJ34,CAVRDYNTDKLIF,0,6,1,6
TRAV3,TRAJ3,CAVRDGGASKIIF,0,6,1,6
TRAV21,TRAJ11,CAVNYSGYSTLTF,0,6,1,6
TRAV17,TRAJ12,CAAAMDSSYKLIF,0,6,1,6
TRAV13-1,TRAJ53,CASSGGSNYKLTF,0,6,1,6
TRAV36DV7,TRAJ40,CALSTSGTYKYIF,0,6,1,6
TRAV12-2,TRAJ22,CAVSSGSARQLTF,0,6,1,6
TRAV8-3,TRAJ26,CAVWDNYGQNFVL,0,6,1,6
TRAV39,TRAJ49,CAVDIATGNQFYF,0,6,1,6
TRAV25,TRAJ33,CAGVGDSNYQLIW,0,6,1,6
TRAV23DV6,TRAJ38,CAASAGNNRKLIW,0,6,1,6
TRAV23DV6,TRAJ3,CAASDSSASKIIF,0,6,1,6
TRAV27,TRAJ15,CAGLKWAGTALIF,0,6,1,6
TRAV25,TRAJ42,CAGPGGSQGNLIF,0,6,1,6
TRAV27,TRAJ40,CAGYKSGTYKYIF,0,6,1,6
TRAV5,TRAJ29,CAESFSGNTPLVF,0,6,1,6
TRAV13-2,TRAJ9,CAENYTGGFKTIF,0,6,1,6
TRAV12-3,TRAJ34,CAMGDYNTDKLIF,0,6,1,6
TRAV14DV4,TRAJ8,CAMTHTGFQKLVF,0,6,1,6
TRAV12-3,TRAJ42,CAMSRGSQGNLIF,0,6,1,6
TRAV26-2,TRAJ26,CPPALNYGQNFVF,0,6,1,6
TRAV26-1,TRAJ41,CIVPPGSGYALNF,0,6,1,6
TRAV26-1,TRAJ56,CIATLGANSKLTF,0,6,1,6
TRAV26-1,TRAJ48,CIAPRFGNEKLTF,0,6,1,6
TRAV12-1,TRAJ43,CVVPRGGNDMRF,0,6,1,6
TRAV9-2,TRAJ33,CALRDSNYQLIW,0,6,1,6
TRAV9-2,TRAJ21,CALRRNFNKFYF,0,6,1,6
TRAV23DV6,TRAJ37,CAVSSNTGKLIF,0,6,1,6
TRAV20,TRAJ27,CAVRANAGKSTF,0,6,1,6
TRAV8-3,TRAJ40,CAVGTGTYKYIF,0,6,1,6
TRAV8-3,TRAJ16,CAVDTDGQKLLF,0,6,1,6
TRAV22,TRAJ47,CAVERGGNKLVF,0,6,1,6
TRAV2,TRAJ6,CAVEGGSYIPTF,0,6,1,6
TRAV12-2,TRAJ39,CAVRRAGNMLTF,0,6,1,6
TRAV1-2,TRAJ33,CAVRDSNYQLIW,0,10,1,10
TRAV2,TRAJ30,CAARPRDDKIIF,0,6,1,6
TRAV29DV5,TRAJ58,CAEETSGSRLTF,0,6,1,6
TRAV17,TRAJ41,CATSKSGYALNF,0,6,1,6
TRAV17,TRAJ34,CATDPDTDKLIF,0,6,1,6
TRAV17,TRAJ12,CATMDSSYKLIF,0,6,1,6
TRAV20,TRAJ21,CAFQNNFNKFYF,0,6,1,6
TRAV12-2,TRAJ27,CAVSTNAGKSTF,0,6,1,6
TRAV13-1,TRAJ21,CAASRAFNKFYF,0,6,1,6
TRAV27,TRAJ16,CAGLLDGQKLLF,0,6,1,6
TRAV25,TRAJ40,CAGPTGTYKYIF,0,6,1,6
TRAV25,TRAJ39,CAGRGAGNMLTF,0,6,1,6
TRAV13-2,TRAJ43,CAETMNNNDMRF,0,6,1,6
TRAV13-2,TRAJ31,CAESSNNARLMF,0,6,1,6
TRAV12-3,TRAJ48,CAINFGNEKLTF,0,6,1,6
TRAV14DV4,TRAJ49,CAMREVIDQFYF,0,6,1,6
TRAV4,TRAJ29,CLVREGNTPLVF,0,6,1,6
TRAV26-1,TRAJ16,CIVSSYGQKLLF,0,6,1,6
TRAV25,TRAJ28,CSGAGSYQLTF,0,6,1,6
TRAV9-2,TRAJ21,CALRNFSKFYF,0,6,1,6
TRAV9-2,TRAJ29,CALRTQAPLVF,0,6,1,6
TRAV12-3,TRAJ34,CAPDNTDKLIF,0,6,1,6
TRAV41,TRAJ43,CAVRGNSDMRF,0,6,1,6
TRAV12-3,TRAJ49,CAVMTVGQFYF,0,6,1,6
TRAV20,TRAJ49,CAAGSPHQFYF,0,6,1,6
TRAV41,TRAJ34,CAADNTDKLIF,0,6,1,6
TRAV24,TRAJ31,CAFGNNARLMF,0,6,1,6
TRAV16,TRAJ30,CAPRGNDKIIF,0,6,1,6
TRAV12-2,TRAJ43,CAVSNNNDMRF,0,6,1,6
TRAV12-2,TRAJ49,CAVNDGNQSYF,0,6,1,6
TRAV12-2,TRAJ16,CAAGDGQKLLF,0,6,1,6
TRAV16,TRAJ16,CAPVRGQKLLF,0,6,1,6
TRAV13-2,TRAJ29,CADGGNTPLVF,0,6,1,6
TRAV23DV6,TRAJ29,CAARGNTPLVF,0,6,1,6
TRAV30,TRAJ43,CGTERNNDMRF,0,6,1,6
TRAV13-1,TRAJ22,CSGSARQLTF,0,6,1,6
TRAV3,TRAJ31,CALNNARLMF,0,6,1,6
TRAV17,TRAJ27,CATNAGKSTF,0,6,1,6
TRAV23DV6,TRAJ37,CAAYTGKLIF,0,6,1,6
TRAV14DV4,TRAJ43,CAMTVGGMRF,0,6,1,6
TRAV12-1,TRAJ43,CVVNLDMRF,0,6,1,6
TRAV25,TRAJ21,YNFNKFYF,0,6,1,6
TRAV26-1,TRAJ37,CIVRWLNGSSNTGKLIF,0,6,1,6
TRAV38-2DV8,TRAJ58,CAYRREETSGSRLTF,0,6,1,6
TRAV3,TRAJ30,CAVRGDMNRDDKIIF,0,6,1,6
TRAV3,TRAJ6,CAVRDIGGGSYIPTF,0,6,1,6
TRAV2,TRAJ17,CAVDLRAAGNKLTF,0,6,1,6
TRAV29DV5,TRAJ34,CAAPRSYNTDKLIF,0,6,1,6
TRAV23DV6,TRAJ34,CAASFLGTDKLIF,0,6,1,6
TRAV9-2,TRAJ29,CALDSGDTPLVF,0,6,1,6
TRAV26-1,TRAJ11,CIRGYSTLTF,0,6,1,6
TRAV13-1,TRAJ13,CAASPGPSGGCQKVTF,0,6,1,6
TRAV12-2,TRAJ42,CAVVAYGGSQGNLIF,0,6,1,6
TRAV20,TRAJ21,CAVQAKNNFDKFYF,0,6,1,6
TRAV9-2,TRAJ20,CALSDQGDYKLSF,0,6,1,6
TRAV16,TRAJ44,CALSSGTASKLTF,0,6,1,6
TRAV13-1,TRAJ26,CAACSDYGQNFVF,0,6,1,6
TRAV25,TRAJ57,CAGTQGGSEKLVF,0,6,1,6
TRAV5,TRAJ40,CAESTSGTYKYIF,0,6,1,6
TRAV12-3,TRAJ49,CAMSGYTGNQFYF,0,6,1,6
TRAV26-2,TRAJ47,CILRREYGNKLVF,0,6,1,6
TRAV5,TRAJ5,CAATGRRALTF,0,6,1,6
TRAV38-2DV8,TRAJ52,CAWTRNTNAGGTSYGKLTF,0,5,1,5
TRAV8-3,TRAJ38,CAAGPARREAGNNRKLIW,0,5,1,5
TRAV8-1,TRAJ52,CAVKLPNAGGTSYGKLTF,0,5,1,5
TRAV38-2DV8,TRAJ42,CAYRRGNYGGSQGNLIF,0,5,1,5
TRAV8-3,TRAJ37,CAVGGYDGSSNTGKLIF,0,5,1,5
TRAV2,TRAJ10,CAVEVGILTGGGNKLTF,0,5,1,5
TRAV3,TRAJ48,CAVRDYLSNFGNEKLTF,0,5,1,5
TRAV17,TRAJ53,CATDASDSGGSSYKLTF,0,5,1,5
TRAV17,TRAJ42,CATDRVYYGGSQGNLIF,0,5,1,5
TRAV39,TRAJ45,CAVNGGRSGGGADGLTF,0,5,1,5
TRAV13-1,TRAJ53,CAASWSNSGGSNYKLTF,0,5,1,5
TRAV23DV6,TRAJ17,CAASNYLIKAAGNKLTF,0,5,1,5
TRAV14DV4,TRAJ23,CAMRELPIYNQGGKLIF,0,5,1,5
TRAV4,TRAJ36,CLVGDPGYQTGANNLFF,0,5,1,5
TRAV26-2,TRAJ42,CILRDVDYGGSQGNLIF,0,5,1,5
TRAV26-1,TRAJ48,CIVRVPISNFGNEKLTF,0,5,1,5
TRAV26-1,TRAJ44,CIVRASFNTGTASKLTF,0,5,1,5
TRAV38-2DV8,TRAJ16,CAYRSASRLRGQKLLF,0,5,1,5
TRAV38-2DV8,TRAJ48,CAYRSTPNFGNEKLTF,0,5,1,5
TRAV9-2,TRAJ52,CALTDTGGTSYGKLTF,0,5,1,5
TRAV20,TRAJ52,CAVQARGGTSYGKLTF,0,5,1,5
TRAV3,TRAJ6,CAVSPNPPGGSYIPTF,0,5,1,5
TRAV21,TRAJ37,CAVNGSWSSNTGKLIF,0,5,1,5
TRAV12-2,TRAJ18,CAVNIDRGSTLGRLYF,0,5,1,5
TRAV13-1,TRAJ37,CAATPYGSSNTGKLIF,0,5,1,5
TRAV29DV5,TRAJ30,CAASDHSMNRDDKIIF,0,5,1,5
TRAV13-2,TRAJ53,CAENINSGGNNYKLTF,0,5,1,5
TRAV14DV4,TRAJ48,CAMQSVSNFGNEKLTF,0,5,1,5
TRAV12-3,TRAJ52,CAMSVAGGTSYGKLTF,0,5,1,5
TRAV14DV4,TRAJ17,CAMREAPKAAGNKLTF,0,5,1,5
TRAV34,TRAJ48,CGADILTNFGNEKLTF,0,5,1,5
TRAV4,TRAJ18,CLVGDPRGSTLGRLYF,0,5,1,5
TRAV4,TRAJ3,CLVGDMSYSSASKIIF,0,5,1,5
TRAV4,TRAJ6,CLVGDRASGGSYIPTF,0,5,1,5
TRAV26-1,TRAJ42,CIVSQDYGGSQGNLIF,0,5,1,5
TRAV10,TRAJ48,CVVTHSKVGNEKLTF,0,5,1,5
TRAV10,TRAJ42,CVVRPYGGSQGNLIF,0,5,1,5
TRAV12-1,TRAJ28,CVVNEPGAGSYQLTF,0,5,1,5
TRAV38-2DV8,TRAJ48,CAYILPNFGNEKLTF,0,5,1,5
TRAV38-2DV8,TRAJ44,CAYRSARGTASKLTF,0,5,1,5
TRAV9-2,TRAJ39,CALSDRNNAGNMLTF,0,5,1,5
TRAV19,TRAJ26,CALSEGSDYGQNFVL,0,5,1,5
TRAV9-2,TRAJ57,CALSPFQGGSEELVF,0,5,1,5
TRAV16,TRAJ9,CALSPQNTGGFKTIF,0,5,1,5
TRAV41,TRAJ44,CAVLRSAGTASKLTF,0,5,1,5
TRAV20,TRAJ10,CAVQPRTGGGSKLTF,0,5,1,5
TRAV2,TRAJ18,CAVGDRGSTLGRLYF,0,5,1,5
TRAV2,TRAJ17,CAVGAIKAAGNKLTF,0,5,1,5
TRAV2,TRAJ39,CAVEAPYRAGNMLTF,0,5,1,5
TRAV21,TRAJ45,CAVIGPGGGADGLTF,0,5,1,5
TRAV21,TRAJ48,CAVMFIKFGSEKLTF,0,5,1,5
TRAV21,TRAJ56,CAVRPWAGANSKLTF,0,5,1,5
TRAV21,TRAJ8,CAVRPMNTGFQKLVF,0,5,1,5
TRAV3,TRAJ39,CAVRGLNNAGNMLTF,0,5,1,5
TRAV41,TRAJ53,CAAPNSGGSNYKLTF,0,5,1,5
TRAV17,TRAJ52,CATEALGTSYGKLTF,0,5,1,5
TRAV12-2,TRAJ53,CAVNPTGGSNYKLTF,0,5,1,5
TRAV13-1,TRAJ22,CAACFHSGSARQLTF,0,5,1,5
TRAV23DV6,TRAJ5,CAAIPMDTGRRALTF,0,5,1,5
TRAV13-1,TRAJ27,CAASPAGTNAGKSTF,0,5,1,5
TRAV13-1,TRAJ7,CAASKENYGNNRLAF,0,5,1,5
TRAV29DV5,TRAJ34,CAASSFMGNTDKLIF,0,5,1,5
TRAV23DV6,TRAJ32,CAASSSGGATNKLIF,0,5,1,5
TRAV23DV6,TRAJ58,CAASIRETSGSRLTF,0,5,1,5
TRAV23DV6,TRAJ42,CAARTPLGSQGNLIF,0,5,1,5
TRAV14DV4,TRAJ3,CAMRDPYSSASKIIF,0,5,1,5
TRAV14DV4,TRAJ9,CAMREAYTGGFKTIF,0,5,1,5
TRAV14DV4,TRAJ17,CAMREAKAAGNKLTF,0,5,1,5
TRAV14DV4,TRAJ20,CAMREAISNDYKLSF,0,5,1,5
TRAV14DV4,TRAJ15,CAMREGDQAGTALIF,0,5,1,5
TRAV14DV4,TRAJ27,CAMREGDTNAGKSTF,0,5,1,5
TRAV14DV4,TRAJ23,CAMREAYNQGGKLIF,0,5,1,5
TRAV34,TRAJ13,CGGRLSSGGYQKVTF,0,5,1,5
TRAV12-2,TRAJ6,CTVNAAAGGSYIPTF,0,5,1,5
TRAV26-2,TRAJ53,CILRRSGGSNYKLTF,0,5,1,5
TRAV26-1,TRAJ13,CIVGALGGGYQKVTF,0,5,1,5
TRAV26-1,TRAJ42,CIVRVAGGSQGNLIF,0,5,1,5
TRAV12-1,TRAJ42,CVVFYGGSQGNLIF,0,5,1,5
TRAV10,TRAJ4,CVVGWAGGYNKLIF,0,5,1,5
TRAV38-1,TRAJ40,CAFMRTSGTYKYIF,0,5,1,5
TRAV38-2DV8,TRAJ34,CAYRSGYNTDKLIF,0,5,1,5
TRAV38-2DV8,TRAJ42,CAYRREGSQGNLIF,0,5,1,5
TRAV19,TRAJ10,CALTITGGGNKLTL,0,5,1,5
TRAV19,TRAJ33,CALSCMDSNYQLIW,0,5,1,5
TRAV9-2,TRAJ35,CALSDQGFGNVLHC,0,5,1,5
TRAV9-2,TRAJ17,CAQRIKAAGNKLTF,0,5,1,5
TRAV41,TRAJ38,CAVLNAGNNRKLIW,0,5,1,5
TRAV20,TRAJ29,CAVLTNSGNTPLVF,0,5,1,5
TRAV20,TRAJ36,CAVRAQTGANNLFF,0,5,1,5
TRAV20,TRAJ39,CAVQGFNAGNMLTF,0,5,1,5
TRAV8-3,TRAJ34,CAVGLSYNTDKLIF,0,5,1,5
TRAV8-3,TRAJ17,CAVGKQAAGNKLTF,0,5,1,5
TRAV2,TRAJ22,CAVEDKGSARQLTF,0,5,1,5
TRAV36DV7,TRAJ33,CAVEIRDSNYQLIW,0,5,1,5
TRAV3,TRAJ13,CAVRDEGGYQKVTF,0,5,1,5
TRAV36DV7,TRAJ45,CAVKSGGGADGLTF,0,5,1,5
TRAV17,TRAJ58,CATAQETSGSRLTF,0,5,1,5
TRAV17,TRAJ53,CATDGRSSNYKLTF,0,5,1,5
TRAV20,TRAJ38,CALCGAGNNRKLIW,0,5,1,5
TRAV9-2,TRAJ27,CALREGTNAGKSTF,0,5,1,5
TRAV12-2,TRAJ49,CAVHLTNTGNQFYF,0,5,1,5
TRAV12-2,TRAJ53,CAVIGGGSNYKLTF,0,5,1,5
TRAV12-2,TRAJ6,CAVIGSGGSYIPTF,0,5,1,5
TRAV12-2,TRAJ26,CAVRNWNYGQNFVF,0,5,1,5
TRAV39,TRAJ47,CAALSAPYGNKLVF,0,5,1,5
TRAV12-2,TRAJ13,CAGPGSGGYQRVTF,0,5,1,5
TRAV23DV6,TRAJ45,CAINSGGGADGLTF,0,5,1,5
TRAV13-1,TRAJ9,CAARSNTGGFKTIF,0,5,1,5
TRAV13-1,TRAJ16,CAAGAFSDGQKLLF,0,5,1,5
TRAV13-1,TRAJ21,CAATSPYNFNKFYF,0,5,1,5
TRAV23DV6,TRAJ20,CAATIRSNDYKLSF,0,5,1,5
TRAV13-1,TRAJ26,CAASMGNYGQNFVF,0,5,1,5
TRAV29DV5,TRAJ39,CAASASNAGNMLTF,0,5,1,5
TRAV23DV6,TRAJ48,CAASMSAGNEKLTF,0,5,1,5
TRAV23DV6,TRAJ36,CAASKYTGANNLFF,0,5,1,5
TRAV27,TRAJ17,CAGSIKAAGNKLTF,0,5,1,5
TRAV27,TRAJ22,CAGTSSGSARQLTF,0,5,1,5
TRAV13-2,TRAJ44,CAESDTGTASKLTF,0,5,1,5
TRAV5,TRAJ29,CAETLLSGNTPLVF,0,5,1,5
TRAV13-2,TRAJ20,CAENIEGSDYKLSF,0,5,1,5
TRAV12-3,TRAJ15,CAMSPNQAGTALIF,0,5,1,5
TRAV12-3,TRAJ15,CAMSASQAGTALIF,0,5,1,5
TRAV12-3,TRAJ21,CAMSALYNFNKFYF,0,5,1,5
TRAV14DV4,TRAJ5,CAMRSDTGRRALTF,0,5,1,5
TRAV14DV4,TRAJ20,CAMREPSNDYKLSF,0,5,1,5
TRAV14DV4,TRAJ43,CAMREKLRNNDMRF,0,5,1,5
TRAV14DV4,TRAJ53,CAMKGGGSNYKLTF,0,5,1,5
TRAV34,TRAJ29,CGAASNSGNTPLVF,0,5,1,5
TRAV4,TRAJ30,CLVGSMNRDDKIIF,0,5,1,5
TRAV26-2,TRAJ48,CILPTNFGNEKLTF,0,5,1,5
TRAV26-2,TRAJ57,CILSPRGGSEKLVF,0,5,1,5
TRAV26-1,TRAJ13,CIVRVMRGYQKVTF,0,5,1,5
TRAV20,TRAJ8,CVNGGTGFQKLVF,0,5,1,5
TRAV10,TRAJ36,CVVFQTGANNLFF,0,5,1,5
TRAV12-1,TRAJ8,CVVNPEGFQKLVF,0,5,1,5
TRAV12-1,TRAJ42,CVVNVGSQGNLIF,0,5,1,5
TRAV12-1,TRAJ29,CVVKNSGNTPLVF,0,5,1,5
TRAV12-1,TRAJ53,CVGSGGSNYKLTF,0,5,1,5
TRAV38-2DV8,TRAJ48,CAFPNFGNEKLTF,0,5,1,5
TRAV21,TRAJ43,CASQSYNNNDMRF,0,5,1,5
TRAV38-2DV8,TRAJ44,CAYIPGTASKLTF,0,5,1,5
TRAV38-2DV8,TRAJ21,CAYSVYNFNKFYF,0,5,1,5
TRAV38-2DV8,TRAJ26,CAYRSDYGQNFVF,0,5,1,5
TRAV9-2,TRAJ48,CALTNFGNEKLTF,0,5,1,5
TRAV9-2,TRAJ34,CALSARNTDKLIF,0,5,1,5
TRAV9-2,TRAJ16,CALSGRDGQKLLF,0,5,1,5
TRAV19,TRAJ39,CALSMNAGNMLTF,0,5,1,5
TRAV19,TRAJ3,CALRYSSASKIIF,0,5,1,5
TRAV6,TRAJ39,CALVARAGNMLTF,0,5,1,5
TRAV21,TRAJ16,CAPWFSDGQKLLF,0,5,1,5
TRAV9-2,TRAJ29,CARLSSGNTPLVY,0,5,1,5
TRAV20,TRAJ22,CAVLSGSARQLTF,0,5,1,5
TRAV21,TRAJ50,CAVPKTSYDKVIF,0,5,1,5
TRAV3,TRAJ39,CAVVLYAGNMLTF,0,5,1,5
TRAV21,TRAJ37,CAVGSSNTGKLIF,0,9,1,9
TRAV22,TRAJ53,CAVSGGSNYKLTF,0,5,1,5
TRAV41,TRAJ54,CAVFYQGAQKLVF,0,5,1,5
TRAV20,TRAJ43,CAVQAYNNNDMRF,0,5,1,5
TRAV20,TRAJ3,CAVQASSASKIIF,0,5,1,5
TRAV8-3,TRAJ34,CAVGARGTDKLIF,0,5,1,5
TRAV22,TRAJ15,CAVGPQAGTALIF,0,5,1,5
TRAV2,TRAJ16,CAVGFSDGQKLLF,0,5,1,5
TRAV2,TRAJ41,CAVGPNSGYALNF,0,5,1,5
TRAV21,TRAJ20,CAVGISNDYKLSF,0,5,1,5
TRAV20,TRAJ50,CAVGKTSYDKVIF,0,5,1,5
TRAV22,TRAJ12,CAVGMDSSYKLIF,0,8,1,8
TRAV2,TRAJ40,CAVDTSGTYKYIF,0,5,1,5
TRAV2,TRAJ26,CAVEGNYGQNFVF,0,5,1,5
TRAV8-3,TRAJ39,CAVSPNAGNMLTF,0,5,1,5
TRAV3,TRAJ5,CAVRVTGRRALTF,0,5,1,5
TRAV21,TRAJ57,CAVNKGGSEKLVF,0,5,1,5
TRAV21,TRAJ45,CAVKRGGADGLTF,0,5,1,5
TRAV17,TRAJ57,CATSQGGSEKLVS,0,5,1,5
TRAV17,TRAJ34,CATARYNTDKLIF,0,5,1,5
TRAV17,TRAJ49,CATGSNTGNQFYF,0,5,1,5
TRAV17,TRAJ20,CATGGKDDYKLSF,0,5,1,5
TRAV17,TRAJ39,CATEPNAGNMLTF,0,5,1,5
TRAV17,TRAJ37,CATRLRNTGKLIF,0,5,1,5
TRAV12-2,TRAJ5,CALPDTGRRALTF,0,5,1,5
TRAV8-1,TRAJ38,CAVNAGNNRKLIW,0,5,1,5
TRAV12-2,TRAJ38,CAVHAGNNRKLIW,0,5,1,5
TRAV12-2,TRAJ6,CAVRPGGSYIPTF,0,5,1,5
TRAV29DV5,TRAJ29,CAAPLSGNTPLVF,0,5,1,5
TRAV23DV6,TRAJ54,CAASGRGAQKLVF,0,5,1,5
TRAV12-3,TRAJ38,CAFNAGNNRKLIW,0,5,1,5
TRAV12-3,TRAJ13,CALYSGGYQKVTF,0,5,1,5
TRAV13-1,TRAJ33,CAALRDSNYQLIW,0,5,1,5
TRAV25,TRAJ34,CAARSYNTDKLIF,0,5,1,5
TRAV29DV5,TRAJ39,CAASRNAGNMLTF,0,5,1,5
TRAV13-1,TRAJ50,CAASEASYDKVIF,0,5,1,5
TRAV13-1,TRAJ48,CAASNFGNEKLTF,0,5,1,5
TRAV13-1,TRAJ47,CAASNRYGNKLVF,0,5,1,5
TRAV13-1,TRAJ27,CAASKTNAGKSTF,0,5,1,5
TRAV23DV6,TRAJ35,CAASLNFGNVLHC,0,5,1,5
TRAV23DV6,TRAJ31,CAASIGGNARLMF,0,5,1,5
TRAV23DV6,TRAJ50,CAASKTSYDKVIF,0,5,1,5
TRAV23DV6,TRAJ22,CAARAGSARQLTF,0,5,1,5
TRAV25,TRAJ40,CAGYTSGTYKYIF,0,5,1,5
TRAV27,TRAJ57,CAGPGGGSEKLVF,0,5,1,5
TRAV27,TRAJ16,CAGGISDGQKLLF,0,5,1,5
TRAV25,TRAJ38,CAGSAGNNRKLIW,0,5,1,5
TRAV27,TRAJ33,CAGALGSNYQLIW,0,5,1,5
TRAV27,TRAJ54,CAGTPPGAQKLVF,0,5,1,5
TRAV13-2,TRAJ21,CAENIRDFNKFYF,0,5,1,5
TRAV12-3,TRAJ15,CAIRNQAGTALIF,0,5,1,5
TRAV12-3,TRAJ22,CAMPRGSARQLTF,0,5,1,5
TRAV12-3,TRAJ49,CAMSAGTGNQFYF,0,5,1,5
TRAV12-3,TRAJ49,CAMSERTGNQFYF,0,5,1,5
TRAV12-3,TRAJ36,CAMSNTGANDLFF,0,5,1,5
TRAV12-3,TRAJ11,CAMRESGYSTLTF,0,5,1,5
TRAV14DV4,TRAJ6,CAMRDGGSYIPTF,0,5,1,5
TRAV14DV4,TRAJ13,CAMREVGYQKVTF,0,5,1,5
TRAV4,TRAJ15,CLVVNQAGTALIF,0,5,1,5
TRAV4,TRAJ33,CLVGAQSNYQLIW,0,5,1,5
TRAV4,TRAJ34,CLVGAYNTDKLIF,0,5,1,5
TRAV4,TRAJ6,CLVGAGGSYIPTF,0,5,1,5
TRAV26-2,TRAJ17,CILTKAAGNKLTF,0,5,1,5
TRAV26-1,TRAJ42,CIDYGGSQGNLIF,0,5,1,5
TRAV21,TRAJ20,CVVRPYDYKLSF,0,5,1,5
TRAV12-1,TRAJ17,CVVKAAGNKLTF,0,5,1,5
TRAV12-1,TRAJ36,CVVDGGANNLFF,0,5,1,5
TRAV10,TRAJ37,CVVSGNTGKLIF,0,5,1,5
TRAV12-1,TRAJ11,CVVNGGYSTLTF,0,5,1,5
TRAV12-1,TRAJ37,CVVKGNTGKLIF,0,5,1,5
TRAV38-1,TRAJ34,CAFGSYTDKLIF,0,5,1,5
TRAV9-2,TRAJ9,CALRTGGFKTIF,0,9,1,9
TRAV19,TRAJ27,CALETNAGKSTF,0,5,1,5
TRAV19,TRAJ40,CALRKGTYKYIF,0,5,1,5
TRAV6,TRAJ23,CALYNQGGKLIF,0,5,1,5
TRAV36DV7,TRAJ27,CALGTNAGKSTF,0,5,1,5
TRAV16,TRAJ48,CALTPGNEKLTF,0,5,1,5
TRAV16,TRAJ35,CALKGFGNVLHC,0,5,1,5
TRAV36DV7,TRAJ34,CAPRRGADKLIF,0,5,1,5
TRAV20,TRAJ7,CARVHGNNRLAF,0,5,1,5
TRAV41,TRAJ33,CAVGRSNYQLIW,0,5,1,5
TRAV20,TRAJ43,CAVRLNNNDMRF,0,5,1,5
TRAV12-2,TRAJ36,CAVRGGANNLFF,0,5,1,5
TRAV8-3,TRAJ48,CAVGDGNEKLTF,0,5,1,5
TRAV12-2,TRAJ26,CAVSDYGQNFVF,0,5,1,5
TRAV8-4,TRAJ53,CAVSEGNYKLTF,0,5,1,5
TRAV17,TRAJ15,CATPETGTALIF,0,5,1,5
TRAV17,TRAJ34,CATDLLSDKLIF,0,5,1,5
TRAV17,TRAJ20,CATDADDCKLSF,0,5,1,5
TRAV13-1,TRAJ39,CAPRDAGNMLTF,0,5,1,5
TRAV23DV6,TRAJ24,CAPTDSWGKLQF,0,5,1,5
TRAV12-2,TRAJ36,CAVQTGANNLFF,0,5,1,5
TRAV39,TRAJ41,CAVDDSGYALNF,0,5,1,5
TRAV36DV7,TRAJ43,CAVGYNNNDMRF,0,9,1,9
TRAV13-2,TRAJ16,CARRSDGQKLLF,0,5,1,5
TRAV29DV5,TRAJ48,CAAYFGNEKLTF,0,5,1,5
TRAV13-1,TRAJ48,CAAGFGNEKLTF,0,9,1,9
TRAV13-1,TRAJ34,CAAILNTDKLIF,0,5,1,5
TRAV23DV6,TRAJ29,CAARTGNTPLVF,0,5,1,5
TRAV13-1,TRAJ29,CAGCSGNTPLVF,0,5,1,5
TRAV25,TRAJ41,CAGPNSGYALNF,0,5,1,5
TRAV13-2,TRAJ37,CAEPSNTGKLIF,0,5,1,5
TRAV5,TRAJ7,CAEKEGNNRLAF,0,5,1,5
TRAV12-3,TRAJ17,CAMSKQGNKLTF,0,5,1,5
TRAV12-3,TRAJ42,CAMGGSQGNLIF,0,5,1,5
TRAV30,TRAJ30,CGTWERDDKIIF,0,5,1,5
TRAV30,TRAJ20,CGTVSNDYKLSF,0,5,1,5
TRAV26-2,TRAJ40,CILFSGTYKYIS,0,5,1,5
TRAV26-2,TRAJ36,CIPHGGANNLFF,0,5,1,5
TRAV26-1,TRAJ28,CIVEAGSYQLTF,0,5,1,5
TRAV13-1,TRAJ35,CLIGFGNVLHC,0,5,1,5
TRAV17,TRAJ50,CRKTSYDKVIF,0,5,1,5
TRAV2,TRAJ21,CASYNFNKFYF,0,5,1,5
TRAV12-2,TRAJ15,CACQAGTALIF,0,5,1,5
TRAV9-2,TRAJ3,CALSSASKIIF,0,5,1,5
TRAV21,TRAJ49,CAVMSVGQFYF,0,5,1,5
TRAV35,TRAJ49,CAGVTGNQFYF,0,5,1,5
TRAV12-2,TRAJ20,CAVTGGYKLSF,0,5,1,5
TRAV13-1,TRAJ43,CAASFIGDMRF,0,5,1,5
TRAV27,TRAJ34,CAGVYTDKLIF,0,5,1,5
TRAV27,TRAJ21,CAGDNFNKFYF,0,5,1,5
TRAV5,TRAJ29,CAESGNTPLVF,0,5,1,5
TRAV12-3,TRAJ9,CAMGGGFKTIF,0,5,1,5
TRAV34,TRAJ49,CGTSTGNQFYF,0,5,1,5
TRAV16,TRAJ13,CAPLEQNVTF,0,5,1,5
TRAV17,TRAJ49,CATVYNQFYF,0,5,1,5
TRAV12-2,TRAJ20,CAVSLNKLSF,0,5,1,5
TRAV13-1,TRAJ49,CAASRGQFYF,0,5,1,5
TRAV13-1,TRAJ37,CAANTGKLIF,0,5,1,5
TRAV8-3,TRAJ9,CAPYFKTIF,0,5,1,5
TRAV26-1,TRAJ20,CIVGYKLSF,0,5,1,5
TRAV6,TRAJ37,FTTGKLIF,0,5,1,5
TRAV38-2DV8,TRAJ28,CAYRLLYSGAGSYQLTF,0,5,1,5
TRAV4,TRAJ28,CLVGDKYSGAGSYHLTF,0,5,1,5
TRAV17,TRAJ32,CATEVSYGGATNKLIF,0,5,1,5
TRAV3,TRAJ12,CAVRVRMDSSYKLIF,0,5,1,5
TRAV30,TRAJ3,CGTGFGYSSASKIIF,0,5,1,5
TRAV38-2DV8,TRAJ57,CAYSLQGGSEKLVF,0,5,1,5
TRAV2,TRAJ45,CAVEGGGGADGLTF,0,5,1,5
TRAV8-4,TRAJ4,CAVSHSGGYNKLIF,0,5,1,5
TRAV21,TRAJ15,CAVRRNQAGTALIF,0,5,1,5
TRAV12-2,TRAJ6,CAVTESGGSYIPTF,0,5,1,5
TRAV29DV5,TRAJ49,CAAMGSTGNLFYF,0,5,1,5
TRAV12-1,TRAJ16,CVPRDGQKLLF,0,5,1,5
TRAV29DV5,TRAJ31,CAASDARLMF,0,5,1,5
TRAV38-2DV8,TRAJ52,CAYRSAGVRAGGTSYGKLTF,0,4,1,4
TRAV12-2,TRAJ52,CAVNRAPGAGGSSYGKLTF,0,4,1,4
TRAV12-2,TRAJ24,CAVNRRCLTTDSWGKLQF,0,4,1,4
TRAV23DV6,TRAJ48,CAASLASISNFGNEKLTF,0,4,1,4
TRAV13-1,TRAJ38,CAASIHRYYAGNNRKLIW,0,4,1,4
TRAV13-1,TRAJ48,CAASRPLLSNFGNEKLTF,0,4,1,4
TRAV14DV4,TRAJ28,CAMRELSYSGAGSYQLTF,0,4,1,4
TRAV14DV4,TRAJ48,CAMREGGVSNFGNEKLTF,0,4,1,4
TRAV9-2,TRAJ52,CALSVRAGGTSYGKLTS,0,4,1,4
TRAV8-3,TRAJ38,CAVGPTTYAGNNRKLIW,0,4,1,4
TRAV8-3,TRAJ18,CAVGARDRGSTLGRLYF,0,4,1,4
TRAV12-2,TRAJ52,CAVSTNAGGTSYGKLTF,0,4,1,4
TRAV3,TRAJ4,CAVRDMITSGVYNKLIF,0,4,1,4
TRAV39,TRAJ42,CAVVTLNYGGSQGNLIF,0,4,1,4
TRAV13-1,TRAJ18,CAASTPDRGSTLGRLYF,0,4,1,4
TRAV29DV5,TRAJ42,CAARVMNYGGSQGNLIF,0,4,1,4
TRAV14DV4,TRAJ57,CAMRVLGTQGGSEKLVF,0,4,1,4
TRAV14DV4,TRAJ12,CAMREGRTMDSSYKLIF,0,4,1,4
TRAV4,TRAJ4,CLVGDSLLSGGYNKLIF,0,4,1,4
TRAV26-2,TRAJ42,CILSGLRYGGSQGNLIF,0,4,1,4
TRAV26-1,TRAJ23,CIVRVPALYNQGGKLIF,0,4,1,4
TRAV26-1,TRAJ54,CIVRVGRIIQGAQKLVF,0,4,1,4
TRAV26-1,TRAJ52,SIVRVSAGGTSYGKLTF,0,4,1,4
TRAV12-1,TRAJ27,CVAPRAQDTNAGKSTF,0,4,1,4
TRAV38-1,TRAJ57,CAFMSTAQGGSEKLVF,0,4,1,4
TRAV38-2DV8,TRAJ34,CAYRSVRSYNTDKLIF,0,4,1,4
TRAV36DV7,TRAJ53,CAVKENSGGSNYKLTF,0,4,1,4
TRAV41,TRAJ30,CAVSLGPRGRRDKIIF,0,4,1,4
TRAV21,TRAJ56,CAVLIFDTGANSKLTF,0,4,1,4
TRAV20,TRAJ22,CAVQVPSSGSARQLTF,0,4,1,4
TRAV21,TRAJ42,CAVRPHYGGSQGNLIF,0,4,1,4
TRAV21,TRAJ24,CAVRPGTTDSWGKLQF,0,4,1,4
TRAV3,TRAJ42,CAVRDYYGGSQGNLIF,0,4,1,4
TRAV3,TRAJ17,CAVRDMGEAAGNKLTF,0,4,1,4
TRAV17,TRAJ57,CAAAPHLEGGSEKLVL,0,4,1,4
TRAV17,TRAJ52,CATPWGGGTSYGKLTF,0,4,1,4
TRAV12-2,TRAJ24,CAVNFMTTDSWGKLQF,0,4,1,4
TRAV13-1,TRAJ28,CAPFSYSGAGSYQLTF,0,4,1,4
TRAV29DV5,TRAJ53,CAASYNSGGSNYKLTF,0,4,1,4
TRAV29DV5,TRAJ42,CAASASYGGSQGNLIF,0,4,1,4
TRAV23DV6,TRAJ17,CAASGRTGAAGNKLTF,0,4,1,4
TRAV29DV5,TRAJ53,CAASGPSGGSNYKLTF,0,4,1,4
TRAV29DV5,TRAJ57,CAASEKDQGGSEELVF,0,4,1,4
TRAV29DV5,TRAJ45,CAASKSSGGGADELTF,0,4,1,4
TRAV29DV5,TRAJ36,CAANRGYQTGANNLFF,0,4,1,4
TRAV14DV4,TRAJ42,CAMWMNYGGSQGNLIF,0,4,1,4
TRAV12-3,TRAJ48,CAMSGASNFGNEKLTF,0,4,1,4
TRAV14DV4,TRAJ9,CAMREGGSTGGFKTIF,0,4,1,4
TRAV14DV4,TRAJ10,CAKREALGRGGNKLTF,0,4,1,4
TRAV4,TRAJ37,CLVGDAPPSNTGKLIF,0,4,1,4
TRAV4,TRAJ37,CLVGDIGASNTGKLIF,0,4,1,4
TRAV30,TRAJ6,CGSEREASGGSYIPTF,0,4,1,4
TRAV26-1,TRAJ40,CIVRVASTSGTYKYIF,0,4,1,4
TRAV26-1,TRAJ32,CIVRVDYGGATNKLIF,0,4,1,4
TRAV12-1,TRAJ9,CVVELEGTGGFKTIF,0,4,1,4
TRAV12-1,TRAJ6,CVVTLASGGSYIPTF,0,4,1,4
TRAV12-1,TRAJ33,CVVNLGMDSNYQLIW,0,4,1,4
TRAV12-1,TRAJ32,CVVNHYGGATNKLIF,0,4,1,4
TRAV12-1,TRAJ42,CVAKWYGGSQGNLIF,0,4,1,4
TRAV38-1,TRAJ44,CAFMTFTGTASKLTF,0,4,1,4
TRAV38-1,TRAJ40,CAFMSPTSGTYKYIF,0,4,1,4
TRAV38-1,TRAJ39,CAFMKGANAGNMLTF,0,4,1,4
TRAV38-2DV8,TRAJ15,CAYRTINQAGTALIF,0,4,1,4
TRAV38-2DV8,TRAJ48,CAYRSFNFGNEKLTL,0,4,1,4
TRAV19,TRAJ54,CALSVINQGAQKLVF,0,4,1,4
TRAV9-2,TRAJ37,CALSEITSNTGKLIF,0,4,1,4
TRAV9-2,TRAJ5,CALSELGPGRRALTF,0,4,1,4
TRAV9-2,TRAJ6,CALRTSSGGSYIPTF,0,4,1,4
TRAV9-2,TRAJ27,CALSDRDTNAGKSTF,0,4,1,4
TRAV6,TRAJ28,CAPLSKGAGSYKLTF,0,4,1,4
TRAV12-2,TRAJ18,CAPDDRGSTLGRLYF,0,4,1,4
TRAV20,TRAJ42,CARGVYGGSQGNLIF,0,4,1,4
TRAV12-3,TRAJ42,CAVQNYGGSQGNLIF,0,4,1,4
TRAV41,TRAJ57,CAVSRMQGGSEKLVF,0,4,1,4
TRAV41,TRAJ57,CAVRSPQGGSEKLVF,0,4,1,4
TRAV41,TRAJ58,CAVRSEETSGSRLTF,0,4,1,4
TRAV20,TRAJ12,CAVRPRMDSSYKLIF,0,4,1,4
TRAV20,TRAJ49,CAVQAYPNTGNQFYF,0,4,1,4
TRAV21,TRAJ53,CAVDYSGGSNYKLTF,0,4,1,4
TRAV22,TRAJ44,CAVEHDTGTASKLTF,0,4,1,4
TRAV3,TRAJ4,CAVTLGAGGYNKLIF,0,4,1,4
TRAV12-2,TRAJ26,CAVRPWDNYGQNFVF,0,4,1,4
TRAV21,TRAJ17,CAATLFKAAGNKLTF,0,4,1,4
TRAV41,TRAJ58,CAGFMKETSGSRLTF,0,4,1,4
TRAV17,TRAJ28,CATSYSGAGSYQLTF,0,4,1,4
TRAV17,TRAJ32,CATAAYGGATNKLIF,0,4,1,4
TRAV17,TRAJ37,CATDDRASNTGKLIF,0,4,1,4
TRAV20,TRAJ4,CALPPSSGGYNKLIF,0,4,1,4
TRAV39,TRAJ40,CAVDSWASGTYKYIF,0,4,1,4
TRAV12-2,TRAJ8,CAVNKMNTGFQKLVF,0,4,1,4
TRAV38-2DV8,TRAJ52,CANNAGGTSYGKLAF,0,4,1,4
TRAV23DV6,TRAJ40,CAASPTTSGTYKYIF,0,4,1,4
TRAV13-1,TRAJ28,CAATRSGAGSYQLTF,0,4,1,4
TRAV13-1,TRAJ44,CAASAPPGTASKLTF,0,4,1,4
TRAV13-1,TRAJ45,CAASRWGGGADGLTF,0,4,1,4
TRAV13-1,TRAJ53,CAASRSGGSNYKLTF,0,4,1,4
TRAV29DV5,TRAJ28,CAASAGGAGSYQLTF,0,4,1,4
TRAV29DV5,TRAJ36,CAASEGIAGANNLFF,0,4,1,4
TRAV29DV5,TRAJ40,CAARLTTSGTYKYIS,0,4,1,4
TRAV27,TRAJ45,CAGSYSGGGADGLTF,0,4,1,4
TRAV27,TRAJ41,CAGLLGANSGYALNF,0,4,1,4
TRAV27,TRAJ57,CAGALGQGGSEKLVF,0,4,1,4
TRAV5,TRAJ38,CAESMYAGNNRKLIW,0,4,1,4
TRAV13-2,TRAJ45,CAENPPGGGADGLTF,0,4,1,4
TRAV12-3,TRAJ11,CAMSIMNSGYSTLTF,0,4,1,4
TRAV12-3,TRAJ53,CAMSLSGGSNYKLTF,0,4,1,4
TRAV14DV4,TRAJ4,CAMRAFSGGYNKLIL,0,4,1,4
TRAV14DV4,TRAJ21,CAMREPIYNFNKFYF,0,4,1,4
TRAV14DV4,TRAJ20,CAMRETRSNDYKLSF,0,4,1,4
TRAV12-3,TRAJ22,CATPEPGGSARQLTF,0,4,1,4
TRAV4,TRAJ35,CLVAPGIGFGNVLHC,0,4,1,4
TRAV4,TRAJ37,CLVGAGSSNTGKLIF,0,4,1,4
TRAV4,TRAJ36,CLVGDAQTGANNLFF,0,4,1,4
TRAV4,TRAJ6,CLVDPSTGGSYIPTF,0,4,1,4
TRAV26-2,TRAJ37,CPWPFDSSNTGKLIF,0,4,1,4
TRAV26-2,TRAJ40,CILRGSTSGAYKYIF,0,4,1,4
TRAV26-2,TRAJ21,CILRDVVRNFNKFYF,0,4,1,4
TRAV26-2,TRAJ48,CILRDTIFGNEKLTF,0,4,1,4
TRAV26-1,TRAJ13,CIVRGYSGGYQKVTF,0,4,1,4
TRAV8-3,TRAJ39,CVVGHNNAGNMLTF,0,4,1,4
TRAV10,TRAJ15,CVVTSNQAGTALIF,0,4,1,4
TRAV12-1,TRAJ9,CVVTGNTGGFKTIF,0,4,1,4
TRAV10,TRAJ26,CVVSAKNYGQNFVF,0,4,1,4
TRAV10,TRAJ47,CVVNPMEYGNKLVF,0,4,1,4
TRAV12-1,TRAJ26,CVVNMGNYGQNFVF,0,4,1,4
TRAV38-1,TRAJ33,CAFMKHDSNYQLIW,0,4,1,4
TRAV38-2DV8,TRAJ30,CAYRSSNRDDKIIF,0,4,1,4
TRAV38-2DV8,TRAJ30,CAYRSARRDNKIIF,0,4,1,4
TRAV6,TRAJ5,CALPGGTGRRALTF,0,4,1,4
TRAV9-2,TRAJ23,CALGGNNQGGKLIF,0,4,1,4
TRAV19,TRAJ3,CALGVDSSASKIIF,0,4,1,4
TRAV9-2,TRAJ57,CALTPQGGSEKLVF,0,4,1,4
TRAV9-2,TRAJ21,CALSDRDNFNKFYF,0,4,1,4
TRAV9-2,TRAJ56,CALSDQGKRSKLTF,0,4,1,4
TRAV9-2,TRAJ39,CALRLNNAGNMLTF,0,4,1,4
TRAV9-2,TRAJ48,CALRTNFGNEKLTF,0,4,1,4
TRAV16,TRAJ13,CALSGVGGYQKVTF,0,4,1,4
TRAV12-2,TRAJ37,CAPGGPSNTGKLIF,0,4,1,4
TRAV17,TRAJ12,CAPKGMDSSYKLIF,0,4,1,4
TRAV22,TRAJ29,CAVLGNSGNTPLVF,0,4,1,4
TRAV2,TRAJ39,CAVLPSNAGNMLTF,0,4,1,4
TRAV12-2,TRAJ34,CAVETPYNTDKLIF,0,4,1,4
TRAV41,TRAJ33,CAVIVRGSNYQLIW,0,4,1,4
TRAV41,TRAJ42,CAVSRGGSQGNLIF,0,4,1,4
TRAV21,TRAJ37,CAVWSSSNTGKLIF,0,4,1,4
TRAV8-3,TRAJ33,CAVPMVDSNYQLIW,0,4,1,4
TRAV2,TRAJ5,CAVHQDTGRRALTF,0,4,1,4
TRAV8-3,TRAJ30,CAVGAPSRDDKIIF,0,4,1,4
TRAV2,TRAJ6,CAVEGGGGSYIPTF,0,4,1,4
TRAV2,TRAJ20,CAVEDRSNDYKLSF,0,4,1,4
TRAV8-4,TRAJ57,CAVSVKSGSEKLVF,0,4,1,4
TRAV8-4,TRAJ9,CAVSDRTGGFKTIF,0,4,1,4
TRAV3,TRAJ26,CAVSAIIYGQNFVF,0,4,1,4
TRAV21,TRAJ32,CAVRPGGATNKLIF,0,4,1,4
TRAV21,TRAJ37,CAVRPISNTGKLIF,0,4,1,4
TRAV1-2,TRAJ4,CAVRVSGGYNKLIF,0,4,1,4
TRAV12-2,TRAJ37,CAVNRSGNTGKLIF,0,4,1,4
TRAV21,TRAJ39,CAVKDNNAGNMLTF,0,4,1,4
TRAV21,TRAJ3,CAATLYSSASKIIF,0,4,1,4
TRAV13-1,TRAJ32,CADMRGGATNKLIF,0,4,1,4
TRAV12-2,TRAJ52,CADSGGTSYGKLTF,0,4,1,4
TRAV41,TRAJ32,CADRDGGATNMLIF,0,4,1,4
TRAV17,TRAJ16,CATDFISDGQKLLF,0,4,1,4
TRAV17,TRAJ8,CATDRRAGFQKLVI,0,4,1,4
TRAV17,TRAJ57,CATEMQGGSEKLVF,0,4,1,4
TRAV17,TRAJ24,CATNPGDSWGKLQF,0,4,1,4
TRAV24,TRAJ40,CAFISTSGTYKYIF,0,4,1,4
TRAV12-2,TRAJ8,CAFRGNTGFQKLVF,0,4,1,4
TRAV12-2,TRAJ37,CAVALTSNTGKLIF,0,4,1,4
TRAV12-2,TRAJ5,CAVRVDTGRRALTF,0,4,1,4
TRAV8-1,TRAJ12,CAVNRMDSSYKLIF,0,4,1,4
TRAV12-2,TRAJ29,CAVNLNSGNTPLVF,0,4,1,4
TRAV12-2,TRAJ9,CAVNENTGGFKTIF,0,4,1,4
TRAV12-2,TRAJ45,CAVNEGGGADGLTF,0,4,1,4
TRAV12-2,TRAJ21,CAIFRGYNFNKFYF,0,4,1,4
TRAV38-2DV8,TRAJ53,CAKWEGGSNYKLTF,0,4,1,4
TRAV13-1,TRAJ52,CAATGGTSYGKLTF,0,4,1,4
TRAV13-1,TRAJ42,CAAPYGGSQGNLIF,0,4,1,4
TRAV23DV6,TRAJ49,CAAIDPNTGNQFNF,0,4,1,4
TRAV23DV6,TRAJ31,CAALPAGNNARLMF,0,4,1,4
TRAV29DV5,TRAJ56,CAARGTGANSKLTF,0,4,1,4
TRAV29DV5,TRAJ45,CAAQRGGGADGLTF,0,4,1,4
TRAV29DV5,TRAJ40,CAAGLFSGTYKYIF,0,4,1,4
TRAV13-1,TRAJ50,CAADMKTSYDKVIL,0,4,1,4
TRAV13-1,TRAJ34,CAATLSYNTDKLIF,0,4,1,4
TRAV29DV5,TRAJ48,CAASLPFGNEKLTF,0,4,1,4
TRAV13-1,TRAJ7,CAASPPYGNNRLAF,0,4,1,4
TRAV29DV5,TRAJ33,CAASGTDSNYQLIW,0,4,1,4
TRAV13-1,TRAJ48,CAASGEFGNEKLTF,0,4,1,4
TRAV13-1,TRAJ5,CAASINTGRRALTF,0,4,1,4
TRAV23DV6,TRAJ17,CAASSGPAGNKLTF,0,4,1,4
TRAV29DV5,TRAJ22,CAASPTGSARQLTF,0,4,1,4
TRAV29DV5,TRAJ40,CAASAYGGTYKYIF,0,4,1,4
TRAV29DV5,TRAJ37,CAASGLSNTGKLIF,0,4,1,4
TRAV23DV6,TRAJ13,CAASIGGGYQKVTF,0,4,1,4
TRAV23DV6,TRAJ47,CAASRMEYGNKLVF,0,4,1,4
TRAV23DV6,TRAJ44,CAASRTGTASKLTF,0,4,1,4
TRAV23DV6,TRAJ41,CAASRVNSGYALNF,0,4,1,4
TRAV25,TRAJ53,CAGHRGGSNYKLTF,0,4,1,4
TRAV27,TRAJ37,CAGARSSNTGKLIF,0,6,1,6
TRAV5,TRAJ16,CAETRFSDGQKLLF,0,4,1,4
TRAV5,TRAJ4,CAESGSGGYNKLIF,0,4,1,4
TRAV13-2,TRAJ54,CAERLIQGAQKLVF,0,4,1,4
TRAV13-2,TRAJ47,CAENIVEYGNKLVF,0,4,1,4
TRAV12-3,TRAJ48,CAMSSFFGNEKLTF,0,4,1,4
TRAV12-3,TRAJ54,CAMSDIQGAQKLVF,0,4,1,4
TRAV14DV4,TRAJ44,CAMSLTGTASKHTF,0,4,1,4
TRAV12-3,TRAJ3,CAMSAYSSASKIIF,0,4,1,4
TRAV12-3,TRAJ6,CAMSGTGGSYIPTF,0,4,1,4
TRAV12-3,TRAJ54,CAMRVLQGAQKLVF,0,4,1,4
TRAV14DV4,TRAJ54,CAMRAIQGAQKLVF,0,4,1,4
TRAV14DV4,TRAJ20,CAMRRRPNDYKLSF,0,4,1,4
TRAV14DV4,TRAJ34,CAMRPRYNTDKLIF,0,4,1,4
TRAV14DV4,TRAJ21,CAMRGRYNFNKFYF,0,4,1,4
TRAV14DV4,TRAJ49,CAMREVNTGNQFYF,0,4,1,4
TRAV12-2,TRAJ48,CAIPSNFGNEKLTF,0,4,1,4
TRAV34,TRAJ39,CGADAHGAGNMLTF,0,4,1,4
TRAV34,TRAJ6,CGADRTGGSYIPTF,0,4,1,4
TRAV4,TRAJ7,CLVVKVDGNNRLAF,0,4,1,4
TRAV4,TRAJ39,CLVAPDNAGNMLTF,0,4,1,4
TRAV4,TRAJ27,CLVGANTNAGKSTF,0,4,1,4
TRAV12-1,TRAJ37,CPRTGSSNTGKLIF,0,4,1,4
TRAV5,TRAJ27,CAASDNTNAGKSTF,0,4,1,4
TRAV30,TRAJ49,CGTVSPHTGNQFYF,0,4,1,4
TRAV30,TRAJ40,CGTDYTSGTYKYIF,0,4,1,4
TRAV26-2,TRAJ17,CILIIKAAGNKLTF,0,4,1,4
TRAV26-2,TRAJ36,CILRIVAGANNLFF,0,4,1,4
TRAV26-1,TRAJ22,CIVHFSGSARQLTF,0,4,1,4
TRAV26-1,TRAJ17,CIVVGEAAGNKLTF,0,4,1,4
TRAV26-1,TRAJ42,CIVYYGGSQGNLIF,0,4,1,4
TRAV26-1,TRAJ37,CIVSLSSNTGKLIF,0,4,1,4
TRAV26-1,TRAJ48,CIVRPPFGNEKLTF,0,4,1,4
TRAV26-1,TRAJ34,CIVRDPLGADKLIF,0,4,1,4
TRAV17,TRAJ47,YATDAEEYGNKLVF,0,4,1,4
TRAV13-1,TRAJ6,RAASSRGGSYIPTF,0,4,1,4
TRAV8-3,TRAJ40,CPNPPPGTYIYIF,0,4,1,4
TRAV12-1,TRAJ24,CVVSPDSWGKLQF,0,4,1,4
TRAV12-1,TRAJ22,CVVISGSARQLTF,0,4,1,4
TRAV10,TRAJ31,CVVRGNNNARLMF,0,4,1,4
TRAV12-1,TRAJ10,CVVNKGGGDKLTF,0,4,1,4
TRAV9-2,TRAJ33,CASYMDSNYQLIW,0,4,1,4
TRAV17,TRAJ9,CASRNTGGFKTIF,0,4,1,4
TRAV38-2DV8,TRAJ54,CASIIQGAQKLVF,0,4,1,4
TRAV38-2DV8,TRAJ37,CACSGSNTGKLIF,0,4,1,4
TRAV38-2DV8,TRAJ31,CAYSRPNNARLMF,0,4,1,4
TRAV38-2DV8,TRAJ30,CAYRTNRDDKIIL,0,4,1,4
TRAV9-2,TRAJ20,CALFGSNDYKLSF,0,4,1,4
TRAV9-2,TRAJ13,CALLSGGYQKVTF,0,4,1,4
TRAV9-2,TRAJ12,CALLMDSSYKLIF,0,4,1,4
TRAV6,TRAJ9,CALVRTGGFKTIF,0,4,1,4
TRAV16,TRAJ48,CALKGFGNEKLTF,0,4,1,4
TRAV36DV7,TRAJ40,CAPLLSGTYKYIF,0,4,1,4
TRAV36DV7,TRAJ45,CAVFSGGADGLTF,0,4,1,4
TRAV21,TRAJ44,CAVPTGTASKLTF,0,4,1,4
TRAV22,TRAJ20,CAVPPFNDYKLSF,0,4,1,4
TRAV41,TRAJ44,CAVLTGTASKLTF,0,4,1,4
TRAV8-3,TRAJ7,CAVLYYGNNRLAF,0,4,1,4
TRAV41,TRAJ57,CAVNQGGSEKLVF,0,4,1,4
TRAV12-2,TRAJ49,CAVLRSTGNQFYF,0,4,1,4
TRAV8-3,TRAJ34,CAVVRCNTDKLIF,0,4,1,4
TRAV20,TRAJ5,CAVAMEGRRALTF,0,4,1,4
TRAV8-3,TRAJ29,CAVGPRGNTPLVF,0,4,1,4
TRAV8-3,TRAJ45,CAVGGGGADGLTF,0,4,1,4
TRAV2,TRAJ33,CAVEDASNYQLIW,0,4,1,4
TRAV12-2,TRAJ33,CAVMEDSNYQLIW,0,4,1,4
TRAV3,TRAJ37,CAVRGSNTGKLIF,0,4,1,4
TRAV2,TRAJ13,CAVNSGGYQKVTF,0,4,1,4
TRAV12-2,TRAJ29,CAVNYLRNTPLVF,0,4,1,4
TRAV20,TRAJ5,CAVMDTGRRALTF,0,4,1,4
TRAV41,TRAJ49,CAAPQNTGNQFYF,0,4,1,4
TRAV21,TRAJ27,CAALNTNAGKSTF,0,4,1,4
TRAV17,TRAJ36,CATRQTGANNLFF,0,4,1,4
TRAV17,TRAJ48,CATANFGNEKLTF,0,4,1,4
TRAV17,TRAJ31,CATDAIGNARLMF,0,4,1,4
TRAV17,TRAJ58,CATDETSGSRLTF,0,4,1,4
TRAV17,TRAJ45,CATRGGGADGLTF,0,4,1,4
TRAV24,TRAJ26,CAFKRDYGQNFVF,0,4,1,4
TRAV3,TRAJ13,CAYPSGGYQKVTF,0,4,1,4
TRAV13-2,TRAJ39,CALGGNAGNMLTF,0,4,1,4
TRAV12-2,TRAJ12,CAVGRDSSYKLIF,0,4,1,4
TRAV12-2,TRAJ36,CAVRSTGANNLFF,0,4,1,4
TRAV8-1,TRAJ22,CAVNALSARQLTF,0,4,1,4
TRAV12-2,TRAJ47,CAVNHGYGNKLVF,0,4,1,4
TRAV12-2,TRAJ42,CAVNVGSQGNLIF,0,4,1,4
TRAV8-1,TRAJ23,CAVKKNQGGKLIF,0,4,1,4
TRAV8-1,TRAJ39,CAAHNNAGNMLTF,0,4,1,4
TRAV13-2,TRAJ20,CAVLAPEDYKLSF,0,4,1,4
TRAV29DV5,TRAJ50,CAAEKTSYDKVIF,0,4,1,4
TRAV13-1,TRAJ36,CAAFQTGANNLFF,0,4,1,4
TRAV13-1,TRAJ4,CAALSGGYNKLIF,0,4,1,4
TRAV13-1,TRAJ20,CAALNPNDYKLSF,0,4,1,4
TRAV13-1,TRAJ5,CAAGDTGRRALTF,0,4,1,4
TRAV27,TRAJ49,CAAPSNTGNQFYF,0,7,1,7
TRAV13-1,TRAJ48,CAAFNFGNEKLTF,0,4,1,4
TRAV13-1,TRAJ27,CAAWNTNAGKSTF,0,4,1,4
TRAV23DV6,TRAJ9,CAAALVGGFKTIF,0,4,1,4
TRAV13-1,TRAJ6,CAAIWGGSYIPTF,0,4,1,4
TRAV13-1,TRAJ40,CAATLSGTYKYIF,0,4,1,4
TRAV13-1,TRAJ48,CAASMGGNEKLTF,0,4,1,4
TRAV13-1,TRAJ15,CAASKKAGTALIF,0,4,1,4
TRAV29DV5,TRAJ43,CAASAINNNDMRF,0,4,1,4
TRAV29DV5,TRAJ43,CAASALENNDMRF,0,4,1,4
TRAV23DV6,TRAJ23,CAASDNQGGKLIF,0,4,1,4
TRAV23DV6,TRAJ31,CAASIHNNARLMF,0,4,1,4
TRAV23DV6,TRAJ20,CAASMRNDYKLSF,0,4,1,4
TRAV23DV6,TRAJ40,CAASNTGTYKYIF,0,4,1,4
TRAV13-1,TRAJ36,CAARTTGANNLFF,0,4,1,4
TRAV25,TRAJ9,CAGQDTGGFKTIF,0,4,1,4
TRAV25,TRAJ13,CAGRSGSYQKVTF,0,4,1,4
TRAV27,TRAJ9,CAGWDTGGFKTIF,0,4,1,4
TRAV25,TRAJ28,CAGHGAGSYQLTF,0,4,1,4
TRAV27,TRAJ43,CAGVRGYNNDMRF,0,4,1,4
TRAV27,TRAJ47,CAGVLGYRNKLVF,0,4,1,4
TRAV27,TRAJ4,CAGASGGYNKLIF,0,4,1,4
TRAV13-2,TRAJ24,CAETSDSWGKLQF,0,4,1,4
TRAV13-2,TRAJ9,CAETDTGGFKTIF,0,4,1,4
TRAV5,TRAJ13,CAESLGGYQKVTF,0,4,1,4
TRAV13-2,TRAJ34,CAERAYNTDKLVF,0,4,1,4
TRAV13-2,TRAJ10,CAERTGGGNKLTF,0,6,1,6
TRAV13-2,TRAJ26,CAENYNYGQNFVF,0,4,1,4
TRAV13-2,TRAJ44,CAENTGTASKLTF,0,4,1,4
TRAV13-2,TRAJ5,CAENNTGRRALTF,0,4,1,4
TRAV14DV4,TRAJ34,CAMAPYNTDKLIF,0,4,1,4
TRAV12-3,TRAJ9,CAMTNTGGFKTIF,0,4,1,4
TRAV12-3,TRAJ20,CAMSFSNDYKLSF,0,4,1,4
TRAV12-3,TRAJ5,CAMSEAGRRALTF,0,4,1,4
TRAV12-3,TRAJ58,CAMRGTSGSRLTF,0,4,1,4
TRAV14DV4,TRAJ23,CAMRDRQGGKLIF,0,4,1,4
TRAV14DV4,TRAJ49,CAMRRNTGNQFYF,0,4,1,4
TRAV12-3,TRAJ13,CAMKTGGYQKVTF,0,4,1,4
TRAV4,TRAJ5,CLVWGTGRRALTF,0,4,1,4
TRAV4,TRAJ35,CLVGGGFGNVLHC,0,4,1,4
TRAV4,TRAJ34,CLVGDHNTDKLIF,0,4,1,4
TRAV4,TRAJ30,CLVGPLRDDKIIF,0,4,1,4
TRAV30,TRAJ36,CGTEQTGANNLFF,0,4,1,4
TRAV26-2,TRAJ43,CILGQYNNNDMRF,0,4,1,4
TRAV26-2,TRAJ34,CILRRYNTDKLIF,0,4,1,4
TRAV26-2,TRAJ49,CILRDDTGIQFYF,0,4,1,4
TRAV26-1,TRAJ32,CIALGGATNKLIF,0,4,1,4
TRAV12-1,TRAJ3,RGALYSSASKIIF,0,4,1,4
TRAV12-1,TRAJ3,CVVGSSASKIIF,0,4,1,4
TRAV12-1,TRAJ33,CVVIPSNYQLIW,0,4,1,4
TRAV12-1,TRAJ49,CVVITTGNQFYF,0,4,1,4
TRAV12-1,TRAJ29,CVVNSGNTPLVF,0,4,1,4
TRAV12-1,TRAJ41,CVVGNSGYALNF,0,4,1,4
TRAV38-1,TRAJ31,CAFIKFDARLMF,0,4,1,4
TRAV38-1,TRAJ47,CAFTEYGNKLVF,0,4,1,4
TRAV9-2,TRAJ21,CALRYNFNKFYF,0,4,1,4
TRAV9-2,TRAJ35,CALSGFENVLHC,0,4,1,4
TRAV9-2,TRAJ36,CALSTGANNLFF,0,4,1,4
TRAV9-2,TRAJ49,CALANTGNQFYF,0,4,1,4
TRAV9-2,TRAJ34,CALSKNTDKLIF,0,4,1,4
TRAV9-2,TRAJ27,CALRTNAGKSTF,0,4,1,4
TRAV9-2,TRAJ36,CALKAGANNLFF,0,4,1,4
TRAV16,TRAJ30,CALSRGDDRIIF,0,4,1,4
TRAV17,TRAJ12,CAPMDSSYKLIL,0,4,1,4
TRAV38-2DV8,TRAJ39,CAHNNAGNMLTF,0,4,1,4
TRAV21,TRAJ39,CAVPNAGNTLTF,0,4,1,4
TRAV21,TRAJ16,CAVHSDGQKLLF,0,4,1,4
TRAV20,TRAJ49,CAVQAPGNQFYF,0,4,1,4
TRAV21,TRAJ34,CAVQGNTDKLIF,0,4,1,4
TRAV8-3,TRAJ27,CAVGADAGKSTF,0,4,1,4
TRAV22,TRAJ49,CAVGITGNQFYF,0,4,1,4
TRAV2,TRAJ34,CAVDYNTDKLIF,0,4,1,4
TRAV2,TRAJ31,CAVEDWNARLMF,0,4,1,4
TRAV12-2,TRAJ36,CAVETGANNLFF,0,4,1,4
TRAV36DV7,TRAJ27,CAVETNAGKSTF,0,4,1,4
TRAV21,TRAJ47,CAVSRYGNKLVF,0,4,1,4
TRAV12-2,TRAJ20,CAVRPNDYKLSF,0,4,1,4
TRAV21,TRAJ20,CAVRFNDYKLSF,0,4,1,4
TRAV8-6,TRAJ49,CAVRNTGNQFYF,0,4,1,4
TRAV2,TRAJ21,CAVNGRLNKFYF,0,4,1,4
TRAV36DV7,TRAJ50,CAVKTSYDKVIF,0,4,1,4
TRAV2,TRAJ29,CAVLSGNTPLVF,0,4,1,4
TRAV8-3,TRAJ12,CAVEGSSYKLIF,0,4,1,4
TRAV8-6,TRAJ26,CAAHNYGQNFVF,0,4,1,4
TRAV38-2DV8,TRAJ52,CAGGTSYGKLTF,0,4,1,4
TRAV2,TRAJ9,CADKRGGFKTIF,0,4,1,4
TRAV3,TRAJ35,CATIGFGNVLHC,0,4,1,4
TRAV17,TRAJ45,CATVHLYAGLTF,0,4,1,4
TRAV24,TRAJ31,CAFIDNNARLMF,0,4,1,4
TRAV24,TRAJ41,CAFMNSGYALNF,0,4,1,4
TRAV12-2,TRAJ34,CALSLNTDKLIF,0,4,1,4
TRAV12-2,TRAJ9,CAPDLGGFKTIF,0,4,1,4
TRAV23DV6,TRAJ39,CAPQAAGNMLTF,0,4,1,4
TRAV12-2,TRAJ5,CAPGVGRRALTF,0,4,1,4
TRAV12-2,TRAJ40,CAVTSGTYKYIF,0,4,1,4
TRAV20,TRAJ7,CAVTRGNNRLVF,0,4,1,4
TRAV3,TRAJ33,CAAMDSNYQLIW,0,4,1,4
TRAV12-2,TRAJ44,CAATGTASKLTF,0,4,1,4
TRAV12-2,TRAJ23,CAGDNQGGKLIF,0,4,1,4
TRAV25,TRAJ16,CAAPSDGQKLLF,0,4,1,4
TRAV13-1,TRAJ49,CAAVGTGNQFYF,0,4,1,4
TRAV13-1,TRAJ29,CAAGRGNTPLVF,0,4,1,4
TRAV13-1,TRAJ47,CAASNEAGKLVF,0,4,1,4
TRAV23DV6,TRAJ22,CAASVNARQLTF,0,4,1,4
TRAV13-2,TRAJ54,CAASDRAQKLVF,0,4,1,4
TRAV13-1,TRAJ43,CAARLSNNDMRF,0,4,1,4
TRAV25,TRAJ33,CAGMDSNYQLIW,0,4,1,4
TRAV27,TRAJ36,CAGFTGANNLFF,0,4,1,4
TRAV27,TRAJ20,CAGPPNDYKLSF,0,4,1,4
TRAV27,TRAJ41,CAGDESGYALNF,0,4,1,4
TRAV5,TRAJ21,CAEMYNFNKFYF,0,4,1,4
TRAV12-3,TRAJ21,CAMVGNFNKFYF,0,4,1,4
TRAV23DV6,TRAJ52,CDGGTSYGKLTF,0,4,1,4
TRAV4,TRAJ6,CLVGGGSYIPTF,0,4,1,4
TRAV30,TRAJ34,CGTERDTDKLIF,0,4,1,4
TRAV27,TRAJ44,YKNTGTASKLTF,0,4,1,4
TRAV12-1,TRAJ43,CVVRDNNDMRF,0,4,1,4
TRAV12-1,TRAJ21,CVALNFNKFYF,0,4,1,4
TRAV17,TRAJ29,CAWGGNTPLVF,0,4,1,4
TRAV6,TRAJ49,CALERGNQFYF,0,4,1,4
TRAV16,TRAJ47,CALMGGNKLVF,0,4,1,4
TRAV41,TRAJ58,CAVRFSSRLTF,0,4,1,4
TRAV2,TRAJ30,CAVEDHDKIIF,0,4,1,4
TRAV17,TRAJ40,CATEGTYKYIF,0,4,1,4
TRAV17,TRAJ20,CATENDYKLSF,0,4,1,4
TRAV12-2,TRAJ49,CATNTGNQFYF,0,4,1,4
TRAV17,TRAJ37,CAFSNTGKLIF,0,4,1,4
TRAV24,TRAJ7,CAFYGNNRLAF,0,4,1,4
TRAV17,TRAJ52,CARTSYGKLTF,0,4,1,4
TRAV12-2,TRAJ54,CAVQGAQKLVF,0,4,1,4
TRAV25,TRAJ50,CAVPPSDKVIF,0,4,1,4
TRAV5,TRAJ31,CAETPNARLMF,0,4,1,4
TRAV5,TRAJ16,CAERDGQKLLF,0,4,1,4
TRAV12-3,TRAJ21,CAMENFNKFYF,0,4,1,4
TRAV12-3,TRAJ31,CAMSNNARLMF,0,4,1,4
TRAV12-2,TRAJ11,YAVTGYSTLTF,0,4,1,4
TRAV38-2DV8,TRAJ22,CAYRRRQLTF,0,4,1,4
TRAV21,TRAJ43,CAVFEADMRF,0,4,1,4
TRAV24,TRAJ40,CAFKTYNYIF,0,4,1,4
TRAV29DV5,TRAJ48,CAAANEKLTF,0,4,1,4
TRAV13-1,TRAJ30,CAAPEGKIIF,0,4,1,4
TRAV5,TRAJ27,CAESHLKSTF,0,4,1,4
TRAV13-2,TRAJ43,CAEKPNDMRF,0,4,1,4
TRAV29DV5,TRAJ20,CGFNDYKLSF,0,4,1,4
TRAV12-1,TRAJ43,CVVNSAMRF,0,4,1,4
TRAV27,TRAJ43,CARGNDMRF,0,4,1,4
TRAV12-1,TRAJ31,CAANARLMF,0,4,1,4
TRAV12-2,TRAJ43,CAVRGMRF,0,4,1,4
TRAV38-2DV8,TRAJ43,CARDMRF,0,4,1,4
TRAV23DV6,TRAJ32,CTNKLIF,0,4,1,4
TRAV13-1,TRAJ44,CAASTRAVTGTASKLTF,0,4,1,4
TRAV16,TRAJ52,CAFKNAGGTSYGKLTF,0,4,1,4
TRAV12-1,TRAJ53,CVVTGSGGSNYKLTF,0,4,1,4
TRAV3,TRAJ9,CAVRDGDTGGFKTIF,0,4,1,4
TRAV9-2,TRAJ56,CALSYTGANSKLTF,0,4,1,4
TRAV41,TRAJ45,CAVYSGGGADGLTF,0,4,1,4
TRAV38-2DV8,TRAJ43,CAYSMYNNNDVRF,0,4,1,4
TRAV12-1,TRAJ6,SLRWDRLAFGKGNQVVVIPRGSYIPTF,0,3,1,3
TRAV35,TRAJ45,CAGPQIEMYSGGGADGLTF,0,3,1,3
TRAV26-1,TRAJ32,CIVRVPATMYGGATNKLIF,0,3,1,3
TRAV38-2DV8,TRAJ52,CAYWGYNAGGTSNGKLTF,0,3,1,3
TRAV21,TRAJ28,CAVRIGIDSGAGSYQLTF,0,3,1,3
TRAV29DV5,TRAJ52,CAAKGRNAGGTSYGKLTF,0,3,1,3
TRAV12-1,TRAJ23,CVVKRPLNYNQGGKLIF,0,3,1,3
TRAV38-2DV8,TRAJ44,CAYRSARETGTASKLTF,0,3,1,3
TRAV9-2,TRAJ42,CALSPVNYGGSQGNLIF,0,3,1,3
TRAV9-2,TRAJ10,CALSDQGVTGGGNKLTF,0,3,1,3
TRAV12-2,TRAJ42,CAVEQVNYGGSQGNLIF,0,3,1,3
TRAV3,TRAJ4,CAVRDSPFSGGYNKLIF,0,3,1,3
TRAV12-2,TRAJ22,CAVPPTLSSGSARQLTF,0,3,1,3
TRAV13-1,TRAJ16,CAASLVPFLSDGQKLLF,0,3,1,3
TRAV23DV6,TRAJ18,CAARRTDRGSTLGRLYF,0,3,1,3
TRAV13-1,TRAJ10,CAASRGGLTGGGNKLTF,0,3,1,3
TRAV23DV6,TRAJ52,CAASIPWGGTSYGKLTF,0,3,1,3
TRAV27,TRAJ18,CAGSTLDRGSTLGRLYF,0,3,1,3
TRAV4,TRAJ22,CLVGDLISSGSARQLTF,0,3,1,3
TRAV4,TRAJ23,CLVGESMIYNQGGKLIF,0,3,1,3
TRAV26-1,TRAJ28,CIVRAPYSGAGSYQLTF,0,3,1,3
TRAV8-2,TRAJ38,CVVSAYNAGNNRKLIW,0,3,1,3
TRAV12-1,TRAJ40,CVVNPVTTSGTYKYIF,0,3,1,3
TRAV12-1,TRAJ15,CVVNKGLNQAGTALIF,0,3,1,3
TRAV38-2DV8,TRAJ45,CAYRSYSGGGADGLTF,0,3,1,3
TRAV38-2DV8,TRAJ38,CAYRTTNAGNNRKLIW,0,3,1,3
TRAV38-2DV8,TRAJ40,CAYRSARTSGTYKYIF,0,3,1,3
TRAV38-2DV8,TRAJ22,CAYRSTISGSARQLTF,0,3,1,3
TRAV9-2,TRAJ53,CALTPRSGGSNYKLTF,0,3,1,3
TRAV9-2,TRAJ52,CALSETGGTSYGKLTF,0,3,1,3
TRAV20,TRAJ52,CAVRSAGGTSYGKLTF,0,3,1,3
TRAV8-3,TRAJ42,CAVGPPYGGSQGNLIF,0,3,1,3
TRAV8-3,TRAJ57,CAVGAKGQGGSEKLVF,0,3,1,3
TRAV36DV7,TRAJ57,CAVGLLTQGGSEKLVF,0,3,1,3
TRAV8-6,TRAJ6,CAVSGHASGGSYIPTF,0,3,1,3
TRAV3,TRAJ22,CAVRLSSSGSARQLTF,0,3,1,3
TRAV3,TRAJ27,CAVRDPHNTNAGKSTF,0,3,1,3
TRAV3,TRAJ15,CAVRDIANQAGTALIF,0,3,1,3
TRAV21,TRAJ45,CAVNQRSGGGADGLTF,0,3,1,3
TRAV12-2,TRAJ8,CAVKGGMNTGFQKLVF,0,3,1,3
TRAV20,TRAJ52,CAVPLDGGTSYGKLTF,0,3,1,3
TRAV21,TRAJ18,CAGSSSGGSTLGRLYF,0,3,1,3
TRAV17,TRAJ34,CATAFVRSYNTDKLIF,0,3,1,3
TRAV17,TRAJ6,CATGGPASGGSYIPTF,0,3,1,3
TRAV24,TRAJ37,CAFDNQGSSNTGKLIF,0,3,1,3
TRAV24,TRAJ48,CALFPLTNFGNEKLTF,0,3,1,3
TRAV24,TRAJ10,CALWLGLTGGGNKLTF,0,3,1,3
TRAV12-2,TRAJ36,CAVTPGDQTGANNLFF,0,3,1,3
TRAV8-1,TRAJ18,CAVNKNRGSTLGRLYF,0,3,1,3
TRAV12-2,TRAJ4,CAVNPEFSGGYNKLIF,0,3,1,3
TRAV12-2,TRAJ53,CAVNTRSGGSNYKLTF,0,3,1,3
TRAV25,TRAJ52,CAGRDAGGTSYGKLTF,0,3,1,3
TRAV25,TRAJ37,CAARLPGSSNTGKLIF,0,3,1,3
TRAV13-1,TRAJ3,CAAATPGYSSASKIIF,0,3,1,3
TRAV29DV5,TRAJ42,CAATYDYGGSQGNLIF,0,3,1,3
TRAV13-1,TRAJ38,CAATALNAGNNRKLIW,0,3,1,3
TRAV13-1,TRAJ52,CAASLGGGTSYGKLTF,0,3,1,3
TRAV29DV5,TRAJ52,CAASPIGGTSYGKLAF,0,3,1,3
TRAV29DV5,TRAJ38,CAASRHNAGNNRKLIW,0,3,1,3
TRAV13-1,TRAJ45,CAARAGGGGGADGLTF,0,3,1,3
TRAV13-2,TRAJ48,CAENIGSNFGNEKLTF,0,3,1,3
TRAV14DV4,TRAJ11,CAMREFTPSGYSTLTF,0,3,1,3
TRAV14DV4,TRAJ9,CAMREGENTGGFKTIF,0,3,1,3
TRAV4,TRAJ4,CLVVSVTSGGYNKLIF,0,3,1,3
TRAV4,TRAJ22,CLVGDPVYGSARQLTF,0,3,1,3
TRAV26-2,TRAJ53,CILRSLSGGSNYKPTF,0,3,1,3
TRAV26-2,TRAJ48,CILRDLTNFGNEKLTF,0,3,1,3
TRAV26-2,TRAJ49,CILRDGLMGTGNQFYF,0,3,1,3
TRAV8-2,TRAJ18,CVDARGGSTLGRLYF,0,3,1,3
TRAV10,TRAJ13,CVVTPGSGGYQKVTF,0,3,1,3
TRAV38-1,TRAJ42,CAFTDYGGSQGNLIF,0,3,1,3
TRAV38-2DV8,TRAJ56,CAYRSFTGANSKLTF,0,3,1,3
TRAV16,TRAJ6,CALPPSSGGSYIPTF,0,3,1,3
TRAV9-2,TRAJ52,CALHAGGTSYGKLTF,0,3,1,3
TRAV9-2,TRAJ37,CALTSGSSNTGKLIF,0,3,1,3
TRAV19,TRAJ39,CALSEADNAGNMLTF,0,3,1,3
TRAV6,TRAJ45,CALAYSGGGADGLTF,0,3,1,3
TRAV16,TRAJ8,CALIPMNTGFQKLVF,0,3,1,3
TRAV16,TRAJ40,CALSESTSGTYKYIF,0,3,1,3
TRAV16,TRAJ57,CALSPTQGGSEKLVL,0,3,1,3
TRAV20,TRAJ53,CAVPRVGGSNYKLTF,0,3,1,3
TRAV20,TRAJ53,CAVQAGGGSNYKLTF,0,3,1,3
TRAV36DV7,TRAJ45,CAVVTQGGGADGLTF,0,3,1,3
TRAV8-3,TRAJ45,CAVGRPGGGADGLTF,0,3,1,3
TRAV8-3,TRAJ44,CAVGVSAGTASKLTF,0,3,1,3
TRAV2,TRAJ32,CAVEDLGGATNKLIF,0,3,1,3
TRAV8-4,TRAJ4,CAVSAFSGGYNKLIF,0,3,1,3
TRAV8-4,TRAJ16,CAVSDPVSDGQKLLF,0,3,1,3
TRAV3,TRAJ33,CAVSLPGGSNYQLIR,0,3,1,3
TRAV3,TRAJ41,CAVSPRSNSGYALNF,0,3,1,3
TRAV12-3,TRAJ24,CAVRRTTDSWGKLQL,0,3,1,3
TRAV3,TRAJ5,CAVRALDTGRRALTF,0,3,1,3
TRAV3,TRAJ8,CAVRDKGTGFQKLVF,0,3,1,3
TRAV3,TRAJ3,CAVRDGGSSASKIIF,0,3,1,3
TRAV3,TRAJ28,CAVRDIPAGSYQLTF,0,3,1,3
TRAV3,TRAJ27,CAVRDMTTYAGKSTF,0,3,1,3
TRAV3,TRAJ29,CAVRDMKSGNTPLVF,0,3,1,3
TRAV35,TRAJ48,CAGLPPNFGNEKLTF,0,3,1,3
TRAV8-3,TRAJ52,CAGGAGGTSYGKLTF,0,3,1,3
TRAV17,TRAJ17,CATSFIKAAGNKLTF,0,3,1,3
TRAV17,TRAJ32,CATVYIGGATNKLIF,0,3,1,3
TRAV17,TRAJ4,CATDPSDGGYNKLIF,0,3,1,3
TRAV17,TRAJ45,CATDGSGGGADGLTF,0,3,1,3
TRAV17,TRAJ34,CATEGVTYNTDKLIF,0,3,1,3
TRAV12-2,TRAJ6,CAPSASSGGSYIPTF,0,3,1,3
TRAV8-1,TRAJ3,CAVNAPYSSASKIIF,0,3,1,3
TRAV8-1,TRAJ37,CAVNNSSSNTGKLIF,0,3,1,3
TRAV12-2,TRAJ28,CAGGNSGAGSYQLTF,0,3,1,3
TRAV25,TRAJ48,CAGDNPNFGNEKLTF,0,3,1,3
TRAV12-3,TRAJ8,CALGFMNTGFQKLVF,0,3,1,3
TRAV12-3,TRAJ35,CASLLVIGFGNVLHC,0,3,1,3
TRAV13-1,TRAJ3,CAAPPGYSSASKIIF,0,3,1,3
TRAV13-1,TRAJ23,CAARGIYNQGGKLIF,0,3,1,3
TRAV13-1,TRAJ40,CAATGGSSGTYKYIF,0,3,1,3
TRAV13-1,TRAJ13,CAATKNSGGYQKVTF,0,3,1,3
TRAV13-1,TRAJ34,CAASMRWGNTDKLIF,0,3,1,3
TRAV13-1,TRAJ6,CAASTASGGSYIPTF,0,3,1,3
TRAV13-1,TRAJ56,CAASNLGGANSKLTF,0,3,1,3
TRAV13-1,TRAJ4,CAASRTYGGYNKLIF,0,3,1,3
TRAV29DV5,TRAJ28,CAASASGAGSYQLTF,0,3,1,3
TRAV29DV5,TRAJ39,CAASAGGNAGNMLTF,0,3,1,3
TRAV29DV5,TRAJ31,CAASEARNNNARLMF,0,3,1,3
TRAV29DV5,TRAJ49,CAASIYSNTGNQFYF,0,3,1,3
TRAV23DV6,TRAJ49,CAASRSSDTGNQFYF,0,3,1,3
TRAV25,TRAJ42,CAGLHYGGSQGNLIF,0,3,1,3
TRAV25,TRAJ37,CAGPKSSSNTGKLIF,0,3,1,3
TRAV27,TRAJ53,CAGAGGGGSNYKLTF,0,3,1,3
TRAV27,TRAJ58,CAGAGRETSGSRLTF,0,3,1,3
TRAV5,TRAJ42,CAEIPYGGSQGNLIF,0,3,1,3
TRAV13-2,TRAJ5,CAENPSWPGRRALTF,0,3,1,3
TRAV12-3,TRAJ52,CAMYAGGTSYGKLTF,0,3,1,3
TRAV12-3,TRAJ4,CAMSDGDGGYNKLIF,0,3,1,3
TRAV14DV4,TRAJ6,CAMRHLEGGSYIPTF,0,3,1,3
TRAV14DV4,TRAJ50,CAMREGWTSYDKVIF,0,3,1,3
TRAV14DV4,TRAJ6,CAMREGEGGSYIPTF,0,3,1,3
TRAV14DV4,TRAJ9,CAMREDGTGGFKTIF,0,3,1,3
TRAV4,TRAJ13,CLVGPPAGGYQKVTF,0,3,1,3
TRAV4,TRAJ6,CLVGDRGRGSYIPTF,0,3,1,3
TRAV4,TRAJ29,CLVGDKSSGNTPLVF,0,3,1,3
TRAV4,TRAJ3,CLVGLTYSSASKIIF,0,3,1,3
TRAV4,TRAJ18,CLASDRGSTLGRLYF,0,3,1,3
TRAV30,TRAJ45,CGTEEAGGGADGLTF,0,3,1,3
TRAV26-2,TRAJ40,CILRATTSGTYKYIF,0,3,1,3
TRAV26-2,TRAJ9,CILRDRNTGGFKTIF,0,3,1,3
TRAV26-2,TRAJ40,CILRSHTSGTYKYIF,0,3,1,3
TRAV26-2,TRAJ53,CILRDVRGSNYKLTF,0,3,1,3
TRAV26-2,TRAJ30,CILRDEWNRDDKIIF,0,3,1,3
TRAV26-2,TRAJ53,CIQRWSGGSNYKLTF,0,3,1,3
TRAV26-1,TRAJ4,CIVRAFSGGYNKLIF,0,3,1,3
TRAV26-1,TRAJ41,CIVRVDVNSGYALNF,0,3,1,3
TRAV10,TRAJ4,CVVIPFWWLNKLIF,0,3,1,3
TRAV10,TRAJ44,CVVTLTGTASKLTF,0,3,1,3
TRAV10,TRAJ36,CVVSPRTGANNLFF,0,3,1,3
TRAV12-1,TRAJ39,CVVNWGNAGNMLTF,0,3,1,3
TRAV12-1,TRAJ48,CVVNRSWGNEKLTF,0,3,1,3
TRAV12-1,TRAJ6,CVVNESGGSYIPTF,0,3,1,3
TRAV38-1,TRAJ24,CAFVPTDSWGKLQF,0,3,1,3
TRAV38-1,TRAJ57,CAFMNWGGSEKLVF,0,3,1,3
TRAV38-1,TRAJ49,CAFMKHDAGNQFYF,0,3,1,3
TRAV16,TRAJ18,CALDRGSTLGRLYF,0,3,1,3
TRAV20,TRAJ28,CAYYSGAGSYQLTF,0,3,1,3
TRAV38-2DV8,TRAJ43,CAYRSASNNNDMRF,0,3,1,3
TRAV38-2DV8,TRAJ49,CAYRNSNTGNQFYF,0,3,1,3
TRAV6,TRAJ38,CALFNAGNNRKLIW,0,3,1,3
TRAV6,TRAJ13,CALKNSGGYQKVTF,0,3,1,3
TRAV9-2,TRAJ50,CALIGATSYDKVIF,0,3,1,3
TRAV9-2,TRAJ34,CALSGAYNTDKLIF,0,3,1,3
TRAV9-2,TRAJ26,CALSDRDYGQNFVF,0,3,1,3
TRAV9-2,TRAJ29,CALSEPSGNTPLVF,0,3,1,3
TRAV19,TRAJ23,CALSRYNQGGKLIF,0,3,1,3
TRAV9-2,TRAJ22,CALKTSGSARQLTF,0,3,1,3
TRAV8-3,TRAJ6,CAVSPSGGSYIPTF,0,3,1,3
TRAV2,TRAJ4,CAVSTPGGYNKLIF,0,3,1,3
TRAV21,TRAJ47,CAVRNREYGNKLVF,0,3,1,3
TRAV21,TRAJ26,CAVAGTNYGQNFVF,0,3,1,3
TRAV8-3,TRAJ36,CAVCDQTGANNLFF,0,3,1,3
TRAV20,TRAJ40,CAVRSSPGTYKYIF,0,3,1,3
TRAV2,TRAJ9,CAVQSYTGGFKTTF,0,3,1,3
TRAV2,TRAJ13,CAVVPSGGYQKVTF,0,3,1,3
TRAV8-3,TRAJ39,CAVAPNNAGNMLTF,0,3,1,3
TRAV8-3,TRAJ8,CAVGADTGFQKLVF,0,3,1,3
TRAV8-3,TRAJ11,CAVGADSGYSTLTF,0,3,1,3
TRAV22,TRAJ44,CAVGGTGTASKLTF,0,3,1,3
TRAV2,TRAJ22,CAVESPGSARQLTF,0,3,1,3
TRAV12-2,TRAJ56,CAVTFAGANSKLTF,0,3,1,3
TRAV21,TRAJ47,CAVTRMEYGNKLVF,0,3,1,3
TRAV8-6,TRAJ10,CAVSFTGGGNKLTF,0,3,1,3
TRAV21,TRAJ32,CAVSLGGATNKLIF,0,3,1,3
TRAV3,TRAJ9,CAVSPYTGGFKTIF,0,3,1,3
TRAV3,TRAJ34,CAVSQSYNTDKLIF,0,3,1,3
TRAV8-6,TRAJ23,CAVSGSNQGGKLIF,0,3,1,3
TRAV8-4,TRAJ24,CAVSETDSWGKLQF,0,3,1,3
TRAV8-4,TRAJ15,CAVSENQAGTALIF,0,3,1,3
TRAV8-6,TRAJ12,CAVSRMDSSYKLIF,0,3,1,3
TRAV21,TRAJ24,CAVRRGDSWGKLQF,0,3,1,3
TRAV3,TRAJ33,CAVRPPDSNYQLIW,0,3,1,3
TRAV3,TRAJ49,CAVRVSNTGNQFYF,0,3,1,3
TRAV3,TRAJ36,CAVRVLTGANNLFF,0,3,1,3
TRAV3,TRAJ6,CAVRDIGGSYIPTF,0,3,1,3
TRAV20,TRAJ4,CAASSSGGYNKLIF,0,3,1,3
TRAV35,TRAJ42,CAGQSGRSQGNLIF,0,3,1,3
TRAV35,TRAJ56,CAGQLSGANSKLTF,0,3,1,3
TRAV35,TRAJ33,CAGQLMDSNYQLIW,0,3,1,3
TRAV3,TRAJ24,CAEVSTDSWGKLQF,0,3,1,3
TRAV41,TRAJ32,CAIWDGGATNKLIF,0,3,1,3
TRAV17,TRAJ12,CATSRMDSSYKLIF,0,3,1,3
TRAV17,TRAJ58,CATDAGFRGSRLTF,0,3,1,3
TRAV12-2,TRAJ28,CAPYSGAGSYQLTF,0,3,1,3
TRAV12-3,TRAJ13,CAVARSGGYQKVTF,0,3,1,3
TRAV12-2,TRAJ6,CAVILGGGSYIPTF,0,3,1,3
TRAV12-2,TRAJ52,CAVRGGTSYGKLTF,0,3,1,3
TRAV12-2,TRAJ52,CAVNSGTSYGKLAF,0,3,1,3
TRAV12-2,TRAJ26,CAVNGGDYGQNFVF,0,3,1,3
TRAV12-2,TRAJ26,CAVNMANYGQNFVF,0,3,1,3
TRAV36DV7,TRAJ42,CAGDYGGRQGNLIF,0,3,1,3
TRAV12-3,TRAJ54,CASGKFQGAQKLVF,0,3,1,3
TRAV27,TRAJ57,CAVPSRGGSEKLVF,0,3,1,3
TRAV13-1,TRAJ53,CAANSGGSNCKLTF,0,3,1,3
TRAV5,TRAJ12,CAASGRDSSYKLIF,0,3,1,3
TRAV13-1,TRAJ28,CAATRNAGSYQLTF,0,3,1,3
TRAV13-1,TRAJ10,CAAIPTGGGNKLTF,0,3,1,3
TRAV13-1,TRAJ27,CAATANTNAGKSTF,0,3,1,3
TRAV13-1,TRAJ54,CAASYGKGAQKLVF,0,3,1,3
TRAV13-1,TRAJ45,CAASGGGGADGLTF,0,3,1,3
TRAV13-1,TRAJ36,CAASGETGANNLFF,0,3,1,3
TRAV13-1,TRAJ36,CAASEGAGANNLFF,0,3,1,3
TRAV13-1,TRAJ24,CAASISDSWGKLQF,0,3,1,3
TRAV13-1,TRAJ26,CAASNPLYGQNFVF,0,3,1,3
TRAV13-1,TRAJ49,CAASKSNTGNQFYF,0,3,1,3
TRAV13-1,TRAJ29,CAASKGSGNTPLVF,0,3,1,3
TRAV29DV5,TRAJ30,CAASLMNRDDKIIF,0,3,1,3
TRAV23DV6,TRAJ37,CAASPASNTGKLIF,0,3,1,3
TRAV29DV5,TRAJ40,CAASATSGTYKYIF,0,3,1,3
TRAV23DV6,TRAJ13,CAASNSGGYQKVTF,0,3,1,3
TRAV23DV6,TRAJ5,CAASKQTGRRALTF,0,3,1,3
TRAV23DV6,TRAJ48,CAASKGFGNEKLTF,0,3,1,3
TRAV23DV6,TRAJ52,CAARGGTSYGKPTF,0,3,1,3
TRAV27,TRAJ15,CAGLFNQAGTALIF,0,3,1,3
TRAV5,TRAJ45,CAGATGGGADGLTF,0,3,1,3
TRAV25,TRAJ21,CAGPRGKVDNKFYF,0,3,1,3
TRAV27,TRAJ16,CAGRRASDGQKLLF,0,3,1,3
TRAV27,TRAJ40,CAGDPTSGTYKYIF,0,3,1,3
TRAV25,TRAJ3,CAGRGGSSASKIIF,0,3,1,3
TRAV27,TRAJ21,CAGLILYNFNKFYF,0,3,1,3
TRAV27,TRAJ42,CAGASRGSQGNLIF,0,3,1,3
TRAV27,TRAJ9,CAGGAHTGGFKTIF,0,3,1,3
TRAV27,TRAJ29,CAGERNSGNTPLVF,0,3,1,3
TRAV5,TRAJ3,CAETSYSSASKIIF,0,3,1,3
TRAV5,TRAJ9,CAESTNTGGFKTIF,0,3,1,3
TRAV13-2,TRAJ27,CAESSNTNAGKSTF,0,3,1,3
TRAV5,TRAJ13,CAERDSGGYQKVTF,0,3,1,3
TRAV13-2,TRAJ27,CAENTLINAGKTTF,0,3,1,3
TRAV13-2,TRAJ23,CAENKGNQGGKLIF,0,3,1,3
TRAV34,TRAJ30,CAIPPMYRVDKIIF,0,3,1,3
TRAV12-3,TRAJ43,CAMVSPPIGDDMRF,0,3,1,3
TRAV12-3,TRAJ52,CAMGDGTSYGKLTF,0,3,1,3
TRAV12-3,TRAJ54,CAMGRVLGAQKLVF,0,3,1,3
TRAV12-3,TRAJ23,CAMSLYNQGGKLIF,0,3,1,3
TRAV14DV4,TRAJ21,CAMSPRYNFNKFYF,0,3,1,3
TRAV12-3,TRAJ49,CAMSVRNTGNQFYF,0,3,1,3
TRAV12-3,TRAJ39,CAMSASNAGNMLTF,0,3,1,3
TRAV34,TRAJ48,CGADFNFGNEKLTF,0,3,1,3
TRAV41,TRAJ57,CTVPVQGGSVKLVF,0,3,1,3
TRAV4,TRAJ20,CLVAAFSNDYKLSF,0,3,1,3
TRAV4,TRAJ11,CLVGLNSGYSTLTF,0,3,1,3
TRAV4,TRAJ9,CLVGPRAGGFKTIF,0,3,1,3
TRAV26-2,TRAJ31,CILRDYDNNARLMF,0,3,1,3
TRAV26-1,TRAJ10,CIVSPTGGGNKLTF,0,3,1,3
TRAV26-1,TRAJ47,CIVRAMEYGNKLVF,0,3,1,3
TRAV26-1,TRAJ42,CIVRGRGSQGNLIF,0,3,1,3
TRAV26-1,TRAJ45,CIVRVGGGADGLTF,0,3,1,3
TRAV26-1,TRAJ33,CIVRVTDSNYQLIW,0,3,1,3
TRAV26-1,TRAJ20,CIVRDPRGDYKLSF,0,3,1,3
TRAV26-1,TRAJ26,CIVNPRAYGQNFVF,0,3,1,3
TRAV26-1,TRAJ58,CIAPRETSGSRLTF,0,3,1,3
TRAV13-1,TRAJ13,RAAHLSGGYQKVTF,0,3,1,3
TRAV8-2,TRAJ42,CVVAGGSQGNLIF,0,3,1,3
TRAV12-1,TRAJ29,CVVGDSGNTPLVF,0,3,1,3
TRAV12-1,TRAJ15,CVVINQAGTALIF,0,3,1,3
TRAV10,TRAJ39,CVVSLRAGNMLTF,0,3,1,3
TRAV10,TRAJ9,CVVSDAGGFKTIF,0,3,1,3
TRAV12-1,TRAJ11,CVVRDSGYSTLTF,0,3,1,3
TRAV10,TRAJ6,CVVNPGGSYIPTF,0,3,1,3
TRAV12-1,TRAJ39,CVAANNAGNMLTF,0,3,1,3
TRAV10,TRAJ32,CVARGGATNKLIF,0,3,1,3
TRAV13-1,TRAJ5,CVAKDTGRRALTF,0,3,1,3
TRAV38-1,TRAJ49,CAFITLTGNQFYF,0,3,1,3
TRAV6,TRAJ38,CASPAGNNRKLIW,0,3,1,3
TRAV38-1,TRAJ23,CAWNINQGGKLIF,0,3,1,3
TRAV38-2DV8,TRAJ54,CAYLIQGAQKLVF,0,3,1,3
TRAV38-2DV8,TRAJ56,CAYRAGANSKLTF,0,3,1,3
TRAV38-2DV8,TRAJ34,CAYRSPNTDKLIF,0,3,1,3
TRAV38-2DV8,TRAJ17,CAYRRAAGNKLTF,0,3,1,3
TRAV6,TRAJ23,CALFYNQGGKLIF,0,3,1,3
TRAV16,TRAJ44,CALNTGTASKLTF,0,3,1,3
TRAV9-2,TRAJ9,CALTYTGGFKTIF,0,3,1,3
TRAV9-2,TRAJ20,CALSGGNDYKLSF,0,3,1,3
TRAV9-2,TRAJ13,CALSGVGYQKVTF,0,3,1,3
TRAV29DV5,TRAJ21,CALRRYNFDKFYF,0,3,1,3
TRAV16,TRAJ58,CALTGASGSRLTF,0,3,1,3
TRAV16,TRAJ16,CALSGQGGQKLLF,0,3,1,3
TRAV16,TRAJ43,CALRPYNNNDMRF,0,3,1,3
TRAV16,TRAJ30,CALKVNRDDKIIF,0,3,1,3
TRAV6,TRAJ3,CAPIYSSASKIIF,0,3,1,3
TRAV12-2,TRAJ37,CAVLGSNTGKLIF,0,3,1,3
TRAV2,TRAJ24,CAVVPDSWGKLQF,0,3,1,3
TRAV22,TRAJ6,CAVSSGGSYIPTF,0,3,1,3
TRAV21,TRAJ29,CAVPNSGNTPLVF,0,3,1,3
TRAV2,TRAJ9,CAVPNTGGFKTIF,0,3,1,3
TRAV41,TRAJ42,CAVDGGSQGNLIF,0,3,1,3
TRAV36DV7,TRAJ26,CAVRGDYGQNFVF,0,3,1,3
TRAV41,TRAJ45,CAVKYGGADGLTF,0,3,1,3
TRAV8-3,TRAJ12,CAVLMDSSYKLIF,0,3,1,3
TRAV20,TRAJ40,CAVLPSGTYKYIF,0,3,1,3
TRAV20,TRAJ41,CAVQPNSGYALNF,0,3,1,3
TRAV20,TRAJ36,CAVQVTGANNLFF,0,3,1,3
TRAV8-3,TRAJ27,CAVANTNAGKSTF,0,3,1,3
TRAV8-3,TRAJ24,CAVGADSWGKLQF,0,3,1,3
TRAV8-3,TRAJ34,CAVGAVNTDKLIF,0,3,1,3
TRAV8-3,TRAJ13,CAVGARGYQKVTF,0,3,1,3
TRAV21,TRAJ39,CAVTPEAGNMLTF,0,3,1,3
TRAV8-4,TRAJ20,CAVSEGYDYKLSF,0,3,1,3
TRAV8-4,TRAJ44,CAVSEGTASKLTF,0,3,1,3
TRAV21,TRAJ16,CAVRPSEGQKLLF,0,3,1,3
TRAV12-2,TRAJ27,CAVRNTNAGKSTF,0,3,1,3
TRAV3,TRAJ20,CAVRAANDYKLSF,0,3,1,3
TRAV3,TRAJ21,CAVRDNNFNKFYF,0,3,1,3
TRAV12-2,TRAJ8,CAVRNTGFQKLVF,0,3,1,3
TRAV12-2,TRAJ13,CAVNSGGYQKATF,0,3,1,3
TRAV21,TRAJ6,CAVKEGGSYIPTF,0,3,1,3
TRAV41,TRAJ56,CAALTGANSKLTF,0,3,1,3
TRAV6,TRAJ8,CAALNTGFQKLVF,0,3,1,3
TRAV12-2,TRAJ13,CAAEERGYQKVTF,0,3,1,3
TRAV20,TRAJ27,CAAQDPNAGKSTF,0,3,1,3
TRAV8-3,TRAJ44,CAGNTGTASKLTF,0,5,1,5
TRAV35,TRAJ22,CAGPSGSARQLTF,0,3,1,3
TRAV22,TRAJ3,CAGATSSASKIIF,0,3,1,3
TRAV38-2DV8,TRAJ12,CAGRMDSSYKLIF,0,3,1,3
TRAV23DV6,TRAJ36,CAGDGTGANNLFF,0,3,1,3
TRAV17,TRAJ26,CATSDNYGQNFVF,0,3,1,3
TRAV17,TRAJ53,CATGGGSNYKLTF,0,3,1,3
TRAV17,TRAJ20,CATDRANDYKLSF,0,3,1,3
TRAV24,TRAJ42,CAFLRGSQGNLIF,0,3,1,3
TRAV24,TRAJ4,CAFISGGYNKLIF,0,3,1,3
TRAV24,TRAJ45,CAFAGGGADGLTF,0,3,1,3
TRAV39,TRAJ28,CASDGAGSYQLTF,0,3,1,3
TRAV12-2,TRAJ10,CALGTGGGNKLTF,0,3,1,3
TRAV12-2,TRAJ12,CAPFMDSSYKLIF,0,3,1,3
TRAV12-2,TRAJ42,CAVFGGSQGNLIF,0,3,1,3
TRAV8-1,TRAJ21,CAVPLPLTNKFYF,0,3,1,3
TRAV39,TRAJ40,CAVEEKGTYKYIF,0,3,1,3
TRAV8-1,TRAJ30,CAVTLNRDDKIIF,0,3,1,3
TRAV8-1,TRAJ17,CAVNPAAGNKLTF,0,3,1,3
TRAV8-1,TRAJ29,CAVNTPRNTPLVF,0,3,1,3
TRAV12-2,TRAJ15,CAVNVGAGTALIF,0,3,1,3
TRAV8-1,TRAJ16,CAVKGSDGQKLLF,0,3,1,3
TRAV12-2,TRAJ9,CAVKNTGGFKTIF,0,3,1,3
TRAV12-2,TRAJ11,CAAPNSGYSTLTF,0,3,1,3
TRAV27,TRAJ7,CAGVPMGNNRLAF,0,3,1,3
TRAV12-2,TRAJ16,CAGRFSDGQKLLF,0,3,1,3
TRAV17,TRAJ3,CAPCGSSASKIIF,0,3,1,3
TRAV13-1,TRAJ8,CAVENTGFQKLVF,0,3,1,3
TRAV12-3,TRAJ21,CAAAPYNFNKFYF,0,3,1,3
TRAV29DV5,TRAJ53,CAAAGGSNYKLTF,0,3,1,3
TRAV23DV6,TRAJ39,CAAPDNAGNMLTF,0,3,1,3
TRAV23DV6,TRAJ8,CAAINTGFQKLVF,0,3,1,3
TRAV13-1,TRAJ30,CAATSSRDDKIIF,0,3,1,3
TRAV13-1,TRAJ6,CAASITGSYIPTF,0,3,1,3
TRAV13-1,TRAJ49,CAASISAGNQFYF,0,3,1,3
TRAV13-1,TRAJ48,CAASTGGNEKLTF,0,3,1,3
TRAV13-1,TRAJ42,CAASKRSQGNLIF,0,3,1,3
TRAV29DV5,TRAJ49,CAASSNTGNQFYF,0,3,1,3
TRAV23DV6,TRAJ20,CAASWSNDYKLSF,0,3,1,3
TRAV29DV5,TRAJ54,CAASYQGAQKLVF,0,3,1,3
TRAV7,TRAJ34,CAASPGGTDKLIF,0,3,1,3
TRAV23DV6,TRAJ33,CAASPDSNYQLIW,0,3,1,3
TRAV29DV5,TRAJ26,CAASVSYGQNFVF,0,3,1,3
TRAV29DV5,TRAJ44,CAANYGTASKLTF,0,3,1,3
TRAV25,TRAJ35,CAGLGGFGNVLHC,0,3,1,3
TRAV27,TRAJ33,CAGVRGSNYQLIW,0,3,1,3
TRAV27,TRAJ33,CAGAGNGNYQLIW,0,3,1,3
TRAV27,TRAJ43,CAGGPQNNNDMRF,0,3,1,3
TRAV25,TRAJ6,CAGDSGGSYIPTF,0,3,1,3
TRAV27,TRAJ33,CAGEVGSNYQLIW,0,3,1,3
TRAV13-2,TRAJ45,CADPGGGADGLTF,0,3,1,3
TRAV5,TRAJ37,CAETWGNTGKLIF,0,3,1,3
TRAV13-2,TRAJ12,CAESMDSSYKLIF,0,3,1,3
TRAV5,TRAJ4,CAESPGGYNKLIF,0,3,1,3
TRAV13-2,TRAJ40,CAENVPGTYKYIF,0,3,1,3
TRAV13-2,TRAJ9,CAENRGGGFKTIF,0,3,1,3
TRAV14DV4,TRAJ29,CAITEGSNTPLVF,0,3,1,3
TRAV12-2,TRAJ3,CAIQNSSASKIIF,0,3,1,3
TRAV12-3,TRAJ6,CAMSSGGSYIPTF,0,3,1,3
TRAV12-3,TRAJ36,CAMGQTGANNLFF,0,3,1,3
TRAV14DV4,TRAJ34,CAMSYYNTDKLIF,0,3,1,3
TRAV12-3,TRAJ43,CAMSEYNNNDMRF,0,3,1,3
TRAV12-3,TRAJ9,CAMSATGGFKTIF,0,3,1,3
TRAV12-3,TRAJ7,CAMSADGNNRLAF,0,3,1,3
TRAV12-3,TRAJ17,CAMSKAAGNKLTF,0,3,1,3
TRAV12-3,TRAJ32,CAMRDGATNKLIF,0,3,1,3
TRAV14DV4,TRAJ49,CAMRRYSGNQFYF,0,3,1,3
TRAV12-3,TRAJ37,CAMKTSNIGKLIF,0,3,1,3
TRAV41,TRAJ45,CGFSGGGADGLTF,0,3,1,3
TRAV34,TRAJ57,CGADIGGSEKLVF,0,3,1,3
TRAV14DV4,TRAJ16,CTMREEDGQKLLF,0,3,1,3
TRAV4,TRAJ39,CLVGGDAGNMLTF,0,3,1,3
TRAV4,TRAJ43,CLVGDINNNDMRF,0,3,1,3
TRAV4,TRAJ8,CPAPERGFQKLVF,0,3,1,3
TRAV4,TRAJ5,CHPRNTGRRALTF,0,3,1,3
TRAV30,TRAJ8,CGTDNTGFQKLVF,0,3,1,3
TRAV26-2,TRAJ38,CILVAGNNRKLIW,0,3,1,3
TRAV26-2,TRAJ17,CILRKAAGNKLTF,0,3,1,3
TRAV26-2,TRAJ27,CILKGTNAGKSTF,0,3,1,3
TRAV26-1,TRAJ9,CIVPPTGGFKTIF,0,3,1,3
TRAV34,TRAJ27,RGAGAKRAGKSTF,0,3,1,3
TRAV26-1,TRAJ48,SIATKPSYEKLTF,0,3,1,3
TRAV12-1,TRAJ30,CVVTNRDDKIIF,0,3,1,3
TRAV10,TRAJ20,CVVSVNGYKLSF,0,3,1,3
TRAV12-1,TRAJ15,CVVNQAGTALIF,0,3,1,3
TRAV38-2DV8,TRAJ36,CAFRTGANNLFF,0,3,1,3
TRAV38-1,TRAJ41,CAFMKAGYALNF,0,3,1,3
TRAV38-2DV8,TRAJ27,CAYRSNAGKSTF,0,3,1,3
TRAV9-2,TRAJ22,CALTGSARQLTF,0,3,1,3
TRAV16,TRAJ15,CALLTGGTALIF,0,3,1,3
TRAV6,TRAJ20,CALGLNDYKLSF,0,3,1,3
TRAV36DV7,TRAJ43,CAVWYNNNDMRF,0,3,1,3
TRAV3,TRAJ43,CAVWGNNNDMRF,0,3,1,3
TRAV41,TRAJ34,CAVKSNPDKLIF,0,3,1,3
TRAV22,TRAJ45,CAVRGGADGLTF,0,3,1,3
TRAV21,TRAJ42,CAVVQSQGNLIF,0,3,1,3
TRAV2,TRAJ13,CAVAGGYQKVTF,0,3,1,3
TRAV8-4,TRAJ49,CAVASTGNQFYF,0,3,1,3
TRAV20,TRAJ30,CAVALSGDKIIF,0,3,1,3
TRAV2,TRAJ31,CAVARYNARLMF,0,3,1,3
TRAV8-3,TRAJ34,CAVGYNTDKLIL,0,3,1,3
TRAV2,TRAJ41,CAVGGSGYALNF,0,3,1,3
TRAV2,TRAJ31,CAVESNNARLMF,0,3,1,3
TRAV36DV7,TRAJ34,CAVEPNTDKLIF,0,3,1,3
TRAV12-2,TRAJ47,CAVRPGMGKLVF,0,3,1,3
TRAV3,TRAJ31,CAVRDVSARLMF,0,3,1,3
TRAV3,TRAJ43,CAVRDNNNEMRF,0,3,1,3
TRAV36DV7,TRAJ58,CAVETSGSRLTF,0,3,1,3
TRAV21,TRAJ23,CAVSPPGGKLIF,0,3,1,3
TRAV41,TRAJ49,CAASNTGNQFYF,0,3,1,3
TRAV21,TRAJ35,CAGYGLWECAAC,0,3,1,3
TRAV17,TRAJ8,CATPTGFQKPVF,0,3,1,3
TRAV17,TRAJ29,CATGSGNTPLVF,0,3,1,3
TRAV24,TRAJ37,CAFTSNTGKLIF,0,3,1,3
TRAV13-1,TRAJ34,CAPPWNTDKLIF,0,3,1,3
TRAV12-2,TRAJ48,CAVNFGNEKLTF,0,3,1,3
TRAV39,TRAJ48,CAVAFGNEKLTF,0,3,1,3
TRAV12-2,TRAJ39,CAVGGAGNMLTF,0,3,1,3
TRAV39,TRAJ29,CAVDIENTPLVF,0,3,1,3
TRAV12-2,TRAJ42,CAVTGSQGNLIF,0,3,1,3
TRAV8-1,TRAJ43,CAVNARDNDMRF,0,3,1,3
TRAV12-2,TRAJ47,CAVNTGGNKLVF,0,3,1,3
TRAV12-2,TRAJ31,CAVKGNNARLMF,0,3,1,3
TRAV12-2,TRAJ53,CAVKGSNYKLTF,0,3,1,3
TRAV12-2,TRAJ13,CAAPGGYQKVTF,0,3,1,3
TRAV22,TRAJ49,CAANRRGNQFYF,0,3,1,3
TRAV12-2,TRAJ16,CAAFSDGQKLLF,0,3,1,3
TRAV12-2,TRAJ38,CAGAGNNRKLIW,0,3,1,3
TRAV12-2,TRAJ12,CAGMDSSYKLIF,0,3,1,3
TRAV36DV7,TRAJ49,CAVPNTGNQFYF,0,3,1,3
TRAV27,TRAJ54,CAGIQGAQKLVF,0,3,1,3
TRAV23DV6,TRAJ11,CASPGGYSTLTF,0,3,1,3
TRAV27,TRAJ40,CAHRSGTYKYIF,0,3,1,3
TRAV29DV5,TRAJ36,CAAPGGANNLFF,0,3,1,3
TRAV23DV6,TRAJ31,CAATNNNARLMF,0,3,1,3
TRAV23DV6,TRAJ49,CAALGTGNQFYF,0,3,1,3
TRAV13-1,TRAJ12,CAAEDSSYKLIF,0,3,1,3
TRAV13-1,TRAJ6,CAATSGSYIPTF,0,3,1,3
TRAV23DV6,TRAJ23,CAASYEGGKLIF,0,3,1,3
TRAV29DV5,TRAJ30,CAASATDDKIIF,0,3,1,3
TRAV23DV6,TRAJ34,CAASKETDKLIF,0,3,1,3
TRAV13-1,TRAJ6,CAAKGGSYIPTF,0,3,1,3
TRAV25,TRAJ17,CAGPIAGNKLTF,0,3,1,3
TRAV25,TRAJ26,CAGRSYGQNFVF,0,3,1,3
TRAV25,TRAJ13,CAGQGGYQKVTF,0,3,1,3
TRAV27,TRAJ20,CAGAPNDYKLSF,0,3,1,3
TRAV27,TRAJ30,CAGARRHDKIIF,0,3,1,3
TRAV13-2,TRAJ21,CAEGGNFNKFYF,0,3,1,3
TRAV13-2,TRAJ49,CAETSTGNQFYF,0,3,1,3
TRAV5,TRAJ3,CAERPSASKIIF,0,3,1,3
TRAV5,TRAJ12,CAERDSSYKLIF,0,3,1,3
TRAV5,TRAJ36,CAEKPGANNLFF,0,3,1,3
TRAV13-2,TRAJ43,CAEKGNNNDMRF,0,3,1,3
TRAV14DV4,TRAJ50,CAMETSYDKVIF,0,3,1,3
TRAV12-3,TRAJ20,CAMSAYDYKLSF,0,3,1,3
TRAV14DV4,TRAJ21,CAMRSFFNKIYF,0,3,1,3
TRAV34,TRAJ36,CGAGTGANNLFF,0,3,1,3
TRAV4,TRAJ23,CLVGDGGGKLIF,0,3,1,3
TRAV4,TRAJ40,CLVDPGTYKYIF,0,3,1,3
TRAV4,TRAJ27,CLVSTNAGKSTF,0,3,1,3
TRAV4,TRAJ29,CLAYTGNTPLVF,0,3,1,3
TRAV8-4,TRAJ31,CAVSDREARLMF,0,3,1,3
TRAV26-2,TRAJ35,CILRGFGNVLHC,0,3,1,3
TRAV26-1,TRAJ34,CIVLYNTDKLIF,0,3,1,3
TRAV26-1,TRAJ20,CIVRVFDYKLSF,0,3,1,3
TRAV26-1,TRAJ7,CIVGYGNNRLAF,0,3,1,3
TRAV26-1,TRAJ49,CIAGNTGNQFYF,0,3,1,3
TRAV26-2,TRAJ28,CIAGAGSYQLTF,0,3,1,3
TRAV17,TRAJ35,FTIGFGNVLHC,0,3,1,3
TRAV20,TRAJ30,CSMNRDDKIIF,0,3,1,3
TRAV12-1,TRAJ49,CVVPTGNQFYF,0,3,1,3
TRAV12-1,TRAJ31,CVVSLGARLMF,0,3,1,3
TRAV12-1,TRAJ11,CVVRGYSTLTF,0,3,1,3
TRAV12-1,TRAJ30,CVVNRDDKIIF,0,3,1,3
TRAV9-2,TRAJ43,CALSDRGDMRF,0,3,1,3
TRAV17,TRAJ9,CAPNGGFKTIF,0,3,1,3
TRAV21,TRAJ49,CAVCTGNQFYF,0,3,1,3
TRAV41,TRAJ49,CAVCPSNQFYF,0,3,1,3
TRAV41,TRAJ33,CAVHSNYQLIW,0,3,1,3
TRAV12-2,TRAJ20,CAVHSGYKLSF,0,3,1,3
TRAV2,TRAJ20,CAVADDYKLSF,0,3,1,3
TRAV2,TRAJ20,CAVGNDYKLSF,0,3,1,3
TRAV22,TRAJ9,CAVERGFKTIF,0,3,1,3
TRAV21,TRAJ29,CAVSGNTPLVF,0,3,1,3
TRAV2,TRAJ16,CAVSDGQKLLF,0,3,1,3
TRAV21,TRAJ16,CAAQDGQKLLF,0,3,1,3
TRAV3,TRAJ24,CAANSWGKLQF,0,3,1,3
TRAV17,TRAJ26,CAHNYGQNFVF,0,3,1,3
TRAV12-3,TRAJ34,CAQEDTDKLIF,0,3,1,3
TRAV12-2,TRAJ12,CAVDSSYKLIF,0,3,1,3
TRAV2,TRAJ20,CAERDYYKLSF,0,3,1,3
TRAV17,TRAJ24,CATGSWGKLQF,0,3,1,3
TRAV27,TRAJ26,CAGSYGQNFVF,0,3,1,3
TRAV12-3,TRAJ16,CAWDDGQKLLF,0,3,1,3
TRAV23DV6,TRAJ41,CAAHSGYALNF,0,3,1,3
TRAV23DV6,TRAJ24,CAAHSWGKLQF,0,3,1,3
TRAV23DV6,TRAJ31,CAAGENARLMF,0,3,1,3
TRAV13-1,TRAJ4,CAASGYNKLIF,0,3,1,3
TRAV13-1,TRAJ17,CAANQGNKLTF,0,3,1,3
TRAV5,TRAJ34,CAESNTDKLIF,0,3,1,3
TRAV12-3,TRAJ54,CAMWGAQKLVF,0,3,1,3
TRAV12-3,TRAJ9,CAMTGGFKTIF,0,3,1,3
TRAV12-3,TRAJ23,CAMSAEGKLIF,0,3,1,3
TRAV30,TRAJ8,CGPGGFQKLVF,0,3,1,3
TRAV26-2,TRAJ49,CIPNTGNQFYF,0,3,1,3
TRAV38-2DV8,TRAJ43,CAYPRNDMRF,0,3,1,3
TRAV38-2DV8,TRAJ30,CAYGDDKIIF,0,3,1,3
TRAV41,TRAJ43,CAVCNNDMRF,0,3,1,3
TRAV3,TRAJ21,CAVRDLKFYF,0,3,1,3
TRAV24,TRAJ34,CAPCTDKLIF,0,3,1,3
TRAV8-6,TRAJ44,CAGTASKLTF,0,3,1,3
TRAV39,TRAJ30,CAGRDDKIIF,0,3,1,3
TRAV13-1,TRAJ20,CAPGDYKLSF,0,3,1,3
TRAV25,TRAJ27,CAGHAGKSTF,0,3,1,3
TRAV25,TRAJ34,CAGNTDKLIF,0,3,1,3
TRAV4,TRAJ16,CLVDGQKLLF,0,3,1,3
TRAV26-1,TRAJ34,CIVYTDKLIF,0,3,1,3
TRAV6,TRAJ3,WPRASKIIF,0,3,1,3
TRAV21,TRAJ36,CAPNNLFF,0,3,1,3
TRAV12-2,TRAJ30,CAVNEIIF,0,3,1,3
TRAV27,TRAJ43,CAGGDMRF,0,3,1,3
TRAV3,TRAJ41,ISGYALNF,0,3,1,3
TRAV13-2,TRAJ43,CDNDMRF,0,3,1,3
TRAV20,TRAJ52,CAVQSPRAGGTSYGKLTF,0,2,1,2
TRAV20,TRAJ13,CAVQAPALNSGGYQKVTF,0,2,1,2
TRAV36DV7,TRAJ52,CAVASLNAGGTSYGKLTF,0,2,1,2
TRAV14DV4,TRAJ28,CAMRGPTYSGAGSYQLTF,0,2,1,2
TRAV4,TRAJ42,CLVGDLANYGGSQGNLIF,0,2,1,2
TRAV4,TRAJ37,CLVGDARPLASNTGKLIF,0,2,1,2
TRAV4,TRAJ4,CLVGDRGSISGGYNKLIF,0,2,1,2
TRAV26-1,TRAJ53,CITPIQQNSGGSNYKLTF,0,2,1,2
TRAV12-1,TRAJ42,CVVNGGNYGGSQGNLIF,0,2,1,2
TRAV38-2DV8,TRAJ42,CAYSTLGYGGSQGNLIF,0,2,1,2
TRAV38-2DV8,TRAJ53,CAYRSPNSGGSNYKLTF,0,2,1,2
TRAV38-2DV8,TRAJ45,CAYRSAMSRGGADGLTF,0,2,1,2
TRAV9-2,TRAJ52,CALGPNAGGTSYGKLTF,0,2,1,2
TRAV6,TRAJ37,CALDEERGSSNTGKLIF,0,2,1,2
TRAV3,TRAJ36,CAVRDDADQTGANNLFF,0,2,1,2
TRAV12-2,TRAJ56,CAVDRSIHTGANSKLTF,0,2,1,2
TRAV8-1,TRAJ28,CAVNAPYSGAGSYQLTF,0,2,1,2
TRAV13-1,TRAJ6,CAASRRGTSGGSYIPTF,0,2,1,2
TRAV13-1,TRAJ18,CAASMEGRGSTLGRLYF,0,2,1,2
TRAV29DV5,TRAJ40,CAASALRMASGTYKYIF,0,2,1,2
TRAV13-2,TRAJ11,CAERTPRGNSGYSTLTF,0,2,1,2
TRAV13-2,TRAJ37,CAEKDSRGSSNTGKLIF,0,2,1,2
TRAV12-3,TRAJ52,CAMSASAGGTSYGKLTF,0,2,1,2
TRAV14DV4,TRAJ36,CAMREGRALAGANNLFF,0,2,1,2
TRAV14DV4,TRAJ45,CAMREGHSGGGADGLTF,0,2,1,2
TRAV14DV4,TRAJ44,CAMREGSNTGTASKLTF,0,2,1,2
TRAV12-3,TRAJ18,CATPLAAGGSTLGRLYF,0,2,1,2
TRAV4,TRAJ23,CLVGVPLLYNQGGKLIF,0,2,1,2
TRAV4,TRAJ27,CLVGDGLRDTNAGKSTL,0,2,1,2
TRAV4,TRAJ3,CLVGDIPGYSSASKIIF,0,2,1,2
TRAV4,TRAJ42,CLVGDMIDGGSQGNLIF,0,2,1,2
TRAV4,TRAJ18,CLVGPADRGSTLGRLYF,0,2,1,2
TRAV12-1,TRAJ22,CVVNPISSGSARQLTF,0,2,1,2
TRAV12-1,TRAJ42,CVVNGWYGGSQGNLIF,0,2,1,2
TRAV38-1,TRAJ52,CAFINAGGTSYGKLTF,0,2,1,2
TRAV17,TRAJ4,CASASWFSGGYNKLIF,0,2,1,2
TRAV6,TRAJ10,CALGAILTGGGNKLTF,0,2,1,2
TRAV19,TRAJ57,CALSVPFSGRSEKLVF,0,2,1,2
TRAV9-2,TRAJ13,CALSGRDSGGYQKVTF,0,2,1,2
TRAV9-2,TRAJ58,CALSEWGETSGSRLTF,0,2,1,2
TRAV16,TRAJ42,CALSLDYGGSQGNLIF,0,2,1,2
TRAV36DV7,TRAJ52,CAVLNAGGTSYGKLTL,0,2,1,2
TRAV8-3,TRAJ6,CAVGSLPSGGSYIPTF,0,2,1,2
TRAV8-3,TRAJ18,CAVGARRGSTLGRLYF,0,2,1,2
TRAV36DV7,TRAJ44,CAVEGRGTGTASKLTF,0,2,1,2
TRAV22,TRAJ35,CAVENERVGFGNVLHC,0,2,1,2
TRAV8-4,TRAJ52,CAVTYSGGTSYGKLTF,0,2,1,2
TRAV8-6,TRAJ13,CAVSAFNSGGYQKVTF,0,2,1,2
TRAV3,TRAJ9,CAVRDTRGVRGFKTIF,0,2,1,2
TRAV3,TRAJ28,CAVRMASGAGSYQLTF,0,2,1,2
TRAV35,TRAJ42,CAGPPNYGGSQGNLIF,0,2,1,2
TRAV12-2,TRAJ45,CAVNNRSGGGADGLTF,0,2,1,2
TRAV27,TRAJ42,CAAPSARGGSQGNLIF,0,2,1,2
TRAV29DV5,TRAJ32,CAASAFSSGATNKLIF,0,2,1,2
TRAV29DV5,TRAJ37,CAASAKDSSNTGKLIF,0,2,1,2
TRAV23DV6,TRAJ42,CAASGSDGGSQGNLIF,0,2,1,2
TRAV23DV6,TRAJ10,CAASDGVTGGGNKLTF,0,2,1,2
TRAV23DV6,TRAJ18,CAASDDRGSTLGRLYF,0,2,1,2
TRAV23DV6,TRAJ53,CAASMGSGGSNYKLTF,0,2,1,2
TRAV23DV6,TRAJ57,CAASTLTQGGSEKLVF,0,2,1,2
TRAV27,TRAJ52,CAGANAGGTSYGKLTF,0,2,1,2
TRAV13-2,TRAJ23,CAEIRVPYNQGGKLIF,0,2,1,2
TRAV13-2,TRAJ22,CAEIRISSGSARQLTF,0,2,1,2
TRAV5,TRAJ32,CAESRWYGGATNKLIL,0,2,1,2
TRAV13-2,TRAJ53,CAENLGSGGSNYKLTF,0,2,1,2
TRAV12-3,TRAJ45,CAMSFYSGGGADGLTF,0,2,1,2
TRAV12-3,TRAJ58,CAMSSGWETSGSRLTF,0,2,1,2
TRAV12-3,TRAJ42,CAMSLNYGGSQGNLIF,0,2,1,2
TRAV12-3,TRAJ36,CAMSETTVTGANNLFF,0,2,1,2
TRAV14DV4,TRAJ57,CAMREATQGGSEKLVF,0,2,1,2
TRAV14DV4,TRAJ3,CAMREGRDSSASKIIF,0,2,1,2
TRAV14DV4,TRAJ35,CAMREERIGFGNVLHC,0,2,1,2
TRAV4,TRAJ37,CLVGDPLSSNTGKLIF,0,2,1,2
TRAV4,TRAJ36,CLVGDTVQTGANNLFF,0,2,1,2
TRAV30,TRAJ52,CGTENAGGTSYGKLTF,0,2,1,2
TRAV26-2,TRAJ48,CILSALTNFGNEKLTF,0,2,1,2
TRAV26-2,TRAJ58,CILRDGQETSGSRLTF,0,2,1,2
TRAV26-1,TRAJ20,CIVRVVDGYYDYKLSF,0,2,1,2
TRAV25,TRAJ3,CSRTSGYSSASKIIF,0,2,1,2
TRAV9-2,TRAJ57,CVLSPTQGGSEKLVF,0,2,1,2
TRAV8-2,TRAJ50,CVVSDRKTSYDKVIF,0,2,1,2
TRAV8-2,TRAJ13,CVVSGRSGGYQKVTF,0,2,1,2
TRAV10,TRAJ10,CVVIPITGGGNKLTF,0,2,1,2
TRAV10,TRAJ13,CVVSPYSGGYQKVTF,0,2,1,2
TRAV12-1,TRAJ42,CVVNLGGGSQGNLIF,0,2,1,2
TRAV12-1,TRAJ22,CVVNDPSGSARQLTF,0,2,1,2
TRAV12-1,TRAJ45,CVVNNGGGGADGLTF,0,2,1,2
TRAV38-1,TRAJ48,CAFMKANFGNEKLTF,0,2,1,2
TRAV38-2DV8,TRAJ42,CAYRGAWRSQGNLIF,0,2,1,2
TRAV38-2DV8,TRAJ29,CAYRTVSPGNTPLVF,0,2,1,2
TRAV38-2DV8,TRAJ8,CAYRSADTGFQKLVF,0,2,1,2
TRAV38-2DV8,TRAJ32,CAYRRYGGATNKLIF,0,2,1,2
TRAV9-2,TRAJ52,CALNPGGTSYGKLTF,0,2,1,2
TRAV9-2,TRAJ35,CALILPIGFGNVLHC,0,2,1,2
TRAV9-2,TRAJ15,CALTSANQAGTALIF,0,2,1,2
TRAV9-2,TRAJ27,CALSDYNTNAGKSTF,0,2,1,2
TRAV9-2,TRAJ13,CALSDRPGGYQKVTF,0,2,1,2
TRAV9-2,TRAJ56,CALSDQTGANSKLTF,0,2,1,2
TRAV19,TRAJ27,CALSEKSLGAGKSTF,0,2,1,2
TRAV19,TRAJ39,CALSRTNNAGNMLTF,0,2,1,2
TRAV6,TRAJ28,CALEYSGAGSYQLTF,0,2,1,2
TRAV16,TRAJ10,CALSPLAGGGNKLTF,0,2,1,2
TRAV21,TRAJ32,CAVWNYGGATNKLIF,0,2,1,2
TRAV2,TRAJ27,CAVPGYNTNAGKSTF,0,2,1,2
TRAV12-2,TRAJ13,CAVPDYSGGYQKVTF,0,2,1,2
TRAV41,TRAJ42,CAVGIYGGSQGNLIL,0,2,1,2
TRAV41,TRAJ44,CAVSLNTGTASKLTF,0,2,1,2
TRAV20,TRAJ23,CAVQAIGDQGGKLIF,0,2,1,2
TRAV12-2,TRAJ42,CAVVFWSGSQGNLIF,0,2,1,2
TRAV8-3,TRAJ39,CAVAPGGNAGNMLTF,0,2,1,2
TRAV36DV7,TRAJ28,CAVAASGAGSYQLTF,0,2,1,2
TRAV8-3,TRAJ39,CAVGAMVNAGNTLTF,0,2,1,2
TRAV8-4,TRAJ23,CAVGLIYNRGGKLIF,0,2,1,2
TRAV22,TRAJ58,CAVDPKETSGSRLTF,0,2,1,2
TRAV2,TRAJ22,CAVDILSGSARQLTF,0,2,1,2
TRAV8-4,TRAJ13,CAVSRPSGGYQKVTF,0,2,1,2
TRAV8-6,TRAJ47,CAVSERQEYGNKLVF,0,2,1,2
TRAV3,TRAJ24,CAVRSSTDSWGKLQF,0,2,1,2
TRAV21,TRAJ44,CAVRPWSGTASKLTF,0,2,1,2
TRAV21,TRAJ6,CAVRRMAGGSYIPTF,0,2,1,2
TRAV3,TRAJ35,CAVRDRIGFGNVLHC,0,2,1,2
TRAV3,TRAJ7,CAVRSPYYGNNRLAF,0,2,1,2
TRAV3,TRAJ8,CAVRALNTGFQKLVF,0,2,1,2
TRAV3,TRAJ32,CAVRDYGGATNKLIF,0,2,1,2
TRAV3,TRAJ9,CAVRDTGTGGFKTIF,0,2,1,2
TRAV8-4,TRAJ48,CAVNEVGFGNEKLTF,0,2,1,2
TRAV20,TRAJ42,CAAGDYGGSQGNLIF,0,2,1,2
TRAV41,TRAJ42,CAGLRDGGSQGNLIF,0,2,1,2
TRAV36DV7,TRAJ38,CAEGLNAGNNRKLIW,0,2,1,2
TRAV17,TRAJ45,CATYGGGGGADGLTF,0,2,1,2
TRAV39,TRAJ32,CAVRLYGGATNKLIF,0,2,1,2
TRAV12-2,TRAJ57,CAVGLEEGGSEKLVF,0,2,1,2
TRAV12-2,TRAJ4,CAVTSGRGGYNKLIF,0,2,1,2
TRAV12-2,TRAJ29,CAVNPRNSGNTPLVF,0,2,1,2
TRAV12-2,TRAJ40,CAVNGGTSGTYKYIF,0,2,1,2
TRAV12-2,TRAJ53,CAVNRSGGSNYKLTF,0,2,1,2
TRAV8-1,TRAJ4,CAVKSFSRGYNKLIF,0,2,1,2
TRAV12-2,TRAJ52,CAVKAGGTSYGELTF,0,2,1,2
TRAV12-1,TRAJ42,CAGNIYGGSQGNLIF,0,2,1,2
TRAV27,TRAJ52,CAPTAGGTSYGKLTF,0,2,1,2
TRAV13-1,TRAJ39,CAAHAPNNAGNMLTF,0,2,1,2
TRAV13-1,TRAJ45,CAAWYSGGGADGLTF,0,2,1,2
TRAV13-1,TRAJ40,CAAVVQSSGTYKYIF,0,2,1,2
TRAV13-1,TRAJ29,CAAGGGLSGNTPLVL,0,2,1,2
TRAV13-1,TRAJ50,CAASYMETSYDKVIF,0,2,1,2
TRAV13-1,TRAJ16,CAASPLGSDGQKLLF,0,2,1,2
TRAV13-1,TRAJ38,CAASRGAGSNRKLIW,0,2,1,2
TRAV13-1,TRAJ23,CAASLPWGQGGKLIF,0,2,1,2
TRAV23DV6,TRAJ41,CAASRNSNSGYALNF,0,2,1,2
TRAV29DV5,TRAJ22,CAASALDGSARQLTF,0,2,1,2
TRAV29DV5,TRAJ4,CAASEFSGGYNKLIF,0,2,1,2
TRAV13-1,TRAJ18,CAANPRGSTLGRLYF,0,2,1,2
TRAV25,TRAJ23,CAGPPPYNQGGKLIF,0,2,1,2
TRAV23DV6,TRAJ24,CAGGRKTDSWGKLQF,0,2,1,2
TRAV27,TRAJ53,CAGARSGGSNYKLTF,0,2,1,2
TRAV27,TRAJ42,CAGEGYGGSQGNLIF,0,2,1,2
TRAV13-2,TRAJ42,CAETLWGGSQGNLIF,0,2,1,2
TRAV5,TRAJ3,CAETPGYSSASKIIF,0,2,1,2
TRAV13-2,TRAJ4,CAENPQRGGYNKLIF,0,2,1,2
TRAV13-2,TRAJ50,CAENDPKTSYDKVIF,0,2,1,2
TRAV12-3,TRAJ9,CAMSSRARVGFKTIF,0,2,1,2
TRAV12-3,TRAJ52,CAMSALGTSYGKLTF,0,2,1,2
TRAV12-3,TRAJ38,CAMSANAGNNRKLIW,0,2,1,2
TRAV12-3,TRAJ21,CAMSGNWYNFNKFYF,0,2,1,2
TRAV12-3,TRAJ3,CAMSGYYSSASKIIF,0,2,1,2
TRAV14DV4,TRAJ8,CAMREPNTGFQKLVF,0,2,1,2
TRAV34,TRAJ32,CGADITGGATNKLIF,0,2,1,2
TRAV4,TRAJ38,CLVALNAGNNRKLIW,0,2,1,2
TRAV4,TRAJ8,CLVGALNTGFQKLVF,0,2,1,2
TRAV4,TRAJ40,CLVGAPTSGTYKYIF,0,2,1,2
TRAV4,TRAJ40,CLVGDGDSGTYKYIF,0,2,1,2
TRAV4,TRAJ8,CLVGDMNTGIQKLVF,0,2,1,2
TRAV4,TRAJ9,CLVGDRGTGGFKTIF,0,2,1,2
TRAV4,TRAJ32,CLVGDKNGATNKLIF,0,2,1,2
TRAV4,TRAJ10,CLVGPSTGGGNKLTF,0,2,1,2
TRAV4,TRAJ5,CLVGPMDTGRRALTF,0,2,1,2
TRAV13-2,TRAJ17,CAERPGKAAGNKLTF,0,2,1,2
TRAV26-2,TRAJ53,CILRSPGGSNYKLTF,0,2,1,2
TRAV26-2,TRAJ34,CILRDPPAIADKLIF,0,2,1,2
TRAV26-1,TRAJ52,CIVSPGGTSYGKLTF,0,2,1,2
TRAV26-1,TRAJ39,CIVRSRFNAGNMLTF,0,2,1,2
TRAV26-1,TRAJ16,CIVRPSFSDGQKLLF,0,2,1,2
TRAV26-1,TRAJ44,CIVRVGTGTASKLTF,0,2,1,2
TRAV26-1,TRAJ39,CIVRVGNNAGNMLTF,0,2,1,2
TRAV26-1,TRAJ33,CIVRVSRDSNYQLIW,0,2,1,2
TRAV8-2,TRAJ5,SVVSDTYTGRRALTF,0,2,1,2
TRAV25,TRAJ52,CRSAGGTSYGKLTF,0,2,1,2
TRAV8-2,TRAJ50,CVVSDPTSYDKVIF,0,2,1,2
TRAV8-2,TRAJ43,CVVSDRSNNNDMRF,0,2,1,2
TRAV8-2,TRAJ20,CVVSETTNDYKLSF,0,2,1,2
TRAV12-1,TRAJ37,CVVGGSSNTGKLIF,0,2,1,2
TRAV12-1,TRAJ22,CVVDQGGSARQLTF,0,2,1,2
TRAV12-1,TRAJ3,CVVIPYSCASKIIF,0,2,1,2
TRAV12-1,TRAJ43,CVVTPNYNNNDMRF,0,2,1,2
TRAV12-1,TRAJ27,CVVTDNTNAGKSTF,0,2,1,2
TRAV10,TRAJ45,CVVSVRGGADGLTF,0,2,1,2
TRAV10,TRAJ44,CVVSAAGTASKLTF,0,2,1,2
TRAV12-1,TRAJ13,CVVRGPGGYQKVTF,0,2,1,2
TRAV12-1,TRAJ34,CVVNYSYNTDKLIF,0,2,1,2
TRAV12-1,TRAJ27,CVVNVDTNAGKSTF,0,2,1,2
TRAV12-1,TRAJ48,CVVNINFGNEKLTF,0,2,1,2
TRAV12-1,TRAJ6,CVGQASGGSYIPTF,0,2,1,2
TRAV12-1,TRAJ12,CVESLMDSSYKLIF,0,2,1,2
TRAV38-1,TRAJ39,CAFMSYNTGNMLTF,0,2,1,2
TRAV38-2DV8,TRAJ44,CAYSTTGTAGKLTF,0,2,1,2
TRAV38-2DV8,TRAJ30,CAYRGRDRDDKIIF,0,2,1,2
TRAV38-2DV8,TRAJ40,CAYRDGSGTYKYIF,0,2,1,2
TRAV38-2DV8,TRAJ56,CAYRSAGANSKLTF,0,2,1,2
TRAV38-2DV8,TRAJ9,CAYRSETGGFKTIF,0,2,1,2
TRAV38-2DV8,TRAJ30,CAYSLMNRDDKIIF,0,2,1,2
TRAV9-2,TRAJ37,CALSDSSNTGKLIF,0,2,1,2
TRAV9-2,TRAJ44,CALSNTGTASKLTF,0,2,1,2
TRAV9-2,TRAJ53,CALRGGGSNYKLTF,0,2,1,2
TRAV21,TRAJ11,CALGALSGYSTLTF,0,2,1,2
TRAV6,TRAJ8,CALDPLTGFQKLVL,0,2,1,2
TRAV16,TRAJ3,CALEGYSSASKIIF,0,2,1,2
TRAV16,TRAJ30,CALTGGGRDDKIIF,0,2,1,2
TRAV19,TRAJ45,CARRSGGGADGLTF,0,2,1,2
TRAV2,TRAJ26,CAVSSTNYGQNFVF,0,2,1,2
TRAV12-2,TRAJ26,CAVIGRNYGQNLVF,0,2,1,2
TRAV20,TRAJ36,CAVFDQTGANNLFF,0,2,1,2
TRAV22,TRAJ57,CAVLPQGGSEKLVF,0,2,1,2
TRAV21,TRAJ52,CAVYGGTSYGKLTF,0,2,1,2
TRAV20,TRAJ17,CAVPKGAAGNKLTF,0,2,1,2
TRAV20,TRAJ37,CAVHGSSNTGKLIF,0,2,1,2
TRAV20,TRAJ23,CAVQSYNQGGKLIF,0,2,1,2
TRAV8-3,TRAJ6,CAVVTSGGSYIPTF,0,2,1,2
TRAV8-3,TRAJ23,CAVGPYNQGGKLIF,0,2,1,2
TRAV2,TRAJ44,CAVGNTGTASKLTF,0,2,1,2
TRAV2,TRAJ30,CAVEDQRRDDKIIF,0,2,1,2
TRAV1-2,TRAJ16,CAVILRRDGQKLLF,0,2,1,2
TRAV8-4,TRAJ29,CAVSSNSGNTPLVF,0,2,1,2
TRAV8-6,TRAJ37,CAVSPSSNTGKLIF,0,2,1,2
TRAV8-6,TRAJ34,CAVSPLGDTDKLIF,0,2,1,2
TRAV3,TRAJ3,CAVRLYSSASKIIF,0,2,1,2
TRAV21,TRAJ6,CAVRQTGGSYIPTF,0,2,1,2
TRAV12-2,TRAJ23,CAVRGYNQGGKLIF,0,2,1,2
TRAV12-2,TRAJ39,CAVRGHNAGNMLTF,0,2,1,2
TRAV3,TRAJ47,CAVRDMEYGNKLVF,0,2,1,2
TRAV3,TRAJ35,CAVRGTGFGNVLHC,0,2,1,2
TRAV3,TRAJ31,CAVRDLNNNARLMF,0,2,1,2
TRAV3,TRAJ27,CAVRDGTNAGKSTF,0,2,1,2
TRAV8-4,TRAJ6,CAVKRAGGSYIPTF,0,2,1,2
TRAV3,TRAJ28,CAGGPGAGSYQLTF,0,2,1,2
TRAV35,TRAJ50,CAGQRGTSYDKVIF,0,2,1,2
TRAV35,TRAJ39,CAGQNRNAGNMLTF,0,2,1,2
TRAV8-6,TRAJ22,CAMSETGSARQLTF,0,2,1,2
TRAV17,TRAJ28,CATVAGAGSYQLTF,0,2,1,2
TRAV17,TRAJ29,CATDPHSGNTPLVF,0,2,1,2
TRAV17,TRAJ37,CATDARDNTGKLIF,0,2,1,2
TRAV17,TRAJ33,CATDEGDSNYQLIW,0,2,1,2
TRAV17,TRAJ16,CASYFSSDGQKLLF,0,2,1,2
TRAV24,TRAJ30,CAFKLGYRDDKIIF,0,2,1,2
TRAV8-1,TRAJ3,CAFAGYSSASKIIF,0,2,1,2
TRAV12-2,TRAJ5,CALAGSPGRRALTF,0,2,1,2
TRAV12-2,TRAJ6,CALTSAGGSYIPTF,0,2,1,2
TRAV29DV5,TRAJ9,CALSDNTGGFKTIF,0,2,1,2
TRAV12-2,TRAJ27,CALGGGTNAGKSTF,0,2,1,2
TRAV12-2,TRAJ4,CAVMFSGGYNKLIF,0,2,1,2
TRAV39,TRAJ41,CAVYQGNSGYALNF,0,2,1,2
TRAV12-2,TRAJ13,CAVIESGGYQKVTF,0,2,1,2
TRAV12-2,TRAJ38,CAVSTAGNNRKLIW,0,2,1,2
TRAV12-2,TRAJ8,CAVRKNTGFQKLVF,0,2,1,2
TRAV8-1,TRAJ12,CAVNAPDSSYKLIF,0,2,1,2
TRAV8-1,TRAJ7,CAVNAGYGNNRLAF,0,2,1,2
TRAV12-2,TRAJ11,CAVNGDSGYSTLTF,0,2,1,2
TRAV8-1,TRAJ9,CAVKSKAGGFKTIF,0,2,1,2
TRAV12-2,TRAJ4,CAADLSGGYNKLIF,0,2,1,2
TRAV13-1,TRAJ30,CAPSKGDRDDKIIF,0,2,1,2
TRAV13-1,TRAJ40,CAAYLTSGTYKYIF,0,2,1,2
TRAV13-1,TRAJ39,CAAGVNNAGNVLTF,0,2,1,2
TRAV13-1,TRAJ41,CAAMNSNSGYALNF,0,2,1,2
TRAV23DV6,TRAJ39,CAATSNNAGNMLTF,0,2,1,2
TRAV13-1,TRAJ54,CAASWSSGAQKLVF,0,2,1,2
TRAV13-1,TRAJ31,CAASIGGNNARLMF,0,2,1,2
TRAV13-1,TRAJ42,CAASTGGSQGNLIF,0,2,1,2
TRAV13-1,TRAJ29,CAASKGARNTPLVF,0,2,1,2
TRAV13-1,TRAJ5,CAASKEAGRRALTF,0,2,1,2
TRAV29DV5,TRAJ45,CAASPGDFDDGLTF,0,2,1,2
TRAV29DV5,TRAJ21,CAASAWDNFNKFYF,0,2,1,2
TRAV29DV5,TRAJ29,CAASANSGNTPLVF,0,2,1,2
TRAV23DV6,TRAJ54,CAASMSGGAQKLVF,0,2,1,2
TRAV23DV6,TRAJ58,CAASSKTSGSRLTF,0,2,1,2
TRAV23DV6,TRAJ57,CAASKKGGSEKLVF,0,2,1,2
TRAV13-1,TRAJ17,CAARFGAAGNKLTF,0,2,1,2
TRAV23DV6,TRAJ23,CAARSYNQGGKLIF,0,2,1,2
TRAV29DV5,TRAJ47,CAAKERKYGNKLVF,0,2,1,2
TRAV27,TRAJ54,CAGTRPRGAQKLVF,0,2,1,2
TRAV13-2,TRAJ23,CAEISYNQGGKLIF,0,2,1,2
TRAV13-2,TRAJ39,CAETDNNAGNMLTF,0,2,1,2
TRAV5,TRAJ42,CAERGGGSQGNLIF,0,2,1,2
TRAV13-2,TRAJ40,CAENRASGTYKYIF,0,2,1,2
TRAV12-3,TRAJ49,CAMIPTNTGNQFYF,0,2,1,2
TRAV14DV4,TRAJ54,CAMIFLQGAQKLVF,0,2,1,2
TRAV14DV4,TRAJ29,CAMSIFSGNTPLVF,0,2,1,2
TRAV12-3,TRAJ32,CAMSDGGATNKLIF,0,2,1,2
TRAV14DV4,TRAJ24,CAMRRTDSWGKLQF,0,2,1,2
TRAV14DV4,TRAJ11,CAMRPNSGYSTLTF,0,2,1,2
TRAV14DV4,TRAJ16,CAMRARTDGQKLLF,0,2,1,2
TRAV14DV4,TRAJ7,CAMRENRGNNRLAF,0,2,1,2
TRAV23DV6,TRAJ17,CAIPKKAAGNKLTF,0,2,1,2
TRAV34,TRAJ56,CGAWKTGANSKLTF,0,2,1,2
TRAV34,TRAJ17,CGARGEAAGNKLTF,0,2,1,2
TRAV4,TRAJ15,CLVLKNQAGTALIF,0,2,1,2
TRAV4,TRAJ9,CLVGDPTGGFKTIF,0,2,1,2
TRAV4,TRAJ32,CLVGDVGATSKLIF,0,2,1,2
TRAV30,TRAJ39,CGTDHNNAGNMLTF,0,2,1,2
TRAV30,TRAJ48,CGTEGNFGNEKLTF,0,2,1,2
TRAV30,TRAJ29,CGTEKGSGNTPLVF,0,2,1,2
TRAV26-2,TRAJ38,CILSNAGNNRKLIW,0,2,1,2
TRAV26-2,TRAJ54,CILRDEGGAQKLVF,0,2,1,2
TRAV26-1,TRAJ40,CIVREGSGTYKYIF,0,2,1,2
TRAV26-1,TRAJ58,CIVRRETSGSRLTF,0,2,1,2
TRAV13-2,TRAJ40,RAASALSGTYKYIF,0,2,1,2
TRAV13-2,TRAJ34,RAEIRSYNTDKLIF,0,2,1,2
TRAV12-1,TRAJ49,SVVQKPNTGNQFYF,0,2,1,2
TRAV26-1,TRAJ48,FIVRVIGNEKLTF,0,2,1,2
TRAV8-3,TRAJ20,CVSRGSNDYKLSF,0,2,1,2
TRAV8-2,TRAJ34,CVVSPYNTDKLIF,0,2,1,2
TRAV8-1,TRAJ20,CVVDAPNDYKLSF,0,2,1,2
TRAV12-1,TRAJ29,CVVSISGNTPLVF,0,2,1,2
TRAV12-1,TRAJ27,CVVGETNAGKSTF,0,2,1,2
TRAV12-1,TRAJ43,CVVGPYNNNDMRF,0,2,1,2
TRAV10,TRAJ9,CVVTHTGGFKTIF,0,2,1,2
TRAV10,TRAJ33,CVVSALSNYQLIW,0,2,1,2
TRAV10,TRAJ20,CVVSANRDYKLSF,0,2,1,2
TRAV10,TRAJ43,CVVRPDQGNDMRF,0,2,1,2
TRAV12-1,TRAJ39,CVVNWNAGNMLTF,0,2,1,2
TRAV12-1,TRAJ35,CVVNIGFGNVLYC,0,2,1,2
TRAV12-1,TRAJ7,CVVNMGGNNRLAF,0,2,1,2
TRAV12-1,TRAJ36,CVVNIYGANNLFF,0,2,1,2
TRAV12-1,TRAJ20,CVVNSADDHKLSF,0,2,1,2
TRAV12-1,TRAJ6,CVVNRGGSYIPTF,0,2,1,2
TRAV12-1,TRAJ11,CVARGSGYSTLTF,0,2,1,2
TRAV12-1,TRAJ24,CVILTDSWGKLQF,0,2,1,2
TRAV17,TRAJ45,CASPGGGADGLTF,0,2,1,2
TRAV3,TRAJ37,CASYLSNTGKLIF,0,2,1,2
TRAV38-2DV8,TRAJ44,CAYRAGTASKLTF,0,2,1,2
TRAV38-2DV8,TRAJ42,CAYRGGSQGNLIF,0,2,1,2
TRAV16,TRAJ22,CALISGSARQLTF,0,2,1,2
TRAV16,TRAJ48,CALSPFGNEKLTF,0,2,1,2
TRAV9-2,TRAJ15,CALLNQAGTALIF,0,2,1,2
TRAV16,TRAJ35,CALPIGFGNVLHC,0,2,1,2
TRAV9-2,TRAJ15,CALRSQAGTALIF,0,2,1,2
TRAV19,TRAJ29,CALATAGNTPLVF,0,2,1,2
TRAV6,TRAJ6,CALASGGSYIPTF,0,2,1,2
TRAV9-2,TRAJ23,CALIYNQGGKLIF,0,2,1,2
TRAV9-2,TRAJ30,CALTQVGDDKIIF,0,2,1,2
TRAV9-2,TRAJ37,CALTYSNTGKLIF,0,2,1,2
TRAV9-2,TRAJ38,CALKGGNNRKLIW,0,2,1,2
TRAV6,TRAJ43,CALDPYNNNDMRF,0,2,1,2
TRAV16,TRAJ8,CALSGHDFQKLVF,0,2,1,2
TRAV16,TRAJ31,CALSGQNNASLMF,0,2,1,2
TRAV23DV6,TRAJ16,CAPFETDGQKLLF,0,2,1,2
TRAV12-2,TRAJ45,CARKRRGADGLTF,0,2,1,2
TRAV2,TRAJ29,CAVWNSGNTPLVF,0,2,1,2
TRAV21,TRAJ17,CAVIKAAGNKLTF,0,2,1,2
TRAV41,TRAJ43,CAVLSYNNNDMRF,0,2,1,2
TRAV12-2,TRAJ39,CAVPNNAGNMLTF,0,2,1,2
TRAV41,TRAJ30,CAVRTNRDDKIIF,0,2,1,2
TRAV8-3,TRAJ26,CAVWDNYGQNFVF,0,2,1,2
TRAV20,TRAJ27,CAVQDPNASKSTF,0,2,1,2
TRAV2,TRAJ5,CAVAPTGRRALTF,0,2,1,2
TRAV21,TRAJ45,CAVARGGADGLTF,0,2,1,2
TRAV8-3,TRAJ37,CAVGEVNTGKLIF,0,2,1,2
TRAV22,TRAJ42,CAVGGGSQGNLIF,0,2,1,2
TRAV12-2,TRAJ39,CAVGKNAGNMLTF,0,2,1,2
TRAV36DV7,TRAJ58,CAVDGTSGSRLTF,0,2,1,2
TRAV22,TRAJ49,CAVERNTGNQFYF,0,2,1,2
TRAV3,TRAJ40,CAVILSGTYKYIF,0,2,1,2
TRAV8-4,TRAJ43,CAVIRYNNNDMRF,0,2,1,2
TRAV3,TRAJ8,CAVTGTGFQKLVF,0,2,1,2
TRAV8-4,TRAJ49,CAVSDPSGNQFYF,0,2,1,2
TRAV8-6,TRAJ20,CAVSDGNDYKLSF,0,2,1,2
TRAV8-4,TRAJ49,CAVSDRRGNHFYF,0,2,1,2
TRAV8-4,TRAJ29,CAVSYSGNTPLVF,0,2,1,2
TRAV21,TRAJ26,CAVRQNYGQNFVF,0,2,1,2
TRAV8-4,TRAJ34,CAVRVFNTDKLIF,0,2,1,2
TRAV12-2,TRAJ6,CAVRTGGSYIPTF,0,2,1,2
TRAV3,TRAJ30,CAVRLLRADKIIF,0,2,1,2
TRAV3,TRAJ29,CAVRGWGNTPLVF,0,2,1,2
TRAV3,TRAJ32,CAVRGGATNKLIF,0,2,1,2
TRAV1-2,TRAJ35,CAVRDGFGNVLHC,0,2,1,2
TRAV3,TRAJ13,CAVRDRGYQKVTF,0,2,1,2
TRAV3,TRAJ31,CAVRDQDNARLMF,0,2,1,2
TRAV3,TRAJ7,CAVRDDGNNRLAF,0,2,1,2
TRAV3,TRAJ11,CAVRDKGYSTLTF,0,2,1,2
TRAV12-2,TRAJ12,CAVGGDSSYKLII,0,2,1,2
TRAV20,TRAJ32,CAAYGGATNKLIF,0,2,1,2
TRAV21,TRAJ10,CAAPTGGGNKLTF,0,4,1,4
TRAV41,TRAJ49,CAADTNTGNQFYF,0,2,1,2
TRAV35,TRAJ56,CAGLSGANSKLTF,0,2,1,2
TRAV35,TRAJ58,CAGVETSGSRLTF,0,2,1,2
TRAV17,TRAJ5,CATLDTGRRALTF,0,2,1,2
TRAV17,TRAJ9,CATDVGGGFKTIF,0,2,1,2
TRAV17,TRAJ30,CATDAFGDDKIIF,0,2,1,2
TRAV17,TRAJ34,CATDAGNTDKLIF,0,2,1,2
TRAV17,TRAJ49,CAKSYDTGNQFYF,0,2,1,2
TRAV24,TRAJ41,CAFNSNSGYALNF,0,2,1,2
TRAV24,TRAJ40,CASGTSGTYKYIF,0,2,1,2
TRAV23DV6,TRAJ12,CAPNRGSSYELIF,0,2,1,2
TRAV16,TRAJ13,CAPQSRGYQKVTF,0,2,1,2
TRAV19,TRAJ22,CAHPAGSARQLTF,0,2,1,2
TRAV12-2,TRAJ3,CAVLYSSASKIIF,0,2,1,2
TRAV39,TRAJ40,CAVRTSGTYKYIF,0,2,1,2
TRAV12-2,TRAJ7,CAVLRRGNNRLAF,0,2,1,2
TRAV8-1,TRAJ43,CAVQKYNNNDMRF,0,2,1,2
TRAV12-2,TRAJ48,CAVGVFGNEKLTF,0,2,1,2
TRAV12-2,TRAJ29,CAVANSGNTPLDF,0,2,1,2
TRAV39,TRAJ49,CAVGGNTGNQFYF,0,2,1,2
TRAV12-2,TRAJ21,CAVTSYNFNKFYF,0,2,1,2
TRAV12-2,TRAJ7,CAVRDYGNNRLAF,0,2,1,2
TRAV8-1,TRAJ35,CAVNAGFGNVLHC,0,2,1,2
TRAV8-1,TRAJ31,CAVNRPNNARLMF,0,2,1,2
TRAV12-2,TRAJ9,CAVNSAGGFKTIF,0,2,1,2
TRAV12-2,TRAJ22,CAVNRGSARQLTF,0,2,1,2
TRAV12-2,TRAJ35,CAVNRSFGNVLHC,0,2,1,2
TRAV12-2,TRAJ26,CAVNKVDGQNFVF,0,2,1,2
TRAV12-3,TRAJ10,CAASTGGGNKLTF,0,2,1,2
TRAV8-1,TRAJ20,CAANKANDYKLSF,0,2,1,2
TRAV6,TRAJ41,CAITPDSGYALNF,0,2,1,2
TRAV8-3,TRAJ42,CATGGGSQGNLIF,0,2,1,2
TRAV21,TRAJ7,CAFPAGGNNRLAF,0,2,1,2
TRAV12-3,TRAJ11,CAVPNSGYSTLTF,0,2,1,2
TRAV13-1,TRAJ6,CAAFEGGSYIPTF,0,2,1,2
TRAV13-1,TRAJ20,CAASLANDYKLSF,0,2,1,2
TRAV29DV5,TRAJ37,CAALSSNTGKLIF,0,2,1,2
TRAV13-1,TRAJ8,CAASKRGFQKLVF,0,2,1,2
TRAV29DV5,TRAJ35,CAASRGFGNVLHC,0,2,1,2
TRAV13-1,TRAJ39,CAATLNAGNMLTF,0,2,1,2
TRAV13-1,TRAJ9,CAASDAGGFKTIF,0,2,1,2
TRAV13-1,TRAJ30,CAASRGGDDKIIF,0,2,1,2
TRAV29DV5,TRAJ21,CAASAHNFNKFYF,0,2,1,2
TRAV29DV5,TRAJ22,CAASESSPRQLTF,0,2,1,2
TRAV23DV6,TRAJ54,CAASMRGAQKLVF,0,2,1,2
TRAV29DV5,TRAJ48,CAARAFGNEKLTF,0,2,1,2
TRAV23DV6,TRAJ13,CAARNGGYQKVTF,0,2,1,2
TRAV25,TRAJ8,CAGLRTGFQKLVF,0,2,1,2
TRAV25,TRAJ50,CAGPKTSYDKVIF,0,2,1,2
TRAV25,TRAJ17,CAGPKAAGNKLTF,0,2,1,2
TRAV27,TRAJ3,CAGDHSSASKIIL,0,2,1,2
TRAV25,TRAJ39,CAGTNNAGNMLTF,0,2,1,2
TRAV13-2,TRAJ21,CAENAINFNKFYF,0,2,1,2
TRAV13-2,TRAJ39,CAENSNAGNMLTF,0,2,1,2
TRAV29DV5,TRAJ48,CAESNFGNEKLTL,0,2,1,2
TRAV12-3,TRAJ43,CAIMTYNNNNMRF,0,2,1,2
TRAV12-3,TRAJ37,CAMGSSNTGKLIF,0,2,1,2
TRAV12-3,TRAJ42,CAMGGGSQGNLIF,0,2,1,2
TRAV12-3,TRAJ40,CAMIPSGTYKYIF,0,2,1,2
TRAV12-3,TRAJ11,CAMTGGGYSTLTF,0,2,1,2
TRAV12-3,TRAJ43,CAMSPPEDNDMRF,0,2,1,2
TRAV12-3,TRAJ13,CAMSVEGYQKVTF,0,2,1,2
TRAV12-3,TRAJ30,CAMSAPRDDKIIF,0,2,1,2
TRAV14DV4,TRAJ23,CAMSARGGGKLIF,0,2,1,2
TRAV14DV4,TRAJ34,CAMRGRNTDKLIF,0,2,1,2
TRAV14DV4,TRAJ30,CAMNRGEDDKIIF,0,2,1,2
TRAV12-3,TRAJ29,CAMKNSGNTPLVF,0,2,1,2
TRAV12-3,TRAJ17,CAIKRAAGNKLTF,0,2,1,2
TRAV12-3,TRAJ42,CATYGGSQGNLIF,0,2,1,2
TRAV8-3,TRAJ23,CATLYNQGGKLIF,0,2,1,2
TRAV34,TRAJ29,CGADMMGNTPLVF,0,2,1,2
TRAV4,TRAJ23,CLVVYNQGGKLIF,0,2,1,2
TRAV4,TRAJ9,CLVAKTGGFKTIF,0,2,1,2
TRAV4,TRAJ34,CLVGPLNTDKLIF,0,2,1,2
TRAV4,TRAJ34,CLVGDIFTDKLIF,0,2,1,2
TRAV4,TRAJ33,CLVGDRSNYQLIW,0,2,1,2
TRAV26-2,TRAJ20,CILRVWGDYKLSF,0,2,1,2
TRAV26-2,TRAJ30,CILRDNRDDKIIF,0,2,1,2
TRAV26-2,TRAJ30,CILREGRDDKIIF,0,2,1,2
TRAV26-1,TRAJ39,CIVGDNAGNMLTF,0,2,1,2
TRAV26-1,TRAJ58,CIVTETSGSRLTF,0,2,1,2
TRAV26-1,TRAJ34,CIVRVYNTDKLIF,0,2,1,2
TRAV17,TRAJ28,WANSGAGSYQLTF,0,2,1,2
TRAV12-1,TRAJ20,CVSSSNDYKLSF,0,2,1,2
TRAV12-1,TRAJ37,CVVNSNTGKLIF,0,2,1,2
TRAV12-1,TRAJ33,CVVQDSNYQLIW,0,2,1,2
TRAV12-1,TRAJ33,CVVTDSNYQLIW,0,2,1,2
TRAV10,TRAJ8,CVVRTGFQKLVF,0,2,1,2
TRAV12-1,TRAJ31,CVVNYDNARLMF,0,2,1,2
TRAV12-1,TRAJ49,CVVNMAGNQFYF,0,2,1,2
TRAV12-1,TRAJ39,CVVNRAGNMLTF,0,2,1,2
TRAV21,TRAJ15,CASYQAGTALIF,0,2,1,2
TRAV9-2,TRAJ54,CALRAGAQKLVS,0,2,1,2
TRAV6,TRAJ26,CALAHYGQNFVF,0,2,1,2
TRAV16,TRAJ53,CALEGSNYKLTF,0,2,1,2
TRAV16,TRAJ21,CALRGNFNKFYF,0,2,1,2
TRAV16,TRAJ37,CAPASNTGKLIF,0,2,1,2
TRAV38-2DV8,TRAJ47,CAHGSGGDKLVF,0,2,1,2
TRAV21,TRAJ56,CAVPGANSKLTF,0,2,1,2
TRAV2,TRAJ11,CAVYSGYSTLTF,0,2,1,2
TRAV20,TRAJ6,CAVQGGSYIPTF,0,2,1,2
TRAV1-2,TRAJ33,CAVADSNYQLIW,0,2,1,2
TRAV8-3,TRAJ9,CAVGTGGFKTIF,0,2,1,2
TRAV8-3,TRAJ20,CAVGPNDYKLSF,0,2,1,2
TRAV2,TRAJ47,CAVEDVGNKLVF,0,2,1,2
TRAV2,TRAJ49,CAVTPTGNQFYF,0,2,1,2
TRAV8-6,TRAJ31,CAVSPNNARLMF,0,2,1,2
TRAV8-6,TRAJ23,CAVSRRAGKLIF,0,2,1,2
TRAV8-4,TRAJ33,CAVSESNYQLIW,0,2,1,2
TRAV3,TRAJ26,CAVRPRGQNFVF,0,2,1,2
TRAV21,TRAJ26,CAVRRGGQNFVF,0,2,1,2
TRAV3,TRAJ34,CAVRDRTDKLIF,0,2,1,2
TRAV8-3,TRAJ39,CAVNNAGNMLTF,0,2,1,2
TRAV36DV7,TRAJ31,CAARNNNARLMF,0,2,1,2
TRAV12-2,TRAJ40,CAAHSGTYKYIF,0,2,1,2
TRAV41,TRAJ43,CAAVFNNNDMRF,0,2,1,2
TRAV12-2,TRAJ29,CAANSGNTPLVF,0,2,1,2
TRAV3,TRAJ40,CAITSGTYKYIF,0,2,1,2
TRAV17,TRAJ11,CATDSGYSTLTF,0,2,1,2
TRAV17,TRAJ21,CATDGDFNKFYF,0,2,1,2
TRAV24,TRAJ21,CAFYGDFNKFYF,0,2,1,2
TRAV9-2,TRAJ41,CAWENSGYALNF,0,2,1,2
TRAV23DV6,TRAJ37,CAPRGNTGKLNF,0,2,1,2
TRAV23DV6,TRAJ52,CAPFDSYGKLTF,0,2,1,2
TRAV6,TRAJ8,CAPGEGFQKLVF,0,2,1,2
TRAV2,TRAJ12,CAPMDSSYKLIF,0,2,1,2
TRAV8-3,TRAJ22,CAVSGSARQLTF,0,2,1,2
TRAV12-2,TRAJ13,CAVSARYQKVTF,0,2,1,2
TRAV39,TRAJ41,CAVYFSGYALNF,0,2,1,2
TRAV8-1,TRAJ20,CAVNADDYKLSF,0,2,1,2
TRAV12-2,TRAJ48,CAVNDGNEKLTF,0,2,1,2
TRAV12-2,TRAJ26,CAGTNYGQNFVF,0,2,1,2
TRAV12-3,TRAJ43,CAHMYNNNDMRF,0,2,1,2
TRAV13-2,TRAJ30,CAAPNRDDKIIF,0,2,1,2
TRAV13-1,TRAJ31,CAAILNNARLMF,0,2,1,2
TRAV13-1,TRAJ54,CAATAGAQKLVF,0,2,1,2
TRAV13-1,TRAJ3,CAATSSASKIIF,0,2,1,2
TRAV13-1,TRAJ15,CAASIKGTALIF,0,2,1,2
TRAV13-1,TRAJ20,CAASTGDYKLSF,0,2,1,2
TRAV29DV5,TRAJ34,CAASANTDKLIF,0,2,1,2
TRAV13-1,TRAJ49,CAARTTGNQFYF,0,2,1,2
TRAV23DV6,TRAJ20,CAAKDGDYKLSF,0,2,1,2
TRAV13-1,TRAJ27,CAAKPNAGKSTF,0,2,1,2
TRAV25,TRAJ6,CAGPGGSYIPTF,0,2,1,2
TRAV27,TRAJ39,CAGGNAGNMLTF,0,2,1,2
TRAV27,TRAJ49,CAGPRTGNQFYF,0,2,1,2
TRAV13-2,TRAJ17,CAERAAGNKLTF,0,2,1,2
TRAV29DV5,TRAJ34,CAESITADKLIF,0,2,1,2
TRAV12-3,TRAJ37,CAMSANTGKLIF,0,2,1,2
TRAV12-3,TRAJ20,CAMSEGDYKLSF,0,2,1,2
TRAV4,TRAJ34,CLGGENTDKLIF,0,2,1,2
TRAV4,TRAJ34,CLGSFNTDKLIF,0,2,1,2
TRAV26-2,TRAJ54,CIPTQGAQKLVF,0,2,1,2
TRAV26-1,TRAJ26,CIVGDYGQNFVF,0,2,1,2
TRAV12-1,TRAJ49,CVVNTGNQFYF,0,2,1,2
TRAV2,TRAJ24,CAFDSWGKLQF,0,2,1,2
TRAV6,TRAJ29,CALEGNTPLVF,0,2,1,2
TRAV22,TRAJ15,CAPRGGTALIF,0,2,1,2
TRAV12-3,TRAJ26,CAPYYGQNFVF,0,2,1,2
TRAV6,TRAJ21,CARHNFNKFYF,0,2,1,2
TRAV21,TRAJ43,CAVYNNNDMRF,0,2,1,2
TRAV12-2,TRAJ34,CAVVNTDKLIF,0,2,1,2
TRAV3,TRAJ37,CAVTSTGKLIF,0,2,1,2
TRAV21,TRAJ26,CAVNYGQNFVF,0,2,1,2
TRAV41,TRAJ30,CAVNRDDKIIF,0,2,1,2
TRAV7,TRAJ40,CAVRGTYKYIF,0,2,1,2
TRAV2,TRAJ34,CAVVGTDKLIF,0,2,1,2
TRAV20,TRAJ48,CAVTGNEKLTF,0,2,1,2
TRAV8-6,TRAJ31,CAVRTDARLMF,0,2,1,2
TRAV1-2,TRAJ33,CAVRSNYQLIW,0,2,1,2
TRAV41,TRAJ49,CAVPTGNQFYF,0,2,1,2
TRAV21,TRAJ20,CAAHNDYKLSF,0,2,1,2
TRAV8-3,TRAJ4,CAMGSSDKLIF,0,2,1,2
TRAV8-3,TRAJ33,CAMNSNYQLIW,0,2,1,2
TRAV17,TRAJ34,CATYTTDKLIF,0,2,1,2
TRAV17,TRAJ9,CATGGGFKTIF,0,2,1,2
TRAV8-1,TRAJ48,CALDLGEKLTF,0,2,1,2
TRAV25,TRAJ15,CAHQAGTALIF,0,2,1,2
TRAV12-2,TRAJ10,CAVGGGNKLTF,0,2,1,2
TRAV29DV5,TRAJ43,CAVELNNDMRF,0,2,1,2
TRAV25,TRAJ39,CAPNAGNMLTF,0,2,1,2
TRAV13-1,TRAJ49,CAALTGNQFYF,0,2,1,2
TRAV29DV5,TRAJ29,CAAGGNTPLVF,0,2,1,2
TRAV29DV5,TRAJ37,CAAVRTGKLIF,0,2,1,2
TRAV25,TRAJ21,CAGDGFNKFYF,0,2,1,2
TRAV25,TRAJ54,CAGEGAQKLVF,0,2,1,2
TRAV27,TRAJ6,CAGGGSYIPTF,0,2,1,2
TRAV12-3,TRAJ11,CAMVGYSTLTF,0,2,1,2
TRAV14DV4,TRAJ44,CAMRPRGKLTF,0,2,1,2
TRAV4,TRAJ43,CLVAPSGDMRF,0,2,1,2
TRAV1-1,TRAJ31,CAVRDHARLMF,0,2,1,2
TRAV26-2,TRAJ20,CILATDYKLSF,0,2,1,2
TRAV17,TRAJ31,WDCGGNARLMF,0,2,1,2
TRAV2,TRAJ42,LGGSQGNLIF,0,2,1,2
TRAV12-1,TRAJ5,CVVSRRALTF,0,2,1,2
TRAV12-1,TRAJ5,CVASRRALTF,0,2,1,2
TRAV21,TRAJ43,CAVFGNDMRF,0,2,1,2
TRAV8-4,TRAJ49,CAVTGNQFYF,0,2,1,2
TRAV3,TRAJ20,CAVREYKLSF,0,2,1,2
TRAV21,TRAJ49,CAVNGNQFYF,0,2,1,2
TRAV35,TRAJ43,CAGREYDMRL,0,2,1,2
TRAV39,TRAJ43,CAPRARDMRF,0,2,1,2
TRAV12-2,TRAJ43,CAVRGWDMRF,0,2,1,2
TRAV41,TRAJ43,CASSNNDMRF,0,2,1,2
TRAV13-1,TRAJ43,CAASRRDMRF,0,2,1,2
TRAV13-1,TRAJ43,CAASDNDMRF,0,2,1,2
TRAV13-2,TRAJ40,CAGGTYKYIF,0,2,1,2
TRAV4,TRAJ10,CLGGGNKLTF,0,2,1,2
TRAV21,TRAJ21,CAVGDKFYF,0,2,1,2
TRAV12-2,TRAJ47,CGGGNKLVF,0,2,1,2
TRAV17,TRAJ43,CATDSLRF,0,2,1,2
TRAV12-2,TRAJ20,CAATLGGF,0,2,1,2
TRAV23DV6,TRAJ58,CAASIRSF,0,2,1,2
TRAV12-2,TRAJ43,CAAYMRF,0,2,1,2
TRAV24,TRAJ22,CAFAG,0,2,1,2
