v_hit,j_hit,cdr3,S2-10ng_S7,S2-10ng_S19,freq,count_sum
TRBV4-3,TRBJ2-1,CASSQDVQGSYNEQFF,243,0,1,243
TRBV10-3,TRBJ2-3,CAISSQKTDTQYF,152,2,2,154
TRBV12-3/4,TRBJ2-1,CASSLRANEQFF,151,25,2,176
TRBV19,TRBJ2-1,CASSIVSGTHSYNEQFF,102,0,1,102
TRBV16,TRBJ2-1,CASSPNNEQFF,89,185,2,274
TRBV4-1,TRBJ2-1,CASRAKSALGPYNEQFF,97,8,2,105
TRBV4-3,TRBJ1-2,CASSQGVRTGPYGYTF,79,0,1,79
TRBV4-1,TRBJ2-7,CASSQTGGNYEQYF,72,0,1,72
TRBV7-6,TRBJ1-2,CASSPIDRVYGYTF,58,49,2,107
TRBV2,TRBJ2-3,CASTRDRGTDTQYF,57,77,2,134
TRBV20-1,TRBJ2-5,CSAPLSSGGAGAPQETQYF,53,0,1,53
TRBV5-1,TRBJ2-3,CASSLLVLDPTDTQYF,50,9,2,59
TRBV15,TRBJ2-1,CATSRANSIPYNEQFF,47,0,1,47
TRBV3-1,TRBJ1-6,CASSPRNSPLHF,42,19,2,61
TRBV15,TRBJ2-5,CATSRDFRDPRETQYF,36,21,2,57
TRBV27,TRBJ1-1,CASSFLSGGTEAFF,35,0,1,35
TRBV11-3,TRBJ2-1,CASSSRTSGSYNEQFF,56,24,2,80
TRBV5-4,TRBJ2-1,CASSRADRGLDEQFF,31,71,2,102
TRBV7-9,TRBJ1-1,CASSLALLGAGTEAFF,30,0,1,30
TRBV29-1,TRBJ2-4,CSADQGENIQYF,30,0,1,30
TRBV19,TRBJ1-3,CASSPFGPSSGNTIYL,29,0,1,29
TRBV7-6,TRBJ1-2,CASSFGTTGDLYGYTF,29,33,2,62
TRBV5-5,TRBJ1-1,CASSLWGAGTEAFF,33,32,2,65
TRBV14,TRBJ2-2,CASSQDGDWNTGELFF,28,27,2,55
TRBV2,TRBJ1-1,CASSEIGTGMNTEAFF,27,0,1,27
TRBV5-5,TRBJ2-2,CATKGLPYTGELFF,27,0,1,27
TRBV12-3/4,TRBJ1-1,CASSAEITGNTEAFF,27,0,1,27
TRBV6-2/3/5/6,TRBJ2-1,CASRGQSSYNEQFF,25,0,1,25
TRBV28,TRBJ2-7,CASSLALYEQYF,25,0,1,25
TRBV7-2,TRBJ2-7,CASSLDRVPNEQYF,25,0,1,25
TRBV28,TRBJ2-4,CASSLTGSPRAKNIQYF,24,25,2,49
TRBV7-8,TRBJ2-4,CASSNYRGEGKNIQYF,24,0,1,24
TRBV5-1,TRBJ2-1,CASRLAENYNEQFF,24,0,1,24
TRBV19,TRBJ1-1,CASSPGTVEAFF,24,0,1,24
TRBV7-2,TRBJ2-3,CASSFPPREGLGDTQYF,23,9,2,32
TRBV7-9,TRBJ2-5,CAIHSPRVGQETQYF,23,16,2,39
TRBV20-1,TRBJ1-2,CSARGPQAFNYGYTF,23,5,2,28
TRBV29-1,TRBJ2-1,CSVDLAGSLGEQFF,23,15,2,38
TRBV29-1,TRBJ2-2,CSVAPLGLGRGTGELFF,22,25,2,47
TRBV29-1,TRBJ2-1,CSVELAGAQPRREQFF,22,0,1,22
TRBV19,TRBJ2-3,CASSIAATSTDTQYF,22,0,1,22
TRBV5-8,TRBJ1-3,CASSLGHSPGNTIYF,22,0,1,22
TRBV12-3/4,TRBJ1-5,CASSLADFYQPQHF,22,24,2,46
TRBV29-1,TRBJ2-1,CSVEWLAGAEQFF,22,0,1,22
TRBV29-1,TRBJ1-1,CSVEERDGGVAFF,22,0,1,22
TRBV2,TRBJ2-3,CASSDSGGGRTDTQYF,21,7,2,28
TRBV6-1,TRBJ1-4,CASSESRIPTNEKLFF,21,0,1,21
TRBV12-3/4,TRBJ2-1,CASSGRGTARNEQFF,21,0,1,21
TRBV6-2/3/5/6,TRBJ1-1,CASSYSRVDEAFF,21,0,1,21
TRBV5-6,TRBJ1-2,CASSLIGDYGYTF,21,0,1,21
TRBV29-1,TRBJ2-3,CSVDDGSTDTQYF,21,19,2,40
TRBV7-2,TRBJ2-1,CASSVGGPEQFF,21,0,1,21
TRBV5-1,TRBJ2-2,CATRTDTGELFF,21,0,1,21
TRBV5-6,TRBJ2-1,CASSLLTSGDYNEQFF,20,28,2,48
TRBV7-2,TRBJ2-3,CASSLVVRPSTDTQYF,20,0,1,20
TRBV20-1,TRBJ2-5,CSATRSQMFGAQYF,20,0,1,20
TRBV27,TRBJ2-1,CASSSRNNEQFF,20,0,1,20
TRBV4-1,TRBJ1-3,CASSQEIFAGTGGNTIYF,20,0,1,20
TRBV5-1,TRBJ1-2,CASSLDINYGYTF,20,0,1,20
TRBV27,TRBJ2-6,CASSQGQVYIRAGANVLTF,20,0,1,20
TRBV13,TRBJ2-3,CASSIRRVDPADTQYF,20,0,1,20
TRBV11-2,TRBJ2-1,CASSPPEDLIMGEQFF,19,14,2,33
TRBV2,TRBJ2-3,CASSGDPAGNTDTQYF,19,2,2,21
TRBV12-3/4,TRBJ1-6,CASSRGQGSFSPLHF,19,0,1,19
TRBV12-3/4,TRBJ2-1,CASRFRGIDNEQFF,19,0,1,19
TRBV7-2,TRBJ2-4,CASSQRTGDIQYF,19,25,2,44
TRBV29-1,TRBJ2-3,CSPTSTDTQYF,19,0,1,19
TRBV10-3,TRBJ2-7,CAISLTSAFYEQYF,18,0,1,18
TRBV12-3/4,TRBJ2-7,CASSPPVPPRRQYF,18,0,1,18
TRBV9,TRBJ1-2,CASSVGGRSYGYTF,18,0,1,18
TRBV29-1,TRBJ2-1,CSVYRPSSYNEQFF,18,0,1,18
TRBV25-1,TRBJ1-1,CASSVQGGTEAFF,18,0,1,18
TRBV14,TRBJ1-1,CASSQSPRTEAFF,18,0,1,18
TRBV12-3/4,TRBJ2-2,CASSHLSSGRLMNTGELFF,17,4,2,21
TRBV12-3/4,TRBJ1-5,CASSFRGAGSNQPQHF,17,13,2,30
TRBV29-1,TRBJ2-3,CSVWGAWGANSGMQYF,17,0,1,17
TRBV12-3/4,TRBJ2-7,CASSYLAGSSYEQYF,17,0,1,17
TRBV6-1,TRBJ1-5,CASSVRTGVSQPQHF,17,0,1,17
TRBV5-4,TRBJ2-5,CASSLRGTLKETQYF,17,10,2,27
TRBV27,TRBJ1-5,CASSLFYSNQPQHF,17,5,2,22
TRBV5-1,TRBJ2-7,CASSLRQRGYEQYF,17,0,1,17
TRBV7-8,TRBJ2-7,CASSSGTEEQYF,17,21,2,38
TRBV12-3/4,TRBJ1-2,CASSPESGYTF,17,12,2,29
TRBV5-1,TRBJ2-5,CASSLVSPLAGPQETQYF,16,9,2,25
TRBV18,TRBJ2-1,CASSTSPSGEMRNEQFF,16,0,1,16
TRBV20-1,TRBJ2-6,CSATLGTSGGGANVLTF,16,15,2,31
TRBV7-3,TRBJ2-3,CASSPLAAGLDTQYS,16,0,1,16
TRBV2,TRBJ2-1,CASSAERGSYNEQFF,16,0,1,16
TRBV5-1,TRBJ2-1,CASSSDERGYNEQFF,16,0,1,16
TRBV20-1,TRBJ1-6,CSARVDGQGDSPLHF,16,0,1,16
TRBV12-3/4,TRBJ1-2,CASTPEDGNYGYTF,16,13,2,29
TRBV6-2/3/5/6,TRBJ2-7,CASSSRDFSYEQYF,16,0,1,16
TRBV2,TRBJ1-1,CASSEALMGTEAFF,16,0,1,16
TRBV7-2,TRBJ2-2,CASSFNRGTGELFF,16,0,1,16
TRBV5-5,TRBJ2-7,CASSAMGGYEQYF,16,0,1,16
TRBV29-1,TRBJ1-1,CSGRGVGNTEAFF,16,0,1,16
TRBV5-6,TRBJ2-7,CASSLSANEQYF,16,4,2,20
TRBV29-1,TRBJ2-4,CSVGDRGGIQYF,16,0,1,16
TRBV29-1,TRBJ1-1,CSAGQNTEAFF,16,0,1,16
TRBV3-1,TRBJ2-3,CASSQDLLAEYTDTQYF,16,42,2,58
TRBV2,TRBJ2-7,CASSEGRGLNYEQYF,16,0,1,16
TRBV12-5,TRBJ1-5,CASGPGQAVNQPQHF,16,14,2,30
TRBV27,TRBJ2-3,CASKFGGLVGPLAQYF,16,0,1,16
TRBV4-2,TRBJ2-3,CASSQTGIQGHTQYF,16,0,1,16
TRBV15,TRBJ1-1,CATSRDTTGGRVNTEAFF,15,10,2,25
TRBV12-3/4,TRBJ2-1,CASRTGASHEQFF,15,0,1,15
TRBV6-2/3/5/6,TRBJ2-7,CASRVGRGTFSSYEQYF,15,0,1,15
TRBV27,TRBJ2-1,CASSLRWETAYNEQFF,15,0,1,15
TRBV12-3/4,TRBJ2-2,CASSLRGPNTGELFF,15,0,1,15
TRBV6-2/3/5/6,TRBJ2-4,CASSPPPEAKNIQYF,15,0,1,15
TRBV7-6,TRBJ2-1,CASSGSRDGFREQFF,15,0,1,15
TRBV20-1,TRBJ2-7,CSARDGTGGSYGQYF,15,0,1,15
TRBV10-3,TRBJ1-1,CAISVRDRDTEAFF,15,0,1,15
TRBV5-6,TRBJ2-7,CASSWGQGSYEQYF,15,0,1,15
TRBV13,TRBJ1-2,CASSPGAANYGYTF,15,0,1,15
TRBV3-1,TRBJ1-1,CASSPATTISEAFF,15,0,1,15
TRBV7-9,TRBJ1-1,CASSLDTNTEAFF,19,0,1,19
TRBV11-1,TRBJ1-1,CASSATENTEAFF,15,9,2,24
TRBV20-1,TRBJ1-2,CSALRVAYGYTF,15,0,1,15
TRBV20-1,TRBJ2-7,CSARDQQGASSGDNYEQYF,15,8,2,23
TRBV29-1,TRBJ2-1,CSVEKTSGTTSEQFF,14,0,1,14
TRBV7-2,TRBJ1-5,CACSFGTGDGQPQHF,14,0,1,14
TRBV10-3,TRBJ2-1,CAISEPGTARGSYNEQFF,14,0,1,14
TRBV12-3/4,TRBJ2-1,CASSLGARTRDYNEQFF,14,0,1,14
TRBV11-2,TRBJ2-3,CASSQSVGRPTTDTQYF,14,0,1,14
TRBV11-2,TRBJ1-6,CASSLNYESYNSPLHF,14,0,1,14
TRBV5-6,TRBJ2-7,CASSEFTAGGIYEQYF,14,6,2,20
TRBV27,TRBJ2-1,CATRTGEGSYNEQFF,14,5,2,19
TRBV12-3/4,TRBJ2-4,CASSLVKQGGNIQYF,14,0,1,14
TRBV7-3,TRBJ2-5,CASSQTPGGPETQYF,14,0,1,14
TRBV9,TRBJ2-7,CASSVGVSNSYEQYF,14,5,2,19
TRBV2,TRBJ2-3,CASSAGTSRTDTQYF,14,0,1,14
TRBV7-2,TRBJ2-1,CASSAGGLNYNEQFF,14,0,1,14
TRBV29-1,TRBJ2-3,CSVEEGGMSTDTQYF,14,0,1,14
TRBV19,TRBJ1-1,CATRAPTGRTEAFF,14,0,1,14
TRBV19,TRBJ1-5,CASSSTGTNQPQHF,14,0,1,14
TRBV19,TRBJ1-1,CASSMRGFATEAFF,14,0,1,14
TRBV12-3/4,TRBJ1-1,CASSRRELNTEAFF,14,6,2,20
TRBV6-2/3/5/6,TRBJ1-4,CASSRGSTNEKLFF,14,2,2,16
TRBV7-2,TRBJ2-5,CASSRGHTQETQYF,14,0,1,14
TRBV12-3/4,TRBJ1-2,CASSGDRERYGYTF,14,0,1,14
TRBV7-9,TRBJ2-7,CASSLGTSVREQYF,14,0,1,14
TRBV29-1,TRBJ1-2,CSVEDKPGGNGYTF,14,0,1,14
TRBV29-1,TRBJ2-7,CSVTVQGRSYEQYF,14,0,1,14
TRBV12-3/4,TRBJ1-4,CASQRTGREKLFF,14,0,1,14
TRBV28,TRBJ1-5,CASSPDMDQPQHF,14,0,1,14
TRBV2,TRBJ1-2,CARGDSENYGYTF,14,0,1,14
TRBV5-1,TRBJ1-1,CASSSGQHTEAFF,14,0,1,14
TRBV20-1,TRBJ2-1,CSAQSSGQGEQFF,14,0,1,14
TRBV29-1,TRBJ2-1,CSVSEFTYNEQFF,14,0,1,14
TRBV29-1,TRBJ2-2,CSVEVLGLAGGPGELFF,13,0,1,13
TRBV12-3/4,TRBJ2-1,CASSHTSGGPWGEQFF,13,0,1,13
TRBV5-5,TRBJ1-4,CASSPHSRATNEKLFF,13,0,1,13
TRBV20-1,TRBJ1-6,CSARDGTVSTRTPLHF,13,0,1,13
TRBV20-1,TRBJ2-2,CSARKFLEENTGELFF,13,0,1,13
TRBV3-1,TRBJ1-5,CASSPGTMGNQPQHF,13,0,1,13
TRBV7-9,TRBJ1-4,CASSHRTGFYEKLFF,13,10,2,23
TRBV9,TRBJ2-7,CASSVGTSGGYEQYF,13,3,2,16
TRBV7-2,TRBJ2-3,CASSILAGRTDTQYF,13,0,1,13
TRBV5-1,TRBJ1-1,CASSPRAGGNTEAFF,13,0,1,13
TRBV29-1,TRBJ2-1,CSVDPLLGSYNEQFF,13,0,1,13
TRBV19,TRBJ2-1,CASSLNPRDGEQFF,13,4,2,17
TRBV12-3/4,TRBJ1-1,CASSGKGANTEAFF,13,0,1,13
TRBV7-2,TRBJ2-5,CASSSEDRLETQYF,13,0,1,13
TRBV5-6,TRBJ1-5,CASSLRTLHQPQHF,13,0,1,13
TRBV4-3,TRBJ2-5,CASSHRDLGETQYF,13,3,2,16
TRBV20-1,TRBJ1-1,CSVKGHSADTEAFF,13,0,1,13
TRBV27,TRBJ2-1,CASRQPDDNEQFF,13,4,2,17
TRBV29-1,TRBJ2-1,CSVGFLLDPEQFF,13,18,2,31
TRBV29-1,TRBJ1-4,CSVENRRGEKLFF,13,0,1,13
TRBV29-1,TRBJ2-1,CSAEREDNNEQFF,13,0,1,13
TRBV3-1,TRBJ2-1,CATKDRGLEQFF,13,4,2,17
TRBV5-1,TRBJ2-7,CASSEAYEQYF,13,0,1,13
TRBV4-2,TRBJ1-1,CASSQDARGPGNTEAFF,13,0,1,13
TRBV29-1,TRBJ1-4,CSVEEFPGEATNEKLFF,13,0,1,13
TRBV6-2/3/5/6,TRBJ2-1,CASNPIPTPSGRGSYNEQFF,12,0,1,12
TRBV2,TRBJ1-4,CATRAGGGETTNEKLFF,12,0,1,12
TRBV24-1,TRBJ1-5,CATSDDEILVDNQPQHF,12,0,1,12
TRBV2,TRBJ2-7,CASSEAHTGKPLNEQYF,12,3,2,15
TRBV20-1,TRBJ2-5,CSARASGGGGLGETQYF,12,0,1,12
TRBV12-3/4,TRBJ2-1,CASSFLAGGPGNEQFF,12,0,1,12
TRBV6-2/3/5/6,TRBJ2-5,CASSQGLTSGKETQYF,12,0,1,12
TRBV5-6,TRBJ1-1,CASSLAWGALWTEAFF,12,0,1,12
TRBV29-1,TRBJ2-1,CSVEGAQLLSYNEQFF,12,0,1,12
TRBV12-5,TRBJ1-5,CASSLGGALNQPQHF,12,3,2,15
TRBV7-2,TRBJ2-1,CATSIGVGKYNEQFF,12,0,1,12
TRBV19,TRBJ2-1,CASSIRLGDYNEQFF,12,0,1,12
TRBV6-2/3/5/6,TRBJ2-3,CASSLGDSETDTQYF,12,0,1,12
TRBV6-1,TRBJ1-5,CASSERTPSRVTQHF,12,0,1,12
TRBV3-1,TRBJ2-3,CASSSQGGGADTQYF,12,0,1,12
TRBV7-2,TRBJ2-1,CASSYSAGAYNEQFF,12,0,1,12
TRBV29-1,TRBJ2-2,CSVQGQGAGTGELFF,12,0,1,12
TRBV19,TRBJ1-2,CASSIPDKNYGYTF,12,0,1,12
TRBV19,TRBJ1-5,CASRGQGFNQPQHF,12,0,1,12
TRBV12-3/4,TRBJ1-5,CASSLADSNQPQHF,12,0,1,12
TRBV2,TRBJ1-2,CASSDMVHVYGYTF,12,0,1,12
TRBV5-4,TRBJ2-5,CASSPTEYQETQYF,12,0,1,12
TRBV27,TRBJ1-6,CASRQGVDNSPLHF,12,0,1,12
TRBV5-1,TRBJ2-1,CASSLVPGAHEQFF,12,0,1,12
TRBV5-1,TRBJ1-4,CASSLDSSNEKLFF,12,0,1,12
TRBV29-1,TRBJ1-3,CSVAQTGSGNTIYF,12,0,1,12
TRBV29-1,TRBJ2-1,CSVDRGKSYNEQFF,12,0,1,12
TRBV29-1,TRBJ1-1,CSATQGRANTEAFF,12,0,1,12
TRBV18,TRBJ1-5,CATTEGVNQPQHF,12,0,1,12
TRBV7-2,TRBJ1-4,CASSFGTGEKLFF,12,3,2,15
TRBV7-2,TRBJ1-1,CASSLFAEVEAFF,12,0,1,12
TRBV7-3,TRBJ1-1,CASSLTYDSEAFF,12,0,1,12
TRBV29-1,TRBJ2-7,CSVERTGGYEQYF,12,5,2,17
TRBV5-6,TRBJ2-7,CASSFIRSEQYF,12,0,1,12
TRBV7-2,TRBJ1-1,CASSLRLGQAFF,12,0,1,12
TRBV7-6,TRBJ1-1,CASSPFSDEAFF,12,22,2,34
TRBV3-1,TRBJ1-1,CASSHSSSGAFF,12,0,1,12
TRBV6-4,TRBJ2-1,CASSAYNEQFF,12,36,2,48
TRBV9,TRBJ2-1,CASSTPDEQFF,12,0,1,12
TRBV27,TRBJ1-1,CASCFLSGGTEAFF,12,0,1,12
TRBV20-1,TRBJ1-5,CSARKIRRDRGNHQPQHF,11,8,2,19
TRBV6-1,TRBJ2-2,CASSGRTSGGYTGELFF,11,7,2,18
TRBV18,TRBJ2-5,CASSPLARGRAETQYF,11,0,1,11
TRBV28,TRBJ2-5,CASSFHRTGGTETQYF,11,8,2,19
TRBV11-1,TRBJ2-1,CASSYPPRGSYNEQFF,11,0,1,11
TRBV7-8,TRBJ2-3,CASSPEGDWGTDTQYF,11,21,2,32
TRBV4-2,TRBJ2-1,CASSQPGQGTYNEQFF,11,15,2,26
TRBV2,TRBJ2-5,CASNRAGGNGQETQYF,11,0,1,11
TRBV20-1,TRBJ2-1,CSATSRGGISYNEQFF,11,11,2,22
TRBV19,TRBJ1-2,CASSTGGTETNGYTF,11,0,1,11
TRBV19,TRBJ2-7,CASSTGLNPLYEQYF,11,0,1,11
TRBV6-2/3/5/6,TRBJ2-7,CASSYLRQGPEEQYF,11,0,1,11
TRBV12-3/4,TRBJ2-5,CASSLRGTGVETQYF,11,0,1,11
TRBV12-3/4,TRBJ2-7,CASSPVSGRTYEQYF,11,0,1,11
TRBV7-6,TRBJ1-4,CASSLEGRTNEKLFF,11,0,1,11
TRBV4-2,TRBJ2-7,CASSQAFSASYEQYF,11,15,2,26
TRBV6-2/3/5/6,TRBJ2-5,CASSNYRGRRETQYF,11,0,1,11
TRBV4-1,TRBJ2-7,CASSLSGGPSYEQYF,11,0,1,11
TRBV20-1,TRBJ2-3,CSAGGDSVITDTQYF,11,0,1,11
TRBV29-1,TRBJ2-5,CSVALRLAVGETQYF,11,3,2,14
TRBV30,TRBJ1-1,CAWSAGQLNTEAFF,11,4,2,15
TRBV19,TRBJ2-7,CASTLSALSYEQYF,11,0,1,11
TRBV19,TRBJ1-5,CASSPDRGNQPQHF,11,0,1,11
TRBV18,TRBJ1-3,CASSLPGTGNTIYF,11,0,1,11
TRBV12-3/4,TRBJ1-1,CASEISGGETEAFF,11,0,1,11
TRBV6-2/3/5/6,TRBJ1-1,CASSIQGGNTEAFF,11,0,1,11
TRBV4-2,TRBJ1-1,CASSYAGSATEAFF,11,0,1,11
TRBV7-6,TRBJ1-1,CASSPLQEGTEAFF,11,0,1,11
TRBV28,TRBJ2-1,CASSGTGVSDEQFF,11,0,1,11
TRBV4-1,TRBJ1-4,CASRKTATNEKLFF,11,0,1,11
TRBV20-1,TRBJ2-1,CSASWQSSYNEQFF,11,8,2,19
TRBV20-1,TRBJ2-5,CSARDREGLETQYF,11,0,1,11
TRBV12-3/4,TRBJ2-6,CAIGTAGANVLTF,11,0,1,11
TRBV5-4,TRBJ1-1,CASSFRGNTEAFF,11,2,2,13
TRBV27,TRBJ1-1,CASSLQGTEAFF,11,0,1,11
TRBV7-2,TRBJ2-7,CASSLGHYEQYF,11,0,1,11
TRBV13,TRBJ2-1,CASSLRVNEQFF,11,0,1,11
TRBV2,TRBJ2-2,CASRKEPGELFF,11,0,1,11
TRBV5-1,TRBJ2-3,CASSLGEDTQYF,11,0,1,11
TRBV29-1,TRBJ1-5,CSVGHPNQPQHF,11,0,1,11
TRBV29-1,TRBJ2-1,CSVERTGGEQFF,11,0,1,11
TRBV19,TRBJ1-1,CASSTGGEAFF,11,0,1,11
TRBV6-4,TRBJ2-1,CASSDQGQVFF,11,0,1,11
TRBV7-7,TRBJ1-2,CASSLAGFRGFAPNYGYTF,11,4,2,15
TRBV4-1,TRBJ1-5,CASSQGAQVLDQPQHF,11,0,1,11
TRBV19,TRBJ2-7,CASSTAGTGGYEQYF,11,0,1,11
TRBV10-3,TRBJ1-6,CAISDGSHNSPLHF,11,0,1,11
TRBV5-1,TRBJ1-1,CASSLDDRAEAFF,11,6,2,17
TRBV20-1,TRBJ1-1,CSAPPLDLDQNTEAFF,11,0,1,11
TRBV5-4,TRBJ2-2,CACGATPNTGELFF,11,0,1,11
TRBV6-1,TRBJ1-1,CASSEAMGATEAFF,11,0,1,11
TRBV2,TRBJ2-1,CASTGLASYNEQFF,11,0,1,11
TRBV19,TRBJ1-1,CASSIDTGENTEAFF,10,7,2,17
TRBV20-1,TRBJ1-5,CSAMLGRGESQPQHF,10,22,2,32
TRBV5-1,TRBJ2-2,CASSLQPGAAGNTGELFF,10,0,1,10
TRBV4-1,TRBJ2-1,CASSRGLAGRSSYNEQFF,10,0,1,10
TRBV20-1,TRBJ2-1,CSARDRRTSGGLYNEQFF,10,0,1,10
TRBV29-1,TRBJ2-6,CSVSVRDRGLPGANVLTF,10,0,1,10
TRBV6-2/3/5/6,TRBJ1-5,CASSLGFRWGSNQPQHF,10,0,1,10
TRBV6-2/3/5/6,TRBJ2-1,CASSLSGGIRRDDEQFF,10,0,1,10
TRBV6-2/3/5/6,TRBJ1-4,CASSSAPPQATNEKLFF,10,0,1,10
TRBV6-2/3/5/6,TRBJ1-3,CASSYFGGNPSGNTIYF,10,0,1,10
TRBV3-1,TRBJ2-3,CASSQDRRGSSTDTQYF,10,0,1,10
TRBV4-3,TRBJ2-3,CASSQDGTSGSTDTQYF,10,0,1,10
TRBV15,TRBJ2-5,CATSHGLAEIQETQYF,10,0,1,10
TRBV19,TRBJ2-1,CASSLLAGGLANEQFF,10,0,1,10
TRBV27,TRBJ1-2,CASSLFPGQLTYGYTF,10,0,1,10
TRBV2,TRBJ1-2,CASSERTGGSIYGYTF,10,0,1,10
TRBV5-6,TRBJ1-1,CASSLESDSLGTEAFF,10,0,1,10
TRBV7-9,TRBJ2-2,CASSLSPPQDTGELFF,10,5,2,15
TRBV7-2,TRBJ2-1,CASSLLAGGHYNEQFF,10,0,1,10
TRBV3-1,TRBJ2-1,CASSQRTSGLYNEQFF,10,0,1,10
TRBV9,TRBJ2-2,CASSEERGPGGGELFF,10,4,2,14
TRBV2,TRBJ1-5,CASKGQGGYSNQPQHF,10,0,1,10
TRBV20-1,TRBJ1-2,CSARDIAWGQSYGYTF,10,0,1,10
TRBV29-1,TRBJ1-3,CSVSTATSFSGNTIYF,10,0,1,10
TRBV19,TRBJ2-3,CASSIVDGGTDTQYF,10,0,1,10
TRBV28,TRBJ2-7,CASSLATGGEYEQYF,10,5,2,15
TRBV5-4,TRBJ2-3,CASSLGGVDTDTQYF,10,0,1,10
TRBV27,TRBJ2-1,CASSLGLVGYNEQFF,10,0,1,10
TRBV7-9,TRBJ1-4,CASSLRDVLGEKLFF,10,0,1,10
TRBV7-2,TRBJ1-1,CASSLLPQGATEAFF,10,0,1,10
TRBV6-2/3/5/6,TRBJ2-6,CASSQATRGANVLTF,10,0,1,10
TRBV12-3/4,TRBJ2-5,CASSQTGLAKETQYF,10,0,1,10
TRBV5-6,TRBJ2-1,CASNPGTQGGNEQFF,10,0,1,10
TRBV5-1,TRBJ2-7,CASSLDGAWVGEQYF,10,0,1,10
TRBV4-1,TRBJ1-5,CASSQDPGSNQPQHF,10,10,2,20
TRBV20-1,TRBJ1-1,CSARVRDRGDTEAFF,10,0,1,10
TRBV29-1,TRBJ2-7,CSVEEGIGTTYEQYF,10,0,1,10
TRBV18,TRBJ1-1,CASSPGGLDTEAFF,10,0,1,10
TRBV12-3/4,TRBJ1-2,CASSLSGGAYGYTF,10,0,1,10
TRBV12-3/4,TRBJ2-7,CASSQTGTGNEQYF,10,0,1,10
TRBV12-3/4,TRBJ1-5,CASSQSYSNQPQHF,10,0,1,10
TRBV7-8,TRBJ2-1,CASSLTGDYNEQFF,10,17,2,27
TRBV7-9,TRBJ1-5,CASSPGQGFQPQHF,10,0,1,10
TRBV3-1,TRBJ1-2,CASSQGTGGHGYTF,10,0,1,10
TRBV7-2,TRBJ1-1,CASSQTDRVTEAFF,10,0,1,10
TRBV9,TRBJ1-6,CASSGRDRGSPLHF,10,0,1,10
TRBV12-3/4,TRBJ2-1,CASRGQGWLDEQFF,10,0,1,10
TRBV5-1,TRBJ2-2,CASSVTGDTGELFF,10,0,1,10
TRBV20-1,TRBJ2-3,CSARESSGSDTQYF,10,0,1,10
TRBV20-1,TRBJ2-7,CSARVSGRTYEQYF,10,4,2,14
TRBV29-1,TRBJ1-1,CSVAGFVEDTEAFF,10,0,1,10
TRBV29-1,TRBJ2-1,CSVAGTPLGDEQFF,10,0,1,10
TRBV29-1,TRBJ1-3,CSVARDGDGNTIYF,10,0,1,10
TRBV15,TRBJ2-1,CATSRVTGNEQFF,10,3,2,13
TRBV2,TRBJ1-1,CASSEGPVTEAFF,10,0,1,10
TRBV9,TRBJ2-2,CASSSTRSGELFF,10,0,1,10
TRBV6-2/3/5/6,TRBJ2-1,CASRKGMENEQFF,10,0,1,10
TRBV10-2,TRBJ1-4,CASRNATNEKLFF,10,0,1,10
TRBV5-1,TRBJ1-1,CASSFVGDTEAFF,10,0,1,10
TRBV29-1,TRBJ1-1,CSVVREGGTEAFF,10,0,1,10
TRBV29-1,TRBJ2-1,CSVGDRGWNEQFF,10,0,1,10
TRBV29-1,TRBJ1-2,CSVEYQENYGYTF,10,0,1,10
TRBV29-1,TRBJ1-5,CSVQQGGNQPQHF,10,0,1,10
TRBV6-2/3/5/6,TRBJ1-1,CASSYWTREAFF,10,0,1,10
TRBV7-9,TRBJ2-7,CASSLAFYEQYF,10,0,1,10
TRBV9,TRBJ1-2,CASSPGTEGYTF,10,38,2,48
TRBV3-1,TRBJ2-2,CASSQNFGELFF,10,0,1,10
TRBV20-1,TRBJ1-5,CSARRGDQPQHF,10,0,1,10
TRBV20-1,TRBJ2-3,CSAPHSTDTQYF,10,0,1,10
TRBV29-1,TRBJ2-3,CSVEWITDTQYF,10,0,1,10
TRBV12-3/4,TRBJ2-5,CASWGGETQYF,10,0,1,10
TRBV12-3/4,TRBJ2-5,CASRGETQYF,10,0,1,10
TRBV9,TRBJ1-5,CASSDGQQPQHF,10,0,1,10
TRBV12-5,TRBJ2-4,CASALGTGEAKNIQYF,10,0,1,10
TRBV20-1,TRBJ2-2,CSARLRIRGTYGTGELFF,10,0,1,10
TRBV29-1,TRBJ1-6,CSVDPGLGGPLHF,10,0,1,10
TRBV12-3/4,TRBJ2-5,CASSFGPSPYQETQYF,10,0,1,10
TRBV7-7,TRBJ2-2,CASSLANTGELFF,10,0,1,10
TRBV9,TRBJ2-7,CASSVGQGTYEQYF,10,0,1,10
TRBV3-1,TRBJ2-1,CASSGLSSYNEQFF,9,0,1,9
TRBV29-1,TRBJ2-7,CSVRGRENYEQYF,9,0,1,9
TRBV3-1,TRBJ1-4,CASSQDEGLLNNEKLFF,9,0,1,9
TRBV4-1,TRBJ2-2,CASSQVRVSTGELFF,9,0,1,9
TRBV24-1,TRBJ2-2,CATSEQGSTGELFF,9,0,1,9
TRBV14,TRBJ2-7,CASAPARGYYEQYF,9,0,1,9
TRBV7-3,TRBJ1-2,CASSPTRGGGYTF,9,0,1,9
TRBV28,TRBJ1-2,CASSGGSYGYTF,9,0,1,9
TRBV29-1,TRBJ1-1,CSASPRNTEAFF,9,0,1,9
TRBV12-5,TRBJ2-2,CASGLTVGVHATGELFF,9,0,1,9
TRBV6-2/3/5/6,TRBJ2-3,CASSASGSGLSTDTQYF,9,0,1,9
TRBV7-2,TRBJ2-4,CASSLVLTGGSKNIQYF,9,0,1,9
TRBV5-4,TRBJ1-1,CASSPQTRGGHQGEAFF,9,0,1,9
TRBV5-1,TRBJ2-1,CASSLMRGGKTSHEQFF,9,0,1,9
TRBV20-1,TRBJ1-5,CSARDERGRGYNQPQHF,9,0,1,9
TRBV18,TRBJ2-1,CASSPIDVLGYNEQFF,9,0,1,9
TRBV6-2/3/5/6,TRBJ2-1,CASSYSQKSSYNEQFF,9,0,1,9
TRBV12-3/4,TRBJ1-5,CASSQRQGRGNQPQHF,9,0,1,9
TRBV6-1,TRBJ2-1,CASSEFGPALGNEQFF,9,0,1,9
TRBV11-1,TRBJ2-1,CASSLGLAGAYNEQFF,9,0,1,9
TRBV5-6,TRBJ1-1,CASSLGATGLNTEAFF,9,4,2,13
TRBV3-1,TRBJ1-2,CASSPLSRGPEYGYTF,9,0,1,9
TRBV2,TRBJ2-1,CARELKGAQSRDEQFF,9,0,1,9
TRBV5-1,TRBJ1-1,CASSLDLVNPNTEAFF,9,0,1,9
TRBV5-1,TRBJ2-1,CASSLYPPPSYNEQFF,9,0,1,9
TRBV5-1,TRBJ1-6,CASSPGIQGGNSPLHF,9,0,1,9
TRBV5-1,TRBJ2-7,CASSDGIRVTGYEQYF,9,0,1,9
TRBV29-1,TRBJ1-2,CSVTPGRTPSGYGYTF,9,5,2,14
TRBV18,TRBJ1-1,CASSPPDRRNTEAFF,9,0,1,9
TRBV3-1,TRBJ1-2,CASTPDSPPAGGYTF,9,0,1,9
TRBV2,TRBJ1-1,CASTSPSTGNTEAFF,9,0,1,9
TRBV12-3/4,TRBJ2-1,CASSFVGQVNNEQFF,9,0,1,9
TRBV12-3/4,TRBJ2-2,CASSLGRAKAGELFF,9,0,1,9
TRBV12-3/4,TRBJ2-1,CASSLGGAGDGEQFF,9,0,1,9
TRBV12-3/4,TRBJ2-1,CASSLMGQGRNEQFF,9,0,1,9
TRBV12-3/4,TRBJ2-7,CASSSRGGSLYEQYF,9,0,1,9
TRBV6-2/3/5/6,TRBJ1-5,CASSWDGRSNQPQHF,9,0,1,9
TRBV12-3/4,TRBJ2-5,CASSWSFGEGETQYF,9,0,1,9
TRBV5-6,TRBJ1-2,CASSLAPSVGYGYTF,9,0,1,9
TRBV11-2,TRBJ1-2,CASSSRGTGVGSYTF,9,0,1,9
TRBV3-1,TRBJ1-2,CASSHNDSPGHGYTF,9,0,1,9
TRBV9,TRBJ2-1,CASSQKGDPYNEQFF,9,0,1,9
TRBV7-6,TRBJ2-5,CASSTGLAGTETQYF,9,0,1,9
TRBV12-3/4,TRBJ2-1,CASRAGQSSYNEQFF,9,0,1,9
TRBV4-1,TRBJ2-5,CASSQVGVGMETQYF,9,0,1,9
TRBV4-3,TRBJ2-1,CASSQDRTGDNEQFF,9,0,1,9
TRBV29-1,TRBJ2-4,CSVEGWGQGKNIQYF,9,0,1,9
TRBV29-1,TRBJ2-7,CSVEGWGQGADEQYF,9,0,1,9
TRBV12-5,TRBJ2-5,CASGLGGYQETQYF,9,0,1,9
TRBV30,TRBJ2-7,CAWNGRDSHYEQYF,9,2,2,11
TRBV19,TRBJ1-2,CASSARTGDYGYTF,9,0,1,9
TRBV2,TRBJ2-3,CASTRDRGTDAQYF,9,0,1,9
TRBV28,TRBJ1-5,CASSFAGITWPQHF,9,0,1,9
TRBV6-1,TRBJ2-3,CASSEGQGGDTQYF,9,0,1,9
TRBV2,TRBJ2-6,CASSERSGANVLTF,9,0,1,9
TRBV7-9,TRBJ1-5,CASSFTGANQPQHF,9,0,1,9
TRBV7-9,TRBJ2-1,CASSFSGTGNEQFF,9,0,1,9
TRBV7-2,TRBJ2-1,CASSLPNSYNEQFF,9,0,1,9
TRBV5-4,TRBJ2-3,CASSRGRHADTQYF,9,0,1,9
TRBV7-2,TRBJ1-5,CASSADSSNQPQHF,9,0,1,9
TRBV6-2/3/5/6,TRBJ1-1,CASKPRDMNTEAFF,9,0,1,9
TRBV20-1,TRBJ2-5,CSATKGQYQETQYF,9,0,1,9
TRBV20-1,TRBJ2-1,CSAPDRGHGNEQFF,9,0,1,9
TRBV12-5,TRBJ1-1,CASGFQGRAEAFF,9,0,1,9
TRBV12-5,TRBJ1-2,CASGSQGGGGYTF,9,0,1,9
TRBV10-3,TRBJ1-1,CAIAPQGYTEAFF,9,0,1,9
TRBV5-6,TRBJ2-2,CASTWGNTGELFF,9,0,1,9
TRBV6-2/3/5/6,TRBJ2-5,CASSLQSQETQYF,9,0,1,9
TRBV6-2/3/5/6,TRBJ1-1,CASSPSTNTEAFF,9,7,2,16
TRBV28,TRBJ2-3,CASSRGQADTQYF,9,0,1,9
TRBV5-6,TRBJ2-7,CASSLGAMFEQYF,9,0,1,9
TRBV13,TRBJ1-1,CASSLGLTGEAFF,9,0,1,9
TRBV14,TRBJ2-7,CASSQDPAYEQYF,9,0,1,9
TRBV9,TRBJ1-2,CASSAGQETSYTF,9,0,1,9
TRBV20-1,TRBJ2-5,CSVAPTSVETQYF,9,0,1,9
TRBV20-1,TRBJ2-1,CSAGNRPYNEQFF,9,26,2,35
TRBV20-1,TRBJ2-1,CSATGTSYNEQFF,9,0,1,9
TRBV20-1,TRBJ2-7,CSARGGRDYEQYF,9,0,1,9
TRBV20-1,TRBJ2-3,CSAREGSTDTQYF,9,0,1,9
TRBV20-1,TRBJ2-3,CSARSRGIDTQYF,9,0,1,9
TRBV30,TRBJ2-7,CAWGTVSYEQYF,9,0,1,9
TRBV19,TRBJ1-2,CASTAANYGYTF,9,0,1,9
TRBV6-2/3/5/6,TRBJ1-1,CASSYDGTEAFF,9,27,2,36
TRBV5-5,TRBJ1-1,CASSFLTTEAFF,9,0,1,9
TRBV7-2,TRBJ2-7,CASSLGAYEQYF,9,0,1,9
TRBV5-4,TRBJ2-3,CASSPRTDTQYF,9,7,2,16
TRBV12-3/4,TRBJ1-3,CATRGRGNTIYF,9,0,1,9
TRBV29-1,TRBJ1-2,CSVEGPSYGYTF,9,0,1,9
TRBV29-1,TRBJ2-3,CSVGRVTDTQYF,9,0,1,9
TRBV2,TRBJ2-5,CASKSGETQYF,9,0,1,9
TRBV19,TRBJ2-2,CASRTAGELFF,9,0,1,9
TRBV7-2,TRBJ1-2,CASSRVLGYTF,9,0,1,9
TRBV11-2,TRBJ2-1,CASIHSGSSYNEQFF,9,0,1,9
TRBV12-3/4,TRBJ1-3,CASSFRKTLSGNTIYF,8,189,2,197
TRBV5-6,TRBJ2-7,CASSQTLAGGPVTYEQYF,8,2,2,10
TRBV7-9,TRBJ2-7,CASSLASGQFTYEQYF,8,0,1,8
TRBV6-2/3/5/6,TRBJ1-1,CASSPFPRDIYLNTEAFF,8,0,1,8
TRBV2,TRBJ2-5,CASSVAQTGGPYQETQYF,8,6,2,14
TRBV7-8,TRBJ2-1,CASSLSRLAKSSYNEQFF,8,0,1,8
TRBV5-4,TRBJ2-1,CASSIPTSGRAGYNEQFF,8,4,2,12
TRBV4-1,TRBJ2-1,CASSQDPAVGGSYNEQFF,8,0,1,8
TRBV5-1,TRBJ2-1,CASSSGTSGGAGTNEQFF,8,0,1,8
TRBV7-8,TRBJ2-5,CASSSRTSGVRQETQYF,8,6,2,14
TRBV7-2,TRBJ2-5,CASSPGGVGQARETQYF,8,0,1,8
TRBV20-1,TRBJ2-3,CSARDPSGGGSTDTQYF,8,0,1,8
TRBV20-1,TRBJ2-1,CSARDRFPGQGFNEQFF,8,0,1,8
TRBV20-1,TRBJ2-5,CSARDKWGTGSQETQYF,8,0,1,8
TRBV27,TRBJ2-6,CATRGRGLSGANVLTF,8,0,1,8
TRBV19,TRBJ1-5,CASSTSGTGNNQPQHF,8,0,1,8
TRBV2,TRBJ2-3,CASTSPLGGGPDTQYF,8,0,1,8
TRBV12-3/4,TRBJ2-5,CASSSKFSGDQETQYF,8,0,1,8
TRBV6-2/3/5/6,TRBJ2-2,CASSYSGGTNTGELFF,8,0,1,8
TRBV5-6,TRBJ1-1,CASSLYRGLPNTEAFF,8,0,1,8
TRBV7-2,TRBJ1-1,CASSSRPLGLNTEAFF,8,0,1,8
TRBV5-4,TRBJ1-3,CASSQDSTPSGNTIYF,8,0,1,8
TRBV3-1,TRBJ2-3,CASSQDLKGSTDTQYF,8,0,1,8
TRBV9,TRBJ1-6,CASSVARLPGISPLHF,8,0,1,8
TRBV7-9,TRBJ2-2,CASSAQRPQGTGELFF,8,4,2,12
TRBV7-8,TRBJ1-1,CASSKKGQGERTEAFF,8,0,1,8
TRBV29-1,TRBJ1-4,CSVEGTTTGDNEKLFF,8,0,1,8
TRBV12-5,TRBJ2-7,CASGLFGTGGYEQYF,8,0,1,8
TRBV30,TRBJ1-1,CAWRDRGLPNTEAFF,8,0,1,8
TRBV10-3,TRBJ2-1,CAIEGGAGGHNEQFF,8,0,1,8
TRBV10-3,TRBJ1-3,CAISESGNSGNTIYF,8,0,1,8
TRBV10-3,TRBJ1-4,CAISENRRTNEKLFF,8,0,1,8
TRBV10-3,TRBJ2-2,CAISLTLQGTGELFF,8,0,1,8
TRBV10-3,TRBJ1-2,CAISLTGSLFYGYTF,8,5,2,13
TRBV19,TRBJ2-1,CASSEDRDSYNEQFF,8,0,1,8
TRBV19,TRBJ2-1,CASSTPTSGYNEQFF,8,0,1,8
TRBV5-6,TRBJ1-1,CASSIVGGRHSEAFF,8,0,1,8
TRBV12-3/4,TRBJ1-6,CASTFTGTSNSPLHF,8,0,1,8
TRBV6-2/3/5/6,TRBJ1-1,CASSYKGQGNTEAFF,8,0,1,8
TRBV6-1,TRBJ1-5,CASSEPQGLNQPQHF,8,0,1,8
TRBV2,TRBJ2-3,CASSEGQPSTDTQYF,8,0,1,8
TRBV2,TRBJ2-7,CASSERGGASYEQYF,8,0,1,8
TRBV12-3/4,TRBJ2-1,CASSIRAGRTNEQFF,8,0,1,8
TRBV12-3/4,TRBJ2-5,CASSSGTGGWETQYF,8,0,1,8
TRBV5-4,TRBJ1-2,CASSLVVGRGYGYTF,8,0,1,8
TRBV5-4,TRBJ2-1,CASSLERGGFDEQFF,8,0,1,8
TRBV7-2,TRBJ2-5,CASSLVVGQQETQYF,8,0,1,8
TRBV7-2,TRBJ2-2,CASSLRQGNTGELFF,8,10,2,18
TRBV7-6,TRBJ1-6,CASSLKTASNSPLHF,8,0,1,8
TRBV7-6,TRBJ2-7,CASSSLDRTRGEQYF,8,0,1,8
TRBV7-9,TRBJ2-1,CASSLDSSSYNEQFF,8,0,1,8
TRBV5-8,TRBJ1-1,CASSPGQGWNTEAFF,8,0,1,8
TRBV4-2,TRBJ2-7,CASSQETGARREQYF,8,0,1,8
TRBV3-1,TRBJ1-2,CASSQELGEYYGYTF,8,0,1,8
TRBV5-8,TRBJ1-5,CASSKRQGGNQPQHF,8,0,1,8
TRBV5-1,TRBJ2-1,CASSFTGTGTVLQFF,8,5,2,13
TRBV5-1,TRBJ2-1,CASSLVLAGSNEQFF,8,0,1,8
TRBV5-1,TRBJ2-2,CASSRGLSDTGELFF,8,0,1,8
TRBV4-1,TRBJ1-6,CASSQEAVYNSPLHF,8,8,2,16
TRBV20-1,TRBJ1-1,CSAADRGPMNTEAFF,8,0,1,8
TRBV20-1,TRBJ2-3,CSATPGTGNTDTQYF,8,0,1,8
TRBV20-1,TRBJ1-4,CSARGRPGQDEKLFF,8,0,1,8
TRBV20-1,TRBJ1-4,CSARETHGYDEKLFF,8,0,1,8
TRBV20-1,TRBJ2-2,CSAPAPGGDSGELFF,8,0,1,8
TRBV29-1,TRBJ1-3,CSVVLRGSSGNTIYF,8,0,1,8
TRBV29-1,TRBJ2-3,CSVDLGASGTDTQYF,8,0,1,8
TRBV29-1,TRBJ2-1,CSVEVAGGGYNEQFF,8,0,1,8
TRBV29-1,TRBJ1-3,CSVEDSVDSGNTIYF,8,0,1,8
TRBV29-1,TRBJ2-7,CSVEDWDRGPREQYF,8,0,1,8
TRBV29-1,TRBJ2-3,CSASATLTSTDTQYF,8,0,1,8
TRBV10-3,TRBJ2-2,CAINGAMGTGELFF,8,0,1,8
TRBV7-2,TRBJ2-7,CASSLLASSYEQYF,8,7,2,15
TRBV19,TRBJ2-5,CASSSQTSGETQYF,8,0,1,8
TRBV19,TRBJ1-5,CASSISWGVQPQHF,8,0,1,8
TRBV18,TRBJ1-1,CASSPGTGYTEAFF,8,0,1,8
TRBV18,TRBJ1-1,CASSPVLGYTEAFF,8,0,1,8
TRBV12-3/4,TRBJ2-5,CASSLARGQETQYF,8,0,1,8
TRBV6-2/3/5/6,TRBJ1-2,CASSLGQGVLGYTF,8,0,1,8
TRBV6-2/3/5/6,TRBJ1-5,CASSYMTGLEPQHF,8,2,2,10
TRBV12-3/4,TRBJ2-7,CASSPRGGRDEQYF,8,0,1,8
TRBV6-1,TRBJ1-1,CASSADGVNTEAFF,8,0,1,8
TRBV27,TRBJ2-3,CASSGTSPRDTQYF,8,0,1,8
TRBV11-1,TRBJ2-2,CASSLALAAGELFF,8,0,1,8
TRBV7-8,TRBJ1-4,CASSLGGTNEKLFF,8,0,1,8
TRBV7-9,TRBJ2-3,CASSPGGVTDTQYF,8,0,1,8
TRBV7-9,TRBJ2-1,CASSPIAGMGEQFF,8,0,1,8
TRBV4-2,TRBJ2-1,CASSHSGTYNEQFF,8,0,1,8
TRBV7-2,TRBJ1-5,CASSIVGGNQPQHF,8,0,1,8
TRBV5-1,TRBJ2-1,CASSWSDRYNEQFF,8,0,1,8
TRBV4-3,TRBJ1-5,CASSHYRDDQPQHF,8,0,1,8
TRBV5-1,TRBJ2-3,CASRRSSSTDTQYF,8,0,1,8
TRBV29-1,TRBJ1-5,CSVLAGGDNQPQHF,8,0,1,8
TRBV29-1,TRBJ2-1,CSVVAGQSYNEQFF,8,13,2,21
TRBV29-1,TRBJ2-7,CSVVKSSGSYEQYF,8,0,1,8
TRBV29-1,TRBJ2-7,CSVGKSQGDYEQYF,8,0,1,8
TRBV29-1,TRBJ2-5,CSVEDRTYQETQYF,8,0,1,8
TRBV29-1,TRBJ2-7,CSVEHGTGNYEQYF,8,0,1,8
TRBV29-1,TRBJ2-7,CSVTGRRSSYEQYF,8,0,1,8
TRBV10-3,TRBJ1-5,CAIRDRVAQPQHF,8,0,1,8
TRBV19,TRBJ2-7,CASSILGVPEQYF,8,0,1,8
TRBV7-2,TRBJ1-2,CASSLAGGYGYTF,8,0,1,8
TRBV18,TRBJ1-1,CASSPAAGAEAFF,8,6,2,14
TRBV28,TRBJ2-5,CASSFRDQETQYF,8,0,1,8
TRBV12-3/4,TRBJ2-2,CASSLSGAGELFF,8,0,1,8
TRBV27,TRBJ1-1,CASSWTVNTEAFF,8,0,1,8
TRBV6-2/3/5/6,TRBJ1-1,CASSYGPNTEAFF,8,11,2,19
TRBV6-2/3/5/6,TRBJ1-5,CASSYKENQPQHF,8,7,2,15
TRBV6-2/3/5/6,TRBJ1-2,CASSPDRSYGYTF,8,0,1,8
TRBV6-1,TRBJ2-7,CASSEMGGGEQYF,8,0,1,8
TRBV5-6,TRBJ2-1,CASSLPGTMGQFF,8,0,1,8
TRBV5-4,TRBJ1-1,CASSLSPNTEAFF,8,0,1,8
TRBV7-8,TRBJ1-1,CASSPDLDTEAFF,8,0,1,8
TRBV3-1,TRBJ1-4,CASSQMPNEKLFF,8,0,1,8
TRBV3-1,TRBJ2-7,CASSQWPPDEQYF,8,0,1,8
TRBV12-3/4,TRBJ1-2,CASSQGTANRYTF,8,0,1,8
TRBV3-1,TRBJ2-7,CASSQGRTYEQYF,8,6,2,14
TRBV9,TRBJ1-1,CASSVDGVTEAFF,8,0,1,8
TRBV7-2,TRBJ2-5,CASRPTGGETQYF,8,0,1,8
TRBV5-1,TRBJ1-4,CASSFTRDEKLFF,8,0,1,8
TRBV20-1,TRBJ1-6,CSASETSGSPLHF,8,0,1,8
TRBV29-1,TRBJ1-6,CSVAMREDSPLHF,8,0,1,8
TRBV29-1,TRBJ2-2,CSVDGPGRGELFF,8,0,1,8
TRBV29-1,TRBJ1-1,CSVEEGGNTEAFF,8,0,1,8
TRBV29-1,TRBJ1-1,CSVTGGIGTEAFF,8,0,1,8
TRBV29-1,TRBJ2-1,CSGGTSGWNEQFF,8,0,1,8
TRBV29-1,TRBJ2-2,CSTSTSGTGELFF,8,0,1,8
TRBV2,TRBJ2-5,CASDMRQETQYF,8,0,1,8
TRBV28,TRBJ2-7,CASSSGAYEQYF,8,0,1,8
TRBV6-2/3/5/6,TRBJ1-1,CASSHGTVEAFF,8,0,1,8
TRBV2,TRBJ2-7,CASSSDAYEQYF,8,0,1,8
TRBV7-9,TRBJ1-1,CASSFGNTEAFF,8,15,2,23
TRBV7-2,TRBJ2-5,CASSSVTWTQYF,8,0,1,8
TRBV28,TRBJ1-5,CASRSGNQPQHF,8,0,1,8
TRBV29-1,TRBJ2-5,CSVVRGEETQYF,8,0,1,8
TRBV12-5,TRBJ1-3,CASGTGNTIYF,8,0,1,8
TRBV12-3/4,TRBJ1-3,CASGQSGTIYF,8,0,1,8
TRBV20-1,TRBJ1-4,CSATRDEKLFF,8,0,1,8
TRBV29-1,TRBJ2-7,CSAVRGYEQYF,8,0,1,8
TRBV29-1,TRBJ1-3,CSGISGNTIYF,8,0,1,8
TRBV12-3/4,TRBJ2-3,CASRVDTQYF,8,0,1,8
TRBV29-1,TRBJ1-1,CSVQTGEAFF,8,0,1,8
TRBV2,TRBJ1-1,CASQYRGLNTEAFF,8,0,1,8
TRBV29-1,TRBJ2-5,CSVEETRLAYGETQYF,8,0,1,8
TRBV29-1,TRBJ1-2,CGAGVGADYGYTF,8,0,1,8
TRBV6-4,TRBJ2-1,CASSRLARKFYNEQFF,8,0,1,8
TRBV5-1,TRBJ2-5,CASGQETQYF,8,0,1,8
TRBV19,TRBJ2-6,CASSPRTGGTGANVLTF,8,5,2,13
TRBV6-2/3/5/6,TRBJ1-2,CASSPQGLGDYTF,8,0,1,8
TRBV7-9,TRBJ1-4,CASSPLDRGRPQNEKLFF,8,0,1,8
TRBV7-9,TRBJ2-3,CASSLGGTDTQYF,8,0,1,8
TRBV7-9,TRBJ1-2,CASSPRDNPISYGYTF,7,0,1,7
TRBV6-1,TRBJ1-2,CASSERLGLNYGYTF,7,0,1,7
TRBV12-3/4,TRBJ2-2,CASSQGIAGELFF,7,0,1,7
TRBV14,TRBJ1-1,CASSQVRGEAFF,7,0,1,7
TRBV29-1,TRBJ2-6,CSVSGLNQYSGANVLTF,7,0,1,7
TRBV5-1,TRBJ2-1,CASTSSPSGPYNEQFF,7,0,1,7
TRBV12-3/4,TRBJ2-3,CASSRQGAGTDTQYF,7,0,1,7
TRBV7-6,TRBJ2-7,CASSPKGKLREQYF,7,0,1,7
TRBV5-6,TRBJ1-5,CASSGTGGQPQHF,7,8,2,15
TRBV3-1,TRBJ1-1,CASSKARWDRWVFGTEAFF,7,6,2,13
TRBV10-3,TRBJ1-5,CAISGQFSLGAGNQPQHF,7,0,1,7
TRBV18,TRBJ2-1,CASSPDEAGDLSYNEQFF,7,0,1,7
TRBV7-9,TRBJ1-2,CASSLAKERTGAHYGYTF,7,0,1,7
TRBV3-1,TRBJ2-1,CASSQSLPRSAGGNEQFF,7,0,1,7
TRBV5-5,TRBJ2-2,CASSGGLAGGPDTGELFF,7,0,1,7
TRBV4-1,TRBJ1-2,CASNQNPGQGGIYYGYTF,7,0,1,7
TRBV29-1,TRBJ1-1,CSVVSVGRPSLLDTEAFF,7,0,1,7
TRBV5-6,TRBJ1-3,CASSFPRNISSGNTIYF,7,0,1,7
TRBV5-6,TRBJ1-3,CASSLDPISTAGNTIYF,7,0,1,7
TRBV7-6,TRBJ2-1,CASSLWEISGGHNEQFF,7,0,1,7
TRBV5-5,TRBJ2-2,CASSSIDRAVITGELFF,7,0,1,7
TRBV7-9,TRBJ2-2,CASSQWGAFGRPGELFF,7,0,1,7
TRBV5-1,TRBJ2-6,CASSSGQSFSGANVLTF,7,0,1,7
TRBV24-1,TRBJ1-1,CATSEIPRGSNTEAFF,7,0,1,7
TRBV15,TRBJ2-3,CATSRVSGNGGDTQYF,7,0,1,7
TRBV15,TRBJ1-5,CATSRDLEGAGQPQHF,7,0,1,7
TRBV2,TRBJ2-6,CASWGQDFSGANVLTF,7,0,1,7
TRBV6-2/3/5/6,TRBJ2-7,CASSYSRLAGDYEQYF,7,0,1,7
TRBV6-2/3/5/6,TRBJ2-1,CASSYSMRVSYNEQFF,7,0,1,7
TRBV6-2/3/5/6,TRBJ1-1,CASSYRAPLVDTEAFF,7,0,1,7
TRBV12-3/4,TRBJ2-5,CASSLAPGHLKETQYF,7,0,1,7
TRBV6-2/3/5/6,TRBJ2-1,CASSPRTGAPYNEQFF,7,0,1,7
TRBV6-4,TRBJ1-4,CASSDLMAGVDEKLFF,7,0,1,7
TRBV7-2,TRBJ1-4,CASSLLLSATNEKLFF,7,0,1,7
TRBV7-2,TRBJ1-5,CASSLVGRVSNQPQHF,7,0,1,7
TRBV7-2,TRBJ1-6,CASSLVDRVINSPLHF,7,0,1,7
TRBV7-2,TRBJ1-6,CASSSRTGADNSPLHF,7,0,1,7
TRBV12-3/4,TRBJ2-3,CASSSETSGQGNTQYF,7,0,1,7
TRBV7-2,TRBJ2-7,CASSLGGSGGTYEQYF,7,0,1,7
TRBV7-6,TRBJ2-3,CASSPRQGVSTDTQYF,7,0,1,7
TRBV5-5,TRBJ1-1,CASSPTTGTLNTEAFF,7,0,1,7
TRBV28,TRBJ2-2,CASSPRRTSGTGELFF,7,0,1,7
TRBV7-2,TRBJ2-2,CASSPGLAGVSGELFF,7,0,1,7
TRBV7-2,TRBJ2-4,CASSPPRGRGQNIQYF,7,0,1,7
TRBV7-2,TRBJ2-3,CASSRRGGRATDTQYF,7,0,1,7
TRBV3-1,TRBJ2-7,CASSQSPSGHQYEQYF,7,0,1,7
TRBV3-1,TRBJ2-4,CASSQASSSIENIQYF,7,14,2,21
TRBV4-2,TRBJ2-7,CASSQEVTGFSYEQYF,7,0,1,7
TRBV4-2,TRBJ2-7,CASSQERGLAGVEQYF,7,0,1,7
TRBV11-1,TRBJ2-2,CASSAPGLGYTGELFF,7,4,2,11
TRBV3-1,TRBJ2-3,CASSESTSGSTDTQYF,7,0,1,7
TRBV7-9,TRBJ1-4,CASSTRTLAINEKLFF,7,0,1,7
TRBV5-1,TRBJ2-1,CASSLDSGGSYNEQFF,7,0,1,7
TRBV4-3,TRBJ2-1,CASSQRVGMGGSEQFF,7,0,1,7
TRBV4-1,TRBJ1-1,CASSQLPGTTNTEAFF,7,0,1,7
TRBV4-1,TRBJ1-5,CASSQDPDYSNQPQHF,7,0,1,7
TRBV4-3,TRBJ1-2,CASSQEDRQYNYGYTF,7,98,2,105
TRBV20-1,TRBJ1-6,CSARSETGQGNSPLHF,7,0,1,7
TRBV19,TRBJ1-2,CASTSLGPRGYGYTF,7,0,1,7
TRBV18,TRBJ2-7,CASSPNRGGTYEQYF,7,0,1,7
TRBV12-3/4,TRBJ1-2,CASSLWTGAHYGYTF,7,0,1,7
TRBV6-2/3/5/6,TRBJ1-1,CASSYKAGRMTEAFF,7,9,2,16
TRBV6-2/3/5/6,TRBJ2-1,CASSPGTSSYNEQFF,7,0,1,7
TRBV12-3/4,TRBJ1-5,CASSPRRQGGEPQHF,7,0,1,7
TRBV2,TRBJ1-3,CASSVDRYSGNTIYF,7,4,2,11
TRBV6-1,TRBJ2-3,CASSDGASGFDTQYF,7,0,1,7
TRBV2,TRBJ2-1,CASSERLASYNEQFF,7,0,1,7
TRBV6-1,TRBJ2-5,CASSEAVGESETQYF,7,0,1,7
TRBV6-4,TRBJ1-1,CASSRGGQANTEAFF,7,0,1,7
TRBV5-4,TRBJ2-4,CASSFSLGPPGEEVF,7,0,1,7
TRBV7-2,TRBJ2-7,CASSFLAGVGYEQYF,7,0,1,7
TRBV7-2,TRBJ2-5,CASSLSTSGSETQYF,7,0,1,7
TRBV5-4,TRBJ1-6,CASSLEAGQNSPLHF,7,0,1,7
TRBV7-6,TRBJ2-7,CASSLVVPGGHEQYF,7,0,1,7
TRBV7-9,TRBJ2-1,CASSLVGQGSNEQFF,7,0,1,7
TRBV11-3,TRBJ2-1,CASSLGRPGWDEQFF,7,0,1,7
TRBV5-4,TRBJ2-4,CASSLGGRDKNIQYF,7,0,1,7
TRBV11-2,TRBJ2-3,CASSLELIYTDTQYF,7,0,1,7
TRBV7-2,TRBJ2-7,CASSLSSSRSYEQYF,7,0,1,7
TRBV7-2,TRBJ2-1,CASSSRGLADNEQFF,7,0,1,7
TRBV7-6,TRBJ2-5,CASSSTFGYEETQYF,7,22,2,29
TRBV28,TRBJ2-7,CASSLTSGGTYEQYF,7,0,1,7
TRBV7-6,TRBJ2-1,CASSLGASGTNEQFF,7,0,1,7
TRBV3-1,TRBJ1-2,CASSQDRAFGYGYTF,7,0,1,7
TRBV3-1,TRBJ1-2,CASSQDVRQTYGYTF,7,0,1,7
TRBV14,TRBJ2-7,CASSQDRTFLRKQYF,7,8,2,15
TRBV9,TRBJ2-5,CASSVGGVIQETQYF,7,0,1,7
TRBV9,TRBJ2-6,CASSVGRSGANVLTF,7,0,1,7
TRBV12-3/4,TRBJ2-1,CASSAQISSYNEQFF,7,2,2,9
TRBV6-2/3/5/6,TRBJ1-5,CASSATRKGNQPQHF,7,0,1,7
TRBV9,TRBJ2-1,CASSMTSGGSNEQFF,7,0,1,7
TRBV7-4,TRBJ1-2,CASSTQDPPIYGYTF,7,0,1,7
TRBV12-3/4,TRBJ2-7,CASRGTSGSSYEQYF,7,0,1,7
TRBV5-4,TRBJ1-4,CASRERTGGSEKLFF,7,0,1,7
TRBV28,TRBJ2-3,CASNTHGLNTDTQYF,7,0,1,7
TRBV5-1,TRBJ2-7,CASSFGQGSIYELYF,7,0,1,7
TRBV5-1,TRBJ1-3,CASSLGSGSGNTIYF,7,0,1,7
TRBV5-1,TRBJ1-1,CASSSVQGRDGEAFF,7,0,1,7
TRBV20-1,TRBJ1-2,CSASLGGRFNYGYTF,7,0,1,7
TRBV20-1,TRBJ1-2,CSARVDNSLEYGYTF,7,0,1,7
TRBV20-1,TRBJ2-7,CSARGTGSGSYEQYF,7,0,1,7
TRBV20-1,TRBJ2-4,CSAREYVGSKNIQYF,7,0,1,7
TRBV29-1,TRBJ2-1,CSVDAREDPGNEQFF,7,0,1,7
TRBV29-1,TRBJ1-2,CSVETRGQGIGGYTF,7,4,2,11
TRBV29-1,TRBJ1-1,CSVRGTGGRITEAFF,7,0,1,7
TRBV12-5,TRBJ1-5,CASGLGQGNQPQHF,7,0,1,7
TRBV19,TRBJ1-1,CASSSSGRGTEAFF,7,0,1,7
TRBV19,TRBJ2-7,CASSVGQGAVEQYF,7,0,1,7
TRBV19,TRBJ2-5,CASSMVGTGETQYF,7,0,1,7
TRBV19,TRBJ2-1,CASSIEGDYNEQFF,7,0,1,7
TRBV19,TRBJ1-1,CASSIKVQNTEAFF,7,0,1,7
TRBV18,TRBJ1-1,CASSPEGDSTEAFF,7,12,2,19
TRBV3-1,TRBJ2-1,CASQGPTHLGEQFF,7,0,1,7
TRBV5-4,TRBJ1-5,CASVVGSSNQPQHF,7,0,1,7
TRBV3-1,TRBJ2-1,CASGGLSSYNEQFF,7,0,1,7
TRBV12-3/4,TRBJ2-3,CASSFLAVSDTQYF,7,4,2,11
TRBV27,TRBJ1-1,CASSFLSGGTEAFL,7,0,1,7
TRBV6-2/3/5/6,TRBJ1-5,CASSSTGGNQPQHF,7,0,1,7
TRBV6-2/3/5/6,TRBJ2-1,CASSSEGEYNEQFF,7,0,1,7
TRBV12-3/4,TRBJ1-2,CASSSTGTGYGYTF,7,0,1,7
TRBV6-2/3/5/6,TRBJ2-1,CASSYSSLYNEQFF,7,0,1,7
TRBV12-3/4,TRBJ1-1,CASSPQGLNTEAFF,7,0,1,7
TRBV12-3/4,TRBJ2-3,CASSPRIDESSQYF,7,0,1,7
TRBV12-3/4,TRBJ2-2,CASSPRGYTGELFF,7,0,1,7
TRBV6-1,TRBJ1-5,CASSELASRQPQHF,7,0,1,7
TRBV2,TRBJ2-3,CASSEARTRATQYF,7,0,1,7
TRBV7-8,TRBJ2-3,CASSFRLVKDTQYF,7,2,2,9
TRBV3-1,TRBJ2-1,CASSFDPRGGEQFF,7,0,1,7
TRBV5-8,TRBJ2-3,CASSLRPGSDTQYF,7,0,1,7
TRBV5-5,TRBJ2-7,CASSLTSGSYEQYF,7,0,1,7
TRBV7-6,TRBJ2-3,CASSLRAGWDTQYF,7,0,1,7
TRBV7-3,TRBJ1-1,CASSLQGWNTEAFF,7,0,1,7
TRBV7-2,TRBJ1-4,CASSLAEYSEKLFF,7,0,1,7
TRBV7-6,TRBJ1-6,CASSLDPYNSPLHF,7,0,1,7
TRBV7-9,TRBJ1-4,CASSSDRSDEKLFF,7,0,1,7
TRBV3-1,TRBJ1-6,CASSPTQGYSPLHF,7,0,1,7
TRBV13,TRBJ1-2,CASSPNTGLSGYTF,7,0,1,7
TRBV3-1,TRBJ1-5,CASSPENSNQPQHF,7,0,1,7
TRBV3-1,TRBJ1-2,CASSQVSGAHGYTF,7,0,1,7
TRBV5-4,TRBJ1-2,CASSIWGTGQGSTF,7,6,2,13
TRBV6-2/3/5/6,TRBJ1-1,CASRLGHRNTEAFF,7,0,1,7
TRBV6-2/3/5/6,TRBJ2-7,CASRQGVYVREQYF,7,0,1,7
TRBV3-1,TRBJ2-5,CASNRIQGAATQYF,7,0,1,7
TRBV29-1,TRBJ2-1,CSVENRGSGWEQFF,7,0,1,7
TRBV29-1,TRBJ2-7,CSVERKGNPYEQYF,7,0,1,7
TRBV29-1,TRBJ2-5,CSVTSGADQETQYF,7,0,1,7
TRBV30,TRBJ1-2,CAWSVDGDYGYTF,7,0,1,7
TRBV30,TRBJ1-1,CAQEGIADTEAFF,7,0,1,7
TRBV7-2,TRBJ1-1,CAISGTTNTEAFF,7,0,1,7
TRBV19,TRBJ1-1,CASSIGRLTEAFF,7,26,2,33
TRBV19,TRBJ2-1,CASSTSEGNEQFF,7,0,1,7
TRBV19,TRBJ2-1,CASSQGLLNEQFF,7,0,1,7
TRBV5-4,TRBJ2-1,CASISFPLNEQFF,7,0,1,7
TRBV6-2/3/5/6,TRBJ2-1,CASIRAAYNEQFF,7,0,1,7
TRBV12-3/4,TRBJ2-7,CASSFRRAYEQYF,7,0,1,7
TRBV6-2/3/5/6,TRBJ1-5,CASSLVINQPQHF,7,0,1,7
TRBV9,TRBJ1-5,CASSANSNQPQHF,7,0,1,7
TRBV6-1,TRBJ2-3,CASSEGPTDTQYF,7,0,1,7
TRBV3-1,TRBJ1-2,CASSFQHNYGYTF,7,0,1,7
TRBV7-2,TRBJ2-7,CASSSSPSYEQYF,7,0,1,7
TRBV12-3/4,TRBJ1-5,CASSSRGRQPQHF,7,0,1,7
TRBV7-9,TRBJ2-7,CASSQGGSYEQYF,7,0,1,7
TRBV12-3/4,TRBJ2-1,CASSVHDRDEQFF,7,0,1,7
TRBV9,TRBJ2-5,CASSVNPTGTQYF,7,0,1,7
TRBV5-6,TRBJ2-7,CASSTGTSYEQYF,7,0,1,7
TRBV12-3/4,TRBJ1-1,CASRPDKHTEAFF,7,0,1,7
TRBV25-1,TRBJ2-1,CASRGSSYNEQFF,7,0,1,7
TRBV4-1,TRBJ2-1,CASSLPGFYEQFF,7,0,1,7
TRBV4-3,TRBJ1-2,CASSHLDRYGYTF,7,0,1,7
TRBV29-1,TRBJ1-1,CGARMGLNTEAFF,7,0,1,7
TRBV20-1,TRBJ2-1,CSAREIPSNEQFF,7,0,1,7
TRBV20-1,TRBJ1-5,CSASLRENQPQYF,7,0,1,7
TRBV20-1,TRBJ2-7,CSARSPAAYEQYF,7,0,1,7
TRBV20-1,TRBJ2-5,CSARGLVQETQYF,7,0,1,7
TRBV20-1,TRBJ1-5,CSAYADPPQPQHF,7,0,1,7
TRBV20-1,TRBJ2-1,CSATTRTTNEQFF,7,0,1,7
TRBV29-1,TRBJ1-1,CSVGATLGTEAFF,7,0,1,7
TRBV29-1,TRBJ2-3,CSVDSGFTDTQYF,7,4,2,11
TRBV29-1,TRBJ1-1,CSVERGVIPEAFF,7,0,1,7
TRBV29-1,TRBJ1-1,CSVELGGATEAFF,7,0,1,7
TRBV29-1,TRBJ1-6,CSVRTEGDSPLHF,7,0,1,7
TRBV20-1,TRBJ2-3,CSVERRGSDTQYF,7,0,1,7
TRBV19,TRBJ2-2,CASQTVTGELFF,7,0,1,7
TRBV19,TRBJ2-7,CASSGESYEQYF,7,0,1,7
TRBV12-3/4,TRBJ2-2,CASCRGQRGLFF,7,0,1,7
TRBV6-2/3/5/6,TRBJ2-7,CASSLTGGEQYS,7,0,1,7
TRBV12-3/4,TRBJ2-7,CASSLGFNEQYF,7,14,2,21
TRBV7-2,TRBJ2-1,CASSSPGVRQFF,7,0,1,7
TRBV12-3/4,TRBJ1-1,CASSPPQGKAFF,7,0,1,7
TRBV6-1,TRBJ2-1,CASSGTNNEQFF,7,0,1,7
TRBV6-1,TRBJ1-3,CASSETANTIYF,7,0,1,7
TRBV7-2,TRBJ1-2,CASSTGKGGYTF,7,0,1,7
TRBV5-5,TRBJ2-7,CASSLESYEQYF,7,0,1,7
TRBV3-1,TRBJ2-3,CASSPPERGKYF,7,0,1,7
TRBV6-2/3/5/6,TRBJ1-3,CASSRPYNTIYF,7,7,2,14
TRBV5-6,TRBJ2-7,CASSRHLLEQYF,7,0,1,7
TRBV3-1,TRBJ2-3,CASSQGDGRQYF,7,0,1,7
TRBV3-1,TRBJ2-5,CASSQDPSAPYF,7,2,2,9
TRBV3-1,TRBJ1-6,CASSQDNSPLHF,7,0,1,7
TRBV3-1,TRBJ2-5,CASSQIQETQYF,7,0,1,7
TRBV5-1,TRBJ1-1,CASSLVDTEAFF,7,0,1,7
TRBV20-1,TRBJ2-5,CSASVGQETQYF,7,0,1,7
TRBV19,TRBJ2-3,CAPGEADTQYF,7,0,1,7
TRBV12-3/4,TRBJ2-7,CASSFRGEQYF,7,0,1,7
TRBV2,TRBJ2-1,CASSPGLTGFF,7,0,1,7
TRBV16,TRBJ2-1,CASSPSNEQFF,7,0,1,7
TRBV12-3/4,TRBJ2-3,CASSHEDTQYF,7,0,1,7
TRBV4-1,TRBJ1-3,CASSQGNTIYF,7,0,1,7
TRBV29-1,TRBJ2-2,CSGSLHGELFF,7,0,1,7
TRBV6-2/3/5/6,TRBJ1-2,GASSYVSGYTF,7,0,1,7
TRBV7-3,TRBJ2-5,CATTYETQYF,7,0,1,7
TRBV30,TRBJ2-2,CAWSAGTSDWNGELFF,7,0,1,7
TRBV18,TRBJ1-1,CASSPQTGTEAFF,7,0,1,7
TRBV29-1,TRBJ2-3,CSVKGLSTDTQYF,6,0,1,6
TRBV20-1,TRBJ2-1,CSARDRGLAGALPARSYNEQFF,6,7,2,13
TRBV7-2,TRBJ2-1,CASSLIRGTGTSASYNEQFF,6,0,1,6
TRBV4-2,TRBJ2-6,CASSQPTGKGLEGANVLTF,6,0,1,6
TRBV5-1,TRBJ1-5,CASSLPRASEDFFNQPQHF,6,0,1,6
TRBV5-1,TRBJ2-6,CASSLRSKSPGSGANVLTF,6,0,1,6
TRBV12-5,TRBJ2-5,CASGLVPAGTGTQETQYF,6,0,1,6
TRBV12-3/4,TRBJ2-3,CASSFLGTSGASTDTQYF,6,0,1,6
TRBV12-3/4,TRBJ2-1,CASSLLPETSGRNNEQFF,6,0,1,6
TRBV27,TRBJ1-3,CASSLSGVRANSGNTIYF,6,0,1,6
TRBV6-2/3/5/6,TRBJ1-1,CASSYLPLTQGRKAEAFF,6,0,1,6
TRBV6-2/3/5/6,TRBJ2-6,CASSYGRQGASGANVLTF,6,0,1,6
TRBV6-2/3/5/6,TRBJ2-2,CASSYTFPSGRFTGELFF,6,0,1,6
TRBV6-1,TRBJ1-4,CASSEAANRRSVREKLFF,6,0,1,6
TRBV5-4,TRBJ2-1,CASSSPGLAGVISNEQFF,6,0,1,6
TRBV5-6,TRBJ2-7,CASSSRRLWGPNSYEQYF,6,0,1,6
TRBV9,TRBJ1-1,CASSVVIGSSLVNTEAFF,6,0,1,6
TRBV4-1,TRBJ2-1,CASSQESRDYTSYNEQFF,6,0,1,6
TRBV20-1,TRBJ2-1,CSAVKRLTLDNFYNEQFF,6,0,1,6
TRBV29-1,TRBJ1-2,CSVEVFSDRGEPNYGYTF,6,0,1,6
TRBV29-1,TRBJ2-1,CSVEDGPAGLVGVDEQFF,6,0,1,6
TRBV15,TRBJ2-1,CATSREPGLAGDNEQFF,6,0,1,6
TRBV19,TRBJ1-5,CASSTGQARRSNQPQHF,6,0,1,6
TRBV6-2/3/5/6,TRBJ1-5,CASSYKGKSGSNQPQHF,6,0,1,6
TRBV14,TRBJ1-1,CASSHYRGLRTNTEAFF,6,0,1,6
TRBV13,TRBJ2-2,CASSFGLADANTGELFF,6,0,1,6
TRBV7-2,TRBJ2-3,CASSLALIGGPTDTQYF,6,0,1,6
TRBV7-6,TRBJ2-2,CASSLDRSSGNTGELFF,6,0,1,6
TRBV7-9,TRBJ2-5,CASSPPIQGAVKETQYF,6,0,1,6
TRBV3-1,TRBJ2-7,CASSQEKLAALTYEQYF,6,0,1,6
TRBV7-9,TRBJ2-1,CASSTRLAGGNYNEQFF,6,0,1,6
TRBV10-2,TRBJ1-1,CASSGGRVSVTNTEAFF,6,0,1,6
TRBV5-1,TRBJ2-1,CASSLLREGPFSGEQFF,6,0,1,6
TRBV5-1,TRBJ1-1,CASSLSDGGLRDTEAFF,6,0,1,6
TRBV20-1,TRBJ2-1,CSAPGLAGTPSYNEQFF,6,0,1,6
TRBV15,TRBJ1-3,CATSYRAGRHRNTIYF,6,2,2,8
TRBV24-1,TRBJ2-3,CATSDPSGRAGDTQYF,6,0,1,6
TRBV15,TRBJ2-7,CATSRARTGSSYEQYF,6,0,1,6
TRBV19,TRBJ2-1,CASSMRAGVPYNEQFF,6,0,1,6
TRBV12-3/4,TRBJ2-7,CASSFYNGPNSYEQYF,6,0,1,6
TRBV6-2/3/5/6,TRBJ2-5,CASSFRLAGGHETQYF,6,0,1,6
TRBV28,TRBJ1-5,CASSLHRAEGNQPQHF,6,0,1,6
TRBV6-2/3/5/6,TRBJ2-7,CASSRPSGAGSYEQYF,6,0,1,6
TRBV6-1,TRBJ2-1,CASSESGSGLYNEQFF,6,0,1,6
TRBV2,TRBJ1-3,CASSEDHGASGNTIYF,6,18,2,24
TRBV2,TRBJ2-3,CASSETLWGDTDTQYF,6,0,1,6
TRBV5-4,TRBJ2-1,CASSFQREGRYNEQFF,6,0,1,6
TRBV5-6,TRBJ1-1,CASSLVGSRGAVEAFF,6,0,1,6
TRBV11-1,TRBJ2-1,CASSLTSGGNVNEQFF,6,0,1,6
TRBV13,TRBJ2-1,CASSLGGRGRNNEQFF,6,0,1,6
TRBV7-2,TRBJ2-5,CASSLGGLAGYETQYF,6,0,1,6
TRBV13,TRBJ2-1,CASSLGFSGGDNEQFF,6,0,1,6
TRBV7-8,TRBJ1-1,CASSSRVDRGNTEAFF,6,0,1,6
TRBV28,TRBJ2-3,CASSSGTSGTTDTQYF,6,8,2,14
TRBV7-2,TRBJ2-3,CASSWAPLRSTDTQYF,6,0,1,6
TRBV7-2,TRBJ2-4,CASSPWTTSPKNIQYF,6,0,1,6
TRBV4-2,TRBJ2-3,CASSPWDSGITDTQYF,6,7,2,13
TRBV6-2/3/5/6,TRBJ2-3,CASSPPRQGTSDTQYF,6,0,1,6
TRBV12-3/4,TRBJ2-4,CASSPGGGRAKNIQYF,6,0,1,6
TRBV12-3/4,TRBJ2-1,CASSALLAGGHNEQFF,6,30,2,36
TRBV13,TRBJ1-5,CASSARTVGSNQPQHF,6,0,1,6
TRBV7-9,TRBJ1-4,CASSKGQGSTNEKLFF,6,0,1,6
TRBV6-2/3/5/6,TRBJ1-5,CASKTVREARYQPQHF,6,0,1,6
TRBV5-1,TRBJ2-2,CASSLFIGGADGELFF,6,0,1,6
TRBV5-1,TRBJ2-7,CASSSLTTGLSYEQYF,6,0,1,6
TRBV5-1,TRBJ1-1,CASSYGQGGVGTEAFF,6,0,1,6
TRBV20-1,TRBJ2-5,CSASPVSGRHRETQYF,6,0,1,6
TRBV20-1,TRBJ2-5,CSASGVAGEAGETQYF,6,0,1,6
TRBV20-1,TRBJ2-3,CSARALTGGDTDTQYF,6,0,1,6
TRBV20-1,TRBJ2-7,CSARGLPGLPGYGQYF,6,0,1,6
TRBV20-1,TRBJ1-5,CSARGQGGPFDQPQHF,6,0,1,6
TRBV29-1,TRBJ2-4,CSVVPGTEKAKNIQYF,6,0,1,6
TRBV4-2,TRBJ2-3,SASSQGAGTGADTQYF,6,0,1,6
TRBV30,TRBJ2-4,CAWSQGQGPKNIQYF,6,0,1,6
TRBV10-3,TRBJ1-2,CAISEEGGPLYGYTF,6,2,2,8
TRBV10-3,TRBJ2-7,CAISNGQGGQTEQYF,6,0,1,6
TRBV10-3,TRBJ1-4,CAINEGPGDNEKLFF,6,0,1,6
TRBV24-1,TRBJ2-1,CATSDWGTFYNEQFF,6,6,2,12
TRBV15,TRBJ1-5,CATSRPTALLQPQHF,6,8,2,14
TRBV18,TRBJ1-6,CASSLDVIVGSPLHF,6,0,1,6
TRBV12-3/4,TRBJ1-2,CASRSRDSDIGGYTF,6,0,1,6
TRBV7-3,TRBJ2-5,CASTDSGLRGETQYF,6,0,1,6
TRBV27,TRBJ1-2,CASTSLDGFNYGYTF,6,4,2,10
TRBV12-3/4,TRBJ1-5,CASSLGIDSNQPQHF,6,0,1,6
TRBV28,TRBJ1-5,CASSLSAGGRQPQHF,6,0,1,6
TRBV6-2/3/5/6,TRBJ1-5,CASSLGVRSNQPQHF,6,0,1,6
TRBV7-9,TRBJ1-1,CASSWGDRPDTEAFF,6,0,1,6
TRBV12-3/4,TRBJ2-1,CASSWRLAGENEQFF,6,0,1,6
TRBV6-2/3/5/6,TRBJ2-1,CASSYGASSYNEQFF,6,0,1,6
TRBV6-2/3/5/6,TRBJ1-2,CASSYSLTESYGYTF,6,0,1,6
TRBV28,TRBJ2-7,CASSLTTGGPYEQYF,6,0,1,6
TRBV12-3/4,TRBJ2-5,CASSPDRGRDETQYF,6,0,1,6
TRBV6-1,TRBJ2-1,CASSDSGASYNEQFF,6,0,1,6
TRBV6-1,TRBJ1-5,CASSDNRDRGQPQHF,6,0,1,6
TRBV2,TRBJ2-3,CASSEGTPPTDTQYF,6,0,1,6
TRBV7-9,TRBJ2-7,CASSFPGTGVYEQYF,6,0,1,6
TRBV7-6,TRBJ2-1,CASSFKASPNNEQFF,6,0,1,6
TRBV7-9,TRBJ2-7,CASSFEDRGTYEQYF,6,0,1,6
TRBV5-4,TRBJ2-1,CASSLFLAGNNEQFF,6,0,1,6
TRBV5-5,TRBJ1-1,CASSLAQGTGGEAFF,6,0,1,6
TRBV7-2,TRBJ1-1,CASSLAGQGGTEAFF,6,0,1,6
TRBV5-6,TRBJ1-2,CASSLGPPTYYGYTF,6,0,1,6
TRBV5-4,TRBJ1-1,CASSLTREPNTEAFS,6,0,1,6
TRBV7-3,TRBJ2-5,CASSLWTGEQETQYF,6,0,1,6
TRBV7-9,TRBJ2-7,CASSLRQGSSYEQYF,6,0,1,6
TRBV7-9,TRBJ1-4,CASSLGTRGGEKLFF,6,0,1,6
TRBV5-4,TRBJ2-5,CASSLGLAGEETQYF,6,0,1,6
TRBV7-2,TRBJ1-2,CASSLGGGGGYGYTF,6,0,1,6
TRBV7-3,TRBJ1-1,CASSLIGGLNTEAFF,6,0,1,6
TRBV7-2,TRBJ2-1,CASSSSWAGFDEQFF,6,0,1,6
TRBV7-2,TRBJ2-7,CASSSDRGPSYEQYF,6,0,1,6
TRBV7-2,TRBJ2-1,CASSSGNRGLNEQFF,6,0,1,6
TRBV13,TRBJ1-1,CASSYGRGPNTEAFF,6,0,1,6
TRBV7-9,TRBJ1-1,CASSLGDTSGTEAFF,6,0,1,6
TRBV5-6,TRBJ2-1,CASSPWRIKADEQFF,6,0,1,6
TRBV12-3/4,TRBJ2-1,CASSPPRSSVNEQFF,6,0,1,6
TRBV7-9,TRBJ2-1,CASSPVSGIHNEQFF,6,0,1,6
TRBV7-6,TRBJ2-3,CASSPGTPNTDTQYF,6,0,1,6
TRBV5-6,TRBJ2-5,CASSPDGRYQETQYF,6,0,1,6
TRBV11-2,TRBJ1-1,CASSPTGAGNTEAFF,6,0,1,6
TRBV7-2,TRBJ2-7,CASSPVSRGVYEQYF,6,0,1,6
TRBV3-1,TRBJ2-3,CASSPGPRGGDTQYF,6,0,1,6
TRBV7-9,TRBJ2-4,CASSPEFLAKNIQYF,6,0,1,6
TRBV7-9,TRBJ2-7,CASSPTSGSSYEQYF,6,0,1,6
TRBV7-3,TRBJ1-1,CASSPNAGAETEAFF,6,0,1,6
TRBV6-2/3/5/6,TRBJ2-5,CASSPNGIRGETQYF,6,0,1,6
TRBV12-3/4,TRBJ2-3,CASSRLNVAANTQHF,6,0,1,6
TRBV4-2,TRBJ2-1,CASSQSLGGYDEQFF,6,0,1,6
TRBV3-1,TRBJ2-5,CASSQVPAIVETQYF,6,0,1,6
TRBV3-1,TRBJ1-4,CASSQGSGTNEKLFF,6,0,1,6
TRBV14,TRBJ2-7,CASSQGLAGRNEQYF,6,2,2,8
TRBV3-1,TRBJ2-7,CASSQEVGTSYEQYF,6,0,1,6
TRBV4-2,TRBJ2-3,CASSQEGRGTDTQYF,6,0,1,6
TRBV4-2,TRBJ2-3,CASSQERAEIDTQYF,6,0,1,6
TRBV9,TRBJ2-1,CASSVGSGSYNEQFF,6,0,1,6
TRBV9,TRBJ2-1,CASSVDGGRPNEQFF,6,11,2,17
TRBV3-1,TRBJ1-3,CASSAPTAAGDTIYF,6,0,1,6
TRBV7-3,TRBJ2-2,CASRAGTANTGELFF,6,0,1,6
TRBV2,TRBJ2-1,CASRADRLGNNEQFF,6,0,1,6
TRBV12-3/4,TRBJ2-7,CASNLVAGGPDEQYF,6,0,1,6
TRBV5-1,TRBJ1-2,CASSRTGIVRWGYTF,6,0,1,6
TRBV4-1,TRBJ1-4,CASSHTGESREKLFF,6,0,1,6
TRBV4-1,TRBJ1-2,CASSQPGQKNYGYTF,6,0,1,6
TRBV20-1,TRBJ1-5,CSAYTGIRGNQPQHF,6,0,1,6
TRBV20-1,TRBJ2-7,CSARDGRTSDYEQYF,6,0,1,6
TRBV20-1,TRBJ1-5,CSARGSLHSNQPQHF,6,0,1,6
TRBV20-1,TRBJ2-7,CSATGTSGFSYEQYF,6,0,1,6
TRBV29-1,TRBJ2-7,CSVRLRQGATYEQYF,6,0,1,6
TRBV29-1,TRBJ2-1,CSATGQTRGHNEQFF,6,0,1,6
TRBV12-5,TRBJ2-7,CASVPGYSSYEQYF,6,0,1,6
TRBV12-5,TRBJ2-1,CASGLDKTYNEQFF,6,0,1,6
TRBV30,TRBJ1-2,CAWSVGGQLYGYTF,6,0,1,6
TRBV15,TRBJ1-1,CATSRDLGTAEAFF,6,0,1,6
TRBV12-3/4,TRBJ2-7,CASFCGGGAGEQYF,6,0,1,6
TRBV18,TRBJ2-5,CASSPPQTGETQYF,6,0,1,6
TRBV7-8,TRBJ2-7,CASRVAVEDYEQYF,6,0,1,6
TRBV6-2/3/5/6,TRBJ2-7,CASIPQGRSYEQYF,6,0,1,6
TRBV2,TRBJ1-4,CASTRDWSEEKLFF,6,0,1,6
TRBV12-3/4,TRBJ1-2,CASSFQQGFYGYTF,6,0,1,6
TRBV27,TRBJ2-5,CASSLGGGRETQYF,6,0,1,6
TRBV6-2/3/5/6,TRBJ1-2,CASSLRAPYYGYTF,6,0,1,6
TRBV6-2/3/5/6,TRBJ2-7,CASSYYGGAYEQYF,6,0,1,6
TRBV6-2/3/5/6,TRBJ2-7,CASSYSGLGYEQYF,6,0,1,6
TRBV6-2/3/5/6,TRBJ1-2,CASSYPQGIGGYTF,6,0,1,6
TRBV6-2/3/5/6,TRBJ1-5,CASSYDSGIGPQHF,6,0,1,6
TRBV6-2/3/5/6,TRBJ1-4,CASSRTGLSEKLFF,6,0,1,6
TRBV6-1,TRBJ2-1,CASSEVLGVGEQFF,6,0,1,6
TRBV25-1,TRBJ1-2,CASSERQLFYGYTF,6,0,1,6
TRBV6-1,TRBJ1-1,CASSEGTTSTEAFF,6,0,1,6
TRBV9,TRBJ2-7,CASSFSGTSGEQYF,6,0,1,6
TRBV7-9,TRBJ2-7,CASSFGGGPREQYF,6,0,1,6
TRBV5-6,TRBJ2-5,CASSLSRAIETQYF,6,0,1,6
TRBV5-4,TRBJ2-1,CASSLVAGVNEQFF,6,0,1,6
TRBV7-9,TRBJ1-1,CASSLGTGNTEAFF,6,0,1,6
TRBV5-5,TRBJ2-2,CASSLGRAAGELFF,6,0,1,6
TRBV12-3/4,TRBJ1-4,CASSLGQGAKKLFF,6,0,1,6
TRBV7-6,TRBJ2-3,CASSLQGSTDTQYF,6,0,1,6
TRBV7-2,TRBJ1-2,CASSLVGRSNGYTF,6,0,1,6
TRBV7-2,TRBJ1-1,CASSLVGMNTEAFF,6,0,1,6
TRBV7-9,TRBJ2-1,CASSLGGRRNEQFF,6,0,1,6
TRBV6-2/3/5/6,TRBJ2-4,CASSLEDEKNIQYF,6,0,1,6
TRBV7-9,TRBJ1-6,CASSLNQYNSPLHF,6,0,1,6
TRBV7-6,TRBJ2-5,CASSSWGGKETQYF,6,0,1,6
TRBV5-6,TRBJ1-3,CASSPLVSGNTIYF,6,0,1,6
TRBV7-9,TRBJ2-7,CASSPPGQSYEQYF,6,0,1,6
TRBV6-2/3/5/6,TRBJ1-5,CASSPGEGRQPQHF,6,0,1,6
TRBV7-9,TRBJ1-4,CASSPRVTNEKLFF,6,0,1,6
TRBV7-2,TRBJ1-3,CASSPRDRRNTIYF,6,0,1,6
TRBV5-4,TRBJ1-2,CASSPRTALYGYTF,6,0,1,6
TRBV12-3/4,TRBJ1-2,CASSPLQGNYGYTF,6,0,1,6
TRBV3-1,TRBJ2-7,CASSRQGGLYEQYF,6,2,2,8
TRBV14,TRBJ2-7,CASSRAGGHYEQYF,6,0,1,6
TRBV5-4,TRBJ2-5,CASSRDTRKETQYF,6,0,1,6
TRBV4-2,TRBJ1-1,CASSQFGDDTEAFF,6,0,1,6
TRBV7-9,TRBJ1-1,CASSQAGGIAEAFF,6,0,1,6
TRBV3-1,TRBJ2-7,CASSQGTGPYEQYF,6,0,1,6
TRBV5-6,TRBJ2-7,CASSQRDKFYEQYF,6,0,1,6
TRBV9,TRBJ1-2,CASSVLGSNYGYTF,6,11,2,17
TRBV9,TRBJ1-2,CASSVGDSNYGYTF,6,0,1,6
TRBV9,TRBJ2-5,CASSVDLSTETQYF,6,0,1,6
TRBV7-9,TRBJ2-7,CASSSRAGSYEQYF,6,0,1,6
TRBV6-2/3/5/6,TRBJ1-6,CASRSTGERSPLHF,6,0,1,6
TRBV27,TRBJ1-1,CASRDKTVNTEAFF,6,0,1,6
TRBV5-1,TRBJ2-5,CASSLSRGSETQYF,6,0,1,6
TRBV5-1,TRBJ2-5,CASSPGQGWETQYF,6,0,1,6
TRBV5-1,TRBJ1-1,CASSQWQGDTEALF,6,0,1,6
TRBV5-1,TRBJ1-2,CASSQLTGNYGYTF,6,0,1,6
TRBV4-3,TRBJ2-3,CASSQDSHRDTQYF,6,0,1,6
TRBV5-1,TRBJ2-2,CASKIGTETGELFF,6,0,1,6
TRBV20-1,TRBJ2-7,CSAPDSRGIYEQYF,6,0,1,6
TRBV20-1,TRBJ2-2,CSAIAGGLDGELFF,6,0,1,6
TRBV20-1,TRBJ1-5,CSARVGTVNQPQHF,6,0,1,6
TRBV20-1,TRBJ2-1,CSAREGETYNEQFF,6,0,1,6
TRBV29-1,TRBJ1-1,CSVVPGVRVTEAFF,6,0,1,6
TRBV29-1,TRBJ2-1,CSVGDRLIYNEQFF,6,0,1,6
TRBV29-1,TRBJ2-1,CSVGVAGGGNEQFF,6,0,1,6
TRBV29-1,TRBJ1-2,CSVDSPRVWDGYTF,6,0,1,6
TRBV29-1,TRBJ2-6,CSVDLGSGANVLTF,6,0,1,6
TRBV29-1,TRBJ2-7,CSVEDPLGTYEQYF,6,0,1,6
TRBV29-1,TRBJ2-5,CSVEEGTFQETQYF,6,0,1,6
TRBV29-1,TRBJ1-1,CSVLRDRGHPEAFF,6,0,1,6
TRBV29-1,TRBJ1-5,CSAAGTGDNQPQHF,6,0,1,6
TRBV29-1,TRBJ1-2,CSATSSTVSYGYTF,6,0,1,6
TRBV7-7,TRBJ2-5,CAIFSGGEETQYF,6,0,1,6
TRBV12-3/4,TRBJ1-2,CATTRASRTSYTF,6,0,1,6
TRBV24-1,TRBJ2-5,CATSDPLRETQYF,6,0,1,6
TRBV19,TRBJ1-1,CASGGGSNTEAFF,6,0,1,6
TRBV19,TRBJ1-1,CASSPGLNTEAFF,6,0,1,6
TRBV2,TRBJ1-6,CASFRTADRNLHF,6,0,1,6
TRBV18,TRBJ1-2,CASSPRENYGYTF,6,0,1,6
TRBV18,TRBJ1-1,CASSPQTNTEAFF,6,0,1,6
TRBV12-3/4,TRBJ2-7,CASLRGSENEQYF,6,4,2,10
TRBV12-3/4,TRBJ1-2,CASTHGREYGYTF,6,0,1,6
TRBV27,TRBJ2-7,CASSFYNSYEQYF,6,0,1,6
TRBV12-3/4,TRBJ1-5,CASSLGSNQPQHF,6,0,1,6
TRBV12-3/4,TRBJ2-7,CASSLGGPYEQYF,6,0,1,6
TRBV12-3/4,TRBJ2-5,CASSSGQGETQYF,6,0,1,6
TRBV6-2/3/5/6,TRBJ2-1,CASSPERRNEQFF,6,0,1,6
TRBV6-1,TRBJ1-4,CASSPTENEKLFF,6,0,1,6
TRBV2,TRBJ2-1,CASSEVVGYEQFF,6,0,1,6
TRBV25-1,TRBJ1-1,CASSEGFYTDAFF,6,0,1,6
TRBV7-2,TRBJ2-3,CASSLGPPGTQYF,6,12,2,18
TRBV7-2,TRBJ1-1,CASSLTENTEAFF,6,0,1,6
TRBV7-8,TRBJ2-7,CASSLQNSYEQYF,6,0,1,6
TRBV5-4,TRBJ2-1,CASSSPTSNEQFF,6,0,1,6
TRBV5-6,TRBJ1-2,CASSYREGGGYTF,6,0,1,6
TRBV6-2/3/5/6,TRBJ2-1,CASSPYPPYEQFF,6,0,1,6
TRBV7-6,TRBJ2-7,CASSRTDNYEQYF,6,5,2,11
TRBV4-2,TRBJ1-2,CASSQNRGRGYTF,6,0,1,6
TRBV14,TRBJ1-1,CASSQSTRTEAFF,6,0,1,6
TRBV7-9,TRBJ2-7,CASSSESSYEQYF,6,0,1,6
TRBV7-9,TRBJ1-4,CASRDRGSEKLFF,6,0,1,6
TRBV7-2,TRBJ2-7,CASRLDRYYEQYF,6,0,1,6
TRBV28,TRBJ2-7,CASRGTGTYEQYF,6,0,1,6
TRBV5-1,TRBJ1-6,CASSLEPGSPLHF,6,0,1,6
TRBV5-1,TRBJ2-7,CASSYRAGDEQYF,6,0,1,6
TRBV5-1,TRBJ1-1,CASSPGPNTEAFF,6,0,1,6
TRBV20-1,TRBJ2-7,CSATSGYSYEQYF,6,0,1,6
TRBV20-1,TRBJ2-7,CSARDNPRYEQYF,6,0,1,6
TRBV20-1,TRBJ2-2,CSARPRDTGELFF,6,0,1,6
TRBV20-1,TRBJ2-7,CSANPGGSYEQYF,6,0,1,6
TRBV20-1,TRBJ2-1,CSAPGQGANEQFF,6,0,1,6
TRBV20-1,TRBJ2-7,CSALAVISYEQYF,6,0,1,6
TRBV29-1,TRBJ2-1,CSVGIDSYNEQFF,6,0,1,6
TRBV29-1,TRBJ1-1,CSVDAGWGTEAFF,6,0,1,6
TRBV29-1,TRBJ1-2,CSVEGTGPRGYTF,6,0,1,6
TRBV29-1,TRBJ2-1,CSVEETSGSMQFF,6,0,1,6
TRBV29-1,TRBJ2-5,CSVLAGLQETQYF,6,0,1,6
TRBV29-1,TRBJ2-7,CSVAVSSSYEQYF,6,0,1,6
TRBV29-1,TRBJ1-6,CSVGDRENSPLHF,6,0,1,6
TRBV29-1,TRBJ1-1,CSTHRGQNTEAFF,6,0,1,6
TRBV30,TRBJ2-3,CAYDRDTDTQYF,6,0,1,6
TRBV19,TRBJ2-3,CASQRSGGRQYF,6,0,1,6
TRBV19,TRBJ2-4,CASSLDKNIQYF,6,0,1,6
TRBV19,TRBJ2-2,CASSIGTGELFF,6,0,1,6
TRBV19,TRBJ1-5,CASSKAPGPQHF,6,0,1,6
TRBV7-9,TRBJ1-5,CASGYSNQPQHF,6,0,1,6
TRBV7-9,TRBJ1-4,CASDRVNEKLFF,6,0,1,6
TRBV27,TRBJ2-7,CASSSTGGEQYF,6,10,2,16
TRBV27,TRBJ2-1,CASSPRYNEQFF,6,0,1,6
TRBV12-3/4,TRBJ2-1,CASSRLVDEQFF,6,0,1,6
TRBV6-2/3/5/6,TRBJ2-5,CASSQGGETQYF,6,0,1,6
TRBV2,TRBJ2-7,CASSASRNEQYF,6,0,1,6
TRBV7-9,TRBJ1-5,CASSLGRRPQHF,6,0,1,6
TRBV11-2,TRBJ1-5,CASSLENQPQHF,6,0,1,6
TRBV7-6,TRBJ1-2,CASSLENRGYTF,6,0,1,6
TRBV6-1,TRBJ1-1,CASSDSVGEAFF,6,0,1,6
TRBV7-9,TRBJ2-1,CGSGEGRYEQFF,6,7,2,13
TRBV10-2,TRBJ2-1,CATSDPWDEQFF,6,0,1,6
TRBV4-3,TRBJ2-3,CASSQSRDTQYF,6,0,1,6
TRBV5-1,TRBJ2-3,CASSQYTDTQYF,6,0,1,6
TRBV20-1,TRBJ2-5,CSANGEGETQYF,6,0,1,6
TRBV20-1,TRBJ2-5,CSAELRQETQYF,6,0,1,6
TRBV29-1,TRBJ1-2,CSVDSPHYGYTF,6,0,1,6
TRBV29-1,TRBJ2-7,CSVEDRAYEQYF,6,0,1,6
TRBV29-1,TRBJ2-1,CSVEEPRGEQFF,6,0,1,6
TRBV29-1,TRBJ1-1,CSVTTGNTEAFF,6,0,1,6
TRBV29-1,TRBJ2-1,CSVGQVGDEQFF,6,0,1,6
TRBV19,TRBJ2-1,CATTTGGRRFF,6,0,1,6
TRBV27,TRBJ1-1,CASEITGQAFF,6,3,2,9
TRBV12-3/4,TRBJ1-2,CASSLAGGYTF,6,0,1,6
TRBV6-1,TRBJ1-6,CASSEGSPLHF,6,0,1,6
TRBV10-3,TRBJ1-5,CASNSKQPQHF,6,0,1,6
TRBV12-3/4,TRBJ1-6,CASKLSSPLHF,6,0,1,6
TRBV20-1,TRBJ1-1,CSAVGAGGAFF,6,0,1,6
TRBV20-1,TRBJ1-3,CSARAVDTIYF,6,0,1,6
TRBV20-1,TRBJ2-1,CSARALVEQFF,6,0,1,6
TRBV29-1,TRBJ2-7,CSVDQGGEQYF,6,0,1,6
TRBV29-1,TRBJ1-1,CSVDGNTEAFF,6,0,1,6
TRBV29-1,TRBJ2-7,CSVELGYEQYF,6,0,1,6
TRBV2,TRBJ2-7,CASSVHEQYF,6,0,1,6
TRBV5-4,TRBJ2-7,CASSKDPTGVYEQYF,6,0,1,6
TRBV12-5,TRBJ1-4,CASGLVRSLATNEKLFF,6,0,1,6
TRBV7-9,TRBJ2-5,CASSPPLGPGQETQYF,6,0,1,6
TRBV7-8,TRBJ1-3,CAGSWTGGAGNTIYF,6,0,1,6
TRBV7-3,TRBJ2-1,RASSHGGGFYNEQFL,6,0,1,6
TRBV7-6,TRBJ1-4,CASSLASGTGNEILFF,6,0,1,6
TRBV3-1,TRBJ1-3,CASSQDYRISGNSIYF,6,0,1,6
TRBV19,TRBJ1-5,CASSTVDPIGSNQPQHF,6,0,1,6
TRBV4-2,TRBJ2-1,CASSLRLAGSYNEQFF,6,0,1,6
TRBV18,TRBJ2-7,CASSPSGGVFYEQYF,6,4,2,10
TRBV2,TRBJ2-2,CASRRGGQNTGELFF,6,0,1,6
TRBV5-8,TRBJ2-1,CASSLFGLNEQFF,6,0,1,6
TRBV18,TRBJ1-5,CASSPGQNSNQTQHF,6,0,1,6
TRBV12-3/4,TRBJ1-5,CASSLLRGGGSQPQHF,5,0,1,5
TRBV12-5,TRBJ2-1,CASGNPGLDSNEQFF,5,346,2,351
TRBV7-2,TRBJ2-5,CASSPSLAGLLGTQYF,5,0,1,5
TRBV9,TRBJ2-5,CASSGPLSWERGETQYF,5,17,2,22
TRBV5-4,TRBJ2-3,CASSLTSTDTQYF,5,16,2,21
TRBV4-1,TRBJ1-1,CASSQDPTVMNTEAFF,5,0,1,5
TRBV20-1,TRBJ2-3,CSARDRGLSDTQYF,5,7,2,12
TRBV9,TRBJ2-2,CASSVGGSGELFF,5,14,2,19
TRBV7-2,TRBJ2-5,CASSFAPTWTGSITGTSAQETQYF,5,0,1,5
TRBV12-3/4,TRBJ2-2,CASSFKVQAGTAGGGMPGELFF,5,0,1,5
TRBV2,TRBJ2-1,CASSGPWGGTSGRIDYNEQFF,5,0,1,5
TRBV6-2/3/5/6,TRBJ2-4,CASTIRPGLAGDLAKNIQYF,5,0,1,5
TRBV6-2/3/5/6,TRBJ2-6,CASSYWDQAGGYSGANVLTF,5,0,1,5
TRBV3-1,TRBJ2-3,CASSQEWWTSGALPTDTQYF,5,0,1,5
TRBV12-5,TRBJ2-2,CASGLPDRVGFWNTGELFF,5,0,1,5
TRBV12-3/4,TRBJ2-5,CASSFQGTSGRWDQETQYF,5,0,1,5
TRBV10-3,TRBJ2-7,CASSDGTGGIAGIYEQYF,5,0,1,5
TRBV19,TRBJ2-6,CASSSPPGRYSGANVLTF,5,3,2,8
TRBV19,TRBJ1-5,CASSIDQSQIQKFQPQHF,5,0,1,5
TRBV12-3/4,TRBJ1-5,CASSLGHRFWNSNQPQHF,5,0,1,5
TRBV6-2/3/5/6,TRBJ2-1,CASSLGGAGGLSYNEQFF,5,0,1,5
TRBV7-3,TRBJ2-3,CASSLSGRATWAPDTQYF,5,0,1,5
TRBV11-2,TRBJ1-5,CASSLARGDRGGNQPQHF,5,0,1,5
TRBV2,TRBJ1-4,CASSLWEQNPLDNEKLFF,5,0,1,5
TRBV4-2,TRBJ1-2,CASSQDSRGDLREDGYTF,5,0,1,5
TRBV20-1,TRBJ1-2,CSATRPGTGGLGDYGYTF,5,0,1,5
TRBV29-1,TRBJ1-3,CSDAGWVITLCAGNTIYF,5,0,1,5
TRBV7-2,TRBJ2-3,CAGSLGVAGGLTDTQYF,5,0,1,5
TRBV15,TRBJ2-7,CATSRDLPGLGTYEQYF,5,0,1,5
TRBV7-9,TRBJ2-5,CASSFLGQLAVQETQYF,5,0,1,5
TRBV18,TRBJ2-3,CASSPRLAGGSTDTQYF,5,0,1,5
TRBV7-2,TRBJ2-3,CASGNLRDRVNTDTQYF,5,0,1,5
TRBV6-2/3/5/6,TRBJ1-1,CASSYSNRGLTNTEAFF,5,0,1,5
TRBV6-1,TRBJ2-2,CASSEARQVVGSGELFF,5,0,1,5
TRBV6-1,TRBJ1-5,CASSEARGSNSNQPQHF,5,0,1,5
TRBV12-3/4,TRBJ2-3,CASSNPGLAGRTDTQYF,5,0,1,5
TRBV7-2,TRBJ2-1,CASSLAVAGGPYNEQFF,5,0,1,5
TRBV11-2,TRBJ1-3,CASSLGVYGRSGNTIYF,5,0,1,5
TRBV7-9,TRBJ2-4,CASSLGGGQGADWIQYF,5,0,1,5
TRBV7-6,TRBJ2-7,CASSLTGRPAGVYEQYF,5,0,1,5
TRBV7-9,TRBJ2-5,CASSSTWDGGYQETQYF,5,0,1,5
TRBV5-4,TRBJ1-2,CASSRLDPTFRNYGYTF,5,0,1,5
TRBV3-1,TRBJ2-3,CASSQYDRSDKTDTQYF,5,0,1,5
TRBV3-1,TRBJ2-3,CASSQARGTGGTDTQYF,5,0,1,5
TRBV7-3,TRBJ2-1,CASSANRGTPQGNEQFF,5,19,2,24
TRBV5-4,TRBJ2-3,CASSAGLAGSTQNTQYF,5,0,1,5
TRBV7-9,TRBJ2-1,CASRRDPVFSSFEEQFF,5,0,1,5
TRBV28,TRBJ1-5,CASRNRDRGYSNQPQHF,5,0,1,5
TRBV5-1,TRBJ2-5,CASSLDPSGVVQETQYF,5,0,1,5
TRBV4-3,TRBJ2-7,CASSKGGRLAGTYEQYF,5,0,1,5
TRBV20-1,TRBJ2-6,CSASTGQGGGGANVLTF,5,0,1,5
TRBV30,TRBJ2-7,CAWSGLAGATFYEQYF,5,0,1,5
TRBV10-3,TRBJ2-3,CAISSLAGDTVDTQYF,5,0,1,5
TRBV24-1,TRBJ1-4,CATSDPRDRKNEKLFF,5,0,1,5
TRBV19,TRBJ2-1,CASSILSGSRGNEQFF,5,0,1,5
TRBV18,TRBJ2-5,CASSWRGLGVQETQYF,5,0,1,5
TRBV5-4,TRBJ2-1,CASIDKKTGTNNEQFF,5,3,2,8
TRBV12-3/4,TRBJ2-7,CASTQGSRQRSYEQYF,5,0,1,5
TRBV27,TRBJ1-5,CASSFRDRGPNQPQHF,5,0,1,5
TRBV12-3/4,TRBJ1-6,CASSLSVGSYNSPLHF,5,4,2,9
TRBV27,TRBJ2-7,CASSSPKLAGVSEQYF,5,0,1,5
TRBV6-2/3/5/6,TRBJ2-1,CASSYSGGKSYNEQFF,5,0,1,5
TRBV6-2/3/5/6,TRBJ1-4,CASSYPGFGGLEKLFF,5,0,1,5
TRBV12-3/4,TRBJ2-4,CASSPGLAVAKNIQYF,5,0,1,5
TRBV27,TRBJ1-5,CASSPGQGAVYQPQHF,5,0,1,5
TRBV5-5,TRBJ1-5,CASSPGGGYINQPQHF,5,0,1,5
TRBV6-2/3/5/6,TRBJ2-7,CASSHRDRSPAYEQYF,5,0,1,5
TRBV6-1,TRBJ1-5,CASSVGGGRINQPQHF,5,0,1,5
TRBV6-4,TRBJ2-5,CASSGSTSGSQETQYF,5,0,1,5
TRBV2,TRBJ2-1,CASSGTSGSSYNEQFF,5,0,1,5
TRBV25-1,TRBJ2-3,CASSEFGGVGTDTQYF,5,0,1,5
TRBV19,TRBJ2-1,CASSIYEGEGDNEQFF,5,0,1,5
TRBV12-3/4,TRBJ1-1,CASSTPDGTVNTEAFF,5,0,1,5
TRBV7-2,TRBJ2-4,CASSFRGRGAKNIQYF,5,0,1,5
TRBV5-6,TRBJ2-3,CASSFVSGRSTDTQYF,5,0,1,5
TRBV5-4,TRBJ2-1,CASSLAGRGGYNEQFF,5,0,1,5
TRBV6-4,TRBJ2-3,CASSLDLAGGPDTQYF,5,0,1,5
TRBV5-6,TRBJ2-1,CASSLMRQSGYNEQFF,5,0,1,5
TRBV7-2,TRBJ2-5,CASSLTSGRARETQYF,5,0,1,5
TRBV7-9,TRBJ1-5,CASSLQPRGSNQPQHF,5,0,1,5
TRBV11-1,TRBJ2-3,CASSLVFSSTADTQYF,5,0,1,5
TRBV7-2,TRBJ2-1,CASSLVADLSYNEQFF,5,0,1,5
TRBV7-9,TRBJ2-1,CASSLAGTGPYNEQFF,5,0,1,5
TRBV7-2,TRBJ2-1,CASSLDTSGLLDEQFF,5,0,1,5
TRBV11-1,TRBJ1-1,CASSLTPGQGGTEAFF,5,0,1,5
TRBV7-2,TRBJ2-5,CASSSQGGEEWETQYF,5,0,1,5
TRBV5-5,TRBJ2-2,CASSSGLAGVDGELFF,5,0,1,5
TRBV5-4,TRBJ2-1,CASSSRKTGILWEQFF,5,0,1,5
TRBV6-2/3/5/6,TRBJ2-6,CASSSDRGGITNVLTF,5,0,1,5
TRBV14,TRBJ2-2,CASSLTDSLNTGELFF,5,14,2,19
TRBV6-2/3/5/6,TRBJ2-5,CASSLTGGTGAETQYF,5,0,1,5
TRBV5-4,TRBJ2-1,CASSLGSVSSYNEQFF,5,3,2,8
TRBV7-2,TRBJ2-3,CASSLTGLAGSDTQYF,5,0,1,5
TRBV5-4,TRBJ2-1,CASSPLAGQPYNEQFF,5,0,1,5
TRBV3-1,TRBJ1-1,CASSPLAGWGNTEAFF,5,0,1,5
TRBV7-8,TRBJ2-1,CASSPPVWGDYNEQFF,5,0,1,5
TRBV12-3/4,TRBJ1-2,CASSPRSAPKSSGYTF,5,8,2,13
TRBV7-9,TRBJ2-1,CASSPPRPGSYNEQFF,5,0,1,5
TRBV5-4,TRBJ2-1,CASSHPEAGGYNEQFF,5,4,2,9
TRBV6-2/3/5/6,TRBJ2-3,CASSHWSGRAVDTQYF,5,0,1,5
TRBV3-1,TRBJ2-6,CASSQAGDSGANVLTF,5,0,1,5
TRBV7-2,TRBJ2-1,CASSQGLAFSYNEQFF,5,0,1,5
TRBV3-1,TRBJ2-2,CASSQGSGSVTGELFF,5,0,1,5
TRBV3-1,TRBJ1-5,CASSQTREGGGQPQHF,5,0,1,5
TRBV9,TRBJ2-1,CASSVGAGAEYNEQFF,5,0,1,5
TRBV9,TRBJ2-3,CASSAPGGGLTDTQYF,5,0,1,5
TRBV7-2,TRBJ2-5,CASSIQTSGSSQTQYF,5,0,1,5
TRBV3-1,TRBJ2-2,CASSRQDPRGSGELFF,5,0,1,5
TRBV2,TRBJ2-2,CASRDLRRGNTGELFF,5,0,1,5
TRBV6-2/3/5/6,TRBJ2-6,CASRADWTSGANVLTF,5,0,1,5
TRBV5-1,TRBJ2-2,CASYSGQSRNTGELFF,5,0,1,5
TRBV5-1,TRBJ2-2,CASGLEPKGTTGELFF,5,0,1,5
TRBV5-1,TRBJ2-7,CASSFGLTLDSYEQYF,5,0,1,5
TRBV5-1,TRBJ2-2,CASSLYPSGNTGELFF,5,0,1,5
TRBV5-1,TRBJ1-1,CASSLGGDGSSAEAFF,5,0,1,5
TRBV5-1,TRBJ2-7,CASSLVGGGSPYEQYF,5,0,1,5
TRBV5-1,TRBJ2-6,CASSSPTGSGANVLTF,5,0,1,5
TRBV5-1,TRBJ2-3,CASSSGLAGGVDTQYF,5,0,1,5
TRBV4-1,TRBJ1-1,CASSQVKGKMNTEAFF,5,0,1,5
TRBV4-3,TRBJ1-2,CASSQDSTGDNYGYTF,5,0,1,5
TRBV4-3,TRBJ2-5,CASSQDVSEPWETQYF,5,4,2,9
TRBV4-3,TRBJ2-7,CASSQDTLTAGDEQYF,5,0,1,5
TRBV5-1,TRBJ1-6,CASSTSGLGDNSPLHF,5,0,1,5
TRBV29-1,TRBJ2-5,CSAGGLARMYQETQYF,5,0,1,5
TRBV20-1,TRBJ1-6,CSAGGVTEKNNSPLHF,5,0,1,5
TRBV20-1,TRBJ2-1,CSAIAGSASSYNEQFF,5,0,1,5
TRBV20-1,TRBJ2-1,CSASGASGDPGNEQFF,5,0,1,5
TRBV20-1,TRBJ2-2,CSARDFGGAWDGELFF,5,0,1,5
TRBV20-1,TRBJ2-3,CSARDLVNFITDTQYF,5,0,1,5
TRBV20-1,TRBJ2-2,CSARDRLAGNTGELFF,5,0,1,5
TRBV20-1,TRBJ1-4,CSARDGTSPPFEKLFF,5,0,1,5
TRBV20-1,TRBJ2-5,CSARDLGTLRGETQYF,5,0,1,5
TRBV29-1,TRBJ2-1,CSVGSWGKSSYNEQFF,5,0,1,5
TRBV29-1,TRBJ2-3,CSVKSGRREDTDTQYF,5,0,1,5
TRBV29-1,TRBJ2-1,CSANGASGSLNNEQFF,5,0,1,5
TRBV7-3,TRBJ1-2,RASSLTTGCANYGYTF,5,0,1,5
TRBV12-5,TRBJ1-1,CASGLTRVTHTEAFF,5,0,1,5
TRBV30,TRBJ2-1,CAWIARAYPYNEQFF,5,0,1,5
TRBV10-3,TRBJ2-5,CAISVSGRAEETQYF,5,0,1,5
TRBV10-3,TRBJ2-2,CAIRLAGVNAGELFF,5,0,1,5
TRBV12-3/4,TRBJ2-1,CATATGTASYNEQFF,5,0,1,5
TRBV15,TRBJ2-5,CATSRGRGGQETQYF,5,0,1,5
TRBV15,TRBJ2-3,CATSRRTVSTDTQYF,5,0,1,5
TRBV12-3/4,TRBJ2-5,CASLEIGWGSETQYF,5,0,1,5
TRBV19,TRBJ1-1,CASSIRTAMNTEAFF,5,0,1,5
TRBV19,TRBJ1-3,CASSISPPTGNTIYF,5,0,1,5
TRBV19,TRBJ2-3,CASSMMRADTDTQYF,5,0,1,5
TRBV19,TRBJ2-1,CASSSPGTGLNEQFF,5,0,1,5
TRBV3-1,TRBJ1-3,CASSGTALSGNTIYF,5,0,1,5
TRBV19,TRBJ2-1,CASRTGLSSYNEQFF,5,0,1,5
TRBV18,TRBJ1-5,CASSPRQGGGQPQHF,5,0,1,5
TRBV18,TRBJ2-5,CASSPMGQGQETQYF,5,0,1,5
TRBV18,TRBJ2-1,CASSRDLSIDNEQFF,5,0,1,5
TRBV18,TRBJ1-4,CASSRSQGVDEKLFF,5,0,1,5
TRBV5-4,TRBJ2-3,CASREGGGNTDTQYF,5,0,1,5
TRBV6-1,TRBJ2-1,CASTEGGLAGGEQFF,5,0,1,5
TRBV6-2/3/5/6,TRBJ2-1,CASTKSAGGYNEQFF,5,0,1,5
TRBV28,TRBJ1-6,CASSFRHSKNSPLHF,5,0,1,5
TRBV28,TRBJ2-7,CASSLPGTGVNEQYF,5,0,1,5
TRBV12-3/4,TRBJ2-3,CASSLVYGRGDTQYF,5,0,1,5
TRBV12-3/4,TRBJ1-5,CASSLKGIGNQPQHF,5,0,1,5
TRBV6-2/3/5/6,TRBJ2-7,CASSLLGTGIYEQYF,5,0,1,5
TRBV12-3/4,TRBJ1-5,CASSLDGRPYQPQHF,5,0,1,5
TRBV7-9,TRBJ1-2,CASSLTQGVYDGYTF,5,0,1,5
TRBV6-2/3/5/6,TRBJ1-5,CASSYSDRSNQPQHF,5,0,1,5
TRBV6-2/3/5/6,TRBJ2-4,CASSYSRDRQNIQYF,5,0,1,5
TRBV12-3/4,TRBJ2-3,CASSLIAGLTDTQYF,5,0,1,5
TRBV25-1,TRBJ2-7,CASSRSGTGRVEQYF,5,0,1,5
TRBV2,TRBJ1-5,CASSRDRRTNQPQHF,5,0,1,5
TRBV6-4,TRBJ1-3,CASSDAGSTGNTIYF,5,0,1,5
TRBV25-1,TRBJ1-2,CASSESGIANYGYTF,5,0,1,5
TRBV6-1,TRBJ2-1,CASSEWYRAYNEQFF,5,0,1,5
TRBV6-1,TRBJ1-1,CASSEAIPGQTEAFF,5,0,1,5
TRBV6-1,TRBJ2-5,CASSEGAGGRETQYF,5,0,1,5
TRBV12-3/4,TRBJ1-5,CASSTRQGGNQPQHF,5,0,1,5
TRBV5-4,TRBJ2-1,CASSKRGLSYNEQFF,5,0,1,5
TRBV5-6,TRBJ2-5,CASSFAGRGQETQYF,5,0,1,5
TRBV5-6,TRBJ2-3,CASSLSEARTDTQYF,5,0,1,5
TRBV5-5,TRBJ2-3,CASSLWEIGADTQYF,5,0,1,5
TRBV5-4,TRBJ2-5,CASSLRGTLKETLYF,5,0,1,5
TRBV5-6,TRBJ2-5,CASSLASGIQETQYF,5,0,1,5
TRBV7-9,TRBJ2-1,CASSLGLFDYNEQFF,5,0,1,5
TRBV7-6,TRBJ2-3,CASSLISSGTDTQYF,5,0,1,5
TRBV7-9,TRBJ1-4,CASSLQGRLNEELFF,5,0,1,5
TRBV7-9,TRBJ2-7,CASSLVGRGNYEQYF,5,0,1,5
TRBV7-2,TRBJ2-1,CASSLAGGPRNEQFF,5,0,1,5
TRBV7-2,TRBJ2-7,CASSLADGTTYEQYF,5,0,1,5
TRBV7-8,TRBJ2-5,CASSLGGGQGETQYF,5,0,1,5
TRBV7-2,TRBJ2-7,CASSLGRLPSYEQYF,5,0,1,5
TRBV7-3,TRBJ2-7,CASSLRGGGVYEQYI,5,0,1,5
TRBV5-6,TRBJ2-5,CASSSRTDVKETQYF,5,0,1,5
TRBV5-6,TRBJ2-4,CASSSDYLAKNIQYF,5,0,1,5
TRBV5-4,TRBJ2-7,CASSSFPRTQLEQYF,5,10,2,15
TRBV7-2,TRBJ1-2,CASSWPGRTTYGYTF,5,0,1,5
TRBV7-3,TRBJ2-1,CASSWGLADHNEQFF,5,0,1,5
TRBV4-2,TRBJ2-7,CASSLMTSGSYEQYF,5,0,1,5
TRBV7-2,TRBJ2-7,CASSPLTVTPYEQYF,5,0,1,5
TRBV5-8,TRBJ2-6,CASSPRTAGANVLTF,5,0,1,5
TRBV6-2/3/5/6,TRBJ2-5,CASSPVSLRKETQYF,5,0,1,5
TRBV11-2,TRBJ2-3,CASSPGNKSTDTQYF,5,0,1,5
TRBV5-5,TRBJ1-3,CASSPDIFPGNTIYF,5,0,1,5
TRBV6-2/3/5/6,TRBJ2-5,CASSPNGQIQETQYF,5,0,1,5
TRBV6-2/3/5/6,TRBJ1-2,CASSPTSSANYGYTF,5,0,1,5
TRBV7-3,TRBJ2-7,CASSPTGQGSFEQYF,5,0,1,5
TRBV7-9,TRBJ1-6,CASSRAGTGVSPLHF,5,0,1,5
TRBV11-1,TRBJ2-1,CASSQDRASYNEQFF,9,0,1,9
TRBV3-1,TRBJ1-2,CASSQIDRADYGYTF,5,0,1,5
TRBV3-1,TRBJ1-4,CASSQPGQGGEKLFF,5,0,1,5
TRBV4-2,TRBJ2-1,CASSQGWEGPNEQFF,5,0,1,5
TRBV14,TRBJ1-5,CASSQGPYSNQPQHF,5,27,2,32
TRBV3-1,TRBJ2-3,CASSQGGPPTDTQYF,5,0,1,5
TRBV3-1,TRBJ2-4,CASSQGKRQTGSRYF,5,0,1,5
TRBV4-2,TRBJ1-1,CASSQDLGQSSGAFF,5,0,1,5
TRBV3-1,TRBJ2-7,CASSQDGIPSYEQYF,5,0,1,5
TRBV3-1,TRBJ2-5,CASSQEILARETQYF,5,0,1,5
TRBV4-2,TRBJ2-1,CASSQETGIYNEQFF,5,0,1,5
TRBV9,TRBJ1-6,CASSVSGTDNSPLHF,5,0,1,5
TRBV9,TRBJ2-1,CASSVGGGTNNEQFF,5,0,1,5
TRBV9,TRBJ2-5,CASSVGLGARKTQYF,5,0,1,5
TRBV5-4,TRBJ2-2,CASSAAGSTTGELFF,5,0,1,5
TRBV9,TRBJ2-1,CASSADVLAGAEQFF,5,0,1,5
TRBV6-2/3/5/6,TRBJ2-5,CASSGLAGAQETQYF,5,0,1,5
TRBV5-6,TRBJ1-6,CASSMTGGRNSPLHF,5,0,1,5
TRBV7-2,TRBJ2-7,CASSTLAGGSYEQYF,5,0,1,5
TRBV11-1,TRBJ2-3,CASSNGAASTDTQYF,5,0,1,5
TRBV12-3/4,TRBJ1-3,CASRSTGPDGNTIYF,5,0,1,5
TRBV6-2/3/5/6,TRBJ1-2,CASRLDETGVYGYTF,5,0,1,5
TRBV11-1,TRBJ2-3,CASRPRVWVTDTQYF,5,0,1,5
TRBV6-2/3/5/6,TRBJ1-1,CASRPWGQINTEAFF,5,0,1,5
TRBV6-2/3/5/6,TRBJ2-7,CASRGFSRKGYEQYF,5,0,1,5
TRBV12-3/4,TRBJ2-2,CASNHGLARTGELFF,5,0,1,5
TRBV4-1,TRBJ1-1,CASTHHWVRNTEAFF,5,0,1,5
TRBV10-2,TRBJ2-3,CASSRLAGFTDTQYF,5,0,1,5
TRBV5-1,TRBJ2-7,CASSLYPGGRSEQYF,5,0,1,5
TRBV5-1,TRBJ1-1,CASSLGQPMNTEAFF,5,0,1,5
TRBV5-1,TRBJ2-5,CASSLEGTYRETQYF,5,0,1,5
TRBV5-1,TRBJ2-7,CASSLRGGLSYEQYF,5,0,1,5
TRBV5-1,TRBJ1-5,CASSWGQGINQPQHF,5,0,1,5
TRBV5-1,TRBJ2-7,CASSYHGQGDSEQYF,5,0,1,5
TRBV5-1,TRBJ1-6,CASSPRGGADSPLHF,5,0,1,5
TRBV4-1,TRBJ1-5,CASSQWVYSNQPQHF,5,5,2,10
TRBV4-1,TRBJ1-2,CASSQGWGTSYGYTF,5,0,1,5
TRBV4-1,TRBJ2-7,CASSQDQTGVYEQYF,5,0,1,5
TRBV4-1,TRBJ1-2,CASSQMGLLTYGYTF,5,0,1,5
TRBV5-1,TRBJ2-3,CASSISGGRGDTQYF,5,0,1,5
TRBV5-1,TRBJ2-3,CASSTGTGSTDTQYF,5,0,1,5
TRBV5-1,TRBJ2-1,CASRALQGAYNEQFF,5,0,1,5
TRBV20-1,TRBJ2-1,CSAAPTSGRQVEQFF,5,0,1,5
TRBV20-1,TRBJ2-1,CSADRDAPLDNEQFF,5,0,1,5
TRBV20-1,TRBJ2-7,CSARLLAGGGYEQYF,5,4,2,9
TRBV20-1,TRBJ2-7,CSARSPLAGENEQYF,5,0,1,5
TRBV20-1,TRBJ1-6,CSARVGQGINSPLHF,5,0,1,5
TRBV20-1,TRBJ2-7,CSARDLLAGAYEQYF,5,0,1,5
TRBV20-1,TRBJ2-1,CSARDRGGYRDEQFF,5,0,1,5
TRBV20-1,TRBJ1-4,CSARDPNRAAEKLFF,5,0,1,5
TRBV20-1,TRBJ2-1,CSALETSGRSNEQFF,5,0,1,5
TRBV20-1,TRBJ2-4,CSAPDTRLAKNIQYF,5,0,1,5
TRBV20-1,TRBJ2-7,CSARLGVAGTYEQYF,5,0,1,5
TRBV20-1,TRBJ1-5,CSASIRDSSYQPQHF,5,0,1,5
TRBV29-1,TRBJ2-1,CSVGQSEPNNNEQFF,5,0,1,5
TRBV29-1,TRBJ2-5,CSVESANLRIETQYF,5,0,1,5
TRBV29-1,TRBJ2-1,CRRKFTRSSYNEQFF,5,0,1,5
TRBV12-3/4,TRBJ2-3,SASSQRTGGSDTQYF,5,0,1,5
TRBV29-1,TRBJ2-1,SSVEEGLAGVNEQFF,5,0,1,5
TRBV30,TRBJ2-1,CAWEWGVAYNEQFF,5,0,1,5
TRBV30,TRBJ1-1,CAWSVVAIGSEAFF,5,0,1,5
TRBV10-3,TRBJ2-1,CAIGMSILGHEQFF,5,0,1,5
TRBV7-8,TRBJ1-5,CAITVLPSNQPQHF,5,0,1,5
TRBV24-1,TRBJ1-1,CATSDFRQNTEAFF,5,0,1,5
TRBV24-1,TRBJ1-5,CATSDFGVDQPQHF,5,0,1,5
TRBV24-1,TRBJ2-7,CATSDSTDSSEQYF,8,12,2,20
TRBV15,TRBJ1-5,CATSRDLRNQPQRF,5,0,1,5
TRBV19,TRBJ1-5,CASSLQGRDQPQHF,5,0,1,5
TRBV19,TRBJ2-7,CASSGGQKGGEQYF,5,0,1,5
TRBV19,TRBJ1-2,CASSIGQGRYGYTF,5,0,1,5
TRBV19,TRBJ2-1,CASSIGAGLNEQFF,5,0,1,5
TRBV19,TRBJ1-1,CASSSGVGNTEAFF,5,0,1,5
TRBV19,TRBJ2-4,CASRGPMGKNIQYF,5,0,1,5
TRBV19,TRBJ2-3,CASRNRGLADTQYF,5,0,1,5
TRBV19,TRBJ2-2,CASNTNLRTGELFF,5,0,1,5
TRBV5-5,TRBJ2-3,CASNGLAGTDTQYF,5,0,1,5
TRBV18,TRBJ2-7,CASSRNSGSYEQYF,5,8,2,13
TRBV7-2,TRBJ2-2,CASSGLAVTGELFF,5,0,1,5
TRBV18,TRBJ2-1,CASSTSGRYNEQFF,5,0,1,5
TRBV7-9,TRBJ1-1,CASWDRVYGTEAFF,5,0,1,5
TRBV7-2,TRBJ2-5,CASIPTSGNRGGYF,5,0,1,5
TRBV7-2,TRBJ1-2,CASTPGPDNYGYTF,5,0,1,5
TRBV9,TRBJ1-3,CASTPTGLGNTIYF,5,0,1,5
TRBV6-2/3/5/6,TRBJ1-2,CASSFTGTGYGYTF,5,5,2,10
TRBV12-3/4,TRBJ1-4,CASSFFATNEKLFF,5,0,1,5
TRBV12-3/4,TRBJ1-2,CASSLATENYGYTF,5,0,1,5
TRBV28,TRBJ2-7,CASSLASGSYEQYF,5,0,1,5
TRBV6-2/3/5/6,TRBJ2-4,CASSLDLESDIQYF,5,0,1,5
TRBV12-3/4,TRBJ2-7,CASSLEQGAYEQYF,5,0,1,5
TRBV27,TRBJ1-4,CASSLRGYNEKLFF,5,0,1,5
TRBV28,TRBJ1-2,CASSSSDGAYGYTF,5,0,1,5
TRBV6-2/3/5/6,TRBJ1-1,CASSSASMNTEAFF,5,0,1,5
TRBV27,TRBJ2-1,CASSSGITYNEQFF,5,0,1,5
TRBV5-4,TRBJ2-1,CASSSISSYNEQFF,5,0,1,5
TRBV27,TRBJ2-7,CASSWAGGTYEQYF,5,0,1,5
TRBV6-2/3/5/6,TRBJ1-1,CASSYGQGDTEAFF,5,0,1,5
TRBV6-2/3/5/6,TRBJ1-5,CASSYGRSNQPQHF,5,0,1,5
TRBV6-2/3/5/6,TRBJ1-1,CASSLEVGSTEAFF,5,0,1,5
TRBV6-2/3/5/6,TRBJ1-1,CASSPDQLGTEAFF,5,0,1,5
TRBV2,TRBJ2-2,CASSVETPTGELFF,5,0,1,5
TRBV25-1,TRBJ2-5,CASSEWGVQETQYF,5,0,1,5
TRBV6-1,TRBJ2-7,CASSEWGAVNEQYF,5,0,1,5
TRBV6-1,TRBJ1-6,CASSEDIDNSPLHF,5,0,1,5
TRBV9,TRBJ1-2,CASSTGANNYGYTF,5,0,1,5
TRBV5-6,TRBJ2-1,CASSFSGRTGEQFF,5,0,1,5
TRBV5-4,TRBJ1-2,CASSFGQGGHGYTF,5,0,1,5
TRBV7-2,TRBJ2-5,CASSLQRQQETQYF,5,0,1,5
TRBV5-5,TRBJ2-7,CASSLVWQNYEQYF,5,0,1,5
TRBV5-6,TRBJ1-5,CASSLEGGNQPQHF,5,3,2,8
TRBV5-5,TRBJ1-5,CASSLEGSHQPQHF,5,0,1,5
TRBV7-8,TRBJ2-3,CASSLVGVGDTQYF,5,0,1,5
TRBV11-2,TRBJ2-1,CASSLAGGRDEQFF,5,0,1,5
TRBV7-2,TRBJ2-7,CASSLGGPAYEQYF,5,0,1,5
TRBV7-8,TRBJ1-5,CASSLTFSNQPQHF,5,0,1,5
TRBV7-9,TRBJ2-7,CASSSGTGSYEQYF,5,0,1,5
TRBV5-6,TRBJ2-1,CASSWGLAGNEQFF,5,0,1,5
TRBV7-2,TRBJ2-3,CASSWGLAEDTQYF,5,0,1,5
TRBV3-1,TRBJ1-3,CASSLLGVGDTIYF,5,0,1,5
TRBV13,TRBJ2-5,CASSPYWMGETQYF,5,0,1,5
TRBV7-3,TRBJ2-7,CASSPYLAPYEQYF,5,0,1,5
TRBV7-9,TRBJ2-7,CASSPLGISYEQYF,5,0,1,5
TRBV7-8,TRBJ2-2,CASSPRTSSGELFF,5,0,1,5
TRBV6-2/3/5/6,TRBJ2-1,CASSPSGRYNEQFF,5,0,1,5
TRBV5-6,TRBJ1-3,CASSRDIRGNTIYF,5,0,1,5
TRBV5-5,TRBJ1-5,CASSRTSGNQPQHF,5,0,1,5
TRBV12-3/4,TRBJ1-2,CASSHGLANYGYTF,5,0,1,5
TRBV5-5,TRBJ1-1,CASSQSYRGTEAFF,5,3,2,8
TRBV4-2,TRBJ1-5,CASSQLVGNQPQHF,5,0,1,5
TRBV3-1,TRBJ1-4,CASSQRQGFEKLFF,5,0,1,5
TRBV4-2,TRBJ1-1,CASSQGKVNTEAFF,5,0,1,5
TRBV7-9,TRBJ1-1,CASSVLGGHTEAFF,5,0,1,5
TRBV9,TRBJ2-7,CASSVDAGTYEQYF,5,0,1,5
TRBV5-4,TRBJ2-1,CASSALAQKGLEFF,5,0,1,5
TRBV5-4,TRBJ2-1,CASSGWGGPGEQFF,5,0,1,5
TRBV7-6,TRBJ1-1,CASSNGQAHTEAFF,5,0,1,5
TRBV3-1,TRBJ2-7,CASRLTGGGYEQYF,5,0,1,5
TRBV27,TRBJ1-5,CASRKQYGNQPQHF,5,0,1,5
TRBV12-3/4,TRBJ2-1,CASNLQGFHNEQFF,5,0,1,5
TRBV7-2,TRBJ2-1,CAVAGGPSYNEQFF,5,0,1,5
TRBV2,TRBJ1-2,CTSSGTGNLYGYTF,5,0,1,5
TRBV5-1,TRBJ1-6,CASHRDGENSPLHF,5,0,1,5
TRBV5-1,TRBJ1-2,CASSLATGGSGYTF,5,0,1,5
TRBV5-1,TRBJ1-6,CASSLGHVRSPLHF,5,0,1,5
TRBV5-1,TRBJ2-5,CASSLVGGVETQYF,5,0,1,5
TRBV5-1,TRBJ1-1,CASSSRGPNTEAFF,5,0,1,5
TRBV5-1,TRBJ1-2,CASSPGGQGIGYTF,5,0,1,5
TRBV4-1,TRBJ1-1,CASSQQTANTEAFF,5,8,2,13
TRBV4-1,TRBJ2-5,CASSQGSSQETQYF,5,0,1,5
TRBV4-1,TRBJ1-2,CASSQESKGYGYTF,5,0,1,5
TRBV4-3,TRBJ2-2,CASSQRVATGELFF,5,0,1,5
TRBV5-1,TRBJ1-4,CASRTGERDEKLFF,5,0,1,5
TRBV20-1,TRBJ2-7,CSAPGDRVKDEQYF,5,0,1,5
TRBV20-1,TRBJ2-7,CSAAGTSRSYEQYF,5,0,1,5
TRBV20-1,TRBJ2-5,CSARLQGRQEAQYF,5,0,1,5
TRBV20-1,TRBJ2-3,CSANRDSSTDTQYF,5,0,1,5
TRBV20-1,TRBJ2-7,CSAPRGGRSYEQYF,5,0,1,5
TRBV20-1,TRBJ1-1,CSAQREGPNTEAFF,5,0,1,5
TRBV20-1,TRBJ2-3,CSGNQARGTDTQYF,5,0,1,5
TRBV29-1,TRBJ1-1,CSVLGGGGGTEAFF,5,0,1,5
TRBV29-1,TRBJ2-3,CSVVIAGSTDTQYF,5,2,2,7
TRBV29-1,TRBJ2-1,CSVVRTSGNNEQFF,5,0,1,5
TRBV29-1,TRBJ1-2,CSVAGTGAGYGYTF,5,0,1,5
TRBV29-1,TRBJ2-7,CSVALPDFPHEQYF,5,0,1,5
TRBV29-1,TRBJ2-7,CSVAGTRQAYEQYF,5,0,1,5
TRBV29-1,TRBJ2-1,CSVAGDELGDEQFF,5,0,1,5
TRBV29-1,TRBJ1-3,CSVDSGTKANTIYF,5,0,1,5
TRBV29-1,TRBJ2-1,CSVESVAGGNEQFF,5,0,1,5
TRBV29-1,TRBJ2-1,CSALVAGRYNEQFF,5,0,1,5
TRBV29-1,TRBJ1-3,CSAETALGGNTIYF,5,0,1,5
TRBV30,TRBJ2-5,CAWDGQEGETQYF,5,0,1,5
TRBV30,TRBJ1-1,CAWSGGTGTEAFF,5,0,1,5
TRBV30,TRBJ1-5,CAWSLGAGQPQHF,5,0,1,5
TRBV30,TRBJ2-1,CAWSPGGYNEQFF,5,0,1,5
TRBV10-3,TRBJ1-2,CAISGTGGNGYTF,5,0,1,5
TRBV19,TRBJ2-7,CATRDRTTYEQYF,5,0,1,5
TRBV19,TRBJ1-2,CASSAGQHYGYAF,5,0,1,5
TRBV19,TRBJ2-7,CASSIWGSYEQYF,5,0,1,5
TRBV19,TRBJ2-1,CASSIVPGGEQFF,5,0,1,5
TRBV7-9,TRBJ2-7,CASRTSGTYEQYF,5,0,1,5
TRBV18,TRBJ2-7,CASSPDSSYEQYF,5,0,1,5
TRBV7-9,TRBJ1-1,CASSGGGITEAFF,5,0,1,5
TRBV18,TRBJ1-1,CASSLGQGAEAFF,5,0,1,5
TRBV18,TRBJ2-7,CASSPAGNYEQYF,5,2,2,7
TRBV18,TRBJ1-2,CASSPKQKHGYTF,5,0,1,5
TRBV18,TRBJ2-1,CASYSTTGNEQFF,5,0,1,5
TRBV6-2/3/5/6,TRBJ1-2,CASTWDREDGYTF,5,0,1,5
TRBV4-2,TRBJ2-3,CASTPSETGTQYF,5,4,2,9
TRBV7-2,TRBJ1-5,CASTMGQNQPQHF,5,0,1,5
TRBV12-3/4,TRBJ1-2,CASSFTVNYGYTF,5,12,2,17
TRBV27,TRBJ2-7,CASSFVATYEQYF,5,0,1,5
TRBV27,TRBJ2-7,CASSLSTRYEQYF,5,0,1,5
TRBV12-3/4,TRBJ2-5,CASSLAFVGTQYF,5,0,1,5
TRBV12-3/4,TRBJ2-5,CASSLALQETQYF,5,0,1,5
TRBV12-3/4,TRBJ2-5,CASSSPARETQYF,5,0,1,5
TRBV6-2/3/5/6,TRBJ2-5,CASSSGPQETQYF,5,0,1,5
TRBV6-2/3/5/6,TRBJ2-1,CASSWTSVNEQFF,5,5,2,10
TRBV6-2/3/5/6,TRBJ1-2,CASSYVRNYGYTF,5,0,1,5
TRBV27,TRBJ1-1,CASSPSGGTEAFF,5,0,1,5
TRBV6-2/3/5/6,TRBJ2-1,CASSPPVNNEQFF,5,0,1,5
TRBV6-1,TRBJ2-1,CASSAPVGNEQFF,5,0,1,5
TRBV14,TRBJ1-1,CASSATLNTEAFF,5,0,1,5
TRBV6-4,TRBJ1-1,CASSDYPDREAFF,5,0,1,5
TRBV11-2,TRBJ2-7,CASSFPTSYEQYF,5,0,1,5
TRBV7-6,TRBJ1-2,CASSLDPEGGYTF,5,0,1,5
TRBV7-6,TRBJ2-1,CASSLVLANEQFF,5,0,1,5
TRBV7-9,TRBJ1-2,CASSLVGVGGYTF,5,0,1,5
TRBV7-9,TRBJ1-1,CASSLARSTEAFF,5,0,1,5
TRBV7-8,TRBJ2-7,CASSLAEDYEQYF,5,0,1,5
TRBV7-2,TRBJ2-1,CASSSPLLPEQFF,5,0,1,5
TRBV7-9,TRBJ2-1,CASSSGGGSEQFF,5,0,1,5
TRBV5-5,TRBJ2-5,CASSWGGTETQYF,5,10,2,15
TRBV7-2,TRBJ2-1,CASSLRQHNEQFF,5,0,1,5
TRBV6-4,TRBJ2-3,CASSPPSADTQYF,5,0,1,5
TRBV9,TRBJ1-1,CASSPNQAIEAFF,5,0,1,5
TRBV11-1,TRBJ2-5,CASSQPGWETQYF,5,0,1,5
TRBV3-1,TRBJ1-2,CASSQGNYYGYTF,5,0,1,5
TRBV4-2,TRBJ1-1,CASSQERNTEAFF,5,0,1,5
TRBV7-9,TRBJ1-1,CASSVRTDLLAFF,5,0,1,5
TRBV9,TRBJ1-2,CASSAGSRVRYTF,5,0,1,5
TRBV7-3,TRBJ2-3,CASSGGLTDTQYF,5,0,1,5
TRBV5-8,TRBJ1-4,CASRRRFNEKLFF,5,0,1,5
TRBV6-4,TRBJ1-1,CASRISGGTEAFF,5,0,1,5
TRBV6-4,TRBJ2-7,CASRTTGEREQYF,5,0,1,5
TRBV5-4,TRBJ2-2,CASRGTNTGELFF,5,0,1,5
TRBV2,TRBJ2-1,CASKASGQDEQFF,5,0,1,5
TRBV6-2/3/5/6,TRBJ2-5,CASKASGMETQYF,5,0,1,5
TRBV5-1,TRBJ2-1,CASSLGNPTEQFF,5,0,1,5
TRBV4-3,TRBJ1-1,CASSRDRGREAFF,5,0,1,5
TRBV4-3,TRBJ2-2,CASSQHGTGELFF,5,0,1,5
TRBV4-3,TRBJ2-7,CASSQAVGYEQYF,5,0,1,5
TRBV4-3,TRBJ2-7,CASSQDLSGEQYF,5,0,1,5
TRBV4-1,TRBJ2-1,CASSQNKNNEQFF,5,0,1,5
TRBV4-1,TRBJ1-2,CASSKGLTGGYTF,5,0,1,5
TRBV5-1,TRBJ1-2,CASRPDRGGGYTF,5,0,1,5
TRBV4-1,TRBJ1-6,CASRDRGNSPLHF,5,0,1,5
TRBV20-1,TRBJ2-7,CSVAPDISYEQYF,5,0,1,5
TRBV20-1,TRBJ1-2,CSAWGEVNYGYTF,5,0,1,5
TRBV20-1,TRBJ1-5,CSAPAQRNQPQHF,5,0,1,5
TRBV20-1,TRBJ2-3,CSAPDWGPDTQYF,5,0,1,5
TRBV20-1,TRBJ1-3,CSARAAGGNTIYF,5,0,1,5
TRBV20-1,TRBJ2-1,CSARDYPYNEQFF,5,0,1,5
TRBV20-1,TRBJ2-1,CSAPGLAGNEQFF,5,0,1,5
TRBV29-1,TRBJ2-1,CSVVRLAGADQFF,5,0,1,5
TRBV29-1,TRBJ2-1,CSVEIKREYEQFF,5,0,1,5
TRBV29-1,TRBJ2-3,CSVVGTLSDTQYF,5,0,1,5
TRBV20-1,TRBJ2-7,CSATGTGEYEQYF,5,0,1,5
TRBV29-1,TRBJ2-1,CSISRGSANEQFF,5,0,1,5
TRBV2,TRBJ2-5,CAGSGGWETQYF,5,0,1,5
TRBV7-2,TRBJ2-7,CATGTNSYEQYF,5,0,1,5
TRBV12-3/4,TRBJ1-5,CASTGGNQPQHF,5,0,1,5
TRBV27,TRBJ2-7,CASSFGATEQYF,5,2,2,7
TRBV6-2/3/5/6,TRBJ1-1,CASSPLNTEAFF,5,0,1,5
TRBV6-1,TRBJ2-7,CASSAGSYEQYF,5,0,1,5
TRBV6-4,TRBJ2-5,CASSAESQTQYF,5,0,1,5
TRBV12-3/4,TRBJ1-1,CASSTGFTEAFF,5,0,1,5
TRBV4-1,TRBJ2-5,CASSRDQETQYF,8,0,1,8
TRBV6-2/3/5/6,TRBJ2-4,CASSRPKNIQYF,5,0,1,5
TRBV7-2,TRBJ2-1,CASSFPSGEQFF,9,0,1,9
TRBV7-9,TRBJ2-2,CASSLDTGELFF,5,0,1,5
TRBV7-9,TRBJ2-1,CASSLRGLREFF,5,0,1,5
TRBV7-6,TRBJ2-1,CASSLRGSEQFF,5,0,1,5
TRBV7-9,TRBJ2-1,CASSLESHEQFF,5,5,2,10
TRBV7-2,TRBJ2-1,CASSLGGPEQFF,5,17,2,22
TRBV3-1,TRBJ2-5,CASSQLQETQYF,5,0,1,5
TRBV7-9,TRBJ2-7,CASSGRSYEQYF,5,0,1,5
TRBV7-8,TRBJ1-1,CASSRGNTEAFF,5,8,2,13
TRBV6-2/3/5/6,TRBJ2-7,CASSRQGYEQYF,5,0,1,5
TRBV10-3,TRBJ2-7,CASKREGREQYF,5,0,1,5
TRBV4-1,TRBJ2-3,CASSQVWDTQYF,5,0,1,5
TRBV29-1,TRBJ1-2,CSVGRVGEGYTF,5,0,1,5
TRBV29-1,TRBJ2-7,CSVELQAYEQYF,5,0,1,5
TRBV29-1,TRBJ1-2,CSVEPNTPTITF,5,0,1,5
TRBV29-1,TRBJ1-3,CSVEMDRNTIYF,5,0,1,5
TRBV29-1,TRBJ1-2,CSVRDGAYGYTF,5,0,1,5
TRBV29-1,TRBJ2-2,CSVHRGTGELFF,5,0,1,5
TRBV29-1,TRBJ1-1,CSALLGNTEAFF,5,0,1,5
TRBV29-1,TRBJ1-4,CSAGATNEKLFF,5,0,1,5
TRBV29-1,TRBJ2-3,CSAERGKDTQYF,5,0,1,5
TRBV29-1,TRBJ2-1,ARERVSYNEQFF,5,0,1,5
TRBV30,TRBJ1-1,CAWFSGAEAFF,5,0,1,5
TRBV19,TRBJ1-1,CASSTGTEAFF,5,0,1,5
TRBV18,TRBJ2-7,CASSPGDEQYF,10,19,2,29
TRBV12-3/4,TRBJ2-1,CASSSGDEQFF,5,5,2,10
TRBV7-2,TRBJ2-7,CASSQSYEQYF,5,0,1,5
TRBV6-2/3/5/6,TRBJ1-1,CASSSEDEAFF,5,0,1,5
TRBV3-1,TRBJ1-2,CASSQSHGYTF,5,0,1,5
TRBV7-2,TRBJ2-3,CASSATDTQYF,7,0,1,7
TRBV12-3/4,TRBJ2-2,CASRLTGELFF,5,0,1,5
TRBV6-2/3/5/6,TRBJ1-2,CASRNIYGYTF,5,0,1,5
TRBV2,TRBJ2-7,CAGGDSYEQYF,5,0,1,5
TRBV4-1,TRBJ2-1,CASSRGSGQFF,5,0,1,5
TRBV20-1,TRBJ1-1,CSAREISEAFF,5,0,1,5
TRBV29-1,TRBJ2-5,CSVDRVETQYF,5,0,1,5
TRBV29-1,TRBJ1-2,CSARGDYGYTF,5,0,1,5
TRBV29-1,TRBJ1-4,CSGWANEKLFF,5,0,1,5
TRBV20-1,TRBJ2-3,CSARDGAQYF,5,0,1,5
TRBV7-9,TRBJ1-5,CASRPLPGPGNQPQHF,5,0,1,5
TRBV20-1,TRBJ1-6,CSARPLDRGNSPLHF,5,0,1,5
TRBV7-2,TRBJ1-1,CACSLTGRNTEAFF,5,0,1,5
TRBV30,TRBJ1-1,CAWSVSSKNTEAFF,5,0,1,5
TRBV19,TRBJ2-2,CASSLRTFTGELFF,5,3,2,8
TRBV4-2,TRBJ2-2,CASSQHQGGLAGGNTGELFF,5,0,1,5
TRBV9,TRBJ2-1,CASSTTRVQSSYNEQFF,5,0,1,5
TRBV4-3,TRBJ2-5,CASSQVLWGGGETQYF,5,0,1,5
TRBV2,TRBJ1-4,CASITQGNAFGKLFF,5,0,1,5
TRBV4-2,TRBJ1-5,CASSQEVGGNQPQHF,5,0,1,5
TRBV12-3/4,TRBJ2-7,CASSLVGSIGEQYF,5,0,1,5
TRBV18,TRBJ2-3,CASSKAGLDTQYF,5,0,1,5
TRBV5-4,TRBJ2-1,CASSLSGGASAEVF,4,0,1,4
TRBV11-2,TRBJ2-7,CASSLGLDGESYEQYF,4,0,1,4
TRBV3-1,TRBJ1-1,CASSDLGGFEAFF,4,0,1,4
TRBV2,TRBJ2-4,CATAPGLSWRAKNIQYF,4,0,1,4
TRBV5-6,TRBJ2-5,CASSLIGAGKQETQYF,4,0,1,4
TRBV7-9,TRBJ2-1,CASSSQAGGHSNEQFF,4,0,1,4
TRBV29-1,TRBJ2-6,CSVEEGRTQKLTPHMVGANVLTF,4,0,1,4
TRBV29-1,TRBJ2-5,CSVEDWGAGHTTGTTQETQYF,4,0,1,4
TRBV6-2/3/5/6,TRBJ1-4,CASSLSGTGQGPATNEKLFF,4,0,1,4
TRBV5-6,TRBJ2-1,CASSLESSGRAMASYNEQFF,4,0,1,4
TRBV19,TRBJ2-2,CASTPGLAGGRPNTGELFF,4,0,1,4
TRBV12-3/4,TRBJ2-3,CASTPVGASGGIFTDTQYF,4,0,1,4
TRBV27,TRBJ1-2,CASTPRRGPGEDRVRGYTF,4,0,1,4
TRBV6-2/3/5/6,TRBJ2-1,CASSFGSARAGSPQSEQFF,4,0,1,4
TRBV12-3/4,TRBJ1-5,CASSLGGELLSAGNQPQHF,4,0,1,4
TRBV6-2/3/5/6,TRBJ2-3,CASSYTNYRLAGVTDTQYF,4,0,1,4
TRBV7-2,TRBJ1-5,CASSLWGGGGPLLNQPQHF,4,0,1,4
TRBV4-2,TRBJ2-3,CASSQQTTSGGDSTDTQYF,4,0,1,4
TRBV3-1,TRBJ2-2,CASSQVGLAGLLNTGELFF,4,0,1,4
TRBV4-1,TRBJ2-7,CASSQGYGTGGTASYEQYF,4,0,1,4
TRBV29-1,TRBJ2-1,CSAGDLGTSGTRSYNEQFF,4,0,1,4
TRBV3-1,TRBJ2-1,RASSQDLSTSGGALNEQFF,4,0,1,4
TRBV12-5,TRBJ1-5,CASAVSGGYPRWDQPQHF,4,0,1,4
TRBV12-5,TRBJ2-1,CASGLKGLAGVGYNEQFF,4,0,1,4
TRBV19,TRBJ2-3,CASSPRIAGGIGTDTQYF,4,0,1,4
TRBV19,TRBJ2-1,CASSRNPTGASYYNEQFF,4,0,1,4
TRBV28,TRBJ2-4,CASSLFPGADLAKNIQYF,4,0,1,4
TRBV6-2/3/5/6,TRBJ1-1,CASSYSLNWGVRRTEAFF,4,0,1,4
TRBV6-2/3/5/6,TRBJ2-7,CASSYSTEWTEIDYEQYF,4,0,1,4
TRBV6-2/3/5/6,TRBJ2-1,CASSYTRGLAGRTDEQFF,4,0,1,4
TRBV6-2/3/5/6,TRBJ1-1,CASSLGTGVTVLNTEAFF,4,0,1,4
TRBV6-1,TRBJ2-5,CASSAGTSGSDPSETQYF,4,0,1,4
TRBV6-1,TRBJ2-1,CASSEWEELTSSYNEQFF,4,0,1,4
TRBV6-1,TRBJ1-5,CASSEAAGRTYSNQPQHF,4,0,1,4
TRBV7-2,TRBJ2-3,CASSLRTSGGAGADTQYF,4,0,1,4
TRBV7-8,TRBJ2-1,CASSLGVGGATLYNEQFF,4,0,1,4
TRBV6-2/3/5/6,TRBJ2-7,CASSSTPKTSGRYYEQYF,4,0,1,4
TRBV5-4,TRBJ2-1,CASSYPQSGLAGYNEQFF,4,0,1,4
TRBV5-8,TRBJ2-3,CASSPPGGSRGKTDTQYF,4,0,1,4
TRBV5-4,TRBJ1-4,CASSPGQGAELGNEKLFF,4,0,1,4
TRBV3-1,TRBJ2-7,CASSQSELAGGPAYEQYF,4,0,1,4
TRBV4-2,TRBJ2-6,CASSQLRTAGAGANVLTF,4,0,1,4
TRBV3-1,TRBJ2-6,CASSQAAGGFSGANVLTF,4,0,1,4
TRBV6-2/3/5/6,TRBJ2-2,CASSTTSGRAEGTGELFF,4,0,1,4
TRBV6-2/3/5/6,TRBJ2-3,CASRRPVAGTGDTGTQYF,4,0,1,4
TRBV4-1,TRBJ1-4,CASTKKGTLGITNEKLFF,4,0,1,4
TRBV10-2,TRBJ2-3,CASSEPPLAGGGSDTQYF,4,0,1,4
TRBV5-1,TRBJ2-1,CASSLVSPTGSSYNEQFF,4,0,1,4
TRBV5-1,TRBJ1-1,CASSLSAGTGRATTEAFL,4,0,1,4
TRBV24-1,TRBJ1-4,CATSDDLPGLEIEKLFF,4,0,1,4
TRBV19,TRBJ1-2,CASSMRLPREGVYGYTF,4,0,1,4
TRBV6-2/3/5/6,TRBJ2-1,CASSFHPTSTKRGEQFF,4,0,1,4
TRBV6-2/3/5/6,TRBJ2-5,CASSYSIGRVNQETQYF,4,0,1,4
TRBV6-2/3/5/6,TRBJ2-3,CASSYKGLAGGADTQYF,4,0,1,4
TRBV6-2/3/5/6,TRBJ1-5,CASSHGQGQGKGQPQHF,4,0,1,4
TRBV6-1,TRBJ2-7,CASSELFGLAGTYEQYF,4,0,1,4
TRBV6-2/3/5/6,TRBJ2-1,CASSTQRQGRSSNEQFF,4,0,1,4
TRBV7-6,TRBJ2-7,CASSLGTGSFGSYEQYF,4,0,1,4
TRBV7-8,TRBJ1-6,CASSLVGGGEYNSPLHF,4,4,2,8
TRBV7-2,TRBJ1-5,CASSLARGTGRDQPQHF,4,0,1,4
TRBV5-5,TRBJ2-5,CASSSGITVKVQETQYF,4,5,2,9
TRBV5-4,TRBJ2-1,CASSPGQGLAEINEQFF,4,0,1,4
TRBV3-1,TRBJ2-2,CASSPGLAGMNTGELFF,4,0,1,4
TRBV3-1,TRBJ2-5,CASSQVSLVWKQETQYF,4,0,1,4
TRBV3-1,TRBJ2-6,CASSQVPGTGGANVLTF,4,0,1,4
TRBV3-1,TRBJ2-5,CASSQALRLAGLETQYF,4,0,1,4
TRBV3-1,TRBJ2-7,CASSQGRLASGGPEQYF,4,0,1,4
TRBV3-1,TRBJ2-4,CASSQDSGMQSKNIQYF,4,0,1,4
TRBV3-1,TRBJ1-5,CASSQDVAGSSNQPQHF,4,0,1,4
TRBV4-2,TRBJ2-6,CASSQDAGHTGANVLTF,4,0,1,4
TRBV14,TRBJ2-1,CASSQDILAGGSNEQFF,4,0,1,4
TRBV4-2,TRBJ2-3,CASSQEGYTSLTDTQYF,4,0,1,4
TRBV14,TRBJ2-2,CASSQRTGTGGTGELFF,4,18,2,22
TRBV9,TRBJ2-1,CASSVGTQAGPYNEQFF,4,0,1,4
TRBV5-5,TRBJ1-6,CASSTVDRSSYNSPLHF,4,0,1,4
TRBV6-2/3/5/6,TRBJ1-5,CASSKRHGPGGNQPQHF,4,0,1,4
TRBV6-2/3/5/6,TRBJ1-2,CASRGLAGSPANYGYTF,4,0,1,4
TRBV5-6,TRBJ2-4,CASRINLAGRAKNIQYF,4,0,1,4
TRBV6-2/3/5/6,TRBJ1-2,CASKTRIRDRGDYGYTF,4,0,1,4
TRBV7-9,TRBJ2-1,CTSSSHRGLAGVNEQFF,4,0,1,4
TRBV5-1,TRBJ1-1,CASSLELVTGLGTEAFF,4,0,1,4
TRBV5-1,TRBJ1-2,CASSLEPQGDARYGYTF,4,0,1,4
TRBV5-1,TRBJ1-1,CASSLREQPIMNTEAFF,4,0,1,4
TRBV5-1,TRBJ2-1,CASSSPSQQLSYNEQFF,4,0,1,4
TRBV5-1,TRBJ2-3,CASSLRLAGAATDTQYF,4,0,1,4
TRBV4-1,TRBJ1-2,CASSHQPRIQGSKGYTF,4,0,1,4
TRBV4-1,TRBJ2-3,CASSQTTSGGAPDTQYF,4,0,1,4
TRBV4-3,TRBJ2-1,CASSQDLSSGRTHEQFY,4,0,1,4
TRBV4-3,TRBJ1-3,CASSQDPPGSSGNTIYF,4,0,1,4
TRBV4-3,TRBJ2-1,CASSQDITSGRKNEQFF,4,0,1,4
TRBV5-1,TRBJ2-5,CASNPAGGPGFQETQYF,4,6,2,10
TRBV20-1,TRBJ2-3,CSVTSGRTYRPRDTQYF,4,0,1,4
TRBV20-1,TRBJ1-3,CSARGMGQPSSGNTIYF,4,0,1,4
TRBV20-1,TRBJ2-1,CSARDLGAGGLRGEQFF,4,0,1,4
TRBV29-1,TRBJ2-3,CSVEDPTGTEFTDTQYF,4,0,1,4
TRBV29-1,TRBJ2-5,CSVLGLAGEPSQETQYF,4,0,1,4
TRBV7-3,TRBJ2-1,RASSFQGDLYYYNEQFF,4,0,1,4
TRBV12-5,TRBJ2-4,CASGLVLAGSKNIQYF,4,0,1,4
TRBV19,TRBJ2-1,CASQEEGLAGGDEQFF,4,0,1,4
TRBV30,TRBJ2-7,CAWSGLGSGRTYEQYF,4,0,1,4
TRBV30,TRBJ1-5,CAWSTRGRGSGQPQHF,4,0,1,4
TRBV10-3,TRBJ2-7,CAISESGRRGSYEQYF,4,0,1,4
TRBV15,TRBJ2-5,CATSRDFRDSRETQYF,4,0,1,4
TRBV19,TRBJ2-2,CASSFVWGSETGELFF,4,0,1,4
TRBV19,TRBJ1-1,CASSAGTVKVNTEAFF,4,0,1,4
TRBV19,TRBJ2-3,CASSIGLAGPLDTQYF,4,0,1,4
TRBV19,TRBJ2-1,CASSIVAGGGDNEQFF,4,0,1,4
TRBV19,TRBJ2-1,CASSTPGGGRGNEQFF,4,0,1,4
TRBV18,TRBJ1-1,CASSPVTGGPHTEAFF,4,0,1,4
TRBV6-2/3/5/6,TRBJ2-1,CASPGLAVNSYNEQFF,4,0,1,4
TRBV6-2/3/5/6,TRBJ2-1,CASTNRGYPNTNEQFF,4,0,1,4
TRBV12-3/4,TRBJ1-2,CASTNLGPTGNYGYTF,4,0,1,4
TRBV12-3/4,TRBJ2-3,CASSFLLAGGGDTQYF,4,12,2,16
TRBV12-3/4,TRBJ2-7,CASSLPVGQGHYEQYF,4,0,1,4
TRBV12-3/4,TRBJ2-5,CASSLWASSTQETQYF,4,0,1,4
TRBV28,TRBJ1-2,CASSLPGTGGFYGYTF,4,0,1,4
TRBV6-2/3/5/6,TRBJ1-1,CASSYSWTGGKNEAFF,4,0,1,4
TRBV6-2/3/5/6,TRBJ2-5,CASSYSPSGYQETQYF,4,0,1,4
TRBV6-2/3/5/6,TRBJ2-7,CASSYSASPLPYEQYF,4,0,1,4
TRBV6-2/3/5/6,TRBJ1-1,CASSYLLTGRGTEAFF,4,0,1,4
TRBV2,TRBJ1-5,CASSEEFPRGYQPQHF,4,3,2,7
TRBV6-1,TRBJ2-2,CASSKMQGANTGELFF,4,0,1,4
TRBV13,TRBJ2-4,CASSFAKQGAKNIQYF,4,0,1,4
TRBV5-4,TRBJ2-2,CASSFGAGANTGELFF,4,0,1,4
TRBV5-6,TRBJ2-1,CASSLAGGAAYNEQFF,4,0,1,4
TRBV7-3,TRBJ2-5,CASSLGLAGAQETQYF,4,0,1,4
TRBV7-9,TRBJ2-5,CASSLGTGGLFETQYF,4,0,1,4
TRBV5-5,TRBJ2-2,CASSLRQGMNTGELFF,4,0,1,4
TRBV7-9,TRBJ1-5,CASSLATGYSNQPQHF,4,0,1,4
TRBV7-8,TRBJ2-3,CASSLAIMAITDTQYF,4,0,1,4
TRBV7-9,TRBJ2-3,CASSLGTGLYADTQYF,4,0,1,4
TRBV9,TRBJ2-7,CASSLGLAGGTYEQYF,4,0,1,4
TRBV11-2,TRBJ2-2,CASSLDPGGDTGELFF,4,0,1,4
TRBV7-2,TRBJ2-1,CASSLEWDRAYNEQFF,4,0,1,4
TRBV7-6,TRBJ2-7,CASSLETGFNSYEQYF,4,0,1,4
TRBV7-9,TRBJ2-1,CASSSTGTSVSGEQFF,4,0,1,4
TRBV5-6,TRBJ2-1,CASSSPSGRTYNEQFF,4,6,2,10
TRBV5-6,TRBJ2-3,CASSSGTGASTDTQYF,4,0,1,4
TRBV11-3,TRBJ2-5,CASSSGRTTNQETQYF,4,0,1,4
TRBV7-6,TRBJ2-7,CASSSDGGVGSYEQYF,4,0,1,4
TRBV9,TRBJ2-1,CASSSFAGSSYNEQFF,4,0,1,4
TRBV7-2,TRBJ1-1,CASSSFRGPGDTEAFF,4,0,1,4
TRBV7-9,TRBJ1-6,CASSSPGSSYNSPLHF,4,0,1,4
TRBV6-2/3/5/6,TRBJ2-7,CASSSRGGLAAYEQYF,4,0,1,4
TRBV11-2,TRBJ2-7,CASSSLSGTRPYEQYF,4,0,1,4
TRBV5-5,TRBJ2-3,CASSWGDSHQGVTQYF,4,0,1,4
TRBV7-2,TRBJ2-3,CASSYLPSGRTDTQYF,4,0,1,4
TRBV5-6,TRBJ2-1,CASSLSASGDYNEQFF,4,0,1,4
TRBV4-2,TRBJ2-7,CASSLSLAGDTYEQYF,4,0,1,4
TRBV7-2,TRBJ2-3,CASSLPVAGDSDTQYF,4,0,1,4
TRBV5-1,TRBJ2-3,CASSPGLAGGSDTQYF,4,3,2,7
TRBV9,TRBJ1-3,CASSPHRGNRGNTIYF,4,0,1,4
TRBV3-1,TRBJ1-2,CASSPGQGEYLWSYTF,4,0,1,4
TRBV3-1,TRBJ2-5,CASSPEGGRAGETQYF,4,0,1,4
TRBV7-9,TRBJ2-3,CASSPTSGRSTDTQYF,4,0,1,4
TRBV6-2/3/5/6,TRBJ1-6,CASSPRQGGDNSPLHF,4,0,1,4
TRBV5-6,TRBJ2-1,CASSPRRGGLYNEQFF,4,0,1,4
TRBV5-6,TRBJ2-7,CASSRRSGTSFYEQYF,4,0,1,4
TRBV4-2,TRBJ1-2,CASSQVSGQGTYGYTF,4,0,1,4
TRBV3-1,TRBJ2-7,CASSQGVIPIAYEQYF,4,0,1,4
TRBV4-2,TRBJ2-4,CASSQDVAGGQDIQYF,4,0,1,4
TRBV4-2,TRBJ2-1,CASSQDRSSGYNEQFF,4,0,1,4
TRBV4-2,TRBJ1-4,CASSQDRGRGNEKLFF,4,0,1,4
TRBV7-9,TRBJ2-5,CASSVSGQGAGETQYF,4,0,1,4
TRBV9,TRBJ2-5,CASSVGGAGGQETQYF,4,0,1,4
TRBV7-2,TRBJ2-7,CASSARVGDVRHEQYF,4,0,1,4
TRBV7-6,TRBJ2-7,CASSASSGRPFYEQYF,4,0,1,4
TRBV9,TRBJ1-2,CASSISQGTRGAGYTF,4,2,2,6
TRBV7-2,TRBJ2-1,CASSKRTSAIYNEQFF,4,0,1,4
TRBV7-2,TRBJ2-7,CASSKEGVGLRDEQYF,4,0,1,4
TRBV12-3/4,TRBJ2-1,CASRRGGVSAYNEQFF,4,0,1,4
TRBV4-1,TRBJ1-5,CASSLGLGRSNQPQHF,4,0,1,4
TRBV10-2,TRBJ2-1,CASSESGQASYNEQFF,4,0,1,4
TRBV10-2,TRBJ2-3,CASSESRTSGIDTQYF,4,0,1,4
TRBV5-1,TRBJ2-1,CASSFIARGGYNEQFF,4,0,1,4
TRBV5-1,TRBJ1-6,CASSFGPNQGNSPLHF,4,0,1,4
TRBV5-1,TRBJ2-1,CASSLVPDLAWNEQFF,4,0,1,4
TRBV5-1,TRBJ2-3,CASSLESTGATDTQYF,4,0,1,4
TRBV5-1,TRBJ2-2,CASSWDPGRDTGELFF,4,0,1,4
TRBV4-1,TRBJ1-4,CASSLGQGAVMAKLFF,4,0,1,4
TRBV4-1,TRBJ2-5,CASSLGLAGRRETQYF,4,0,1,4
TRBV4-3,TRBJ2-7,CASSPTPGQGTFEQYF,4,0,1,4
TRBV4-1,TRBJ2-1,CASSHIAGITTNEQFF,4,0,1,4
TRBV4-1,TRBJ2-3,CASSQQQGSVTDTQYF,4,0,1,4
TRBV4-1,TRBJ2-7,CASSQGSGTGAYEQYF,4,0,1,4
TRBV4-1,TRBJ1-1,CASSQDPQTGGTEAFF,4,0,1,4
TRBV4-1,TRBJ2-1,CASSQDRGTSGNEQFF,4,6,2,10
TRBV4-1,TRBJ2-1,CASSQEMPPSYNEQFF,4,0,1,4
TRBV5-1,TRBJ1-6,CASSVSGQGGNSPLHF,4,0,1,4
TRBV20-1,TRBJ1-6,CSAPIIGSSYNSPLHF,4,0,1,4
TRBV20-1,TRBJ2-1,CSARYMGTSGYNEQFF,4,0,1,4
TRBV20-1,TRBJ2-5,CSARLPTSGSGETQYF,4,0,1,4
TRBV20-1,TRBJ2-6,CSARLGQISGANVLTF,4,0,1,4
TRBV20-1,TRBJ2-3,CSARPSTSGLTDTQYF,4,0,1,4
TRBV20-1,TRBJ2-4,CSARDRGSRAKNIQYF,4,0,1,4
TRBV20-1,TRBJ2-1,CSAINPGQGTYNEQFF,4,0,1,4
TRBV20-1,TRBJ2-5,CSARNPSGGRKETQYF,4,0,1,4
TRBV29-1,TRBJ2-3,CSVEGSTGTNPDTQYF,4,0,1,4
TRBV29-1,TRBJ1-2,CSVETRTGKANHGYTF,4,0,1,4
TRBV29-1,TRBJ2-3,CSAISGGGQGSDTQYF,4,0,1,4
TRBV29-1,TRBJ2-2,CSGGAGGPWNTGELFF,4,0,1,4
TRBV29-1,TRBJ1-2,CSDETRTGKANYGYTF,4,0,1,4
TRBV12-3/4,TRBJ1-5,CAGSGKDRERQPQHF,4,0,1,4
TRBV7-9,TRBJ2-5,CAIHSPRVGQVTQYF,4,0,1,4
TRBV10-3,TRBJ2-1,CAISRLAEAYNEQFF,4,0,1,4
TRBV10-3,TRBJ2-1,CAIRRPGLSYNEQFF,4,0,1,4
TRBV11-3,TRBJ2-2,CATLREDSNTGELFF,4,0,1,4
TRBV15,TRBJ2-3,CATGHGLAGTDTQYF,4,0,1,4
TRBV24-1,TRBJ2-3,CATSDEMDSTDTQYF,4,0,1,4
TRBV24-1,TRBJ2-1,CATSESGSPSGEQFF,4,0,1,4
TRBV15,TRBJ1-6,CATSRDYSGNSPLHF,4,0,1,4
TRBV15,TRBJ2-5,CATSRETGGPETQYF,4,0,1,4
TRBV19,TRBJ1-6,CASSFRRNERFALHF,4,0,1,4
TRBV19,TRBJ1-5,CASSSTTRSNQPQHF,4,0,1,4
TRBV19,TRBJ1-6,CASSPGGAYNSPLHF,4,0,1,4
TRBV19,TRBJ1-5,CASSMWDSYNQPQHF,4,0,1,4
TRBV19,TRBJ1-3,CASSMVWKGRNTIYF,4,0,1,4
TRBV19,TRBJ1-4,CASSIVGGTNEKLFF,4,0,1,4
TRBV19,TRBJ2-2,CASRPPRVDTGELFF,4,0,1,4
TRBV18,TRBJ2-1,CASSPTGNVYNEQFF,4,0,1,4
TRBV19,TRBJ1-2,CASRDSISAGYGYSF,4,0,1,4
TRBV7-9,TRBJ2-3,CASAKRGPSTDTQYF,4,0,1,4
TRBV12-3/4,TRBJ2-3,CASMPAGRRTDTQYF,4,0,1,4
TRBV9,TRBJ2-3,CASTLGEGWTDTQYF,4,0,1,4
TRBV5-6,TRBJ1-2,CASTPGQGLLYGYTF,4,0,1,4
TRBV7-9,TRBJ2-3,CASTRRGEDTDTQYF,4,0,1,4
TRBV12-3/4,TRBJ1-5,CASSFGGIGSQPQHF,4,0,1,4
TRBV12-3/4,TRBJ2-7,CASSFGGRPSYEQYF,4,0,1,4
TRBV6-2/3/5/6,TRBJ2-5,CASSFLLAGEETQYF,4,0,1,4
TRBV27,TRBJ2-1,CASSLLRGLQDEQFF,4,0,1,4
TRBV25-1,TRBJ2-1,CASSLGRGRVNEQFF,4,0,1,4
TRBV6-2/3/5/6,TRBJ2-3,CASSLNGRAADTQYF,4,0,1,4
TRBV28,TRBJ2-7,CASSLLAAAFYEQYF,4,9,2,13
TRBV28,TRBJ2-5,CASSLRTGGTETQYF,4,0,1,4
TRBV12-3/4,TRBJ1-2,CASSLAPDSNYGYTF,4,0,1,4
TRBV6-2/3/5/6,TRBJ1-2,CASSLDREGGYGYTF,4,0,1,4
TRBV6-2/3/5/6,TRBJ2-4,CASSLEAGGIGIQYF,4,0,1,4
TRBV28,TRBJ2-7,CASSSPGTGAYEQYF,4,0,1,4
TRBV12-3/4,TRBJ2-1,CASSSRQGHYNEQFF,4,0,1,4
TRBV7-6,TRBJ2-5,CASSYYGPDQETQYF,4,2,2,6
TRBV6-2/3/5/6,TRBJ2-5,CASSYLPGPPETQYF,4,3,2,7
TRBV6-2/3/5/6,TRBJ2-7,CASSYSMAGSYEQYF,4,0,1,4
TRBV6-2/3/5/6,TRBJ1-1,CASSYSMGLNTEAFF,4,0,1,4
TRBV6-2/3/5/6,TRBJ1-2,CASSYLRGTNYGYTF,4,0,1,4
TRBV6-2/3/5/6,TRBJ2-3,CASSYASGRTDTQYF,4,0,1,4
TRBV6-2/3/5/6,TRBJ1-5,CASSYGTGANQPQHF,4,0,1,4
TRBV9,TRBJ2-7,CASSPEGAGEDEQYF,4,0,1,4
TRBV7-2,TRBJ2-1,CASSRRDGSYNEQFF,4,0,1,4
TRBV6-2/3/5/6,TRBJ2-7,CASSHRDSYRREQYF,4,0,1,4
TRBV2,TRBJ1-6,CASSVWTVSRSPLHF,4,0,1,4
TRBV7-2,TRBJ2-5,CASSVRAVGGETQYF,4,0,1,4
TRBV6-1,TRBJ2-1,CASSATGQPYNEQFF,4,0,1,4
TRBV2,TRBJ2-1,CASSGAQNAYNEQFF,4,0,1,4
TRBV6-1,TRBJ2-7,CASSEWNTFSYEQYF,4,0,1,4
TRBV2,TRBJ1-3,CASSEAPLPGNTIYF,4,0,1,4
TRBV6-1,TRBJ1-5,CASSESRVPNQPQHF,4,0,1,4
TRBV6-2/3/5/6,TRBJ1-1,CASSMAEKMNTEAFF,4,0,1,4
TRBV7-9,TRBJ1-3,CASSNPAVSGNTIYF,4,0,1,4
TRBV7-2,TRBJ2-2,CASSFWTGGTGELFF,4,0,1,4
TRBV7-9,TRBJ2-2,CASSFRQGNTGELFF,4,0,1,4
TRBV7-6,TRBJ2-3,CASSFKAVRTDTQYF,4,0,1,4
TRBV7-2,TRBJ1-5,CASSFFGQGNQPQHF,4,0,1,4
TRBV7-9,TRBJ2-1,CASSFVSGRYNEQFF,4,0,1,4
TRBV7-9,TRBJ2-3,CASSFGSMSTDTQYF,4,0,1,4
TRBV7-2,TRBJ2-7,CASSFRGGAVYEQYF,4,7,2,11
TRBV5-4,TRBJ2-2,CASSLRGTNTGELFF,4,0,1,4
TRBV5-4,TRBJ1-6,CASSLGGSYNSPLHF,4,0,1,4
TRBV5-4,TRBJ2-3,CASSLGTSGRDTQYF,4,0,1,4
TRBV5-4,TRBJ2-2,CASSLDSGNTGELFF,4,0,1,4
TRBV7-2,TRBJ1-1,CASSLLALVDTEAFF,4,0,1,4
TRBV7-9,TRBJ2-4,CASSLQGGAKNIQYF,4,0,1,4
TRBV7-9,TRBJ2-2,CASSLVGLNTGELFF,4,0,1,4
TRBV7-9,TRBJ2-5,CASSLARGGQETQYF,4,0,1,4
TRBV7-2,TRBJ2-7,CASSLAGLDPYEQYF,4,0,1,4
TRBV7-2,TRBJ2-4,CASSLGAGTANIQYF,4,0,1,4
TRBV7-9,TRBJ2-1,CASSLGQGARNEQFF,4,0,1,4
TRBV7-6,TRBJ2-3,CASSLGGAQGDTQYF,4,0,1,4
TRBV7-2,TRBJ2-1,CASSLRQGLYNEQFF,4,0,1,4
TRBV7-2,TRBJ2-7,CASSSRTGVPYEQYF,4,2,2,6
TRBV3-1,TRBJ2-5,CASSYGLAGQETQYF,4,0,1,4
TRBV5-8,TRBJ2-7,CASSLLQTGSYEQYF,4,0,1,4
TRBV7-9,TRBJ2-3,CASSLTSGRYDTQYF,4,0,1,4
TRBV5-4,TRBJ2-1,CASSLSGSSYNEQFF,4,0,1,4
TRBV6-2/3/5/6,TRBJ1-1,CASSPLQDMNTEAFF,4,0,1,4
TRBV7-9,TRBJ2-1,CASSPRDRAYNEQFF,4,0,1,4
TRBV7-9,TRBJ2-2,CASSPVLGNTGELFF,4,0,1,4
TRBV12-3/4,TRBJ2-7,CASSPGTPFTLEQYF,4,0,1,4
TRBV13,TRBJ2-7,CASSPGTGGLLEQYF,4,0,1,4
TRBV5-4,TRBJ1-2,CASSPWQGVNYGYTF,4,0,1,4
TRBV7-9,TRBJ1-6,CASSPGQGAWSPLHF,4,0,1,4
TRBV14,TRBJ2-7,CASSPGPSGAYEQYF,4,0,1,4
TRBV12-3/4,TRBJ2-6,CASSRVTSGANVLTF,4,0,1,4
TRBV5-4,TRBJ1-2,CASSRGHPEGYGYTF,4,0,1,4
TRBV14,TRBJ1-4,CASSHLGTANEKLFF,4,0,1,4
TRBV3-1,TRBJ2-1,CASSQREFPNNEQFF,4,0,1,4
TRBV7-8,TRBJ1-2,CASSQLTGLEYGYTF,4,17,2,21
TRBV14,TRBJ2-5,CASSQVGGSGETQYF,4,0,1,4
TRBV14,TRBJ2-7,CASSQGEQWWYEQYF,4,0,1,4
TRBV3-1,TRBJ1-1,CASSQDWGAGTEAFF,4,0,1,4
TRBV14,TRBJ2-1,CASSQDGTSGIGQFF,4,0,1,4
TRBV4-2,TRBJ1-3,CASSQDRGTEHTIYF,4,0,1,4
TRBV3-1,TRBJ1-2,CASSQEGDRGYGYTF,4,0,1,4
TRBV3-1,TRBJ1-5,CASSQRSYSNQPQHF,4,0,1,4
TRBV7-2,TRBJ1-2,CASSVSGTANYGYTF,4,0,1,4
TRBV7-2,TRBJ2-1,CASSVVLGSYNEQFF,4,0,1,4
TRBV9,TRBJ2-1,CASSVWAGGRNEQFF,4,0,1,4
TRBV9,TRBJ2-1,CASSVGSSLWGEQFF,4,0,1,4
TRBV12-3/4,TRBJ1-1,CASSVKQGVGTEAFF,4,0,1,4
TRBV5-6,TRBJ1-5,CASSGYRDTHQPQHF,4,0,1,4
TRBV7-3,TRBJ1-6,CASSGVGQNNSPLHF,4,0,1,4
TRBV5-5,TRBJ2-7,CASSGRNSPTLEQYF,4,0,1,4
TRBV7-2,TRBJ2-3,CASSGLAGASNTQYF,4,0,1,4
TRBV7-2,TRBJ2-1,CASSDPGQNYNEQSF,4,0,1,4
TRBV2,TRBJ2-3,CASSEEQGGTNTQYF,4,0,1,4
TRBV7-9,TRBJ1-1,CASSILYGVSTEAFF,4,2,2,6
TRBV7-2,TRBJ1-5,CASSTPGRANQPQHF,4,0,1,4
TRBV7-2,TRBJ2-5,CASSTDRVPQETQYF,4,0,1,4
TRBV6-2/3/5/6,TRBJ2-1,CASSRTWGTTNEQFF,4,0,1,4
TRBV7-9,TRBJ2-1,CASSKGQLPGDEQFF,4,0,1,4
TRBV7-2,TRBJ2-7,CASSKRLVLPREQYF,4,0,1,4
TRBV2,TRBJ1-2,CASRSGRSVNYGYTF,4,0,1,4
TRBV12-3/4,TRBJ1-4,CASRSTGAANEKLFF,4,0,1,4
TRBV5-1,TRBJ2-1,CASSSRGASYNGQFF,4,0,1,4
TRBV4-1,TRBJ2-1,CASSKSDRDEDEQFF,4,0,1,4
TRBV5-1,TRBJ2-7,CASSFEGSRSYEQYF,4,0,1,4
TRBV5-1,TRBJ2-5,CASSLVLSDQETQYF,4,0,1,4
TRBV5-1,TRBJ2-1,CASSLVPNPDDEQFF,4,0,1,4
TRBV5-1,TRBJ2-5,CASSLGYGGQGTQYF,4,0,1,4
TRBV5-1,TRBJ2-7,CASSLTFGGTGEQYF,4,0,1,4
TRBV5-1,TRBJ1-1,CASSSRDTKNTEAFF,4,0,1,4
TRBV5-1,TRBJ2-3,CASSSTSGGTDTQYF,4,0,1,4
TRBV4-1,TRBJ2-5,CASSLRWQLKETQYF,4,0,1,4
TRBV5-1,TRBJ2-7,CASSPVGGIGYEQYF,4,0,1,4
TRBV4-1,TRBJ2-4,CASSRLIAGQNIQYF,4,2,2,6
TRBV4-3,TRBJ2-7,CASSHASGGAYEQYF,4,0,1,4
TRBV4-1,TRBJ1-1,CASSQVPDPNTEAFF,4,0,1,4
TRBV4-3,TRBJ1-2,CASSQDYRGFYGYTF,4,0,1,4
TRBV4-1,TRBJ1-5,CASSQDKSRNQPQHF,4,0,1,4
TRBV4-3,TRBJ2-1,CASSQDGRSYNEQFF,4,0,1,4
TRBV5-1,TRBJ2-7,CASSDSTANYYEQYF,4,0,1,4
TRBV4-1,TRBJ2-4,CASSELAGGADIQYF,4,0,1,4
TRBV5-1,TRBJ1-1,CASSIEGRWDTEAFF,4,0,1,4
TRBV20-1,TRBJ2-3,CSAPGTSGSTDTQYF,4,0,1,4
TRBV20-1,TRBJ1-2,CSAALPWTDDYGYTF,4,0,1,4
TRBV20-1,TRBJ2-5,CSADGTSGPQETQYF,4,0,1,4
TRBV20-1,TRBJ1-5,CSATPRRATSQPQHF,4,0,1,4
TRBV20-1,TRBJ1-5,CSASPPRGGNQPQHF,4,0,1,4
TRBV20-1,TRBJ2-1,CSASPGASSYNEQFF,4,0,1,4
TRBV20-1,TRBJ2-3,CSARVRQGAADTQYF,4,0,1,4
TRBV20-1,TRBJ2-7,CSARDPGLLSYEQYF,4,0,1,4
TRBV20-1,TRBJ2-7,CSARDGLAGGDEQYF,4,0,1,4
TRBV20-1,TRBJ2-3,CSAKGLGLGTDTQYF,4,0,1,4
TRBV20-1,TRBJ2-5,CSAPGPPPNQETQYF,4,0,1,4
TRBV20-1,TRBJ2-5,CSAPEGGGIQETQYF,4,0,1,4
TRBV20-1,TRBJ2-5,CSARLAGDPRETQYF,4,0,1,4
TRBV20-1,TRBJ2-3,CSADYLAVDTGTQYF,4,0,1,4
TRBV20-1,TRBJ1-2,CSATPGTGDNYGYTF,4,0,1,4
TRBV20-1,TRBJ2-2,CSASDRGKVTGELFF,4,0,1,4
TRBV20-1,TRBJ2-1,CSAVVGESSYNEQFF,4,0,1,4
TRBV29-1,TRBJ1-1,CSVSRLGVMGTEAFF,4,0,1,4
TRBV29-1,TRBJ2-5,CSVDLGGTGLKTQYF,4,0,1,4
TRBV29-1,TRBJ2-3,CSVDGQGGGTDTQYF,4,0,1,4
TRBV29-1,TRBJ2-3,CSVDGDVDFTDTQYF,4,0,1,4
TRBV29-1,TRBJ2-7,CSVEHRDGSYYEQYF,4,0,1,4
TRBV29-1,TRBJ2-5,CSVEDLFQGLETQYF,4,0,1,4
TRBV29-1,TRBJ2-4,CSVEDPLLAKNIQYF,4,0,1,4
TRBV29-1,TRBJ2-6,CSVEDTNSGANVLTF,4,0,1,4
TRBV29-1,TRBJ2-7,CSVEIPRGFVAEQYF,4,0,1,4
TRBV29-1,TRBJ1-5,CSVRDSSNSNQPQHF,4,0,1,4
TRBV29-1,TRBJ2-7,CSVLGLAGLTGEQYF,4,0,1,4
TRBV29-1,TRBJ2-5,CSVGPSGRAVETQYF,4,0,1,4
TRBV7-4,TRBJ2-7,RASSLGDPATYEQYF,4,0,1,4
TRBV12-5,TRBJ2-5,CASGHGGPTETQYF,4,2,2,6
TRBV12-5,TRBJ2-1,CASGSSGGLNEQFF,4,0,1,4
TRBV30,TRBJ2-2,CAWSVSANTGELFF,4,0,1,4
TRBV30,TRBJ1-1,CAWSGDIRNTEAFF,4,3,2,7
TRBV30,TRBJ1-2,CAWRMGGQGFGYTF,4,0,1,4
TRBV19,TRBJ2-3,CATGQGESTDTQYF,4,0,1,4
TRBV15,TRBJ1-5,CATSRERVGQPQHF,4,0,1,4
TRBV15,TRBJ1-5,CATSRDLRNQPQHF,4,0,1,4
TRBV2,TRBJ1-1,CATRNRAMNTEAFF,4,0,1,4
TRBV19,TRBJ1-5,CATNTGDSDQPQHF,4,0,1,4
TRBV19,TRBJ2-5,CASSLLLGQETQYF,4,0,1,4
TRBV19,TRBJ1-1,CASSIATDYTEAFF,4,0,1,4
TRBV19,TRBJ1-1,CASSRQVGNTEAFF,4,0,1,4
TRBV19,TRBJ2-2,CASRYPAPSGELFF,4,0,1,4
TRBV19,TRBJ1-1,CASSGARMNTEAFF,4,0,1,4
TRBV18,TRBJ2-1,CASSPLGVGNEQFF,4,0,1,4
TRBV18,TRBJ2-5,CASSPPFYLETQYF,4,0,1,4
TRBV18,TRBJ2-7,CASSPPGTSGEQYF,4,0,1,4
TRBV2,TRBJ2-5,CASRGAAGGETQYF,4,0,1,4
TRBV13,TRBJ2-7,CASRPAGVSYEQYF,4,0,1,4
TRBV27,TRBJ1-5,CASRRRDSNQPQHF,4,0,1,4
TRBV7-9,TRBJ2-7,CASGRGRETYEQYF,4,0,1,4
TRBV7-2,TRBJ1-1,CASEGGRMVTEAFF,4,0,1,4
TRBV7-2,TRBJ1-2,CASIRDRGNYGYTF,4,0,1,4
TRBV12-3/4,TRBJ2-5,CASMPSGNQETQYF,4,0,1,4
TRBV12-3/4,TRBJ2-1,CASTVAVTYNEQFF,4,0,1,4
TRBV12-3/4,TRBJ1-1,CASTPGLITAEAFF,4,0,1,4
TRBV5-4,TRBJ1-4,CASTQTGGNEKLFF,4,0,1,4
TRBV2,TRBJ2-5,CASTTLGFQETQYF,4,0,1,4
TRBV12-3/4,TRBJ1-2,CASSFGGQGRGYTF,4,0,1,4
TRBV27,TRBJ2-2,CASSFNPNTGELFF,4,0,1,4
TRBV6-2/3/5/6,TRBJ2-4,CASSFELAGSIQYF,4,0,1,4
TRBV6-2/3/5/6,TRBJ2-5,CASSLASGEETQYF,4,0,1,4
TRBV27,TRBJ2-5,CASSLGQRGETQYF,4,0,1,4
TRBV6-2/3/5/6,TRBJ2-5,CASSLLTGGETQYF,4,0,1,4
TRBV12-3/4,TRBJ1-5,CASSLGAENQPQHF,4,0,1,4
TRBV14,TRBJ1-1,CASSLGGGDTEAFF,4,5,2,9
TRBV12-3/4,TRBJ2-1,CASSLGGKYNEQFF,4,0,1,4
TRBV12-3/4,TRBJ1-2,CASSLDTGVVGYTF,4,0,1,4
TRBV12-3/4,TRBJ1-1,CASSLIQSNTEAFF,4,0,1,4
TRBV6-2/3/5/6,TRBJ2-5,CASSLIDGPKTQYF,4,0,1,4
TRBV12-3/4,TRBJ2-3,CASSSDRAGDTQYF,4,0,1,4
TRBV6-2/3/5/6,TRBJ2-3,CASSYLQGADTQYF,4,0,1,4
TRBV6-2/3/5/6,TRBJ2-5,CASSYLGPGETQYF,4,0,1,4
TRBV6-2/3/5/6,TRBJ2-2,CASSYSTSTGELFF,4,0,1,4
TRBV7-2,TRBJ2-3,CASSYGSVGDTQYF,4,3,2,7
TRBV27,TRBJ2-7,CASSPARGPYEQYF,4,0,1,4
TRBV12-3/4,TRBJ2-4,CASSRTDLKNIQYF,4,0,1,4
TRBV2,TRBJ2-3,CASSVSQGWDTQYF,4,0,1,4
TRBV6-1,TRBJ1-1,CASSVQGAYTEAFF,4,0,1,4
TRBV6-1,TRBJ2-7,CASSAGGGTYEQYF,4,0,1,4
TRBV6-1,TRBJ2-3,CASSAVDSTDTQYF,4,0,1,4
TRBV6-1,TRBJ1-2,CASSAGTFDYGYTF,4,0,1,4
TRBV6-4,TRBJ2-3,CASSDRGGPDTQYF,4,0,1,4
TRBV6-1,TRBJ2-7,CASSETSGFYEQYF,4,0,1,4
TRBV6-2/3/5/6,TRBJ2-3,CASSTQDATDTQYF,4,0,1,4
TRBV6-2/3/5/6,TRBJ1-2,CASSNLGVNYGYTF,4,0,1,4
TRBV5-4,TRBJ2-5,CASSFWTGRETQYF,4,0,1,4
TRBV7-8,TRBJ2-1,CASSFQGRGNEQFF,4,0,1,4
TRBV7-2,TRBJ1-2,CASSFGVSNYGYTF,4,0,1,4
TRBV5-6,TRBJ2-5,CASSFDRQKGTQYF,4,0,1,4
TRBV7-2,TRBJ1-2,CASSLRGTDAGYTF,4,0,1,4
TRBV7-6,TRBJ1-1,CASSLQGLGSEAFF,4,0,1,4
TRBV5-6,TRBJ1-6,CASSLASYNSPLHF,4,0,1,4
TRBV7-6,TRBJ2-1,CASSLAGKNNEQFF,4,0,1,4
TRBV5-4,TRBJ1-1,CASSLGAGNTEAFF,4,0,1,4
TRBV5-4,TRBJ1-1,CASSLGPVDTEAFF,4,0,1,4
TRBV7-9,TRBJ1-3,CASSLGRAADTIYF,4,0,1,4
TRBV5-4,TRBJ2-1,CASSLDGGYNEQFF,4,0,1,4
TRBV7-8,TRBJ1-2,CASSLDRNNYGYTF,4,0,1,4
TRBV7-9,TRBJ2-3,CASSLSTSTDTQYF,4,0,1,4
TRBV7-9,TRBJ2-2,CASSLVGDTGELFF,4,0,1,4
TRBV7-6,TRBJ2-5,CASSLVAGEETQYF,4,0,1,4
TRBV7-9,TRBJ2-7,CASSLAGGAWEQYF,4,0,1,4
TRBV7-6,TRBJ2-3,CASSLGARVDTQYF,4,0,1,4
TRBV7-6,TRBJ1-1,CASSLGDKNTEAFF,4,0,1,4
TRBV7-2,TRBJ1-1,CASSLGRMNTEAFF,4,0,1,4
TRBV7-2,TRBJ2-1,CASSLDFGGDRRFF,4,0,1,4
TRBV7-6,TRBJ1-1,CASSLEGTGAEAFF,4,0,1,4
TRBV7-2,TRBJ1-4,CASSLETGNEKLFF,4,0,1,4
TRBV7-2,TRBJ2-7,CASSLTSGRYEQYF,4,0,1,4
TRBV7-9,TRBJ2-3,CASSLRGGADTQYF,4,0,1,4
TRBV7-8,TRBJ1-1,CASSLNRQNTEAFF,4,0,1,4
TRBV7-9,TRBJ2-3,CASSSSAATDTQYF,4,0,1,4
TRBV7-6,TRBJ2-3,CASSSGALTDTQYF,4,0,1,4
TRBV7-9,TRBJ1-1,CASSSWRGNTEAFF,4,0,1,4
TRBV7-9,TRBJ1-6,CASSSGQGRSPLHF,4,0,1,4
TRBV7-3,TRBJ2-3,CASSSSGGTDTQYF,4,0,1,4
TRBV5-5,TRBJ2-5,CASSWASGEETQYF,4,0,1,4
TRBV5-6,TRBJ1-6,CASSWDGRNSPLHF,4,0,1,4
TRBV5-4,TRBJ1-1,CASSYDPGGAEAFF,4,0,1,4
TRBV4-2,TRBJ1-4,CASSLGRGDEKLFF,4,0,1,4
TRBV7-9,TRBJ2-5,CASSPARIFETQYF,4,0,1,4
TRBV7-6,TRBJ1-2,CASSPGTGGYGYTF,4,0,1,4
TRBV12-3/4,TRBJ1-4,CASSPGQGREKLSF,4,0,1,4
TRBV3-1,TRBJ2-7,CASSPDEGTYEQYF,4,0,1,4
TRBV13,TRBJ1-1,CASSPLQGNTEAFF,4,0,1,4
TRBV4-2,TRBJ1-1,CASSRDRMNTEAFF,4,0,1,4
TRBV5-4,TRBJ1-4,CASSQDSSEEKLFF,4,0,1,4
TRBV3-1,TRBJ2-7,CASSQVGGSYEQYF,4,0,1,4
TRBV4-2,TRBJ1-2,CASSQVDEGPGYTF,4,0,1,4
TRBV3-1,TRBJ2-7,CASSQDSQGYEQYF,4,0,1,4
TRBV4-2,TRBJ1-2,CASSQDGGGSGYTF,4,2,2,6
TRBV4-2,TRBJ1-1,CASSQDMGSSEAFF,4,3,2,7
TRBV4-2,TRBJ1-2,CASSQEGALHGYTF,4,0,1,4
TRBV5-6,TRBJ2-7,CASSVGLGGYEQYF,4,0,1,4
TRBV9,TRBJ1-1,CASSVTDRNTEAFF,4,0,1,4
TRBV9,TRBJ2-1,CASSVVMDPNEQFF,4,0,1,4
TRBV13,TRBJ2-5,CASSARLATETQYF,4,0,1,4
TRBV11-2,TRBJ1-6,CASSADRGISPLHF,4,0,1,4
TRBV5-4,TRBJ2-7,CASSGGLTGVEQYF,4,0,1,4
TRBV9,TRBJ1-4,CASSEGTGGEKLFF,4,0,1,4
TRBV7-9,TRBJ1-3,CASSIAVSGNTIYF,4,0,1,4
TRBV7-8,TRBJ1-2,CASSTGHRTYGYTF,4,0,1,4
TRBV5-6,TRBJ2-2,CASSRDVYTGELFF,4,0,1,4
TRBV7-2,TRBJ1-1,CASSNTDRNTEAFF,4,0,1,4
TRBV5-6,TRBJ1-2,CASSKEVANYGYTF,4,0,1,4
TRBV12-3/4,TRBJ1-1,CASRATGERAEAFF,4,0,1,4
TRBV6-1,TRBJ1-4,CASRNRRVNEKLFF,4,0,1,4
TRBV6-2/3/5/6,TRBJ1-6,CASRPGQSPSPLHF,4,0,1,4
TRBV7-2,TRBJ2-1,CASRQRGANNEQFF,4,0,1,4
TRBV12-3/4,TRBJ2-1,CASRKIGTPFEQFF,4,0,1,4
TRBV7-2,TRBJ2-5,CASNQQGGKETQYF,4,0,1,4
TRBV2,TRBJ2-1,CASKGGTSYNEQFF,4,0,1,4
TRBV20-1,TRBJ1-5,CSARLGGVRQPQHF,4,0,1,4
TRBV4-1,TRBJ1-3,CACSPDRGGNTIYF,4,0,1,4
TRBV5-1,TRBJ1-1,CASSLSTGFTEAFF,4,0,1,4
TRBV5-1,TRBJ2-5,CASSLPDRGETQYF,4,0,1,4
TRBV5-1,TRBJ2-3,CASSLVLRTDTQYF,4,0,1,4
TRBV5-1,TRBJ2-7,CASSLVAEPYEQYF,4,0,1,4
TRBV5-1,TRBJ1-1,CASSLGQGNTEAFF,4,0,1,4
TRBV5-1,TRBJ1-1,CASSLRQANTEAFF,4,0,1,4
TRBV4-3,TRBJ2-7,CASSSGTGTYEQYF,4,0,1,4
TRBV4-1,TRBJ2-3,CASSSVGTTDTQYF,4,0,1,4
TRBV5-1,TRBJ1-6,CASSWRGLDSPLHF,4,0,1,4
TRBV5-1,TRBJ1-1,CASSPRFPNTEAFF,4,0,1,4
TRBV5-1,TRBJ1-2,CASSPRDRSYGYTF,4,0,1,4
TRBV5-1,TRBJ1-1,CASSPGPPNTEAFF,4,0,1,4
TRBV5-1,TRBJ2-7,CASSPGGIKYEQYF,4,0,1,4
TRBV5-1,TRBJ1-6,CASSRAQENSPLHF,4,0,1,4
TRBV4-1,TRBJ1-2,CASSQGTRTGGHTF,4,2,2,6
TRBV4-1,TRBJ1-2,CASSQLGQQYGYTF,4,0,1,4
TRBV4-1,TRBJ1-6,CASSQTTGGEPLPF,4,0,1,4
TRBV20-1,TRBJ2-7,CSALTGTGVREQYF,4,0,1,4
TRBV20-1,TRBJ2-3,CSAPSQRGADTQYF,4,0,1,4
TRBV20-1,TRBJ2-5,CSAHPGGGAETQYF,4,0,1,4
TRBV20-1,TRBJ2-1,CSAINRLGYNEQFF,4,0,1,4
TRBV20-1,TRBJ1-3,CSAMSGYSLNTIYF,4,16,2,20
TRBV20-1,TRBJ2-7,CSAILGQGRHEQYF,4,0,1,4
TRBV20-1,TRBJ1-1,CSATRTGGSAEAFF,4,0,1,4
TRBV20-1,TRBJ2-3,CSASWIADTDTQYF,4,0,1,4
TRBV20-1,TRBJ2-1,CSASEGLADNEQFF,4,0,1,4
TRBV20-1,TRBJ1-5,CSARRVSADQPQHF,4,0,1,4
TRBV20-1,TRBJ1-1,CSARFISGGTEAFF,4,0,1,4
TRBV20-1,TRBJ2-5,CSARARDSQETQYF,4,0,1,4
TRBV20-1,TRBJ2-7,CSARDPSGSKEQYF,4,0,1,4
TRBV20-1,TRBJ2-5,CSARDPRGWETQYF,4,0,1,4
TRBV20-1,TRBJ2-1,CSAPRPQGGNEQFF,4,0,1,4
TRBV20-1,TRBJ2-1,CSAPIRDFLNEQFF,4,0,1,4
TRBV20-1,TRBJ2-3,CSAPANAGPDTQYF,4,0,1,4
TRBV20-1,TRBJ1-5,CSARRGAVNQPQHF,4,0,1,4
TRBV29-1,TRBJ2-1,CSSDSAGGYNEQFF,4,0,1,4
TRBV29-1,TRBJ1-2,CSVDAGIGPYGYTF,4,0,1,4
TRBV29-1,TRBJ2-2,CSVEGTGETGELFF,4,0,1,4
TRBV29-1,TRBJ2-5,CSVGSGGGRETQYF,4,0,1,4
TRBV29-1,TRBJ2-7,CSVKTSGGASEQYF,4,0,1,4
TRBV29-1,TRBJ2-1,CSARLAGDLNEQFF,4,0,1,4
TRBV2,TRBJ2-7,CVTTSGGSYEQYF,4,0,1,4
TRBV12-5,TRBJ2-5,CASGLGWQETQYF,4,0,1,4
TRBV12-5,TRBJ2-5,CASGTSRGETQYF,4,0,1,4
TRBV30,TRBJ1-2,CAWSPQGSYGYTF,4,0,1,4
TRBV30,TRBJ2-3,CAWSDASTDTQYF,4,0,1,4
TRBV5-4,TRBJ2-2,CALAWASPGELFF,4,0,1,4
TRBV27,TRBJ1-1,CAIFLSGGTEAFF,4,0,1,4
TRBV19,TRBJ1-3,CAITPRSGNTIYF,4,0,1,4
TRBV10-3,TRBJ2-2,CAIGQGNTGELFF,4,0,1,4
TRBV10-3,TRBJ2-7,CAIRGPGDYEQYF,4,0,1,4
TRBV10-3,TRBJ1-6,CATVKGFDSPLHF,4,0,1,4
TRBV24-1,TRBJ2-3,CATSASGADTQYF,4,0,1,4
TRBV15,TRBJ1-1,CATSRDANTEAFF,4,0,1,4
TRBV15,TRBJ1-5,CATSREGNQPQHF,4,0,1,4
TRBV27,TRBJ2-1,CATTRRGYNEQFF,4,0,1,4
TRBV19,TRBJ1-1,CASSFRDTYEAFF,4,0,1,4
TRBV19,TRBJ2-5,CASSSSGQETQYF,4,14,2,18
TRBV19,TRBJ1-2,CASSIRGDYGYTF,4,0,1,4
TRBV19,TRBJ1-1,CASSIWGNTEAFF,4,0,1,4
TRBV19,TRBJ1-5,CASSITGNQPQHF,4,0,1,4
TRBV2,TRBJ2-7,CASSQAISYEQYF,4,0,1,4
TRBV6-2/3/5/6,TRBJ1-4,CASFGRINEKLFF,4,0,1,4
TRBV18,TRBJ1-1,CASSTGMNTEAFF,4,0,1,4
TRBV18,TRBJ1-6,CASSPSGNSPLHF,4,0,1,4
TRBV18,TRBJ2-7,CASSPPVSHEQYF,4,0,1,4
TRBV6-4,TRBJ2-1,CASWDRSYNEQFF,4,0,1,4
TRBV19,TRBJ2-1,CASRDTPYNEQFF,4,0,1,4
TRBV2,TRBJ2-2,CASAGKNTGELFF,4,0,1,4
TRBV6-2/3/5/6,TRBJ1-1,CASSFGVNTEAFF,4,0,1,4
TRBV12-3/4,TRBJ2-5,CASSFPDQETQYF,4,0,1,4
TRBV12-3/4,TRBJ2-1,CASSFREWSEQFF,4,0,1,4
TRBV12-3/4,TRBJ2-7,CASSLQGKNEQYF,4,0,1,4
TRBV12-3/4,TRBJ2-1,CASSLSIANEQFF,4,0,1,4
TRBV12-3/4,TRBJ2-5,CASSLRGQETQYF,4,0,1,4
TRBV6-2/3/5/6,TRBJ1-6,CASSSTENSPLHF,4,3,2,7
TRBV6-2/3/5/6,TRBJ1-1,CASSSGFGTEAFF,4,0,1,4
TRBV12-3/4,TRBJ1-5,CASSWDRLQPQHF,4,0,1,4
TRBV6-2/3/5/6,TRBJ2-7,CASSWEEPYEQYF,4,0,1,4
TRBV6-2/3/5/6,TRBJ2-1,CASSYSGYNEQFF,4,0,1,4
TRBV6-2/3/5/6,TRBJ2-1,CASSYGSVREQFF,4,0,1,4
TRBV12-3/4,TRBJ2-5,CASSLSEQETQYF,4,0,1,4
TRBV5-6,TRBJ1-2,CASSPDRTYGYTF,4,0,1,4
TRBV12-3/4,TRBJ1-2,CASSPNDGYGYTF,4,0,1,4
TRBV7-6,TRBJ1-5,CASSQDPNQPQHF,4,0,1,4
TRBV6-1,TRBJ2-6,CASSVTGANVLTF,4,0,1,4
TRBV6-1,TRBJ1-1,CASSVTGRTEAFF,4,0,1,4
TRBV6-4,TRBJ2-2,CASSDRGTGELFF,4,0,1,4
TRBV6-1,TRBJ1-4,CASSEGRFGNLFF,4,0,1,4
TRBV7-2,TRBJ2-7,CASSFTASHEQYF,4,0,1,4
TRBV5-6,TRBJ2-1,CASSLVYLREQFF,4,0,1,4
TRBV5-6,TRBJ1-4,CASSLGSGEKLFF,4,7,2,11
TRBV5-6,TRBJ2-7,CASSLMSRGEQYF,4,0,1,4
TRBV7-2,TRBJ2-2,CASSLSGVGELFF,4,0,1,4
TRBV7-6,TRBJ2-7,CASSLGRAYEQYF,4,0,1,4
TRBV7-8,TRBJ2-7,CASSLGVGYEQYF,4,0,1,4
TRBV7-2,TRBJ1-2,CASSLEGGHGYTF,4,0,1,4
TRBV11-1,TRBJ2-7,CASSLIRGREQYF,4,2,2,6
TRBV7-9,TRBJ2-1,CASSLNRDNEQFF,4,0,1,4
TRBV6-2/3/5/6,TRBJ1-5,CASSSTGNQPQHF,4,0,1,4
TRBV7-9,TRBJ1-5,CASSSYLSQPQHF,4,0,1,4
TRBV6-2/3/5/6,TRBJ1-5,CASSSTEEEPQHF,4,0,1,4
TRBV7-9,TRBJ2-5,CASSSGVGETQYF,4,0,1,4
TRBV5-4,TRBJ1-5,CASSLGTRQPQHF,4,0,1,4
TRBV7-7,TRBJ2-3,CASSPFDADTQYF,4,0,1,4
TRBV11-2,TRBJ2-7,CASSPSPGYEQYF,4,0,1,4
TRBV3-1,TRBJ2-3,CASSPRESDTQYF,4,0,1,4
TRBV14,TRBJ1-1,CASSPTADTEAFF,4,0,1,4
TRBV4-2,TRBJ2-1,CASSQSGKDEQFF,4,0,1,4
TRBV3-1,TRBJ1-1,CASSQDRGVVAFF,4,0,1,4
TRBV7-2,TRBJ2-4,CASSQRTGDILYF,4,0,1,4
TRBV9,TRBJ2-1,CASSVGQINEQFF,4,0,1,4
TRBV5-6,TRBJ2-7,CASSGTPAYEQYF,4,0,1,4
TRBV7-9,TRBJ1-6,CASSEWTASPLHF,4,0,1,4
TRBV14,TRBJ2-5,CASSTLAGETQYF,4,0,1,4
TRBV7-6,TRBJ2-7,CASSKTNSYEQYF,4,0,1,4
TRBV6-1,TRBJ2-5,CASRVTGPETQYF,4,0,1,4
TRBV7-2,TRBJ2-1,CASRINPNNEQFF,4,0,1,4
TRBV7-9,TRBJ2-5,CASRLTDQETQYF,4,0,1,4
TRBV4-2,TRBJ2-7,CTSSQDQGVEQYF,4,0,1,4
TRBV7-4,TRBJ2-7,CAWGGQGNHEQYF,4,0,1,4
TRBV5-1,TRBJ1-5,CASIRPSNQPQHF,4,3,2,7
TRBV5-1,TRBJ1-2,CASSFGHNYGYTF,4,0,1,4
TRBV5-1,TRBJ2-1,CASSLYRDGEQFF,4,0,1,4
TRBV5-1,TRBJ1-1,CASSLAGDTEAFF,4,0,1,4
TRBV5-1,TRBJ2-7,CASSLDTPYEQYF,4,0,1,4
TRBV4-3,TRBJ2-3,CASSPSSTDTQYF,4,0,1,4
TRBV4-3,TRBJ1-1,CASSPTGQGEAFF,4,0,1,4
TRBV2,TRBJ2-3,CASSRDHTDTQYF,4,0,1,4
TRBV4-1,TRBJ1-1,CASSQVQWTEAFF,4,0,1,4
TRBV4-1,TRBJ2-5,CASSQDRGETQYF,4,0,1,4
TRBV4-3,TRBJ2-5,CASSQKSMGTQYF,4,0,1,4
TRBV5-1,TRBJ2-3,CASSTGTLDTQYF,4,0,1,4
TRBV20-1,TRBJ1-1,CSATAGGDTEAFF,4,0,1,4
TRBV20-1,TRBJ2-4,CSASLTGGNIQYF,4,16,2,20
TRBV20-1,TRBJ2-5,CSASGARLETQYF,4,0,1,4
TRBV20-1,TRBJ1-1,CSARGVGRTEAFF,4,0,1,4
TRBV20-1,TRBJ2-5,CSARGTGQETQYF,4,0,1,4
TRBV20-1,TRBJ2-7,CSARDGLFYEQYF,4,0,1,4
TRBV20-1,TRBJ2-7,CSAGQGSYDEQYF,4,0,1,4
TRBV29-1,TRBJ2-3,CSPWDQSTDTQYF,4,2,2,6
TRBV29-1,TRBJ1-1,CSVVGTRNTEAFF,4,0,1,4
TRBV29-1,TRBJ1-5,CSVGDNFDQPQHF,4,0,1,4
TRBV29-1,TRBJ2-5,CSVGRDTQETQYF,4,3,2,7
TRBV29-1,TRBJ2-7,CSVGQGLAYEQYF,4,6,2,10
TRBV29-1,TRBJ2-1,CSVERDLVDEQFF,4,0,1,4
TRBV29-1,TRBJ1-1,CSVTRTMNTEAFF,4,0,1,4
TRBV29-1,TRBJ1-4,CSVNKGQGGKLFF,4,0,1,4
TRBV29-1,TRBJ2-7,CSVGSGGDYEQYF,4,0,1,4
TRBV29-1,TRBJ2-7,CSAWDNNSYEQYF,4,0,1,4
TRBV29-1,TRBJ2-1,CSAGLAGEGEQFF,4,0,1,4
TRBV29-1,TRBJ1-5,CSGADGSNQPQHF,4,0,1,4
TRBV29-1,TRBJ2-1,CSTWGIQGNEQFF,4,0,1,4
TRBV15,TRBJ2-1,RATSRVTGNEQFF,4,0,1,4
TRBV9,TRBJ2-1,RASSAPWDNEQFF,4,0,1,4
TRBV12-5,TRBJ1-1,CASGQSKTEAFF,4,0,1,4
TRBV12-5,TRBJ1-5,CASGLLSQPQHF,4,0,1,4
TRBV30,TRBJ2-3,CAWTAGLHTQYF,4,0,1,4
TRBV2,TRBJ2-7,CAGGRKAYEQYF,4,2,2,6
TRBV24-1,TRBJ2-5,CAIPVKQETQYF,4,0,1,4
TRBV10-3,TRBJ2-1,CAISEGDNEQFF,4,0,1,4
TRBV10-3,TRBJ2-3,CAIRGNTDTQYF,4,0,1,4
TRBV19,TRBJ2-1,CASSIDPLEQFF,4,0,1,4
TRBV11-2,TRBJ2-7,CASEGRGNEQYF,4,0,1,4
TRBV12-3/4,TRBJ1-5,CASTYSNQPQHF,4,4,2,8
TRBV6-2/3/5/6,TRBJ1-2,CASTTEGADYTF,4,0,1,4
TRBV25-1,TRBJ2-1,CASTGIRNEQFF,4,0,1,4
TRBV12-3/4,TRBJ2-1,CASSLGGDEQSF,4,0,1,4
TRBV5-1,TRBJ2-7,CASSLQGYEQYF,4,5,2,9
TRBV6-2/3/5/6,TRBJ1-1,CASSSPNTEAFF,4,0,1,4
TRBV6-2/3/5/6,TRBJ2-3,CASSLRLDTQYF,4,0,1,4
TRBV6-2/3/5/6,TRBJ2-3,CASSQGLDTQYF,4,0,1,4
TRBV7-6,TRBJ2-1,CASSLQGNEQFF,4,0,1,4
TRBV5-6,TRBJ1-2,CASSLAGPPYTF,4,0,1,4
TRBV5-5,TRBJ1-1,CASSLELDYAFF,4,0,1,4
TRBV7-6,TRBJ2-7,CASSLSDREQYF,4,4,2,8
TRBV7-6,TRBJ1-1,CASSLVEGEAFF,4,0,1,4
TRBV7-9,TRBJ1-5,CASSLEGQPQHF,4,0,1,4
TRBV7-9,TRBJ2-5,CASSSSYQAQYF,4,0,1,4
TRBV7-9,TRBJ2-1,CASSLAYNEQFF,4,0,1,4
TRBV14,TRBJ1-1,CASSPSGVEAFF,4,0,1,4
TRBV5-4,TRBJ2-5,CASSPTTETQYF,4,0,1,4
TRBV7-9,TRBJ2-5,CASSPLGETQYF,4,0,1,4
TRBV27,TRBJ2-3,CASSHDTFTQYF,4,0,1,4
TRBV6-2/3/5/6,TRBJ2-1,CASSQNLFEQFF,4,0,1,4
TRBV5-6,TRBJ1-6,CASSGWNSPLHF,4,0,1,4
TRBV7-9,TRBJ2-7,CASREKGGEQYF,4,15,2,19
TRBV6-2/3/5/6,TRBJ2-7,CASRTTGYEQYF,4,0,1,4
TRBV5-1,TRBJ2-7,CASSLRGSEQYF,4,0,1,4
TRBV5-1,TRBJ2-7,CASSINSREQYF,4,0,1,4
TRBV20-1,TRBJ1-1,CSAPLDIPEAFL,4,0,1,4
TRBV20-1,TRBJ2-5,CSAPSTGETQYF,4,0,1,4
TRBV20-1,TRBJ2-5,CSAIGTEETQYF,4,0,1,4
TRBV20-1,TRBJ1-1,CSARAGNTEAFF,4,0,1,4
TRBV29-1,TRBJ2-7,CSVVTGGYEQYF,4,0,1,4
TRBV29-1,TRBJ2-7,CSVGGSTYEQYF,4,0,1,4
TRBV29-1,TRBJ2-1,CSVGTGDNEQFF,4,0,1,4
TRBV29-1,TRBJ1-2,CSVEDRDIGYTF,4,0,1,4
TRBV20-1,TRBJ1-1,CSAPRGATEAFF,4,0,1,4
TRBV7-2,TRBJ2-1,RASSVGGPEQFF,4,0,1,4
TRBV30,TRBJ2-7,CAWNRGMEQYF,4,0,1,4
TRBV10-3,TRBJ1-2,CAISTPAGYTF,4,0,1,4
TRBV12-3/4,TRBJ2-2,CASLTTGELFF,4,0,1,4
TRBV3-1,TRBJ2-2,CASLLSGELFF,4,0,1,4
TRBV27,TRBJ2-1,CASGYRDFGFF,4,0,1,4
TRBV16,TRBJ2-1,CASGPNNEQFF,4,0,1,4
TRBV6-4,TRBJ2-3,CASTRGDTQYF,4,0,1,4
TRBV11-2,TRBJ2-1,CASTQSLEQFF,4,0,1,4
TRBV12-3/4,TRBJ2-7,CASSLGYEQYF,4,0,1,4
TRBV12-3/4,TRBJ2-4,CASSLGDRGDF,4,0,1,4
TRBV6-2/3/5/6,TRBJ2-2,CASSYSGELFF,4,0,1,4
TRBV7-9,TRBJ2-7,CASSLGPEQYF,4,0,1,4
TRBV11-1,TRBJ2-7,CASSLTGGQYF,4,0,1,4
TRBV11-3,TRBJ2-1,CASSLRDSGIF,4,0,1,4
TRBV7-9,TRBJ2-7,CASSYSYEQYF,4,0,1,4
TRBV7-9,TRBJ2-1,CASSLRDEQFF,4,0,1,4
TRBV3-1,TRBJ2-7,CASSHLYEQYF,4,0,1,4
TRBV3-1,TRBJ1-4,CASSQRGLLFF,4,0,1,4
TRBV29-1,TRBJ1-3,CSGGQGNTIYF,4,0,1,4
TRBV6-2/3/5/6,TRBJ2-7,CASGRDEQYF,4,0,1,4
TRBV29-1,TRBJ1-1,CSVVNGEAFF,4,0,1,4
TRBV29-1,TRBJ2-7,CSVAGYEQYF,4,0,1,4
TRBV29-1,TRBJ2-2,CSAGTGELFF,4,0,1,4
TRBV12-3/4,TRBJ2-4,CASSPPGAGGFAKDIQYF,4,0,1,4
TRBV5-1,TRBJ2-2,CASSLLGQLAITGELFF,4,0,1,4
TRBV6-2/3/5/6,TRBJ1-6,CASSSSTGTGNSPLHF,4,0,1,4
TRBV9,TRBJ1-4,CASSGSGYSTNEKLFF,4,0,1,4
TRBV7-7,TRBJ2-5,CASSLGAGRQETQYF,4,0,1,4
TRBV10-2,TRBJ2-5,CASAGTSGRVETQYF,4,0,1,4
TRBV19,TRBJ2-5,CASSIGSSPETQYF,4,0,1,4
TRBV12-3/4,TRBJ1-6,CASSLWDTNSPLHF,4,0,1,4
TRBV25-1,TRBJ1-2,CASSVGSSSLRYTF,4,0,1,4
TRBV7-8,TRBJ2-7,CASRPRGRPYEQYF,4,0,1,4
TRBV4-1,TRBJ2-5,CASSQAGGWETQYF,4,0,1,4
TRBV18,TRBJ1-2,CASSPGRDNGYTF,4,0,1,4
TRBV19,TRBJ1-2,CASCWGAGYGYTF,4,0,1,4
TRBV4-3,TRBJ2-3,CASSRGRTDTQYF,4,0,1,4
TRBV6-2/3/5/6,TRBJ2-1,CASQRGVGPDGPNEQFF,4,0,1,4
TRBV3-1,TRBJ2-5,CASTSGGAGQETQYF,4,0,1,4
TRBV30,TRBJ1-5,CAWRLDRSNQPQHF,4,0,1,4
TRBV19,TRBJ2-3,CASSASGTGGTDTQYF,3,0,1,3
TRBV10-3,TRBJ2-3,CAISESAGGTQYF,3,0,1,3
TRBV7-6,TRBJ2-1,CASSSHNEQFF,3,0,1,3
TRBV6-2/3/5/6,TRBJ1-1,CASSLMAAFMNTEAFF,3,0,1,3
TRBV9,TRBJ1-1,CASSARPTGRSTEAFF,3,12,2,15
TRBV7-6,TRBJ2-3,CASSLEGTDTQYF,3,9,2,12
TRBV5-1,TRBJ2-1,CASSSPLGTSGGTLNRIEQFF,3,0,1,3
TRBV6-2/3/5/6,TRBJ2-3,CASTDLSGQGWGLSTDTQYF,3,0,1,3
TRBV7-9,TRBJ2-2,CASSLPPYSRGLANTGELFF,3,0,1,3
TRBV18,TRBJ2-7,CASSHRIPGLAGGTYEQYF,3,0,1,3
TRBV18,TRBJ2-5,CASSRTSVRGYSWEETQYF,3,0,1,3
TRBV12-3/4,TRBJ1-4,CASSFLTQRGQGTNEKLFF,3,0,1,3
TRBV12-3/4,TRBJ1-2,CASSLGLGPKALEIRVYTF,3,13,2,16
TRBV12-3/4,TRBJ2-3,CASSLGLAGPPPDTDTQYF,3,0,1,3
TRBV6-2/3/5/6,TRBJ2-7,CASSYSAPGLAGSPNEQYF,3,0,1,3
TRBV7-9,TRBJ2-7,CASSEPPGIGTSGPYEQYF,3,0,1,3
TRBV5-5,TRBJ2-1,CASSFGTPSRRALWNEQFF,3,0,1,3
TRBV5-4,TRBJ2-1,CASSLATGTNGTGYNEQFF,3,0,1,3
TRBV6-2/3/5/6,TRBJ2-1,CASSLAPGPGTGQLGEQFF,3,0,1,3
TRBV5-5,TRBJ1-5,CASSLGAGGALYSNQPQHF,3,0,1,3
TRBV7-9,TRBJ2-1,CASSPRLFGLAESYNEQFF,3,0,1,3
TRBV5-5,TRBJ2-5,CASSGAGTSGTALWETQYF,3,0,1,3
TRBV6-2/3/5/6,TRBJ2-1,CASSERGGILAVNRNEQFF,3,0,1,3
TRBV9,TRBJ2-1,CASSERGGILAGNRNEQFF,3,0,1,3
TRBV12-3/4,TRBJ2-5,CASRLYRLAGGGAQETQYF,3,0,1,3
TRBV5-1,TRBJ2-5,CASSLQKGLAGLKGETQYF,3,0,1,3
TRBV4-1,TRBJ1-1,CASSPGSLRGPYMNTEAFF,3,0,1,3
TRBV29-1,TRBJ2-1,CSVRRPGLAGAPTYNEQFF,3,0,1,3
TRBV10-3,TRBJ2-1,CAISGGLAGVRGGNEQFF,3,0,1,3
TRBV15,TRBJ2-2,CATSRELAGVGNTGELFF,3,0,1,3
TRBV19,TRBJ1-5,CASRAGPPGRLSNQPQHF,3,0,1,3
TRBV6-2/3/5/6,TRBJ1-2,CASSLGSITGGTNYGYTF,3,0,1,3
TRBV6-2/3/5/6,TRBJ2-3,CASSYSWAGGPVADAQYF,3,0,1,3
TRBV4-2,TRBJ2-6,CASSLGGEGDSGANVLTF,3,2,2,5
TRBV6-2/3/5/6,TRBJ1-5,CASSRLTGTALPNQPQHF,3,0,1,3
TRBV12-3/4,TRBJ1-4,CASSQRQGSHQANEKLFF,3,0,1,3
TRBV6-1,TRBJ1-5,CASSGRSRGIYSNQPQHF,3,0,1,3
TRBV5-6,TRBJ1-4,CASSFSTGPSHFDEKLFF,3,0,1,3
TRBV12-3/4,TRBJ2-1,CASSFRLAGGRSYNEQFF,3,0,1,3
TRBV7-6,TRBJ1-6,CASSLETGSSSYNSPLHF,3,0,1,3
TRBV11-3,TRBJ2-7,CASSLIQARTDRDYEQYF,3,0,1,3
TRBV4-2,TRBJ2-7,CASSLQTGTSGVLYEQYF,3,0,1,3
TRBV13,TRBJ2-1,CASSLARERKTSGNEQFF,3,0,1,3
TRBV7-2,TRBJ2-3,CASSPRGNLGVITDTQYF,3,0,1,3
TRBV11-2,TRBJ2-1,CASSPWTSGRKLYNEQFF,3,0,1,3
TRBV4-2,TRBJ2-1,CASSQASGTTLFYNEQFF,3,0,1,3
TRBV4-2,TRBJ1-2,CASSQDQNRGHSNYGYTF,3,0,1,3
TRBV9,TRBJ2-3,CASSVGEREGPVADTQYF,3,0,1,3
TRBV4-1,TRBJ2-7,CASSQRRLAGGSSYEQYF,3,0,1,3
TRBV4-1,TRBJ2-2,CASSQAVASGINTGELFF,3,0,1,3
TRBV4-1,TRBJ1-2,CASSQGVKGNRANYGYTF,3,0,1,3
TRBV4-3,TRBJ2-4,CASSQDLGQGLAKNIQYF,3,0,1,3
TRBV4-3,TRBJ1-3,CASSQDGTPAFSGNTIYF,3,0,1,3
TRBV4-3,TRBJ2-1,CASSQDSPSGALYNEQFF,3,0,1,3
TRBV4-3,TRBJ2-2,CASSQELSGRTNTGELFF,3,0,1,3
TRBV4-3,TRBJ2-1,CASSQEEAQGSSYNEQFF,3,0,1,3
TRBV20-1,TRBJ2-3,CSVEKGLAGFLSRDTQYF,3,0,1,3
TRBV20-1,TRBJ2-3,CSVEKGLAGFLNRDTQYF,3,0,1,3
TRBV20-1,TRBJ1-5,CSASAGTGGLFGNQPQHF,3,2,2,5
TRBV20-1,TRBJ2-1,CSARGGLAGLSSYNEQFF,3,0,1,3
TRBV20-1,TRBJ1-5,CSARDRVSGGAGNQPQHF,3,0,1,3
TRBV20-1,TRBJ1-1,CSARDIGAFLQMNTEAFF,3,0,1,3
TRBV12-5,TRBJ2-1,CASGFYRGLANYNEQFF,3,0,1,3
TRBV7-6,TRBJ2-1,CAGSPTLKEFSYNEQFF,3,0,1,3
TRBV15,TRBJ2-1,CATSPNSRGVGGNEQFF,3,0,1,3
TRBV15,TRBJ2-3,CATSRKRAGGPTDTQYF,3,0,1,3
TRBV19,TRBJ1-5,CASSIRADTLRNQPQHF,3,0,1,3
TRBV19,TRBJ1-1,CASSIVWAGGRNTEAFF,3,0,1,3
TRBV19,TRBJ1-5,CASSRGALREGNQPQHF,3,0,1,3
TRBV18,TRBJ1-2,CASSPRPLAAPNYGYTF,3,0,1,3
TRBV18,TRBJ2-3,CASSPTFASGGSDTQYF,3,0,1,3
TRBV12-3/4,TRBJ2-2,CASSLGWLAGNTGELFF,3,0,1,3
TRBV6-2/3/5/6,TRBJ2-3,CASSLSGLAGGLDTQYF,3,0,1,3
TRBV6-2/3/5/6,TRBJ2-3,CASSLLSVPVGADTQYF,3,0,1,3
TRBV12-3/4,TRBJ2-3,CASSLILAARLPGGQYF,3,0,1,3
TRBV27,TRBJ2-1,CASSSRLLASSYNEQFF,3,0,1,3
TRBV6-2/3/5/6,TRBJ1-3,CASSYSKRAGSGNTIYF,3,0,1,3
TRBV6-2/3/5/6,TRBJ2-4,CASSYSDLLAVKNIQYF,3,0,1,3
TRBV6-2/3/5/6,TRBJ1-1,CASSYVRAENPNTEAFF,3,0,1,3
TRBV6-4,TRBJ2-2,CASSASEWGAVTGELFF,3,0,1,3
TRBV12-3/4,TRBJ2-4,CASSGSRSGLAKNIQYF,3,0,1,3
TRBV2,TRBJ2-1,CASSDGDSGRAYNEQFF,3,0,1,3
TRBV6-1,TRBJ2-1,CASSEKLAGGRRNEQFF,3,0,1,3
TRBV9,TRBJ2-3,CASSFRTSGYGADTQYF,3,0,1,3
TRBV5-6,TRBJ2-7,CASSLASVGKPSYEQYF,3,0,1,3
TRBV5-6,TRBJ1-2,CASSLEYRDSVSYGYTF,3,0,1,3
TRBV7-9,TRBJ2-7,CASSLSGNYQGAYEQYF,3,0,1,3
TRBV7-2,TRBJ2-7,CASSLQFGLAGSYEQYF,3,0,1,3
TRBV11-3,TRBJ2-2,CASSLVYNAGNTGELFF,3,0,1,3
TRBV7-2,TRBJ2-3,CASSLARVSGQAQTQYF,3,0,1,3
TRBV7-6,TRBJ1-1,CASSLAGQGAGWTEAFF,3,0,1,3
TRBV7-6,TRBJ2-1,CASSLAIPDGAYNEQFF,3,0,1,3
TRBV11-3,TRBJ2-3,CASSLGVSGRSEDTQYF,3,0,1,3
TRBV7-9,TRBJ2-7,CASSLGWTGGSHYEQYF,3,0,1,3
TRBV7-8,TRBJ2-7,CASSLDLRDRAFYEQYF,3,0,1,3
TRBV7-6,TRBJ2-2,CASSLDRVKANTGELFF,3,0,1,3
TRBV7-9,TRBJ2-6,CASSLEVGFSGANVLTF,3,0,1,3
TRBV7-9,TRBJ1-5,CASSLTGGNRGNQPQHF,3,0,1,3
TRBV7-6,TRBJ2-7,CASSSRLAGDPSYEQYF,3,0,1,3
TRBV4-2,TRBJ2-6,CASSLGTGLSGANVLTF,3,0,1,3
TRBV7-9,TRBJ2-1,CASSLGPASGTNNEQFF,3,0,1,3
TRBV5-4,TRBJ2-1,CASSLNFNRGSYNEQFF,3,0,1,3
TRBV7-9,TRBJ2-7,CASSPSPSGGLPYEQYF,3,0,1,3
TRBV4-2,TRBJ1-5,CASSQAPLGGYDQPQHF,3,0,1,3
TRBV4-2,TRBJ1-5,CASSQSTREDSNQPQHF,3,0,1,3
TRBV3-1,TRBJ2-7,CASSQAQDGGPTYEQYF,3,0,1,3
TRBV3-1,TRBJ1-6,CASSQAIGGTYNSPLHF,3,0,1,3
TRBV4-2,TRBJ2-3,CASSQIGSGRATDTQYF,3,0,1,3
TRBV27,TRBJ1-5,CASSMTGGVGGNQPQHF,3,0,1,3
TRBV11-1,TRBJ2-1,CASRKGGDGSGYNEQFF,3,2,2,5
TRBV6-2/3/5/6,TRBJ2-7,CASRPPATAQGIYEQYF,3,0,1,3
TRBV5-1,TRBJ2-5,CASSLGFATRTKETQYF,3,0,1,3
TRBV5-1,TRBJ1-2,CASSLGGLRGRSYGYTF,3,0,1,3
TRBV5-1,TRBJ2-1,CASSSGAGSQKYNEQFF,3,0,1,3
TRBV5-1,TRBJ2-7,CASSSAEGSLSSYEQYF,3,0,1,3
TRBV5-1,TRBJ2-5,CASSSGLAGAPPETQYF,3,0,1,3
TRBV4-1,TRBJ2-4,CASSQPPGELGENIQYF,3,0,1,3
TRBV4-1,TRBJ2-4,CASSQGGASIAKNIQYF,3,0,1,3
TRBV4-3,TRBJ2-5,CASSQDLGGVNQETQYF,3,0,1,3
TRBV4-3,TRBJ2-1,CASSQDQVGLAGERQFF,3,0,1,3
TRBV4-1,TRBJ1-6,CASSQEVRSSYNSPLHF,3,0,1,3
TRBV4-3,TRBJ2-1,CASSQEIGRKDQGEQFF,3,0,1,3
TRBV20-1,TRBJ2-2,CSAEWGVQGARTGELFF,3,0,1,3
TRBV20-1,TRBJ2-1,CSARVQGLADSYNEQFF,3,0,1,3
TRBV20-1,TRBJ2-3,CSARDPTSGGGTDTQYF,3,0,1,3
TRBV29-1,TRBJ2-7,CSVETGSVTSGRPEQYF,3,0,1,3
TRBV29-1,TRBJ2-5,CSVEVAGARNPGETQYF,3,0,1,3
TRBV29-1,TRBJ2-6,CSVEGRAGDSGANVLTF,3,0,1,3
TRBV12-5,TRBJ1-1,CASGSAATGRGAEAFF,3,0,1,3
TRBV3-1,TRBJ1-1,CASRHVVGLGGTEAFF,3,0,1,3
TRBV30,TRBJ2-2,CAWVSGRTSNTGELFF,3,0,1,3
TRBV12-3/4,TRBJ2-2,CAGSLGTSANTGELFF,3,0,1,3
TRBV10-3,TRBJ2-7,CAISEISSGRDNEQYF,3,0,1,3
TRBV24-1,TRBJ2-1,CATSDYSRLIYNEQFF,3,0,1,3
TRBV15,TRBJ2-3,CATSRVQRVDDDTQYF,3,0,1,3
TRBV15,TRBJ2-3,CATSREEGQGRDTQYF,3,0,1,3
TRBV19,TRBJ1-2,CASSPGRRANNYGYTF,3,7,2,10
TRBV19,TRBJ1-5,CASSILRQGSNQPQHF,3,0,1,3
TRBV19,TRBJ1-2,CASSIEADKSNYGYTF,3,0,1,3
TRBV19,TRBJ2-5,CASSIYDGTGQETQYF,3,0,1,3
TRBV11-3,TRBJ2-1,CASSGRDGGSYNEQFF,3,0,1,3
TRBV18,TRBJ1-4,CASSPRLTATNEKLFF,3,0,1,3
TRBV18,TRBJ2-4,CASSPRLAGSLNIQYF,3,0,1,3
TRBV18,TRBJ1-1,CASSPKPFAGVTEAFF,3,4,2,7
TRBV27,TRBJ2-2,CASIPTSGGYTGELFF,3,0,1,3
TRBV12-3/4,TRBJ2-1,CASIREVELPRGEQFF,3,0,1,3
TRBV19,TRBJ1-5,CASTPSGPTGHQPQHF,3,2,2,5
TRBV2,TRBJ2-3,CASTGTSGELTDTQYF,3,0,1,3
TRBV6-2/3/5/6,TRBJ1-5,CASTGLRTVIDWPQHF,3,0,1,3
TRBV6-2/3/5/6,TRBJ2-6,CASTNRRGAGANVLTF,3,0,1,3
TRBV28,TRBJ1-5,CASSFGGQGNNQPQHF,3,0,1,3
TRBV6-2/3/5/6,TRBJ1-5,CASSLVDRGKGQPQHF,3,0,1,3
TRBV6-2/3/5/6,TRBJ2-4,CASSLGTGDVKNTQYF,3,0,1,3
TRBV6-2/3/5/6,TRBJ2-5,CASSLFLWGSQETQYF,3,0,1,3
TRBV12-3/4,TRBJ2-1,CASSLSTASEYNEQFF,3,0,1,3
TRBV12-3/4,TRBJ2-1,CASSSSGSSLGNEQFF,3,6,2,9
TRBV6-2/3/5/6,TRBJ2-1,CASSSLWDRTYNEQFF,3,0,1,3
TRBV12-3/4,TRBJ1-6,CASSSLQGLHNSPLHF,3,0,1,3
TRBV6-2/3/5/6,TRBJ2-3,CASSSLAGLGSDTQYF,3,0,1,3
TRBV6-2/3/5/6,TRBJ1-5,CASSYSLRREGQPQHF,3,0,1,3
TRBV6-2/3/5/6,TRBJ1-5,CASSYSSWAVNQPQHF,3,0,1,3
TRBV6-2/3/5/6,TRBJ2-4,CASSYEDTVAKNIQYF,3,0,1,3
TRBV2,TRBJ2-1,CASSYRAGNSYNEQFF,3,0,1,3
TRBV12-3/4,TRBJ2-6,CASSPLGAAGANVLTF,3,0,1,3
TRBV2,TRBJ1-5,CASSELSALTDQPQHF,3,5,2,8
TRBV2,TRBJ2-7,CASSEPGQGRSYEQYF,3,0,1,3
TRBV6-1,TRBJ2-5,CASSEGRIRGQETQYF,3,0,1,3
TRBV6-1,TRBJ2-5,CASSEIRTAPVETQYF,3,0,1,3
TRBV6-2/3/5/6,TRBJ1-1,CASSTDRVVAGTEAFF,3,0,1,3
TRBV7-6,TRBJ1-2,CASSFGTAGDLYGYTF,3,0,1,3
TRBV7-9,TRBJ2-4,CASSFQAGGPGDIQYF,3,0,1,3
TRBV5-5,TRBJ1-2,CASSLVGQGATYGYTF,3,11,2,14
TRBV7-9,TRBJ2-3,CASSLGGGRSTDTQYF,3,0,1,3
TRBV5-4,TRBJ2-3,CASSLRLAGPVDTQYF,3,0,1,3
TRBV11-2,TRBJ2-6,CASSLSVHSGANVLTF,3,0,1,3
TRBV7-2,TRBJ1-2,CASSLQSGGTNYGYTF,3,0,1,3
TRBV6-2/3/5/6,TRBJ2-5,CASSLVASGRKETQYF,3,0,1,3
TRBV7-3,TRBJ1-1,CASSLVGGGGYTEAFF,3,0,1,3
TRBV11-3,TRBJ2-3,CASSLAAGASTDTQYF,3,0,1,3
TRBV7-9,TRBJ2-1,CASSLAGQGAGNEQFF,3,0,1,3
TRBV7-2,TRBJ2-1,CASSLEADSSYNEQFF,3,0,1,3
TRBV11-3,TRBJ2-1,CASSLEWGQGRNEQFF,3,0,1,3
TRBV7-2,TRBJ2-3,CASSLTESSGMDTQYF,3,2,2,5
TRBV7-2,TRBJ2-1,CASSLSPSGRAREQFF,3,0,1,3
TRBV7-9,TRBJ2-1,CASSLNEGAPYNEQFF,3,0,1,3
TRBV7-6,TRBJ2-1,CASSSRLAGEYDEQFF,3,0,1,3
TRBV7-9,TRBJ2-1,CASSSRQTSSYNEQFF,3,0,1,3
TRBV11-3,TRBJ2-1,CASSSRGAGSYNEQFF,3,6,2,9
TRBV4-2,TRBJ2-5,CASSSGGWGPGETQYF,3,0,1,3
TRBV5-6,TRBJ2-7,CASSSDGGRAVHEQYF,3,0,1,3
TRBV7-2,TRBJ2-3,CASSSRTDGATSTQYF,3,0,1,3
TRBV4-2,TRBJ2-3,CASSSLAGGRADTQYF,3,0,1,3
TRBV3-1,TRBJ2-5,CASSLGTSGEKETQYF,3,0,1,3
TRBV3-1,TRBJ2-1,CASSLALADLYNEQFF,3,0,1,3
TRBV7-2,TRBJ2-2,CASSLSWSMNTGELFF,3,0,1,3
TRBV7-2,TRBJ2-1,CASSPQLGGDYNEQFF,3,0,1,3
TRBV14,TRBJ2-1,CASSPTGQKIYNEQFF,3,3,2,6
TRBV7-2,TRBJ2-5,CASSPSGGSLQETQYF,3,3,2,6
TRBV7-2,TRBJ2-6,CASSRDRHSGANVLTF,3,0,1,3
TRBV9,TRBJ1-1,CASSRGTGGMNTEAFF,3,0,1,3
TRBV4-2,TRBJ1-5,CASSHIGGGGNQPQHF,3,0,1,3
TRBV7-9,TRBJ1-5,CASSHWTGGSNQPQHF,3,0,1,3
TRBV11-2,TRBJ2-6,CASSQRDASGANVLTF,3,0,1,3
TRBV3-1,TRBJ2-7,CASSQVRGGQGSEQYF,3,0,1,3
TRBV14,TRBJ1-2,CASSQGQGGYGYGYTF,3,0,1,3
TRBV14,TRBJ2-7,CASSQGQGIKRYEQYF,3,0,1,3
TRBV4-2,TRBJ2-3,CASSQGDGVSTDTQYF,3,0,1,3
TRBV4-2,TRBJ1-5,CASSQDEGAGNQPQHF,3,0,1,3
TRBV9,TRBJ2-2,CASSVGTGANTGELFF,3,0,1,3
TRBV9,TRBJ2-7,CASSVAMGGSSYEQYF,3,0,1,3
TRBV6-4,TRBJ1-6,CASSVGPRGQDSPLHF,3,0,1,3
TRBV7-2,TRBJ2-5,CASSATGRIFEETQYF,3,0,1,3
TRBV7-2,TRBJ2-1,CASSARLAGGDNEQFF,3,0,1,3
TRBV5-4,TRBJ2-2,CASSGGPAGYTGELFF,3,0,1,3
TRBV7-9,TRBJ2-7,CASSGPTRTGSYEQYF,3,0,1,3
TRBV5-4,TRBJ2-1,CASSGRLAAPYNEQFF,3,0,1,3
TRBV7-2,TRBJ2-6,CASSKTWDYGANVLTF,3,0,1,3
TRBV7-2,TRBJ2-7,CASRYDFGTNVYEQYF,3,0,1,3
TRBV6-2/3/5/6,TRBJ1-1,CASRHLKQVSNTEAFF,3,0,1,3
TRBV12-3/4,TRBJ2-7,CASKVEIGTPTHEQYF,3,3,2,6
TRBV5-1,TRBJ2-1,CASSFRSSGIYNEQFF,3,0,1,3
TRBV5-1,TRBJ2-7,CASSLSSGRPTYEQYF,3,0,1,3
TRBV5-1,TRBJ2-3,CASSLPSLAATDTQYF,3,0,1,3
TRBV5-1,TRBJ2-1,CASSLGGAGRDNEQFF,3,0,1,3
TRBV5-1,TRBJ2-7,CASSLGTGTSAYEQYF,3,0,1,3
TRBV5-1,TRBJ2-5,CASSLEGSGSSGTQYF,3,0,1,3
TRBV4-3,TRBJ2-3,CASSSGLAGITDTQYF,3,0,1,3
TRBV4-3,TRBJ1-3,CASSLNHRSSGNTIYF,3,0,1,3
TRBV4-3,TRBJ2-3,CASSLFSGRAADTQYF,3,0,1,3
TRBV4-1,TRBJ2-7,CASSPTMGLNPTGQYF,3,0,1,3
TRBV4-3,TRBJ2-7,CASSQPNRGSRGEQYF,3,0,1,3
TRBV4-1,TRBJ2-6,CASSQVIGSGANVLTF,3,0,1,3
TRBV4-3,TRBJ2-7,CASSQGIPDSSYEQYF,3,0,1,3
TRBV4-3,TRBJ2-6,CASSQDGFSGANVLTF,3,4,2,7
TRBV4-3,TRBJ2-7,CASSQEGAGGVYEQYF,3,0,1,3
TRBV4-1,TRBJ2-3,CASSARTGGGTDTQYF,3,0,1,3
TRBV4-1,TRBJ1-2,CASSAGRARKVYGYTF,3,0,1,3
TRBV20-1,TRBJ2-1,CSARGRSGGRFGEQFF,3,0,1,3
TRBV20-1,TRBJ1-1,CSARFHSRALNTEAFF,3,0,1,3
TRBV20-1,TRBJ2-1,CSARVTSGEYNNEQFF,3,0,1,3
TRBV20-1,TRBJ2-3,CSARDMVAGRTDTQYF,3,0,1,3
TRBV20-1,TRBJ2-7,CSAREGLAGVRYEQYF,3,0,1,3
TRBV29-1,TRBJ2-3,CSVRTMGWDSTDTQYF,3,0,1,3
TRBV29-1,TRBJ2-7,CSVETGRTDSAYEQYF,3,0,1,3
TRBV29-1,TRBJ2-5,CSVEVGIAADLWTQYF,3,0,1,3
TRBV29-1,TRBJ2-7,CSVEGLLGADPCEQYF,3,0,1,3
TRBV29-1,TRBJ2-7,CSVEDPVLGSSYEQYF,3,0,1,3
TRBV29-1,TRBJ2-7,CSVEKSGQGVSYEQYF,3,0,1,3
TRBV29-1,TRBJ2-7,CSVTPGQEVALGEQYF,3,2,2,5
TRBV29-1,TRBJ2-1,CSATSIQTGIYNEQFF,3,0,1,3
TRBV12-3/4,TRBJ2-3,RASRPGTSGITDTQYF,3,0,1,3
TRBV30,TRBJ2-3,CAWSAGGRATDTQYF,3,0,1,3
TRBV30,TRBJ2-1,CAWSERTRTNNEQFF,3,0,1,3
TRBV30,TRBJ2-1,CAWNRGGGPNNEQFF,3,0,1,3
TRBV10-3,TRBJ2-5,CAIIVAGGPGETQYF,3,0,1,3
TRBV10-3,TRBJ2-7,CAISSGTGGIYEQYF,3,0,1,3
TRBV10-3,TRBJ1-1,CAISEPSLTGSEAFF,3,0,1,3
TRBV10-3,TRBJ2-7,CAIRPGTGGLLEQYF,3,0,1,3
TRBV10-3,TRBJ2-3,CATTSGQGEADTQYF,3,0,1,3
TRBV15,TRBJ2-1,CATSRLAGVGNEQFF,3,0,1,3
TRBV15,TRBJ2-1,CATSRPGLAGNEQFF,3,0,1,3
TRBV15,TRBJ2-3,CATSRDLLAPDTQYF,3,0,1,3
TRBV15,TRBJ1-5,CATSRDRDAYQPQHF,3,0,1,3
TRBV19,TRBJ2-5,CASTQLAGGQETQYF,3,0,1,3
TRBV19,TRBJ2-3,CASSLEGRSTDTQYF,3,0,1,3
TRBV19,TRBJ2-1,CASSPRQGAYNEQFF,3,0,1,3
TRBV19,TRBJ1-1,CASSPRTGTGTEAFF,3,6,2,9
TRBV19,TRBJ2-1,CASSITDSLGNEQFF,3,0,1,3
TRBV19,TRBJ2-7,CASSTESGGPYEQYF,3,0,1,3
TRBV18,TRBJ2-7,CASSSEQTGPGEQYF,3,0,1,3
TRBV18,TRBJ2-4,CASSLDWGAKNIQYF,3,0,1,3
TRBV18,TRBJ1-5,CASSPGTTSNQPQHF,3,0,1,3
TRBV18,TRBJ1-1,CASSPPSSGGGWAFF,3,0,1,3
TRBV18,TRBJ1-4,CASSRARDVNEKLFF,3,0,1,3
TRBV18,TRBJ1-2,CASSTDTGTGNGYTF,3,0,1,3
TRBV2,TRBJ2-7,CASCYRRGTSYEQYF,3,0,1,3
TRBV6-2/3/5/6,TRBJ2-5,CASLPGLAVKETQYF,3,0,1,3
TRBV12-3/4,TRBJ2-5,CASAPFGRIQETQYF,3,0,1,3
TRBV27,TRBJ1-6,CASDLWGLGYSPLHF,3,0,1,3
TRBV6-2/3/5/6,TRBJ1-2,CASIQGWGADYGYTF,3,0,1,3
TRBV12-3/4,TRBJ2-3,CASITSGLSTDTQYF,3,0,1,3
TRBV7-9,TRBJ2-1,CASTLSGGVYNEQFF,3,0,1,3
TRBV7-2,TRBJ2-1,CASTYWTSGYNEQFF,3,3,2,6
TRBV11-2,TRBJ2-1,CASTPGGGGVNEQFF,3,0,1,3
TRBV28,TRBJ2-7,CASSFNGEPSYEQYF,3,0,1,3
TRBV27,TRBJ1-1,CASSFHPSVEPLAFF,3,0,1,3
TRBV12-3/4,TRBJ2-7,CASSLGLAGAYEQYF,3,0,1,3
TRBV6-2/3/5/6,TRBJ2-2,CASSLSVSNTGELFF,3,0,1,3
TRBV6-2/3/5/6,TRBJ1-1,CASSLSWGGGTEAFF,3,7,2,10
TRBV12-3/4,TRBJ1-2,CASSLPGQGIYGYTF,3,0,1,3
TRBV27,TRBJ1-1,CASSLQGRSNTEAFF,3,0,1,3
TRBV6-2/3/5/6,TRBJ2-2,CASSSLDGSPWELFF,3,0,1,3
TRBV6-2/3/5/6,TRBJ2-7,CASSYSKDRPYEQYF,3,0,1,3
TRBV6-2/3/5/6,TRBJ1-6,CASSYLRAYNSPLHF,3,6,2,9
TRBV6-2/3/5/6,TRBJ2-1,CASSYPWSSGNEQFF,3,0,1,3
TRBV6-2/3/5/6,TRBJ2-5,CASSYRDRPQETQYL,3,0,1,3
TRBV6-2/3/5/6,TRBJ1-1,CASSYRDKMNTEAFF,3,0,1,3
TRBV12-3/4,TRBJ2-1,CASSLRDRVIDEQFF,3,0,1,3
TRBV12-3/4,TRBJ2-6,CASSLTRSGANVLTF,3,0,1,3
TRBV6-2/3/5/6,TRBJ2-1,CASSLTGSSYNEQFF,3,0,1,3
TRBV6-2/3/5/6,TRBJ2-5,CASSPGTGVGETQYY,3,0,1,3
TRBV6-2/3/5/6,TRBJ2-1,CASSPRTSGSNEQFF,3,0,1,3
TRBV10-2,TRBJ1-2,CASSPQSWVWDGYTF,3,0,1,3
TRBV6-2/3/5/6,TRBJ2-7,CASSRQQGGPYEQYF,3,0,1,3
TRBV6-2/3/5/6,TRBJ1-1,CASSRDRGGNTEAFF,3,0,1,3
TRBV6-1,TRBJ2-2,CASSQRDFFTGELFF,3,0,1,3
TRBV6-1,TRBJ1-1,CASSVRDRVNTEAFF,3,0,1,3
TRBV6-1,TRBJ1-4,CASSVDRGGGEKLFF,3,0,1,3
TRBV6-1,TRBJ1-1,CASSAPGQMNTEAFF,3,0,1,3
TRBV5-4,TRBJ2-7,CASSGAGVTAYEQYF,3,0,1,3
TRBV6-1,TRBJ1-2,CASSDKGWDNYGYTF,3,0,1,3
TRBV25-1,TRBJ1-1,CASSEGRGPNTEAFF,3,0,1,3
TRBV6-1,TRBJ2-5,CASSETSGGQETQYF,3,3,2,6
TRBV6-1,TRBJ2-7,CASSELSGRALEQYF,3,0,1,3
TRBV6-1,TRBJ2-3,CASSEYDRGTDTQYF,3,0,1,3
TRBV2,TRBJ1-6,CASSEQGGSNSPLHF,3,0,1,3
TRBV6-1,TRBJ1-2,CASSEMLIRGYGYTF,3,0,1,3
TRBV28,TRBJ2-5,CASSTPQTYQETQYF,3,0,1,3
TRBV6-4,TRBJ2-5,CASSRLAGARETQYF,3,0,1,3
TRBV6-1,TRBJ2-7,CASSKGQPISYEQYF,3,0,1,3
TRBV5-4,TRBJ1-1,CASSFNQGENAEAFF,3,0,1,3
TRBV7-2,TRBJ2-1,CASSFKRGNYNEQFF,3,0,1,3
TRBV5-6,TRBJ1-2,CASSLLRSDSYGYTF,3,0,1,3
TRBV5-6,TRBJ1-5,CASSLVQTGNQPQHF,3,0,1,3
TRBV5-4,TRBJ1-1,CASSLAGQVHTEAFF,3,0,1,3
TRBV5-4,TRBJ2-7,CASSLADRGHYEQYF,3,0,1,3
TRBV11-1,TRBJ2-2,CASSLGQGFTGELFF,3,0,1,3
TRBV5-6,TRBJ2-3,CASSLGTGGPDTQYF,3,0,1,3
TRBV5-4,TRBJ2-5,CASSLRREGQETQYF,3,0,1,3
TRBV7-6,TRBJ2-1,CASSLYNSRDYEQFF,3,0,1,3
TRBV7-9,TRBJ1-1,CASSLLGRYNTEAFF,3,0,1,3
TRBV7-9,TRBJ1-1,CASSLPGQGTTEAFF,3,0,1,3
TRBV7-2,TRBJ2-2,CASSLRTANTGELFF,3,0,1,3
TRBV7-2,TRBJ2-1,CASSLVNVAGVEQFF,3,0,1,3
TRBV7-6,TRBJ2-4,CASSLALGGRDIQYF,3,0,1,3
TRBV7-8,TRBJ1-2,CASSLAGQGMGGYTF,3,0,1,3
TRBV6-2/3/5/6,TRBJ1-1,CASSLGRGRYTEAFF,3,0,1,3
TRBV7-3,TRBJ2-3,CASSLGGQGPDTQYF,3,0,1,3
TRBV7-9,TRBJ2-7,CASSLGTGGTYEQYF,3,0,1,3
TRBV7-2,TRBJ2-7,CASSLGGTTIYEQYF,3,0,1,3
TRBV7-3,TRBJ2-1,CASSLMSGRDNEQFF,3,0,1,3
TRBV7-2,TRBJ2-1,CASSLTSGTYNEQFF,3,0,1,3
TRBV7-9,TRBJ2-3,CASSLNGGGADTQYF,3,0,1,3
TRBV7-9,TRBJ2-3,CASSSLSGHTDTQYF,3,0,1,3
TRBV7-2,TRBJ1-5,CASSWDRASLEPQHF,3,0,1,3
TRBV6-2/3/5/6,TRBJ1-5,CASSYQDPGFQPQHF,3,0,1,3
TRBV7-2,TRBJ2-7,CASSLRTGEHYEQYF,3,0,1,3
TRBV7-2,TRBJ2-7,CASSLAGGASYEQYF,3,0,1,3
TRBV7-2,TRBJ1-4,CASSLGQIGFEKLFF,3,0,1,3
TRBV5-6,TRBJ2-2,CASSLRQVTTGELFF,3,5,2,8
TRBV7-8,TRBJ2-1,CASSLMFRSYNEQFF,3,0,1,3
TRBV7-9,TRBJ2-5,CASSPRGGDRETQYF,3,0,1,3
TRBV3-1,TRBJ2-1,CASSPQEARDNEQSF,3,0,1,3
TRBV5-5,TRBJ1-2,CASSPVGTGNYGYTF,3,0,1,3
TRBV6-2/3/5/6,TRBJ1-2,CASSPGTGLNYGYTF,3,0,1,3
TRBV7-2,TRBJ2-1,CASSPGTGRYNEQFF,3,0,1,3
TRBV7-3,TRBJ2-3,CASSPSPARTDTQYF,3,0,1,3
TRBV7-2,TRBJ2-1,CASSPGTSGYNEQFF,3,5,2,8
TRBV7-8,TRBJ2-1,CASSPLAGSYNEQFF,3,0,1,3
TRBV6-2/3/5/6,TRBJ1-5,CASSPRRTGNQPQHF,3,0,1,3
TRBV7-2,TRBJ1-6,CASSPGTGRDSPLHF,3,0,1,3
TRBV7-9,TRBJ2-3,CASSPDGYRRDTQYF,3,0,1,3
TRBV12-3/4,TRBJ1-2,CASSPNRANPYGYTF,3,0,1,3
TRBV4-2,TRBJ1-2,CASSRAGQGSGGYTF,3,0,1,3
TRBV27,TRBJ2-5,CASSRDRGIGETQYF,3,0,1,3
TRBV3-1,TRBJ2-3,CASSQGGGRTDTQYF,3,0,1,3
TRBV11-2,TRBJ2-5,CASSQGLAGGETQYF,3,0,1,3
TRBV4-2,TRBJ2-7,CASSQEDLATYEQYF,3,0,1,3
TRBV3-1,TRBJ2-5,CASSQVLAGRETQYF,3,9,2,12
TRBV14,TRBJ2-1,CASSQASSGRGEQFF,3,0,1,3
TRBV4-2,TRBJ2-4,CASSQAVNPSHIQYF,3,0,1,3
TRBV14,TRBJ1-2,CASSQGARVTYGYTF,3,0,1,3
TRBV3-1,TRBJ1-4,CASSQDWATNEKLFF,3,0,1,3
TRBV3-1,TRBJ2-7,CASSQEPTLPSEQYF,3,0,1,3
TRBV3-1,TRBJ2-5,CASSQEVGTQETQYF,3,0,1,3
TRBV9,TRBJ2-2,CASSVAPTSSGELFF,3,0,1,3
TRBV9,TRBJ2-5,CASSVAGTGQETQYF,3,0,1,3
TRBV9,TRBJ2-1,CASSVDGGRADEQFF,3,0,1,3
TRBV27,TRBJ1-5,CASSKTKIRGQPQHF,3,0,1,3
TRBV12-3/4,TRBJ2-3,CASRSGTRSTDTQYF,3,0,1,3
TRBV6-4,TRBJ2-7,CASRVDRGASYEQYF,3,0,1,3
TRBV6-2/3/5/6,TRBJ2-1,CASRGTSGPGAEQFF,3,0,1,3
TRBV5-4,TRBJ2-3,CASREAGGPRDTQYF,3,0,1,3
TRBV6-1,TRBJ1-1,CASRSGGGSVREAFF,3,0,1,3
TRBV7-6,TRBJ2-3,CASRPVSGGADTQYF,3,0,1,3
TRBV11-2,TRBJ1-1,CASRRVPGGRTEAFF,3,7,2,10
TRBV7-2,TRBJ2-7,CASRELSGGANEQYF,3,0,1,3
TRBV6-1,TRBJ1-1,CASREGRGMNTEAFF,3,0,1,3
TRBV2,TRBJ2-4,CASREGGLAKNIQYF,3,0,1,3
TRBV13,TRBJ2-7,CASNYQTGSFGEQYF,3,0,1,3
TRBV5-1,TRBJ2-3,CATKLGGSLSDTQYF,3,0,1,3
TRBV5-1,TRBJ2-1,CASNPLRGSYNEQFF,3,0,1,3
TRBV4-1,TRBJ1-2,CASLAPGQINYGYTF,3,0,1,3
TRBV4-3,TRBJ2-1,CASTPLAGDAGEQFF,3,0,1,3
TRBV5-1,TRBJ2-6,CASSLVGLGANVLTF,3,0,1,3
TRBV5-1,TRBJ1-1,CASSLAGPSSTEAFF,3,0,1,3
TRBV5-1,TRBJ2-7,CASSLPGSSSYEQYF,3,0,1,3
TRBV5-1,TRBJ2-5,CASSSGQGQQETQYF,3,0,1,3
TRBV5-1,TRBJ2-5,CASSLEGRNQETQYF,3,0,1,3
TRBV4-1,TRBJ2-4,CASSLSGGTKNIQYF,3,0,1,3
TRBV5-1,TRBJ2-5,CASSPRPYSAETQYF,3,0,1,3
TRBV5-1,TRBJ1-6,CASSPTSGADSPLHF,3,0,1,3
TRBV5-1,TRBJ2-1,CASSPLGGVYNEQFF,3,0,1,3
TRBV4-3,TRBJ1-4,CASSHRGRSNEKLFF,3,0,1,3
TRBV4-1,TRBJ1-2,CASSHQDRENYGYTF,3,8,2,11
TRBV4-3,TRBJ1-2,CASSQDGTASGGYTF,3,0,1,3
TRBV4-1,TRBJ2-7,CASSQTQVPVLEQYF,3,0,1,3
TRBV5-1,TRBJ2-7,CASSQGTVYYYEQYF,3,0,1,3
TRBV4-1,TRBJ1-4,CASSQDTGGGEKLFF,3,0,1,3
TRBV4-1,TRBJ1-1,CASSQDRQYSTEAFF,3,4,2,7
TRBV4-1,TRBJ1-2,CASSVPGGSNYGYTF,3,0,1,3
TRBV5-1,TRBJ1-1,CASSEKKDTDTEAFF,3,0,1,3
TRBV5-1,TRBJ2-5,CASSKDRGRLETQYF,3,0,1,3
TRBV5-1,TRBJ2-1,CASNLQGALYNEQFF,3,0,1,3
TRBV20-1,TRBJ2-2,CSARAGGAGTGELFF,3,0,1,3
TRBV20-1,TRBJ2-7,CSARSGAGAGYEQYF,3,0,1,3
TRBV20-1,TRBJ2-3,CSARFGSGSPDTQYF,3,0,1,3
TRBV20-1,TRBJ1-3,CSARGSWDIQNAIYF,3,0,1,3
TRBV20-1,TRBJ1-4,CSARDWKETNEKLFF,3,0,1,3
TRBV20-1,TRBJ2-1,CSARDPAGHYNEQFF,3,0,1,3
TRBV20-1,TRBJ2-7,CSARDGGQESNEQYF,3,0,1,3
TRBV20-1,TRBJ2-1,CSARDGGLPYNEQFF,3,3,2,6
TRBV20-1,TRBJ1-4,CSARDMGTTNEKLFF,3,0,1,3
TRBV20-1,TRBJ2-7,CSARELGLPIGEQYF,3,0,1,3
TRBV20-1,TRBJ2-1,CSAREPERDSNEQFF,3,0,1,3
TRBV20-1,TRBJ2-1,CSAREWERFSYEQFF,3,0,1,3
TRBV20-1,TRBJ1-5,CSARRADGGNQPQHF,3,0,1,3
TRBV20-1,TRBJ1-5,CSAPGTGRFNQPQHF,3,0,1,3
TRBV20-1,TRBJ2-7,CSARTGGTFSYEQYF,3,0,1,3
TRBV20-1,TRBJ2-1,CSATRPSGGYNEQFF,3,0,1,3
TRBV29-1,TRBJ2-7,CSVSVFGTGGVEQYF,3,0,1,3
TRBV29-1,TRBJ2-1,CSVRSGRADINEQFF,3,0,1,3
TRBV29-1,TRBJ1-4,CSVAGNTATNEKLFF,3,0,1,3
TRBV29-1,TRBJ2-1,CSVDRGGSPTREQFF,3,0,1,3
TRBV29-1,TRBJ2-3,CSVESGRGRTDTQYF,3,0,1,3
TRBV29-1,TRBJ2-5,CSVELRGGLVETQYF,3,0,1,3
TRBV29-1,TRBJ1-1,CSVPEGATGTYEAFF,3,0,1,3
TRBV29-1,TRBJ1-2,CSAASTGTENYGYTF,3,0,1,3
TRBV29-1,TRBJ2-4,CSATAGGPANNIQYF,3,0,1,3
TRBV12-5,TRBJ2-5,CASGARQSGETQYL,3,0,1,3
TRBV30,TRBJ2-2,CAWSLPRDTGELFF,3,0,1,3
TRBV30,TRBJ1-6,CAWRGGSYNSPLHF,3,0,1,3
TRBV15,TRBJ1-4,CAAAPGTGDEKLFF,3,0,1,3
TRBV10-3,TRBJ1-2,CAIPKIDGTYGYTF,3,0,1,3
TRBV10-3,TRBJ1-1,CAISPGTPDVAAFF,3,0,1,3
TRBV10-3,TRBJ1-1,CAISESRGNTEAFF,3,0,1,3
TRBV10-3,TRBJ1-1,CAISEPVDSRGAFF,3,0,1,3
TRBV24-1,TRBJ2-7,CATSESAGTYEQYF,3,0,1,3
TRBV27,TRBJ1-1,CASSTGGAVTEAFF,3,0,1,3
TRBV2,TRBJ2-5,CASPSQGGVETQYF,3,0,1,3
TRBV19,TRBJ1-1,CASIQTGLNTEAFF,3,0,1,3
TRBV19,TRBJ1-3,CASSPPVSGNTIYF,3,0,1,3
TRBV19,TRBJ2-7,CASSVDGSSYEQYF,3,4,2,7
TRBV19,TRBJ1-3,CASSILGAGNTIYF,3,0,1,3
TRBV19,TRBJ1-4,CASSIHQGNEKLFF,3,0,1,3
TRBV19,TRBJ1-2,CASSIATVNYGYTF,3,0,1,3
TRBV19,TRBJ2-5,CASSIRGYQETQYF,3,0,1,3
TRBV19,TRBJ2-1,CASSTGLAFNEQFF,3,0,1,3
TRBV19,TRBJ1-1,CASSTGGANTEAFF,3,0,1,3
TRBV19,TRBJ2-1,CASSRTALNNEQFF,3,0,1,3
TRBV19,TRBJ1-2,CASSPTPGVYGYTF,3,0,1,3
TRBV19,TRBJ2-1,CASSRSSGYNEQFF,3,0,1,3
TRBV18,TRBJ1-1,CASSPEGDNPEAFF,3,2,2,5
TRBV18,TRBJ2-7,CASSPGSGAYEQYF,3,0,1,3
TRBV18,TRBJ1-1,CASSPKGLDTEAFF,3,0,1,3
TRBV5-6,TRBJ2-5,CASRDREYQETQYF,3,0,1,3
TRBV19,TRBJ1-5,CASATARSNQPQHF,3,0,1,3
TRBV12-3/4,TRBJ2-7,CASADSLNSYEQYF,3,0,1,3
TRBV7-2,TRBJ2-5,CASGLARRVETQYF,3,0,1,3
TRBV7-2,TRBJ1-2,CASISAGRNYGYTF,3,0,1,3
TRBV2,TRBJ1-6,CASTSRTLGSSLHF,3,0,1,3
TRBV12-3/4,TRBJ1-1,CASTADGSNTEAFF,3,0,1,3
TRBV2,TRBJ2-2,CASTTAVNTGELFF,3,0,1,3
TRBV7-9,TRBJ1-1,CASTSDSWDREAFF,3,0,1,3
TRBV6-2/3/5/6,TRBJ2-7,CASTPSGRSYEQYF,3,0,1,3
TRBV11-2,TRBJ2-1,CASTQLAGYNEQFF,3,0,1,3
TRBV7-2,TRBJ2-7,CASTAPSGNYEQYF,3,0,1,3
TRBV12-3/4,TRBJ1-1,CASTAGLGNTEAFF,3,0,1,3
TRBV12-3/4,TRBJ1-5,CASSFSVRYQPQHF,3,0,1,3
TRBV12-3/4,TRBJ1-1,CASSFREMNTEAFF,3,0,1,3
TRBV12-3/4,TRBJ1-1,CASSFGQLNTEAFF,3,0,1,3
TRBV6-2/3/5/6,TRBJ1-5,CASSLAGDNQPQHF,3,0,1,3
TRBV12-3/4,TRBJ2-1,CASSLGSGYNEQFF,3,0,1,3
TRBV6-2/3/5/6,TRBJ1-5,CASSLLGRNQPQHF,3,0,1,3
TRBV12-3/4,TRBJ1-1,CASSLQEIRSEAFF,3,0,1,3
TRBV12-3/4,TRBJ2-7,CASSLQGQAYEQYF,3,0,1,3
TRBV28,TRBJ2-2,CASSLVRTPGELFF,3,0,1,3
TRBV6-2/3/5/6,TRBJ2-7,CASSSQGSSYEQYF,3,0,1,3
TRBV12-3/4,TRBJ2-1,CASSSTDRGGEQFF,3,0,1,3
TRBV12-3/4,TRBJ2-1,CASSSTGRNNEQFF,3,0,1,3
TRBV11-2,TRBJ2-4,CASSSPRGKNIQYF,3,0,1,3
TRBV6-2/3/5/6,TRBJ1-4,CASSSQGRGEKLFF,3,0,1,3
TRBV6-2/3/5/6,TRBJ1-2,CASSWGLGYYGYTF,3,0,1,3
TRBV6-2/3/5/6,TRBJ1-5,CASSWDSGNQPQHF,3,5,2,8
TRBV12-3/4,TRBJ2-7,CASSWDSSSYEQYF,3,0,1,3
TRBV12-3/4,TRBJ1-1,CASSWTSANTEAFF,3,0,1,3
TRBV6-2/3/5/6,TRBJ1-6,CASSYGQGNSPLHF,3,0,1,3
TRBV6-2/3/5/6,TRBJ2-1,CASSYSRQGNEQFF,3,0,1,3
TRBV6-2/3/5/6,TRBJ2-7,CASSYSGGSYEQYF,3,0,1,3
TRBV6-2/3/5/6,TRBJ2-5,CASSYSERVETQYF,3,5,2,8
TRBV6-2/3/5/6,TRBJ2-7,CASSYSTGGNEQYF,3,7,2,10
TRBV6-2/3/5/6,TRBJ1-5,CASSYSTGGQPQHF,3,0,1,3
TRBV7-9,TRBJ1-1,CASSYPPGVIEAFF,3,0,1,3
TRBV6-2/3/5/6,TRBJ2-1,CASSYAGGLAEQFF,3,0,1,3
TRBV6-2/3/5/6,TRBJ2-5,CASSYGGQQETQYF,3,0,1,3
TRBV6-2/3/5/6,TRBJ1-1,CASSYMGVNTEAFF,3,0,1,3
TRBV6-2/3/5/6,TRBJ2-2,CASSYNAPTGELFF,3,0,1,3
TRBV6-2/3/5/6,TRBJ2-7,CASSLRYIHCEQYF,3,0,1,3
TRBV6-2/3/5/6,TRBJ1-5,CASSLRQGGRPQHF,3,0,1,3
TRBV28,TRBJ2-3,CASSLTLTSDTQYF,3,0,1,3
TRBV27,TRBJ2-7,CASSPRGVVYEQYF,3,0,1,3
TRBV6-2/3/5/6,TRBJ1-1,CASSPGRGRTEAFF,3,0,1,3
TRBV2,TRBJ2-2,CASSRTRNTGELFF,3,8,2,11
TRBV7-9,TRBJ2-1,CASSRGGGYNEQFF,3,0,1,3
TRBV12-3/4,TRBJ2-5,CASSHTRGVETQYF,3,0,1,3
TRBV12-3/4,TRBJ2-7,CASSQLGGSYEQYF,3,4,2,7
TRBV6-1,TRBJ1-5,CASSQDRTYQAQHF,3,0,1,3
TRBV12-3/4,TRBJ2-2,CASSVGGDTGELFF,3,0,1,3
TRBV6-4,TRBJ1-1,CASSAQFGTDEAFF,3,0,1,3
TRBV6-1,TRBJ2-4,CASSAGTVKNIQYF,3,0,1,3
TRBV2,TRBJ1-5,CASSGRINNQPQHF,3,0,1,3
TRBV2,TRBJ1-4,CASSGQGLREKLFF,3,0,1,3
TRBV6-1,TRBJ1-2,CASSGTPGWYGYTF,3,0,1,3
TRBV6-4,TRBJ1-1,CASSDSGDGDEAFF,3,0,1,3
TRBV6-1,TRBJ2-5,CASSELSVKETQYF,3,0,1,3
TRBV2,TRBJ1-1,CASSELQGATEAFF,3,4,2,7
TRBV25-1,TRBJ1-4,CASSEWGRGRKLFF,3,0,1,3
TRBV6-1,TRBJ1-1,CASSERQGISEAFF,3,0,1,3
TRBV6-1,TRBJ2-1,CASSEVEINNEQFF,3,0,1,3
TRBV6-1,TRBJ1-1,CASSEGAENTEAFF,3,0,1,3
TRBV6-2/3/5/6,TRBJ2-2,CASSMGLDTGELFF,3,0,1,3
TRBV5-4,TRBJ1-1,CASSFQGVGTGAFF,3,0,1,3
TRBV11-2,TRBJ2-7,CASSFGGLRNEQYF,3,0,1,3
TRBV11-2,TRBJ2-1,CASSFSGRGYEQFF,3,0,1,3
TRBV7-9,TRBJ2-3,CASSFFSGPDTQYF,3,0,1,3
TRBV7-2,TRBJ2-1,CASSFWGSAGEQFF,3,0,1,3
TRBV5-5,TRBJ1-5,CASSFGQGAQPQHF,3,0,1,3
TRBV5-6,TRBJ1-1,CASSLGGLNTEAFF,3,0,1,3
TRBV7-8,TRBJ2-1,CASSLTGDHNEQFF,3,0,1,3
TRBV7-9,TRBJ1-4,CASSLPAGPEKLFF,3,0,1,3
TRBV7-9,TRBJ2-6,CASSLPPGANVLTF,3,2,2,5
TRBV7-6,TRBJ1-1,CASSLRGPNTEAFF,3,0,1,3
TRBV7-8,TRBJ1-5,CASSLRQGGQPQHF,3,3,2,6
TRBV7-7,TRBJ2-5,CASSLQGQGETQYF,3,0,1,3
TRBV7-6,TRBJ1-1,CASSLAPPGTEAFF,3,0,1,3
TRBV7-2,TRBJ2-2,CASSLAPMTGELFF,3,0,1,3
TRBV6-2/3/5/6,TRBJ2-7,CASSLAGGPYEQYF,3,0,1,3
TRBV7-9,TRBJ1-2,CASSLAEGTYGYTF,3,0,1,3
TRBV7-2,TRBJ1-2,CASSLGGATPGYTF,3,0,1,3
TRBV7-8,TRBJ2-7,CASSLGTGDHEQYF,3,0,1,3
TRBV7-2,TRBJ1-4,CASSLGKGNEKLFF,3,0,1,3
TRBV7-9,TRBJ2-2,CASSLDYHTGELFF,3,0,1,3
TRBV11-1,TRBJ1-1,CASSLRGGLSEAFF,3,0,1,3
TRBV6-2/3/5/6,TRBJ1-1,CASSSHRRSSEAFF,3,0,1,3
TRBV6-2/3/5/6,TRBJ2-1,CASSSGTLYNEQFF,3,0,1,3
TRBV7-6,TRBJ1-2,CASSSRGANYGYTF,3,0,1,3
TRBV7-2,TRBJ1-5,CASSSDGSNQPQHF,3,0,1,3
TRBV7-6,TRBJ2-3,CASSSLRETDTQYF,3,0,1,3
TRBV7-9,TRBJ1-1,CASSSLGSDTEAFF,3,0,1,3
TRBV5-4,TRBJ2-1,CASSSMEGYNEQFF,3,0,1,3
TRBV9,TRBJ1-2,CASSPSWVNYGYTF,3,0,1,3
TRBV6-2/3/5/6,TRBJ2-3,CASSPSQGSDTQYF,3,0,1,3
TRBV7-9,TRBJ2-7,CASSPPRETYEQYF,3,0,1,3
TRBV12-3/4,TRBJ1-1,CASSPRTPGTEAFF,3,8,2,11
TRBV11-2,TRBJ2-5,CASSPQQYQETQYF,3,0,1,3
TRBV7-2,TRBJ2-7,CASSPGQYSYEQYF,3,0,1,3
TRBV9,TRBJ1-3,CASSPTTSGNTIYF,3,0,1,3
TRBV7-2,TRBJ2-7,CASSPTGGDYEQYF,3,0,1,3
TRBV7-2,TRBJ1-1,CASSPNPANTEAFF,3,0,1,3
TRBV7-9,TRBJ1-2,CASSPPWGDYGYTF,3,0,1,3
TRBV2,TRBJ1-2,CASSPGQPLYGYTF,3,0,1,3
TRBV7-2,TRBJ1-4,CASSPTGTFEKLFF,3,0,1,3
TRBV7-4,TRBJ2-7,CASSPRLAGDEQYF,3,0,1,3
TRBV7-6,TRBJ2-7,CASSPSTGANEQYF,3,0,1,3
TRBV4-2,TRBJ2-1,CASSRGELNNEQFF,3,0,1,3
TRBV7-9,TRBJ1-5,CASSRGGAGQPQHF,3,0,1,3
TRBV7-9,TRBJ1-6,CASSRDRGNSPLHF,3,0,1,3
TRBV14,TRBJ2-3,CASSHGGSTDTRYF,3,0,1,3
TRBV14,TRBJ2-3,CASSHGGSTDTQYF,3,0,1,3
TRBV12-3/4,TRBJ1-2,CASSHGRPNYGYTF,3,0,1,3
TRBV3-1,TRBJ2-1,CASSQEPRDNEQFF,3,0,1,3
TRBV7-9,TRBJ1-2,CASSQLGESYGYTF,3,0,1,3
TRBV3-1,TRBJ2-5,CASSQAGSQETQYF,3,0,1,3
TRBV3-1,TRBJ2-7,CASSQGTVTDEQYF,3,0,1,3
TRBV7-9,TRBJ2-2,CASSQSLSPGELFF,3,0,1,3
TRBV4-2,TRBJ2-1,CASSVGQGIHEQFF,3,0,1,3
TRBV7-9,TRBJ1-4,CASSVTGSGEKLFF,3,0,1,3
TRBV9,TRBJ2-5,CASSVAFLEETQYF,3,0,1,3
TRBV9,TRBJ2-7,CASSVEPGSYEQYF,3,0,1,3
TRBV9,TRBJ1-2,CASSALGSNYGYTF,3,0,1,3
TRBV7-9,TRBJ2-4,CASSGTGGKNIQYF,3,0,1,3
TRBV7-2,TRBJ2-7,CASSTRTGPYEQYF,3,0,1,3
TRBV5-5,TRBJ2-7,CASSTSPRRDEQYF,3,0,1,3
TRBV6-2/3/5/6,TRBJ2-3,CASSTGLGADTQYF,3,0,1,3
TRBV2,TRBJ2-5,CASRQDRGDETQYF,3,0,1,3
TRBV2,TRBJ2-1,CASRGDRGRNEQFF,3,0,1,3
TRBV12-3/4,TRBJ2-4,CASRTGGAKNIQYF,3,4,2,7
TRBV6-4,TRBJ1-2,CASRTGGLDYGYTF,3,0,1,3
TRBV6-2/3/5/6,TRBJ1-4,CASRRQGGSEKLFF,3,0,1,3
TRBV2,TRBJ2-6,CASRPGSGANVLTF,3,0,1,3
TRBV6-2/3/5/6,TRBJ1-5,CASRQDRTYQPQHF,3,0,1,3
TRBV7-7,TRBJ1-1,CASRKQGARTEAFF,3,0,1,3
TRBV27,TRBJ1-1,CASNQGVENTEAFF,3,0,1,3
TRBV12-3/4,TRBJ1-1,CASNTGQGQAEAFF,3,3,2,6
TRBV3-1,TRBJ2-2,CASKPRGNTGELFF,3,0,1,3
TRBV14,TRBJ2-7,CARQGRGDPYEQYF,3,0,1,3
TRBV7-6,TRBJ2-7,CANQRMAGGLEQYF,3,0,1,3
TRBV4-1,TRBJ1-1,CASTGLSLGTEAFF,3,0,1,3
TRBV5-1,TRBJ2-7,CASSLDVLSYEQYF,3,0,1,3
TRBV5-1,TRBJ1-5,CASSLDGGHQPQHF,3,0,1,3
TRBV5-1,TRBJ1-1,CASSLNGGHTEAFF,3,11,2,14
TRBV5-1,TRBJ1-1,CASSLQVSGTEAFF,3,0,1,3
TRBV5-1,TRBJ2-7,CASSSEGGGDEQYF,3,0,1,3
TRBV5-1,TRBJ1-1,CASSLGGRNTEAFF,3,0,1,3
TRBV5-1,TRBJ1-3,CASSPGGSGNTIYF,3,0,1,3
TRBV4-1,TRBJ1-5,CASSPGQDHQPQHF,3,0,1,3
TRBV5-1,TRBJ2-7,CASSPGQGGAHADF,3,0,1,3
TRBV5-1,TRBJ1-1,CASSRQGQNTEAFF,3,0,1,3
TRBV4-3,TRBJ2-7,CASSRRLGPYEQYF,3,0,1,3
TRBV4-1,TRBJ1-1,CASSRRVLGTEAFF,3,0,1,3
TRBV4-3,TRBJ2-7,CASSQGLAAYEQYF,3,5,2,8
TRBV4-3,TRBJ2-1,CASSQGQGGNEQFF,3,0,1,3
TRBV4-1,TRBJ1-1,CASSQTGANTEAFF,3,0,1,3
TRBV4-1,TRBJ1-1,CASSQTGGNTEAFF,3,0,1,3
TRBV4-1,TRBJ2-7,CASSQTRGDYEQYF,3,0,1,3
TRBV4-1,TRBJ2-1,CASSQPTSYNEQFF,3,0,1,3
TRBV4-3,TRBJ1-5,CASSQAGGAEPQHF,3,0,1,3
TRBV4-1,TRBJ2-7,CASSQGDRAYEQYF,3,0,1,3
TRBV4-3,TRBJ1-2,CASSQGQRPYGYTF,3,0,1,3
TRBV4-1,TRBJ2-1,CASSQDPGSNEQFF,3,0,1,3
TRBV4-1,TRBJ2-7,CASSQDPSSRGQYF,3,0,1,3
TRBV4-3,TRBJ2-7,CASSQDRGPYEQYF,3,0,1,3
TRBV4-3,TRBJ1-5,CASSQDRVRQPQHF,3,0,1,3
TRBV5-1,TRBJ2-7,CASSGTSGAYEQYF,3,0,1,3
TRBV5-1,TRBJ1-3,CASRQQGGGNTIYF,3,0,1,3
TRBV20-1,TRBJ2-7,CSAYRDGETYEQYF,3,0,1,3
TRBV20-1,TRBJ1-1,CSALLGSMNTEAFF,3,0,1,3
TRBV20-1,TRBJ2-1,CSAPLAGGLKSPFF,3,0,1,3
TRBV20-1,TRBJ1-1,CSAPGTKPNTEAFF,3,0,1,3
TRBV20-1,TRBJ2-1,CSADSGRGYNEQFF,3,0,1,3
TRBV20-1,TRBJ2-1,CSATGGGIYNEQFF,3,0,1,3
TRBV20-1,TRBJ1-2,CSASPQTGPYGYTF,3,0,1,3
TRBV20-1,TRBJ2-1,CSARGEGYRDEQFF,3,0,1,3
TRBV20-1,TRBJ2-5,CSARYSRQGETQYF,3,0,1,3
TRBV20-1,TRBJ2-1,CSARLGGSYNEQFF,3,0,1,3
TRBV20-1,TRBJ2-7,CSARVESRSYEQYF,3,0,1,3
TRBV20-1,TRBJ1-1,CSARVTGGGTEAFF,3,0,1,3
TRBV20-1,TRBJ2-1,CSARAGLVGGEQFF,3,0,1,3
TRBV20-1,TRBJ2-2,CSARDLAVSGELFF,3,0,1,3
TRBV20-1,TRBJ2-1,CSAREEGGHHEQFF,3,0,1,3
TRBV20-1,TRBJ2-7,CSAPTGTGGNEQYF,3,0,1,3
TRBV20-1,TRBJ1-2,CSAANRGLSYGYTF,3,9,2,12
TRBV20-1,TRBJ2-7,CSAGGAGLSYEQYF,3,0,1,3
TRBV20-1,TRBJ2-5,CSAMTPGRRETQYF,3,0,1,3
TRBV20-1,TRBJ2-7,CSALGLPSSYEQYF,3,0,1,3
TRBV29-1,TRBJ1-1,CSVRGAGLQTEAFF,3,0,1,3
TRBV29-1,TRBJ2-1,CSVGWGGESREQFF,3,0,1,3
TRBV29-1,TRBJ2-2,CSVDGGGNTGELFF,3,0,1,3
TRBV29-1,TRBJ2-1,CSVEGPDLYNEQFF,3,0,1,3
TRBV29-1,TRBJ2-1,CSVEGTGDNNEQFF,3,0,1,3
TRBV29-1,TRBJ1-2,CSVEQTGANYGYTF,3,0,1,3
TRBV29-1,TRBJ2-7,CSVAARGISYEQYF,3,0,1,3
TRBV29-1,TRBJ2-3,CSVAAGASTDTQYF,3,0,1,3
TRBV29-1,TRBJ1-4,CSAATGPLDEKLFF,3,0,1,3
TRBV29-1,TRBJ1-1,CSAMPGTGNTEAFF,3,0,1,3
TRBV29-1,TRBJ2-1,CSGGTGGRYNEQFF,3,0,1,3
TRBV30,TRBJ2-1,SAWSKAQLDNEQFF,3,0,1,3
TRBV30,TRBJ2-7,CVIGSGQSYEQYF,3,0,1,3
TRBV12-5,TRBJ1-1,CASGYRPNTEAFF,3,0,1,3
TRBV30,TRBJ1-1,CAWMDPVNTEAFF,3,0,1,3
TRBV30,TRBJ1-2,CAWSVIQGHSYTF,3,0,1,3
TRBV30,TRBJ2-7,CAWSVNGLGEQYF,3,0,1,3
TRBV30,TRBJ1-1,CAWSAQGQTEAFF,3,0,1,3
TRBV10-3,TRBJ2-3,CAITDGSTDTQYF,3,0,1,3
TRBV10-3,TRBJ2-3,CAISERGTDTQYF,3,0,1,3
TRBV10-3,TRBJ1-4,CAISLDRAEKLFF,3,0,1,3
TRBV9,TRBJ1-6,CATSQGADSPLHF,3,0,1,3
TRBV2,TRBJ2-7,CATPGTGGREQYF,3,0,1,3
TRBV7-2,TRBJ2-3,CATTGLSTDTQYF,3,0,1,3
TRBV24-1,TRBJ2-7,CATSGTGTDEQYF,3,5,2,8
TRBV24-1,TRBJ2-1,CATSKTSNNEQFF,3,2,2,5
TRBV15,TRBJ2-7,CATSRGLSYEQYF,3,0,1,3
TRBV15,TRBJ2-5,CATSRGEGGTQYF,3,0,1,3
TRBV19,TRBJ2-1,CASSPSGVREQFF,3,0,1,3
TRBV19,TRBJ2-7,CASSEQDSYEQYF,3,0,1,3
TRBV19,TRBJ1-1,CASSIQTKREAFF,3,0,1,3
TRBV19,TRBJ1-2,CASSIGQGRFYTF,3,0,1,3
TRBV19,TRBJ1-2,CASSNPVNYGYTF,3,0,1,3
TRBV19,TRBJ1-1,CASSHQRGTEAFF,3,0,1,3
TRBV12-3/4,TRBJ2-6,CASLTSGANVLTF,3,0,1,3
TRBV18,TRBJ2-5,CASSPGRGETQYF,3,0,1,3
TRBV18,TRBJ2-7,CASSLQGAGEQYF,3,0,1,3
TRBV18,TRBJ2-7,CASSPAESYEQYF,3,0,1,3
TRBV2,TRBJ1-2,CASAPGQIYGYTF,3,0,1,3
TRBV28,TRBJ2-3,CASISKTTGLQYF,3,0,1,3
TRBV7-9,TRBJ2-3,CASIPVNTDTQYF,3,0,1,3
TRBV2,TRBJ1-1,CASITDSYTEAFF,3,0,1,3
TRBV12-3/4,TRBJ2-3,CASMESSADTQYF,3,0,1,3
TRBV7-6,TRBJ2-1,CASTAWGANEQFF,3,0,1,3
TRBV27,TRBJ1-1,CASSFDRALVAFF,3,0,1,3
TRBV12-3/4,TRBJ1-2,CASSLGPNYGYTF,3,0,1,3
TRBV27,TRBJ2-3,CASSLSSTDTQYF,3,0,1,3
TRBV6-2/3/5/6,TRBJ2-7,CASSLSGAYEQYF,3,0,1,3
TRBV28,TRBJ2-5,CASSLSGFGTQYF,3,0,1,3
TRBV12-3/4,TRBJ1-1,CASSLAVGREAFF,3,0,1,3
TRBV6-2/3/5/6,TRBJ1-3,CASSLGTGNTIYF,3,0,1,3
TRBV6-2/3/5/6,TRBJ2-7,CASSLNVLGEQYL,3,0,1,3
TRBV27,TRBJ1-5,CASSLKGNQPQHF,3,0,1,3
TRBV2,TRBJ2-3,CASSSMSWDTQYF,3,0,1,3
TRBV5-5,TRBJ2-5,CASSWGAQETQYF,3,0,1,3
TRBV6-2/3/5/6,TRBJ2-1,CASSYQAYNEQFF,3,0,1,3
TRBV27,TRBJ2-5,CASSPFEQETQYF,3,0,1,3
TRBV6-1,TRBJ1-1,CASSAGKITEAFF,3,0,1,3
TRBV2,TRBJ1-1,CASSGLEGTEAFF,3,0,1,3
TRBV2,TRBJ2-4,CASSDGDRGIQYF,3,0,1,3
TRBV6-1,TRBJ2-2,CASSDGEFRELFF,3,0,1,3
TRBV25-1,TRBJ1-1,CASSEWGRVEAFF,3,0,1,3
TRBV2,TRBJ2-7,CASSEGGSYEQYF,3,0,1,3
TRBV6-2/3/5/6,TRBJ2-7,CASSSSVAYEQYF,3,0,1,3
TRBV25-1,TRBJ2-5,CASSRQGQETQYF,3,0,1,3
TRBV7-6,TRBJ2-7,CASSFRDTYEQYF,3,0,1,3
TRBV5-6,TRBJ2-3,CASSLLGTDTQYF,3,4,2,7
TRBV5-5,TRBJ1-2,CASSLADRDDYTF,3,0,1,3
TRBV13,TRBJ1-2,CASSLWGADGYTF,3,0,1,3
TRBV7-6,TRBJ2-7,CASSLVQGYEQYF,3,0,1,3
TRBV7-8,TRBJ2-3,CASSLVSTDTQYF,3,0,1,3
TRBV7-9,TRBJ1-1,CASSLDRGVGAFF,3,0,1,3
TRBV7-9,TRBJ1-1,CASSLDTGTKAFF,3,0,1,3
TRBV5-6,TRBJ1-6,CASSLDKFSPLHF,3,0,1,3
TRBV7-8,TRBJ2-7,CASSLNPGSEQYF,3,0,1,3
TRBV7-9,TRBJ1-2,CASSSSGGHGYTF,3,0,1,3
TRBV11-2,TRBJ2-1,CASSSGLFNEQFF,3,0,1,3
TRBV7-9,TRBJ1-1,CASSSGGDLEAFF,3,0,1,3
TRBV4-2,TRBJ2-7,CASSWRGTYEQYF,3,0,1,3
TRBV3-1,TRBJ2-5,CASSLINQETQYF,3,0,1,3
TRBV11-2,TRBJ1-1,CASSLGWGTEAFF,3,0,1,3
TRBV7-2,TRBJ2-7,CASSLGGYYEQYF,3,0,1,3
TRBV7-9,TRBJ1-1,CASSPYRDTEAFF,3,0,1,3
TRBV12-3/4,TRBJ1-5,CASSPPAGGPQHF,3,0,1,3
TRBV7-9,TRBJ1-2,CASSPRIGVGYTF,3,0,1,3
TRBV7-2,TRBJ2-5,CASSPGLQETQYF,3,0,1,3
TRBV5-6,TRBJ1-1,CASSPDQGAEAFF,3,0,1,3
TRBV7-6,TRBJ1-2,CASSRDRTYGYTF,3,0,1,3
TRBV4-2,TRBJ2-7,CASSQAHSYEQYF,3,0,1,3
TRBV7-9,TRBJ1-2,CASSQTANYGYTF,3,0,1,3
TRBV4-2,TRBJ2-7,CASSQAGSYEQYF,6,0,1,6
TRBV3-1,TRBJ2-1,CASSQDFGGEQFF,3,0,1,3
TRBV4-2,TRBJ2-7,CASSVTGADEQYF,3,0,1,3
TRBV5-6,TRBJ2-2,CASSVNREGELFF,3,0,1,3
TRBV9,TRBJ2-1,CASSVDRTYEQFF,3,0,1,3
TRBV11-2,TRBJ1-2,CASSAAGVYGYTF,3,0,1,3
TRBV11-1,TRBJ1-2,CASSGVDYYGYTF,3,0,1,3
TRBV11-2,TRBJ2-1,CASSGGETSGAFF,3,0,1,3
TRBV7-2,TRBJ2-5,CASSNDNQETQYF,3,0,1,3
TRBV5-6,TRBJ1-5,CASSKGANQPQHF,3,0,1,3
TRBV7-9,TRBJ1-1,CASRSGGNTEAFF,3,0,1,3
TRBV7-9,TRBJ1-5,CASRRISNQPQHF,3,0,1,3
TRBV5-6,TRBJ1-2,CASRAGTDYGYTF,3,0,1,3
TRBV27,TRBJ2-1,CASRTGASNEQFF,3,0,1,3
TRBV6-2/3/5/6,TRBJ2-7,CASRWTAPYEQYF,3,0,1,3
TRBV7-9,TRBJ1-1,CASRLVGDTEAFF,3,0,1,3
TRBV27,TRBJ2-7,CASRLAGTYEQYF,3,0,1,3
TRBV6-1,TRBJ2-1,CASRETGDNEQFF,3,0,1,3
TRBV7-2,TRBJ1-2,CASRMDSNYGYTF,3,0,1,3
TRBV29-1,TRBJ1-2,CSVGGGGGIVYTF,3,0,1,3
TRBV4-1,TRBJ1-4,CASSFLQGEKLFF,3,0,1,3
TRBV10-2,TRBJ2-1,CASSEKGYNEQFF,3,0,1,3
TRBV2,TRBJ1-2,CASSESKEYGYTF,3,0,1,3
TRBV4-1,TRBJ2-5,CASSLGHRETQYF,3,0,1,3
TRBV4-1,TRBJ1-2,CASSQPGHYGYTF,3,0,1,3
TRBV4-1,TRBJ2-7,CASSQGFIYEQYF,3,0,1,3
TRBV4-3,TRBJ2-1,CASSQDQTNEQFF,3,0,1,3
TRBV4-3,TRBJ2-3,CASSQDITDTQYF,3,0,1,3
TRBV5-1,TRBJ2-3,CASSMGLAGLTYF,3,0,1,3
TRBV4-3,TRBJ2-7,CASSMGQAYEQYF,3,0,1,3
TRBV5-1,TRBJ2-5,CASKLAGEETQYF,3,0,1,3
TRBV20-1,TRBJ2-1,CSAAGTDYNEQFF,3,0,1,3
TRBV20-1,TRBJ1-5,CSAIQGFNQPQHF,3,0,1,3
TRBV20-1,TRBJ2-5,CSARAGGRETQYF,3,0,1,3
TRBV20-1,TRBJ1-5,CSARDSRNQPQHF,3,0,1,3
TRBV20-1,TRBJ2-7,CSARMGGFYEQYF,3,0,1,3
TRBV20-1,TRBJ2-1,CSAVRGSYNEQFF,3,0,1,3
TRBV20-1,TRBJ1-5,CSASGEVLQPQHF,3,0,1,3
TRBV20-1,TRBJ2-3,CSGIAGGIDTQYF,3,5,2,8
TRBV29-1,TRBJ2-7,CSFALAGGREQYF,3,0,1,3
TRBV29-1,TRBJ2-1,CSLRILNYNEQFF,3,0,1,3
TRBV29-1,TRBJ1-1,CSVPGQGLTEAFF,3,0,1,3
TRBV29-1,TRBJ2-1,CSVRTGDFNEQFF,3,0,1,3
TRBV29-1,TRBJ1-1,CSVGGRAGTEAFF,3,0,1,3
TRBV29-1,TRBJ1-2,CSVGLRGRYGYTF,3,0,1,3
TRBV29-1,TRBJ2-3,CSVDPLGGDTQYF,3,0,1,3
TRBV29-1,TRBJ1-1,CSVSGDMNTEAFF,3,0,1,3
TRBV29-1,TRBJ1-2,CSVPSGDYYGYTF,3,0,1,3
TRBV29-1,TRBJ1-2,CSVHRGQNYGYTF,3,0,1,3
TRBV29-1,TRBJ1-1,CSVAGTVNTEAFF,3,0,1,3
TRBV29-1,TRBJ1-1,CSVVDRGQTEAFF,3,0,1,3
TRBV29-1,TRBJ2-7,CSVGGMGPYEQYF,3,0,1,3
TRBV29-1,TRBJ2-1,CSVSRGGGIEQFF,3,0,1,3
TRBV29-1,TRBJ2-2,CSGLAGGGGELLF,3,0,1,3
TRBV29-1,TRBJ1-1,CSGGDGRNTEAFF,3,0,1,3
TRBV29-1,TRBJ2-3,CSGRTGGADTQYF,3,0,1,3
TRBV4-3,TRBJ2-3,RASGSGSPDTQYF,3,0,1,3
TRBV30,TRBJ2-7,CAWSVRGGEQYF,3,0,1,3
TRBV15,TRBJ1-5,CATSRDENTQHF,3,0,1,3
TRBV7-9,TRBJ2-1,CASHGGPNEQFF,3,0,1,3
TRBV19,TRBJ1-5,CASRTDNQPQHF,3,0,1,3
TRBV2,TRBJ1-2,CASQDRGSGYTF,3,0,1,3
TRBV7-9,TRBJ1-1,CASGLKAGEAFF,3,0,1,3
TRBV2,TRBJ2-5,CASGREGETQYF,3,0,1,3
TRBV19,TRBJ2-1,CASIGGPNEQFF,3,0,1,3
TRBV12-3/4,TRBJ2-1,CASTGTGVQQFF,3,0,1,3
TRBV12-3/4,TRBJ2-2,CASSFGTGELFF,3,5,2,8
TRBV12-3/4,TRBJ2-7,CASSFQGFEQYF,3,0,1,3
TRBV5-6,TRBJ2-7,CASSLVGYEQYF,3,10,2,13
TRBV27,TRBJ2-7,CASSSTGSEQYF,3,0,1,3
TRBV6-2/3/5/6,TRBJ2-3,CASSSSLDTQYF,3,0,1,3
TRBV12-3/4,TRBJ1-2,CASSSGQVGYTF,3,0,1,3
TRBV6-2/3/5/6,TRBJ2-1,CASSYFQFEQFF,3,0,1,3
TRBV25-1,TRBJ2-5,CASSVHDGTQYF,3,0,1,3
TRBV12-3/4,TRBJ1-5,CASSGPDQPQHF,3,0,1,3
TRBV6-1,TRBJ2-7,CASSDMVYEQYF,3,0,1,3
TRBV2,TRBJ2-5,CASSEAPGTQYF,3,0,1,3
TRBV3-1,TRBJ2-2,CASSKLAGELFF,3,0,1,3
TRBV7-9,TRBJ2-1,CASSLAQGEPFF,3,0,1,3
TRBV7-6,TRBJ2-2,CASSLGGRELFF,3,8,2,11
TRBV5-4,TRBJ2-7,CASSLMGIEQYF,3,0,1,3
TRBV7-6,TRBJ2-1,CASSLNLNEQFF,3,0,1,3
TRBV7-2,TRBJ2-7,CASSLNRAEQYF,3,0,1,3
TRBV7-2,TRBJ1-6,CASSSRHSPLHF,3,0,1,3
TRBV11-1,TRBJ2-5,CASSSDSETQYF,3,0,1,3
TRBV7-8,TRBJ2-7,CASSYSTYEQYF,3,0,1,3
TRBV7-2,TRBJ1-1,CASSLGGPEASF,3,0,1,3
TRBV7-9,TRBJ2-7,CASSLGLYDQYF,3,0,1,3
TRBV7-9,TRBJ2-7,CASSLGSYEQYF,3,0,1,3
TRBV7-6,TRBJ1-1,CASSPLNTEASF,3,0,1,3
TRBV7-9,TRBJ2-1,CASSPLGNEQFF,3,0,1,3
TRBV14,TRBJ2-5,CASSQDWETQYF,3,0,1,3
TRBV7-6,TRBJ1-2,CASSGPVEGYTF,3,0,1,3
TRBV6-2/3/5/6,TRBJ2-1,CASRTLTNEQFF,3,0,1,3
TRBV2,TRBJ1-5,CASRSSNQPQHF,3,0,1,3
TRBV6-2/3/5/6,TRBJ1-2,CASRSWMDGYTF,3,0,1,3
TRBV7-6,TRBJ2-2,CAAGAGTGELFF,3,0,1,3
TRBV4-1,TRBJ2-7,CASSQGPSEQYF,3,0,1,3
TRBV10-2,TRBJ1-2,CASSEGGLGYTF,3,0,1,3
TRBV5-1,TRBJ2-7,CASSSGPSEQYF,3,0,1,3
TRBV4-1,TRBJ1-5,CASSLPAGPQHF,3,0,1,3
TRBV4-1,TRBJ2-2,CASSHSAGELFF,3,0,1,3
TRBV4-1,TRBJ2-1,CASSQVGDEQFF,3,0,1,3
TRBV4-1,TRBJ2-7,CASSGVLGEQYF,3,0,1,3
TRBV20-1,TRBJ2-5,CSATSGGETQYF,3,0,1,3
TRBV20-1,TRBJ2-3,CSARVRTGTQYF,3,0,1,3
TRBV20-1,TRBJ2-1,CSAGRHYNEQFF,3,0,1,3
TRBV20-1,TRBJ2-5,CSARLLAGTQYF,3,0,1,3
TRBV29-1,TRBJ1-1,CSVLTGGTEAFL,3,0,1,3
TRBV29-1,TRBJ1-2,CSVPTGTRGYTF,3,0,1,3
TRBV29-1,TRBJ1-1,CSVARGNTEAFF,3,0,1,3
TRBV29-1,TRBJ1-5,CSVGGSDQPQHF,3,0,1,3
TRBV29-1,TRBJ1-1,CSVGTANTEAFF,3,0,1,3
TRBV29-1,TRBJ2-7,CSVEDLQTEQYF,3,0,1,3
TRBV29-1,TRBJ2-7,CSVEDGGGLQYF,3,0,1,3
TRBV29-1,TRBJ1-3,CSVETGRNTIYF,3,0,1,3
TRBV29-1,TRBJ2-7,CSVETQYYEQYF,3,0,1,3
TRBV29-1,TRBJ2-1,CSVESGSAEQFF,3,0,1,3
TRBV29-1,TRBJ1-2,CSVEQGRYGYTF,3,0,1,3
TRBV29-1,TRBJ1-5,CSVRGLNQPQHF,3,0,1,3
TRBV29-1,TRBJ1-1,CSATPYSTEAFF,3,0,1,3
TRBV29-1,TRBJ2-1,CSGQQGWDEQFF,3,0,1,3
TRBV29-1,TRBJ1-1,CSTFDLNTEAFF,3,0,1,3
TRBV30,TRBJ1-1,CAWIKNTEAFF,3,0,1,3
TRBV30,TRBJ1-1,CAWSSEDEAFF,3,0,1,3
TRBV30,TRBJ1-1,CAWSVRQGAFF,3,0,1,3
TRBV30,TRBJ2-1,CAWSVGGPRFF,3,0,1,3
TRBV18,TRBJ2-6,CASSGANVLTF,3,11,2,14
TRBV12-3/4,TRBJ2-1,CASVRAGEQFF,3,0,1,3
TRBV7-9,TRBJ2-5,CASTLQETQYF,3,0,1,3
TRBV6-2/3/5/6,TRBJ1-1,CASTGRTEAFF,3,0,1,3
TRBV2,TRBJ1-1,CASSFHWEAFF,3,0,1,3
TRBV28,TRBJ1-4,CASSLSEKLFF,3,0,1,3
TRBV6-2/3/5/6,TRBJ2-3,CASSLGGTQYF,3,0,1,3
TRBV6-2/3/5/6,TRBJ2-5,CASSSAETQYF,3,0,1,3
TRBV7-2,TRBJ2-1,CASSVQDEQFF,3,0,1,3
TRBV6-4,TRBJ2-1,CASSAYSEQFF,3,0,1,3
TRBV2,TRBJ2-2,CASSDDGELFF,3,0,1,3
TRBV25-1,TRBJ2-3,CASSEFGTQYF,3,0,1,3
TRBV6-2/3/5/6,TRBJ2-5,CASSTKETQYF,3,0,1,3
TRBV11-1,TRBJ2-1,CASSFSNEQFF,3,0,1,3
TRBV3-1,TRBJ1-2,CASSQASTYTF,3,0,1,3
TRBV14,TRBJ1-3,CASSARNTIYF,3,0,1,3
TRBV7-9,TRBJ2-1,CASSTYNEQFF,3,0,1,3
TRBV4-1,TRBJ2-3,CASSHGDTQYF,3,0,1,3
TRBV20-1,TRBJ2-7,CSASGRRGEYF,3,0,1,3
TRBV20-1,TRBJ2-1,CSANERNEQFF,3,0,1,3
TRBV29-1,TRBJ2-3,CSVFSADTQYF,3,0,1,3
TRBV29-1,TRBJ1-1,CSVDSQARAFF,3,0,1,3
TRBV29-1,TRBJ1-2,CSVADNYGYTF,3,0,1,3
TRBV29-1,TRBJ1-3,CSALEGNTIYF,3,0,1,3
TRBV29-1,TRBJ2-2,CSAGVPGELFF,3,0,1,3
TRBV29-1,TRBJ2-5,CSTRGQETQYF,3,0,1,3
TRBV29-1,TRBJ1-1,SSATGGTEAFF,3,0,1,3
TRBV12-3/4,TRBJ1-1,CASSFAEAFF,3,0,1,3
TRBV27,TRBJ1-5,CASSWEPQHF,3,0,1,3
TRBV7-2,TRBJ2-2,CASSLGELFF,3,0,1,3
TRBV6-2/3/5/6,TRBJ2-4,CASSYGF,3,0,1,3
TRBV19,TRBJ1-4,CASSIRQRATNEKLFF,3,0,1,3
TRBV9,TRBJ2-4,CASSVTSGGWINVQYF,3,0,1,3
TRBV5-1,TRBJ2-7,CTSSSGDRVIWDEQYF,3,0,1,3
TRBV9,TRBJ2-3,CASSGRVGSTDTQYF,3,0,1,3
TRBV4-1,TRBJ1-2,CASSQVGQALYGYTF,3,0,1,3
TRBV30,TRBJ1-4,CAWSGGHANEKLFF,3,0,1,3
TRBV3-1,TRBJ1-2,CASSQDGRAYGYTF,3,0,1,3
TRBV13,TRBJ2-7,CASRGGISYEQYF,3,0,1,3
TRBV5-6,TRBJ2-1,CASSFSGAEQFF,3,0,1,3
TRBV7-6,TRBJ1-1,CASSLLGGGVDTEAFF,3,0,1,3
TRBV6-2/3/5/6,TRBJ2-7,CASSLNVLGEQYF,2,0,1,2
TRBV6-1,TRBJ1-5,CASSQDRTYQPQHF,2,0,1,2
TRBV20-1,TRBJ2-5,CSAIFSETQYF,2,11,2,13
TRBV20-1,TRBJ2-1,CSATPSGRGTYNEQFF,2,0,1,2
TRBV12-3/4,TRBJ1-2,CASSLMGYTF,2,0,1,2
TRBV15,TRBJ2-1,CATSRSFTGTSGGSSYNEQFF,2,0,1,2
TRBV18,TRBJ2-1,CASSPPKPLAGFLGREDEQFF,2,0,1,2
TRBV14,TRBJ2-1,CASCQGLAGSRWSSYNEQFF,2,0,1,2
TRBV6-2/3/5/6,TRBJ2-7,CASSFFSTNGLAGGRYEQYF,2,12,2,14
TRBV6-2/3/5/6,TRBJ2-5,CASSLRGTGYQRGPQETQYF,2,0,1,2
TRBV6-2/3/5/6,TRBJ2-1,CASSPVSGGPPYPIPNEQFF,2,0,1,2
TRBV5-1,TRBJ1-6,CASSQGTGDHLSSYNSSLHF,2,0,1,2
TRBV20-1,TRBJ1-4,CSAIRAATPLPNPTNEKLFF,2,0,1,2
TRBV6-2/3/5/6,TRBJ2-5,CASSLYGPRDRGYQETQYF,2,0,1,2
TRBV6-2/3/5/6,TRBJ2-1,CASSYPQAGGPHPLNEQFF,2,0,1,2
TRBV6-2/3/5/6,TRBJ2-3,CASSYPLSLADTSTDTQYF,2,0,1,2
TRBV12-3/4,TRBJ1-4,CASSALGGTGDVANERLFF,2,0,1,2
TRBV7-2,TRBJ2-1,CASSRKAIITQGARDEQFF,2,0,1,2
TRBV3-1,TRBJ2-6,CASSQFQREGPPGANVLTF,2,0,1,2
TRBV4-2,TRBJ1-6,CASSQVKGAPESLDSPLHF,2,0,1,2
TRBV4-2,TRBJ2-3,CASSQELSRLLNRADTQYF,2,0,1,2
TRBV5-6,TRBJ1-6,CASSDSGTGIDAYNSPLHF,2,0,1,2
TRBV9,TRBJ2-5,CASSERTSLAGGPRETQYF,2,0,1,2
TRBV6-4,TRBJ2-1,CASRTRGPVLAGNDNEQFF,2,0,1,2
TRBV5-1,TRBJ2-1,CASSGQGTTAGGGYNEQFF,2,0,1,2
TRBV20-1,TRBJ2-2,CSASGGTGITGAQTGELFF,2,0,1,2
TRBV29-1,TRBJ2-3,CSVEGSSSGGEWATDTQYF,2,0,1,2
TRBV12-3/4,TRBJ2-7,CVSSSIFLDRGGTYEQYF,2,0,1,2
TRBV30,TRBJ2-1,CAWSPTRTSGRTYNEQFF,2,0,1,2
TRBV5-6,TRBJ2-7,CAGSSPHDPTSRSYEQYF,2,0,1,2
TRBV19,TRBJ2-7,CASSPLVGGSRGRNEQYF,2,0,1,2
TRBV19,TRBJ1-1,CASSPLRDRDFMNTEAFF,2,0,1,2
TRBV6-2/3/5/6,TRBJ1-5,CASSFLPGGKGSNQPQHF,2,0,1,2
TRBV27,TRBJ2-3,CASSLLGRGGSKGYTQYF,2,0,1,2
TRBV6-2/3/5/6,TRBJ2-1,CASSYSIATVYSYNEQFF,2,0,1,2
TRBV12-3/4,TRBJ2-1,CASSPPRGLAGISDEQFF,2,0,1,2
TRBV27,TRBJ2-1,CASSPMGLAGVSYNEQFF,2,4,2,6
TRBV2,TRBJ2-1,CASSEVAGGPDGYNEQFF,2,0,1,2
TRBV6-2/3/5/6,TRBJ2-7,CASSIVLRLAGGTHEQYF,2,0,1,2
TRBV7-2,TRBJ2-3,CASSLAIRASGDTDTQYF,2,0,1,2
TRBV7-8,TRBJ2-5,CASSLAGTRLFGPETQYF,2,0,1,2
TRBV14,TRBJ2-4,CASSPSLQGSLAKSIQYF,2,0,1,2
TRBV11-2,TRBJ2-3,CASSRDEGLAGGTDTQYF,2,0,1,2
TRBV9,TRBJ2-2,CASSVDPSGGRNTGELFF,2,0,1,2
TRBV5-4,TRBJ1-6,CASSTRTGGSSYNSPLHF,2,0,1,2
TRBV6-2/3/5/6,TRBJ2-2,CASNPAPRQGGYTGELFF,2,0,1,2
TRBV10-2,TRBJ2-7,CASSGAGAGGFRRYEQYF,2,0,1,2
TRBV5-1,TRBJ2-6,CASSLISPQHSGANVLTF,2,0,1,2
TRBV5-1,TRBJ2-7,CASSSPPFPGLRTYEQYF,2,0,1,2
TRBV5-1,TRBJ2-1,CASSPGLAGGLGWNEQFF,2,0,1,2
TRBV5-1,TRBJ2-3,CASSPGLAGGRGTDTQYF,2,0,1,2
TRBV4-1,TRBJ1-2,CASSQRTLQGGADYGYTF,2,0,1,2
TRBV4-3,TRBJ2-5,CASSQEIGLAAIRETQYF,2,0,1,2
TRBV4-1,TRBJ2-6,CASSQETRMGSGANVLTF,2,0,1,2
TRBV5-1,TRBJ2-3,CASSGTSGTLTFTDTQYF,2,0,1,2
TRBV20-1,TRBJ2-3,CSASPVGRGGRGTDTQYF,2,0,1,2
TRBV20-1,TRBJ2-3,CSARDPAGLAGYTDTQYF,2,0,1,2
TRBV12-5,TRBJ2-5,CASGPPPGLAGQETQYF,2,0,1,2
TRBV30,TRBJ2-1,CAWTGLAGGRIYNEQFF,2,0,1,2
TRBV24-1,TRBJ2-4,CATSDLGGRGLLNIQYF,2,0,1,2
TRBV24-1,TRBJ2-1,CATSDQRTSGRNGEQFF,2,0,1,2
TRBV15,TRBJ2-1,CATSRRGSSGGANEQFF,2,0,1,2
TRBV15,TRBJ1-1,CATSRARTGRVNTEAFF,2,0,1,2
TRBV15,TRBJ1-5,CATSRDGRGPSNQPQHF,2,0,1,2
TRBV7-6,TRBJ2-1,CATLGQGERGPSMGQFF,2,0,1,2
TRBV19,TRBJ1-5,CASSIEPGQGPNQPQHF,2,0,1,2
TRBV19,TRBJ1-1,CASSTRQDLRMNTEAFF,2,0,1,2
TRBV18,TRBJ1-5,CASSPANPGQGSQPQHF,2,0,1,2
TRBV27,TRBJ2-1,CASSFGGDGFAYNEQFF,2,0,1,2
TRBV12-3/4,TRBJ2-1,CASSLLASQSSYNEQFF,2,0,1,2
TRBV12-3/4,TRBJ2-3,CASSLVAAPSGADTQYF,2,0,1,2
TRBV27,TRBJ1-2,CASSLNLPQGGYYGYTF,2,0,1,2
TRBV6-2/3/5/6,TRBJ1-6,CASSLNGPSSYNSPLHF,2,0,1,2
TRBV6-2/3/5/6,TRBJ1-4,CASSSPGVEGPNEKLFF,2,0,1,2
TRBV6-2/3/5/6,TRBJ2-1,CASSSALLRRGSNEQFF,2,0,1,2
TRBV6-2/3/5/6,TRBJ2-7,CASSYSPPGLADYEQYF,2,6,2,8
TRBV6-2/3/5/6,TRBJ1-2,CASSYSPSLVANYGYTF,2,0,1,2
TRBV6-2/3/5/6,TRBJ1-5,CASSYSPHRDINQPQHF,2,0,1,2
TRBV6-2/3/5/6,TRBJ1-3,CASSYYTGFESGNTIYF,2,0,1,2
TRBV12-3/4,TRBJ2-7,CASSRGTGGWGNYEQYF,2,0,1,2
TRBV6-4,TRBJ2-1,CASSDRTSGGVYNEQFF,2,0,1,2
TRBV2,TRBJ1-1,CASSDALYRGRGTEAFF,2,0,1,2
TRBV12-3/4,TRBJ2-1,CASSTRQGSPTYNEQFF,2,0,1,2
TRBV11-2,TRBJ2-4,CASSFGGGQTKKNIQYF,2,0,1,2
TRBV7-2,TRBJ2-7,CASSFSGIDRMSYEQYF,2,0,1,2
TRBV7-2,TRBJ1-5,CASSFNPTGYSNQPQHF,2,0,1,2
TRBV5-4,TRBJ1-5,CASSLYRTGVGDQPQHF,2,6,2,8
TRBV7-2,TRBJ2-1,CASSLVLRTSGRNEQFF,2,0,1,2
TRBV11-2,TRBJ2-3,CASSLVASGGASDTQYF,2,0,1,2
TRBV11-1,TRBJ2-1,CASSLARLVGGYNEQFF,2,0,1,2
TRBV7-9,TRBJ2-7,CASSLAESAGGVYEQYF,2,0,1,2
TRBV7-2,TRBJ2-7,CASSLGLAGNYSYEQYF,2,0,1,2
TRBV7-6,TRBJ1-5,CASSLGPGTGNHQPQHF,2,0,1,2
TRBV7-3,TRBJ2-1,CASSLTPKLAEYNEQFF,2,2,2,4
TRBV7-9,TRBJ2-5,CASSLTDRDRVAETQYF,2,3,2,5
TRBV7-8,TRBJ2-5,CASSLRTSGRVQETQYF,2,3,2,5
TRBV5-6,TRBJ2-1,CASSLPAMVVSYNEQFF,2,0,1,2
TRBV7-6,TRBJ2-1,CASSLNGRAGGYNEQFF,2,0,1,2
TRBV7-9,TRBJ2-3,CASSPWVALKGTDTQYF,2,0,1,2
TRBV7-3,TRBJ2-1,CASSPRGGRGPGNEQFF,2,0,1,2
TRBV7-2,TRBJ2-3,CASSPGTSGRMTDTQYF,2,0,1,2
TRBV9,TRBJ2-5,CASSPRAASGSEETQYF,2,0,1,2
TRBV11-2,TRBJ2-1,CASSPNSGTYLGNGQFF,2,0,1,2
TRBV7-9,TRBJ1-1,CASSPGSTGTTNTEAFF,2,0,1,2
TRBV4-2,TRBJ2-7,CASSQPDSVGAPYEQYF,2,0,1,2
TRBV3-1,TRBJ2-3,CASSQVAGGPPGNTQYF,2,0,1,2
TRBV4-2,TRBJ2-5,CASSQDLSGRAGETQYF,2,0,1,2
TRBV6-2/3/5/6,TRBJ2-7,CASSQDRGYQRSYEQYF,2,0,1,2
TRBV9,TRBJ1-3,CASSVVDRDYSGNTIYF,2,0,1,2
TRBV7-2,TRBJ1-2,CASSGRDSGAVNHGYTF,2,0,1,2
TRBV9,TRBJ2-2,CASSESGLATNTGELFF,2,0,1,2
TRBV6-2/3/5/6,TRBJ2-7,CASSKIKSDSRVYEQYF,2,0,1,2
TRBV13,TRBJ2-5,CASRDTGTGDPRETQYF,2,0,1,2
TRBV5-1,TRBJ2-3,CASSLLRQGFLTDTQYF,2,0,1,2
TRBV5-1,TRBJ2-1,CASSLGSPTRSYNEQFF,2,0,1,2
TRBV5-1,TRBJ1-4,CASSLGGLRTTNEKLFF,2,0,1,2
TRBV5-1,TRBJ2-5,CASSSLRTEHLKETQYF,2,0,1,2
TRBV4-3,TRBJ2-3,CASSLYLAGVGPDTQYF,2,0,1,2
TRBV4-1,TRBJ1-6,CASSPEGRMSFYSPLHF,2,0,1,2
TRBV4-1,TRBJ2-1,CASSHSQVRGPNNEQFF,2,0,1,2
TRBV4-3,TRBJ2-3,CASSQGGLSARGDTQYF,2,0,1,2
TRBV4-1,TRBJ2-4,CASSQVSSQIAKNIQYF,2,0,1,2
TRBV4-3,TRBJ1-3,CASSQVRARGSGNTIYF,2,0,1,2
TRBV4-1,TRBJ1-5,CASSQEGVRGGNQPQHF,2,0,1,2
TRBV4-3,TRBJ2-6,CASSQEGTYTGANVLTF,2,0,1,2
TRBV5-1,TRBJ2-1,CASSREGPGFTYNEQFF,2,0,1,2
TRBV20-1,TRBJ2-3,CSQPPAGGPGTTDTQYF,2,0,1,2
TRBV20-1,TRBJ2-7,CSAKRPPGTGGRYEQYF,2,0,1,2
TRBV29-1,TRBJ2-1,CSVSGTSPPLLYNEQFF,2,0,1,2
TRBV9,TRBJ2-5,RASSAGTSGGAGKTQHF,2,0,1,2
TRBV12-5,TRBJ1-1,CASGFIPPGNDTEAFF,2,0,1,2
TRBV12-5,TRBJ2-1,CASGLQGQGFYNEQFF,2,0,1,2
TRBV10-3,TRBJ2-3,CAVSGRDYQSTDTQYF,2,0,1,2
TRBV7-2,TRBJ2-5,CAGGPSLAGLLGTQYF,2,0,1,2
TRBV10-3,TRBJ2-7,CAISKFRDRDLYEQYF,2,0,1,2
TRBV10-3,TRBJ1-2,CAISRRQGFVNYGYTF,2,0,1,2
TRBV15,TRBJ2-5,CATSEITIGVEETQYF,2,0,1,2
TRBV15,TRBJ2-2,CATSTRGTANTGELFF,2,0,1,2
TRBV19,TRBJ2-5,CASSIVFRTAKETQYF,2,0,1,2
TRBV19,TRBJ2-3,CASSIDWEGNTDTQYF,2,0,1,2
TRBV19,TRBJ2-5,CASSRTSGGRQETQYF,2,0,1,2
TRBV18,TRBJ2-7,CASSPLRGEGYYEQYF,2,0,1,2
TRBV18,TRBJ1-2,CASSSISGTAIYGYTF,2,0,1,2
TRBV18,TRBJ1-1,CASSPARDRGLTEAFF,2,0,1,2
TRBV18,TRBJ1-4,CASSPNIGFPNEKLFF,2,0,1,2
TRBV6-2/3/5/6,TRBJ1-5,CASLREPLYSNQPQHF,2,0,1,2
TRBV25-1,TRBJ2-1,CASIHLRDKRTRGRGF,2,0,1,2
TRBV11-2,TRBJ2-5,CASTLGASGIQETQYF,2,0,1,2
TRBV12-3/4,TRBJ1-2,CASTPSRDRGPYGYTF,2,0,1,2
TRBV12-3/4,TRBJ2-5,CASTPRAGEGRETQYF,2,2,2,4
TRBV6-2/3/5/6,TRBJ2-5,CASTQGLNERQETQYF,2,0,1,2
TRBV7-2,TRBJ2-5,CASTQSRGRGRETQYF,2,0,1,2
TRBV2,TRBJ2-7,CASTEPGQASSYEQYF,2,0,1,2
TRBV7-9,TRBJ1-4,CASTTSLAATNEKLFF,2,0,1,2
TRBV2,TRBJ2-7,CASTKAGGRPSYEQYF,2,0,1,2
TRBV27,TRBJ2-1,CASSLRGQGSYNEQFF,2,0,1,2
TRBV6-2/3/5/6,TRBJ1-5,CASSLSRDRANQPQHF,2,0,1,2
TRBV12-3/4,TRBJ2-5,CASSLVLAGNQETQYF,2,0,1,2
TRBV12-3/4,TRBJ1-4,CASSLAPQGVGEKLFF,2,0,1,2
TRBV12-3/4,TRBJ2-4,CASSLARQGTKNIQYF,2,0,1,2
TRBV12-3/4,TRBJ2-1,CASSLARRSSYNEQFF,2,0,1,2
TRBV12-3/4,TRBJ2-7,CASSLGAGRTSYEQYF,2,0,1,2
TRBV6-2/3/5/6,TRBJ1-2,CASSLMGPRGLYGYTF,2,0,1,2
TRBV12-3/4,TRBJ2-1,CASSSSSGRSPNEQFF,2,0,1,2
TRBV6-2/3/5/6,TRBJ2-7,CASSSPVSGRIYEQYF,2,0,1,2
TRBV12-3/4,TRBJ1-1,CASSSGTGGGNTEAFF,2,0,1,2
TRBV6-2/3/5/6,TRBJ2-5,CASSSEPTGPQETQYF,2,0,1,2
TRBV6-2/3/5/6,TRBJ1-1,CASSYSSWGGNTEAFF,2,2,2,4
TRBV6-2/3/5/6,TRBJ2-3,CASSYSNYPGTDTQYF,2,0,1,2
TRBV27,TRBJ2-1,CASSYLAGAAHNEQFF,2,0,1,2
TRBV6-2/3/5/6,TRBJ1-2,CASSYRTGPTNYGYTF,2,0,1,2
TRBV6-2/3/5/6,TRBJ2-7,CASSYRVSLILGEQYF,2,0,1,2
TRBV12-3/4,TRBJ2-1,CASSLVSLRGSNEQFF,2,0,1,2
TRBV7-2,TRBJ1-2,CASSHYRSQRNYGYTF,2,18,2,20
TRBV6-2/3/5/6,TRBJ2-1,CASSQRTVLAYNEQFF,2,0,1,2
TRBV6-1,TRBJ2-1,CASSASIAGGNNEQFF,2,19,2,21
TRBV2,TRBJ2-5,CASSDPGTASQETQYF,2,0,1,2
TRBV6-4,TRBJ2-7,CASSDRPGTGGLEQYF,2,0,1,2
TRBV6-2/3/5/6,TRBJ2-2,CASSESQGSGTGELFF,2,0,1,2
TRBV25-1,TRBJ2-3,CASSEPGGISTDTQYF,2,0,1,2
TRBV2,TRBJ1-1,CASSERRAAGRPEAFF,2,0,1,2
TRBV6-1,TRBJ2-3,CASSEVGQGITDTQYF,2,0,1,2
TRBV6-1,TRBJ1-4,CASSEASGRRREKLFF,2,0,1,2
TRBV2,TRBJ2-6,CASSETPAVGANVLTF,2,0,1,2
TRBV6-1,TRBJ2-7,CASSERGGAFKDEQYF,2,0,1,2
TRBV28,TRBJ2-7,CASSMSRGPWAYEQYF,2,0,1,2
TRBV6-2/3/5/6,TRBJ2-5,CASSTRTSGRRETQYF,2,0,1,2
TRBV6-2/3/5/6,TRBJ2-7,CASSRGASGRSYEQYF,2,0,1,2
TRBV7-6,TRBJ1-2,CASSFGTTGGLYGYTF,2,0,1,2
TRBV7-2,TRBJ2-2,CASSFPGEGNTGELFF,2,0,1,2
TRBV5-6,TRBJ2-3,CASSLVPSGRSGTQYF,2,0,1,2
TRBV5-4,TRBJ2-1,CASSLEGGSWYNEQFF,2,0,1,2
TRBV7-9,TRBJ2-2,CASSLFLSSSAGELFF,2,0,1,2
TRBV7-9,TRBJ2-7,CASSLLTSGSVYEQYF,2,0,1,2
TRBV7-2,TRBJ1-2,CASSLSGDRGLWGYTF,2,0,1,2
TRBV7-9,TRBJ2-7,CASSLPDIYPSYEQYF,2,0,1,2
TRBV7-7,TRBJ2-3,CASSLHHTDRTDTQYF,2,0,1,2
TRBV7-2,TRBJ2-5,CASSLVMTTFQETQYF,2,0,1,2
TRBV7-9,TRBJ2-6,CASSLVLPSGANVLTF,2,0,1,2
TRBV7-2,TRBJ2-3,CASSLASGGSTDTQYF,2,0,1,2
TRBV7-2,TRBJ2-5,CASSLGTASKQETQYF,2,7,2,9
TRBV7-2,TRBJ2-1,CASSLIPPNLNNEQFF,2,10,2,12
TRBV7-3,TRBJ2-1,CASSLTGRVAYNEQFF,2,0,1,2
TRBV11-2,TRBJ2-5,CASSLNPAGTQETQYF,2,0,1,2
TRBV7-9,TRBJ2-2,CASSLNSVGNTGELFF,2,0,1,2
TRBV7-9,TRBJ2-1,CASSSSGLAGTNEQFF,2,0,1,2
TRBV5-4,TRBJ2-1,CASSSRRGATYNEQFF,2,0,1,2
TRBV4-2,TRBJ2-1,CASSSGGQGARNEQFF,2,0,1,2
TRBV13,TRBJ2-2,CASSSGQGRDTGELFF,2,0,1,2
TRBV13,TRBJ2-7,CASSSNDRGSPYEQYF,2,0,1,2
TRBV12-3/4,TRBJ1-5,CASSSGQRSSNQPQHF,2,4,2,6
TRBV5-6,TRBJ1-5,CASSSTFGTANQPQHF,2,0,1,2
TRBV11-2,TRBJ2-3,CASSLGTSPGTDTQYF,2,0,1,2
TRBV3-1,TRBJ2-5,CASSLGARTDGETQYF,2,0,1,2
TRBV7-9,TRBJ2-7,CASSPNTGEEYYEQYF,2,0,1,2
TRBV4-2,TRBJ2-2,CASSPLGTANTGELFF,2,0,1,2
TRBV7-9,TRBJ2-7,CASSPRLAGTAYEQYF,2,0,1,2
TRBV7-6,TRBJ2-1,CASSPQLAGEENEQFF,2,0,1,2
TRBV4-2,TRBJ2-1,CASSPTDGGGYNEQFF,2,0,1,2
TRBV7-2,TRBJ2-3,CASSPRTSGLADTQYF,2,0,1,2
TRBV7-2,TRBJ2-1,CASSPSRLAGANEQFF,2,0,1,2
TRBV7-9,TRBJ1-4,CASSRGPGQDNEKLFF,2,0,1,2
TRBV4-1,TRBJ2-5,CASSRSAVRGPETQYF,4,0,1,4
TRBV4-2,TRBJ2-4,CASSHRDPREGDIQYF,2,0,1,2
TRBV3-1,TRBJ2-1,CASSQVAGVLYNEQFF,2,0,1,2
TRBV4-2,TRBJ2-6,CASSQASGSGANVLTF,2,8,2,10
TRBV3-1,TRBJ2-1,CASSQDVLAGVNEQFF,2,0,1,2
TRBV7-6,TRBJ2-3,CASSQTSPSLTDTQYF,2,0,1,2
TRBV4-2,TRBJ2-1,CASSQPGQGTYNERFF,2,0,1,2
TRBV4-2,TRBJ1-6,CASSQVGRAGSSPPHF,2,0,1,2
TRBV4-2,TRBJ2-3,CASSQVAGGPTDTQYF,2,0,1,2
TRBV3-1,TRBJ1-4,CASSQDPTGPGEKLFF,2,0,1,2
TRBV4-2,TRBJ2-1,CASSQDRLAGHNEQFF,2,0,1,2
TRBV14,TRBJ2-2,CASSQDGDRNTGELFF,2,0,1,2
TRBV4-2,TRBJ2-7,CASSQDNPGGGYEQYF,2,0,1,2
TRBV4-2,TRBJ2-5,CASSQDGRGGEETQYF,2,0,1,2
TRBV4-2,TRBJ2-6,CASSQEPYSGANVLTF,2,0,1,2
TRBV3-1,TRBJ2-5,CASSQETGPFQETQYF,2,0,1,2
TRBV4-2,TRBJ2-7,CASSQNLGTGSYEQYF,2,0,1,2
TRBV3-1,TRBJ2-5,CASSVKAEGYQETQYF,2,0,1,2
TRBV6-2/3/5/6,TRBJ2-5,CASSVGGARRQETQHF,2,0,1,2
TRBV9,TRBJ2-5,CASSVEAGAYQETQYF,2,0,1,2
TRBV6-2/3/5/6,TRBJ1-5,CASSARGGTGRQPQHF,2,11,2,13
TRBV9,TRBJ2-3,CASSAIGGGAGDTQYF,2,0,1,2
TRBV9,TRBJ2-1,CASSGGLTRSYNEQFF,2,0,1,2
TRBV9,TRBJ2-2,CASSGTSGRGTGELFF,2,0,1,2
TRBV9,TRBJ2-1,CASSGGEGLAGDEQFF,2,0,1,2
TRBV25-1,TRBJ1-2,CASSGFAEGQERGYTF,2,0,1,2
TRBV3-1,TRBJ2-7,CASSIGGAASSYEQYF,2,0,1,2
TRBV7-9,TRBJ2-2,CASSNSGTGNTGELFF,2,0,1,2
TRBV6-2/3/5/6,TRBJ1-6,CASRLGVGTGNSPLHF,2,0,1,2
TRBV2,TRBJ1-6,CASRDTGMGWSSPLHF,2,0,1,2
TRBV2,TRBJ2-1,CASRDWTCGEYNEQFF,2,0,1,2
TRBV12-3/4,TRBJ2-7,CASRTTAGQGSYEQYF,2,0,1,2
TRBV7-2,TRBJ2-4,CASRTNQGFGKNIQYF,2,0,1,2
TRBV27,TRBJ2-5,CASRPPGTPWEETQYF,2,0,1,2
TRBV6-2/3/5/6,TRBJ1-2,CASRRLGDSLKGGYTF,2,0,1,2
TRBV4-3,TRBJ2-2,CASSRGGTRNTGELFF,2,0,1,2
TRBV5-1,TRBJ2-1,CASSFPRDKSYNEQFF,2,0,1,2
TRBV5-1,TRBJ1-1,CASSLVFVGSNTEAFF,2,0,1,2
TRBV5-1,TRBJ1-2,CASSLGHRDVDYGYTF,2,0,1,2
TRBV5-1,TRBJ2-1,CASSLGRLSSYNEQFF,2,0,1,2
TRBV5-1,TRBJ2-5,CASSLGLAGGQETQYF,2,0,1,2
TRBV5-1,TRBJ2-5,CASSLERGSPQETQYF,2,0,1,2
TRBV5-1,TRBJ1-3,CASSLEIHASGNTIYF,2,0,1,2
TRBV5-1,TRBJ2-2,CASSLESGRRTGELFF,2,0,1,2
TRBV5-1,TRBJ2-5,CASSLNGLGEQETQYF,2,0,1,2
TRBV5-1,TRBJ1-5,CASSSEGRGGNQPQHF,2,0,1,2
TRBV5-1,TRBJ2-6,CASSSSGDTGANVLTF,2,0,1,2
TRBV4-1,TRBJ1-5,CASSLRPGYSNQPQHF,2,0,1,2
TRBV5-1,TRBJ2-2,CASSPKNRVDTGELFF,2,0,1,2
TRBV4-1,TRBJ2-3,CASSRPGDSSLDTQYF,2,0,1,2
TRBV4-3,TRBJ2-1,CASSRYYRVGYNEQFF,2,0,1,2
TRBV5-1,TRBJ1-1,CASSHRPGPQNTEAFF,2,0,1,2
TRBV4-1,TRBJ1-2,CASSQDFGQGLGGYTF,2,0,1,2
TRBV4-1,TRBJ1-5,CASSQDPRYSNQPQHF,2,0,1,2
TRBV4-3,TRBJ2-1,CASSQDPGLAPKREFF,2,0,1,2
TRBV4-3,TRBJ2-1,CASSQDRGALGYEQFF,2,0,1,2
TRBV4-3,TRBJ2-1,CASSQDRRPIYNEQFF,2,0,1,2
TRBV4-1,TRBJ1-6,CASSQDRGSYNSPLHF,2,0,1,2
TRBV4-1,TRBJ2-5,CASSQDQGLAGSDQYF,2,0,1,2
TRBV4-3,TRBJ2-7,CASSQDGLAASYEQYF,2,0,1,2
TRBV4-1,TRBJ2-7,CASSQDTFPGVYEQYF,2,0,1,2
TRBV4-1,TRBJ1-6,CASSQEWTAYNSPLHF,2,0,1,2
TRBV4-1,TRBJ2-3,CASSQEWDRSTDTQYF,2,0,1,2
TRBV4-1,TRBJ2-7,CASSQTSGGRNYEQYF,2,3,2,5
TRBV5-1,TRBJ2-1,CASSAQLAGPLDEQFF,2,0,1,2
TRBV4-3,TRBJ2-1,CASSNRLAGGHNEQFF,2,0,1,2
TRBV20-1,TRBJ1-1,CSALAAITGRGTEAFF,2,0,1,2
TRBV20-1,TRBJ2-1,CSASTLAGHSYNEQFF,2,0,1,2
TRBV20-1,TRBJ2-1,CSARPRVSGVYNEQFF,2,0,1,2
TRBV20-1,TRBJ2-1,CSARVGGSVSYNEQFF,2,0,1,2
TRBV20-1,TRBJ2-7,CSARAGLVLADYEQYF,2,0,1,2
TRBV20-1,TRBJ2-7,CSARGLWTSESYEQYF,2,0,1,2
TRBV20-1,TRBJ2-7,CSARDSERGNPYEQYF,2,0,1,2
TRBV20-1,TRBJ1-5,CSARDYEQGISQPQHF,2,0,1,2
TRBV20-1,TRBJ1-2,CSARDRSGEANYGYTF,2,0,1,2
TRBV20-1,TRBJ2-7,CSARDALAGDSYEQYF,2,0,1,2
TRBV20-1,TRBJ2-4,CSARDELAGRENIQYF,2,0,1,2
TRBV20-1,TRBJ2-5,CSASHRTGVDQETQYF,2,0,1,2
TRBV29-1,TRBJ2-2,CSVADTGQGDGGELFF,2,0,1,2
TRBV29-1,TRBJ2-1,CSVDLGGASSYNEQFF,2,0,1,2
TRBV29-1,TRBJ2-3,CSVEGLQGSPTDTQYF,2,0,1,2
TRBV29-1,TRBJ2-7,CSVETLERESGYEQYF,2,0,1,2
TRBV12-5,TRBJ1-1,CASSRGGFMNTEAFF,2,0,1,2
TRBV6-2/3/5/6,TRBJ1-1,CASSYRTAGGSEAFF,2,0,1,2
TRBV30,TRBJ2-7,CAWQGGRDSSYEQYF,2,0,1,2
TRBV30,TRBJ2-2,CAWSVVEQESGELFF,2,0,1,2
TRBV30,TRBJ1-1,CAWSTAQLMNTEAFF,2,0,1,2
TRBV30,TRBJ1-4,CAWRAGVTTNEKLFF,2,0,1,2
TRBV18,TRBJ1-1,CAGSPPHRDDTEAFF,2,0,1,2
TRBV11-3,TRBJ2-1,CAGSLQGEANSEQFF,2,0,1,2
TRBV10-3,TRBJ2-3,CAIARQTGGTDTQYF,2,0,1,2
TRBV10-3,TRBJ1-2,CAISESPRGYYGYTF,2,0,1,2
TRBV10-3,TRBJ2-2,CAIRPAGGNTGELFF,2,0,1,2
TRBV24-1,TRBJ2-7,CATSTYLPAFYEQYF,2,0,1,2
TRBV15,TRBJ2-1,CATSTLAWYDNEQFF,2,0,1,2
TRBV10-3,TRBJ2-3,CATSFLSSGTDTQYF,2,0,1,2
TRBV19,TRBJ1-1,CASCSIGLKNTEAFF,2,0,1,2
TRBV19,TRBJ2-2,CASEQLAWGTGELFF,2,0,1,2
TRBV19,TRBJ2-3,CASSETSGGTDTQYF,2,0,1,2
TRBV19,TRBJ1-1,CASSIQKGRGTEAFF,2,0,1,2
TRBV19,TRBJ2-1,CASSIGSGSYNEQFF,2,0,1,2
TRBV19,TRBJ2-5,CASSIIGQNQETQYF,2,0,1,2
TRBV19,TRBJ1-5,CASSNYGLGTQPQHF,2,0,1,2
TRBV19,TRBJ2-7,CASRESLSAGYEQYF,2,0,1,2
TRBV6-2/3/5/6,TRBJ1-4,CASKQWFGTNEKLFF,2,0,1,2
TRBV18,TRBJ2-7,CASSLNGPSSYEQYF,2,0,1,2
TRBV2,TRBJ2-1,CASSLGGEAYNEQFF,2,0,1,2
TRBV2,TRBJ2-5,CASSSGQGAWETQYS,2,0,1,2
TRBV18,TRBJ1-6,CASSQGDSYNSPLHF,2,0,1,2
TRBV18,TRBJ2-5,CASSSPTGRSETQYF,2,0,1,2
TRBV18,TRBJ2-5,CASSPGIAGGEDQYF,2,0,1,2
TRBV18,TRBJ1-5,CASSPQANSNQPQHF,2,0,1,2
TRBV18,TRBJ2-1,CASSPTGPPYNEQFF,2,0,1,2
TRBV5-5,TRBJ2-1,CASLRGLAGNNEQFF,2,0,1,2
TRBV7-9,TRBJ2-1,CASRVSNRSYNEQFF,2,0,1,2
TRBV18,TRBJ2-1,CASAAPGGQYNGQFF,2,0,1,2
TRBV25-1,TRBJ1-5,CASIEKDSGNQPQHF,2,0,1,2
TRBV2,TRBJ1-1,CASMNYGRSNTEAFF,2,0,1,2
TRBV6-2/3/5/6,TRBJ2-7,CASTIRQGTSYEQYF,2,0,1,2
TRBV6-4,TRBJ2-3,CASTLAGGHTDTQYF,2,0,1,2
TRBV12-3/4,TRBJ2-5,CASTWTGVEKETQYF,2,0,1,2
TRBV6-2/3/5/6,TRBJ2-1,CASTPEQGLYNEQFF,2,0,1,2
TRBV12-3/4,TRBJ2-1,CASTPTRSSYNEQFF,2,0,1,2
TRBV6-2/3/5/6,TRBJ2-5,CASTGTGSTRETQYF,2,0,1,2
TRBV6-2/3/5/6,TRBJ2-3,CASSFWVAFTDTQYF,2,0,1,2
TRBV6-2/3/5/6,TRBJ2-7,CASSFRSGRRYEQYF,2,0,1,2
TRBV6-2/3/5/6,TRBJ2-5,CASSFGTGDQETQYF,2,0,1,2
TRBV12-3/4,TRBJ2-1,CASSLSGEGYNEQFF,2,0,1,2
TRBV12-3/4,TRBJ1-2,CASSLAGPPNYGYTF,2,0,1,2
TRBV6-1,TRBJ2-1,CASSLKRGGQNEQFF,2,0,1,2
TRBV6-2/3/5/6,TRBJ2-1,CASSLLRGGGHEQFS,2,0,1,2
TRBV12-3/4,TRBJ2-7,CASSLSPIHSYEQYF,2,0,1,2
TRBV6-2/3/5/6,TRBJ1-1,CASSLPGRLNTEAFF,2,0,1,2
TRBV6-2/3/5/6,TRBJ2-1,CASSLVRNSYNEQFF,2,0,1,2
TRBV6-2/3/5/6,TRBJ2-1,CASSLTNSGGREQFF,2,0,1,2
TRBV6-2/3/5/6,TRBJ1-2,CASSSRDRGLFGYTF,2,0,1,2
TRBV7-9,TRBJ2-3,CASSSTSGSGDTQYF,2,0,1,2
TRBV12-3/4,TRBJ1-5,CASSSRDYSNQPQHF,2,0,1,2
TRBV27,TRBJ1-1,CASSYSGTGNTEAFF,2,5,2,7
TRBV6-2/3/5/6,TRBJ2-5,CASSYSSTPQETQYF,2,0,1,2
TRBV6-2/3/5/6,TRBJ2-4,CASSYSSLAKNIQYF,2,0,1,2
TRBV6-2/3/5/6,TRBJ2-2,CASSYSRQGGWELFF,2,0,1,2
TRBV6-2/3/5/6,TRBJ2-5,CASSYSDRVWETQYF,2,0,1,2
TRBV6-2/3/5/6,TRBJ1-1,CASSYSKWGNTEAFF,2,0,1,2
TRBV6-2/3/5/6,TRBJ1-1,CASSYGVFMNTEAFF,2,0,1,2
TRBV6-2/3/5/6,TRBJ2-7,CASSYRASQTYEQYF,2,0,1,2
TRBV6-2/3/5/6,TRBJ2-7,CASSLRLAGEDEQYF,2,0,1,2
TRBV3-1,TRBJ1-5,CASSLQGESNQPQHF,2,0,1,2
TRBV12-3/4,TRBJ1-2,CASSPGRTDPRGYTF,2,5,2,7
TRBV6-2/3/5/6,TRBJ2-1,CASSPQKSSYNEQFF,2,0,1,2
TRBV7-2,TRBJ2-1,CASSPEGVSYNEQFF,2,0,1,2
TRBV12-3/4,TRBJ1-2,CASSPLPTFWGGYTF,2,0,1,2
TRBV7-2,TRBJ2-1,CASSPLAGIHNEQFF,2,0,1,2
TRBV27,TRBJ2-7,CASSPARDSGHEQYF,2,0,1,2
TRBV25-1,TRBJ2-1,CASSGRLGMGNEQFF,2,0,1,2
TRBV6-1,TRBJ1-2,CASSGELSGDYGYTS,2,0,1,2
TRBV6-1,TRBJ2-7,CASSDLGTRSYEQYF,2,0,1,2
TRBV6-4,TRBJ2-1,CASSDGTGGNNEQFF,2,0,1,2
TRBV6-4,TRBJ2-3,CASSDSAGSTDTQYF,2,0,1,2
TRBV2,TRBJ2-4,CASSEDLGAKNIQYF,2,0,1,2
TRBV25-1,TRBJ1-4,CASSEFTGRHEKLFF,2,0,1,2
TRBV2,TRBJ2-5,CASSEYRGGRETQYF,2,0,1,2
TRBV6-1,TRBJ2-7,CASSEAPLNSYEQYF,2,0,1,2
TRBV6-4,TRBJ1-2,CASSTRDTVNYGYTF,2,0,1,2
TRBV2,TRBJ2-2,CASSRGTANTGELFF,2,0,1,2
TRBV7-6,TRBJ2-3,CASSFSPGGTDTQYF,2,0,1,2
TRBV7-9,TRBJ2-1,CASSFQGMGPNEQFF,2,0,1,2
TRBV7-2,TRBJ2-3,CASSFGLAGTDTQYF,2,0,1,2
TRBV7-2,TRBJ1-2,CASSFVWGMTYGYTF,2,0,1,2
TRBV7-3,TRBJ2-3,CASSFAGGSTDTQYF,2,0,1,2
TRBV7-9,TRBJ1-5,CASSFEGQGHQPQHF,2,0,1,2
TRBV5-4,TRBJ2-7,CASSLLSPSSYEQYF,2,0,1,2
TRBV7-9,TRBJ1-5,CASSLGDRGNQPQHF,2,0,1,2
TRBV5-4,TRBJ1-5,CASSLEPGSNQPQHF,2,0,1,2
TRBV5-6,TRBJ2-5,CASSLIQGGEETQYF,2,0,1,2
TRBV5-4,TRBJ1-5,CASSLTGDGNQPQHF,2,0,1,2
TRBV13,TRBJ2-1,CASSLKAGGYNEQFF,2,6,2,8
TRBV7-6,TRBJ2-1,CASSLWGSSYNEQFF,2,0,1,2
TRBV11-3,TRBJ2-1,CASSLRGGPYNEQFF,2,3,2,5
TRBV7-9,TRBJ1-4,CASSLVGQNNEKLFF,2,0,1,2
TRBV13,TRBJ2-2,CASSLVAGLTGELFF,2,0,1,2
TRBV7-2,TRBJ1-5,CASSLVSRALQPQHF,2,0,1,2
TRBV7-9,TRBJ1-1,CASSLVGQWNTEAFF,2,0,1,2
TRBV7-8,TRBJ1-6,CASSLAQGARSPLHF,2,0,1,2
TRBV7-9,TRBJ1-1,CASSLATTVNTEAFF,2,0,1,2
TRBV7-9,TRBJ2-1,CASSLATSSYNEQFF,2,0,1,2
TRBV7-6,TRBJ1-1,CASSLAGTWGAEAFF,2,0,1,2
TRBV7-9,TRBJ1-2,CASSLGGTGDRGYTF,2,0,1,2
TRBV7-8,TRBJ2-7,CASSLGSGFSYEQYF,2,11,2,13
TRBV6-2/3/5/6,TRBJ2-1,CASSLGGGGHNEQFF,2,0,1,2
TRBV11-2,TRBJ1-5,CASSLGGQVNQPQHF,2,0,1,2
TRBV7-7,TRBJ2-2,CASSLGYGDSGELFF,2,0,1,2
TRBV7-2,TRBJ1-2,CASSLGPRTGGGYTF,2,0,1,2
TRBV11-1,TRBJ2-7,CASSLGDLLPGEQYF,2,0,1,2
TRBV7-9,TRBJ2-7,CASSLDPGRDYEQYF,2,0,1,2
TRBV7-6,TRBJ2-3,CASSLDPSYTDTQYF,2,0,1,2
TRBV7-2,TRBJ2-1,CASSLSPGTGDEQFF,2,0,1,2
TRBV7-2,TRBJ1-2,CASSLSSDTYNGYTF,2,0,1,2
TRBV7-2,TRBJ2-3,CASSLRGGGTDTQYF,2,0,1,2
TRBV7-9,TRBJ2-3,CASSSLDRGPDTQYF,2,0,1,2
TRBV7-9,TRBJ2-5,CASSSSGTGQETQYF,2,0,1,2
TRBV5-4,TRBJ2-3,CASSSWTGRTDTQYF,2,0,1,2
TRBV7-2,TRBJ2-7,CASSSPGRSSYEQYF,2,0,1,2
TRBV7-6,TRBJ2-5,CASSSRQGAVETQYF,2,0,1,2
TRBV7-9,TRBJ1-6,CASSSMGQGFSPLHF,2,0,1,2
TRBV7-2,TRBJ2-3,CASSSNSPSTDTQYF,2,4,2,6
TRBV7-9,TRBJ1-2,CASSSSGTGFGGYTF,2,0,1,2
TRBV5-4,TRBJ1-2,CASSWRGSSNYGYTF,2,0,1,2
TRBV28,TRBJ2-1,CASSLSGYSYNEQFF,2,0,1,2
TRBV11-2,TRBJ2-7,CASSLSGTISYEQYF,2,5,2,7
TRBV5-5,TRBJ2-1,CASSLRDSALVEQFF,2,0,1,2
TRBV5-6,TRBJ2-6,CASSLGLAGANVLTF,2,0,1,2
TRBV3-1,TRBJ1-3,CASSLSRDTGNTIYF,2,0,1,2
TRBV5-4,TRBJ2-1,CASSLAVSSYNEQFF,2,0,1,2
TRBV7-9,TRBJ2-7,CASSPTSGRAYEQYF,2,0,1,2
TRBV7-2,TRBJ2-3,CASSPSGGAADTQYF,2,0,1,2
TRBV7-2,TRBJ1-5,CASSPRGGRNQPQHF,2,0,1,2
TRBV11-2,TRBJ2-5,CASSPRDRGRETQYF,2,0,1,2
TRBV5-6,TRBJ2-7,CASSPAAGVSYEQYF,2,0,1,2
TRBV9,TRBJ1-3,CASSPGGFSGNTIYF,2,0,1,2
TRBV7-9,TRBJ1-1,CASSPGTDFNTEAFF,2,0,1,2
TRBV11-3,TRBJ2-1,CASSPDVSSYNEQFF,2,0,1,2
TRBV5-4,TRBJ2-1,CASSPDIGGANEQFF,2,0,1,2
TRBV7-6,TRBJ1-5,CASSPGVNSNQPQHF,2,0,1,2
TRBV7-9,TRBJ1-6,CASSPGTLAVSPLHF,2,0,1,2
TRBV5-4,TRBJ2-1,CASSPSVPGGNEQFF,2,0,1,2
TRBV5-5,TRBJ1-6,CASSPTLTPEKALHF,2,0,1,2
TRBV9,TRBJ2-7,CASSPRGQDPYEQYF,2,0,1,2
TRBV7-6,TRBJ2-1,CASSRISGSRNGQFF,2,0,1,2
TRBV7-9,TRBJ2-7,CASSRRGLAGAEQYF,2,0,1,2
TRBV4-2,TRBJ2-3,CASSHLGERLDTQYF,2,0,1,2
TRBV9,TRBJ1-3,CASSHSGGAGNTIYF,2,0,1,2
TRBV3-1,TRBJ1-2,CASSQIPKGRYGYTF,2,0,1,2
TRBV3-1,TRBJ2-1,CASSQVDRQGNEQFF,2,0,1,2
TRBV3-1,TRBJ1-1,CASSQGRGEGSEAFF,2,0,1,2
TRBV4-2,TRBJ2-5,CASSQDPGSRETQYF,2,0,1,2
TRBV3-1,TRBJ2-7,CASSQDASGSGEQYF,2,0,1,2
TRBV14,TRBJ2-7,CASSQDRGLPYEQYF,2,0,1,2
TRBV3-1,TRBJ2-7,CASSQEGGRGQEQYF,2,0,1,2
TRBV3-1,TRBJ2-7,CASSQIPPPSYEQYF,2,0,1,2
TRBV4-2,TRBJ1-1,CASSQTWTGGTEAFF,2,0,1,2
TRBV14,TRBJ2-5,CASSQNLGAGETQYF,2,0,1,2
TRBV9,TRBJ2-1,CASSVGGSSYNEQFF,2,0,1,2
TRBV9,TRBJ2-5,CASSVVSGGRETRYF,2,0,1,2
TRBV9,TRBJ1-5,CASSVAGTGNQPQHF,2,0,1,2
TRBV9,TRBJ2-1,CASSVEGGFYNEQFF,2,0,1,2
TRBV7-2,TRBJ1-3,CASSAQTGPGNTIYF,2,0,1,2
TRBV6-2/3/5/6,TRBJ2-1,CASSAGTSGHYERFF,2,0,1,2
TRBV5-4,TRBJ2-1,CASSATSGAYNEQFF,2,0,1,2
TRBV5-6,TRBJ1-5,CASSAQGGEYQPQHF,2,0,1,2
TRBV11-2,TRBJ2-5,CASSGDGTSEETQYF,2,4,2,6
TRBV6-2/3/5/6,TRBJ1-5,CASSGGQYSNQPQHF,2,0,1,2
TRBV9,TRBJ1-1,CASSDKTGGRTEAFF,2,0,1,2
TRBV3-1,TRBJ2-5,CASSEGGGNLETQYF,2,0,1,2
TRBV7-2,TRBJ2-7,CASSIRTSGSYEQYF,2,4,2,6
TRBV5-5,TRBJ1-5,CASSTSSRENQPQHF,2,0,1,2
TRBV5-6,TRBJ1-1,CASSTAGMRSTEAFF,2,0,1,2
TRBV6-2/3/5/6,TRBJ2-1,CASSRTLPSYNEQFF,2,0,1,2
TRBV5-4,TRBJ1-1,CASSRSRLGGRGAFF,2,0,1,2
TRBV12-3/4,TRBJ2-1,CASSNSGLTYNEQFF,2,0,1,2
TRBV27,TRBJ2-1,CASRPLTGSYNEQFF,2,0,1,2
TRBV12-3/4,TRBJ2-5,CASRMTSGGPETQYF,2,0,1,2
TRBV6-1,TRBJ2-1,CASRIQGLVYDEQFF,2,0,1,2
TRBV6-2/3/5/6,TRBJ1-2,CASRSDWVLNYGYTF,2,0,1,2
TRBV6-2/3/5/6,TRBJ2-7,CASRPLGQVPYEQYF,2,0,1,2
TRBV6-2/3/5/6,TRBJ2-6,CASRPTGYGANVLTF,2,0,1,2
TRBV6-2/3/5/6,TRBJ2-7,CASRAGTGEAYEQYF,2,0,1,2
TRBV12-3/4,TRBJ2-3,CASRESGRDADTQYF,2,0,1,2
TRBV7-2,TRBJ2-3,CASRTRGGGADTQYF,2,0,1,2
TRBV6-2/3/5/6,TRBJ2-1,CASRTQGQGGDEQFF,2,0,1,2
TRBV6-2/3/5/6,TRBJ1-3,CASRTREVSGNTIYF,2,2,2,4
TRBV27,TRBJ2-5,CASRSLAGGLETQYF,2,0,1,2
TRBV12-3/4,TRBJ2-2,CASRRGGVSTGELFF,2,0,1,2
TRBV7-9,TRBJ2-1,CASRNPGQGHYEQFF,2,0,1,2
TRBV12-3/4,TRBJ2-6,CASNPTGTGANVLTF,2,0,1,2
TRBV5-6,TRBJ2-1,CASNPGTQGGDEQFF,2,0,1,2
TRBV4-1,TRBJ1-1,CASVGREVRNTEAFF,2,0,1,2
TRBV4-3,TRBJ2-4,CASGQEDRVKNIQYF,2,0,1,2
TRBV5-1,TRBJ1-4,CASTLSWATNENLFF,2,0,1,2
TRBV5-1,TRBJ1-1,CASSFGGRLNTEAFF,2,0,1,2
TRBV5-1,TRBJ2-1,CASSFSGIQMYEQFF,2,0,1,2
TRBV5-1,TRBJ2-3,CASSFVGSSTDTQYF,2,0,1,2
TRBV5-1,TRBJ2-7,CASSFGQGSIYEQYF,2,0,1,2
TRBV5-1,TRBJ1-2,CASSLLGTVDYGYTF,2,0,1,2
TRBV5-1,TRBJ2-3,CASSLSEGGTDTQYF,2,0,1,2
TRBV5-1,TRBJ2-3,CASSLQDQSTDTQYF,2,0,1,2
TRBV5-1,TRBJ2-1,CASSLVSSSYNEQFF,2,0,1,2
TRBV5-1,TRBJ2-1,CASSLGQGAKREQFF,2,0,1,2
TRBV5-1,TRBJ1-2,CASSLGAGGNYGYTF,2,0,1,2
TRBV5-1,TRBJ2-3,CASSLDRDVTDTQYF,2,0,1,2
TRBV5-1,TRBJ2-3,CASSLEARGTDTQYF,2,0,1,2
TRBV5-1,TRBJ1-1,CASSLMSGEDTEAFF,2,0,1,2
TRBV5-1,TRBJ2-5,CASSLNGQGGETQYF,2,0,1,2
TRBV4-1,TRBJ2-1,CASSLTSGGYNEQFF,2,0,1,2
TRBV4-1,TRBJ1-2,CASSPPGGGYGGYTF,2,0,1,2
TRBV4-1,TRBJ2-7,CASSPVGSGVYEQYF,2,0,1,2
TRBV4-3,TRBJ2-7,CASSPGRTASYEQYF,2,0,1,2
TRBV4-3,TRBJ2-7,CASSPLGLAGNEQYF,2,0,1,2
TRBV5-1,TRBJ2-1,CASSRAPDSYNEQFF,2,0,1,2
TRBV4-1,TRBJ2-1,CASSHQRSAYNEQFF,2,0,1,2
TRBV4-1,TRBJ1-5,CASSQGQLGNQPQHF,2,4,2,6
TRBV4-1,TRBJ1-1,CASSQPGSSNTEAFF,2,0,1,2
TRBV4-1,TRBJ1-4,CASSQGGRGNEKLFF,2,0,1,2
TRBV4-3,TRBJ2-7,CASSQDLSYSYEQYF,2,0,1,2
TRBV4-1,TRBJ2-5,CASSQDPMRWETQYF,2,0,1,2
TRBV4-1,TRBJ2-7,CASSQEAVDTYEQYF,2,0,1,2
TRBV4-3,TRBJ2-1,CASSQEWGSYNEQFF,2,0,1,2
TRBV4-1,TRBJ1-6,CASSQMTSPSSPLHF,2,0,1,2
TRBV5-1,TRBJ2-6,CASSVQDSGANVLTF,2,0,1,2
TRBV4-3,TRBJ2-1,CASKEGEGSYNEQFF,2,0,1,2
TRBV20-1,TRBJ1-1,CSAPRGGEQGTEAFF,2,0,1,2
TRBV20-1,TRBJ2-7,CSAPAWRSSSYEQYF,2,0,1,2
TRBV20-1,TRBJ2-7,CSAQSPQGRRYEQYF,2,0,1,2
TRBV20-1,TRBJ1-2,CSARGPQAFHYGYTF,2,0,1,2
TRBV20-1,TRBJ2-3,CSARRGRFDTDTQYF,2,0,1,2
TRBV20-1,TRBJ2-4,CSARLGTGAGDIQYF,2,0,1,2
TRBV20-1,TRBJ1-6,CSARQQGTYNSPLHF,2,0,1,2
TRBV20-1,TRBJ1-6,CSARARWQWNSPLHF,2,0,1,2
TRBV20-1,TRBJ2-5,CSARDLRGREETQYF,2,0,1,2
TRBV20-1,TRBJ1-2,CSARDWDRGDYGYTF,2,0,1,2
TRBV20-1,TRBJ1-1,CSARDYAGRYTEAFF,2,0,1,2
TRBV20-1,TRBJ2-3,CSARDAGTSGDTQYF,2,0,1,2
TRBV20-1,TRBJ2-2,CSARETDREVGELFF,2,0,1,2
TRBV20-1,TRBJ2-1,CSASTSGGAWNEQFF,2,0,1,2
TRBV20-1,TRBJ2-7,CSALIGGEVGNEQYF,2,6,2,8
TRBV20-1,TRBJ2-4,CSGFSSGAGGNIQYF,2,0,1,2
TRBV20-1,TRBJ2-3,CSGGTSGSGTDTQYF,2,0,1,2
TRBV20-1,TRBJ1-6,CSDIRDKQGNSPLHF,2,0,1,2
TRBV29-1,TRBJ2-1,CSVVYKGTSNNEQFF,2,0,1,2
TRBV29-1,TRBJ2-1,CSVVLAGGPGNEQFF,2,0,1,2
TRBV29-1,TRBJ2-1,CSVVATSGWENEQFF,2,0,1,2
TRBV29-1,TRBJ2-7,CSVEDTGTGADEQYF,2,4,2,6
TRBV20-1,TRBJ2-1,CRARAWDRSINEQFF,2,0,1,2
TRBV7-9,TRBJ1-5,RASSSGQGMGQPQHF,2,0,1,2
TRBV12-5,TRBJ2-7,CASGFQSGRTEQYF,2,0,1,2
TRBV12-5,TRBJ2-5,CASGLRTGIETQYF,2,0,1,2
TRBV30,TRBJ1-1,CAWTRAGVWTEAFF,2,0,1,2
TRBV30,TRBJ1-4,CAWSAGTENEKLFF,2,6,2,8
TRBV30,TRBJ1-5,CAWSGTGGNQPQHF,2,0,1,2
TRBV30,TRBJ2-6,CAWSIDSGANVLTF,2,0,1,2
TRBV30,TRBJ1-5,CAWSEGVRRQPQHF,2,0,1,2
TRBV30,TRBJ2-1,CAWSKGLAGDEQFF,2,0,1,2
TRBV10-3,TRBJ1-2,CAISEPDGDYGYTF,2,0,1,2
TRBV10-3,TRBJ1-6,CAISPGQGSSPLHF,2,0,1,2
TRBV10-3,TRBJ2-1,CAIRGLAVYNEQFF,2,0,1,2
TRBV5-5,TRBJ2-7,CATGMSGRAYEQNF,2,0,1,2
TRBV10-3,TRBJ2-5,CATGISLGEKAQYF,2,0,1,2
TRBV30,TRBJ2-7,CATGLAGLSYEQYF,2,0,1,2
TRBV24-1,TRBJ1-2,CATTRPGRNYGYTF,2,0,1,2
TRBV15,TRBJ2-7,CATSPRDGAYEQYF,2,0,1,2
TRBV15,TRBJ2-5,CATSRDRGRETQYF,2,0,1,2
TRBV15,TRBJ1-6,CATSRDRASHTLHF,2,0,1,2
TRBV24-1,TRBJ1-5,CATNRTGGGQPQHF,2,0,1,2
TRBV19,TRBJ1-1,CASTPDRWNTEAFF,2,0,1,2
TRBV19,TRBJ2-3,CASSSTGFTDTQYF,2,0,1,2
TRBV19,TRBJ2-1,CASSALRVYNEQFF,2,0,1,2
TRBV19,TRBJ1-1,CASSIVTGNTEAFF,2,0,1,2
TRBV19,TRBJ1-4,CASSILLGDEKLFF,2,0,1,2
TRBV19,TRBJ2-1,CASSIGPSNNEQFF,2,0,1,2
TRBV19,TRBJ2-5,CASSIETSGRVQYF,2,0,1,2
TRBV19,TRBJ2-7,CASSTGMSTYEQYF,2,0,1,2
TRBV19,TRBJ2-7,CASSRQNKDYEQYF,2,0,1,2
TRBV19,TRBJ1-4,CASNPAVGGEKLFF,2,0,1,2
TRBV19,TRBJ1-4,CASKRNPTNEKLFF,2,0,1,2
TRBV7-2,TRBJ2-7,CASFDGTGVSEQYF,2,0,1,2
TRBV18,TRBJ1-4,CASSPSATNEKLFF,2,11,2,13
TRBV18,TRBJ2-7,CASSLRDRAGEQYF,2,0,1,2
TRBV18,TRBJ1-1,CASSPSTGNTEAFF,2,0,1,2
TRBV18,TRBJ2-7,CASSPRKDAYEQYF,2,0,1,2
TRBV18,TRBJ1-1,CASSPSGRGAGAFF,2,0,1,2
TRBV18,TRBJ1-4,CASSQSATNEKLFF,2,0,1,2
TRBV18,TRBJ2-5,CASSQGTDQETQYF,2,0,1,2
TRBV7-9,TRBJ2-4,CASRGEGAKNIQYF,2,0,1,2
TRBV19,TRBJ2-7,CASREDYGAYEQYF,2,6,2,8
TRBV6-2/3/5/6,TRBJ2-7,CASQPDRSTYEQYF,2,0,1,2
TRBV2,TRBJ2-5,CASAGQGGQETQYF,2,0,1,2
TRBV2,TRBJ2-7,CASGTSGGYYEQYF,2,0,1,2
TRBV28,TRBJ2-5,CASGASGYQETQYF,2,0,1,2
TRBV6-2/3/5/6,TRBJ2-5,CASELGGKQETQYF,2,0,1,2
TRBV5-6,TRBJ1-6,CASESRSEFPPLHF,2,0,1,2
TRBV2,TRBJ1-2,CASIQTDSDYGYTF,2,0,1,2
TRBV13,TRBJ1-4,CASTLGGRAEKLFF,2,0,1,2
TRBV16,TRBJ2-7,CASTRIGISYEQYF,2,0,1,2
TRBV7-9,TRBJ1-6,CASTEPPHNSPLHF,2,0,1,2
TRBV28,TRBJ2-3,CASSFLSGTDTQYF,2,0,1,2
TRBV12-3/4,TRBJ2-7,CASSFWDRSYEQYF,2,0,1,2
TRBV12-3/4,TRBJ2-1,CASSFQGAHNEQFF,2,0,1,2
TRBV12-3/4,TRBJ1-3,CASSFAGSGNTIYF,2,0,1,2
TRBV6-2/3/5/6,TRBJ2-1,CASSFGGVGNEQFF,2,0,1,2
TRBV12-3/4,TRBJ1-5,CASSFGLLNQPQHF,2,0,1,2
TRBV12-3/4,TRBJ1-6,CASSFTQGESPLHF,2,0,1,2
TRBV27,TRBJ1-1,CASSFRGGDTEAFF,2,0,1,2
TRBV12-3/4,TRBJ2-7,CASSLVGSSYEQYF,2,0,1,2
TRBV12-3/4,TRBJ2-2,CASSLVGRTGELFF,2,0,1,2
TRBV12-3/4,TRBJ2-7,CASSLVVSSYEQYF,2,0,1,2
TRBV12-3/4,TRBJ2-1,CASSLAGDENEQFF,2,4,2,6
TRBV12-3/4,TRBJ2-5,CASSLGGSQETQYF,2,0,1,2
TRBV12-3/4,TRBJ1-6,CASSLTGGNSPLHF,2,0,1,2
TRBV6-2/3/5/6,TRBJ2-5,CASSLNRGQETQYF,2,6,2,8
TRBV6-2/3/5/6,TRBJ1-1,CASSLKGDGTGAFF,2,0,1,2
TRBV28,TRBJ1-2,CASSSSPLNYGYTF,2,0,1,2
TRBV2,TRBJ1-6,CASSSGPTHSPLHF,2,0,1,2
TRBV12-3/4,TRBJ2-3,CASSSTARGDTQYF,2,0,1,2
TRBV6-2/3/5/6,TRBJ1-2,CASSYWRQGSGYTF,2,0,1,2
TRBV6-2/3/5/6,TRBJ1-1,CASSYSRPDGEAFF,2,0,1,2
TRBV6-2/3/5/6,TRBJ2-7,CASSYLSQSYEQYF,2,0,1,2
TRBV6-2/3/5/6,TRBJ1-4,CASSYAPNGGKLFF,2,0,1,2
TRBV6-2/3/5/6,TRBJ2-1,CASSYGTSGSKQFF,2,0,1,2
TRBV6-2/3/5/6,TRBJ1-3,CASSYGTGGDTIYF,2,0,1,2
TRBV6-2/3/5/6,TRBJ2-3,CASSYEREMDTQYF,2,6,2,8
TRBV6-2/3/5/6,TRBJ1-1,CASSLVYMNTEAFF,2,0,1,2
TRBV6-2/3/5/6,TRBJ2-1,CASSLSVEGNEQFF,2,0,1,2
TRBV6-2/3/5/6,TRBJ1-1,CASSLRGMNTEAFF,2,0,1,2
TRBV6-2/3/5/6,TRBJ1-2,CASSPLRESDGYTF,2,0,1,2
TRBV27,TRBJ1-5,CASSPLGGSQPQHF,2,0,1,2
TRBV12-3/4,TRBJ2-5,CASSPPGVRETQYF,2,0,1,2
TRBV12-3/4,TRBJ1-2,CASSPQGVNYGYTF,2,0,1,2
TRBV6-2/3/5/6,TRBJ1-5,CASSPAGGDQPQHF,2,0,1,2
TRBV6-2/3/5/6,TRBJ2-7,CASSPGTSGYEQYF,2,0,1,2
TRBV6-2/3/5/6,TRBJ1-1,CASSQSNMNTEAFF,2,0,1,2
TRBV12-3/4,TRBJ1-2,CASSVWDRDSGYTF,2,0,1,2
TRBV6-1,TRBJ2-5,CASSVGQLQETQYF,2,0,1,2
TRBV25-1,TRBJ2-7,CASSVGNRGYEQYF,2,0,1,2
TRBV6-1,TRBJ2-7,CASSAPGLSYEQYF,2,0,1,2
TRBV25-1,TRBJ2-1,CASSDSTKIYEQFF,2,0,1,2
TRBV6-1,TRBJ2-7,CASSEWSGEDEQYF,2,0,1,2
TRBV2,TRBJ1-2,CASSEARRTYGYTF,2,0,1,2
TRBV28,TRBJ2-3,CASSTTGTTDTQYF,2,0,1,2
TRBV7-2,TRBJ2-7,CASSFLRGTYEQYF,2,0,1,2
TRBV7-6,TRBJ1-1,CASSFPTGVSEAFF,2,0,1,2
TRBV7-3,TRBJ1-1,CASSFPGQNTEAFF,2,0,1,2
TRBV5-8,TRBJ2-5,CASSFRDDQETQYF,2,0,1,2
TRBV7-2,TRBJ2-4,CASSFIPGQDIQYF,2,0,1,2
TRBV7-2,TRBJ2-7,CASSFSGRPYEQYF,2,0,1,2
TRBV5-6,TRBJ2-2,CASSLSSLTGELFF,2,0,1,2
TRBV5-4,TRBJ2-5,CASSLVGSGETQYF,2,0,1,2
TRBV5-6,TRBJ2-7,CASSLVGTAYEQYF,2,0,1,2
TRBV5-6,TRBJ2-3,CASSLAATTDTQYF,2,0,1,2
TRBV7-9,TRBJ2-7,CASSLAGVGYEQYF,2,0,1,2
TRBV7-2,TRBJ1-3,CASSLDRAGNTIYF,2,15,2,17
TRBV5-6,TRBJ1-2,CASSLEARNYGYTF,2,0,1,2
TRBV5-6,TRBJ2-7,CASSLEGGLSKQYF,2,0,1,2
TRBV7-2,TRBJ1-5,CASSLVPGDQPQHF,2,0,1,2
TRBV11-2,TRBJ2-7,CASSLVRGAPEQYF,2,0,1,2
TRBV7-2,TRBJ2-7,CASSLVAFSYEQYF,2,0,1,2
TRBV11-3,TRBJ2-1,CASSLAVAGNEQFF,2,0,1,2
TRBV7-2,TRBJ1-2,CASSLAGVAYGYTF,2,0,1,2
TRBV7-9,TRBJ2-1,CASSLAISYNEQFF,2,0,1,2
TRBV7-8,TRBJ2-7,CASSLGYRVYEQYF,2,0,1,2
TRBV7-9,TRBJ1-1,CASSLDLVNTEAFF,2,0,1,2
TRBV7-9,TRBJ2-3,CASSLDRLTDTQYF,2,0,1,2
TRBV7-3,TRBJ2-1,CASSLTGANNEQFF,2,0,1,2
TRBV7-2,TRBJ1-1,CASSLRQGAFEAFF,2,0,1,2
TRBV7-2,TRBJ2-2,CASSLNRATGELFF,2,0,1,2
TRBV11-2,TRBJ2-3,CASSSWEAYDTQYF,2,0,1,2
TRBV7-2,TRBJ1-1,CASSSLDRVEGAFF,2,0,1,2
TRBV7-6,TRBJ2-5,CASSSTGLKETQYF,2,0,1,2
TRBV7-9,TRBJ1-4,CASSSTTRTGKLFF,2,0,1,2
TRBV28,TRBJ1-4,CASSSGQINEKLFF,2,0,1,2
TRBV7-2,TRBJ2-2,CASSSDQGAGELFF,2,0,1,2
TRBV5-6,TRBJ2-7,CASSSDRGSYEQYF,2,0,1,2
TRBV7-3,TRBJ1-5,CASSSTDSNQPQHF,2,0,1,2
TRBV7-9,TRBJ2-5,CASSSTGGGETQYF,2,0,1,2
TRBV7-9,TRBJ2-5,CASSSQVGQETQYF,2,0,1,2
TRBV7-6,TRBJ2-1,CASSSASGRNEQFF,2,5,2,7
TRBV7-6,TRBJ2-7,CASSSEQGIYEQYF,2,0,1,2
TRBV5-4,TRBJ1-6,CASSWDRDNSPLHF,2,0,1,2
TRBV5-4,TRBJ2-5,CASSWTGFQETQYF,2,0,1,2
TRBV7-2,TRBJ2-3,CASSLSGGTDTQYF,2,0,1,2
TRBV7-9,TRBJ2-1,CASSLVPGDNEQFF,2,0,1,2
TRBV12-3/4,TRBJ2-2,CASSLRGGTGELFF,2,0,1,2
TRBV12-3/4,TRBJ2-7,CASSLMPGNHEQYF,2,5,2,7
TRBV7-9,TRBJ1-1,CASSLTLANSEAFF,2,0,1,2
TRBV7-9,TRBJ2-1,CASSLTADYNEQFF,2,0,1,2
TRBV4-2,TRBJ2-7,CASSPTSGPYEQYF,2,0,1,2
TRBV5-5,TRBJ2-7,CASSPRGDSYEQYF,2,0,1,2
TRBV3-1,TRBJ2-7,CASSPRTGEYEQYF,2,0,1,2
TRBV7-2,TRBJ2-3,CASSPQNRADTQYF,2,0,1,2
TRBV7-6,TRBJ2-5,CASSPGGGPETQYF,2,0,1,2
TRBV4-2,TRBJ2-1,CASSPGGSYNEQFF,2,0,1,2
TRBV9,TRBJ2-1,CASSPGLEDNEQFF,2,0,1,2
TRBV4-2,TRBJ2-3,CASSPGLASDTQYF,2,0,1,2
TRBV7-2,TRBJ2-5,CASSPSGSLETQYF,2,0,1,2
TRBV9,TRBJ2-5,CASSPSDGLGTQYF,2,0,1,2
TRBV6-2/3/5/6,TRBJ2-5,CASSPDGAPATQYF,2,0,1,2
TRBV9,TRBJ2-1,CASSRRGGADEQFF,2,0,1,2
TRBV7-9,TRBJ2-7,CASSRGTVEYEQYF,2,0,1,2
TRBV3-1,TRBJ1-1,CASSHTTANTEAFF,2,0,1,2
TRBV3-1,TRBJ1-1,CASSQWEPNTEAFF,2,10,2,12
TRBV4-2,TRBJ2-7,CASSQGDGPYEQYF,2,0,1,2
TRBV11-1,TRBJ2-7,CASSQDRGAYEQYF,2,0,1,2
TRBV4-2,TRBJ1-1,CASSQVDAFTEAFF,2,0,1,2
TRBV3-1,TRBJ1-1,CASSQAAASRKAFF,2,0,1,2
TRBV4-2,TRBJ2-5,CASSQRGNQETQYF,2,3,2,5
TRBV9,TRBJ2-5,CASSVSAVQETQYF,2,5,2,7
TRBV9,TRBJ1-1,CASSVASEVGEAFF,2,0,1,2
TRBV9,TRBJ1-6,CASSVAGMASPLHF,2,0,1,2
TRBV9,TRBJ1-6,CASSVAGGSSPLHF,2,0,1,2
TRBV9,TRBJ2-5,CASSVDVGGETQYF,2,0,1,2
TRBV5-6,TRBJ1-5,CASSGREGRGSQHF,2,0,1,2
TRBV9,TRBJ2-1,CASSGTLSYNEQFF,2,0,1,2
TRBV7-6,TRBJ2-3,CASSGMNGGDTQYF,2,0,1,2
TRBV7-9,TRBJ2-1,CASSELAGVNEQFF,2,0,1,2
TRBV9,TRBJ2-7,CASSEGRESSEQYF,2,0,1,2
TRBV7-9,TRBJ2-4,CASSERTGRNIQYF,2,0,1,2
TRBV5-4,TRBJ1-2,CASSIWGTGQGSAF,2,0,1,2
TRBV7-9,TRBJ2-3,CASSTRGGTDTQYF,2,0,1,2
TRBV5-4,TRBJ2-7,CASSTGRALYEQYF,2,7,2,9
TRBV14,TRBJ1-1,CASSNYRARTEAFF,2,0,1,2
TRBV7-9,TRBJ1-2,CASSNQGTAAGYTF,2,0,1,2
TRBV2,TRBJ1-5,CASRGAGGKQPQHF,2,0,1,2
TRBV12-3/4,TRBJ2-3,CASRGTGRSDTQYF,2,6,2,8
TRBV6-2/3/5/6,TRBJ1-4,CASRLTGIIEKLFF,2,0,1,2
TRBV5-6,TRBJ2-2,CASRIGQMTGELFF,2,0,1,2
TRBV12-3/4,TRBJ1-2,CASNSLGQLYGYTF,2,0,1,2
TRBV12-3/4,TRBJ2-3,CASKDGGGVDTQYF,2,0,1,2
TRBV7-2,TRBJ1-2,CANSLGSATGGYTF,2,0,1,2
TRBV5-1,TRBJ2-1,CASSRDRGHNEQFF,2,0,1,2
TRBV5-1,TRBJ2-6,CASGPGDGANVLTF,2,0,1,2
TRBV5-1,TRBJ1-3,CASSPGTDGNTIYF,2,0,1,2
TRBV10-2,TRBJ1-1,CASSDTGRFTEAFF,2,0,1,2
TRBV5-1,TRBJ1-2,CASSFRPDGEGYTF,2,0,1,2
TRBV5-1,TRBJ2-7,CASSFTGLAGGEYF,2,0,1,2
TRBV5-1,TRBJ2-7,CASSLAAGVHEQYF,2,0,1,2
TRBV5-1,TRBJ2-1,CASSLGWGHNEQFF,2,0,1,2
TRBV5-1,TRBJ2-7,CASSLGQGAYEQYF,2,0,1,2
TRBV5-1,TRBJ2-2,CASSLGTNTGELFF,2,0,1,2
TRBV5-1,TRBJ2-3,CASSLEGITDTQYF,2,0,1,2
TRBV5-1,TRBJ1-1,CASSLGRAATEAFF,2,0,1,2
TRBV5-1,TRBJ2-7,CASSLSGSTYEQYF,2,0,1,2
TRBV4-1,TRBJ1-2,CASSPLDRDYGYTF,2,0,1,2
TRBV4-1,TRBJ2-4,CASSPAGSGDIQYF,2,0,1,2
TRBV10-2,TRBJ1-1,CASSRVKLDTEAFF,2,0,1,2
TRBV4-3,TRBJ1-4,CASSHGQVGEKLFF,2,0,1,2
TRBV5-1,TRBJ2-3,CASSQGHPTDTQYF,2,0,1,2
TRBV4-3,TRBJ1-2,CASSQVGINYGYTF,2,0,1,2
TRBV4-3,TRBJ2-1,CASSQGGDYNEQFF,2,3,2,5
TRBV4-1,TRBJ2-7,CASSQGDGGYEQYF,2,0,1,2
TRBV4-3,TRBJ2-7,CASSQDWGNYEQYF,2,0,1,2
TRBV4-1,TRBJ2-1,CASSQERGYNEQSF,2,0,1,2
TRBV4-1,TRBJ2-6,CASSGGSGANVLTF,2,0,1,2
TRBV4-1,TRBJ2-2,CASSRDSRTGELFF,2,0,1,2
TRBV4-1,TRBJ2-7,CASRRVVGTYEQYF,2,0,1,2
TRBV5-1,TRBJ1-1,CASRKGLGGTEAFF,2,0,1,2
TRBV20-1,TRBJ1-2,CSAPPGGVSDGYTF,2,0,1,2
TRBV20-1,TRBJ1-1,CSAQIKTGGVEAFF,2,0,1,2
TRBV20-1,TRBJ2-5,CSAGGGAGQETQYF,2,0,1,2
TRBV20-1,TRBJ2-7,CSAIALWGNYEQYF,2,0,1,2
TRBV20-1,TRBJ2-3,CSASQGTYTDTQYF,2,0,1,2
TRBV20-1,TRBJ2-1,CSARAGGAYNEQFF,2,0,1,2
TRBV20-1,TRBJ1-5,CSARTGGSDKPQHF,2,0,1,2
TRBV20-1,TRBJ2-3,CSARLAGYTDTQYF,2,0,1,2
TRBV20-1,TRBJ1-1,CSARYGDRDTEAFF,2,0,1,2
TRBV20-1,TRBJ2-5,CSARVSGEQETQYF,2,0,1,2
TRBV20-1,TRBJ1-4,CSARAPDRAEKLFF,2,0,1,2
TRBV20-1,TRBJ1-4,CSARDGTFNEKLFF,2,0,1,2
TRBV20-1,TRBJ2-7,CSAPAGDRVYEQYF,2,0,1,2
TRBV20-1,TRBJ2-1,CSARASGRRGEQFF,2,0,1,2
TRBV20-1,TRBJ1-1,CSPSMWAVNTEAFF,2,0,1,2
TRBV29-1,TRBJ1-4,CSVSTASKGEKLFF,2,0,1,2
TRBV29-1,TRBJ2-1,CSVVYGQGGYEQFF,2,13,2,15
TRBV29-1,TRBJ1-4,CSVAEGTTNEKLFF,2,0,1,2
TRBV29-1,TRBJ2-1,CSVAGGLVFGEQFF,2,0,1,2
TRBV29-1,TRBJ1-5,CSVAFGASNQPQHF,2,0,1,2
TRBV29-1,TRBJ1-1,CSVGGVGGATEAFF,2,0,1,2
TRBV29-1,TRBJ2-7,CSVGGAGTVYEQYF,2,0,1,2
TRBV29-1,TRBJ2-4,CSVEGGQGRDIQYF,2,0,1,2
TRBV29-1,TRBJ2-1,CSVEPRWGLNEQFF,2,0,1,2
TRBV29-1,TRBJ2-3,CSVEGAFNTDTQYF,2,0,1,2
TRBV29-1,TRBJ2-1,CSVEGTSGYNEQFF,2,0,1,2
TRBV29-1,TRBJ1-2,CSVEDGGLGYGYTF,2,0,1,2
TRBV29-1,TRBJ2-3,CSVERAGPKDTQYF,2,0,1,2
TRBV29-1,TRBJ2-5,CSVAIGERGETQYF,2,0,1,2
TRBV29-1,TRBJ2-5,CSVLSLQSPETQYF,2,0,1,2
TRBV29-1,TRBJ1-4,CSVTGGTTNEKLFF,2,0,1,2
TRBV29-1,TRBJ1-5,CSASTGGRNQPQHF,2,0,1,2
TRBV29-1,TRBJ2-3,CSAQSGGRTDTQYF,2,0,1,2
TRBV29-1,TRBJ2-5,CSIEERDGQETQYF,2,0,1,2
TRBV2,TRBJ2-7,CVGSGTTRHEQYF,2,0,1,2
TRBV3-1,TRBJ2-5,CASSQGYQETQYF,2,0,1,2
TRBV5-4,TRBJ2-5,CASTSSWEETQYF,2,0,1,2
TRBV30,TRBJ1-1,CAWSTRRNTEAFF,2,0,1,2
TRBV30,TRBJ1-5,CAWSKGTGQPQHF,2,0,1,2
TRBV30,TRBJ2-6,CAWSLGGANVLSF,2,0,1,2
TRBV30,TRBJ2-1,CAGIRGMGNEQFF,2,0,1,2
TRBV10-3,TRBJ2-7,CAISADTSYEQYF,2,0,1,2
TRBV19,TRBJ1-5,CATQGLSNQPQHF,2,0,1,2
TRBV24-1,TRBJ2-2,CATGLAGGGELFF,2,0,1,2
TRBV19,TRBJ1-1,CATDHREGTEAFF,2,0,1,2
TRBV24-1,TRBJ2-1,CATSDLTYNEQFF,2,0,1,2
TRBV15,TRBJ1-1,CATSRSQNTEAFF,2,0,1,2
TRBV19,TRBJ1-1,CASSMGLNTEAFF,2,0,1,2
TRBV19,TRBJ2-3,CASSMGGTDTQYF,2,0,1,2
TRBV19,TRBJ1-5,CASSILGPGPQHF,2,0,1,2
TRBV19,TRBJ1-5,CASRRSPGEPQHF,2,5,2,7
TRBV19,TRBJ1-1,CASRVDRETEAFF,2,0,1,2
TRBV19,TRBJ2-1,CASNLQGDNEQFF,2,0,1,2
TRBV19,TRBJ1-2,CASNLGQNYGYTF,2,0,1,2
TRBV6-2/3/5/6,TRBJ2-5,CASSGWGREDLYF,2,0,1,2
TRBV9,TRBJ1-5,CASSMTGLEPQHF,2,0,1,2
TRBV5-4,TRBJ2-5,CASAGAGRETQYF,2,0,1,2
TRBV2,TRBJ2-5,CASGQEGQETQYF,2,0,1,2
TRBV2,TRBJ2-7,CASGRGGPVEQYF,2,0,1,2
TRBV12-3/4,TRBJ2-3,CASMSPGRDTQYF,2,0,1,2
TRBV7-9,TRBJ1-4,CASMHSTDEKLFF,2,0,1,2
TRBV3-1,TRBJ2-5,CASTRGRLETQYF,2,0,1,2
TRBV12-3/4,TRBJ2-7,CASSFVGGYEQYF,2,0,1,2
TRBV6-1,TRBJ2-1,CASSFADLAEQFF,2,0,1,2
TRBV27,TRBJ2-7,CASSFRGSYEQYF,2,0,1,2
TRBV6-2/3/5/6,TRBJ1-1,CASSFRTNTEAFF,2,0,1,2
TRBV12-3/4,TRBJ1-1,CASSFGGNTEAFF,2,0,1,2
TRBV6-2/3/5/6,TRBJ1-5,CASSFGENQPQHF,2,4,2,6
TRBV27,TRBJ1-2,CASSLGTGQGYTF,2,0,1,2
TRBV6-2/3/5/6,TRBJ1-2,CASSLRQGYGYTF,2,0,1,2
TRBV12-3/4,TRBJ2-1,CASSLNRYNEQFF,2,0,1,2
TRBV12-3/4,TRBJ1-4,CASSLARDEKLFF,2,0,1,2
TRBV6-2/3/5/6,TRBJ1-1,CASSLTRSTEAFF,2,0,1,2
TRBV5-5,TRBJ2-5,CASSSGTQETQYF,2,0,1,2
TRBV12-3/4,TRBJ1-2,CASSSRGGDGYTF,2,0,1,2
TRBV6-2/3/5/6,TRBJ2-7,CASSYAAVYEQYF,2,0,1,2
TRBV6-2/3/5/6,TRBJ1-1,CASSYGLNTEAFF,2,0,1,2
TRBV7-8,TRBJ2-7,CASSPGHSYEQYF,2,0,1,2
TRBV11-1,TRBJ2-3,CASSQVRTDTQYF,2,0,1,2
TRBV12-3/4,TRBJ1-5,CASSQSSNQPQHF,2,0,1,2
TRBV6-1,TRBJ2-7,CASSGVGDYEQYF,2,0,1,2
TRBV6-1,TRBJ1-5,CASSGEYNQPQHF,2,0,1,2
TRBV6-1,TRBJ1-2,CASSERGQGTVLL,2,0,1,2
TRBV6-1,TRBJ2-7,CASSEASESEQYF,2,5,2,7
TRBV2,TRBJ1-1,CASSEGGYTEAFF,2,0,1,2
TRBV6-1,TRBJ1-1,CASSEKYGPEAFF,2,0,1,2
TRBV7-2,TRBJ1-2,CASSTGQGNGYTF,2,0,1,2
TRBV7-6,TRBJ1-5,CASSTGGVQPQHF,2,0,1,2
TRBV6-2/3/5/6,TRBJ2-5,CASSSLQGAFSNF,2,0,1,2
TRBV12-3/4,TRBJ2-5,CASSRAGRKTQYF,2,0,1,2
TRBV6-4,TRBJ1-1,CASSRLMNTEAFF,2,0,1,2
TRBV7-2,TRBJ2-7,CASSFNDGHEQYF,2,0,1,2
TRBV7-2,TRBJ1-1,CASSFDGNTEAFF,2,0,1,2
TRBV5-4,TRBJ1-1,CASSFDRGTAAFF,2,0,1,2
TRBV7-9,TRBJ1-1,CASSFTRNTEAFF,2,0,1,2
TRBV11-2,TRBJ2-1,CASSLSPYNEQFF,2,0,1,2
TRBV5-4,TRBJ2-5,CASSLAPQETQYF,2,0,1,2
TRBV7-7,TRBJ2-7,CASSLTSGYEQYF,2,0,1,2
TRBV7-9,TRBJ1-1,CASSLSGRTEAFF,2,6,2,8
TRBV7-9,TRBJ1-5,CASSLSIRQPQHF,2,0,1,2
TRBV7-2,TRBJ2-7,CASSLSTPYEQYF,2,0,1,2
TRBV7-9,TRBJ1-5,CASSLATDQPQHF,2,0,1,2
TRBV11-3,TRBJ2-1,CASSLGGYNEQFF,2,0,1,2
TRBV7-3,TRBJ1-1,CASSLGGGSEAFF,2,0,1,2
TRBV7-9,TRBJ2-7,CASSLTGDYEQYF,2,0,1,2
TRBV11-1,TRBJ1-1,CASSLTGNTEAFF,2,0,1,2
TRBV7-9,TRBJ2-7,CASSSGQLYEQYF,2,0,1,2
TRBV6-2/3/5/6,TRBJ2-1,CASSSTGGWEQFF,2,0,1,2
TRBV7-9,TRBJ2-2,CASSSRYTGELFF,2,0,1,2
TRBV7-9,TRBJ1-1,CASSSPFNTEAFF,2,0,1,2
TRBV3-1,TRBJ2-7,CASSSGAAYEQYF,2,0,1,2
TRBV7-6,TRBJ1-1,CASSWEEDTEAFF,2,0,1,2
TRBV27,TRBJ2-5,CASSYGGRETQYF,2,0,1,2
TRBV7-9,TRBJ1-1,CASSLGGNTEAFF,2,0,1,2
TRBV12-3/4,TRBJ1-2,CASSLRAPYGYTF,2,4,2,6
TRBV7-2,TRBJ1-1,CASSLQGGTEAFF,2,0,1,2
TRBV6-2/3/5/6,TRBJ1-2,CASSLGKDYGYTF,2,0,1,2
TRBV7-9,TRBJ1-5,CASSLNSNQPQHF,2,0,1,2
TRBV6-2/3/5/6,TRBJ2-1,CASSPRWYDEQFF,2,0,1,2
TRBV7-9,TRBJ2-1,CASSPRDGGEQFF,2,0,1,2
TRBV5-4,TRBJ1-1,CASSPGRKTEAFF,2,0,1,2
TRBV7-6,TRBJ2-7,CASSPGAAYEQYF,2,5,2,7
TRBV4-2,TRBJ1-2,CASSPGQDYGYTF,2,0,1,2
TRBV9,TRBJ1-2,CASSPTGGHGYTF,2,0,1,2
TRBV11-1,TRBJ2-5,CASSRRVQETQYF,2,0,1,2
TRBV7-2,TRBJ1-5,CASSRIGNQPQHF,2,0,1,2
TRBV3-1,TRBJ2-5,CASSQDIRETQYF,2,0,1,2
TRBV14,TRBJ1-3,CASSQIVRNTIYF,2,0,1,2
TRBV7-2,TRBJ1-2,CASSVAQGWGYTF,2,0,1,2
TRBV9,TRBJ2-7,CASSVVVGGEQYF,2,0,1,2
TRBV9,TRBJ1-1,CASSVGAGSEAFF,2,0,1,2
TRBV6-1,TRBJ2-2,CASSETSVRELFF,2,0,1,2
TRBV5-6,TRBJ1-1,CASSILRGTEAFF,2,0,1,2
TRBV7-9,TRBJ1-1,CASSRDIGTEAFF,2,9,2,11
TRBV9,TRBJ2-3,CASRSTPGDTQYF,2,0,1,2
TRBV6-2/3/5/6,TRBJ2-4,CASRLGNKNIQYI,2,0,1,2
TRBV2,TRBJ1-5,CASRGRGGQPQHF,2,0,1,2
TRBV12-3/4,TRBJ2-4,CASRGGGTAPNYF,2,0,1,2
TRBV7-9,TRBJ2-1,CASRPDGYNEQFF,2,0,1,2
TRBV12-3/4,TRBJ2-7,CASRAGTLYEQYF,2,0,1,2
TRBV12-3/4,TRBJ1-2,CASRDRVDYGYTF,2,0,1,2
TRBV7-9,TRBJ2-5,CASRERGRETQYF,2,0,1,2
TRBV4-2,TRBJ1-1,CASRIWGGTEAFF,2,0,1,2
TRBV12-3/4,TRBJ2-1,CASKANSRSVQFF,2,0,1,2
TRBV5-1,TRBJ2-3,CASTEQGTDTQYF,2,0,1,2
TRBV5-1,TRBJ1-2,CASSFGTTYGYTF,2,0,1,2
TRBV5-1,TRBJ1-2,CASSLLSQSGYTF,2,0,1,2
TRBV5-1,TRBJ2-1,CASSLSSYNEQFF,2,0,1,2
TRBV5-1,TRBJ2-7,CASSLNRGGEQYF,2,0,1,2
TRBV5-1,TRBJ1-1,CASSSGQGGEAFF,2,0,1,2
TRBV4-1,TRBJ2-5,CASSLTGRETQYF,2,0,1,2
TRBV5-1,TRBJ2-1,CASSLAAQNEQFF,2,0,1,2
TRBV5-1,TRBJ2-3,CASSPAGGDTQYF,2,0,1,2
TRBV4-3,TRBJ2-1,CASSPTGNNEQFF,2,0,1,2
TRBV4-1,TRBJ1-1,CASSRTLNTEAFF,2,5,2,7
TRBV4-1,TRBJ1-5,CASSQDRDQPQHF,2,0,1,2
TRBV4-1,TRBJ1-5,CASSQHRGEPQHF,2,0,1,2
TRBV4-1,TRBJ2-1,CASSQDGTWEQFF,2,0,1,2
TRBV4-1,TRBJ2-3,CASSQEGTSTQYF,2,0,1,2
TRBV5-1,TRBJ1-1,CASSVDRNTEAFF,2,0,1,2
TRBV5-1,TRBJ2-3,CASSGSGTDTQYF,2,0,1,2
TRBV5-1,TRBJ2-1,CASSIPDDNEQFF,2,0,1,2
TRBV5-1,TRBJ1-1,CASSITVLTEAFF,2,0,1,2
TRBV4-1,TRBJ1-1,CASSITVNTEAFF,2,0,1,2
TRBV4-3,TRBJ2-1,CASRQGLADEQFF,2,0,1,2
TRBV20-1,TRBJ2-5,CSVPDGYQETQYF,2,0,1,2
TRBV20-1,TRBJ1-1,CSARVVAGMGAFF,2,0,1,2
TRBV20-1,TRBJ2-7,CSARGDRDYEQYF,2,0,1,2
TRBV20-1,TRBJ1-5,CSARESTHQPQHF,2,0,1,2
TRBV20-1,TRBJ1-3,CSARKDGGNTIYF,2,0,1,2
TRBV20-1,TRBJ2-7,CSANLGGTYEQYF,2,0,1,2
TRBV20-1,TRBJ1-5,CSAKVRGNQPQHF,2,0,1,2
TRBV20-1,TRBJ1-1,CSAPNRVSTEAFF,2,0,1,2
TRBV20-1,TRBJ1-4,CSAIKRPSEKLFF,2,0,1,2
TRBV20-1,TRBJ1-5,CSAGQGSNQPQHF,2,0,1,2
TRBV29-1,TRBJ2-7,CSVSRGRGYEQYF,2,0,1,2
TRBV29-1,TRBJ1-4,CSVVRDVNEKLFF,2,0,1,2
TRBV29-1,TRBJ2-5,CSVVASEVETQYF,2,4,2,6
TRBV29-1,TRBJ2-5,CSVGGFGEETQYF,2,0,1,2
TRBV29-1,TRBJ2-1,CSVGTSGYNEQFF,2,0,1,2
TRBV29-1,TRBJ2-7,CSVDTGNTYEQYF,2,0,1,2
TRBV29-1,TRBJ1-1,CSVELGGNTEAFF,2,0,1,2
TRBV29-1,TRBJ1-6,CSVKEGEAAPLHF,2,0,1,2
TRBV29-1,TRBJ1-5,CSVGEGVGQPQHF,2,0,1,2
TRBV29-1,TRBJ2-7,CSVGGLAVYEQYF,2,0,1,2
TRBV29-1,TRBJ2-1,CSVGLAVYNEQFF,2,0,1,2
TRBV29-1,TRBJ2-7,CSVARGLAYEQYF,2,0,1,2
TRBV29-1,TRBJ1-2,CSAGGGGVNGYTF,2,0,1,2
TRBV29-1,TRBJ1-1,CSGDRPEGTEAFF,2,0,1,2
TRBV29-1,TRBJ2-5,CSGESRIQETQYF,2,0,1,2
TRBV29-1,TRBJ1-1,CSGTGVGNTEAFF,2,0,1,2
TRBV12-3/4,TRBJ2-7,YASSRLNSYEQYF,2,0,1,2
TRBV7-3,TRBJ1-2,RASSLSGHYGYTF,2,0,1,2
TRBV30,TRBJ2-1,CAWSVFDMVKSF,2,0,1,2
TRBV7-9,TRBJ2-7,CATRQGAYEQYF,2,0,1,2
TRBV24-1,TRBJ2-3,CATRGGTDTQYF,2,0,1,2
TRBV18,TRBJ1-2,CASSPTSEGYTF,2,0,1,2
TRBV18,TRBJ2-1,CASSPLKRAQFF,2,0,1,2
TRBV2,TRBJ2-5,CASLGLGETQYF,2,0,1,2
TRBV28,TRBJ1-2,CASRAGNYGYTF,2,0,1,2
TRBV12-3/4,TRBJ1-2,CASGGTTYGYTF,2,0,1,2
TRBV7-9,TRBJ2-1,CASGQGNSEQFF,2,0,1,2
TRBV2,TRBJ2-6,CASTSGANVLTF,2,0,1,2
TRBV6-2/3/5/6,TRBJ1-1,CASSFGGPEAFF,2,0,1,2
TRBV12-3/4,TRBJ1-1,CASSLVGTEAFF,2,0,1,2
TRBV6-2/3/5/6,TRBJ2-4,CASSLTGSELYF,2,0,1,2
TRBV12-3/4,TRBJ2-7,CASSLSSHEQYF,2,0,1,2
TRBV12-3/4,TRBJ2-4,CASSLDVNIQYF,2,0,1,2
TRBV6-2/3/5/6,TRBJ2-3,CASSYPSNTQYF,2,0,1,2
TRBV27,TRBJ2-7,CASSLDSYEQYF,2,0,1,2
TRBV6-2/3/5/6,TRBJ1-5,CASSPEDQPQHF,2,0,1,2
TRBV7-6,TRBJ2-1,CASSPSGNEQFF,2,2,2,4
TRBV6-2/3/5/6,TRBJ2-1,CASSPRGGTRFF,2,0,1,2
TRBV6-1,TRBJ2-1,CASSPEYNEQFF,2,0,1,2
TRBV6-2/3/5/6,TRBJ2-2,CASSRYTGELFF,2,0,1,2
TRBV25-1,TRBJ2-1,CASSVSYNEQFF,2,0,1,2
TRBV2,TRBJ2-7,CASSENSYEQYF,2,0,1,2
TRBV12-3/4,TRBJ2-4,CASSTPGGIQYF,2,11,2,13
TRBV5-6,TRBJ2-2,CASSLGTGELFF,2,21,2,23
TRBV5-6,TRBJ1-1,CASSLRITEAFF,2,0,1,2
TRBV7-9,TRBJ1-3,CASSSTWDTIYF,2,0,1,2
TRBV7-2,TRBJ1-6,CASSLRQGPLHF,2,0,1,2
TRBV12-3/4,TRBJ1-1,CASSPWSTEAFF,2,0,1,2
TRBV7-9,TRBJ2-1,CASSPPGWEQFF,2,0,1,2
TRBV12-3/4,TRBJ1-1,CASSPRLTEAFF,2,0,1,2
TRBV7-9,TRBJ1-5,CASSPDAQPQHF,2,0,1,2
TRBV7-9,TRBJ1-5,CASSPLDQPQHF,2,0,1,2
TRBV7-8,TRBJ2-7,CASSPRLDEQYF,2,0,1,2
TRBV6-2/3/5/6,TRBJ2-1,CASSRPYNEQFF,2,3,2,5
TRBV3-1,TRBJ1-5,CASSHSNQPQHF,2,0,1,2
TRBV3-1,TRBJ2-3,CASSQNRDTQYF,2,0,1,2
TRBV5-5,TRBJ1-2,CASSQGSYGYTF,2,0,1,2
TRBV3-1,TRBJ2-2,CASSQEPGELFF,2,0,1,2
TRBV3-1,TRBJ2-7,CASSQSRYEQYF,2,10,2,12
TRBV11-2,TRBJ2-5,CASSVGVETQYF,2,0,1,2
TRBV9,TRBJ1-1,CASSVRAGRAFF,2,0,1,2
TRBV5-6,TRBJ2-7,CASSAGPYEQYF,2,0,1,2
TRBV5-6,TRBJ1-1,CASSTMNTEAFF,2,0,1,2
TRBV6-2/3/5/6,TRBJ2-5,CASRFLQETQYF,2,0,1,2
TRBV25-1,TRBJ1-2,CASRGSLYGYTF,2,0,1,2
TRBV6-2/3/5/6,TRBJ2-5,CASRAGGETQYF,2,0,1,2
TRBV2,TRBJ2-1,CASRELAGEKFF,2,0,1,2
TRBV11-3,TRBJ2-3,CASREAADTQYF,2,0,1,2
TRBV2,TRBJ2-7,CASRTGAYEQYF,2,0,1,2
TRBV7-9,TRBJ2-7,CATSQGDHEQYF,2,0,1,2
TRBV12-3/4,TRBJ2-2,CALGGYTGELFF,2,0,1,2
TRBV4-1,TRBJ2-1,CASGQVRNEQFF,2,0,1,2
TRBV5-1,TRBJ2-7,CASSSELYEQYF,2,0,1,2
TRBV4-1,TRBJ1-6,CASSQTRSPLHF,2,0,1,2
TRBV5-1,TRBJ1-1,CASSAEGREAFL,2,0,1,2
TRBV4-1,TRBJ1-5,CARTRSNQPQHF,2,0,1,2
TRBV29-1,TRBJ2-1,CTGTSGSDEQFF,2,0,1,2
TRBV20-1,TRBJ2-3,CSASPTTDTQYF,2,0,1,2
TRBV20-1,TRBJ2-1,CSARRSYNEQFF,2,0,1,2
TRBV20-1,TRBJ1-2,CSADPGGRRYTF,2,0,1,2
TRBV29-1,TRBJ2-7,CSVVSQGDEQYF,2,0,1,2
TRBV29-1,TRBJ2-1,CSVGATDNEQFF,2,0,1,2
TRBV29-1,TRBJ2-5,CSVGQDRETQYF,2,0,1,2
TRBV29-1,TRBJ2-2,CSVGRDTGELFF,2,0,1,2
TRBV29-1,TRBJ1-2,CSVDPAGGGYTF,2,0,1,2
TRBV29-1,TRBJ2-1,CSVDIQGNEQFF,2,0,1,2
TRBV29-1,TRBJ2-4,CSVKGAKNIQYF,2,0,1,2
TRBV29-1,TRBJ2-1,CSAGTDYNEQFF,2,0,1,2
TRBV29-1,TRBJ2-7,CSAGQGPYEQYF,2,0,1,2
TRBV20-1,TRBJ2-1,CSGLDNDNEQFF,2,0,1,2
TRBV29-1,TRBJ2-5,CSGLAAEETQYF,2,0,1,2
TRBV29-1,TRBJ2-3,CSGGPAYSWQYF,2,0,1,2
TRBV30,TRBJ2-7,CAWGRSYEQYF,2,0,1,2
TRBV30,TRBJ1-3,CAWSNGNTIYF,2,0,1,2
TRBV30,TRBJ1-2,CAWSDGRDCAF,2,0,1,2
TRBV19,TRBJ2-7,CAAKGLHEQYF,2,0,1,2
TRBV12-3/4,TRBJ1-5,CAGSLSEPQHF,2,0,1,2
TRBV10-3,TRBJ1-2,CAISDSYGYTF,2,0,1,2
TRBV10-3,TRBJ1-1,CAISQDGEAFF,2,0,1,2
TRBV10-3,TRBJ2-1,CAIKLAGEQFF,2,0,1,2
TRBV19,TRBJ1-5,CASSQGQPQHF,2,0,1,2
TRBV19,TRBJ1-2,CASTSFYGYTF,2,0,1,2
TRBV30,TRBJ2-2,CASSGSGELFF,2,0,1,2
TRBV27,TRBJ1-1,CASSFGQEAFF,2,0,1,2
TRBV28,TRBJ2-1,CASSLDNEQFF,2,11,2,13
TRBV6-1,TRBJ2-1,CASSQGNEQFF,2,0,1,2
TRBV6-1,TRBJ2-3,CASSAPDTQYF,2,0,1,2
TRBV25-1,TRBJ2-7,CASSGSYEQYF,2,0,1,2
TRBV2,TRBJ2-1,CASSEAPGQFF,2,0,1,2
TRBV25-1,TRBJ2-3,CASSEQNTQYF,2,0,1,2
TRBV5-6,TRBJ2-1,CASSLYDEQFF,2,0,1,2
TRBV5-6,TRBJ2-5,CASSLTETQYF,2,0,1,2
TRBV6-2/3/5/6,TRBJ1-1,CASSLGGEAFF,2,0,1,2
TRBV7-9,TRBJ2-7,CASSPGIEQYF,2,0,1,2
TRBV3-1,TRBJ2-7,CASSHRTEQYF,2,0,1,2
TRBV7-9,TRBJ1-2,CASSASAGYTF,2,0,1,2
TRBV7-9,TRBJ2-7,CASRLTGEQYF,2,0,1,2
TRBV5-4,TRBJ1-2,CASRHIHGYTF,2,0,1,2
TRBV6-4,TRBJ2-1,CTSSAYNEQFF,2,0,1,2
TRBV4-1,TRBJ1-1,CASSPGSEAFF,2,0,1,2
TRBV29-1,TRBJ2-5,CSLGGPETQYF,2,0,1,2
TRBV20-1,TRBJ2-3,CSASGRDTQYF,2,0,1,2
TRBV20-1,TRBJ1-1,CSARENTEAFF,2,0,1,2
TRBV20-1,TRBJ2-5,CSATAQETQYF,2,0,1,2
TRBV29-1,TRBJ1-1,CSVVGQGWAFF,2,0,1,2
TRBV29-1,TRBJ1-1,CSVGWGTEAFF,2,0,1,2
TRBV29-1,TRBJ2-5,CSVDWGETQYF,2,0,1,2
TRBV29-1,TRBJ2-3,CSVEQTDTQYF,2,0,1,2
TRBV29-1,TRBJ1-2,CSAPGIYGYTF,2,0,1,2
TRBV29-1,TRBJ1-1,CSAASGTEAFF,2,0,1,2
TRBV7-9,TRBJ1-2,CASSPPGYTF,2,0,1,2
TRBV25-1,TRBJ1-2,CASSAPAVTF,2,0,1,2
TRBV20-1,TRBJ2-1,CSARRVEQFF,2,0,1,2
TRBV20-1,TRBJ2-7,CSAGTYEQYF,2,0,1,2
TRBV29-1,TRBJ2-2,CSVGNGELFF,2,0,1,2
TRBV29-1,TRBJ2-3,CSALRDTQYF,2,0,1,2
TRBV29-1,TRBJ1-1,CSANAFF,2,0,1,2
TRBV18,TRBJ2-6,CASSRKSLAGGIPTSGANVLTF,2,0,1,2
TRBV4-3,TRBJ2-2,CVSSQGTSRAYTGELFF,2,0,1,2
TRBV27,TRBJ2-1,CASSSPLASGSNEQFF,2,0,1,2
TRBV10-3,TRBJ2-7,CASSESRVGGEQYF,2,0,1,2
TRBV30,TRBJ2-1,CAWSGLDNEQFF,2,0,1,2
TRBV4-3,TRBJ2-1,CASSQEGGSSYNEQFF,0,250,1,250
TRBV7-9,TRBJ1-1,CASSFRTENTEAFF,0,75,1,75
TRBV7-9,TRBJ1-1,CASRTGSSEAFF,0,61,1,61
TRBV7-9,TRBJ1-5,CASSLSREQPQHF,0,50,1,50
TRBV6-4,TRBJ2-7,CASSLPPARGNYEQYF,0,46,1,46
TRBV20-1,TRBJ2-1,CSAISGGAGNEQFF,0,42,1,42
TRBV7-2,TRBJ2-7,CASGINSYEQYF,0,41,1,41
TRBV14,TRBJ1-5,CASSRNNQPQHF,0,42,1,42
TRBV2,TRBJ1-4,CASSEVWQRGEKLFF,0,33,1,33
TRBV13,TRBJ2-3,CASKAGQGGPRITDTQYF,0,32,1,32
TRBV5-6,TRBJ1-2,CASSLTGLGYTF,0,32,1,32
TRBV7-2,TRBJ2-3,CASSSSRGLAGATQYF,0,31,1,31
TRBV6-2/3/5/6,TRBJ1-5,CASSYRGDSNQPQHF,0,30,1,30
TRBV12-5,TRBJ2-1,CASGLAGTGEGDEQFF,0,28,1,28
TRBV7-2,TRBJ1-1,CASSLGGPEAFF,0,28,1,28
TRBV29-1,TRBJ2-1,CSAISGSAFRLHEQFF,0,28,1,28
TRBV14,TRBJ1-1,CASSQGGNTEAFF,0,26,1,26
TRBV10-3,TRBJ2-2,CAIGKTGGFTGELFF,0,26,1,26
TRBV7-2,TRBJ2-3,CASSPSGGRTDTQYF,0,25,1,25
TRBV7-9,TRBJ2-7,CASSLVVSGGHEQYF,0,25,1,25
TRBV3-1,TRBJ2-3,CASSQGLVRRVGTDTQYF,0,24,1,24
TRBV12-3/4,TRBJ1-5,CASSFGNQPQHF,0,24,1,24
TRBV2,TRBJ1-2,CASSEARNAVAPYGYTF,0,24,1,24
TRBV20-1,TRBJ2-3,CSAGPEAGADTQYF,0,23,1,23
TRBV5-1,TRBJ1-1,CASSIGMNTEAFF,0,23,1,23
TRBV29-1,TRBJ1-1,CSVTGNTEAFF,0,23,1,23
TRBV5-6,TRBJ2-7,CASSSTGGEGSYEQYF,0,22,1,22
TRBV29-1,TRBJ1-1,CSVDRGQLNTEAFF,0,22,1,22
TRBV29-1,TRBJ2-1,CSVDILNNEQFF,0,22,1,22
TRBV27,TRBJ1-6,CASSAGLTHSPLHF,0,24,1,24
TRBV5-6,TRBJ1-2,CASSLGPGPGWYGYTF,0,21,1,21
TRBV7-2,TRBJ2-7,CASIPRLVASGEQYF,0,21,1,21
TRBV12-3/4,TRBJ1-5,CASSFLESNQPQHF,0,21,1,21
TRBV7-2,TRBJ2-7,CAGSSGTEEQYF,0,21,1,21
TRBV12-3/4,TRBJ2-3,CASSLRSGAGTDTQYF,0,20,1,20
TRBV5-1,TRBJ1-4,CASSLRQGADEKLFF,0,20,1,20
TRBV6-1,TRBJ2-3,CASSENRGGQDTQYF,0,22,1,22
TRBV12-3/4,TRBJ1-5,CASSLVPGGQPQHF,0,19,1,19
TRBV20-1,TRBJ2-5,CSAGLVEQETQYF,0,19,1,19
TRBV11-2,TRBJ2-5,CASSPNNKETQYF,0,19,1,19
TRBV5-5,TRBJ2-2,CASSQDYLNTGELFF,0,18,1,18
TRBV7-2,TRBJ2-1,CASSLLAGGFSFVGNNEQFF,0,18,1,18
TRBV15,TRBJ1-1,CATKGTGAKDTEAFF,0,18,1,18
TRBV14,TRBJ2-7,CASSQSGRNRYEQYF,0,18,1,18
TRBV12-3/4,TRBJ2-3,CASSYDINSPSQYF,0,18,1,18
TRBV20-1,TRBJ2-7,CSAAGDREIYEQYF,0,18,1,18
TRBV12-3/4,TRBJ2-3,CASNPPAGGLTDTQYF,0,17,1,17
TRBV29-1,TRBJ2-1,CSVGGGGLGTYNEQFF,0,17,1,17
TRBV12-3/4,TRBJ2-7,CASTPGLKTPREQYF,0,17,1,17
TRBV5-6,TRBJ1-6,CASSFRQGSLSPLHF,0,17,1,17
TRBV11-2,TRBJ2-1,CASSLDGLSWDEQFF,0,17,1,17
TRBV12-3/4,TRBJ2-3,CASSLRRGKDTQYF,0,17,1,17
TRBV12-3/4,TRBJ2-7,CASSLGTSGTSKYF,0,17,1,17
TRBV11-1,TRBJ2-3,CASLGRRTDTQYF,0,17,1,17
TRBV12-3/4,TRBJ2-4,CASSLGFLDIQYF,0,17,1,17
TRBV20-1,TRBJ1-5,CSAGAGNQPQHF,0,17,1,17
TRBV5-1,TRBJ1-1,CASSLVDVNTEAFF,0,17,1,17
TRBV19,TRBJ1-4,CASSITGTNEKLFF,0,16,1,16
TRBV19,TRBJ2-6,CASSAQGHSGANVLTF,0,16,1,16
TRBV5-4,TRBJ1-6,CASSPDNRAYNSPLHF,0,16,1,16
TRBV3-1,TRBJ2-1,CASSQRAGTLYNEQFF,0,16,1,16
TRBV7-8,TRBJ2-1,CASRSGGMSSYNEQFF,0,16,1,16
TRBV19,TRBJ2-1,CASSPDRGAFDEQFF,0,16,1,16
TRBV3-1,TRBJ1-1,CASSQRTGPNTEAFF,0,16,1,16
TRBV5-1,TRBJ1-5,CASSLEGGAGQPQHF,0,16,1,16
TRBV5-1,TRBJ1-1,CASSLKGAENTEAFF,0,16,1,16
TRBV12-3/4,TRBJ2-7,CASSLGTYSYEQYF,0,16,1,16
TRBV6-1,TRBJ2-1,CASSEPLAGVLQFF,0,16,1,16
TRBV20-1,TRBJ2-5,CSATTAVNQETQYF,0,16,1,16
TRBV15,TRBJ1-2,CATSRGSGYGYTF,0,16,1,16
TRBV14,TRBJ2-1,CASSRREGNEQFF,0,16,1,16
TRBV29-1,TRBJ2-5,CSLEPGEGETQYF,0,16,1,16
TRBV6-2/3/5/6,TRBJ1-1,CASSEVATEAFF,0,16,1,16
TRBV19,TRBJ2-4,CASSNQGAGPNIQYF,0,16,1,16
TRBV12-3/4,TRBJ2-5,CASSFRTSGSGGTQYF,0,15,1,15
TRBV15,TRBJ1-5,CATSRVWTPGQPQHF,0,15,1,15
TRBV19,TRBJ1-3,CASSQGAGPGNTIYF,0,15,1,15
TRBV19,TRBJ1-5,CASSGGQGTIRPQHF,0,15,1,15
TRBV7-2,TRBJ2-3,CASSLAPGILDTQYF,0,15,1,15
TRBV5-6,TRBJ2-7,CASSRLAGGLYEQYF,0,15,1,15
TRBV16,TRBJ2-4,CASSQSIYRGNIQYF,0,15,1,15
TRBV5-1,TRBJ2-2,CASSSPLSGTGELFF,0,15,1,15
TRBV20-1,TRBJ2-1,CSAGVAGVAYNEQFF,0,15,1,15
TRBV19,TRBJ2-7,CASSTGQGAYEQYF,0,15,1,15
TRBV3-1,TRBJ2-1,CASSFTSGDNEQFF,0,15,1,15
TRBV7-9,TRBJ2-5,CASSPRVDRETQYF,0,15,1,15
TRBV6-2/3/5/6,TRBJ1-5,CASNNDGSNQPQHF,0,15,1,15
TRBV29-1,TRBJ2-7,CSVVFAGISYEQYF,0,15,1,15
TRBV12-5,TRBJ1-5,CASGLNDQPQHF,0,15,1,15
TRBV2,TRBJ2-7,CASSVNSGEQYF,0,15,1,15
TRBV6-2/3/5/6,TRBJ2-7,CASSNPSHEQYF,0,15,1,15
TRBV29-1,TRBJ2-7,CSVMRETYEQYF,0,15,1,15
TRBV3-1,TRBJ1-1,CASSQTAFF,0,15,1,15
TRBV18,TRBJ1-2,CASSPVRDIYGYTF,0,15,1,15
TRBV15,TRBJ2-6,CATSRDTGRGRTGANVLTF,0,14,1,14
TRBV4-2,TRBJ2-7,CASSQGPRWKGSYEQYF,0,14,1,14
TRBV6-2/3/5/6,TRBJ2-7,CASSPKGSSGSKFYEQYF,0,14,1,14
TRBV5-6,TRBJ2-5,CASSARGAPKSGETQYF,0,14,1,14
TRBV28,TRBJ2-3,CASSLGAALSTDTQYF,0,14,1,14
TRBV6-2/3/5/6,TRBJ1-4,CASSHHRMGVNEKLFF,0,14,1,14
TRBV3-1,TRBJ2-7,CASSQEAGRSSYEQYF,0,14,1,14
TRBV20-1,TRBJ1-4,CSARAGQGEKAEKLFF,0,14,1,14
TRBV5-6,TRBJ2-4,CASSNLEGGKNIQYF,0,14,1,14
TRBV7-8,TRBJ1-1,CASSLAQEGRTEAFF,0,16,1,16
TRBV7-9,TRBJ1-5,CASSLGSVPHQPQHF,0,14,1,14
TRBV20-1,TRBJ1-1,CSARSGAGDVTEAFF,0,14,1,14
TRBV15,TRBJ2-1,CATSREGSYNEQFF,0,14,1,14
TRBV19,TRBJ2-7,CASSNRDASYEQYF,0,14,1,14
TRBV2,TRBJ2-1,CARELQGTGNEQFF,0,14,1,14
TRBV4-1,TRBJ2-5,CASSQDPTSETQYF,0,14,1,14
TRBV19,TRBJ1-1,CASSMFQNTEAFF,0,14,1,14
TRBV5-6,TRBJ1-6,CASSSSSNSPLHF,0,14,1,14
TRBV11-3,TRBJ2-3,CASSSTSTDTQYF,0,14,1,14
TRBV20-1,TRBJ2-3,CSARRDSTDTQYF,0,14,1,14
TRBV20-1,TRBJ2-7,CSAQRGISYEQYF,0,14,1,14
TRBV12-3/4,TRBJ2-3,CASTLSTDTQYF,0,14,1,14
TRBV14,TRBJ2-7,CASSQGFYEQYF,0,14,1,14
TRBV12-3/4,TRBJ2-7,CASSSFYEQYF,0,14,1,14
TRBV14,TRBJ2-2,CASSLDRRTGELFF,0,14,1,14
TRBV7-6,TRBJ2-1,CASSSGFGIGSYNEQFF,0,14,1,14
TRBV29-1,TRBJ1-5,CSVVTGSAYSNQPQHF,0,14,1,14
TRBV12-3/4,TRBJ2-1,CASSFLLAGGLQLNEQFF,0,16,1,16
TRBV2,TRBJ2-5,CASSVRGTGEYQETQYF,0,13,1,13
TRBV20-1,TRBJ2-1,CSAPGLAGVLSHNEQFF,0,13,1,13
TRBV6-2/3/5/6,TRBJ2-2,CASSYMTGDDTGELFF,0,13,1,13
TRBV6-2/3/5/6,TRBJ2-1,CASSPLLAEVSDEQFF,0,13,1,13
TRBV19,TRBJ2-6,CASSMRASGANVLTF,0,13,1,13
TRBV5-8,TRBJ2-5,CASSLGTGGAETQYF,0,13,1,13
TRBV3-1,TRBJ2-7,CASSQESRPSYEQYF,0,13,1,13
TRBV5-1,TRBJ1-1,CASSPDRSTNTEAFF,0,13,1,13
TRBV7-3,TRBJ2-1,RASTKVVLDGDEQFF,0,13,1,13
TRBV19,TRBJ2-1,CASSIGAGVDEQFF,0,13,1,13
TRBV12-3/4,TRBJ2-1,CASSSGRGSNEQFF,0,13,1,13
TRBV6-2/3/5/6,TRBJ2-1,CASSYEAMRNEQFF,0,13,1,13
TRBV7-8,TRBJ2-1,CASSLDPWKHEQFF,0,13,1,13
TRBV27,TRBJ2-7,CASSPTSPTYEQYF,0,13,1,13
TRBV3-1,TRBJ2-7,CASSQRDRSYEQYF,0,13,1,13
TRBV3-1,TRBJ1-1,CASSQTGQATEAFF,0,13,1,13
TRBV9,TRBJ2-7,CASSEAMGFGEQYF,0,13,1,13
TRBV2,TRBJ2-5,CASRQNSGLETQYF,0,13,1,13
TRBV20-1,TRBJ2-1,CSASRAGANNEQFF,0,13,1,13
TRBV19,TRBJ2-7,CASSFSYANEQYF,0,13,1,13
TRBV12-3/4,TRBJ1-2,CASSLGQDYGYTF,0,13,1,13
TRBV6-1,TRBJ2-1,CASRQAGVNEQFF,0,13,1,13
TRBV20-1,TRBJ2-5,CSARTGGAETQYF,0,13,1,13
TRBV7-9,TRBJ2-1,CASSFGTSSQFF,0,13,1,13
TRBV11-2,TRBJ2-2,CASSLGFGELFF,0,13,1,13
TRBV5-6,TRBJ2-7,CASSSDPVQQYF,0,13,1,13
TRBV7-2,TRBJ1-4,CASSPGSEKLFF,0,13,1,13
TRBV9,TRBJ2-1,CASSETSDEQFF,0,13,1,13
TRBV5-1,TRBJ1-2,CASSLESYGYTF,0,13,1,13
TRBV18,TRBJ2-7,CASSPKGGTGLNEQYF,0,13,1,13
TRBV3-1,TRBJ2-6,CASSRTPTGANVLTF,0,13,1,13
TRBV5-4,TRBJ1-1,CASSFWQNTEAFF,0,13,1,13
TRBV19,TRBJ2-5,CASSTSSETQYF,0,13,1,13
TRBV20-1,TRBJ2-7,CSARDGTSSYERYF,0,13,1,13
TRBV20-1,TRBJ2-1,CSARDYPPLGTSGRNEQFF,0,12,1,12
TRBV13,TRBJ2-4,CASSHAQPKLAKNIQYF,0,12,1,12
TRBV19,TRBJ2-5,CASSILLAGGQETQYF,0,12,1,12
TRBV2,TRBJ2-2,CASTEPGQSAAGELFF,0,12,1,12
TRBV12-3/4,TRBJ2-3,CASSLWFSPDSDTQYF,0,12,1,12
TRBV6-2/3/5/6,TRBJ1-2,CASSPEGRTQTRGYTF,0,12,1,12
TRBV7-2,TRBJ2-1,CASSFRTGGGYNEQFF,0,12,1,12
TRBV5-4,TRBJ2-2,CASSRGQVIGDGELFF,0,12,1,12
TRBV5-4,TRBJ2-7,CASSRTSASYSYEQYF,0,12,1,12
TRBV20-1,TRBJ2-3,CSATRPGGRGTDTQYF,0,12,1,12
TRBV19,TRBJ1-1,CASRRPAAMNTEAFF,0,12,1,12
TRBV12-3/4,TRBJ1-5,CASSFGSTVNQPQHF,0,12,1,12
TRBV6-1,TRBJ2-1,CASSASGPRGNEQFF,0,12,1,12
TRBV6-1,TRBJ1-1,CASSGQSTGIGEAFF,0,12,1,12
TRBV12-3/4,TRBJ1-4,CASSPRQGTNEKLFF,0,12,1,12
TRBV2,TRBJ2-1,CASRTLAFSYNEQFF,0,12,1,12
TRBV5-1,TRBJ2-1,CASRGDGGLYNEQFF,0,12,1,12
TRBV20-1,TRBJ1-3,CSARVGLSSGNTIYF,0,12,1,12
TRBV20-1,TRBJ2-1,CSAPQGTPSYNEQFF,0,12,1,12
TRBV29-1,TRBJ2-3,CSVEDTGGAEDTQYF,0,12,1,12
TRBV29-1,TRBJ2-7,CSVEGEGRASYEQYF,0,12,1,12
TRBV27,TRBJ2-7,CASSVTGQSYEQYF,0,12,1,12
TRBV12-3/4,TRBJ1-6,CASSLEGPNSPLHF,0,12,1,12
TRBV28,TRBJ1-1,CASSSGTGLYEAFF,0,12,1,12
TRBV12-3/4,TRBJ2-5,CASSHSGREETQYF,0,12,1,12
TRBV7-9,TRBJ2-7,CASSLTSGFYEQYF,0,12,1,12
TRBV27,TRBJ1-5,CASRRTGGNQPQHF,0,12,1,12
TRBV7-2,TRBJ2-2,CASRHRGNTGELFF,0,12,1,12
TRBV4-1,TRBJ1-2,CASRTPGQQYGYTF,0,12,1,12
TRBV5-1,TRBJ2-3,CASSQDRAQDTQYF,0,12,1,12
TRBV5-1,TRBJ2-1,CASSFDRGEDEQFF,0,12,1,12
TRBV20-1,TRBJ2-1,CSASLAGGSNEQFF,0,12,1,12
TRBV20-1,TRBJ2-7,CSARDSIYPYEQYF,0,12,1,12
TRBV20-1,TRBJ1-5,CSARREDGNQPQHF,0,12,1,12
TRBV29-1,TRBJ2-7,CSAGSLQSSYEQYF,0,12,1,12
TRBV2,TRBJ2-7,CAGSGTTRHEQYF,0,12,1,12
TRBV6-2/3/5/6,TRBJ1-5,CASTLGGNQPQHF,0,12,1,12
TRBV6-2/3/5/6,TRBJ2-1,CASSYSIYNEQFF,0,12,1,12
TRBV6-2/3/5/6,TRBJ2-1,CASSYSGGNEQFF,0,12,1,12
TRBV7-9,TRBJ1-1,CASSLEVNTEAFF,0,15,1,15
TRBV3-1,TRBJ1-2,CASSQDPDRSYTF,0,12,1,12
TRBV5-6,TRBJ2-7,CASRGGTTYEQYF,0,12,1,12
TRBV5-1,TRBJ2-1,CASSQGQGDEQFF,0,12,1,12
TRBV4-3,TRBJ1-1,CASSQDGNTEAFF,0,12,1,12
TRBV29-1,TRBJ2-7,CSVEVPSSYEQYF,0,12,1,12
TRBV29-1,TRBJ2-5,CSAGRDTQETQYF,0,12,1,12
TRBV29-1,TRBJ2-1,CSGALAGGNEQFF,0,12,1,12
TRBV15,TRBJ2-7,CATSPNSYEQYF,0,12,1,12
TRBV29-1,TRBJ1-1,CSVSGGDTEAFF,0,12,1,12
TRBV29-1,TRBJ2-7,CSASGVSHEQYF,0,12,1,12
TRBV29-1,TRBJ2-5,CSGGRETQYF,0,12,1,12
TRBV5-5,TRBJ1-5,CASSLDSNQPQHF,0,12,1,12
TRBV12-3/4,TRBJ2-4,CASSLGTSGGLNIQYF,0,12,1,12
TRBV27,TRBJ1-1,CAGRKPGVLWTEAFF,0,12,1,12
TRBV3-1,TRBJ2-1,CASSQSGQGYYNEQFF,0,12,1,12
TRBV28,TRBJ1-3,CASRSSGNTIYF,0,11,1,11
TRBV11-2,TRBJ1-6,CASSFSGDNSPLHF,0,11,1,11
TRBV10-3,TRBJ2-1,CATENRGDRGYNEQFF,0,11,1,11
TRBV2,TRBJ2-2,CAGYQVTGELFF,0,11,1,11
TRBV4-1,TRBJ2-7,CASSQTGFSYEQYY,0,11,1,11
TRBV5-8,TRBJ1-4,CASRRRFNEKLVF,0,11,1,11
TRBV12-3/4,TRBJ2-3,CASSFGGQPSVSTDTQYF,0,11,1,11
TRBV3-1,TRBJ2-7,CASSQVVGSGTRGYEQYF,0,11,1,11
TRBV5-1,TRBJ2-2,CASSLGLAGEVNTGELFF,0,11,1,11
TRBV18,TRBJ1-2,CASSPVPGGSSFYGYTF,0,11,1,11
TRBV27,TRBJ1-5,CASSLSPGGYSNQPQHF,0,11,1,11
TRBV5-4,TRBJ2-1,CASSFGLGTSGPNEQFF,0,11,1,11
TRBV19,TRBJ2-5,CASSISRAPGQETQYF,0,11,1,11
TRBV18,TRBJ2-3,CASSPSDRGYPDTQYF,0,11,1,11
TRBV6-2/3/5/6,TRBJ2-1,CASSLGRRSENNEQFF,0,11,1,11
TRBV7-2,TRBJ2-3,CASSYPRATRTDTQYF,0,11,1,11
TRBV5-1,TRBJ2-1,CASSLERGGDYNEQFF,0,11,1,11
TRBV5-1,TRBJ2-6,CASSFSAVSGANVLTF,0,11,1,11
TRBV5-1,TRBJ1-6,CASSSYRRGYNSPLHF,0,11,1,11
TRBV5-1,TRBJ2-1,CASSPSSGGVYNEQFF,0,11,1,11
TRBV19,TRBJ2-5,CASSATSGDQETQYF,0,11,1,11
TRBV19,TRBJ2-3,CASSTGALSTDTQYF,0,11,1,11
TRBV19,TRBJ1-3,CASRAGGISGNTIYF,0,11,1,11
TRBV18,TRBJ1-6,CASSSQRTDNSPLHF,0,11,1,11
TRBV12-3/4,TRBJ1-1,CASSLGEIPFYEAFF,0,11,1,11
TRBV10-3,TRBJ2-1,CASSESQLTYNEQFF,0,11,1,11
TRBV6-4,TRBJ2-3,CASSKAGTSTDTQYF,0,11,1,11
TRBV12-3/4,TRBJ1-1,CASRLPTGWDTEAFF,0,11,1,11
TRBV20-1,TRBJ2-7,CSARDPDSGYGEQYF,0,11,1,11
TRBV24-1,TRBJ1-5,CATSDFGSNQPQHF,0,11,1,11
TRBV15,TRBJ1-4,CATSRRGDHEKLFF,0,11,1,11
TRBV19,TRBJ2-1,CASGNSGRWNEQFF,0,11,1,11
TRBV12-3/4,TRBJ1-1,CASTLGGAGTEAFF,0,11,1,11
TRBV12-3/4,TRBJ2-1,CASSFLGLAHEQFF,0,11,1,11
TRBV12-3/4,TRBJ2-2,CASSLKPTTGELFF,0,11,1,11
TRBV6-2/3/5/6,TRBJ2-7,CASSYGTSGYEQYF,0,11,1,11
TRBV6-2/3/5/6,TRBJ2-1,CASSPGGLNNEQFF,0,11,1,11
TRBV13,TRBJ2-1,CASSFKGPNGEQFF,0,11,1,11
TRBV14,TRBJ2-7,CASSLGQGSYEQYF,0,11,1,11
TRBV3-1,TRBJ2-7,CASSRDRARYEQYF,0,11,1,11
TRBV3-1,TRBJ1-2,CASSQEGQAYGYTF,0,11,1,11
TRBV14,TRBJ1-1,CASSQESTGLEAFF,0,11,1,11
TRBV9,TRBJ2-7,CASSVVGTPAEQYF,0,11,1,11
TRBV5-4,TRBJ1-2,CASSRTTLNYGYTF,0,11,1,11
TRBV7-2,TRBJ2-7,CASSNRDRVYEQYF,0,11,1,11
TRBV20-1,TRBJ2-7,CSASLLRQGYEQYF,0,11,1,11
TRBV20-1,TRBJ1-2,CSARGVKGRNGYTF,0,11,1,11
TRBV20-1,TRBJ1-1,CSARDLGGRAEAFF,0,11,1,11
TRBV29-1,TRBJ1-1,CSAGTLGQFTEAFF,0,11,1,11
TRBV29-1,TRBJ2-1,CSGLSRAFYNEQFF,0,11,1,11
TRBV11-2,TRBJ2-1,YASSLRHSGDEQFF,0,11,1,11
TRBV12-3/4,TRBJ1-5,CASSFWGNQPQHF,0,11,1,11
TRBV12-3/4,TRBJ2-6,CASSTAGANVLTF,0,11,1,11
TRBV14,TRBJ1-1,CASSQGVGTEAFF,0,11,1,11
TRBV11-3,TRBJ2-2,CASSGQNTGELFF,0,11,1,11
TRBV12-3/4,TRBJ1-1,CASNDRGWTEAFF,0,11,1,11
TRBV5-1,TRBJ1-3,CASSLGLGNTIYF,0,17,1,17
TRBV20-1,TRBJ2-7,CSAIQVTAYEQYF,0,11,1,11
TRBV12-3/4,TRBJ2-1,CASSLRANEQFL,0,11,1,11
TRBV7-2,TRBJ2-1,CASSSYSGSRFF,0,11,1,11
TRBV12-3/4,TRBJ2-5,CASSLLRETQYF,0,11,1,11
TRBV20-1,TRBJ1-5,CSARGMLQPQHF,0,11,1,11
TRBV20-1,TRBJ2-7,CSASAASYEQYF,0,11,1,11
TRBV29-1,TRBJ1-1,CSARTRNTEAFF,0,11,1,11
TRBV29-1,TRBJ2-2,CSAERGTGELFF,0,11,1,11
TRBV7-9,TRBJ2-3,CASSNTDTQYF,0,11,1,11
TRBV5-1,TRBJ2-2,CASSFSGELFF,0,11,1,11
TRBV5-1,TRBJ2-7,CASSRKLISFDRGGPAYEQYF,0,10,1,10
TRBV29-1,TRBJ2-1,CSVDGGWTSGRTLSSYNEQFF,0,10,1,10
TRBV6-2/3/5/6,TRBJ2-1,CASSSRRTSGVLSSYNEQFF,0,10,1,10
TRBV6-2/3/5/6,TRBJ2-1,CASSSPPSSSGSFDNEQFF,0,10,1,10
TRBV7-2,TRBJ2-2,CASSSRGGLAGANTGELFF,0,10,1,10
TRBV2,TRBJ2-3,CASLGRGLAGGRTDTQYF,0,10,1,10
TRBV13,TRBJ2-7,CASSPSRPASGDSYEQYF,0,10,1,10
TRBV6-2/3/5/6,TRBJ2-3,CASSFLVAGGPTDTQYF,0,10,1,10
TRBV12-3/4,TRBJ1-5,CASSSSEGPYSNQPQHF,0,10,1,10
TRBV7-2,TRBJ2-1,CASSSRGSGTLYNEQFF,0,10,1,10
TRBV2,TRBJ2-1,CASSEVTRASAYNEQFF,0,10,1,10
TRBV3-1,TRBJ2-5,CASSQGGLAGSGETQYF,0,10,1,10
TRBV20-1,TRBJ1-3,CSARDPVYRDSGNTIYF,0,10,1,10
TRBV12-5,TRBJ2-2,CASGLARQGINGELFF,0,10,1,10
TRBV19,TRBJ1-2,CASSISNKGQNYGYTF,0,10,1,10
TRBV19,TRBJ2-2,CASSNPYRGRAGELFF,0,10,1,10
TRBV27,TRBJ2-2,CASSLGAGRGSGELFF,0,10,1,10
TRBV6-2/3/5/6,TRBJ2-5,CASSYHGMTTQETQYF,0,10,1,10
TRBV5-1,TRBJ2-3,CASSLAVAGGTDTQYF,0,10,1,10
TRBV20-1,TRBJ1-4,CSASDPGAPVNEKLFF,0,10,1,10
TRBV20-1,TRBJ2-3,CSANPRLAAYTDTQYF,0,10,1,10
TRBV29-1,TRBJ2-1,CSVEDWPLRSYNEQFF,0,10,1,10
TRBV29-1,TRBJ2-2,CSVETPGLLNTGELFF,0,10,1,10
TRBV12-5,TRBJ2-1,CASGHDRSSYNEQFF,0,10,1,10
TRBV2,TRBJ2-2,CAGTPVGTGVRELFF,0,10,1,10
TRBV19,TRBJ1-1,CASIGTGVMNTEAFF,0,10,1,10
TRBV19,TRBJ2-7,CASSMGLGTSYEQYF,0,10,1,10
TRBV19,TRBJ1-1,CASRGEAFMNTEAFF,0,10,1,10
TRBV12-3/4,TRBJ2-1,CASSLGLAVVGEQFF,0,10,1,10
TRBV27,TRBJ1-2,CASSSLRNTRTGYTF,0,10,1,10
TRBV6-2/3/5/6,TRBJ2-7,CASSYSDRFAYEQYF,0,10,1,10
TRBV7-8,TRBJ2-2,CASSLASRGTGELFF,0,10,1,10
TRBV14,TRBJ2-5,CASSSLRGTQETQYF,0,10,1,10
TRBV3-1,TRBJ2-3,CASSQRRGQTDTQYF,0,10,1,10
TRBV3-1,TRBJ2-7,CASSQDLTGLYEQYF,0,10,1,10
TRBV14,TRBJ2-4,CASSQDRFLGDIQYF,0,10,1,10
TRBV11-1,TRBJ2-1,CASSADSIGATEQFF,0,10,1,10
TRBV7-9,TRBJ2-7,CASSDSGSHDYEQYF,0,10,1,10
TRBV2,TRBJ1-1,CARESTGGIGTEAFF,0,10,1,10
TRBV29-1,TRBJ2-6,CSVEPGGPGANVLTF,0,10,1,10
TRBV12-5,TRBJ2-7,CASTGTETSYEQYF,0,10,1,10
TRBV24-1,TRBJ2-1,CATSDSTWGDEQFF,0,10,1,10
TRBV19,TRBJ1-5,CASSIRDSNQPQHF,0,10,1,10
TRBV19,TRBJ1-5,CASSRGDPRSPQHF,0,10,1,10
TRBV7-2,TRBJ2-2,CASRPIPGPGELFF,0,10,1,10
TRBV12-3/4,TRBJ2-1,CASSFGTAYNEQFF,0,10,1,10
TRBV6-4,TRBJ2-3,CASSPGTPLDTQYF,0,10,1,10
TRBV2,TRBJ1-1,CASSQRRGGEAAFF,0,10,1,10
TRBV25-1,TRBJ1-1,CASSESRGNSEAFF,0,10,1,10
TRBV6-1,TRBJ2-5,CASSEDRDRETQYF,0,10,1,10
TRBV2,TRBJ1-2,CASSTYQTGGGYTF,0,10,1,10
TRBV5-4,TRBJ1-1,CASSFAPLDTEAFF,0,10,1,10
TRBV5-6,TRBJ1-5,CASSLRAGDQPQHF,0,10,1,10
TRBV7-2,TRBJ1-5,CASSLRHGNQPQHF,0,10,1,10
TRBV7-6,TRBJ2-7,CASSSQRDLYEQYF,0,10,1,10
TRBV13,TRBJ2-3,CASSSLPPTDTQYF,0,10,1,10
TRBV5-4,TRBJ1-4,CASSHGPPEEKLFF,0,10,1,10
TRBV5-5,TRBJ2-2,CASSDPSYTGELFF,0,10,1,10
TRBV5-1,TRBJ2-3,CASSFGQGTDTQYF,0,10,1,10
TRBV20-1,TRBJ1-5,CSASDRGSNQPQHF,0,10,1,10
TRBV29-1,TRBJ2-1,CSVVGTDSYNEQFF,0,10,1,10
TRBV29-1,TRBJ1-2,CSVDPQDRNYGYTF,0,10,1,10
TRBV29-1,TRBJ1-1,CSVEEGPTNTEAFF,0,10,1,10
TRBV30,TRBJ1-1,CAWSVAGNTEAFF,0,10,1,10
TRBV15,TRBJ2-7,CATSRAEGNEQYF,0,10,1,10
TRBV2,TRBJ1-1,CASLGQGNTGAFF,0,10,1,10
TRBV19,TRBJ2-2,CASSPRNTGELFF,0,10,1,10
TRBV12-3/4,TRBJ1-6,CASSRTGASPLHF,0,10,1,10
TRBV12-3/4,TRBJ1-1,CASSVQGGSEAFF,0,10,1,10
TRBV2,TRBJ1-1,CASSGRERAEAFF,0,10,1,10
TRBV7-8,TRBJ1-2,CASSLGPDYGYTF,0,10,1,10
TRBV5-5,TRBJ2-5,CASSYGNKETQYF,0,10,1,10
TRBV14,TRBJ1-1,CASSQHLNTEAFF,0,10,1,10
TRBV20-1,TRBJ1-3,CSVGTGVGNTIYF,0,10,1,10
TRBV13,TRBJ2-7,CASGRGSYEQYF,0,10,1,10
TRBV27,TRBJ1-1,CASSLTGTEAFF,0,10,1,10
TRBV12-3/4,TRBJ2-7,CASSSTQEEQYF,0,10,1,10
TRBV13,TRBJ2-7,CASSLGRYEQYF,0,10,1,10
TRBV7-9,TRBJ1-1,CASSWVITEAFF,0,10,1,10
TRBV3-1,TRBJ2-7,CASSRSRYEQYF,0,10,1,10
TRBV12-3/4,TRBJ2-3,CASRVSTDTQYF,0,10,1,10
TRBV30,TRBJ2-7,CAWSGIYEQYF,0,10,1,10
TRBV7-2,TRBJ2-5,CASSLRETQYF,0,10,1,10
TRBV3-1,TRBJ2-5,CASSQRETQYL,0,10,1,10
TRBV5-1,TRBJ2-1,CASSLGGEQFF,0,10,1,10
TRBV5-1,TRBJ2-3,CASSSRDTQYF,0,10,1,10
TRBV29-1,TRBJ1-3,CSARWDVAIYF,0,10,1,10
TRBV29-1,TRBJ2-5,CSTVLETQYF,0,10,1,10
TRBV5-4,TRBJ2-2,CASSSLSGALFF,0,10,1,10
TRBV3-1,TRBJ2-2,CASSPQGVGELFF,0,10,1,10
TRBV10-3,TRBJ1-1,CAISGNVGQMNTEAFF,0,10,1,10
TRBV12-3/4,TRBJ2-7,CASSLVVGGISYEQYF,0,10,1,10
TRBV5-1,TRBJ2-5,CASSGLAGNQGETQYF,0,9,1,9
TRBV3-1,TRBJ1-6,CAIHSGDGRSPLHF,0,9,1,9
TRBV25-1,TRBJ2-1,CASSENSGGRYNEQFF,0,9,1,9
TRBV6-2/3/5/6,TRBJ2-1,CASRLGQGGNHEQFF,0,9,1,9
TRBV6-2/3/5/6,TRBJ2-2,CASSYSSLGLAGEITGELFF,0,9,1,9
TRBV2,TRBJ2-1,CASSALTRTSGGPRNEQFF,0,9,1,9
TRBV6-2/3/5/6,TRBJ2-5,CASSSRLAGAGSRETQYF,0,9,1,9
TRBV6-2/3/5/6,TRBJ1-2,CASSYGRLGDRGRYGYTF,0,9,1,9
TRBV12-3/4,TRBJ2-1,CASSRAPRGASSYNEQFF,0,9,1,9
TRBV7-6,TRBJ2-1,CASSSLRTSGGSYNEQFF,0,9,1,9
TRBV14,TRBJ2-3,CASSQATSGRPHTDTQYF,0,9,1,9
TRBV5-4,TRBJ1-5,CASSVRERQGRSNQPQHF,0,9,1,9
TRBV5-6,TRBJ1-2,CASRNLLGHTRENYGYTF,0,9,1,9
TRBV10-2,TRBJ1-5,CASSESLSIVSSNQPQHF,0,9,1,9
TRBV29-1,TRBJ2-3,CSVEDGWTSGRAPDTQYF,0,9,1,9
TRBV29-1,TRBJ2-3,CSVESPYLAGSMVDTQYF,0,9,1,9
TRBV19,TRBJ2-1,CASSKSPGLAGTTKEFF,0,9,1,9
TRBV12-3/4,TRBJ2-3,CASTKWGLAGSTDTQYF,0,9,1,9
TRBV12-3/4,TRBJ1-4,CASSLGADYRANEKLFF,0,9,1,9
TRBV6-2/3/5/6,TRBJ2-7,CASSYLNVPGLADEQYF,0,9,1,9
TRBV7-2,TRBJ2-3,CASSLGGGGARADTQYF,0,9,1,9
TRBV7-9,TRBJ2-1,CASSSTKTAAKNNEQFF,0,9,1,9
TRBV6-2/3/5/6,TRBJ2-1,CASSPPGLGSSYNEQFF,0,9,1,9
TRBV14,TRBJ1-2,CASSRLDRATGGEGYTF,0,9,1,9
TRBV4-2,TRBJ2-5,CASSQGVGGSFAETQYF,0,9,1,9
TRBV5-1,TRBJ2-7,CASSPGLAGGLSYEQYF,0,9,1,9
TRBV4-1,TRBJ2-3,CASSQDWLAGATDTQYF,0,9,1,9
TRBV20-1,TRBJ2-1,CSARDFLAPSSYNEQFF,0,9,1,9
TRBV28,TRBJ2-1,CATLTAGTSYANEQFF,0,9,1,9
TRBV12-3/4,TRBJ2-1,CASTQAGGSSYNEQFF,0,9,1,9
TRBV12-3/4,TRBJ2-3,CASTPPGRRETDTQYF,0,9,1,9
TRBV12-3/4,TRBJ1-3,CASSLPGGSSGNTIYF,0,9,1,9
TRBV25-1,TRBJ2-2,CASSEWGLADTGELFF,0,9,1,9
TRBV6-1,TRBJ1-5,CASSEARLGNSQPQHF,0,9,1,9
TRBV6-1,TRBJ2-5,CASSESQGAGAETQYF,0,9,1,9
TRBV13,TRBJ2-5,CASSLTSGGSGETQYF,0,9,1,9
TRBV7-2,TRBJ2-3,CASSSRQGYYTDTQYF,0,9,1,9
TRBV7-9,TRBJ1-5,CASSPLDVVSNQPQHF,0,9,1,9
TRBV7-6,TRBJ2-3,CASSRQREGLRDTQYF,0,9,1,9
TRBV5-1,TRBJ1-3,CASSLDQGGSGNTIYF,0,9,1,9
TRBV20-1,TRBJ2-3,CSASPPGLGGTDTQYF,0,9,1,9
TRBV20-1,TRBJ2-3,CSASWGTGGSTDTQYF,0,9,1,9
TRBV10-3,TRBJ1-5,CAISTGGDSNQPQHF,0,9,1,9
TRBV19,TRBJ2-3,CASSIEDRSTDTQYF,0,9,1,9
TRBV19,TRBJ2-1,CASSRRGPPYNEQFF,0,9,1,9
TRBV19,TRBJ1-1,CASNIRAGVGTEAFF,0,9,1,9
TRBV2,TRBJ1-5,CASCALGASNQPQHF,0,9,1,9
TRBV6-2/3/5/6,TRBJ1-5,CASTLNPKSNQPQHF,0,9,1,9
TRBV7-6,TRBJ2-3,CASTSIGGATDTQYF,0,9,1,9
TRBV6-2/3/5/6,TRBJ2-1,CASSLTSGRKNEQFF,0,9,1,9
TRBV6-2/3/5/6,TRBJ1-2,CASSYSGGFNYGYTF,0,9,1,9
TRBV12-3/4,TRBJ1-5,CASSPRGIGYQPQHF,0,9,1,9
TRBV6-1,TRBJ2-3,CASSANFQGPQTQYF,0,9,1,9
TRBV6-4,TRBJ1-4,CASSDTTDRGEKLFF,0,9,1,9
TRBV2,TRBJ1-1,CASSEASGLNTEAFF,0,9,1,9
TRBV5-6,TRBJ2-1,CASSFWPGGWNEQFF,0,9,1,9
TRBV5-4,TRBJ1-4,CASSLAGTANEKLFF,0,9,1,9
TRBV7-3,TRBJ1-3,CASSLFWSSGNTIYF,0,9,1,9
TRBV7-2,TRBJ2-1,CASSLLAGRHNEQFF,0,9,1,9
TRBV7-9,TRBJ1-1,CASSLAQVMNTEAFF,0,9,1,9
TRBV7-3,TRBJ2-5,CASSLTTGRGETQYF,0,9,1,9
TRBV14,TRBJ1-1,CASSQDGSPYTEAFF,0,9,1,9
TRBV3-1,TRBJ2-3,CASSQENRRTDTQYF,0,9,1,9
TRBV9,TRBJ2-1,CASSVEGVSYNEQFF,0,9,1,9
TRBV12-3/4,TRBJ1-2,CASRPPGQGWYGYTF,0,9,1,9
TRBV12-3/4,TRBJ2-1,CASRPSGGRYNEQFF,0,9,1,9
TRBV28,TRBJ1-6,CASRNADRGYSPLHF,0,9,1,9
TRBV5-1,TRBJ2-3,CASSSGQIRTDTQYF,0,9,1,9
TRBV5-1,TRBJ2-3,CASSPRTGLEDTQYF,0,9,1,9
TRBV4-1,TRBJ1-1,CASSQDFPGFTEAFF,0,9,1,9
TRBV5-1,TRBJ2-7,CASSMGTSGSYEQYF,0,9,1,9
TRBV20-1,TRBJ2-7,CSAREGGRSSYEQYF,0,9,1,9
TRBV20-1,TRBJ2-3,CSAPVRASSTDTQYF,0,9,1,9
TRBV10-3,TRBJ2-1,CAISESRVRDEQFF,0,9,1,9
TRBV19,TRBJ1-2,CASTDGRGNYGYTF,0,9,1,9
TRBV19,TRBJ2-2,CASRQGAVGGELFF,0,9,1,9
TRBV18,TRBJ1-2,CASSSGQGDLGYTF,0,9,1,9
TRBV3-1,TRBJ2-2,CASGQAPGIGELFF,0,9,1,9
TRBV12-3/4,TRBJ2-3,CASSLHRGTDTQYF,0,9,1,9
TRBV3-1,TRBJ1-5,CASSPWGDDQPQHF,0,9,1,9
TRBV6-1,TRBJ2-7,CASSEIRASYEQYF,0,9,1,9
TRBV7-6,TRBJ2-7,CASSLVYRSYEQYF,0,9,1,9
TRBV11-2,TRBJ1-1,CASSLIFGGTEAFF,0,9,1,9
TRBV7-6,TRBJ2-7,CASSPRRENYEQYF,0,9,1,9
TRBV14,TRBJ2-7,CASSPGTPGYEQYF,0,9,1,9
TRBV3-1,TRBJ1-1,CASSRSPGATEAFF,0,9,1,9
TRBV3-1,TRBJ2-2,CASSQRGRTGELFF,0,9,1,9
TRBV4-2,TRBJ1-2,CASSQEVVFYGYTF,0,9,1,9
TRBV4-2,TRBJ2-5,CASSQKTGRETQYF,0,9,1,9
TRBV5-6,TRBJ2-7,CASRPTSGRNEQYF,0,9,1,9
TRBV3-1,TRBJ2-7,CASRGPLAGYEQYF,0,9,1,9
TRBV5-5,TRBJ1-1,CASRLWGGETEAFF,0,9,1,9
TRBV5-4,TRBJ1-2,CASRPGQQNYGYTF,0,9,1,9
TRBV5-1,TRBJ2-7,CASSLATSGNEQYF,0,9,1,9
TRBV5-1,TRBJ2-7,CASSLAGNPYEQYF,0,9,1,9
TRBV4-3,TRBJ1-1,CASSQGTDFTEAFF,0,9,1,9
TRBV5-1,TRBJ2-3,CASSVYRGTDTQYF,0,9,1,9
TRBV20-1,TRBJ2-1,CSANTRRSYNEQFF,0,9,1,9
TRBV20-1,TRBJ2-2,CSARSPRGTGELFF,0,9,1,9
TRBV29-1,TRBJ2-5,CSVAASGPRETQYF,0,9,1,9
TRBV29-1,TRBJ2-3,CSVENDQGTDTQYF,0,9,1,9
TRBV29-1,TRBJ1-1,CSVQLTGMNTEAFF,0,9,1,9
TRBV19,TRBJ2-1,CATAATTYNEQFF,0,9,1,9
TRBV19,TRBJ1-1,CASSGQANTEAFF,0,9,1,9
TRBV12-3/4,TRBJ2-7,CASQDGYSYEQYF,0,9,1,9
TRBV12-3/4,TRBJ2-5,CASGSRDQETQYF,0,9,1,9
TRBV7-9,TRBJ1-2,CASDPTAHYGYTF,0,9,1,9
TRBV27,TRBJ2-5,CASSSDSPGTQYF,0,9,1,9
TRBV12-3/4,TRBJ1-5,CASSPRTERPQHF,0,9,1,9
TRBV2,TRBJ2-7,CASSVRASYEQYF,0,9,1,9
TRBV6-4,TRBJ2-3,CASSDSSTDTQYF,0,9,1,9
TRBV5-4,TRBJ2-7,CASSLSSSYEQYF,0,9,1,9
TRBV13,TRBJ2-5,CASSLAVTETQYF,0,9,1,9
TRBV7-2,TRBJ1-2,CASSLTYTGGYTF,0,9,1,9
TRBV7-9,TRBJ2-3,CASSPRGPDTQYF,0,9,1,9
TRBV12-3/4,TRBJ1-2,CASSPQGSRGYTF,0,9,1,9
TRBV7-9,TRBJ1-5,CASSPSRNQPQHF,0,9,1,9
TRBV9,TRBJ1-2,CASSRQEHYGYTF,0,9,1,9
TRBV2,TRBJ1-1,CASSAKMNTEAFF,0,9,1,9
TRBV12-3/4,TRBJ1-2,CASRGTGLGGYTF,0,9,1,9
TRBV7-6,TRBJ2-5,CASRTRGQETQYF,0,9,1,9
TRBV5-1,TRBJ1-3,CASSGQTGNTIYF,0,9,1,9
TRBV5-1,TRBJ2-1,CASSLGNYNEQFF,0,9,1,9
TRBV20-1,TRBJ1-1,CSASRRRNTEAFF,0,9,1,9
TRBV20-1,TRBJ1-5,CSGREGGNQPQHF,0,9,1,9
TRBV29-1,TRBJ2-7,CSASGLAASEQYF,0,9,1,9
TRBV10-3,TRBJ1-2,CAIPDSNYGYTF,0,9,1,9
TRBV24-1,TRBJ2-2,CATSSATGELFF,0,9,1,9
TRBV18,TRBJ1-5,CASSPGNQPQHF,0,9,1,9
TRBV2,TRBJ1-2,CASGDRPYGYTF,0,9,1,9
TRBV13,TRBJ1-1,CASSFPGGEAFF,0,9,1,9
TRBV4-2,TRBJ2-1,CASSPDGTEQFF,0,9,1,9
TRBV6-2/3/5/6,TRBJ2-1,CASRGEFNEQFF,0,9,1,9
TRBV20-1,TRBJ2-5,CSASFSRGTQYF,0,9,1,9
TRBV29-1,TRBJ1-2,CSVEFRGRGYTF,0,9,1,9
TRBV29-1,TRBJ1-1,CSAEPQAAEAFF,0,9,1,9
TRBV12-3/4,TRBJ1-2,CASSLGAGYTF,0,9,1,9
TRBV5-6,TRBJ2-7,CASSLFREQYF,0,9,1,9
TRBV3-1,TRBJ1-1,CASSQDFRAFF,0,9,1,9
TRBV4-1,TRBJ2-1,CASSQAGEQFF,0,9,1,9
TRBV29-1,TRBJ1-4,CTIGAAEKLFF,0,9,1,9
TRBV20-1,TRBJ2-3,CSGLAVDTQYF,0,9,1,9
TRBV13,TRBJ2-1,CASSLGLAPNNEQFF,0,9,1,9
TRBV7-9,TRBJ2-6,CASSLEGRRSGANVLTF,0,9,1,9
TRBV18,TRBJ2-5,CASSPPSARRETQYF,0,9,1,9
TRBV3-1,TRBJ2-3,CASSQSGGAPTQYF,0,9,1,9
TRBV5-1,TRBJ1-4,CASSLGEKLFF,0,13,1,13
TRBV4-2,TRBJ2-3,CASSQEAGASTDTQYF,0,9,1,9
TRBV11-1,TRBJ2-7,CASSQRGSSYEQYF,0,9,1,9
TRBV19,TRBJ2-2,CASGISTGGTGELFF,0,9,1,9
TRBV5-6,TRBJ2-1,CASSLVSQGSNEQFF,0,9,1,9
TRBV4-1,TRBJ1-1,CASTQGFSVATEAFF,0,8,1,8
TRBV3-1,TRBJ2-5,CASSQSRGETQYF,0,8,1,8
TRBV7-9,TRBJ1-3,CASSNPDTIYF,0,8,1,8
TRBV19,TRBJ2-3,CASRRRAALRASGRTDTQYF,0,8,1,8
TRBV19,TRBJ2-1,CASSIARLAGGPSYNEQFF,0,8,1,8
TRBV12-3/4,TRBJ2-1,CASSSPLASGWGLINEQFF,0,8,1,8
TRBV20-1,TRBJ2-1,CSARDLRSGSETRYNEQFF,0,8,1,8
TRBV12-5,TRBJ1-3,CASGLVLGQGLFGNTIYF,0,8,1,8
TRBV19,TRBJ2-1,CASRGWMAGRSSYNEQFF,0,8,1,8
TRBV28,TRBJ2-6,CASSEQGAASSGANVLTF,0,8,1,8
TRBV12-3/4,TRBJ2-3,CASSSRRGLAGGSDTQYF,0,8,1,8
TRBV7-6,TRBJ1-3,CASSPTGGSGASGNTIYF,0,8,1,8
TRBV20-1,TRBJ1-5,CSALAGTGGENGNQPQHF,0,8,1,8
TRBV12-5,TRBJ2-7,CASGLPRSIRTTYEQYF,0,8,1,8
TRBV10-3,TRBJ2-7,CAIRNPPDRWDDYEQYF,0,8,1,8
TRBV3-1,TRBJ1-1,CASGRTGRFGGVSEAFF,0,8,1,8
TRBV19,TRBJ2-1,CASSSAAGTGVDNEQFF,0,8,1,8
TRBV12-3/4,TRBJ2-7,CASSFSWDAGPPTEQYF,0,8,1,8
TRBV12-3/4,TRBJ1-1,CASSSLGAGGFSTEAFF,0,8,1,8
TRBV6-2/3/5/6,TRBJ1-2,CASSYPSVWTPNYGYTF,0,8,1,8
TRBV12-3/4,TRBJ2-1,CASSGPSQREPPHEQFF,0,8,1,8
TRBV7-2,TRBJ1-1,CASSLVSDRGRTLGAFF,0,8,1,8
TRBV3-1,TRBJ2-5,CASSLSREGKNQETQYF,0,8,1,8
TRBV7-9,TRBJ2-3,CASSILTGGYSTDTQYF,0,8,1,8
TRBV20-1,TRBJ1-1,CSARGLLDSRMNTEAFF,0,8,1,8
TRBV12-5,TRBJ2-3,CASGPWTSGDTDTQYF,0,8,1,8
TRBV18,TRBJ1-1,CASSPLPGQGPPEAFF,0,8,1,8
TRBV18,TRBJ2-4,CASSPGTGVSKNIQYF,0,8,1,8
TRBV12-3/4,TRBJ2-1,CASSLFRGGSYNEQFF,0,8,1,8
TRBV12-3/4,TRBJ2-7,CASSLSRDRETYEQYF,0,8,1,8
TRBV12-3/4,TRBJ2-4,CASSLARQGAKNIQYF,0,8,1,8
TRBV12-3/4,TRBJ1-1,CASSLGTGGGNTEAFF,0,8,1,8
TRBV6-2/3/5/6,TRBJ2-5,CASSYYRGPTGETQYF,0,8,1,8
TRBV6-2/3/5/6,TRBJ1-2,CASSYFRQGTLRGYTF,0,8,1,8
TRBV6-2/3/5/6,TRBJ1-1,CASSYSSFQGGSEAFF,0,8,1,8
TRBV2,TRBJ2-2,CASSEGGAPEDGELFF,0,8,1,8
TRBV2,TRBJ2-1,CASSENDRVSYNEQFF,0,8,1,8
TRBV12-3/4,TRBJ2-1,CASSTRGLAGVNEQFF,0,8,1,8
TRBV2,TRBJ1-6,CASSNRGLSYNSPLHF,0,8,1,8
TRBV5-6,TRBJ2-7,CASSLDSASGTYEQYF,0,8,1,8
TRBV7-9,TRBJ1-4,CASSSTPNPLNEKLFF,0,8,1,8
TRBV7-3,TRBJ2-1,CASSLNSGNSYNEQFF,0,8,1,8
TRBV6-2/3/5/6,TRBJ1-5,CASSLLGTEPLEPQHF,0,8,1,8
TRBV5-4,TRBJ2-1,CASSPGGTSGYNEQFF,0,8,1,8
TRBV12-3/4,TRBJ2-5,CASSHKSSGAGETQYF,0,8,1,8
TRBV4-2,TRBJ2-1,CASSQSVRGGPDEQFF,0,8,1,8
TRBV14,TRBJ2-1,CASSQVGTTSYNEQFF,0,8,1,8
TRBV7-9,TRBJ2-7,CASSGSRDRQTYEQYF,0,8,1,8
TRBV7-3,TRBJ2-1,CASSTLELAGRDEQFF,0,8,1,8
TRBV12-3/4,TRBJ1-5,CASRAGFLYSNQPQHF,0,8,1,8
TRBV28,TRBJ2-1,CASRISLAGGINEQFF,0,8,1,8
TRBV5-1,TRBJ2-2,CASTWTDPFNTGELFF,0,8,1,8
TRBV5-1,TRBJ2-7,CASSLSGSLSIYEQYF,0,8,1,8
TRBV20-1,TRBJ2-2,CSALGTSGSYTGELFF,0,8,1,8
TRBV20-1,TRBJ2-3,CSGGLAGVAGTDTQYF,0,8,1,8
TRBV29-1,TRBJ1-1,CSVPLTGGEWNTEAFF,0,8,1,8
TRBV29-1,TRBJ2-7,CSVDGLVGGSIYEQYF,0,8,1,8
TRBV29-1,TRBJ1-2,CSVETRTGKANYGYTF,0,8,1,8
TRBV7-4,TRBJ2-3,RASSFRQGASGDTQYF,0,8,1,8
TRBV27,TRBJ1-1,CAISSGTGGWTEAFF,0,8,1,8
TRBV15,TRBJ2-5,CATSRGPGTQETQYF,0,8,1,8
TRBV19,TRBJ2-7,CASSQLPAGDYEQYF,0,8,1,8
TRBV19,TRBJ2-3,CASSISAESTDTQYF,0,8,1,8
TRBV18,TRBJ2-7,CASSPPGQSGNEQYF,0,8,1,8
TRBV18,TRBJ2-7,CASSQRPSGSYEQYF,0,8,1,8
TRBV5-4,TRBJ1-6,CASTLQGAYNSPLHF,0,8,1,8
TRBV2,TRBJ2-7,CASTPEGAGGYEQYF,0,8,1,8
TRBV2,TRBJ2-5,CASTGQPLRQETQYF,0,8,1,8
TRBV12-3/4,TRBJ2-1,CASSLLAGGGNEQFF,0,8,1,8
TRBV6-2/3/5/6,TRBJ2-3,CASSSTGESTDTQYF,0,8,1,8
TRBV7-2,TRBJ2-7,CASSWDAGGTYEQYF,0,8,1,8
TRBV6-2/3/5/6,TRBJ2-5,CASSYSGAYQETQYF,0,8,1,8
TRBV6-2/3/5/6,TRBJ2-3,CASSYSIQVTDTQYF,0,8,1,8
TRBV7-2,TRBJ1-6,CASSPTGVHGSPLHF,0,8,1,8
TRBV11-1,TRBJ2-6,CASSFRGLGANVLTF,0,8,1,8
TRBV7-2,TRBJ1-2,CASSFATTGSYGYTF,0,8,1,8
TRBV5-4,TRBJ1-1,CASSLVSNMNTEAFF,0,8,1,8
TRBV5-6,TRBJ1-2,CASSLGRQANYGYTF,0,8,1,8
TRBV5-4,TRBJ2-3,CASSLDGGSTDTQYF,0,8,1,8
TRBV7-2,TRBJ1-2,CASSLQGQNNYGYTF,0,8,1,8
TRBV7-9,TRBJ1-1,CASSLVGGRDTEAFF,0,8,1,8
TRBV7-3,TRBJ2-5,CASSLGGLDQETQYF,0,8,1,8
TRBV7-2,TRBJ1-1,CASSLEAGRNTEAFF,0,8,1,8
TRBV7-2,TRBJ1-2,CASSSTWPFGGGYTF,0,8,1,8
TRBV13,TRBJ1-1,CASSSSDRANTEAFF,0,8,1,8
TRBV7-9,TRBJ2-1,CASSSRQGVYNEQFF,0,8,1,8
TRBV7-9,TRBJ1-1,CASSSPPRGRTEAFF,0,8,1,8
TRBV7-2,TRBJ2-1,CASSLSGGGGHEQFF,0,8,1,8
TRBV14,TRBJ2-7,CASSPGVAGTPGQYF,0,8,1,8
TRBV7-9,TRBJ1-5,CASSPGTGINQPQHF,0,8,1,8
TRBV7-6,TRBJ2-7,CASSPTVTGSDEQYF,0,8,1,8
TRBV3-1,TRBJ2-3,CASSHGGGRADTQYF,0,8,1,8
TRBV7-2,TRBJ1-2,CASSHRDSPNYGYTF,0,8,1,8
TRBV6-4,TRBJ2-3,CASSHRLENTDTQYF,0,8,1,8
TRBV3-1,TRBJ2-7,CASSQDLTSFYEQYF,0,8,1,8
TRBV14,TRBJ2-5,CASSQDRRIRETQYF,0,8,1,8
TRBV7-2,TRBJ2-7,CASSVHGRGVDEQYF,0,8,1,8
TRBV9,TRBJ1-5,CASSVGRGGNQPQHF,0,8,1,8
TRBV7-9,TRBJ2-2,CASSTDRMNTGELFF,0,8,1,8
TRBV12-3/4,TRBJ2-3,CASRAGTGVPDTQYF,0,8,1,8
TRBV12-3/4,TRBJ2-1,CASRGTSGRFDEQFF,0,8,1,8
TRBV2,TRBJ2-1,CASRGQSKNYNEQFF,0,8,1,8
TRBV5-1,TRBJ1-6,CASGPLEGYNSPLHF,0,8,1,8
TRBV5-1,TRBJ2-1,CASSFRDSRENEQFF,0,8,1,8
TRBV5-1,TRBJ1-5,CASSLRGSSNQPQHF,0,8,1,8
TRBV5-1,TRBJ2-1,CASSLNPPLDNEQFF,0,8,1,8
TRBV4-3,TRBJ2-5,CASSLTVAGGETQYF,0,8,1,8
TRBV4-1,TRBJ2-7,CASSQIAGTAYEQYF,0,8,1,8
TRBV4-1,TRBJ2-1,CASSQTEGYWDEQFF,0,8,1,8
TRBV20-1,TRBJ2-1,CSASGRGASYNEQFF,0,8,1,8
TRBV19,TRBJ2-2,RASRPPRVDTGELFF,0,8,1,8
TRBV2,TRBJ2-5,CAGGLAGHQETQYF,0,8,1,8
TRBV24-1,TRBJ2-1,CATSERGTYNEQFF,0,8,1,8
TRBV6-4,TRBJ2-1,CASSGTVSYNEQFF,0,8,1,8
TRBV18,TRBJ1-1,CASSLIGRNTEAFF,0,8,1,8
TRBV18,TRBJ2-5,CASSPKQEGVTQYF,0,8,1,8
TRBV6-2/3/5/6,TRBJ2-7,CASDWQPSPYEQYF,0,8,1,8
TRBV5-5,TRBJ1-1,CASDQRDSWTEAFF,0,8,1,8
TRBV25-1,TRBJ2-1,CASTRSGAYNEQFF,0,8,1,8
TRBV12-3/4,TRBJ2-1,CASSFSRSYNEQFF,0,8,1,8
TRBV2,TRBJ2-7,CASSSTSGGYEQYF,0,8,1,8
TRBV6-2/3/5/6,TRBJ2-1,CASSYLLNGGGEFF,0,8,1,8
TRBV6-2/3/5/6,TRBJ2-4,CASSPRTAQNIQYF,0,8,1,8
TRBV12-3/4,TRBJ2-7,CASSPRDTAYEQYF,0,8,1,8
TRBV6-1,TRBJ1-2,CASSAMTANYGYTF,0,8,1,8
TRBV5-6,TRBJ2-7,CASSLASVSYEQYF,0,8,1,8
TRBV7-9,TRBJ1-1,CASSLGGAYTEAFF,0,8,1,8
TRBV7-2,TRBJ1-2,CASSLGGRIRGYTF,0,8,1,8
TRBV7-3,TRBJ2-1,CASSLGTSPHEQFF,0,10,1,10
TRBV11-3,TRBJ2-3,CASSLTRFSDTQYF,0,8,1,8
TRBV7-9,TRBJ2-2,CASSLNRHTGELFF,0,8,1,8
TRBV7-2,TRBJ2-7,CASSSRTSGVEQYF,0,8,1,8
TRBV5-6,TRBJ2-1,CASSWGQGYNEQFF,0,8,1,8
TRBV6-4,TRBJ2-5,CASSLGPVVETQYF,0,8,1,8
TRBV12-3/4,TRBJ1-1,CASSPGRPNTEAFF,0,8,1,8
TRBV5-6,TRBJ2-7,CASSPQGQGYEQYF,0,8,1,8
TRBV12-3/4,TRBJ1-5,CASSPTGDNQPQHF,0,8,1,8
TRBV3-1,TRBJ2-7,CASSQDYLAYEQYF,0,8,1,8
TRBV5-4,TRBJ2-1,CASSQRDLYNEQFF,0,8,1,8
TRBV9,TRBJ1-4,CASSETGDQEKLFF,0,8,1,8
TRBV6-4,TRBJ1-1,CASRPGPGWTEAFF,0,8,1,8
TRBV6-2/3/5/6,TRBJ2-7,CASRGTSGSLQQYS,0,8,1,8
TRBV5-1,TRBJ2-3,CASSTSGHTDTQYF,0,8,1,8
TRBV5-1,TRBJ1-1,CASSLAVLNTEAFF,0,8,1,8
TRBV5-1,TRBJ1-1,CASSLTELNTEAFF,0,8,1,8
TRBV5-1,TRBJ1-1,CASSPGGSVTEAFF,0,8,1,8
TRBV20-1,TRBJ2-7,CSARGDRGFYEQYF,0,8,1,8
TRBV20-1,TRBJ2-5,CSARDVRESETQYF,0,8,1,8
TRBV20-1,TRBJ1-4,CSAAGQPGDEKLFF,0,8,1,8
TRBV29-1,TRBJ2-2,CSVVGGENTGELFF,0,8,1,8
TRBV29-1,TRBJ2-1,CSVVQGESYNEQFF,0,8,1,8
TRBV29-1,TRBJ2-3,CSVGQGAPMDTQYF,0,8,1,8
TRBV29-1,TRBJ1-1,CSVETGARYTEAFF,0,8,1,8
TRBV29-1,TRBJ2-7,CSVILEGATYEQYF,0,8,1,8
TRBV29-1,TRBJ2-1,CSVRQGTLYNEQFF,0,8,1,8
TRBV29-1,TRBJ2-5,CSVPTGGMGETQYF,0,8,1,8
TRBV29-1,TRBJ2-7,CSVTTGGDYYEQYF,0,8,1,8
TRBV30,TRBJ1-5,CAWTTGSNQPQHF,0,8,1,8
TRBV10-3,TRBJ2-5,CAISESVGGERYF,0,8,1,8
TRBV19,TRBJ1-1,CATSKGGSTEAFF,0,8,1,8
TRBV19,TRBJ2-1,CASQEGPYNEQFF,0,8,1,8
TRBV19,TRBJ1-6,CASTEDGNSPLHF,0,8,1,8
TRBV19,TRBJ1-5,CASSREGLGPQHF,0,8,1,8
TRBV5-8,TRBJ1-4,CASSKGVREKLFF,0,8,1,8
TRBV28,TRBJ2-3,CASQGHDTDTQYF,0,8,1,8
TRBV3-1,TRBJ2-1,CASGLSSYNEQFF,0,8,1,8
TRBV3-1,TRBJ1-1,CASSLFLNTEAFF,0,8,1,8
TRBV11-3,TRBJ1-1,CASSRQGNTEAFF,0,8,1,8
TRBV25-1,TRBJ2-5,CASSEGGLETQYF,0,8,1,8
TRBV5-5,TRBJ2-5,CASSFGNKETQYF,0,8,1,8
TRBV5-6,TRBJ2-7,CASSLVSVDEQYF,0,8,1,8
TRBV7-9,TRBJ1-5,CASSLGGDQPQHF,0,8,1,8
TRBV5-5,TRBJ2-5,CASSWAGTETQYF,0,8,1,8
TRBV5-5,TRBJ1-2,CASSPGTAYGYTF,0,8,1,8
TRBV7-3,TRBJ2-7,CASSPGTGYEQYF,0,8,1,8
TRBV5-4,TRBJ1-2,CASSPGTVYGYTF,0,8,1,8
TRBV3-1,TRBJ1-3,CASSHLTGNTIYF,0,8,1,8
TRBV9,TRBJ2-7,CASSVGEPYEQYF,0,8,1,8
TRBV2,TRBJ1-1,CANSQNLVTEAFF,0,8,1,8
TRBV5-1,TRBJ2-7,CASSLATAYEQYF,0,8,1,8
TRBV4-1,TRBJ2-7,CASSPDKFYEQYF,0,8,1,8
TRBV29-1,TRBJ1-4,CSVPGRGNEKLFF,0,8,1,8
TRBV29-1,TRBJ1-6,CSVRGQYNSPLHF,0,8,1,8
TRBV29-1,TRBJ1-2,CSVRPYSRNGYTF,0,8,1,8
TRBV29-1,TRBJ2-3,CSVQDRSTDTQYF,0,8,1,8
TRBV29-1,TRBJ2-3,CSVDTQDTDTQYF,0,8,1,8
TRBV29-1,TRBJ2-3,CSVDAGNTDTQYF,0,8,1,8
TRBV29-1,TRBJ2-7,CSVEVGLGYEQYF,0,8,1,8
TRBV29-1,TRBJ2-3,CSVLPGRTDTQYF,0,8,1,8
TRBV29-1,TRBJ1-5,CSVGDREEQPQHF,0,8,1,8
TRBV15,TRBJ1-1,CATSTRTGKAFF,0,8,1,8
TRBV19,TRBJ1-1,CASHLGNTEAFF,0,8,1,8
TRBV12-3/4,TRBJ2-1,CASSPLRNEQFF,0,8,1,8
TRBV7-9,TRBJ1-6,CASSPRGSPLHF,0,8,1,8
TRBV7-2,TRBJ2-5,CASSLGGKTQYF,0,8,1,8
TRBV7-9,TRBJ2-1,CASSLEGGEQFF,0,8,1,8
TRBV7-9,TRBJ2-7,CASSTTAYEQYF,0,8,1,8
TRBV4-1,TRBJ1-2,CASSQQGNGYTF,0,8,1,8
TRBV20-1,TRBJ2-7,CSSGVDLYEQYF,0,8,1,8
TRBV20-1,TRBJ2-5,CSASMSQETQYF,0,8,1,8
TRBV20-1,TRBJ2-7,CSASPWEREQYF,0,8,1,8
TRBV29-1,TRBJ1-5,CSARKANQPQHF,0,8,1,8
TRBV29-1,TRBJ2-1,CSSSQGATEQFF,0,8,1,8
TRBV29-1,TRBJ2-1,CSSERSYNEQFF,0,8,1,8
TRBV29-1,TRBJ2-3,CSVGTTGDTQYF,0,8,1,8
TRBV7-9,TRBJ1-1,CASSLVGEAFF,0,8,1,8
TRBV29-1,TRBJ1-4,CTIGAAGKLFF,0,8,1,8
TRBV29-1,TRBJ2-1,CSVVGSDEQFF,0,8,1,8
TRBV29-1,TRBJ2-5,CSVGTEGTQYF,0,8,1,8
TRBV29-1,TRBJ2-4,CSAVAKNIQYF,0,8,1,8
TRBV20-1,TRBJ2-7,CSGWEGEQYF,0,8,1,8
TRBV11-1,TRBJ2-5,CASSYPGTAIIRDRETQYF,0,8,1,8
TRBV20-1,TRBJ1-1,CSASRDRGGSNTEAFF,0,8,1,8
TRBV4-3,TRBJ1-1,CASSQWTGMNTEAFF,0,8,1,8
TRBV4-3,TRBJ2-7,CASSQTGGRPNEQYF,0,8,1,8
TRBV5-6,TRBJ1-4,CASSPDSKREKLFF,0,8,1,8
TRBV6-2/3/5/6,TRBJ1-4,CASSYSVRAANEKLFF,0,8,1,8
TRBV3-1,TRBJ1-3,CASSQVETGNTIYF,0,8,1,8
TRBV7-9,TRBJ2-2,CASGSGSGARTGELFF,0,8,1,8
TRBV7-9,TRBJ2-1,CASSSTSGGFYNEQFF,0,12,1,12
TRBV15,TRBJ1-3,CATRLGNSGNTIYF,0,8,1,8
TRBV5-1,TRBJ2-4,CASSQDSGGTQYF,0,8,1,8
TRBV29-1,TRBJ2-7,CSVLPTGRNEQYF,0,8,1,8
TRBV9,TRBJ2-5,CASKGPLSWERGETQYF,0,8,1,8
TRBV12-3/4,TRBJ1-4,CASSLGLGQGEKLFF,0,8,1,8
TRBV5-8,TRBJ1-5,CAGSLMRQASNQPQHF,0,8,1,8
TRBV5-4,TRBJ2-3,CASSSPDRGRFGTDTQYF,0,7,1,7
TRBV4-2,TRBJ1-1,CASSQAGENTEAFF,0,7,1,7
TRBV20-1,TRBJ2-6,CSARPPLSRGHSTKSGANVLTF,0,7,1,7
TRBV20-1,TRBJ1-4,CSAEFGGDEKLIF,0,7,1,7
TRBV5-5,TRBJ2-7,CASRPWEGDYEQYF,0,7,1,7
TRBV19,TRBJ1-2,CASSPATVTNRVEERGYTF,0,7,1,7
TRBV7-6,TRBJ1-4,CASSRTGTGLAQGEKLFF,0,7,1,7
TRBV7-2,TRBJ2-4,CASSPPPRLAENIQYF,0,7,1,7
TRBV9,TRBJ1-6,CASSPTRGGEGSPLHF,0,7,1,7
TRBV19,TRBJ2-3,CASSIGLAPTDTQYF,0,7,1,7
TRBV6-1,TRBJ2-2,CASSAAGVTGELFF,0,7,1,7
TRBV3-1,TRBJ1-5,CASSQEWGREQPQHF,0,7,1,7
TRBV15,TRBJ2-4,CATSSATQTNIQYF,0,7,1,7
TRBV7-6,TRBJ2-3,CASSLSADSSTRYF,0,7,1,7
TRBV13,TRBJ1-4,CASSPGPNKEKLFS,0,7,1,7
TRBV13,TRBJ1-1,CASSFENTEAFF,0,7,1,7
TRBV4-2,TRBJ2-6,CASSRPRGSGVLSSGANVLTF,0,7,1,7
TRBV28,TRBJ2-5,CASTWDFGLGTQYF,0,7,1,7
TRBV5-1,TRBJ2-2,CASSETGDTGELFF,0,7,1,7
TRBV29-1,TRBJ1-1,CSVGKGNMNTEAFF,0,7,1,7
TRBV14,TRBJ1-2,CASSPGLDYGYTF,0,7,1,7
TRBV2,TRBJ2-3,CASSYKGALSGTEYTDTQYF,0,7,1,7
TRBV29-1,TRBJ2-1,CSVEGRGTSGITSSYNEQFF,0,7,1,7
TRBV10-3,TRBJ1-1,CAISESRGPYEGRSTEAFF,0,7,1,7
TRBV3-1,TRBJ2-1,CASSPLAGGPSMGRDEQFF,0,7,1,7
TRBV4-2,TRBJ2-2,CASSQVGDTGGRDTGELFF,0,7,1,7
TRBV3-1,TRBJ2-1,CASSQVSCTGARDYNEQFF,0,7,1,7
TRBV11-2,TRBJ2-2,CASSFGLAGDLNTGELFF,0,7,1,7
TRBV5-6,TRBJ1-5,CASSSALGISDRNQPQHF,0,7,1,7
TRBV20-1,TRBJ2-4,CSARDGGGGLIAKNIQYF,0,7,1,7
TRBV30,TRBJ2-3,CAWSNTGGKFGGDTQYF,0,7,1,7
TRBV10-3,TRBJ2-2,CAISAWTTSRNTGELFF,0,7,1,7
TRBV12-3/4,TRBJ2-7,CATSFGSGRVPGYEQYF,0,7,1,7
TRBV13,TRBJ2-7,CATGAGGIGVSDHEQYF,0,7,1,7
TRBV15,TRBJ1-3,CATSRGTGPSSGNTIYF,0,7,1,7
TRBV19,TRBJ1-2,CASSIFPDTRGLYGYTF,0,7,1,7
TRBV6-2/3/5/6,TRBJ1-1,CASSLGWKFGTNTEAFF,0,7,1,7
TRBV6-2/3/5/6,TRBJ1-6,CASSLIGAGVYNSPLHF,0,7,1,7
TRBV12-3/4,TRBJ2-1,CASSSKTSGSKGNEQFF,0,7,1,7
TRBV6-2/3/5/6,TRBJ2-3,CASSWAGGWGSTDTQYF,0,7,1,7
TRBV6-2/3/5/6,TRBJ1-2,CASSYVGTGGANYGYTF,0,7,1,7
TRBV7-2,TRBJ1-6,CASSFGLRGNYNSPLHF,0,7,1,7
TRBV7-9,TRBJ1-1,CASSLLPYLAGNTEAFF,0,7,1,7
TRBV7-9,TRBJ1-6,CASSLTFRLNDLSPLHF,0,7,1,7
TRBV7-2,TRBJ2-3,CASSLGLAGGMEDTQYF,0,7,1,7
TRBV11-3,TRBJ2-5,CASSRRTSGREQETQYF,0,7,1,7
TRBV2,TRBJ2-4,CASRRSGLELAKNIQYF,0,7,1,7
TRBV5-1,TRBJ2-1,CASSLELAGVSYNEQFF,0,7,1,7
TRBV20-1,TRBJ2-1,CSARENGLAGGYNEQFF,0,7,1,7
TRBV20-1,TRBJ1-3,CSATPDDIPSSGNTIYF,0,7,1,7
TRBV29-1,TRBJ2-3,CSVEDLGQQPRTDTQYF,0,7,1,7
TRBV12-5,TRBJ2-7,CASGPPSGQRPYEQYF,0,7,1,7
TRBV19,TRBJ2-5,CASSPFGGTGEETQYF,0,7,1,7
TRBV18,TRBJ2-3,CASSPPRGTDADTQYF,0,7,1,7
TRBV27,TRBJ2-7,CASRSPGTSLPYEQYF,0,7,1,7
TRBV6-2/3/5/6,TRBJ1-3,CASSFRKTLSENTICF,0,7,1,7
TRBV12-3/4,TRBJ1-6,CASSSRGTASNSPLHF,0,7,1,7
TRBV6-2/3/5/6,TRBJ1-2,CASSYSWTEINYGYTF,0,7,1,7
TRBV6-2/3/5/6,TRBJ2-1,CASSYVVQARGHEQFF,0,7,1,7
TRBV6-2/3/5/6,TRBJ2-1,CASSYNQGAFYNEQFF,0,7,1,7
TRBV27,TRBJ1-3,CASSPGGQITGNTIYF,0,7,1,7
TRBV5-4,TRBJ2-3,CASSFRGQGAIDTQYF,0,7,1,7
TRBV7-2,TRBJ2-1,CASSLASVAGNNEQFF,0,7,1,7
TRBV7-8,TRBJ1-5,CASSLEGQGSNQPQHF,0,7,1,7
TRBV7-9,TRBJ2-5,CASSSLADHYQETQYF,0,7,1,7
TRBV7-8,TRBJ2-7,CASSPRPDLGSYEQYF,0,7,1,7
TRBV3-1,TRBJ2-4,CASSPGPGEPKNIQYF,0,7,1,7
TRBV9,TRBJ2-7,CASSPYGTSGNYEQYF,0,7,1,7
TRBV7-2,TRBJ2-2,CASSVRLAENTGELFF,0,7,1,7
TRBV5-4,TRBJ1-2,CASSAPRTGAVYGYTF,0,7,1,7
TRBV11-2,TRBJ2-1,CASSATWTSGRTEQFF,0,7,1,7
TRBV13,TRBJ2-1,CASSGPEAGGRNEQFF,0,7,1,7
TRBV12-3/4,TRBJ2-5,CASRSFGTGDRETQYF,0,7,1,7
TRBV12-3/4,TRBJ1-3,CASRNRGRQERDTIYF,0,7,1,7
TRBV6-2/3/5/6,TRBJ2-1,CASRGVGGIYSNEQFF,0,7,1,7
TRBV5-1,TRBJ1-6,CASSLTGGTGGSPLHF,0,7,1,7
TRBV5-1,TRBJ1-3,CASSATGGSSGNTIYF,0,7,1,7
TRBV20-1,TRBJ2-5,CSARDLGSAQAETQYF,0,7,1,7
TRBV12-3/4,TRBJ2-5,CVSSPPGTGGETQYF,0,7,1,7
TRBV2,TRBJ1-4,CASLIGQGINEKLFF,0,7,1,7
TRBV30,TRBJ2-1,CAWSVRLAGVYEQFF,0,7,1,7
TRBV30,TRBJ1-5,CAWSKGADSNQPQHF,0,7,1,7
TRBV10-3,TRBJ2-7,CAISESNGGAYEQYF,0,7,1,7
TRBV24-1,TRBJ2-3,CATSDLRDSTDTQYF,0,7,1,7
TRBV15,TRBJ1-1,CATSRGGLMNTEAFF,0,7,1,7
TRBV18,TRBJ1-1,CASSPGRGENTEAFF,0,7,1,7
TRBV18,TRBJ1-6,CASSPDSSYNSPLHF,0,7,1,7
TRBV14,TRBJ2-3,CASQREGTSTDTQYF,0,7,1,7
TRBV6-2/3/5/6,TRBJ2-2,CASTRGGQHTGELFF,0,7,1,7
TRBV12-3/4,TRBJ1-6,CASSFGQGQNSPLHF,0,7,1,7
TRBV12-3/4,TRBJ2-3,CASSLGRGSTDTQYF,0,7,1,7
TRBV6-2/3/5/6,TRBJ2-1,CASSLGQANYNEQFF,0,7,1,7
TRBV27,TRBJ1-2,CASSSWTAPNYGYTF,0,7,1,7
TRBV12-3/4,TRBJ2-7,CASSSRGALPYEQYF,0,7,1,7
TRBV6-2/3/5/6,TRBJ2-3,CASSSASGGADTQYF,0,7,1,7
TRBV12-3/4,TRBJ2-3,CASSWSGGPTDTQYF,0,7,1,7
TRBV6-2/3/5/6,TRBJ1-5,CASSYSRQSNQPQHF,0,7,1,7
TRBV6-2/3/5/6,TRBJ1-1,CASSYRSDRLLEAFF,0,7,1,7
TRBV6-2/3/5/6,TRBJ2-1,CASSYGGSSYNEQFF,0,7,1,7
TRBV6-2/3/5/6,TRBJ2-3,CASSYGAGSADTQYF,0,7,1,7
TRBV6-2/3/5/6,TRBJ2-7,CASSYTYLAGHEQYF,0,7,1,7
TRBV12-3/4,TRBJ2-1,CASSLGQGSYNEQFF,0,7,1,7
TRBV27,TRBJ1-1,CASSPRDRMNTEAFF,0,7,1,7
TRBV6-2/3/5/6,TRBJ2-7,CASSPTSGGYYEQYF,0,7,1,7
TRBV6-1,TRBJ2-2,CASSVRADNTGELFF,0,7,1,7
TRBV2,TRBJ2-7,CASSGPAGERYEQYF,0,7,1,7
TRBV6-1,TRBJ2-3,CASSDLRGGLNTQYF,0,7,1,7
TRBV2,TRBJ2-7,CASSEGDTSSYEQYF,0,7,1,7
TRBV5-4,TRBJ1-4,CASSLVGATNEKLFF,0,7,1,7
TRBV7-2,TRBJ1-6,CASSLAGPPNSPLHF,0,7,1,7
TRBV13,TRBJ2-1,CASSLRQGATNEQFF,0,7,1,7
TRBV7-2,TRBJ2-7,CASSLAQSLFYEQYF,0,7,1,7
TRBV7-2,TRBJ1-5,CASSLGTGPNQPQHF,0,7,1,7
TRBV11-2,TRBJ2-1,CASSLGQGTYNEQFF,0,7,1,7
TRBV7-2,TRBJ1-3,CASSSGTGSGNTIYF,0,7,1,7
TRBV7-6,TRBJ1-6,CASSSNRGHNSPLHF,0,7,1,7
TRBV28,TRBJ2-2,CASSLGDRDTGELFF,0,7,1,7
TRBV4-2,TRBJ2-3,CASSLTQRNTDTQYF,0,7,1,7
TRBV7-2,TRBJ2-1,CASSPSLGNNDEQFF,0,7,1,7
TRBV3-1,TRBJ2-7,CASSPQTGGNYEQYF,0,7,1,7
TRBV6-2/3/5/6,TRBJ1-2,CASSPSGTTRDGYTF,0,7,1,7
TRBV11-1,TRBJ1-1,CASSHPTGGNTEAFF,0,7,1,7
TRBV3-1,TRBJ1-1,CASSQDHALDTEAFF,0,7,1,7
TRBV9,TRBJ1-6,CASSAGHSDNSPLHF,0,7,1,7
TRBV6-4,TRBJ2-3,CASSDGLLNRDTQYF,0,7,1,7
TRBV7-6,TRBJ2-7,CASSTTSGGNYEQYF,0,7,1,7
TRBV7-6,TRBJ2-7,CASSTTSGDNYEQYF,0,7,1,7
TRBV6-4,TRBJ2-6,CASSRGDSGANVLTF,0,7,1,7
TRBV5-6,TRBJ2-3,CASSNRTGWTDTQYF,0,7,1,7
TRBV12-3/4,TRBJ1-1,CASRGLWGFRTEAFF,0,7,1,7
TRBV7-2,TRBJ2-7,CASRRTGDGTYEQYF,0,7,1,7
TRBV7-9,TRBJ2-1,CASRPDGGGLHEQFF,0,7,1,7
TRBV7-2,TRBJ2-3,CASRPIGTSTDTQYF,0,7,1,7
TRBV2,TRBJ2-1,CASRTKTSENNEQFF,0,7,1,7
TRBV5-1,TRBJ1-6,CASSLAVTGESPLHF,0,7,1,7
TRBV5-1,TRBJ1-1,CASSLGQGHNTEAFF,0,7,1,7
TRBV5-1,TRBJ1-1,CASSLDEEGWTEAFF,0,7,1,7
TRBV4-1,TRBJ1-5,CASSRRRGANQPQHF,0,7,1,7
TRBV4-1,TRBJ2-7,CASSQGFLGGNEQYF,0,7,1,7
TRBV20-1,TRBJ1-4,CSATERGQANEKLFF,0,7,1,7
TRBV20-1,TRBJ2-7,CSASPGTGASYEQYF,0,7,1,7
TRBV20-1,TRBJ2-7,CSARVPGGSSYEQYF,0,7,1,7
TRBV20-1,TRBJ2-7,CSARGASGRTYEQYF,0,7,1,7
TRBV20-1,TRBJ1-6,CSARDLDRVGSPLHF,0,7,1,7
TRBV20-1,TRBJ1-1,CSARDLEGPRTEAFF,0,7,1,7
TRBV20-1,TRBJ1-6,CSAKTGGFYNSPLHF,0,7,1,7
TRBV20-1,TRBJ2-1,CSAKSSGGPFNEQFF,0,7,1,7
TRBV20-1,TRBJ2-2,CSARTSGLDTGELFF,0,7,1,7
TRBV20-1,TRBJ2-4,CSANHRQGNKNIQYF,0,7,1,7
TRBV29-1,TRBJ2-3,CSVGRGQNPTDTQYF,0,7,1,7
TRBV13,TRBJ2-7,RASSLGVAGVYEQYF,0,7,1,7
TRBV10-3,TRBJ2-5,CAISSGLAGGSQYF,0,7,1,7
TRBV7-6,TRBJ2-1,CATGTGGVYNEQFF,0,7,1,7
TRBV19,TRBJ2-5,CASTSSGWGETQYF,0,7,1,7
TRBV19,TRBJ1-5,CASTPGQFAQPQHF,0,7,1,7
TRBV19,TRBJ2-3,CASTKGALTDTQYF,0,7,1,7
TRBV18,TRBJ2-7,CASSRLAADYEQYF,0,7,1,7
TRBV18,TRBJ2-7,CASSLQGEIYEQYF,0,7,1,7
TRBV2,TRBJ2-1,CASIPGLDRGEQFF,0,7,1,7
TRBV2,TRBJ1-2,CASTRSISDYGYTF,0,7,1,7
TRBV6-2/3/5/6,TRBJ1-1,CASSFADMNTEAFF,0,7,1,7
TRBV12-3/4,TRBJ1-4,CASSLTGEREKLFF,0,7,1,7
TRBV12-3/4,TRBJ1-6,CASSLQAGDSPLHF,0,7,1,7
TRBV27,TRBJ2-7,CASSLAGGAYKQYF,0,7,1,7
TRBV12-3/4,TRBJ1-5,CASSLGTDNQPQHF,0,7,1,7
TRBV12-3/4,TRBJ1-1,CASSLNSLNTEAFF,0,7,1,7
TRBV6-2/3/5/6,TRBJ2-7,CASSSTGFSYEQYF,0,7,1,7
TRBV6-2/3/5/6,TRBJ2-1,CASSYSSYYNEQFF,0,7,1,7
TRBV5-4,TRBJ2-7,CASSPGTAPREQYF,0,7,1,7
TRBV4-2,TRBJ2-7,CASSHTGQSYEQYF,0,7,1,7
TRBV6-1,TRBJ2-1,CASSVGRGLNEQFF,0,7,1,7
TRBV25-1,TRBJ1-5,CASSAGGQGQPQHF,0,7,1,7
TRBV6-1,TRBJ2-2,CASSEKRNTGELFF,0,7,1,7
TRBV6-1,TRBJ2-5,CASSEQGNAETQYF,0,7,1,7
TRBV2,TRBJ2-7,CASSETGTAYEQYF,0,7,1,7
TRBV7-2,TRBJ2-5,CASSFKREVETQYF,0,7,1,7
TRBV5-6,TRBJ2-7,CASSLWGTSYEQYF,0,7,1,7
TRBV11-1,TRBJ2-3,CASSLGESTDTQYF,0,7,1,7
TRBV7-8,TRBJ1-5,CASSLSQGNQPQHF,0,7,1,7
TRBV7-2,TRBJ2-7,CASSLVEGAYEQYF,0,7,1,7
TRBV7-8,TRBJ2-1,CASSLASSYNEQFF,0,7,1,7
TRBV7-9,TRBJ2-7,CASSLAGSSYEQYF,0,10,1,10
TRBV7-9,TRBJ2-7,CASSLGTPFFEQYF,0,7,1,7
TRBV7-2,TRBJ2-7,CASSLDRGHYEQYF,0,7,1,7
TRBV5-4,TRBJ1-2,CASSSGQSLYGYTF,0,7,1,7
TRBV5-4,TRBJ2-7,CASSSGTGPYEQYF,0,7,1,7
TRBV11-2,TRBJ1-3,CASSSGAPPKAIYF,0,7,1,7
TRBV7-2,TRBJ2-3,CASSLGLPSDTQYF,0,7,1,7
TRBV7-8,TRBJ2-1,CASSLLLADNEQFF,0,7,1,7
TRBV5-4,TRBJ2-3,CASSPGAEADTQYF,0,7,1,7
TRBV12-3/4,TRBJ2-7,CASSPDRALYEQYF,0,7,1,7
TRBV2,TRBJ2-5,CASSPTRVIETQYF,0,7,1,7
TRBV7-9,TRBJ1-1,CASSPRQGATEAFF,0,7,1,7
TRBV7-6,TRBJ1-4,CASSRGQGGEKLFF,0,7,1,7
TRBV12-3/4,TRBJ1-1,CASSAQPGQGTVDF,0,7,1,7
TRBV6-1,TRBJ2-7,CASSDRWSSYEQYF,0,7,1,7
TRBV7-2,TRBJ2-7,CASSMGQPALEQYF,0,7,1,7
TRBV13,TRBJ2-7,CASSTSGKSYEQYF,0,7,1,7
TRBV13,TRBJ1-6,CASSTGRINSPLHF,0,7,1,7
TRBV7-6,TRBJ1-1,CASSKGAGATEAFF,0,7,1,7
TRBV2,TRBJ1-1,CASRLRGSNTEAFF,0,7,1,7
TRBV6-2/3/5/6,TRBJ2-1,CASRQALGDNEQFF,0,7,1,7
TRBV5-1,TRBJ1-1,CASSSDRLNTEAFF,0,7,1,7
TRBV4-3,TRBJ1-5,CASSQVAGNQPQHF,0,7,1,7
TRBV4-3,TRBJ2-2,CASSQDWATGELFF,0,7,1,7
TRBV5-1,TRBJ1-1,CASNLVGGDPEAFF,0,7,1,7
TRBV20-1,TRBJ2-1,CSARERGDYNEQFF,0,7,1,7
TRBV20-1,TRBJ1-6,CSARDLLVGSPLHF,0,7,1,7
TRBV20-1,TRBJ2-7,CSARDRGVFYEQYF,0,7,1,7
TRBV29-1,TRBJ2-3,CSVEAIVVADTQYF,0,7,1,7
TRBV29-1,TRBJ2-3,CSASTPTGSDTQYF,0,7,1,7
TRBV11-2,TRBJ2-1,RASTPNRAANEQFF,0,7,1,7
TRBV12-5,TRBJ1-1,CASPLGVNTEAFF,0,7,1,7
TRBV30,TRBJ1-1,CAWSATENTEAFF,0,7,1,7
TRBV19,TRBJ2-5,CATSSSRQETQYF,0,7,1,7
TRBV5-4,TRBJ1-3,CATSLDIGNTIYF,0,7,1,7
TRBV19,TRBJ1-5,CASRSSYGQPQHF,0,7,1,7
TRBV19,TRBJ1-2,CASSIDISYGYTF,0,7,1,7
TRBV18,TRBJ1-1,CASSPNRDTEAFF,0,7,1,7
TRBV7-2,TRBJ2-5,CASSGGFQETQYF,0,7,1,7
TRBV5-5,TRBJ1-2,CASTWEATSGYTF,0,7,1,7
TRBV12-3/4,TRBJ2-7,CASSFWGLYEQYF,0,7,1,7
TRBV6-2/3/5/6,TRBJ1-6,CASSFAAGSPLHF,0,7,1,7
TRBV12-3/4,TRBJ1-2,CASSSRTGIGYTF,0,7,1,7
TRBV27,TRBJ2-5,CASSSTLTGAPDF,0,7,1,7
TRBV7-2,TRBJ1-1,CASSSHVNTEAFF,0,7,1,7
TRBV6-2/3/5/6,TRBJ2-7,CASSYGGTYEQYF,0,7,1,7
TRBV5-4,TRBJ2-3,CASSPTSTDTQYF,0,7,1,7
TRBV27,TRBJ1-1,CASSGQGMSEAFF,0,7,1,7
TRBV2,TRBJ1-5,CASSNRGDQPQHF,0,7,1,7
TRBV7-2,TRBJ2-7,CASSFGTTYEQYF,0,7,1,7
TRBV5-5,TRBJ2-3,CASSLVGPYTQYF,0,7,1,7
TRBV7-2,TRBJ1-2,CASSLEAGASYTF,0,7,1,7
TRBV5-5,TRBJ2-5,CASSWAAEETQYF,0,9,1,9
TRBV12-3/4,TRBJ1-1,CASSWDRTPEAFF,0,7,1,7
TRBV5-4,TRBJ1-1,CASSPQGNTEAFF,0,7,1,7
TRBV7-9,TRBJ2-1,CASSPVGGGGQFF,0,7,1,7
TRBV6-2/3/5/6,TRBJ2-5,CASSPTSVETQYF,0,11,1,11
TRBV7-9,TRBJ2-7,CASSPTSVYEQYF,0,7,1,7
TRBV6-2/3/5/6,TRBJ2-1,CASSPLAENEQFF,0,7,1,7
TRBV3-1,TRBJ2-7,CASSQGTSYEQYF,0,7,1,7
TRBV12-3/4,TRBJ1-2,CASSQQGNYGYTF,0,7,1,7
TRBV3-1,TRBJ2-5,CASSQGRGAAQYF,0,7,1,7
TRBV14,TRBJ2-3,CASSQDLEDTQYF,0,7,1,7
TRBV3-1,TRBJ1-5,CASSQKDGQPQHF,0,7,1,7
TRBV7-9,TRBJ1-2,CASSIKEGGGYTF,0,7,1,7
TRBV6-4,TRBJ1-1,CASRDGINTEAFF,0,7,1,7
TRBV2,TRBJ1-1,CASRNGQGQLPFF,0,7,1,7
TRBV5-1,TRBJ1-5,CACSLGGNQPQHF,0,7,1,7
TRBV5-1,TRBJ2-1,CASSLEGFNEQFF,0,7,1,7
TRBV20-1,TRBJ2-7,CSARPAPGGEQYF,0,7,1,7
TRBV20-1,TRBJ2-7,CSARSGGGVEQYF,0,7,1,7
TRBV20-1,TRBJ1-5,CSARPPGNQPQHF,0,7,1,7
TRBV20-1,TRBJ2-7,CSALAGATYEQYF,0,7,1,7
TRBV20-1,TRBJ1-6,CSAEGSPNSPLHF,0,7,1,7
TRBV29-1,TRBJ2-7,CSVVQPSSYEQYF,0,7,1,7
TRBV29-1,TRBJ2-3,CSVVGEGLDTQYF,0,7,1,7
TRBV29-1,TRBJ2-1,CSVGGEGGNEQFF,0,7,1,7
TRBV29-1,TRBJ2-7,CSVERASGHEQYF,0,7,1,7
TRBV29-1,TRBJ2-2,CSVERGDTGELFF,0,7,1,7
TRBV29-1,TRBJ2-1,CSVPGLAGNEQFF,0,7,1,7
TRBV29-1,TRBJ2-3,CSAPGASTDAQYF,0,7,1,7
TRBV9,TRBJ2-2,SASSVGGSGELFF,0,7,1,7
TRBV30,TRBJ1-3,CASHRGENTIYF,0,7,1,7
TRBV30,TRBJ2-1,CACQKVYNEQFF,0,7,1,7
TRBV30,TRBJ1-5,CAWSVYKDSPHF,0,7,1,7
TRBV7-9,TRBJ2-7,CATSRGSYEQYF,0,7,1,7
TRBV19,TRBJ2-3,CASSPLGGTQYF,0,7,1,7
TRBV19,TRBJ1-4,CASSRGQEKLFF,0,7,1,7
TRBV7-2,TRBJ2-1,CASTYGPSEQFF,0,7,1,7
TRBV7-9,TRBJ1-1,CASTRMSSEAFF,0,7,1,7
TRBV7-2,TRBJ1-5,CASSVTTGPQHF,0,7,1,7
TRBV7-9,TRBJ1-2,CASSGGNYGYTF,0,7,1,7
TRBV2,TRBJ1-2,CASSGTASGYTF,0,7,1,7
TRBV5-6,TRBJ1-1,CASSLGGTEAFF,0,7,1,7
TRBV13,TRBJ2-1,CASSLGADEQFF,0,7,1,7
TRBV12-3/4,TRBJ2-7,CASSLHEYEQYF,0,7,1,7
TRBV12-3/4,TRBJ1-2,CASSLQGPGYTF,0,7,1,7
TRBV7-2,TRBJ2-7,CASSPSRREQYF,0,7,1,7
TRBV9,TRBJ2-3,CASSPSGDTQYF,0,7,1,7
TRBV6-2/3/5/6,TRBJ2-7,CASSHPISEQYF,0,7,1,7
TRBV14,TRBJ2-7,CASSQGRYEQYF,0,7,1,7
TRBV6-4,TRBJ2-7,CASNDRGYEQYF,0,7,1,7
TRBV19,TRBJ2-1,CAAGAKYNEQFF,0,7,1,7
TRBV20-1,TRBJ2-1,CSQPGVRDEQFF,0,7,1,7
TRBV20-1,TRBJ2-1,CSAFGEGHEQFF,0,7,1,7
TRBV20-1,TRBJ2-1,CSASGVDNEQFF,0,7,1,7
TRBV20-1,TRBJ2-7,CSALRQDYEQCF,0,7,1,7
TRBV29-1,TRBJ1-1,CSGSGQATEAFF,0,7,1,7
TRBV29-1,TRBJ1-2,CSVAIGSYGYTF,0,7,1,7
TRBV29-1,TRBJ1-2,CSVDRGNYGYTF,0,7,1,7
TRBV7-7,TRBJ1-2,RASSSSGPGYTF,0,7,1,7
TRBV19,TRBJ1-1,CAGSPGAEAFF,0,7,1,7
TRBV15,TRBJ2-1,CATSRVNEQFF,0,7,1,7
TRBV6-2/3/5/6,TRBJ2-7,CASSFGYEQYF,0,7,1,7
TRBV5-6,TRBJ2-5,CASSSTRTQYF,0,7,1,7
TRBV6-2/3/5/6,TRBJ1-1,CASSRGAEAFF,0,7,1,7
TRBV3-1,TRBJ2-3,CASSQGGNKYF,0,7,1,7
TRBV2,TRBJ2-1,CASREGDEQFF,0,7,1,7
TRBV19,TRBJ1-1,CASMRTEAFF,0,7,1,7
TRBV12-3/4,TRBJ1-2,CASGLNYYTF,0,7,1,7
TRBV4-3,TRBJ2-1,CAWGGRLQFF,0,7,1,7
TRBV29-1,TRBJ2-1,CSVRDNEQFF,0,7,1,7
TRBV2,TRBJ2-3,CASTDTQYF,0,7,1,7
TRBV29-1,TRBJ1-1,CSVLAFF,0,7,1,7
TRBV7-9,TRBJ2-3,CASSFLAAGGDTQYF,0,6,1,6
TRBV12-3/4,TRBJ1-5,CASSLFGPWPQHF,0,6,1,6
TRBV7-3,TRBJ2-3,CASSPGLAGGAQYF,0,6,1,6
TRBV19,TRBJ1-1,CASRRREGYPDTGAFF,0,6,1,6
TRBV6-2/3/5/6,TRBJ2-2,CASRTLDSGELFF,0,6,1,6
TRBV19,TRBJ2-1,CASSGRGVYSSGEAIRLYNEQFF,0,6,1,6
TRBV7-2,TRBJ1-2,CASSLAPRGTGLLFNYGYTF,0,6,1,6
TRBV7-9,TRBJ2-3,CASSLTIFRDRATSTDTQYF,0,6,1,6
TRBV11-2,TRBJ2-7,CASSLFYPQASGRSSYEQYF,0,6,1,6
TRBV12-5,TRBJ2-6,CASGLGSGTESSGANVLTF,0,6,1,6
TRBV5-1,TRBJ2-1,CATDGSGGPNQSPCNEQFF,0,6,1,6
TRBV20-1,TRBJ2-3,CSARLVSGSVVGPTDTQYF,0,6,1,6
TRBV28,TRBJ1-3,SASSSPGDRGFYSGNTIYF,0,6,1,6
TRBV12-5,TRBJ1-1,CASGLVRTAFRENTEAFF,0,6,1,6
TRBV10-3,TRBJ2-5,CAISESRLAGVYQETQYF,0,6,1,6
TRBV19,TRBJ2-2,CASSIARLAGGRTGELFF,0,6,1,6
TRBV19,TRBJ1-5,CASSSQGQTQYSNQPQHF,0,6,1,6
TRBV18,TRBJ2-1,CASSPRTATSGKGDEQFF,0,6,1,6
TRBV12-3/4,TRBJ2-1,CASSSETSGRATYNEQFF,0,6,1,6
TRBV6-2/3/5/6,TRBJ1-1,CASSLLTGTGSSNTEAFF,0,6,1,6
TRBV7-9,TRBJ1-2,CASSFSGAPGTENYGYTF,0,6,1,6
TRBV11-2,TRBJ1-4,CASSLYSLRYRGLEKLFF,0,6,1,6
TRBV7-9,TRBJ1-5,CASSLPWTGRGDNQPQHF,0,6,1,6
TRBV7-2,TRBJ2-3,CASSSWTSGVPRGDTQYF,0,6,1,6
TRBV11-2,TRBJ2-1,CASSPRPPGLAGRDEQFF,0,6,1,6
TRBV3-1,TRBJ1-4,CASSHRTGEVATNEKLFF,0,6,1,6
TRBV3-1,TRBJ1-1,CASSQVPRPGQLNTEAFF,0,6,1,6
TRBV3-1,TRBJ2-1,CASSQEGTSGLSIHEQFF,0,6,1,6
TRBV27,TRBJ2-1,CASSILGNSGPAYNEQFF,0,6,1,6
TRBV12-3/4,TRBJ1-4,CASRTRGQVYATNEKLFF,0,6,1,6
TRBV5-1,TRBJ2-3,CASSLGVRAGGFGDTQYF,0,6,1,6
TRBV4-1,TRBJ2-2,CASSLLGNGGRNTGELFF,0,6,1,6
TRBV4-1,TRBJ2-2,CASSQGGVLAGLSGELFF,0,6,1,6
TRBV20-1,TRBJ1-5,CSASVEMEMRNSNQPQHF,0,6,1,6
TRBV12-5,TRBJ1-1,CASGLKYRGLRVAEAFF,0,6,1,6
TRBV15,TRBJ1-2,CATSRDKIPLRYYGYTF,0,6,1,6
TRBV19,TRBJ2-1,CASSIGDRPNRYNEQFF,0,6,1,6
TRBV6-2/3/5/6,TRBJ2-7,CASSFEHYRGRNYEQYF,0,6,1,6
TRBV6-2/3/5/6,TRBJ2-7,CASSFSGSGRGSYEQYF,0,6,1,6
TRBV6-2/3/5/6,TRBJ1-1,CASSFHAGANWPTEASF,0,6,1,6
TRBV12-3/4,TRBJ2-2,CASSLGTSGRATGELFF,0,6,1,6
TRBV6-2/3/5/6,TRBJ2-3,CASSYPASGTSTDTQYF,0,6,1,6
TRBV2,TRBJ2-3,CASSVRLPRAGTDTQYF,0,6,1,6
TRBV7-6,TRBJ1-3,CASSFGFEGSSGNTIYF,0,6,1,6
TRBV13,TRBJ2-5,CASSLYSGNRGQETQYF,0,6,1,6
TRBV5-6,TRBJ2-6,CASSSGTGVGWANVLTF,0,6,1,6
TRBV3-1,TRBJ2-1,CASSLGLDSGPIGEQFF,0,6,1,6
TRBV7-9,TRBJ2-7,CASSLNGGPTSAYEQYF,0,6,1,6
TRBV7-2,TRBJ2-2,CASSPIAQGALGGELFF,0,6,1,6
TRBV12-3/4,TRBJ2-7,CASSRGLAGGHSYEQYF,0,6,1,6
TRBV3-1,TRBJ2-7,CASSAPKIRRAPYEQYF,0,6,1,6
TRBV4-1,TRBJ2-5,CASSHPGGQGGRETQYF,0,6,1,6
TRBV5-1,TRBJ1-6,CASSINREAVYNSPLHF,0,6,1,6
TRBV20-1,TRBJ2-4,CSAPARLGLGDKNIQYF,0,6,1,6
TRBV20-1,TRBJ1-4,CSAEGGGAPATNEKLFF,0,10,1,10
TRBV20-1,TRBJ2-7,CSARPFRAGASTYEQYF,0,6,1,6
TRBV20-1,TRBJ1-2,CSARDPRTGWYTDGYTF,0,6,1,6
TRBV29-1,TRBJ2-1,CSALTLPGLAGPNEQFF,0,6,1,6
TRBV10-3,TRBJ2-3,CAISAPPGQGTDTQYF,0,6,1,6
TRBV19,TRBJ2-1,CASKRNAARPYNEQFF,0,6,1,6
TRBV18,TRBJ1-4,CASSPYEGAMSEKLFF,0,6,1,6
TRBV18,TRBJ2-3,CASSPPLRVPTDTQYF,0,6,1,6
TRBV7-9,TRBJ2-1,CASILGGTGGRNEQFF,0,6,1,6
TRBV6-4,TRBJ1-1,CASTKLRIRQRTEAFF,0,6,1,6
TRBV12-3/4,TRBJ1-2,CASSFGTGGVRGGYTF,0,6,1,6
TRBV27,TRBJ2-1,CASSLFPAGYHNEQFF,0,6,1,6
TRBV27,TRBJ2-5,CASSLFWGQRGETQYF,0,6,1,6
TRBV12-3/4,TRBJ1-5,CASSLRSPSLGQPQHF,0,6,1,6
TRBV6-2/3/5/6,TRBJ1-4,CASSSTTGPGNEKLFF,0,6,1,6
TRBV6-2/3/5/6,TRBJ1-3,CASSSRVPSSGNTIYF,0,6,1,6
TRBV6-2/3/5/6,TRBJ1-2,CASSSGRPTFSHGYTF,0,6,1,6
TRBV6-2/3/5/6,TRBJ2-7,CASSYLSGGSSYEQYF,0,6,1,6
TRBV3-1,TRBJ2-3,CASSQPLAGDTDTQYF,0,6,1,6
TRBV6-1,TRBJ1-5,CASSGTVVFQYQPQHF,0,6,1,6
TRBV2,TRBJ1-2,CASSDSGSRLYYGYTF,0,6,1,6
TRBV6-4,TRBJ2-3,CASSDIAGGPTDTQYF,0,6,1,6
TRBV2,TRBJ2-5,CASSERSGGPLETQYF,0,6,1,6
TRBV6-1,TRBJ1-1,CASSETSGALNTEAFF,0,6,1,6
TRBV7-2,TRBJ2-3,CASSFLAGVGTDTQYF,0,6,1,6
TRBV13,TRBJ2-5,CASSFRQGAPSETQYF,0,6,1,6
TRBV5-4,TRBJ2-1,CASSLSTVRSYNEQFF,0,6,1,6
TRBV7-6,TRBJ1-4,CASSLASGTGEEKLFF,0,6,1,6
TRBV11-2,TRBJ1-4,CASSLKASTAKEKLFF,0,6,1,6
TRBV5-6,TRBJ2-3,CASSSRNEWGTDTQYF,0,6,1,6
TRBV7-9,TRBJ2-1,CASSWGLAGLYNEQFF,0,6,1,6
TRBV5-6,TRBJ2-3,CASSLRLDLLTDTQYF,0,6,1,6
TRBV11-1,TRBJ1-2,CASSPDPLTGGEGYTF,0,6,1,6
TRBV6-4,TRBJ2-5,CASSPAGGLGGETQYF,0,6,1,6
TRBV5-4,TRBJ2-7,CASSPKKTHDPYEQYF,0,6,1,6
TRBV3-1,TRBJ1-6,CASSREPGSTNSPLHF,0,6,1,6
TRBV7-9,TRBJ1-4,CASSRLAARANEKLFF,0,6,1,6
TRBV3-1,TRBJ1-4,CASSHQGTSTNEKLFF,0,6,1,6
TRBV4-2,TRBJ2-1,CASSQERTSGGDEQFF,0,6,1,6
TRBV3-1,TRBJ2-7,CASSQVFGATSYEQYF,0,6,1,6
TRBV3-1,TRBJ2-1,CASSQDGGLQYNEQFF,0,6,1,6
TRBV3-1,TRBJ2-1,CASSQDSALSYNEQFF,0,6,1,6
TRBV14,TRBJ1-5,CASSQDTGVSNQPQHF,0,6,1,6
TRBV4-2,TRBJ2-4,CASSQELAGGSNIQYF,0,6,1,6
TRBV14,TRBJ2-3,CASSQERELAGDTQYF,0,6,1,6
TRBV7-9,TRBJ2-7,CASSATRSPVGHGWYF,0,6,1,6
TRBV2,TRBJ2-5,CASNAPSSGGLETQYF,0,6,1,6
TRBV5-1,TRBJ2-3,CASSGTGAFPTDTQYF,0,6,1,6
TRBV5-1,TRBJ2-2,CASSLAIQGGTGELFF,0,6,1,6
TRBV5-1,TRBJ2-3,CASSLTSGGPGDTQYF,0,6,1,6
TRBV5-1,TRBJ2-6,CASSLTTSARANVLTF,0,6,1,6
TRBV4-3,TRBJ1-6,CASSQDRVVGNSPLHF,0,6,1,6
TRBV4-3,TRBJ2-3,CASSQEPRPSTDTQYF,0,6,1,6
TRBV4-1,TRBJ2-1,CASSQERGQSYNEQFF,0,6,1,6
TRBV20-1,TRBJ2-2,CSASRSGGPFTGELFF,0,6,1,6
TRBV20-1,TRBJ2-5,CSASPLQEGYQETQYF,0,6,1,6
TRBV20-1,TRBJ1-5,CSARPRIRYSNQPQHF,0,6,1,6
TRBV20-1,TRBJ2-2,CSARDLSDPNTGELFF,0,6,1,6
TRBV20-1,TRBJ2-3,CSAPPDGSPSTDTQYF,0,6,1,6
TRBV20-1,TRBJ2-1,CSAVTGTSGYYNEQFF,0,6,1,6
TRBV29-1,TRBJ1-2,CSVPNSWGTGIYGYTF,0,6,1,6
TRBV29-1,TRBJ2-1,CSVDLRTPSPFNEQFF,0,6,1,6
TRBV29-1,TRBJ1-1,SSVGGLRIAEGTEAFF,0,6,1,6
TRBV7-9,TRBJ2-3,CSSSFSGSKADTQYF,0,6,1,6
TRBV7-3,TRBJ2-5,CPSSHTIGQGETQYF,0,6,1,6
TRBV30,TRBJ2-3,CAWSVLGIGTDTQYF,0,6,1,6
TRBV10-3,TRBJ1-2,CAIRGTDLDNYGYTF,0,6,1,6
TRBV19,TRBJ1-2,CASTGGVDRVNGYTF,0,6,1,6
TRBV19,TRBJ1-2,CASSSDMDREYGYTF,0,6,1,6
TRBV19,TRBJ2-1,CASSDRKGKDNEQFF,0,6,1,6
TRBV19,TRBJ2-1,CASSIGLAGGFEQFF,0,6,1,6
TRBV19,TRBJ2-7,CASSMSAGGSYEQYF,0,6,1,6
TRBV19,TRBJ2-1,CASSMVAAKENEQFF,0,6,1,6
TRBV19,TRBJ2-1,CASSMGGVTYNEQFF,0,6,1,6
TRBV19,TRBJ2-7,CASSIRLGKLGEQYF,0,6,1,6
TRBV19,TRBJ2-7,CASSKTSGRNYEQYF,0,6,1,6
TRBV19,TRBJ1-4,CASSLGRDYNEKLFF,0,6,1,6
TRBV19,TRBJ1-5,CASSQPGYPHQPQHF,0,6,1,6
TRBV18,TRBJ1-5,CASSPDGRSNQPQHF,0,6,1,6
TRBV18,TRBJ1-1,CASSPPGGVNTEAFF,0,6,1,6
TRBV18,TRBJ1-5,CASSPSHRDNQPQHF,0,6,1,6
TRBV18,TRBJ1-1,CASSPLDSLWTEAFF,0,6,1,6
TRBV2,TRBJ1-1,CASCPTGGQDTEAFF,0,6,1,6
TRBV12-3/4,TRBJ1-3,CASGGKVASGNTIYL,0,6,1,6
TRBV12-3/4,TRBJ2-3,CASIPGGADTDTQYF,0,6,1,6
TRBV6-2/3/5/6,TRBJ2-1,CASTPNRASGGLPFF,0,6,1,6
TRBV12-3/4,TRBJ1-2,CASSFGRGNNYGYTF,0,6,1,6
TRBV12-3/4,TRBJ2-3,CASSFTSGVTDTQYF,0,6,1,6
TRBV6-2/3/5/6,TRBJ2-1,CASSFRRGDNNEQFF,0,6,1,6
TRBV12-3/4,TRBJ1-6,CASSLNSGGHSPLHF,0,6,1,6
TRBV12-3/4,TRBJ1-4,CASSLLGATNEKLFF,0,6,1,6
TRBV28,TRBJ2-3,CASSLLDRRTDTQYF,0,6,1,6
TRBV6-2/3/5/6,TRBJ1-1,CASSLLGGRRTEAFF,0,6,1,6
TRBV12-3/4,TRBJ1-4,CASSLAGAGGEKLFF,0,6,1,6
TRBV27,TRBJ1-5,CASSLSSYSNQPQHF,0,6,1,6
TRBV12-3/4,TRBJ2-1,CASSSRGRGTDEQFF,0,6,1,6
TRBV6-2/3/5/6,TRBJ2-5,CASSYSRAERETQYF,0,6,1,6
TRBV12-3/4,TRBJ2-6,CASSYGLSGANVLTF,0,6,1,6
TRBV7-9,TRBJ2-3,CASSLPGQTTDTQYF,0,6,1,6
TRBV12-3/4,TRBJ2-7,CASSPTGTGDYEQYF,0,6,1,6
TRBV27,TRBJ1-1,CASSPTGGLNTEAFF,0,6,1,6
TRBV6-2/3/5/6,TRBJ2-1,CASSPRQGTYNEQFF,0,6,1,6
TRBV6-1,TRBJ1-4,CASSRKGPTNEKLFF,0,6,1,6
TRBV6-4,TRBJ1-2,CASSVSPLDVYGYTF,0,6,1,6
TRBV6-1,TRBJ2-3,CASSGPGGATDTQYF,0,6,1,6
TRBV6-1,TRBJ2-7,CASSGDRGFSYEQYF,0,6,1,6
TRBV6-1,TRBJ2-5,CASSGRTSAGETQYF,0,6,1,6
TRBV2,TRBJ2-1,CASSDAGSSYNEQFF,0,6,1,6
TRBV6-4,TRBJ2-3,CASSDRNPSTDTQYF,0,6,1,6
TRBV25-1,TRBJ1-2,CASSEFGGLGYGYTF,0,6,1,6
TRBV6-1,TRBJ2-7,CASSEVGAAGYEQYF,0,6,1,6
TRBV6-1,TRBJ2-3,CASSEVLDGTDTQYF,0,6,1,6
TRBV7-2,TRBJ2-7,CASSFLGQGFYEQYF,0,6,1,6
TRBV7-2,TRBJ1-6,CASSFEAEFNSPLHF,0,6,1,6
TRBV7-2,TRBJ1-1,CASSFRRLGNTEAFF,0,6,1,6
TRBV7-9,TRBJ2-4,CASSLPPRFGNIQYF,0,6,1,6
TRBV5-6,TRBJ2-1,CASSLASGPYNEQFF,0,6,1,6
TRBV5-4,TRBJ1-1,CASSLGLPKFAEAFF,0,6,1,6
TRBV5-4,TRBJ2-1,CASSLGGRGYNEQFF,0,6,1,6
TRBV7-2,TRBJ2-7,CASSLGTSGVYEQYF,0,6,1,6
TRBV5-4,TRBJ1-5,CASSLDQAPNQPQHF,0,6,1,6
TRBV5-5,TRBJ1-3,CASSLNTPRGNTIYF,0,6,1,6
TRBV7-3,TRBJ2-3,CASSLAGVVGDTQYF,0,6,1,6
TRBV7-2,TRBJ1-1,CASSLAMNMNTEAFF,0,6,1,6
TRBV7-2,TRBJ2-7,CASSLDSRQIYEQYF,0,6,1,6
TRBV7-2,TRBJ2-5,CASSLDSGGAETQYF,0,6,1,6
TRBV11-2,TRBJ2-3,CASSLRGTEADTQYF,0,6,1,6
TRBV7-2,TRBJ2-7,CASSSLQGPPYEQYF,0,6,1,6
TRBV11-3,TRBJ2-2,CASSSTGPNTGELFF,0,6,1,6
TRBV7-3,TRBJ2-1,CASSLAGAEYNEQFF,0,6,1,6
TRBV3-1,TRBJ1-1,CASSPGGGASTEAFF,0,6,1,6
TRBV7-3,TRBJ2-3,CASSPGLAGTDTQYF,0,6,1,6
TRBV2,TRBJ1-4,CASSPRRGTNEKLFF,0,6,1,6
TRBV4-2,TRBJ2-1,CASSHGTRGYNEQFF,0,6,1,6
TRBV6-4,TRBJ1-2,CASSHRDRGADGYTF,0,6,1,6
TRBV3-1,TRBJ2-7,CASSQVKGTAYEQYF,0,6,1,6
TRBV3-1,TRBJ1-1,CASSQAGQGRTEAFF,0,6,1,6
TRBV7-2,TRBJ2-4,CASSQDGTQLNIQYF,0,6,1,6
TRBV14,TRBJ1-6,CASSQEGGQNSPLHF,0,6,1,6
TRBV14,TRBJ2-7,CASSQRAWGAYEQYF,0,6,1,6
TRBV3-1,TRBJ2-3,CASSQAGAGGDTQYF,0,6,1,6
TRBV9,TRBJ2-3,CASSVVERATDTQYF,0,6,1,6
TRBV7-9,TRBJ1-2,CASSGDTGINYGYTF,0,6,1,6
TRBV7-9,TRBJ2-1,CASSTGTSGHNEQFF,0,6,1,6
TRBV7-6,TRBJ1-2,CASRLEGQFLNGYTF,0,6,1,6
TRBV12-3/4,TRBJ2-3,CASRPAGVSTDTQYF,0,6,1,6
TRBV12-3/4,TRBJ2-1,CASRGGTGGRWEQFL,0,6,1,6
TRBV7-9,TRBJ2-5,CASRLPLPTQETQYF,0,6,1,6
TRBV2,TRBJ2-1,CAREHTGAGGNEQFF,0,6,1,6
TRBV28,TRBJ2-7,CAATAAGGLSYEQYF,0,6,1,6
TRBV5-1,TRBJ1-4,CASSFSRRTNEKLFF,0,6,1,6
TRBV5-1,TRBJ2-3,CASSFDRASTDTQYF,0,6,1,6
TRBV5-1,TRBJ1-6,CASSLVTGRDSPLHF,0,6,1,6
TRBV5-1,TRBJ2-1,CASSLAPGSYNEQFF,0,6,1,6
TRBV5-1,TRBJ1-5,CASSSGTGLSQPQHF,0,6,1,6
TRBV4-3,TRBJ2-2,CASSLRGANTGELFF,0,6,1,6
TRBV5-8,TRBJ2-1,CASSKRTSDQDEQFF,0,6,1,6
TRBV10-2,TRBJ1-5,CASRSDRGVGQPQHF,0,6,1,6
TRBV4-1,TRBJ2-7,CASRQVEGSSYEQYF,0,6,1,6
TRBV20-1,TRBJ1-2,CSALEGPGGNYGYTF,0,6,1,6
TRBV20-1,TRBJ2-1,CSAPNSGSGYNEQFF,0,6,1,6
TRBV20-1,TRBJ2-7,CSAENREMGIYEQYF,0,6,1,6
TRBV20-1,TRBJ2-3,CSASLAHSSTDTQYF,0,6,1,6
TRBV20-1,TRBJ2-7,CSARGGKTATYEQYF,0,6,1,6
TRBV20-1,TRBJ2-5,CSARGIRGQQETQYF,0,6,1,6
TRBV20-1,TRBJ2-3,CSARGSSGSSDTQYF,0,6,1,6
TRBV20-1,TRBJ2-2,CSARDLAGDTGELFF,0,6,1,6
TRBV20-1,TRBJ1-1,CSARDLDKQNTEASF,0,6,1,6
TRBV29-1,TRBJ2-3,CSVESQRRNTDTQYF,0,6,1,6
TRBV29-1,TRBJ2-1,CSVEPLGVSYNEQFF,0,6,1,6
TRBV29-1,TRBJ2-5,CSVEGTRDRGQTQYF,0,6,1,6
TRBV29-1,TRBJ1-4,CSVEGTGGVNEKLFF,0,6,1,6
TRBV29-1,TRBJ1-4,CSVEDGDRGPYELFF,0,6,1,6
TRBV29-1,TRBJ1-5,CSVNEGEGADQPQHF,0,6,1,6
TRBV12-5,TRBJ1-4,CASGLGEGQGRLFF,0,6,1,6
TRBV12-5,TRBJ1-1,CASGYTVKNTEAFF,0,6,1,6
TRBV30,TRBJ2-3,CAWIPQGKRGRQYF,0,6,1,6
TRBV7-2,TRBJ2-5,CAVGEGASHETQYF,0,6,1,6
TRBV10-3,TRBJ1-1,CAIRLMAANTEAFF,0,6,1,6
TRBV10-3,TRBJ1-2,CAISRNPRRGGYTF,0,6,1,6
TRBV15,TRBJ2-7,CATSSRTGLDEQYF,0,6,1,6
TRBV15,TRBJ2-7,CATSREGTGREQYF,0,6,1,6
TRBV27,TRBJ1-2,CASSGTNTFYGYTF,0,6,1,6
TRBV19,TRBJ2-2,CASSYNRDTGELFF,0,6,1,6
TRBV19,TRBJ2-7,CASSLAVRSYEQYF,0,6,1,6
TRBV19,TRBJ2-3,CASSVLGAQDTQYF,0,6,1,6
TRBV19,TRBJ1-2,CASSIQRTVGGYTF,0,6,1,6
TRBV19,TRBJ1-1,CASSTQGGTTEAFF,0,6,1,6
TRBV19,TRBJ2-7,CASSHSGRAHEQYF,0,6,1,6
TRBV6-2/3/5/6,TRBJ1-4,CASSFWTENEKLFF,0,6,1,6
TRBV18,TRBJ1-5,CASSPRSGNQPQHF,0,6,1,6
TRBV12-3/4,TRBJ1-6,CASRPNGANSPLHF,0,6,1,6
TRBV13,TRBJ2-7,CASHAGTDAYEQYF,0,6,1,6
TRBV6-1,TRBJ2-4,CASGAFVAKNIQYF,0,6,1,6
TRBV6-2/3/5/6,TRBJ1-6,CASGPGQSSSPLHF,0,6,1,6
TRBV6-4,TRBJ2-3,CASGLAGVSDTQYF,0,6,1,6
TRBV6-1,TRBJ1-1,CASGSTGKNTEAFF,0,6,1,6
TRBV27,TRBJ2-5,CASTPGDNRETQYF,0,6,1,6
TRBV12-3/4,TRBJ2-1,CASSFSASGYEQFF,0,6,1,6
TRBV12-3/4,TRBJ1-5,CASSFSGNGQPQHF,0,6,1,6
TRBV27,TRBJ2-7,CASSFGTDIGEQYF,0,6,1,6
TRBV27,TRBJ2-1,CASSLTQSATEQFF,0,6,1,6
TRBV27,TRBJ1-2,CASSLRHRGGGYTF,0,6,1,6
TRBV2,TRBJ1-5,CASSLDRGNQPQHF,0,6,1,6
TRBV27,TRBJ1-1,CASSSLQGNTEAFF,0,6,1,6
TRBV6-2/3/5/6,TRBJ2-2,CASSSVRTTGELFF,0,6,1,6
TRBV6-2/3/5/6,TRBJ2-3,CASSWTRITDTQYF,0,6,1,6
TRBV12-3/4,TRBJ1-5,CASSPLDSNQPQHF,0,6,1,6
TRBV6-2/3/5/6,TRBJ2-7,CASSPGQGGYEQYF,0,6,1,6
TRBV6-2/3/5/6,TRBJ1-2,CASSPDRANYGYTF,0,6,1,6
TRBV2,TRBJ2-5,CASSEDRDIETQYF,0,6,1,6
TRBV2,TRBJ2-1,CASSEPLAGVLQFS,0,6,1,6
TRBV6-1,TRBJ2-7,CASSEGAYNDEQYF,0,6,1,6
TRBV2,TRBJ2-2,CASSENPWSGELFF,0,6,1,6
TRBV19,TRBJ2-5,CASSTTRGGETQYF,0,6,1,6
TRBV6-2/3/5/6,TRBJ1-6,CASSRDRGSSPLHF,0,6,1,6
TRBV7-3,TRBJ2-3,CASSFTGFTDTQYF,0,6,1,6
TRBV7-2,TRBJ1-2,CASSFRGVDYGYTF,0,6,1,6
TRBV7-3,TRBJ1-6,CASSFRVKGSPLHF,0,6,1,6
TRBV5-5,TRBJ1-5,CASSLGVMGQPQHF,0,6,1,6
TRBV7-2,TRBJ1-1,CASSLTGMNTEAFF,0,6,1,6
TRBV7-2,TRBJ1-1,CASSLYSRGIEAFF,0,6,1,6
TRBV7-9,TRBJ2-3,CASSLGISQDTQYF,0,6,1,6
TRBV7-9,TRBJ1-2,CASSLEGLSGGYTF,0,6,1,6
TRBV7-8,TRBJ2-1,CASSLSRDYNEQFF,0,6,1,6
TRBV12-3/4,TRBJ2-5,CASSSGSHQETQYF,0,6,1,6
TRBV7-9,TRBJ2-3,CASSSSGIRDTQYF,0,6,1,6
TRBV5-4,TRBJ1-1,CASSWRGLGTEAFF,0,6,1,6
TRBV11-2,TRBJ1-1,CASSWGKMNTEAFF,0,6,1,6
TRBV7-9,TRBJ2-1,CASSLSGSGNEQFF,0,6,1,6
TRBV3-1,TRBJ1-4,CASSLGRGREKLFF,0,6,1,6
TRBV11-3,TRBJ2-3,CASSPRLGEDTQYF,0,6,1,6
TRBV11-1,TRBJ2-2,CASSPSGNTGELFF,0,6,1,6
TRBV13,TRBJ1-4,CASSPRRINEKLFF,0,6,1,6
TRBV9,TRBJ2-5,CASSPRFEGETQYF,0,6,1,6
TRBV12-3/4,TRBJ1-4,CASSPRTGGEKLFF,0,6,1,6
TRBV27,TRBJ1-5,CASSPGTVVQPQHF,0,6,1,6
TRBV11-2,TRBJ2-5,CASSPTGGQETQYF,0,6,1,6
TRBV5-6,TRBJ1-1,CASSPRSLGTEAFF,0,6,1,6
TRBV12-3/4,TRBJ2-7,CASSRAGNSYEQYF,0,6,1,6
TRBV9,TRBJ1-5,CASSRGQGDQPQHF,0,6,1,6
TRBV5-6,TRBJ2-1,CASSHGLDALEQFF,0,6,1,6
TRBV7-9,TRBJ1-3,CASSQNLVGNTIYF,0,6,1,6
TRBV3-1,TRBJ1-4,CASSQDQDNEKLFF,0,6,1,6
TRBV3-1,TRBJ2-1,CASSQDFSYNEQFF,0,6,1,6
TRBV3-1,TRBJ2-5,CASSQDRGRETQYF,0,6,1,6
TRBV7-6,TRBJ1-5,CASSATGDTQPQHF,0,6,1,6
TRBV7-9,TRBJ2-7,CASSETGPAYEQYF,0,6,1,6
TRBV6-1,TRBJ2-1,CASSEAGVDNEQFF,0,6,1,6
TRBV5-6,TRBJ2-1,CASSTIYSYNEQFF,0,6,1,6
TRBV7-9,TRBJ2-7,CASSTGSLTYEQYF,0,6,1,6
TRBV12-3/4,TRBJ2-7,CASRSGGQGYEQYF,0,6,1,6
TRBV5-6,TRBJ2-5,CASRSPGQGETQYF,0,6,1,6
TRBV6-2/3/5/6,TRBJ2-7,CASRPGGALIEQYF,0,6,1,6
TRBV6-2/3/5/6,TRBJ2-7,CASKSTSSLYEQYF,0,6,1,6
TRBV12-3/4,TRBJ1-5,CTSSFTQGAQPQHF,0,6,1,6
TRBV5-1,TRBJ2-7,CASSLTSGGYEQYF,0,6,1,6
TRBV5-1,TRBJ1-1,CASSLRGDGTEAFF,0,6,1,6
TRBV4-3,TRBJ2-1,CASSLMGTYNEQFF,0,6,1,6
TRBV4-1,TRBJ1-1,CASSRRSMNTEAFF,0,6,1,6
TRBV4-1,TRBJ1-2,CASSQAPGAGGYTF,0,6,1,6
TRBV4-1,TRBJ2-5,CASSQEQGRETQYF,0,6,1,6
TRBV5-1,TRBJ1-1,CASSRSDRNTEAFF,0,6,1,6
TRBV20-1,TRBJ2-1,CSASGQGGRSEQFF,0,6,1,6
TRBV20-1,TRBJ1-5,CSASRGRGNQPQHF,0,6,1,6
TRBV20-1,TRBJ2-5,CSARVSGSLETQYF,0,6,1,6
TRBV20-1,TRBJ1-5,CSARAPGRDQPQHF,0,6,1,6
TRBV20-1,TRBJ2-1,CSARDSAGDHEQFF,0,6,1,6
TRBV20-1,TRBJ2-5,CSARDPGGRETQYF,0,6,1,6
TRBV20-1,TRBJ2-5,CSANVLAGEETQYF,0,6,1,6
TRBV20-1,TRBJ1-1,CSARWGGVNTEAFF,0,6,1,6
TRBV29-1,TRBJ2-3,CSAVRPASTDTQYF,0,6,1,6
TRBV20-1,TRBJ1-3,CSAEPGSSGNTIYF,0,6,1,6
TRBV29-1,TRBJ2-6,CSVVFTGGANVLTF,0,6,1,6
TRBV29-1,TRBJ1-4,CSVGQGATNEKLFF,0,6,1,6
TRBV29-1,TRBJ1-2,CSVGTGTENYGYTF,0,6,1,6
TRBV29-1,TRBJ2-3,CSVDFGSTTDTQYF,0,6,1,6
TRBV29-1,TRBJ2-7,CSVDLRGRGNEQYF,0,6,1,6
TRBV29-1,TRBJ1-2,CSVDLGGHIYGYTF,0,6,1,6
TRBV29-1,TRBJ2-3,CSVEVTGGSDTQYF,0,6,1,6
TRBV29-1,TRBJ2-3,CSVEGLESTDTQYF,0,6,1,6
TRBV29-1,TRBJ1-2,CSVEVGQPTYGYTF,0,6,1,6
TRBV29-1,TRBJ2-5,CSVETSGSYETQYF,0,6,1,6
TRBV29-1,TRBJ1-5,CSVGGQSSNQPQHF,0,6,1,6
TRBV29-1,TRBJ2-2,CSATGGLNTGELFF,0,6,1,6
TRBV29-1,TRBJ2-7,CSARTGSSSYEQYF,0,6,1,6
TRBV20-1,TRBJ1-5,CSGQGEIGNQPQHF,0,6,1,6
TRBV20-1,TRBJ2-1,RSARSSRGVNEQFF,0,6,1,6
TRBV18,TRBJ1-1,SASSPEGDSTEAFF,0,6,1,6
TRBV5-4,TRBJ1-1,CAASSLGHLEAFF,0,6,1,6
TRBV24-1,TRBJ1-2,CATSDSTGYGYTF,0,6,1,6
TRBV15,TRBJ1-6,CATSPGTLSPLHF,0,6,1,6
TRBV12-3/4,TRBJ2-1,CATRGGSGRGQFF,0,6,1,6
TRBV19,TRBJ1-4,CASSFGQGEKLFF,0,6,1,6
TRBV19,TRBJ1-1,CASSIALLELPFF,0,6,1,6
TRBV19,TRBJ1-1,CASSTTPGQRAFF,0,6,1,6
TRBV18,TRBJ2-1,CASSSQGAGEQFF,0,6,1,6
TRBV18,TRBJ2-5,CASSPPGQETQYF,0,6,1,6
TRBV5-6,TRBJ1-1,CASISWDTTEAFF,0,6,1,6
TRBV12-3/4,TRBJ2-4,CASTLGRGNIQYF,0,6,1,6
TRBV7-9,TRBJ1-1,CASTPAGDTEAFF,0,6,1,6
TRBV12-3/4,TRBJ1-6,CASTRGFNSPLHF,0,6,1,6
TRBV5-6,TRBJ1-2,CASTRDRLYSYTF,0,6,1,6
TRBV2,TRBJ2-7,CASTESGLYEQYF,0,6,1,6
TRBV12-3/4,TRBJ2-1,CASSFSGPNEQFF,0,6,1,6
TRBV6-2/3/5/6,TRBJ1-2,CASSFKANYGYTF,0,6,1,6
TRBV6-2/3/5/6,TRBJ2-3,CASSFRDRDTQYF,0,6,1,6
TRBV12-3/4,TRBJ1-5,CASSFRGWQPQHF,0,6,1,6
TRBV27,TRBJ2-5,CASSLSIKSTQYF,0,6,1,6
TRBV12-3/4,TRBJ2-2,CASSLLGGGELFF,0,6,1,6
TRBV12-3/4,TRBJ1-2,CASSLASAAGYTF,0,6,1,6
TRBV12-3/4,TRBJ2-7,CASSLGLPYEQYF,0,6,1,6
TRBV12-3/4,TRBJ1-1,CASSWTEFTEAFF,0,6,1,6
TRBV5-6,TRBJ1-5,CASSRGANQPQHF,0,6,1,6
TRBV6-4,TRBJ1-6,CASSVRENSPLHF,0,6,1,6
TRBV6-1,TRBJ2-3,CASSVSGGYTQYF,0,6,1,6
TRBV6-1,TRBJ1-1,CASSAGPRVSAFF,0,6,1,6
TRBV2,TRBJ2-5,CASSEGGVETQYF,0,6,1,6
TRBV25-1,TRBJ1-2,CASSEEWVYGYTF,0,6,1,6
TRBV6-2/3/5/6,TRBJ1-5,CASSRTGYQPQHF,0,6,1,6
TRBV5-4,TRBJ2-2,CASSLAPAGELFF,0,6,1,6
TRBV5-5,TRBJ2-7,CASSLGLGYEQYF,0,6,1,6
TRBV7-2,TRBJ2-7,CASSLASGYEQYF,0,6,1,6
TRBV7-2,TRBJ1-1,CASSLAGRSEAFF,0,6,1,6
TRBV7-2,TRBJ1-5,CASSLGVEKPQHF,0,6,1,6
TRBV6-2/3/5/6,TRBJ1-1,CASSLDPGVEAFF,0,6,1,6
TRBV7-2,TRBJ1-1,CASSLDRGRSAFF,0,6,1,6
TRBV7-3,TRBJ2-5,CASSSGHPDFQYF,0,6,1,6
TRBV5-4,TRBJ2-7,CASSPRDTYEQYF,0,6,1,6
TRBV4-2,TRBJ2-7,CASSPERTYEQYF,0,6,1,6
TRBV14,TRBJ2-1,CASSPQGMGEQFF,0,6,1,6
TRBV7-9,TRBJ1-5,CASSRTTNQPQHF,0,6,1,6
TRBV3-1,TRBJ2-7,CASSHAQAYEQYF,0,6,1,6
TRBV7-9,TRBJ1-1,CASSQGLRTEAFF,0,6,1,6
TRBV3-1,TRBJ1-1,CASSQVPQTEAFF,0,6,1,6
TRBV3-1,TRBJ1-1,CASSQGANTEAFF,0,6,1,6
TRBV7-9,TRBJ2-7,CASSVGTIDEQYF,0,6,1,6
TRBV9,TRBJ1-5,CASSGADSQPQHF,0,6,1,6
TRBV5-6,TRBJ2-7,CASSGGISYEQYF,0,6,1,6
TRBV12-3/4,TRBJ2-7,CASSRQYSYEQYF,0,6,1,6
TRBV6-4,TRBJ1-2,CASRLTGSDGYTF,0,6,1,6
TRBV2,TRBJ1-4,CASRGSSNEKLFF,0,6,1,6
TRBV28,TRBJ2-5,CASRGQGQETQYF,0,6,1,6
TRBV6-4,TRBJ2-5,CASRDRSRETQYF,0,6,1,6
TRBV6-2/3/5/6,TRBJ2-2,CASRPGGAGELFF,0,6,1,6
TRBV6-1,TRBJ2-3,CASREGPTDTQYF,0,6,1,6
TRBV6-1,TRBJ1-1,CASRERGSTEAFF,0,6,1,6
TRBV6-2/3/5/6,TRBJ1-2,CASNRSGHYGYTF,0,6,1,6
TRBV7-9,TRBJ1-1,CASKGRLNTEAFF,0,6,1,6
TRBV7-9,TRBJ1-6,CASKRSYNSPLHF,0,6,1,6
TRBV12-3/4,TRBJ2-5,CASKTSSQETQYF,0,6,1,6
TRBV10-2,TRBJ2-5,CASTAILQETQYF,0,6,1,6
TRBV5-1,TRBJ2-3,CASSSTGADTQYF,0,6,1,6
TRBV4-3,TRBJ2-1,CASSQDNYNEQFF,0,6,1,6
TRBV5-1,TRBJ1-2,CASSAGTENGYTF,0,6,1,6
TRBV20-1,TRBJ2-5,CSASSGGGETQYF,0,6,1,6
TRBV20-1,TRBJ2-4,CSASLPVGDIQYF,0,6,1,6
TRBV20-1,TRBJ2-4,CSARGGAKNIQYF,0,6,1,6
TRBV20-1,TRBJ2-1,CSARDTGGNEQFF,0,11,1,11
TRBV20-1,TRBJ1-2,CSARDSLNDGYTF,0,6,1,6
TRBV20-1,TRBJ2-7,CSAPPTGSIEQYF,0,6,1,6
TRBV20-1,TRBJ2-7,CSAPIKKPHEQYF,0,6,1,6
TRBV29-1,TRBJ2-3,CSVDRGGTDTQYF,0,6,1,6
TRBV29-1,TRBJ2-1,CSVEEGTLNEQFF,0,6,1,6
TRBV29-1,TRBJ2-1,CSVEDRVLSEQFF,0,6,1,6
TRBV29-1,TRBJ2-5,CSVIGTVRETQYF,0,6,1,6
TRBV29-1,TRBJ2-1,CSVKTSGRFEQFF,0,6,1,6
TRBV29-1,TRBJ1-1,CSVVGGLGTEAFF,0,6,1,6
TRBV29-1,TRBJ2-7,CSVVGQGAYEQYF,0,6,1,6
TRBV29-1,TRBJ2-7,CSVRNPSSYEQYF,0,6,1,6
TRBV29-1,TRBJ2-5,CSVKTSPQEAQYF,0,6,1,6
TRBV29-1,TRBJ2-1,CSVRLGPLNEQFF,0,6,1,6
TRBV30,TRBJ2-7,CAWGHETYEQYF,0,6,1,6
TRBV30,TRBJ2-5,CAWSGGWETQYF,0,6,1,6
TRBV19,TRBJ2-1,CASSIRYNEQFF,0,6,1,6
TRBV19,TRBJ2-5,CASSTSEETQYF,0,6,1,6
TRBV2,TRBJ2-7,CASGRQAGEQYF,0,6,1,6
TRBV6-2/3/5/6,TRBJ2-1,CASTFSLGEQFF,0,6,1,6
TRBV18,TRBJ2-1,CASTSGLDEQFF,0,6,1,6
TRBV2,TRBJ2-5,CASTTGRETQYF,0,6,1,6
TRBV6-2/3/5/6,TRBJ1-1,CASSFTGVEAFF,0,6,1,6
TRBV12-3/4,TRBJ2-7,CASSLVGTEQYF,0,6,1,6
TRBV5-5,TRBJ2-3,CASSLDADTQYF,0,6,1,6
TRBV7-2,TRBJ2-7,CASSFRSYEQYF,0,6,1,6
TRBV5-4,TRBJ2-3,CASSLSTDTQYF,0,9,1,9
TRBV7-9,TRBJ1-2,CASSLALSGYTF,0,6,1,6
TRBV7-9,TRBJ1-1,CASSLAGYGAFF,0,6,1,6
TRBV11-2,TRBJ2-2,CASSLDRGELFF,0,6,1,6
TRBV18,TRBJ1-4,CASSRGNEKLFF,0,10,1,10
TRBV3-1,TRBJ2-2,CASSRLGGELFF,0,6,1,6
TRBV7-2,TRBJ2-7,CASSRGPYEQYF,0,6,1,6
TRBV3-1,TRBJ2-1,CASSQARSEQFF,0,6,1,6
TRBV12-3/4,TRBJ1-1,CASRTGATEAFF,0,6,1,6
TRBV6-2/3/5/6,TRBJ2-7,CASRRGVYEQYF,0,6,1,6
TRBV5-1,TRBJ2-3,CASSFSTDTLYF,0,6,1,6
TRBV5-1,TRBJ2-7,CASSSTGNEQYF,0,6,1,6
TRBV20-1,TRBJ2-7,CSAERTGHEQYF,0,6,1,6
TRBV20-1,TRBJ2-3,CSASLHTDTQYF,0,6,1,6
TRBV20-1,TRBJ1-2,CSASPTGYGYTF,0,6,1,6
TRBV20-1,TRBJ1-1,CSASGTGVEAFF,0,6,1,6
TRBV20-1,TRBJ2-1,CSASGSRSEQFF,0,6,1,6
TRBV20-1,TRBJ2-7,CSARTDPYEQYF,0,6,1,6
TRBV29-1,TRBJ2-7,CSVAGNSYEQYF,0,6,1,6
TRBV29-1,TRBJ2-5,CSVERGGETQYF,0,6,1,6
TRBV29-1,TRBJ1-1,CSVEFGNTEAFF,0,6,1,6
TRBV29-1,TRBJ2-7,CSVELGTYEQYF,0,6,1,6
TRBV29-1,TRBJ2-3,CSVEWDLDTQYF,0,6,1,6
TRBV29-1,TRBJ2-1,CSVETRRNEQFF,0,6,1,6
TRBV29-1,TRBJ1-4,CSAAGGGEKLFF,0,6,1,6
TRBV29-1,TRBJ2-2,CSGLSRAGELFF,0,6,1,6
TRBV29-1,TRBJ1-2,CSDTTGGYGYTF,0,6,1,6
TRBV14,TRBJ1-1,CAIRGAGGTFF,0,6,1,6
TRBV14,TRBJ2-1,CASSVRSEQFF,0,6,1,6
TRBV12-3/4,TRBJ2-3,CASSSSDTQYF,0,6,1,6
TRBV6-1,TRBJ1-5,CASSGNQPQHF,0,6,1,6
TRBV12-3/4,TRBJ2-7,CASSTYYEQYF,0,6,1,6
TRBV6-2/3/5/6,TRBJ2-3,CASSSTDTQYF,0,6,1,6
TRBV5-4,TRBJ2-1,CASSLAYEQFF,0,6,1,6
TRBV12-3/4,TRBJ1-3,CASSPSDTIYF,0,6,1,6
TRBV20-1,TRBJ2-7,CSARASYEQYF,0,6,1,6
TRBV20-1,TRBJ2-3,CSARSKDTQYF,0,6,1,6
TRBV20-1,TRBJ2-1,CSARAGGGQFF,0,6,1,6
TRBV29-1,TRBJ2-7,CSVEDVHEQYF,0,6,1,6
TRBV29-1,TRBJ1-1,CSGSLGNRPLF,0,6,1,6
TRBV9,TRBJ2-1,CASSPNEQFF,0,6,1,6
TRBV29-1,TRBJ2-1,CSVDTRGEFF,0,6,1,6
TRBV20-1,TRBJ2-2,CREDTGELFF,0,6,1,6
TRBV29-1,TRBJ1-5,CTKRPQHF,0,6,1,6
TRBV12-5,TRBJ2-7,CASGLVLNRGHPYEQYF,0,6,1,6
TRBV4-3,TRBJ2-2,CASSQDLRLANTGELFF,0,6,1,6
TRBV10-3,TRBJ1-5,CAISEFGDRNQPQHF,0,6,1,6
TRBV7-2,TRBJ2-1,CASSFGPTMGNEQFF,0,6,1,6
TRBV7-2,TRBJ2-2,CASSLDGGVTGELFF,0,6,1,6
TRBV6-1,TRBJ1-5,CTSSKNRGRDQPQHF,0,6,1,6
TRBV4-3,TRBJ1-4,CASSQDYRGEKLFF,0,6,1,6
TRBV2,TRBJ1-6,CASSGTISSPLHF,0,6,1,6
TRBV29-1,TRBJ2-4,CSIRDYRNIQYF,0,6,1,6
TRBV19,TRBJ1-6,CASSSPDDHF,0,6,1,6
TRBV7-9,TRBJ1-5,FASSYGTGGLNQPQHF,0,6,1,6
TRBV15,TRBJ1-5,CATSVGPINQPQHF,0,6,1,6
TRBV6-2/3/5/6,TRBJ2-3,CASSNSGTSDTQYF,0,6,1,6
TRBV9,TRBJ1-1,CASSVGGVRTEAFL,0,6,1,6
TRBV4-2,TRBJ1-5,CASSRGQGNQPQHF,0,6,1,6
TRBV14,TRBJ2-5,CASSRDNGETQYF,0,6,1,6
TRBV5-4,TRBJ2-7,CASSKGTSGSIYEQYF,0,6,1,6
TRBV5-8,TRBJ2-5,CASSLGGGVEETQYF,0,6,1,6
TRBV25-1,TRBJ1-5,CAGDGAGGNQPQHF,0,6,1,6
TRBV5-5,TRBJ2-5,CASSLGTLEAQYF,0,6,1,6
TRBV20-1,TRBJ1-6,CSAIELPGTGPNNSPLHF,0,5,1,5
TRBV5-6,TRBJ2-3,CASSADRGRSTDTQYF,0,5,1,5
TRBV2,TRBJ1-5,CASSEWLDSNQPQHF,0,5,1,5
TRBV20-1,TRBJ2-3,CSADGEAGTLADTQYF,0,5,1,5
TRBV5-1,TRBJ1-2,CASKWADRGIYGYTF,0,5,1,5
TRBV7-2,TRBJ2-3,CASSLDHFGLASDRGTDTQYI,0,5,1,5
TRBV19,TRBJ1-5,CASSISPPGQGLGGNQPQHF,0,5,1,5
TRBV27,TRBJ2-1,CASSLPTGVTGTTNSNEQFF,0,5,1,5
TRBV6-2/3/5/6,TRBJ2-2,CASSYADRPVTGINTGELFF,0,5,1,5
TRBV30,TRBJ2-1,CALHPSGGSAAQGYNERFF,0,5,1,5
TRBV19,TRBJ1-1,CASSISFWRQTSLNTEAFF,0,5,1,5
TRBV19,TRBJ2-2,CASSIGGGPFQANTGELFF,0,5,1,5
TRBV6-2/3/5/6,TRBJ2-4,CASFDRVQDLPLAKNIQYF,0,5,1,5
TRBV12-3/4,TRBJ1-2,CASIEGPWGRGHEENGYTF,0,5,1,5
TRBV6-2/3/5/6,TRBJ2-6,CASSLDGPWSNSGANVLTF,0,5,1,5
TRBV11-2,TRBJ2-1,CASSLERTGTSGRWGEQFF,0,5,1,5
TRBV5-6,TRBJ2-3,CASSPTKFWLAGGTDTQYF,0,5,1,5
TRBV14,TRBJ2-7,CASSHWSGQGARSLYEQYF,0,5,1,5
TRBV5-1,TRBJ2-3,CASSYKWDGRDVRADTQYF,0,5,1,5
TRBV5-1,TRBJ2-1,CASSIGLAGLVKNYNEQFF,0,5,1,5
TRBV29-1,TRBJ2-1,CSVETRTAKRFYVNNEQFF,0,5,1,5
TRBV12-5,TRBJ1-1,CASGLVRDRGALNTEAFF,0,5,1,5
TRBV18,TRBJ2-1,CASSPVPPGLAGYGEQFF,0,5,1,5
TRBV6-2/3/5/6,TRBJ2-1,CASTLSVAGLPVYNEQFF,0,5,1,5
TRBV6-2/3/5/6,TRBJ2-1,CASSLSQVAGGPNNEQFF,0,5,1,5
TRBV6-2/3/5/6,TRBJ2-1,CASSYSERGTSSYNEQFF,0,5,1,5
TRBV6-2/3/5/6,TRBJ2-3,CASSYSPWTGHRTDTQYF,0,5,1,5
TRBV13,TRBJ1-2,CASSPPSVQRQPSYGYTF,0,5,1,5
TRBV7-2,TRBJ1-2,CASSLGGQANSFWDGYTF,0,5,1,5
TRBV7-2,TRBJ2-3,CASSLASLAGWSTDTQYF,0,5,1,5
TRBV11-1,TRBJ2-1,CASSLGGRQGFIYNEQFF,0,5,1,5
TRBV5-6,TRBJ2-2,CASSSHLMGQGINGELFF,0,5,1,5
TRBV5-5,TRBJ2-3,CASSPGTSGSWESDTQYF,0,5,1,5
TRBV12-3/4,TRBJ2-5,CASSRTIRRDTLKETQYF,0,5,1,5
TRBV6-2/3/5/6,TRBJ2-1,CASSHRGGSLLSYNEQFF,0,5,1,5
TRBV3-1,TRBJ2-1,CASSQGLAGGQTYNEQFF,0,5,1,5
TRBV6-2/3/5/6,TRBJ1-6,CASSAPDKTNSYNSPLHF,0,5,1,5
TRBV5-1,TRBJ2-1,CASSLASAGDPLINEQFF,0,5,1,5
TRBV4-3,TRBJ2-5,CASSQGLSREGLIETQYF,0,5,1,5
TRBV20-1,TRBJ2-7,CSASWTSGSLFPPYEQYF,0,5,1,5
TRBV20-1,TRBJ1-5,CSARGLGQGVSSNQPQHF,0,5,1,5
TRBV29-1,TRBJ2-1,CSGIGTSGGRNSYNEQFF,0,5,1,5
TRBV13,TRBJ2-7,SASSPSRPASGDSYEQYF,0,5,1,5
TRBV30,TRBJ1-2,CAWSAPDNSRRGYGYTF,0,5,1,5
TRBV15,TRBJ2-1,CATSRDIAGGNYNEQFF,0,5,1,5
TRBV19,TRBJ1-5,CASSSPGRDRGNQPQHF,0,5,1,5
TRBV19,TRBJ2-1,CASSIRPLAGGFNEQFF,0,5,1,5
TRBV19,TRBJ2-4,CASSQLAGEEAKNTQYF,0,5,1,5
TRBV6-2/3/5/6,TRBJ1-2,CASTFLTGQGTNYGYTF,0,5,1,5
TRBV28,TRBJ2-1,CASSFIVGTVEDDEQFF,0,5,1,5
TRBV6-2/3/5/6,TRBJ1-1,CASSFTLGMGGYTEAFF,0,5,1,5
TRBV12-3/4,TRBJ2-7,CASSLAIYSGRGYEQYF,0,5,1,5
TRBV6-4,TRBJ2-1,CASSGSTSGSSYNEQFF,0,5,1,5
TRBV2,TRBJ2-1,CASSGGLAGGNYNEQFF,0,5,1,5
TRBV6-1,TRBJ2-4,CASSEKWAIPAKNIQYF,0,5,1,5
TRBV6-2/3/5/6,TRBJ2-7,CASSTGASGTGIYEQYF,0,5,1,5
TRBV7-6,TRBJ2-2,CASSLGGLAGRTGELFF,0,5,1,5
TRBV7-2,TRBJ1-1,CASSSFDGTVGDTEAFF,0,5,1,5
TRBV5-4,TRBJ2-1,CASSSGLAGGSYNEQFF,0,5,1,5
TRBV11-1,TRBJ2-5,CASSLMFPGFGMETQYF,0,5,1,5
TRBV11-1,TRBJ2-1,CASSLGRALALGNEQFF,0,5,1,5
TRBV12-3/4,TRBJ1-4,CASSPSGGGNVGGKLFF,0,5,1,5
TRBV7-3,TRBJ2-2,CASSPHSSGSRTGELFF,0,5,1,5
TRBV5-6,TRBJ2-7,CASSPELDRDIPYEQYF,0,5,1,5
TRBV7-2,TRBJ2-5,CASSRPGLARDAETQYF,0,5,1,5
TRBV3-1,TRBJ2-1,CASSHDPRSYSYNEQFF,0,5,1,5
TRBV5-6,TRBJ2-7,CASSQVLVWGSSYEQYF,0,5,1,5
TRBV3-1,TRBJ1-5,CASSQGAGGQGNQPQHF,0,5,1,5
TRBV14,TRBJ2-7,CASSQDRGTRDFSEQYF,0,5,1,5
TRBV4-2,TRBJ1-2,CASSQDRTFGNNYGYTF,0,5,1,5
TRBV9,TRBJ2-5,CASSVAGPSGTQETQYF,0,5,1,5
TRBV7-9,TRBJ1-4,CASSNPTAGVGDEKLFF,0,5,1,5
TRBV2,TRBJ1-4,CASRATGTGGVDEKLFF,0,5,1,5
TRBV12-3/4,TRBJ2-6,CDKWKTSGPLRANVLTF,0,5,1,5
TRBV5-1,TRBJ2-5,CASSLIFGGSPFETQYF,0,5,1,5
TRBV4-3,TRBJ1-4,CASSRTPVGGMDEKLFF,0,5,1,5
TRBV4-1,TRBJ2-1,CASSQPGATGDRNEQFF,0,5,1,5
TRBV29-1,TRBJ1-4,CSVKEFPGEATNEKLFF,0,5,1,5
TRBV12-5,TRBJ2-1,CASGLGSGGSYNEQFF,0,5,1,5
TRBV30,TRBJ2-5,CAWTDKQPMRGETQYF,0,5,1,5
TRBV10-3,TRBJ1-3,CAISESTGGWRNTIYF,0,5,1,5
TRBV24-1,TRBJ2-3,CATSVGGVGSTDTQYF,0,5,1,5
TRBV24-1,TRBJ2-2,CATSGGTVRSPGEPFF,0,5,1,5
TRBV15,TRBJ2-2,CATSSRRGSNTGELFF,0,5,1,5
TRBV15,TRBJ2-1,CATSRGTGATNNEQFF,0,5,1,5
TRBV19,TRBJ2-4,CASTMTSGVAKNIQYF,0,5,1,5
TRBV19,TRBJ1-4,CASTSGTWATNEKLFF,0,5,1,5
TRBV19,TRBJ2-6,CASSLEGTSGANVLTF,0,5,1,5
TRBV19,TRBJ2-2,CASSITSGRATGELFF,0,5,1,5
TRBV19,TRBJ2-7,CASSMDSGSVAYEQYF,0,5,1,5
TRBV19,TRBJ1-1,CASSTPGEGMNTEAFF,0,5,1,5
TRBV19,TRBJ2-1,CASSTAAGLGNNGQFF,0,5,1,5
TRBV19,TRBJ1-2,CASSSKTDYYNYGYTF,0,5,1,5
TRBV19,TRBJ1-5,CASSGWGGSFNQPQHF,0,5,1,5
TRBV19,TRBJ2-3,CASNDQGASGTDSQYF,0,5,1,5
TRBV18,TRBJ1-4,CASSPRRGTTNEKLFF,0,5,1,5
TRBV18,TRBJ2-1,CASSPPGGVIYNEQFF,0,5,1,5
TRBV7-9,TRBJ1-2,CASGPPGSEANYGYTF,0,5,1,5
TRBV6-2/3/5/6,TRBJ1-5,CASSLPLQGTNQPQHF,0,5,1,5
TRBV27,TRBJ2-1,CASSLFLAGGPREQFF,0,5,1,5
TRBV6-2/3/5/6,TRBJ2-1,CASSLWRGGSGDEQFF,0,5,1,5
TRBV12-3/4,TRBJ2-5,CASSLAGLAVQETQYF,0,5,1,5
TRBV28,TRBJ2-5,CASSLGRGGISETQYF,0,5,1,5
TRBV12-3/4,TRBJ2-3,CASSSWTATSADTQYF,0,5,1,5
TRBV27,TRBJ1-1,CASSSGGGWANTEAFF,0,5,1,5
TRBV12-3/4,TRBJ1-1,CASSSGTGVWDTEAFF,0,5,1,5
TRBV12-3/4,TRBJ1-5,CASSWGLGRGNQPQHF,0,5,1,5
TRBV6-2/3/5/6,TRBJ2-4,CASSYSQDLAKNIQYF,0,5,1,5
TRBV6-2/3/5/6,TRBJ1-6,CASSYSTGGYNSPLHF,0,5,1,5
TRBV6-2/3/5/6,TRBJ2-3,CASSYPIWYSTDTQYF,0,5,1,5
TRBV6-2/3/5/6,TRBJ1-5,CASSYTRTGPNQPQHF,0,5,1,5
TRBV12-3/4,TRBJ1-5,CASSLTGTYGNQPQHF,0,5,1,5
TRBV6-1,TRBJ2-1,CASSQRTSGKDNEQFF,0,5,1,5
TRBV2,TRBJ2-7,CASSQKDRAITYEQYF,0,5,1,5
TRBV6-4,TRBJ2-5,CASSAPGLAGQETQYF,0,5,1,5
TRBV6-1,TRBJ2-3,CASSAQDYSVLDTQYS,0,5,1,5
TRBV6-1,TRBJ1-5,CASSERGAGSNQPQHF,0,5,1,5
TRBV6-2/3/5/6,TRBJ2-4,CASSTQDLLAKNIQYF,0,5,1,5
TRBV6-2/3/5/6,TRBJ1-2,CASSTGPPDRSYGYTF,0,5,1,5
TRBV7-2,TRBJ2-3,CASSFLLAGGQDTQYF,0,5,1,5
TRBV7-8,TRBJ2-3,CASSLAEAASSDTQYF,0,5,1,5
TRBV13,TRBJ2-7,CASSLGAAGGPYEQYF,0,5,1,5
TRBV12-3/4,TRBJ2-3,CASSLEGSGNTDTQYF,0,5,1,5
TRBV7-2,TRBJ1-5,CASSLISGESNQPQHF,0,5,1,5
TRBV11-2,TRBJ2-3,CASSLNLGGGYDTQYF,0,5,1,5
TRBV5-4,TRBJ2-1,CASSLKREVSYNEQFF,0,5,1,5
TRBV6-2/3/5/6,TRBJ1-5,CASSSPLGGPHQPQHF,0,5,1,5
TRBV7-2,TRBJ2-1,CASSSSRLAGNNEQFF,0,5,1,5
TRBV5-6,TRBJ1-2,CASSWGQSQSNYGYTF,0,5,1,5
TRBV7-9,TRBJ2-1,CASSWTSGFGDNEQFF,0,5,1,5
TRBV28,TRBJ2-1,CASSLGLAGPYNEQFF,0,5,1,5
TRBV3-1,TRBJ2-2,CASSLTARGYAGELFF,0,5,1,5
TRBV3-1,TRBJ2-5,CASSLGPGLAWETQYF,0,5,1,5
TRBV5-6,TRBJ1-6,CASSPGTGGWFSPLHF,0,5,1,5
TRBV11-1,TRBJ2-1,CASSPSTGRGYNEQFF,0,5,1,5
TRBV7-9,TRBJ2-1,CASSPPDRLSYNEQFF,0,5,1,5
TRBV7-2,TRBJ2-5,CASSPRRMAGIPTQYF,0,5,1,5
TRBV27,TRBJ1-4,CASSQLPGGLNEKLFF,0,5,1,5
TRBV3-1,TRBJ2-1,CASSQGLAGPNNEQFF,0,5,1,5
TRBV3-1,TRBJ1-1,CASSQGTSMMNTEAFF,0,5,1,5
TRBV3-1,TRBJ2-7,CASSQDRGTVFYEQYF,0,5,1,5
TRBV3-1,TRBJ1-2,CASSQDARTDSYGYTF,0,5,1,5
TRBV4-2,TRBJ2-1,CASSQTRPSVGNEQFF,0,5,1,5
TRBV7-9,TRBJ2-3,CASSAPRRGGPDTQYF,0,5,1,5
TRBV5-5,TRBJ2-4,CASSAPTGGGKDIQYF,0,5,1,5
TRBV9,TRBJ1-3,CASSADGTGKGNTIYF,0,5,1,5
TRBV7-9,TRBJ2-7,CASSGIWDRSSYEQYF,0,5,1,5
TRBV5-6,TRBJ2-3,CASRWGGTSGTDTQYF,0,5,1,5
TRBV11-2,TRBJ2-3,CASRHPGRRGIDTQYF,0,5,1,5
TRBV6-4,TRBJ1-3,CANRTIQGGSGNTIYF,0,5,1,5
TRBV5-1,TRBJ2-5,CASSLVNRSLRETQYF,0,5,1,5
TRBV5-1,TRBJ2-7,CASSLVGRGSSYEQYF,0,5,1,5
TRBV5-1,TRBJ2-2,CASSLAGTGGTGELFF,0,5,1,5
TRBV5-1,TRBJ2-5,CASSLDGGAYQETQYF,0,5,1,5
TRBV5-1,TRBJ1-1,CASSSSGGAGNTEAFF,0,5,1,5
TRBV4-1,TRBJ2-7,CASSPSWAETSNEQYF,0,5,1,5
TRBV5-1,TRBJ1-1,CASSHSTGVGGTEAFF,0,5,1,5
TRBV4-3,TRBJ2-3,CASSQESGGGADTQYF,0,5,1,5
TRBV5-1,TRBJ2-1,CASSGKQGPPSNEQFF,0,5,1,5
TRBV5-1,TRBJ2-5,CASSTQQGGSSETQYF,0,5,1,5
TRBV20-1,TRBJ2-5,CSARYPGLAAQETQYF,0,5,1,5
TRBV20-1,TRBJ1-5,CSAQGGGLVSNQPQHF,0,5,1,5
TRBV20-1,TRBJ2-3,CSATQTSGRPTDTQYF,0,5,1,5
TRBV20-1,TRBJ1-3,CSATTRAVYSGNTIYF,0,5,1,5
TRBV20-1,TRBJ1-6,CSARGDRSSYNSPLHF,0,5,1,5
TRBV20-1,TRBJ2-5,CSARDQYTGGWETQYF,0,5,1,5
TRBV20-1,TRBJ2-4,CSARTQTDLDKNIQYF,0,5,1,5
TRBV29-1,TRBJ2-1,CSVEVPPGLFYNEQFF,0,5,1,5
TRBV29-1,TRBJ2-1,CSVEGQGAEQYNKQFF,0,5,1,5
TRBV29-1,TRBJ2-3,CSVEDRAAGVADTQYF,0,5,1,5
TRBV29-1,TRBJ2-1,CSAEGKTSGRLNEQFF,0,5,1,5
TRBV7-4,TRBJ2-1,RASSAASGGSYNEQFF,0,5,1,5
TRBV4-3,TRBJ2-7,RASSQGTSGSSYEQYF,0,5,1,5
TRBV12-3/4,TRBJ2-3,CVSRAGTGVPDTQYF,0,5,1,5
TRBV12-5,TRBJ1-5,CASGLTIGGAQPQHF,0,5,1,5
TRBV12-5,TRBJ1-1,CASGTRTGKNTEAFF,0,5,1,5
TRBV30,TRBJ1-1,CAWSPLGQQNTEAFF,0,5,1,5
TRBV6-2/3/5/6,TRBJ1-2,CARSYSWDLGYGYTF,0,5,1,5
TRBV10-3,TRBJ2-3,CAISGLNTVIDTQYF,0,5,1,5
TRBV10-3,TRBJ2-1,CAISDRGTGGNEQFF,0,5,1,5
TRBV10-3,TRBJ1-5,CAISEYRGGNQPQHF,0,5,1,5
TRBV10-3,TRBJ2-3,CAIRDLTPGTDTQYF,0,5,1,5
TRBV15,TRBJ1-2,CATSPGQGARYGYTF,0,5,1,5
TRBV15,TRBJ2-1,CATRSQGLAYNEQFF,0,5,1,5
TRBV5-4,TRBJ2-3,CATKISGGYTDTQYF,0,5,1,5
TRBV11-2,TRBJ2-3,CATSGGVAGTDTQYF,0,5,1,5
TRBV19,TRBJ2-1,CASSSQAGDYNEQFF,0,5,1,5
TRBV19,TRBJ1-1,CASSIAGSMNTEAFF,0,5,1,5
TRBV19,TRBJ1-2,CASSIKQGIDYGYTF,0,5,1,5
TRBV19,TRBJ2-1,CASSIDRGRPREQFF,0,5,1,5
TRBV19,TRBJ1-1,CASSPPAGENTEAFF,0,5,1,5
TRBV19,TRBJ2-5,CASSKRTGGQETQYF,0,5,1,5
TRBV19,TRBJ2-3,CASRTTSGSTDTQYF,0,5,1,5
TRBV19,TRBJ2-2,CASNEGVANTGELFF,0,5,1,5
TRBV18,TRBJ1-1,CASSPNGVMGTEAFF,0,5,1,5
TRBV18,TRBJ2-3,CASSPKRPSTDTQYF,0,5,1,5
TRBV18,TRBJ1-1,CASSPGRILNTEAFF,0,5,1,5
TRBV18,TRBJ1-1,CASSPPGGLNTEAFF,0,5,1,5
TRBV18,TRBJ2-7,CASSPRTGGGYEQYF,0,5,1,5
TRBV18,TRBJ2-7,CASSPIPLASGEQYF,0,5,1,5
TRBV18,TRBJ1-5,CASSPTTGKNQPQHF,0,5,1,5
TRBV18,TRBJ1-1,CASSQGQGSNTEAFF,0,5,1,5
TRBV18,TRBJ2-7,CASSNPGQGTYEQYF,0,5,1,5
TRBV3-1,TRBJ2-1,CASHGGPSSYNEQFF,0,5,1,5
TRBV6-2/3/5/6,TRBJ2-1,CASGQQGLTYNEQFF,0,5,1,5
TRBV6-2/3/5/6,TRBJ1-1,CASGGGLGMNTEAFF,0,5,1,5
TRBV6-2/3/5/6,TRBJ1-5,CASTRGVDGPEPQHF,0,5,1,5
TRBV5-4,TRBJ2-1,CASTFLGGRYNEQFF,0,5,1,5
TRBV12-3/4,TRBJ2-7,CASTNRDREFHEQYF,0,5,1,5
TRBV12-3/4,TRBJ2-4,CASSFETGEGGIQYF,0,5,1,5
TRBV28,TRBJ1-5,CASSLYRGGGQPQHF,0,5,1,5
TRBV12-3/4,TRBJ1-1,CASSLVAGKNTEAFF,0,5,1,5
TRBV27,TRBJ1-1,CASSLGAQGTPEAFF,0,5,1,5
TRBV6-2/3/5/6,TRBJ2-3,CASSLDFSSTDTQYF,0,5,1,5
TRBV6-2/3/5/6,TRBJ2-5,CASSSHRDSQETQYF,0,5,1,5
TRBV6-2/3/5/6,TRBJ2-1,CASSYQSGAYNEQFF,0,5,1,5
TRBV6-2/3/5/6,TRBJ1-1,CASSYIWQGPSEAFF,0,5,1,5
TRBV16,TRBJ2-7,CASSLTTGPLYEQYF,0,5,1,5
TRBV6-2/3/5/6,TRBJ2-6,CASSPVSSGANVLTF,0,5,1,5
TRBV12-3/4,TRBJ2-3,CASSPRGGRTDTQYF,0,5,1,5
TRBV28,TRBJ2-7,CASSPSGRGAPEQYF,0,5,1,5
TRBV6-2/3/5/6,TRBJ1-1,CASSPNRGPNTEAFF,0,5,1,5
TRBV7-8,TRBJ2-3,CASSRGLAEADTQYF,0,5,1,5
TRBV6-2/3/5/6,TRBJ1-4,CASSRGTGLNEKLFF,0,5,1,5
TRBV6-1,TRBJ1-1,CASSAPREMNTEAFF,0,5,1,5
TRBV28,TRBJ1-1,CASSAHKTGPPEAFF,0,5,1,5
TRBV27,TRBJ1-2,CASSGQGFLSYGYTF,0,5,1,5
TRBV25-1,TRBJ2-7,CASSDPWTGSYEQYF,0,5,1,5
TRBV6-4,TRBJ2-3,CASSDGTSDTDTQYF,0,5,1,5
TRBV25-1,TRBJ1-6,CASSEYPRGGSPLHF,0,5,1,5
TRBV6-1,TRBJ1-6,CASSEEGQRNSPLHF,0,5,1,5
TRBV28,TRBJ1-6,CASSTGQGSDSPLHF,0,5,1,5
TRBV27,TRBJ1-1,CASSTDRLMNTEAFF,0,5,1,5
TRBV12-3/4,TRBJ2-1,CASSRGLAEASEQFF,0,5,1,5
TRBV12-3/4,TRBJ2-1,CASSRGPGDCNEQFF,0,5,1,5
TRBV12-3/4,TRBJ1-5,CASSKNRGRDQPQHF,0,5,1,5
TRBV5-6,TRBJ2-1,CASSFPAGTMYEQFF,0,5,1,5
TRBV7-2,TRBJ2-1,CASSFKRGNYNGQFF,0,5,1,5
TRBV5-6,TRBJ2-6,CASSLWEFGANVLTF,0,5,1,5
TRBV7-2,TRBJ2-3,CASSLQTGAADTQYF,0,5,1,5
TRBV7-9,TRBJ1-1,CASSLVQGLGAEAFF,0,5,1,5
TRBV5-8,TRBJ2-7,CASSLAPAWSGEQYF,0,5,1,5
TRBV7-2,TRBJ1-5,CASSLGGAGGQPQHF,0,5,1,5
TRBV5-6,TRBJ1-5,CASSLGPGTNQPQHF,0,5,1,5
TRBV7-2,TRBJ2-1,CASSLDSRHLGEQFF,0,5,1,5
TRBV5-4,TRBJ2-7,CASSLKGSGGYEQYF,0,5,1,5
TRBV7-6,TRBJ1-2,CASSLFPGQSYGYTF,0,5,1,5
TRBV7-2,TRBJ2-7,CASSLLARGDYEQYF,0,5,1,5
TRBV7-2,TRBJ1-1,CASSLYLQRYTEAFF,0,5,1,5
TRBV7-9,TRBJ2-7,CASSLPSGKSYEQYF,0,5,1,5
TRBV7-6,TRBJ2-5,CASSLPRDRQETQYF,0,5,1,5
TRBV7-9,TRBJ2-5,CASSLVPEGQETQYF,0,5,1,5
TRBV7-2,TRBJ2-5,CASSLVGRDQETQYF,0,5,1,5
TRBV11-2,TRBJ2-1,CASSLVVAGGNEQFF,0,5,1,5
TRBV7-9,TRBJ1-1,CASSLAQGRNTEAFF,0,5,1,5
TRBV11-2,TRBJ1-3,CASSLAGDSGNTIYF,0,5,1,5
TRBV11-2,TRBJ2-3,CASSLAQTSTDTQCF,0,5,1,5
TRBV7-6,TRBJ2-5,CASSLAPGGQETQYF,0,5,1,5
TRBV6-2/3/5/6,TRBJ1-4,CASSLEAATNEKLFF,0,5,1,5
TRBV7-2,TRBJ1-2,CASSLEGRGHEGYTF,0,5,1,5
TRBV7-9,TRBJ1-1,CASSLEGAGSTEAFF,0,5,1,5
TRBV7-2,TRBJ1-3,CASSLETKQGNTIYF,0,5,1,5
TRBV11-3,TRBJ1-1,CASSLEGQMNTEAFF,0,5,1,5
TRBV7-2,TRBJ2-7,CASSLERQGSYEQYF,0,5,1,5
TRBV11-1,TRBJ2-6,CASSLKRAGANVLTF,0,5,1,5
TRBV7-3,TRBJ2-5,CASSSSDTPQETQYF,0,5,1,5
TRBV7-8,TRBJ2-3,CASSSLQGVTDTQYF,0,5,1,5
TRBV7-2,TRBJ2-3,CASSSLGGGTDTQYF,0,5,1,5
TRBV3-1,TRBJ2-2,CASSSRQMNTGELFF,0,5,1,5
TRBV7-6,TRBJ2-6,CASSSQGSGANVLTF,0,5,1,5
TRBV7-2,TRBJ1-5,CASSSDTYSNQPQHF,0,5,1,5
TRBV7-2,TRBJ2-1,CASSSRTGEYNEQFF,0,5,1,5
TRBV11-3,TRBJ2-1,CASSSRGGRNDEQFF,0,5,1,5
TRBV6-2/3/5/6,TRBJ2-1,CASSSVGLVYDEQFF,0,5,1,5
TRBV7-2,TRBJ1-4,CASSWGGDSGEKLFF,0,5,1,5
TRBV5-4,TRBJ2-7,CASSWTGTGGLEQYF,0,5,1,5
TRBV5-6,TRBJ1-1,CASSWTGSANTEAFF,0,5,1,5
TRBV7-3,TRBJ1-3,CASSYAGSGGNTIYF,0,5,1,5
TRBV5-5,TRBJ2-1,CASSPQGLASNEQFF,0,5,1,5
TRBV12-3/4,TRBJ2-4,CASSPTLGAKNIQYF,0,5,1,5
TRBV12-3/4,TRBJ1-5,CASSPTGRSNQPQHF,0,5,1,5
TRBV5-4,TRBJ2-7,CASSPPGTDFYEQYF,0,5,1,5
TRBV5-6,TRBJ2-1,CASSPWGVSYNEQFF,0,5,1,5
TRBV4-2,TRBJ2-2,CASSPDRDFTGELFF,0,5,1,5
TRBV4-2,TRBJ2-7,CASSPTRNDAYEQYF,0,5,1,5
TRBV12-3/4,TRBJ2-1,CASSQLAGAYNEQFF,0,5,1,5
TRBV14,TRBJ2-7,CASSQVDRGNYEQYF,0,5,1,5
TRBV2,TRBJ2-7,CASSQSTRGSYEQYF,0,5,1,5
TRBV4-2,TRBJ2-3,CASSQVDSMADTQYF,0,5,1,5
TRBV3-1,TRBJ2-3,CASSQVGLGTDTQYF,0,5,1,5
TRBV3-1,TRBJ2-5,CASSQDLLRQETQYF,0,5,1,5
TRBV14,TRBJ1-1,CASSQDIAANTEAFF,0,5,1,5
TRBV4-2,TRBJ1-1,CASSQRSWRRAEAFF,0,5,1,5
TRBV9,TRBJ2-1,CASSVAGGDYNEQFF,0,5,1,5
TRBV7-9,TRBJ2-1,CASSASGGEINEQFF,0,5,1,5
TRBV9,TRBJ2-1,CASSALAGSKNEQFF,0,5,1,5
TRBV9,TRBJ2-1,CASSATSGGANEQFF,0,5,1,5
TRBV9,TRBJ2-1,CASSTTLAGLNEQFF,0,5,1,5
TRBV7-2,TRBJ2-7,CASSSLGTVSYEQYF,0,5,1,5
TRBV3-1,TRBJ2-1,CASSRQGGSYNEQFF,0,5,1,5
TRBV6-2/3/5/6,TRBJ2-7,CASSNPGLHSYEQYF,0,5,1,5
TRBV7-2,TRBJ1-4,CASRAGSATNEKLFF,0,5,1,5
TRBV7-6,TRBJ1-1,CASRDTLKGDTEAFF,0,5,1,5
TRBV13,TRBJ2-3,CASRPMKGSTDTQYF,0,5,1,5
TRBV6-2/3/5/6,TRBJ2-4,CASRGTYLAKNIQYF,0,5,1,5
TRBV6-2/3/5/6,TRBJ2-7,CASKPLAGDTYEQYF,0,5,1,5
TRBV12-3/4,TRBJ2-1,CANSPSSGDYNEQFF,0,5,1,5
TRBV4-2,TRBJ2-1,CTSSHTSGGVNEQFF,0,5,1,5
TRBV5-1,TRBJ2-3,CASTLAGGLTDTQYF,0,5,1,5
TRBV5-1,TRBJ1-1,CASSYPGQGSTEAFF,0,5,1,5
TRBV10-2,TRBJ1-2,CASSDGGLFPYGYTF,0,5,1,5
TRBV5-1,TRBJ2-1,CASSLVLAGYNEQFF,0,8,1,8
TRBV13,TRBJ1-5,CASSLGGPGNQPQHF,0,5,1,5
TRBV5-1,TRBJ2-5,CASSWGVAEEETQYF,0,5,1,5
TRBV4-1,TRBJ1-3,CASSLPRGSGNTIYF,0,5,1,5
TRBV5-1,TRBJ1-1,CASSLVGGADTEAFF,0,5,1,5
TRBV4-1,TRBJ1-3,CASSPRVASGNTIYF,0,5,1,5
TRBV5-1,TRBJ1-4,CASSPDRSLNEKLFF,0,5,1,5
TRBV4-3,TRBJ1-1,CASSRRDREFPEAFF,0,5,1,5
TRBV4-1,TRBJ2-1,CASSQVGLAYNEQFF,0,5,1,5
TRBV4-3,TRBJ2-2,CASSQATIDTGELFF,0,5,1,5
TRBV4-1,TRBJ2-7,CASSQDNSGGYEQYF,0,5,1,5
TRBV20-1,TRBJ1-5,CSAAPLIHSNQPQHF,0,5,1,5
TRBV20-1,TRBJ1-2,CSARAPRTPGYGYTF,0,5,1,5
TRBV20-1,TRBJ1-5,CSARDWGQGSQPQHF,0,5,1,5
TRBV20-1,TRBJ2-7,CSARDLTDYLYEQYF,0,5,1,5
TRBV20-1,TRBJ2-2,CSARDIRDMGGELFF,0,5,1,5
TRBV20-1,TRBJ1-1,CSARDALGPRTEAFF,0,5,1,5
TRBV20-1,TRBJ1-4,CSARESDRGHVKLFF,0,5,1,5
TRBV20-1,TRBJ2-1,CSAHPTSGAYNEQFF,0,5,1,5
TRBV29-1,TRBJ2-3,CSSRGLAELTDTQYF,0,5,1,5
TRBV29-1,TRBJ2-7,CSVEGASGVTYEQYF,0,5,1,5
TRBV29-1,TRBJ1-4,CSVEDLGRGNEKLFF,0,5,1,5
TRBV29-1,TRBJ2-3,CSVEDDSRQQDTQYF,0,5,1,5
TRBV29-1,TRBJ2-1,CSVEDEGLAGNEQFF,0,5,1,5
TRBV29-1,TRBJ1-3,CSAKQDRFSGNTIYF,0,5,1,5
TRBV14,TRBJ2-3,CVSSRGLAIDTQYF,0,5,1,5
TRBV7-9,TRBJ2-1,CAPSQLAVYNEQFF,0,5,1,5
TRBV28,TRBJ1-4,CAGRAGGENEKLFF,0,5,1,5
TRBV27,TRBJ2-6,CATYAFFGANVLTF,0,5,1,5
TRBV15,TRBJ2-2,CATSRMGAARELFF,0,5,1,5
TRBV19,TRBJ1-5,CASCLSREFQPQHF,0,5,1,5
TRBV19,TRBJ1-5,CASAGQGEGQPQHF,0,5,1,5
TRBV19,TRBJ1-1,CASTVGQVNTEAFF,0,5,1,5
TRBV19,TRBJ2-1,CASSIGASGILWFF,0,5,1,5
TRBV19,TRBJ2-5,CASSTSPGPETQYF,0,5,1,5
TRBV19,TRBJ1-2,CASSTKQGIYGYTF,0,5,1,5
TRBV19,TRBJ2-1,CASSPPMDYNEQFF,0,5,1,5
TRBV19,TRBJ1-4,CASRKGQYNEKLFF,0,5,1,5
TRBV19,TRBJ2-3,CASKKRGSTDTQYF,0,5,1,5
TRBV18,TRBJ2-7,CASSLGGSYYEQYF,0,5,1,5
TRBV12-3/4,TRBJ2-5,CASSLRGRQETQYF,0,5,1,5
TRBV18,TRBJ1-1,CASSPPGVNTEAFF,0,5,1,5
TRBV18,TRBJ1-1,CASSPGLGGTEAFF,0,5,1,5
TRBV19,TRBJ2-7,CASCDRDRAYEQYF,0,5,1,5
TRBV12-3/4,TRBJ2-3,CASHTSPSTDTQYF,0,5,1,5
TRBV9,TRBJ1-5,CASGGGASNQPQHF,0,5,1,5
TRBV9,TRBJ2-3,CASTSRGETDTQYF,0,5,1,5
TRBV12-3/4,TRBJ1-1,CASTASAGTTEAFF,0,5,1,5
TRBV6-2/3/5/6,TRBJ1-5,CASSFTQGAQPQHF,0,5,1,5
TRBV12-3/4,TRBJ1-1,CASSFSGGNTEAFF,0,5,1,5
TRBV12-3/4,TRBJ1-2,CASSLSGGNQGYTF,0,5,1,5
TRBV12-3/4,TRBJ2-7,CASSLAPLSSEQYF,0,5,1,5
TRBV6-2/3/5/6,TRBJ2-5,CASSLNRAEETQYF,0,5,1,5
TRBV12-3/4,TRBJ1-6,CASSLGSYNSPLHF,0,5,1,5
TRBV6-2/3/5/6,TRBJ1-1,CASSLGGANTEAFF,0,5,1,5
TRBV12-3/4,TRBJ2-7,CASSLGGPIYEQYF,0,5,1,5
TRBV28,TRBJ1-1,CASSSKKPNTEAFF,0,5,1,5
TRBV6-2/3/5/6,TRBJ1-1,CASSYSKIKTEAFF,0,5,1,5
TRBV6-2/3/5/6,TRBJ1-1,CASSYPGGPTEAFF,0,5,1,5
TRBV6-2/3/5/6,TRBJ2-3,CASSYRRNADTQYF,0,5,1,5
TRBV6-2/3/5/6,TRBJ1-2,CASSYTRDNYGYTF,0,5,1,5
TRBV6-2/3/5/6,TRBJ2-1,CASSLLTDYNEQFF,0,5,1,5
TRBV12-3/4,TRBJ1-5,CASSPGGGVQPQHF,0,5,1,5
TRBV6-2/3/5/6,TRBJ2-1,CASSRSSSYNEQFF,0,5,1,5
TRBV6-1,TRBJ2-1,CASSHSGSKSEQFF,0,5,1,5
TRBV6-2/3/5/6,TRBJ2-5,CASSQNSRFGTQYF,0,5,1,5
TRBV6-1,TRBJ1-5,CASSVYRGNQPQHF,0,5,1,5
TRBV6-1,TRBJ2-1,CASSAGGRAGEQFF,0,5,1,5
TRBV2,TRBJ2-1,CASSAGLEVDEQFF,0,5,1,5
TRBV2,TRBJ1-6,CASSGQTYNSPLHF,0,5,1,5
TRBV6-1,TRBJ2-7,CASSGAGTSVKQYF,0,5,1,5
TRBV6-1,TRBJ1-1,CASSGRGGVGEAFF,0,5,1,5
TRBV6-1,TRBJ2-7,CASSELSGFHEQYF,0,5,1,5
TRBV6-1,TRBJ2-2,CASSESGDTGELFF,0,5,1,5
TRBV25-1,TRBJ2-7,CASSEYVTSYEQYF,0,5,1,5
TRBV25-1,TRBJ1-1,CASSEYAANTEAFF,0,5,1,5
TRBV6-2/3/5/6,TRBJ2-1,CASSIGLAGDGGFF,0,5,1,5
TRBV2,TRBJ2-1,CASSTRVLGYEQFF,0,5,1,5
TRBV2,TRBJ2-7,CASSTPGTTYEQYF,0,5,1,5
TRBV6-2/3/5/6,TRBJ1-1,CASSSILGAAEAFF,0,5,1,5
TRBV5-6,TRBJ2-3,CASSFWVSTDTQYF,0,5,1,5
TRBV7-9,TRBJ2-4,CASSFSGAKNIQYF,0,5,1,5
TRBV7-2,TRBJ2-7,CASSLFEVRDEQYF,0,5,1,5
TRBV5-4,TRBJ1-5,CASSLPGSNQPQHF,0,5,1,5
TRBV5-5,TRBJ2-1,CASSLVSSRSEQFF,0,5,1,5
TRBV5-4,TRBJ2-1,CASSLAEEGNEQFF,0,5,1,5
TRBV5-4,TRBJ1-1,CASSLAEDRGEAFF,0,5,1,5
TRBV5-6,TRBJ2-1,CASSLGIPGNEQFF,0,5,1,5
TRBV5-4,TRBJ2-1,CASSLDPKTNEQFF,0,5,1,5
TRBV7-2,TRBJ2-2,CASSLYRATGELFF,0,5,1,5
TRBV5-6,TRBJ1-1,CASSLYRGNTEAFF,0,5,1,5
TRBV7-2,TRBJ2-2,CASSLLGQTGELFF,0,5,1,5
TRBV5-4,TRBJ1-1,CASSLQQMNTEAFF,0,5,1,5
TRBV7-9,TRBJ1-1,CASSLVGGDTEAFF,0,5,1,5
TRBV7-9,TRBJ1-1,CASSLVGLNTEAFF,0,5,1,5
TRBV6-2/3/5/6,TRBJ2-5,CASSLVGRQETQYF,0,5,1,5
TRBV7-2,TRBJ1-3,CASSLGSVGNTIYF,0,5,1,5
TRBV7-8,TRBJ2-7,CASSLGVRIYEQYF,0,5,1,5
TRBV7-9,TRBJ2-5,CASSLGGFQETQYF,0,5,1,5
TRBV7-8,TRBJ1-1,CASSLDRGYTEAFF,0,5,1,5
TRBV7-9,TRBJ1-1,CASSLEGANTEAFF,0,5,1,5
TRBV7-2,TRBJ1-2,CASSLEGTPWSYTF,0,5,1,5
TRBV7-9,TRBJ1-2,CASSLTAGNYGYTF,0,5,1,5
TRBV7-2,TRBJ1-1,CASSLSQGGTEAFF,0,5,1,5
TRBV5-4,TRBJ2-5,CASSLRTSGETQYF,0,5,1,5
TRBV3-1,TRBJ2-7,CASSSRTVPYEQYF,0,5,1,5
TRBV5-6,TRBJ1-5,CASSSGQLNQPQHF,0,5,1,5
TRBV7-2,TRBJ1-1,CASSSRSVNTEAFF,0,5,1,5
TRBV7-2,TRBJ2-7,CASSSGLWSYEQYF,0,5,1,5
TRBV5-4,TRBJ2-7,CASSWRDLPYEQYF,0,5,1,5
TRBV6-2/3/5/6,TRBJ2-7,CASSYRQGRYEQYF,0,5,1,5
TRBV2,TRBJ1-1,CASSLSRQNTEAFF,0,5,1,5
TRBV12-3/4,TRBJ2-2,CASSLGLASGELFF,0,5,1,5
TRBV6-2/3/5/6,TRBJ2-3,CASSPLSYTDTQYF,0,5,1,5
TRBV6-2/3/5/6,TRBJ1-6,CASSPQDSTSPLHF,0,5,1,5
TRBV14,TRBJ1-2,CASSPGQRKGSYTF,0,5,1,5
TRBV7-2,TRBJ1-5,CASSPGTDDQPQHF,0,5,1,5
TRBV11-3,TRBJ2-7,CASSPRTGVNEQYF,0,5,1,5
TRBV7-9,TRBJ1-2,CASSPRTSNYGYTF,0,5,1,5
TRBV12-3/4,TRBJ2-3,CASSRGGALDTQYF,0,5,1,5
TRBV3-1,TRBJ1-4,CASSQGFANEKLFF,0,5,1,5
TRBV27,TRBJ1-1,CASSQGASNTEALF,0,5,1,5
TRBV3-1,TRBJ1-2,CASSQDPQLRGYTF,0,5,1,5
TRBV3-1,TRBJ1-2,CASSQDVGDSGYTF,0,5,1,5
TRBV4-2,TRBJ1-1,CASSQELSDTEAFF,0,5,1,5
TRBV12-3/4,TRBJ2-1,CASSQRLVRGEQFF,0,5,1,5
TRBV6-2/3/5/6,TRBJ2-1,CASSQRLGRGEQFF,0,5,1,5
TRBV3-1,TRBJ2-7,CASSARDRGYEQYF,0,5,1,5
TRBV7-9,TRBJ1-6,CASSAGTGVSPLHF,0,5,1,5
TRBV12-3/4,TRBJ2-3,CASSGDRDTDTQYF,0,5,1,5
TRBV5-6,TRBJ2-7,CASSTPQGVYEQYF,0,5,1,5
TRBV7-8,TRBJ2-5,CASSTPGRQETQYF,0,5,1,5
TRBV7-2,TRBJ1-3,CASRPAGTGNTIYF,0,5,1,5
TRBV7-2,TRBJ1-5,CASRIQGAHQPQHF,0,5,1,5
TRBV6-1,TRBJ1-4,CASRKTGDNEKLFF,0,5,1,5
TRBV3-1,TRBJ1-2,CASRPGQDGYGYTF,0,5,1,5
TRBV12-3/4,TRBJ2-7,CASRQGWEDYEQYF,0,5,1,5
TRBV2,TRBJ1-2,CASRGTGVLYGYTF,0,5,1,5
TRBV5-5,TRBJ1-1,CASNLEQVRTEAFF,0,5,1,5
TRBV2,TRBJ1-1,CASNPTRKNTEAFF,0,5,1,5
TRBV2,TRBJ2-7,CASNQQGTAYEQYF,0,5,1,5
TRBV12-3/4,TRBJ2-3,CASKGSLSTDTQYF,0,5,1,5
TRBV5-1,TRBJ2-1,CASRPGLADNEQFF,0,5,1,5
TRBV10-2,TRBJ2-5,CASSESKGQETQYF,0,5,1,5
TRBV5-1,TRBJ2-7,CASSFAVGVYEQYF,0,5,1,5
TRBV5-1,TRBJ2-7,CASSLRAGPYEQYF,0,5,1,5
TRBV5-1,TRBJ1-6,CASSLGQGGSPLHF,0,5,1,5
TRBV5-1,TRBJ1-1,CASSLDRGSAEAFF,0,5,1,5
TRBV5-1,TRBJ1-1,CASSSGRTNTEAFF,0,5,1,5
TRBV5-1,TRBJ1-4,CASSWTSTNEKLFF,0,5,1,5
TRBV4-1,TRBJ1-5,CASSLRSGNQPQHF,0,5,1,5
TRBV4-3,TRBJ2-1,CASSPTSGPNEQFF,0,5,1,5
TRBV4-3,TRBJ2-4,CASSPSLAKNIQYF,0,5,1,5
TRBV5-1,TRBJ2-2,CASSPSVNTGELFF,0,5,1,5
TRBV4-1,TRBJ1-5,CASSHPIKNQPQHF,0,5,1,5
TRBV4-1,TRBJ2-1,CASSQVTANNEQFF,0,5,1,5
TRBV4-1,TRBJ2-7,CASSQVDRSYEQYF,0,5,1,5
TRBV4-3,TRBJ2-3,CASSQGQGADTQYF,0,5,1,5
TRBV4-1,TRBJ1-2,CASSQDYDTPRWTF,0,5,1,5
TRBV4-1,TRBJ1-1,CASSQEFLNTEAFF,0,5,1,5
TRBV5-1,TRBJ2-3,CASSEGQRWDTQYF,0,5,1,5
TRBV5-1,TRBJ1-2,CASKYNRGDPGYTF,0,5,1,5
TRBV20-1,TRBJ2-1,CSVTLAGDYNEQFF,0,5,1,5
TRBV20-1,TRBJ2-1,CSVRLAGINNEQFF,0,5,1,5
TRBV20-1,TRBJ2-7,CSASGEGERNEQYF,0,5,1,5
TRBV20-1,TRBJ1-5,CSAQSQELNQPQHF,0,5,1,5
TRBV20-1,TRBJ2-7,CSAVSGGASYEQYF,0,5,1,5
TRBV20-1,TRBJ2-5,CSAITQAGDETQYF,0,5,1,5
TRBV20-1,TRBJ2-1,CSAISEKGNNEQFF,0,5,1,5
TRBV20-1,TRBJ1-6,CSARARGWNSPLHF,0,5,1,5
TRBV20-1,TRBJ2-7,CSARGNLAAYEQYF,0,5,1,5
TRBV20-1,TRBJ2-7,CSARDRERSYEQYF,0,5,1,5
TRBV20-1,TRBJ1-5,CSARSPDGNQPQHF,0,5,1,5
TRBV20-1,TRBJ2-5,CSARLQGRRETQYF,0,5,1,5
TRBV20-1,TRBJ1-2,CSARASLGYYGYTF,0,5,1,5
TRBV20-1,TRBJ2-7,CSARDPRLSYEQYF,0,5,1,5
TRBV20-1,TRBJ2-5,CSARDRGSQETQYF,0,5,1,5
TRBV20-1,TRBJ2-3,CSAKRQGNTDTQYF,0,5,1,5
TRBV20-1,TRBJ2-7,CSALKPGQKGEQYF,0,5,1,5
TRBV20-1,TRBJ2-3,CSAPLRGREDTQYF,0,5,1,5
TRBV20-1,TRBJ2-1,CSATGLFSYNEQFF,0,5,1,5
TRBV20-1,TRBJ2-1,CSAQTGELVNEQFF,0,5,1,5
TRBV20-1,TRBJ2-1,CSADQGDPRDEQFF,0,5,1,5
TRBV20-1,TRBJ2-4,CSAIRTTVQNIQYF,0,5,1,5
TRBV29-1,TRBJ2-2,CSYVETGGTGELFF,0,5,1,5
TRBV29-1,TRBJ2-7,CSVAGTASSYEQYF,0,5,1,5
TRBV29-1,TRBJ2-3,CSVDAGMGEDTQYF,0,5,1,5
TRBV29-1,TRBJ2-5,CSVDPGTSVRTQYF,0,5,1,5
TRBV29-1,TRBJ1-1,CSVDPGQGNTEAFF,0,5,1,5
TRBV29-1,TRBJ2-3,CSDGTSGNTDTQYF,0,5,1,5
TRBV7-3,TRBJ2-1,RASSFGTSGDPLFF,0,5,1,5
TRBV12-5,TRBJ2-3,CASGPTSTDTQYF,0,5,1,5
TRBV2,TRBJ1-6,CAFQDRWNSPLHF,0,5,1,5
TRBV30,TRBJ1-6,CAWVKTDNSPLHF,0,5,1,5
TRBV10-3,TRBJ2-3,CAYGTEATDTQYF,0,5,1,5
TRBV2,TRBJ2-3,CAALAGGTDTQYF,0,5,1,5
TRBV12-3/4,TRBJ2-4,CAAGLAGGGIQYF,0,5,1,5
TRBV10-3,TRBJ1-2,CAISEAGDDGYTF,0,5,1,5
TRBV10-3,TRBJ2-1,CAISEGVTNEQFF,0,5,1,5
TRBV24-1,TRBJ2-1,CATSVPGDNEQFF,0,5,1,5
TRBV19,TRBJ2-7,CASSAAGAYEQYF,0,5,1,5
TRBV19,TRBJ2-3,CASSGGAADTQYF,0,5,1,5
TRBV19,TRBJ2-3,CASSTTNTDTQYF,0,5,1,5
TRBV18,TRBJ1-4,CASSPDRDEKLFF,0,5,1,5
TRBV18,TRBJ1-2,CASSTGEDYGYTF,0,5,1,5
TRBV18,TRBJ2-7,CASSPPGDYEQYF,0,5,1,5
TRBV7-2,TRBJ2-5,CASAPWGQETQYF,0,5,1,5
TRBV25-1,TRBJ1-1,CASEPGAATEAFF,0,5,1,5
TRBV12-3/4,TRBJ2-7,CASTWGATYEQYF,0,5,1,5
TRBV7-9,TRBJ1-1,CASTRAVDTEAFF,0,5,1,5
TRBV6-2/3/5/6,TRBJ2-4,CASSFSQGNIQYF,0,5,1,5
TRBV12-3/4,TRBJ1-1,CASSFGRNTEAFS,0,5,1,5
TRBV6-2/3/5/6,TRBJ2-1,CASSFGGHNEQFF,0,5,1,5
TRBV12-3/4,TRBJ1-1,CASSLGANTEAFF,0,5,1,5
TRBV27,TRBJ2-7,CASSLSGTYEQYF,0,5,1,5
TRBV27,TRBJ1-1,CASSLSGRTSAFF,0,5,1,5
TRBV27,TRBJ2-5,CASSLWDSETQYF,0,5,1,5
TRBV12-3/4,TRBJ1-5,CASSLDFRWPQHF,0,5,1,5
TRBV27,TRBJ1-1,CASSLRGKAEAFF,0,5,1,5
TRBV12-3/4,TRBJ2-1,CASSLNRWNEQFF,0,5,1,5
TRBV27,TRBJ2-1,CASSLNWVDEQFF,0,5,1,5
TRBV12-3/4,TRBJ2-1,CASSSLAGDIRFF,0,5,1,5
TRBV6-2/3/5/6,TRBJ2-1,CASSYRRYNEQFF,0,5,1,5
TRBV6-2/3/5/6,TRBJ2-5,CASSYVETRTQYF,0,5,1,5
TRBV12-3/4,TRBJ1-5,CASSYRYNQPQHF,0,5,1,5
TRBV27,TRBJ1-1,CASSLSTDVVAFF,0,5,1,5
TRBV12-3/4,TRBJ2-7,CASSPTGGHEQYF,0,5,1,5
TRBV27,TRBJ2-5,CASSPYPAETQYF,0,5,1,5
TRBV12-3/4,TRBJ1-6,CASSHGLNSPLHF,0,5,1,5
TRBV6-1,TRBJ2-7,CASSAYRDYEQYF,0,5,1,5
TRBV5-6,TRBJ2-1,CASSFGFYNEQFF,0,5,1,5
TRBV7-9,TRBJ1-2,CASSFPDRVGYTF,0,5,1,5
TRBV5-4,TRBJ2-1,CASSLAGRNEQFF,0,5,1,5
TRBV7-9,TRBJ1-2,CASSLADSYGYTF,0,5,1,5
TRBV7-2,TRBJ2-5,CASSLGVQETQYF,0,5,1,5
TRBV7-2,TRBJ2-1,CASSLDVGVEQFF,0,5,1,5
TRBV7-9,TRBJ1-1,CASSLREGREAFF,0,5,1,5
TRBV5-8,TRBJ2-5,CASSSDYLETQYF,0,5,1,5
TRBV7-9,TRBJ2-1,CASSSSGHNEQFF,0,5,1,5
TRBV3-1,TRBJ1-1,CASSPSAYTEAFF,0,5,1,5
TRBV7-2,TRBJ2-4,CASSPTWTTVPYF,0,5,1,5
TRBV7-2,TRBJ2-1,CASSPGLAGEQFF,0,5,1,5
TRBV16,TRBJ2-7,CASSQRQTMEQYF,0,5,1,5
TRBV7-2,TRBJ2-7,CASSQKFPGEQYF,0,5,1,5
TRBV7-2,TRBJ2-1,CASSVDSYNEQFF,0,5,1,5
TRBV6-2/3/5/6,TRBJ2-7,CASSAGVGYEQYF,0,5,1,5
TRBV9,TRBJ1-5,CASSGEGNQPQHF,0,5,1,5
TRBV5-5,TRBJ1-5,CASSTWGSQPQHF,0,5,1,5
TRBV2,TRBJ1-2,CASSTTGAYGYTF,0,5,1,5
TRBV27,TRBJ2-7,CASSNRLGGEQYF,0,5,1,5
TRBV2,TRBJ1-1,CASRYRKNTEAFF,0,5,1,5
TRBV6-2/3/5/6,TRBJ2-1,CASRAITGNEQFF,0,5,1,5
TRBV7-9,TRBJ2-7,CASRAGASYEQYF,0,5,1,5
TRBV6-2/3/5/6,TRBJ1-1,CASRGQGRTEAFF,0,5,1,5
TRBV6-4,TRBJ2-2,CASRDQYTGELFF,0,5,1,5
TRBV12-3/4,TRBJ2-7,CASRSTGPYEQYF,0,5,1,5
TRBV12-3/4,TRBJ2-2,CASRTLDSGELCF,0,5,1,5
TRBV3-1,TRBJ2-1,CASNPGGRNEQSF,0,5,1,5
TRBV6-2/3/5/6,TRBJ2-2,CASKGQNTGELFF,0,5,1,5
TRBV27,TRBJ1-1,CASKTGGLAEAFF,0,5,1,5
TRBV5-8,TRBJ1-2,CARDSGVDYGYTF,0,5,1,5
TRBV4-3,TRBJ1-6,CASSPRGGSPLHF,0,5,1,5
TRBV5-1,TRBJ2-7,CASSFDPSYEQYF,0,5,1,5
TRBV5-1,TRBJ1-1,CASSLAGQGKAFF,0,5,1,5
TRBV5-1,TRBJ2-7,CASSLANPYEQYF,0,5,1,5
TRBV5-1,TRBJ1-6,CASSSQDNSPLHF,0,5,1,5
TRBV4-1,TRBJ1-2,CASSLPGSYGYTF,0,5,1,5
TRBV4-1,TRBJ2-7,CASSLRDTYEQYF,0,5,1,5
TRBV4-1,TRBJ2-1,CASSPGGSNEQFF,0,5,1,5
TRBV5-1,TRBJ2-7,CASSRGTGYEQYF,0,5,1,5
TRBV4-3,TRBJ1-1,CASSHLGGHEAFF,0,5,1,5
TRBV5-1,TRBJ2-7,CASSHGTVYEQYF,0,5,1,5
TRBV4-3,TRBJ2-7,CASSQASGDEQYF,0,5,1,5
TRBV4-3,TRBJ2-7,CASSQGQGYEQYF,0,5,1,5
TRBV5-1,TRBJ1-2,CASSVTGGNGYTF,0,5,1,5
TRBV5-1,TRBJ2-5,CASSDNPQETQYF,0,5,1,5
TRBV5-1,TRBJ2-6,CASRDDPTNVLTF,0,5,1,5
TRBV20-1,TRBJ2-3,CSVDRGSTDTQYF,0,5,1,5
TRBV20-1,TRBJ1-2,CSAWRDSPYGYTF,0,5,1,5
TRBV20-1,TRBJ2-5,CSAPPTGEETQYF,0,5,1,5
TRBV20-1,TRBJ1-2,CSAVGQTNYGYTF,0,5,1,5
TRBV20-1,TRBJ2-1,CSASSAVYNEQFF,0,5,1,5
TRBV20-1,TRBJ1-1,CSASRGERVEAFF,0,5,1,5
TRBV20-1,TRBJ1-6,CSASMGENSPLHF,0,5,1,5
TRBV20-1,TRBJ1-2,CSARDGSYYGYTS,0,5,1,5
TRBV20-1,TRBJ2-5,CSARARPEGTQYF,0,5,1,5
TRBV20-1,TRBJ2-2,CSANSGRTGELFF,0,5,1,5
TRBV20-1,TRBJ2-7,CSAKRGDLPGQYF,0,5,1,5
TRBV29-1,TRBJ1-1,CSVARGTNTEAFF,0,5,1,5
TRBV29-1,TRBJ1-1,CSVESSLNTEAFF,0,5,1,5
TRBV29-1,TRBJ1-1,CSVEIVRNTEAFF,0,5,1,5
TRBV29-1,TRBJ1-1,CSVTYLGNTEAFF,0,5,1,5
TRBV29-1,TRBJ1-2,CSVSVQSGEGYTF,0,5,1,5
TRBV29-1,TRBJ2-4,CSVLAIAKNIQYF,0,5,1,5
TRBV29-1,TRBJ2-1,CSVQGSSYNEQFF,0,5,1,5
TRBV29-1,TRBJ2-1,CSVGRTGRNEQFF,0,5,1,5
TRBV29-1,TRBJ2-1,CSVGLAGVGEQFF,0,5,1,5
TRBV29-1,TRBJ2-7,CSVERGAAYEQYF,0,5,1,5
TRBV29-1,TRBJ1-1,CSATTGGNTEAFF,0,5,1,5
TRBV29-1,TRBJ2-2,CSALAATTGELFF,0,5,1,5
TRBV29-1,TRBJ1-2,CSARQGGYDGYTF,0,5,1,5
TRBV29-1,TRBJ1-2,CSAKADRDHGYTF,0,5,1,5
TRBV29-1,TRBJ2-1,CSAGLADYNEQFF,0,5,1,5
TRBV29-1,TRBJ1-1,CSGISGQGGEAFF,0,5,1,5
TRBV29-1,TRBJ2-2,CSGRDRSYGELFF,0,5,1,5
TRBV29-1,TRBJ2-7,CSGGDGPLGEQYF,0,5,1,5
TRBV30,TRBJ2-1,CAWSAPGPEQFF,0,5,1,5
TRBV10-3,TRBJ2-3,CAILGDTDTQYF,0,5,1,5
TRBV24-1,TRBJ2-3,CATSGGTDTQYF,0,5,1,5
TRBV19,TRBJ2-3,CATGAEADTQYF,0,5,1,5
TRBV19,TRBJ1-1,CASSPPNTEAFF,0,5,1,5
TRBV19,TRBJ1-1,CASTLRGSEAFF,0,5,1,5
TRBV19,TRBJ1-1,CASSAFDTEAFF,0,5,1,5
TRBV19,TRBJ2-7,CASRDRASEQYF,0,5,1,5
TRBV7-9,TRBJ2-7,CASGEGFGEQYF,0,5,1,5
TRBV12-3/4,TRBJ2-3,CASSLTSDTQYF,0,5,1,5
TRBV12-3/4,TRBJ2-7,CASSSRADEQYF,0,5,1,5
TRBV12-3/4,TRBJ2-4,CASSSVQVIQYF,0,5,1,5
TRBV6-2/3/5/6,TRBJ2-1,CASSYNRFEQFF,0,5,1,5
TRBV3-1,TRBJ2-5,CASSPRRETQYF,0,5,1,5
TRBV2,TRBJ2-1,CASSAGGNEQFF,0,5,1,5
TRBV12-3/4,TRBJ1-6,CASSGKGAPLHF,0,5,1,5
TRBV27,TRBJ2-7,CASSTTGSEQYF,0,5,1,5
TRBV2,TRBJ2-5,CASSSGRETQYF,0,5,1,5
TRBV7-9,TRBJ2-1,CASSFRTDEQFF,0,5,1,5
TRBV6-2/3/5/6,TRBJ1-1,CASSLEVTEAFF,0,5,1,5
TRBV7-2,TRBJ2-7,CASSLGGPEQYF,0,5,1,5
TRBV7-9,TRBJ1-2,CASSLGGDRSNF,0,5,1,5
TRBV7-9,TRBJ2-5,CASSSTEETQYF,0,5,1,5
TRBV7-9,TRBJ2-7,CASSLTGREQYF,0,5,1,5
TRBV6-2/3/5/6,TRBJ2-1,CASSPPADEQFF,0,5,1,5
TRBV7-9,TRBJ2-1,CASSPPGDEQFF,0,5,1,5
TRBV4-2,TRBJ2-7,CASSQPPGGQYF,0,5,1,5
TRBV3-1,TRBJ2-3,CASSQDRALPHF,0,5,1,5
TRBV3-1,TRBJ2-7,CASSQEGAARCF,0,5,1,5
TRBV9,TRBJ2-7,CASSAGAYEQYF,0,5,1,5
TRBV3-1,TRBJ2-2,CASSANTGELFF,0,5,1,5
TRBV25-1,TRBJ2-5,CASRDPLKTQYF,0,5,1,5
TRBV6-2/3/5/6,TRBJ1-1,CASRVMNTEAFF,0,5,1,5
TRBV6-2/3/5/6,TRBJ2-7,CASRGSNYEQYF,0,5,1,5
TRBV5-1,TRBJ2-1,CASSLLLGEQFF,0,5,1,5
TRBV20-1,TRBJ2-3,CSAARGTDTQYF,0,5,1,5
TRBV20-1,TRBJ1-1,CSATGGRAEAFF,0,5,1,5
TRBV20-1,TRBJ2-3,CSASPVADTQYF,0,5,1,5
TRBV20-1,TRBJ1-3,CSASGEYHTIYF,0,5,1,5
TRBV20-1,TRBJ2-7,CSARVHSYEQYF,0,5,1,5
TRBV20-1,TRBJ1-2,CSARAATGSYTF,0,5,1,5
TRBV20-1,TRBJ2-1,CSARDSRNEQFF,0,5,1,5
TRBV20-1,TRBJ2-1,CSAREDGFEQFF,0,5,1,5
TRBV20-1,TRBJ2-7,CSASGTRSEQYF,0,5,1,5
TRBV20-1,TRBJ2-1,CSANFLFDEQFF,0,5,1,5
TRBV29-1,TRBJ2-5,CSVWGFQETQYF,0,5,1,5
TRBV29-1,TRBJ2-5,CSVETSRETQYF,0,5,1,5
TRBV29-1,TRBJ2-7,CSVEGRAYEQYF,0,5,1,5
TRBV29-1,TRBJ2-1,CSARDRGDEQFF,0,5,1,5
TRBV29-1,TRBJ2-1,CSGDLLGNEQFF,0,5,1,5
TRBV13,TRBJ1-2,CAVSGDYGYTF,0,5,1,5
TRBV10-3,TRBJ2-3,CAISETDTQYF,0,5,1,5
TRBV19,TRBJ1-1,CATRTGPEAFF,0,5,1,5
TRBV2,TRBJ2-1,CASEAPNEQFF,0,5,1,5
TRBV27,TRBJ2-3,CASSFSDTQYF,0,5,1,5
TRBV28,TRBJ2-3,CASSFTDTQYF,0,5,1,5
TRBV12-3/4,TRBJ1-2,CASSFRDGYTF,0,5,1,5
TRBV12-3/4,TRBJ1-5,CASSLVQPQHF,0,5,1,5
TRBV6-2/3/5/6,TRBJ2-7,CASSYNYEQYF,0,5,1,5
TRBV5-6,TRBJ2-7,CASSYENEQYF,0,5,1,5
TRBV7-9,TRBJ2-7,CASSRDYEQYF,0,5,1,5
TRBV7-8,TRBJ1-1,CASSQWSEAFF,0,5,1,5
TRBV3-1,TRBJ2-7,CASSGPLEQYF,0,5,1,5
TRBV12-3/4,TRBJ1-3,CASRVQGTIYF,0,5,1,5
TRBV7-9,TRBJ2-7,CASRIGALEYF,0,5,1,5
TRBV11-2,TRBJ1-4,CATERGRQLFF,0,5,1,5
TRBV20-1,TRBJ2-2,CTMHRYGELFF,0,5,1,5
TRBV29-1,TRBJ2-3,CSVSTGDTQYF,0,5,1,5
TRBV29-1,TRBJ2-7,CSATITYEQYF,0,5,1,5
TRBV29-1,TRBJ2-5,CSGGGGETQYF,0,5,1,5
TRBV20-1,TRBJ2-4,CSDSRGGIQYF,0,5,1,5
TRBV6-4,TRBJ2-1,CASRSNEQFF,0,5,1,5
TRBV29-1,TRBJ2-3,CSAGGDTQYF,0,5,1,5
TRBV20-1,TRBJ1-1,CSVSAFF,0,8,1,8
TRBV6-4,TRBJ2-7,CASSRTLVGSSYEQYF,0,5,1,5
TRBV7-9,TRBJ2-5,CASSLLLAGTETLYF,0,5,1,5
TRBV25-1,TRBJ1-1,CASSEAGVTEAFF,0,5,1,5
TRBV30,TRBJ2-1,CAWSVRGLSSYNEQFF,0,5,1,5
TRBV28,TRBJ2-1,CASRFRLGDRAEQFF,0,5,1,5
TRBV16,TRBJ1-2,CASSQSTGVYGFTF,0,5,1,5
TRBV30,TRBJ2-4,CAWSIDAKNIQYY,0,5,1,5
TRBV6-2/3/5/6,TRBJ2-4,CASCSGPRSIQYF,0,5,1,5
TRBV4-2,TRBJ2-2,CASSRDNTNTGGLFF,0,5,1,5
TRBV4-1,TRBJ2-3,CASSQPAISTDTQYF,0,5,1,5
TRBV11-3,TRBJ2-1,CASSLDLFDNEQFF,0,4,1,4
TRBV6-1,TRBJ1-2,CASSGPNYGYTF,0,4,1,4
TRBV19,TRBJ2-1,CASSPRGASGGAGEQFF,0,4,1,4
TRBV15,TRBJ2-7,CATSRGSPSVLQYF,0,4,1,4
TRBV5-6,TRBJ1-1,CASSYTDRETEAFF,0,4,1,4
TRBV20-1,TRBJ1-5,CSAIAPRAGGNQPQHF,0,4,1,4
TRBV2,TRBJ1-1,CASSFEGGNTEAFF,0,4,1,4
TRBV6-2/3/5/6,TRBJ1-2,CASSRWQGNYGYTF,0,4,1,4
TRBV6-2/3/5/6,TRBJ2-5,CASSYSIRGAQGETQYF,0,4,1,4
TRBV29-1,TRBJ2-2,CSIRDRGSTGELFF,0,4,1,4
TRBV7-2,TRBJ1-1,CASSFYPEPEAFF,0,4,1,4
TRBV12-3/4,TRBJ1-2,CASSLRGRPNYGYTF,0,4,1,4
TRBV12-3/4,TRBJ2-3,CASSLGGERDTQYF,0,4,1,4
TRBV4-3,TRBJ2-3,CASSQDLVGGLAGGLYGTDTQYF,0,4,1,4
TRBV7-2,TRBJ2-3,CASSFGFSLRGGPVMADTQYF,0,4,1,4
TRBV11-2,TRBJ2-1,CASSLGRMDREGSPYNEQFF,0,4,1,4
TRBV7-2,TRBJ2-3,CASSLGPGTSGGAGTDTQYF,0,4,1,4
TRBV4-1,TRBJ1-2,CASSQVGFLARSATNYGYTF,0,4,1,4
TRBV15,TRBJ2-2,CATSRGYLGTGKSTGELFF,0,4,1,4
TRBV18,TRBJ2-6,CASSPGGFDPWTGANVLTF,0,4,1,4
TRBV5-4,TRBJ2-5,CASTTLSTAGGHNQETQYF,0,4,1,4
TRBV5-6,TRBJ2-3,CASTKPKVDTGAETDTQYF,0,4,1,4
TRBV12-3/4,TRBJ2-3,CASSLTLAGGQIGTDTQYF,0,4,1,4
TRBV7-2,TRBJ2-5,CASSPRLAGPLLGSETQYF,0,4,1,4
TRBV6-1,TRBJ1-5,CASSDGTDRLRYSNQPQHF,0,4,1,4
TRBV6-2/3/5/6,TRBJ2-2,CASRRGWDSNIANTGELFF,0,4,1,4
TRBV4-3,TRBJ2-1,CASSQDMRQGVLSYNEQFF,0,4,1,4
TRBV4-3,TRBJ2-3,CASSQKSWNRLADTDTQYF,0,4,1,4
TRBV12-5,TRBJ1-2,CASGLFPLTAFPNYGYTF,0,4,1,4
TRBV12-5,TRBJ2-3,CASGLQGTRGYYTDTQYF,0,4,1,4
TRBV10-3,TRBJ2-5,CATTTGLADTNYQETQYF,0,4,1,4
TRBV2,TRBJ2-3,CASLFTPRQAITTDTQYF,0,4,1,4
TRBV2,TRBJ2-1,CASGRPPGLAGIYNEQFF,0,4,1,4
TRBV12-3/4,TRBJ2-2,CASTLGTSGTPPGGELFF,0,4,1,4
TRBV12-3/4,TRBJ1-2,CASTPVGFRDLGPYGYTF,0,4,1,4
TRBV6-2/3/5/6,TRBJ1-5,CASSFQFSVLRDNQPQHF,0,4,1,4
TRBV6-2/3/5/6,TRBJ2-5,CASSLLASGRAWQETQYF,0,4,1,4
TRBV12-3/4,TRBJ2-7,CASSLALAGTSGAYEQYF,0,4,1,4
TRBV12-3/4,TRBJ2-3,CASSSPVTGTSKTDTQYF,0,4,1,4
TRBV27,TRBJ2-2,CASSSTSGGPSNTGELFF,0,4,1,4
TRBV6-2/3/5/6,TRBJ1-3,CASSYIRSRESSGNTIYF,0,4,1,4
TRBV2,TRBJ2-1,CASSEAHPRTWQHNEQFF,0,4,1,4
TRBV6-1,TRBJ1-2,CASSEGFRIGVPNYGYTF,0,4,1,4
TRBV6-1,TRBJ1-5,CASSKSPQGRASNQPQHF,0,4,1,4
TRBV7-2,TRBJ1-1,CASSFRVTGVTSYTEAFF,0,4,1,4
TRBV5-6,TRBJ2-5,CASSLGDLGVAMQETQYF,0,4,1,4
TRBV7-2,TRBJ2-5,CASSLAGDGRGRVETQYF,0,4,1,4
TRBV7-2,TRBJ1-4,CASSLGDRALATNEKLFF,0,4,1,4
TRBV11-2,TRBJ2-1,CASSSGGASGVSYNEQFF,0,4,1,4
TRBV7-2,TRBJ2-4,CASSSGLAGQSDKNIQYF,0,4,1,4
TRBV2,TRBJ2-1,CASSYRALAVNLNNEQFF,0,4,1,4
TRBV3-1,TRBJ2-5,CASSLRTSGGVYQETQYF,0,4,1,4
TRBV4-2,TRBJ2-7,CASSLHPGLAGSGGEQYF,0,4,1,4
TRBV3-1,TRBJ2-1,CASSPRAVLRSSYNEQFF,0,4,1,4
TRBV14,TRBJ2-7,CASSRKEVRLAGDHEQYF,0,4,1,4
TRBV3-1,TRBJ2-6,CASSQPDRVLLGANVLTF,0,4,1,4
TRBV4-2,TRBJ2-2,CASSQGPGLADSTGELFF,0,4,1,4
TRBV3-1,TRBJ2-4,CASSQDTSSGGAGDIQYF,0,4,1,4
TRBV4-2,TRBJ1-1,CASSQDNRAGGLGGEAFF,0,4,1,4
TRBV9,TRBJ2-3,CASSVGEREGPVADTQYS,0,4,1,4
TRBV7-8,TRBJ2-1,CASSTREREPDPYNEQFF,0,4,1,4
TRBV6-2/3/5/6,TRBJ2-6,CASRLPGLAGSGANVLTF,0,4,1,4
TRBV6-4,TRBJ2-6,CASRGQVAPFSGANVLTF,0,4,1,4
TRBV20-1,TRBJ2-4,CSAGKGTSGDLAKNIQYF,0,4,1,4
TRBV20-1,TRBJ2-1,CSARVRNGGGRPYNEQFF,0,4,1,4
TRBV20-1,TRBJ2-1,CSARDALAGFSSYNEQFF,0,4,1,4
TRBV20-1,TRBJ2-7,CSARNLWTSGEGHYEQYF,0,4,1,4
TRBV20-1,TRBJ1-6,CSAGEANLKSSYNSPLHF,0,4,1,4
TRBV20-1,TRBJ2-3,CSAEHRTSGGTSTDTQYF,0,4,1,4
TRBV29-1,TRBJ2-1,CSVDKWDYSKRGVNEQFF,0,4,1,4
TRBV12-5,TRBJ2-1,CACGPRGGGEGTNEQFF,0,4,1,4
TRBV12-5,TRBJ2-3,CASALAHLAGGTDTQYF,0,4,1,4
TRBV12-5,TRBJ2-1,CASGLAAGAGEYNEQFF,0,4,1,4
TRBV30,TRBJ2-1,CAWSVRTSGRVYGEQFF,0,4,1,4
TRBV15,TRBJ2-2,CATSSRLAGVGTGELFF,0,4,1,4
TRBV15,TRBJ2-1,CATSRDVAGGVYNEQFF,0,4,1,4
TRBV15,TRBJ2-1,CATSRDTGSPSYNEQFF,0,4,1,4
TRBV19,TRBJ1-1,CASDKRAQGRRETEAFF,0,4,1,4
TRBV19,TRBJ1-1,CASSVPWGTPMNTEAFF,0,4,1,4
TRBV18,TRBJ2-1,CASSRSLGPEDYNEQFF,0,4,1,4
TRBV18,TRBJ1-1,CASSPIGNSWGYTEAFF,0,4,1,4
TRBV27,TRBJ2-6,CASCQGNYYSGANVLTF,0,4,1,4
TRBV12-3/4,TRBJ2-2,CASVGPEGGRNTGELFF,0,4,1,4
TRBV28,TRBJ2-7,CASSLWKLAGGPGEQYF,0,4,1,4
TRBV6-2/3/5/6,TRBJ2-7,CASSLGRLAGDSYEQYF,0,4,1,4
TRBV12-3/4,TRBJ1-5,CASSLGTGVRSNQPQHF,0,4,1,4
TRBV6-2/3/5/6,TRBJ2-1,CASSLTPFSGSNDEQFF,0,4,1,4
TRBV6-2/3/5/6,TRBJ2-1,CASSYSKERYFYNEQFF,0,4,1,4
TRBV6-2/3/5/6,TRBJ1-5,CASSPRQGRHGNQPQHF,0,4,1,4
TRBV12-3/4,TRBJ2-5,CASSQQVGGRYQETQYF,0,4,1,4
TRBV6-1,TRBJ1-2,CASSEASWDRGRYGYTF,0,4,1,4
TRBV2,TRBJ2-4,CASSEGGGGRAKNIQYF,0,4,1,4
TRBV2,TRBJ2-1,CASSTTTSGKTINEQFF,0,4,1,4
TRBV6-1,TRBJ1-2,CASSKTGGGPTNYGYTF,0,4,1,4
TRBV7-2,TRBJ2-3,CASSFLTGGGSSDTQYF,0,4,1,4
TRBV5-6,TRBJ1-5,CASSFRRAGALDQPQHF,0,4,1,4
TRBV6-2/3/5/6,TRBJ1-6,CASSFTRPGGSNSPLHF,0,4,1,4
TRBV5-6,TRBJ2-1,CASSLEAGRGLYNEQFF,0,4,1,4
TRBV7-3,TRBJ2-6,CASSLSEVISGANVLTF,0,4,1,4
TRBV7-2,TRBJ2-1,CASSLVGGPLNYNEQFF,0,4,1,4
TRBV11-2,TRBJ2-3,CASSLVPLAGRTDTQYF,0,4,1,4
TRBV7-2,TRBJ2-7,CASSLARLRTSPYEQYF,0,4,1,4
TRBV7-2,TRBJ2-5,CASSLAGTSGGQETQYF,0,4,1,4
TRBV5-4,TRBJ2-3,CASSLGPRDTNTDTQYF,0,4,1,4
TRBV11-3,TRBJ2-1,CASSLGGTTFGDDEQFF,0,4,1,4
TRBV7-8,TRBJ2-7,CASSLGVVAGGFYEQYF,0,4,1,4
TRBV7-9,TRBJ1-5,CASSLESSLGGNQPQHF,0,4,1,4
TRBV7-3,TRBJ1-1,CASSLIGGNEQVAEAFF,0,4,1,4
TRBV11-2,TRBJ2-5,CASSSPPAEAGDETQYF,0,4,1,4
TRBV3-1,TRBJ2-2,CASSLRRDRGNTGELFF,0,4,1,4
TRBV7-2,TRBJ2-7,CASSLFPRGGSPYEQYF,0,4,1,4
TRBV7-9,TRBJ2-7,CASSLSPVGDRFYEQYF,0,4,1,4
TRBV7-2,TRBJ2-2,CASSLWTLATNTGELFF,0,4,1,4
TRBV3-1,TRBJ2-5,CASSLRDRGLLQETQYF,0,4,1,4
TRBV6-2/3/5/6,TRBJ2-3,CASSPMRKVAGTDTQYF,0,4,1,4
TRBV2,TRBJ2-6,CASSPGGGRIGANVLTF,0,4,1,4
TRBV7-2,TRBJ2-3,CASSPAAAGSRTDTQYF,0,4,1,4
TRBV7-2,TRBJ2-4,CASSPWTSGTGKNIQYF,0,4,1,4
TRBV3-1,TRBJ2-7,CASSQPLSISGDYEQYF,0,4,1,4
TRBV3-1,TRBJ2-1,CASSQVGQVGSYNEQFF,0,4,1,4
TRBV3-1,TRBJ2-7,CASSQGRQDWGFYEQYF,0,4,1,4
TRBV7-8,TRBJ2-5,CASSEEKNRDFQETQYF,0,4,1,4
TRBV5-8,TRBJ2-5,CASRPRIQGAYRETQYF,0,4,1,4
TRBV6-4,TRBJ2-2,CASRGYAGVLNTGELFF,0,4,1,4
TRBV6-2/3/5/6,TRBJ2-7,CASRTTSGRRASYEQYF,0,4,1,4
TRBV12-3/4,TRBJ2-3,CASNKFRLAGERDTRYF,0,4,1,4
TRBV5-1,TRBJ1-1,CASSFGDRGSLNTEAFF,0,4,1,4
TRBV5-1,TRBJ2-1,CASSLEGLAGGVNEQFF,0,4,1,4
TRBV5-1,TRBJ1-4,CASSLERRNLANEKLFF,0,4,1,4
TRBV4-3,TRBJ2-1,CASSPQVAEAFFGEQFF,0,4,1,4
TRBV4-1,TRBJ1-4,CASSQVSFRVSNEKLFF,0,4,1,4
TRBV4-3,TRBJ2-1,CASSQEEELAGFNEQFF,0,4,1,4
TRBV5-1,TRBJ2-7,CASSNGLAGGLSYEQYF,0,4,1,4
TRBV20-1,TRBJ2-3,CSASTSGIPRGADTQYF,0,4,1,4
TRBV20-1,TRBJ2-3,CSASNRRDLASTDTQYF,0,4,1,4
TRBV20-1,TRBJ1-5,CSARDPSRSEANQPQHF,0,4,1,4
TRBV29-1,TRBJ2-1,CSVVGLAGVASYNEQFF,0,4,1,4
TRBV12-3/4,TRBJ2-7,SASSPSGVMGAYEQYF,0,4,1,4
TRBV30,TRBJ1-4,CAWSGPETGSNEKLFF,0,4,1,4
TRBV30,TRBJ2-1,CAWSGSGREFNNEQFF,0,4,1,4
TRBV19,TRBJ1-1,CARLRGIVGMNTEAFF,0,4,1,4
TRBV7-2,TRBJ2-4,CAGSPRAGIAKNIQYF,0,4,1,4
TRBV10-3,TRBJ1-5,CAISEWGTGDNQPQHF,0,4,1,4
TRBV11-3,TRBJ1-5,CAISSHRGCSNQPQHF,0,4,1,4
TRBV3-1,TRBJ2-2,CATTLSQAKSTGELFF,0,4,1,4
TRBV24-1,TRBJ2-1,CATSEPDRGANNEQFF,0,4,1,4
TRBV15,TRBJ2-6,CATSPTADSGANVLTF,0,4,1,4
TRBV15,TRBJ1-6,CATSTRDRFLNSPLHF,0,4,1,4
TRBV15,TRBJ2-1,CATSRDRLRMVNEQFF,0,4,1,4
TRBV25-1,TRBJ2-1,CATQLADRGPNNEQFF,0,4,1,4
TRBV19,TRBJ1-1,CASSAQGLPSGTEAFF,0,4,1,4
TRBV19,TRBJ2-2,CASSILTDPGTGELFF,0,4,1,4
TRBV19,TRBJ1-5,CASSIVKMTRDQPQHF,0,4,1,4
TRBV19,TRBJ2-1,CASSPLRSGGKNEQFF,0,4,1,4
TRBV19,TRBJ2-5,CASSPRLQPHQETQYF,0,4,1,4
TRBV19,TRBJ2-2,CASRSAGGSRTGELFF,0,4,1,4
TRBV18,TRBJ2-1,CASSPPTGGSYNEQFF,0,4,1,4
TRBV18,TRBJ1-5,CASSPLGVGSNQPQHF,0,4,1,4
TRBV7-2,TRBJ1-5,CASQKVGGDSNQPQHF,0,4,1,4
TRBV27,TRBJ2-7,CASAIQGRGPSYEQYF,0,4,1,4
TRBV7-2,TRBJ1-4,CASGRQGARANEKLFF,0,4,1,4
TRBV9,TRBJ2-2,CASGEERGPGGGELFF,0,4,1,4
TRBV12-3/4,TRBJ1-2,CASTSPSSEVNYGYTF,0,4,1,4
TRBV3-1,TRBJ2-7,CASTPGDSPGVDERYF,0,4,1,4
TRBV18,TRBJ1-1,CASTTGTGGMNTEAFF,0,4,1,4
TRBV6-2/3/5/6,TRBJ1-2,CASSFSPTGANYGYTF,0,4,1,4
TRBV6-2/3/5/6,TRBJ2-2,CASSLGSGGAAGELFF,0,4,1,4
TRBV6-2/3/5/6,TRBJ2-7,CASSLEWGGASYEQYF,0,4,1,4
TRBV27,TRBJ1-5,CASSLWATPGDQPQHF,0,4,1,4
TRBV6-2/3/5/6,TRBJ2-2,CASSLRPGGRSGELFF,0,4,1,4
TRBV6-1,TRBJ2-1,CASSLALPQGNNEQFF,0,4,1,4
TRBV12-3/4,TRBJ2-5,CASSLARGEGLETQYF,0,4,1,4
TRBV28,TRBJ2-7,CASSSTDRVILYEQYF,0,4,1,4
TRBV6-2/3/5/6,TRBJ1-6,CASSYLPGEQNSPLHF,0,4,1,4
TRBV6-2/3/5/6,TRBJ2-3,CASSYSLADLTDTQYF,0,4,1,4
TRBV6-2/3/5/6,TRBJ2-1,CASSYSILAGENEQFF,0,4,1,4
TRBV6-2/3/5/6,TRBJ2-3,CASSYSRTHGGDTQYF,0,4,1,4
TRBV6-2/3/5/6,TRBJ2-7,CASSYPGESGSYEQYF,0,4,1,4
TRBV6-4,TRBJ2-5,CASSRGGGTGQETQYF,0,4,1,4
TRBV12-3/4,TRBJ1-5,CASSAEAGGSNQPQHF,0,4,1,4
TRBV12-3/4,TRBJ1-2,CASSADRGRSNYGYTF,0,4,1,4
TRBV6-1,TRBJ2-1,CASSDLAGGPYNEQFF,0,4,1,4
TRBV2,TRBJ1-6,CASSDPAGVYNSPLHF,0,4,1,4
TRBV25-1,TRBJ2-1,CASSEFEGTGQREQFF,0,4,1,4
TRBV6-1,TRBJ2-1,CASSEGLAGAYNEQLS,0,4,1,4
TRBV25-1,TRBJ1-1,CASSEDRGRMNTEAFF,0,4,1,4
TRBV11-2,TRBJ2-7,CASSFSFQGNSYEQYF,0,4,1,4
TRBV7-8,TRBJ2-7,CASSFPGTGGAYEQYF,0,4,1,4
TRBV7-2,TRBJ2-5,CASSFSAGTLQETQYF,0,4,1,4
TRBV13,TRBJ2-1,CASSFVTSGSLHEQFF,0,4,1,4
TRBV5-8,TRBJ2-2,CASSFTGTGRTGELFF,0,4,1,4
TRBV7-8,TRBJ2-2,CASSFTAGGGTGELFF,0,4,1,4
TRBV7-8,TRBJ2-5,CASSFRTATPLGTQYF,0,4,1,4
TRBV5-4,TRBJ1-6,CASSLYRAGLNSPLHF,0,4,1,4
TRBV7-9,TRBJ2-3,CASSLVTSASTDTQYF,0,4,1,4
TRBV5-6,TRBJ1-2,CASSLARDRYTYGYTF,0,4,1,4
TRBV5-6,TRBJ2-7,CASSLGGALSSYEQYF,0,4,1,4
TRBV7-2,TRBJ2-1,CASSLRGPSGNNEQFF,0,4,1,4
TRBV7-9,TRBJ2-7,CASSLVGQGVSYEQYF,0,4,1,4
TRBV7-2,TRBJ2-1,CASSLDRLTFYNEQFF,0,4,1,4
TRBV7-9,TRBJ2-4,CASSLDRDAAKNIQYF,0,4,1,4
TRBV7-2,TRBJ2-1,CASSLRASGRVGEQFF,0,4,1,4
TRBV7-9,TRBJ1-4,CASSLRGTVTNEKLFF,0,4,1,4
TRBV7-9,TRBJ2-2,CASSLRGDRGTGELFF,0,4,1,4
TRBV11-2,TRBJ2-7,CASSSATSGVSYEQYF,0,4,1,4
TRBV5-4,TRBJ2-1,CASSSTSGDSYNEQFF,0,4,1,4
TRBV11-1,TRBJ2-5,CASSSPGPRTRETQYF,0,4,1,4
TRBV11-2,TRBJ2-6,CASSSRTLSGANVLTF,0,4,1,4
TRBV7-3,TRBJ1-1,CASSLRGGRVNTEAFF,0,4,1,4
TRBV7-9,TRBJ2-1,CASSPYTSGGYNEQFF,0,4,1,4
TRBV13,TRBJ2-5,CASSPRLAEPGETQYF,0,4,1,4
TRBV5-5,TRBJ2-2,CASSPDGSRGTGELFF,0,4,1,4
TRBV12-3/4,TRBJ2-7,CASSPRPSGRANEQYF,0,4,1,4
TRBV7-9,TRBJ2-7,CASSPKQGAAIFEQYF,0,4,1,4
TRBV7-8,TRBJ2-7,CASSPRGSGIQYEQYF,0,4,1,4
TRBV6-4,TRBJ1-6,CASSHGQGSYNSPLHF,0,4,1,4
TRBV3-1,TRBJ2-1,CASSQAGTGLYNEQFF,0,4,1,4
TRBV4-2,TRBJ2-3,CASSQRLAGGTDTQYF,0,4,1,4
TRBV3-1,TRBJ2-7,CASSQAVGLSSYEQYF,0,4,1,4
TRBV3-1,TRBJ1-5,CASSQDAGGLNQPQHF,0,4,1,4
TRBV4-2,TRBJ2-1,CASSQEGPGGANEQFF,0,4,1,4
TRBV9,TRBJ1-1,CASSAPWDGVNTEAFF,0,4,1,4
TRBV7-9,TRBJ2-2,CASSAQRPQGTGGLFF,0,4,1,4
TRBV6-1,TRBJ2-5,CASSEDIAGGEETQYF,0,4,1,4
TRBV6-2/3/5/6,TRBJ2-1,CASSTEGPRSYNEQFF,0,4,1,4
TRBV13,TRBJ2-5,CASSTRTSGKQETQYF,0,4,1,4
TRBV11-3,TRBJ2-7,CASSNQRNRDSHEQYF,0,4,1,4
TRBV7-2,TRBJ1-5,CASSNEGGWSNQPQHF,0,4,1,4
TRBV6-2/3/5/6,TRBJ2-2,CASRPTGTGDTGELFF,0,4,1,4
TRBV6-2/3/5/6,TRBJ2-7,CASRGLGASRHYEQYF,0,4,1,4
TRBV7-9,TRBJ1-2,CASRDGTASERRGYTF,0,4,1,4
TRBV6-4,TRBJ1-5,CASNSYIGFSNQPQHF,0,4,1,4
TRBV5-6,TRBJ1-1,CASSAGTGLMNTEAFF,0,4,1,4
TRBV27,TRBJ1-5,CGSRPSSWTANQPQHF,0,4,1,4
TRBV19,TRBJ1-5,CTSSIEGQGGNQPQHF,0,4,1,4
TRBV10-2,TRBJ2-1,CASSDPGGGKYNEQFF,0,4,1,4
TRBV5-1,TRBJ1-5,CASSLGTGGADQPQHF,0,4,1,4
TRBV5-1,TRBJ1-1,CASSLHNGGGNTEAFF,0,4,1,4
TRBV5-1,TRBJ2-2,CASSSFQGPNTGELFF,0,4,1,4
TRBV5-1,TRBJ2-7,CASSSYPGQGFGEQYF,0,4,1,4
TRBV5-1,TRBJ2-3,CASSLPGGPPTDTQYF,0,4,1,4
TRBV5-1,TRBJ1-1,CASSPGQGAMNTEAFF,0,4,1,4
TRBV4-1,TRBJ2-7,CASSQYPGQATYEQYF,0,4,1,4
TRBV4-1,TRBJ2-5,CASSQAGGGYQETQYF,0,4,1,4
TRBV4-1,TRBJ1-2,CASSQGSTEANYGYTF,0,4,1,4
TRBV4-1,TRBJ1-4,CASSQDQTGGVEKLFF,0,4,1,4
TRBV4-1,TRBJ1-1,CASSQEAITLNTEAFF,0,4,1,4
TRBV7-2,TRBJ2-1,CASSKDPSGRGHEQFF,0,4,1,4
TRBV5-1,TRBJ2-7,CASRPSAGQGIYEQYF,0,4,1,4
TRBV20-1,TRBJ2-5,CSAHASSGGVAETQYF,0,4,1,4
TRBV20-1,TRBJ2-1,CSATIGWTSGSDEQFF,0,4,1,4
TRBV20-1,TRBJ2-1,CSARPTEAGSVYEQFF,0,4,1,4
TRBV20-1,TRBJ2-3,CSARPGLAVSTDTQYF,0,4,1,4
TRBV20-1,TRBJ1-5,CSARGLGPRGNQPQHF,0,4,1,4
TRBV20-1,TRBJ2-5,CSARDPGTLFQETQYF,0,4,1,4
TRBV20-1,TRBJ1-4,CSARDARTSTREKLFF,0,4,1,4
TRBV20-1,TRBJ2-6,CSARDAYLSGANVLTF,0,4,1,4
TRBV20-1,TRBJ2-3,CSAVTADRVRPDTQYF,0,4,1,4
TRBV20-1,TRBJ2-7,CSASVGRGGLNYEQYF,0,4,1,4
TRBV29-1,TRBJ2-1,CSVERLAGNIYNEQFF,0,4,1,4
TRBV29-1,TRBJ2-3,CSVQNSGGSSTDTQYF,0,4,1,4
TRBV29-1,TRBJ2-6,CSVGQGASGGANVLTF,0,4,1,4
TRBV29-1,TRBJ2-3,CSAEGGTGFRTDTQYF,0,4,1,4
TRBV5-6,TRBJ1-2,RASSLGPGPGWYGYTF,0,4,1,4
TRBV12-5,TRBJ1-1,CASGLAEGSGTEAFF,0,4,1,4
TRBV15,TRBJ1-5,CASSRPTALLQPQHF,0,4,1,4
TRBV30,TRBJ2-3,CAWSLGAGEGNTQYF,0,4,1,4
TRBV30,TRBJ2-3,CAWTELAGGPDTQYF,0,4,1,4
TRBV30,TRBJ2-3,CAWSVGGAATDTQYF,0,4,1,4
TRBV30,TRBJ1-3,CAWSGQGLSGNTIYF,0,4,1,4
TRBV6-2/3/5/6,TRBJ1-1,CAGSYKAGRMTEAFF,0,4,1,4
TRBV10-3,TRBJ2-1,CAIRYGDKPYNEQFF,0,4,1,4
TRBV15,TRBJ2-2,CATSPGGEVTGELFF,0,4,1,4
TRBV24-1,TRBJ2-1,CATSDRQARGNEQFF,0,4,1,4
TRBV15,TRBJ2-5,CATSRSGTTRETQYF,0,4,1,4
TRBV19,TRBJ2-3,CASRNSDDYTDTQYF,0,4,1,4
TRBV19,TRBJ1-1,CASTDLRGKKTEAFF,0,4,1,4
TRBV19,TRBJ2-1,CASSIAGEGYNEQFF,0,4,1,4
TRBV19,TRBJ2-2,CASSRGQANTGELFF,0,4,1,4
TRBV7-6,TRBJ2-1,CASSLAVDSYNEQFF,0,4,1,4
TRBV19,TRBJ1-1,CASSPSGGRYGEAFF,0,4,1,4
TRBV19,TRBJ2-7,CASRCDGTEDYEQYF,0,4,1,4
TRBV18,TRBJ1-5,CASSPPGRGHQPQHF,0,4,1,4
TRBV18,TRBJ1-5,CASSPGQSSNQPQHF,0,4,1,4
TRBV5-4,TRBJ2-7,CASCSLPDSFYEQYF,0,4,1,4
TRBV9,TRBJ2-1,CASRPGLAGEGEQFF,0,4,1,4
TRBV2,TRBJ2-2,CASVLKRLSTGELFF,0,4,1,4
TRBV7-9,TRBJ2-7,CASGLAYRGVYEQYF,0,4,1,4
TRBV6-2/3/5/6,TRBJ1-2,CASGSGALFNYGYTF,0,4,1,4
TRBV7-2,TRBJ2-2,CASIRSGRNTGELFF,0,4,1,4
TRBV5-6,TRBJ2-1,CASMRAGGIYNEQFF,0,4,1,4
TRBV12-3/4,TRBJ1-1,CASSFGAPSNTEAFF,0,4,1,4
TRBV12-3/4,TRBJ2-5,CASSFGTSGLETQYF,0,4,1,4
TRBV12-3/4,TRBJ2-1,CASSLGQSSYNEQFF,0,4,1,4
TRBV12-3/4,TRBJ2-3,CASSLGRRRGDTQYF,0,4,1,4
TRBV6-2/3/5/6,TRBJ1-1,CASSLFGQENTEAFF,0,4,1,4
TRBV6-2/3/5/6,TRBJ2-3,CASSLQGGSTDTQYF,0,4,1,4
TRBV12-3/4,TRBJ1-1,CASSLVDRDYREAFF,0,4,1,4
TRBV12-3/4,TRBJ2-7,CASSLSSGGKYEQYF,0,4,1,4
TRBV12-3/4,TRBJ2-7,CASSSHTLAGYEQYF,0,4,1,4
TRBV28,TRBJ2-7,CASSSHDRVPYEQYF,0,4,1,4
TRBV12-3/4,TRBJ2-7,CASSSGTHGSYEQYF,0,4,1,4
TRBV6-2/3/5/6,TRBJ2-5,CASSWASGKPETQYF,0,4,1,4
TRBV6-2/3/5/6,TRBJ1-1,CASSYSAETNTEDFF,0,4,1,4
TRBV6-2/3/5/6,TRBJ2-1,CASSYSGSSYNEQFF,0,4,1,4
TRBV6-2/3/5/6,TRBJ2-7,CASSYSIGGSDEQYF,0,4,1,4
TRBV6-2/3/5/6,TRBJ1-4,CASSYSKAVSGKLFF,0,4,1,4
TRBV6-2/3/5/6,TRBJ2-5,CASSYSDRGEETQYF,0,4,1,4
TRBV6-2/3/5/6,TRBJ1-2,CASSYRPTDPYGYTF,0,4,1,4
TRBV6-2/3/5/6,TRBJ1-3,CASSYSRGTGNTIYF,0,4,1,4
TRBV6-2/3/5/6,TRBJ1-1,CASSYRGRMNTEAFF,0,4,1,4
TRBV6-2/3/5/6,TRBJ2-1,CASSLAGTPYNEQFF,0,4,1,4
TRBV6-2/3/5/6,TRBJ1-5,CASSLTGGKNQPQHF,0,4,1,4
TRBV7-9,TRBJ2-7,CASSLGQGSFYEQYF,0,4,1,4
TRBV6-2/3/5/6,TRBJ2-1,CASSPSGGRYNEQFF,0,4,1,4
TRBV6-4,TRBJ1-5,CASSPSLGGYQPQHF,0,4,1,4
TRBV28,TRBJ2-7,CASSPQGQGRREQYF,0,4,1,4
TRBV6-2/3/5/6,TRBJ2-5,CASSPSGALQETQYF,0,4,1,4
TRBV6-2/3/5/6,TRBJ2-3,CASSPWLTGTDTQYF,0,4,1,4
TRBV6-2/3/5/6,TRBJ2-4,CASSPRGGTQNIQYF,0,4,1,4
TRBV6-2/3/5/6,TRBJ2-5,CASSRTGGLQETQYF,0,4,1,4
TRBV27,TRBJ2-7,CASSQPDSRDYEQYY,0,4,1,4
TRBV2,TRBJ2-3,CASSARQGSTDTQYF,0,4,1,4
TRBV6-1,TRBJ2-1,CASSAGTSGYNEQFF,0,4,1,4
TRBV6-1,TRBJ1-5,CASSGAGERNQPQHF,0,4,1,4
TRBV6-4,TRBJ2-3,CASSGTRVGTDTQYF,0,4,1,4
TRBV6-1,TRBJ2-5,CASSGTQGDQETQYF,0,4,1,4
TRBV25-1,TRBJ1-2,CASSDWGQINYGYTF,0,4,1,4
TRBV12-3/4,TRBJ2-5,CASSDPGATQETQYF,0,4,1,4
TRBV25-1,TRBJ2-3,CASSDGGLSTDTQYF,0,4,1,4
TRBV2,TRBJ2-3,CASSDDTQAYDTQYF,0,4,1,4
TRBV6-1,TRBJ1-1,CASSEFQGAYTEAFF,0,4,1,4
TRBV2,TRBJ1-5,CASSELEISNQPQHF,0,4,1,4
TRBV2,TRBJ2-1,CASSEGSGAPNEQFF,0,4,1,4
TRBV6-1,TRBJ2-5,CASSENPFGTETQYF,0,4,1,4
TRBV12-3/4,TRBJ2-1,CASSSLWSSYNEQFF,0,4,1,4
TRBV7-2,TRBJ2-1,CASSFLAGVRNEQFF,0,4,1,4
TRBV7-9,TRBJ1-5,CASSFGTASNQPQHF,0,4,1,4
TRBV5-4,TRBJ2-3,CASSLPGQGADTQYF,0,4,1,4
TRBV5-4,TRBJ1-2,CASSLAAGYSYGYTF,0,4,1,4
TRBV5-5,TRBJ1-2,CASSLAGGQNYGYTF,0,4,1,4
TRBV5-6,TRBJ1-5,CASSLGATNNQPQHF,0,4,1,4
TRBV13,TRBJ2-3,CASSLTSGFTDTQYF,0,4,1,4
TRBV7-9,TRBJ2-3,CASSLSLATTDTQYF,0,4,1,4
TRBV7-6,TRBJ2-7,CASSLLVRDKYEQYF,0,4,1,4
TRBV5-6,TRBJ2-5,CASSLLTSGEETQYF,0,4,1,4
TRBV6-2/3/5/6,TRBJ2-2,CASSLWSSNTGELFF,0,4,1,4
TRBV7-9,TRBJ1-5,CASSLQGGGNQPQHF,0,4,1,4
TRBV7-2,TRBJ2-7,CASSLVSGGTYEQYF,0,4,1,4
TRBV7-9,TRBJ1-1,CASSLVVPGGTEAFF,0,4,1,4
TRBV7-2,TRBJ2-7,CASSLAGQVPHEQYF,0,4,1,4
TRBV7-9,TRBJ1-1,CASSLADSGNTEAFF,0,4,1,4
TRBV7-2,TRBJ2-1,CASSLAPSSHNEQFF,0,4,1,4
TRBV7-6,TRBJ2-1,CASSLAAQAANEQFF,0,4,1,4
TRBV7-2,TRBJ1-5,CASSLAARADQPQHF,0,4,1,4
TRBV11-3,TRBJ2-1,CASSLAGGPSNEQFF,0,4,1,4
TRBV7-9,TRBJ1-5,CASSLGPGVNQPQHF,0,4,1,4
TRBV7-9,TRBJ2-7,CASSLGRDSSYEQYF,0,4,1,4
TRBV7-9,TRBJ1-1,CASSLGEGMNTEAFF,0,4,1,4
TRBV7-2,TRBJ1-2,CASSLDGTGRRGYTF,0,4,1,4
TRBV7-2,TRBJ2-3,CASSLERGNPDTQYF,0,4,1,4
TRBV7-2,TRBJ2-5,CASSLEGAREETQYF,0,4,1,4
TRBV7-2,TRBJ2-5,CASSLMWGKQETQYF,0,4,1,4
TRBV7-3,TRBJ2-7,CASSLTGTVSYEQYF,0,4,1,4
TRBV7-9,TRBJ1-1,CASSLTGRMNTEAFF,0,4,1,4
TRBV7-2,TRBJ2-5,CASSLNPGVGETQYF,0,4,1,4
TRBV11-2,TRBJ1-6,CASSLNRGGNSPLHF,0,4,1,4
TRBV7-6,TRBJ1-5,CASSSTGIGNQPQHF,0,4,1,4
TRBV7-2,TRBJ2-7,CASSSSGSVSYEQYF,0,4,1,4
TRBV7-2,TRBJ2-1,CASSSSGSSYNEQFF,0,4,1,4
TRBV7-8,TRBJ2-7,CASSSRGHDYYEQYF,0,4,1,4
TRBV7-9,TRBJ1-3,CASSSGLRYGNTIYF,0,4,1,4
TRBV3-1,TRBJ2-7,CASSSSGTGAGEQYF,0,4,1,4
TRBV12-3/4,TRBJ2-1,CASSSVGLVYNEQFF,0,4,1,4
TRBV7-6,TRBJ2-4,CASSSGTGPQNIQYF,0,4,1,4
TRBV13,TRBJ2-5,CASSSTSGGQETQYF,0,4,1,4
TRBV6-2/3/5/6,TRBJ2-1,CASSWRGGMDNEQFF,0,4,1,4
TRBV14,TRBJ2-7,CASSLFGSGVYEQYF,0,4,1,4
TRBV7-3,TRBJ2-1,CASSLGTSGGNEQFF,0,4,1,4
TRBV13,TRBJ2-5,CASSLGRGERETQYF,0,4,1,4
TRBV27,TRBJ2-1,CASSLGRNPYNEQFF,0,4,1,4
TRBV7-2,TRBJ1-5,CASSLTRGRGQPQHF,0,4,1,4
TRBV7-2,TRBJ2-7,CASSLALGLGYEQYF,0,4,1,4
TRBV27,TRBJ2-1,CASSPAPGAYNEQFF,0,4,1,4
TRBV7-6,TRBJ2-5,CASSPPGGRVETQYF,0,4,1,4
TRBV7-8,TRBJ2-1,CASSPGRGAFYEQFF,0,4,1,4
TRBV6-2/3/5/6,TRBJ2-1,CASSPDWRGGNEQFF,0,4,1,4
TRBV9,TRBJ1-1,CASSPKDRVRTEAFF,0,4,1,4
TRBV3-1,TRBJ1-1,CASSPGGGQNTEAFF,0,4,1,4
TRBV5-6,TRBJ2-7,CASSPGQAYSYEQYF,0,4,1,4
TRBV7-9,TRBJ2-3,CASSPTGGGTDTQYF,0,4,1,4
TRBV7-9,TRBJ2-1,CASSPDRGLPYEQFF,0,4,1,4
TRBV7-6,TRBJ2-1,CASSHRSLPYNEQFF,0,4,1,4
TRBV5-4,TRBJ1-1,CASSQGAGVSTEAFS,0,4,1,4
TRBV11-3,TRBJ2-7,CASSQRPGPIYEQYF,0,4,1,4
TRBV14,TRBJ1-6,CASSQVPGNNSPLHF,0,4,1,4
TRBV14,TRBJ2-1,CASSQVTSGRGRRFF,0,4,1,4
TRBV3-1,TRBJ1-1,CASSQGGGGIGEAFF,0,4,1,4
TRBV3-1,TRBJ2-5,CASSQGWTSVETQYF,0,4,1,4
TRBV14,TRBJ2-7,CASSQDSALSYEQYF,0,4,1,4
TRBV3-1,TRBJ2-5,CASSQDLSGGETQYF,0,4,1,4
TRBV4-2,TRBJ2-5,CASSQDAPGGETQYF,0,4,1,4
TRBV3-1,TRBJ2-7,CASSQDLAGYDEQYF,0,4,1,4
TRBV3-1,TRBJ2-5,CASSQDQGGKETQYF,0,4,1,4
TRBV14,TRBJ2-1,CASSQDQLILNEQFF,0,4,1,4
TRBV4-2,TRBJ1-5,CASSQEYGGAQPQHF,0,4,1,4
TRBV9,TRBJ1-1,CASSVLGRSDTEAFF,0,4,1,4
TRBV9,TRBJ2-7,CASSVSRGYSYEQYF,0,4,1,4
TRBV9,TRBJ1-5,CASSVYPYSNQPQHF,0,4,1,4
TRBV9,TRBJ1-4,CASSATPSPDEKLFF,0,4,1,4
TRBV9,TRBJ2-3,CASSAGLAATDTQYF,0,4,1,4
TRBV7-2,TRBJ2-6,CASSATGSGANVLTF,0,4,1,4
TRBV7-2,TRBJ2-7,CASSGTGGRTYEQYF,0,4,1,4
TRBV7-2,TRBJ2-1,CASSEDGLGTAEQFF,0,4,1,4
TRBV7-6,TRBJ2-7,CASSTPGTPDYEQYF,0,4,1,4
TRBV3-1,TRBJ2-2,CASSNYGLPTGELFF,0,4,1,4
TRBV7-9,TRBJ1-1,CASRARADLNTEAFF,0,4,1,4
TRBV2,TRBJ1-4,CASRRGLQVSEKLFF,0,4,1,4
TRBV12-3/4,TRBJ2-7,CASRPGTSGSDEQYF,0,4,1,4
TRBV7-9,TRBJ2-2,CASRPTGMNTGELFF,0,4,1,4
TRBV6-2/3/5/6,TRBJ2-7,CASRHASVSSYEQYF,0,4,1,4
TRBV7-9,TRBJ2-1,CASRQGQGAYNEQFF,0,4,1,4
TRBV6-2/3/5/6,TRBJ2-3,CASRGTGDSTDTQYF,0,4,1,4
TRBV28,TRBJ1-5,CASRIGGQVTQPQHF,0,4,1,4
TRBV7-2,TRBJ2-1,CASRTRASSYNEQFF,0,4,1,4
TRBV5-1,TRBJ2-7,CASSLGSGESYEQYF,0,4,1,4
TRBV5-1,TRBJ2-3,CASSFLRQGTDTQYF,0,4,1,4
TRBV5-1,TRBJ2-1,CASSLVAGGYNEQFF,0,4,1,4
TRBV5-1,TRBJ2-7,CASSLTGDNTYEQYF,0,4,1,4
TRBV5-1,TRBJ2-2,CASSLRRDDHRELFF,0,4,1,4
TRBV5-1,TRBJ2-7,CASSLRQGAGYEQYF,0,4,1,4
TRBV5-1,TRBJ2-1,CASSSEGGGGNEQFF,0,4,1,4
TRBV5-1,TRBJ1-2,CASSSNPGQGGGYTF,0,4,1,4
TRBV4-3,TRBJ1-1,CASSPGGEVGAEAFF,0,4,1,4
TRBV4-1,TRBJ1-6,CASSHRTLGDSPLHF,0,4,1,4
TRBV4-1,TRBJ2-1,CASSQTSGGAYEQFF,0,4,1,4
TRBV4-1,TRBJ1-5,CASSQLGISNQPQHF,0,4,1,4
TRBV4-3,TRBJ2-7,CASSQRDGGGYEQYF,0,4,1,4
TRBV4-1,TRBJ1-6,CASSQAGLRLSSLHS,0,4,1,4
TRBV4-3,TRBJ2-7,CASSQGQGLAYEQYF,0,4,1,4
TRBV4-3,TRBJ1-1,CASSQDLDTSAEAFF,0,4,1,4
TRBV4-3,TRBJ2-1,CASSQDPLAGNEQFF,0,4,1,4
TRBV4-3,TRBJ1-2,CASSQDHGKGYGYTF,0,4,1,4
TRBV4-1,TRBJ1-5,CASSQEVTGDQPQHF,0,4,1,4
TRBV5-1,TRBJ1-1,CASRDDTYMNTEAFF,0,4,1,4
TRBV12-3/4,TRBJ2-2,CASNKLGFYTGELFF,0,4,1,4
TRBV20-1,TRBJ1-1,CSASHGQPTRSEAFF,0,4,1,4
TRBV29-1,TRBJ1-1,CSAPVPGQKNTEAFF,0,4,1,4
TRBV20-1,TRBJ2-7,CSAGGGLAVRGEQYF,0,4,1,4
TRBV20-1,TRBJ2-1,CSAGGLIHSYNEQFF,0,4,1,4
TRBV20-1,TRBJ2-3,CSARVPGQGQDTQYF,0,4,1,4
TRBV20-1,TRBJ1-5,CSARLARGAGQPQHF,0,4,1,4
TRBV20-1,TRBJ2-5,CSARPQRSPVETQYF,0,4,1,4
TRBV20-1,TRBJ2-7,CSARVYAGDTYEQYF,0,4,1,4
TRBV20-1,TRBJ2-2,CSARGSGRPGGELFF,0,4,1,4
TRBV20-1,TRBJ2-2,CSARDYGRDTGELFF,0,4,1,4
TRBV20-1,TRBJ2-1,CSARDLASGYGEQFF,0,4,1,4
TRBV20-1,TRBJ2-5,CSARDLKGRGETQYF,0,4,1,4
TRBV20-1,TRBJ2-1,CSARDVLAGRNEQFF,0,4,1,4
TRBV20-1,TRBJ2-7,CSARDGLAGGYEQYF,0,4,1,4
TRBV20-1,TRBJ2-5,CSARDKKQGTETQYF,0,4,1,4
TRBV20-1,TRBJ2-5,CSARESNSGGWTQYF,0,4,1,4
TRBV20-1,TRBJ2-1,CSARRVESSYNEQFF,0,4,1,4
TRBV20-1,TRBJ2-1,CSAPTRASGSNEQFF,0,4,1,4
TRBV20-1,TRBJ2-2,CSAQMDFTNTGELFF,0,4,1,4
TRBV20-1,TRBJ2-1,CSATLGGEAYNEQFF,0,4,1,4
TRBV20-1,TRBJ2-7,CSATIGGLGAYEQYF,0,4,1,4
TRBV20-1,TRBJ1-1,CSANRDRSASTEAFF,0,4,1,4
TRBV29-1,TRBJ2-5,CSVVPYRGKRETQYF,0,4,1,4
TRBV29-1,TRBJ1-1,CSVAYTGKRGTEAFF,0,4,1,4
TRBV29-1,TRBJ2-3,CSVGPRQGSTDTQYF,0,4,1,4
TRBV29-1,TRBJ2-3,CSVDTSGRATDTQYF,0,4,1,4
TRBV29-1,TRBJ1-1,CSVEEDSGASTEAFF,0,4,1,4
TRBV29-1,TRBJ1-2,CSVEGEQGGYNGYTF,0,4,1,4
TRBV29-1,TRBJ1-1,CSVEDLDSLNTEAFF,0,4,1,4
TRBV29-1,TRBJ2-1,CSVEEGTTTYNEQFF,0,4,1,4
TRBV29-1,TRBJ2-1,CSVESSSGSGEEQFF,0,4,1,4
TRBV29-1,TRBJ2-1,CSVSGTGGYHNEQFF,0,4,1,4
TRBV29-1,TRBJ2-3,CSVGRGPLGTDTQYF,0,4,1,4
TRBV29-1,TRBJ2-2,CSVEGEGTYTGELFF,0,4,1,4
TRBV29-1,TRBJ1-3,CSANLDRGRGNTIYF,0,4,1,4
TRBV12-5,TRBJ2-7,CASGLSQGAYEQYF,0,4,1,4
TRBV5-5,TRBJ1-1,CASGLWGAGTEAFF,0,4,1,4
TRBV15,TRBJ2-1,CASSQVGSYNEQFF,0,4,1,4
TRBV30,TRBJ1-3,CAWTKERDASTIYF,0,4,1,4
TRBV30,TRBJ1-2,CAWTGTGFGYGYTF,0,4,1,4
TRBV30,TRBJ1-4,CAWSGTAYNEKLFF,0,4,1,4
TRBV30,TRBJ1-5,CAWSGQSRNQPQYF,0,4,1,4
TRBV30,TRBJ1-1,CARNPGPLNTEAFF,0,4,1,4
TRBV10-3,TRBJ2-1,CAATSGGSYNEQFF,0,4,1,4
TRBV10-3,TRBJ2-3,CAGGTGKGPDTQYF,0,4,1,4
TRBV3-1,TRBJ1-1,CAGSQDQGYTEAFF,0,4,1,4
TRBV10-3,TRBJ2-1,CAISRGGPPNEQFF,0,4,1,4
TRBV10-3,TRBJ2-5,CAISSDRGGETLYS,0,4,1,4
TRBV10-3,TRBJ2-7,CAISDVESSYEQYF,0,4,1,4
TRBV10-3,TRBJ2-5,CAIRASGRDQTQYF,0,4,1,4
TRBV10-3,TRBJ1-1,CAINQDLGNTEAFF,0,4,1,4
TRBV12-3/4,TRBJ1-6,CATSLRLYNSPLHF,0,4,1,4
TRBV24-1,TRBJ2-2,CATSGDRDTGELFF,0,4,1,4
TRBV15,TRBJ2-3,CATSLARRTDTQYF,0,4,1,4
TRBV24-1,TRBJ2-5,CATRRQPGPETQYF,0,4,1,4
TRBV2,TRBJ2-1,CATLGGGMGNEQFF,0,4,1,4
TRBV5-5,TRBJ2-7,CASLRDLRSYEQYF,0,4,1,4
TRBV2,TRBJ2-1,CASRSGASGNEQFF,0,4,1,4
TRBV19,TRBJ2-7,CASSLRDGAYEQYF,0,4,1,4
TRBV19,TRBJ1-4,CASSDTGDREKLFF,0,4,1,4
TRBV19,TRBJ2-4,CASSSNRALNIQYF,0,4,1,4
TRBV19,TRBJ1-5,CASSKAPGNQPQHF,0,4,1,4
TRBV19,TRBJ2-7,CASSGLDSRRGQYF,0,4,1,4
TRBV7-2,TRBJ2-7,CASRDRSGSYEQYF,0,4,1,4
TRBV18,TRBJ2-7,CASSPAGAGDEQYF,0,4,1,4
TRBV18,TRBJ2-5,CASSLKKYQETQYF,0,4,1,4
TRBV18,TRBJ2-3,CASSPRENTDTQYF,0,4,1,4
TRBV18,TRBJ1-2,CASSPAGTVDGCTF,0,4,1,4
TRBV18,TRBJ1-1,CASSPADMNTEAFF,0,4,1,4
TRBV18,TRBJ2-1,CASSPTTRNNEQFF,0,4,1,4
TRBV18,TRBJ2-5,CASSPPVKKETQYF,0,4,1,4
TRBV18,TRBJ1-2,CASSPGEAARGYTF,0,4,1,4
TRBV6-2/3/5/6,TRBJ2-1,CASWDAGLYNEQFF,0,4,1,4
TRBV19,TRBJ1-2,CASRDRVVRAGYTF,0,4,1,4
TRBV7-2,TRBJ2-7,CASATGQGFYEQYF,0,4,1,4
TRBV27,TRBJ2-7,CASADRPGSYEQYF,0,4,1,4
TRBV2,TRBJ1-6,CASTTGTRNSPLHF,0,4,1,4
TRBV6-2/3/5/6,TRBJ1-6,CASTSEKHNSPLHF,0,4,1,4
TRBV7-6,TRBJ2-5,CASTPGGGLETQYF,0,4,1,4
TRBV27,TRBJ2-1,CASTAREGLNEQFF,0,4,1,4
TRBV12-3/4,TRBJ2-7,CASTMGGPSYEQYF,0,4,1,4
TRBV5-6,TRBJ2-7,CASTKGGTGGEQYF,0,4,1,4
TRBV12-3/4,TRBJ2-1,CASSFRSGRDEQFF,0,4,1,4
TRBV12-3/4,TRBJ2-7,CASSLGGVSYEQYF,0,4,1,4
TRBV27,TRBJ2-1,CASSLSSAYNEQFF,0,4,1,4
TRBV6-2/3/5/6,TRBJ1-2,CASSLGTDNYGYTF,0,4,1,4
TRBV12-3/4,TRBJ2-4,CASSLGGLVRIQYF,0,4,1,4
TRBV6-2/3/5/6,TRBJ1-2,CASSLDGTAYGYTF,0,4,1,4
TRBV6-2/3/5/6,TRBJ2-1,CASSLTAFFNEQFF,0,4,1,4
TRBV12-3/4,TRBJ1-5,CASSLRAGNQPQHF,0,4,1,4
TRBV6-2/3/5/6,TRBJ2-5,CASSLRTGGETQYF,0,4,1,4
TRBV7-9,TRBJ2-3,CASSSDRDPHTQYF,0,4,1,4
TRBV6-2/3/5/6,TRBJ2-5,CASSSLAGQETQYF,0,4,1,4
TRBV12-3/4,TRBJ2-1,CASSSQTGDNEQFF,0,4,1,4
TRBV6-2/3/5/6,TRBJ2-5,CASSYSEPGLTQYF,0,4,1,4
TRBV6-2/3/5/6,TRBJ2-5,CASSYSSRQETQYF,0,4,1,4
TRBV6-2/3/5/6,TRBJ2-2,CASSYSGVGGELFF,0,4,1,4
TRBV6-2/3/5/6,TRBJ2-7,CASSYREGIYEQYF,0,4,1,4
TRBV12-3/4,TRBJ2-5,CASSLGGAGETQYF,0,4,1,4
TRBV6-2/3/5/6,TRBJ1-2,CASSPPGTNYGYTF,0,4,1,4
TRBV7-3,TRBJ2-2,CASSRGAGTGKLFF,0,4,1,4
TRBV7-2,TRBJ2-7,CASSQGWQGDEQYF,0,4,1,4
TRBV14,TRBJ2-2,CASSQGTDTGELFF,0,4,1,4
TRBV2,TRBJ2-7,CASSVQSFDYEQYF,0,4,1,4
TRBV2,TRBJ2-3,CASSAGIGADTQYF,0,4,1,4
TRBV25-1,TRBJ1-5,CASSGSTGLEPQHF,0,4,1,4
TRBV6-1,TRBJ1-2,CASSDVVHVYGYTF,0,4,1,4
TRBV6-4,TRBJ1-2,CASSDLTGRAGYTF,0,4,1,4
TRBV2,TRBJ2-1,CASSDSTPYNEQFF,0,4,1,4
TRBV2,TRBJ2-7,CASSELAGVLEQYF,0,4,1,4
TRBV25-1,TRBJ2-7,CASSESPGSYEQYF,0,4,1,4
TRBV25-1,TRBJ1-5,CASSESGYNQPQHF,0,4,1,4
TRBV6-1,TRBJ2-1,CASSEPLAGVFQFF,0,4,1,4
TRBV6-1,TRBJ1-3,CASSEGFDLDTIYF,0,4,1,4
TRBV6-1,TRBJ2-1,CASSEDQSYNEQFF,0,4,1,4
TRBV6-1,TRBJ1-2,CASSENVEIYGYTF,0,4,1,4
TRBV6-2/3/5/6,TRBJ2-5,CASSILRGRETQNF,0,4,1,4
TRBV6-2/3/5/6,TRBJ2-5,CASSTGGIQETQYF,0,4,1,4
TRBV6-2/3/5/6,TRBJ1-1,CASSSSGAVTEAFF,0,4,1,4
TRBV5-4,TRBJ2-5,CASSFWGVGETQYF,0,4,1,4
TRBV5-6,TRBJ1-5,CASSFLATNQPQHF,0,4,1,4
TRBV5-4,TRBJ2-1,CASSFRAGYGEQFF,0,4,1,4
TRBV7-9,TRBJ2-1,CASSFLAGGREQFF,0,4,1,4
TRBV5-4,TRBJ1-1,CASSFGQPNTEAFF,0,4,1,4
TRBV11-3,TRBJ2-2,CASSFMGNTGELFF,0,4,1,4
TRBV6-2/3/5/6,TRBJ1-6,CASSFNRARATLHF,0,4,1,4
TRBV5-8,TRBJ2-3,CASSLDRGGDTQYF,0,4,1,4
TRBV5-8,TRBJ2-5,CASSLRDSEETQYF,0,4,1,4
TRBV7-9,TRBJ1-2,CASSLFGDNYGYTF,0,4,1,4
TRBV7-2,TRBJ2-7,CASSLSFRLGEQYF,0,4,1,4
TRBV7-9,TRBJ2-5,CASSLSTGGETQYF,0,4,1,4
TRBV7-9,TRBJ2-5,CASSLLASQETQYF,0,4,1,4
TRBV7-9,TRBJ2-5,CASSLPWDLETQYF,0,4,1,4
TRBV7-9,TRBJ2-1,CASSLVLGGSEQFF,0,4,1,4
TRBV7-9,TRBJ2-5,CASSLVRSQETQYF,0,4,1,4
TRBV7-9,TRBJ1-2,CASSLALTGDGYTF,0,4,1,4
TRBV11-2,TRBJ1-5,CASSLAGGYQPQHF,0,4,1,4
TRBV11-2,TRBJ2-7,CASSLGPRVYEQYF,0,4,1,4
TRBV11-1,TRBJ2-5,CASSLGSLQETQYF,0,4,1,4
TRBV7-9,TRBJ1-1,CASSLGWTVTEAFF,0,4,1,4
TRBV6-2/3/5/6,TRBJ2-7,CASSLGLAGREQYF,0,4,1,4
TRBV7-9,TRBJ1-2,CASSLDSANYGYTF,0,4,1,4
TRBV7-9,TRBJ1-1,CASSLERVSTEAFF,0,4,1,4
TRBV7-9,TRBJ1-2,CASSLTPFNYGYTF,0,4,1,4
TRBV13,TRBJ1-2,CASSLTGSNYGYTF,0,4,1,4
TRBV7-9,TRBJ2-4,CASSLSGSGNIQYF,0,4,1,4
TRBV7-2,TRBJ1-6,CASSLNGATSPLHF,0,4,1,4
TRBV7-9,TRBJ1-2,CASSSSGTAYGYTF,0,4,1,4
TRBV7-9,TRBJ2-5,CASSSGLEQETQYF,0,4,1,4
TRBV5-6,TRBJ1-1,CASSSALPNTEAFF,0,4,1,4
TRBV7-9,TRBJ2-1,CASSWTSSYNEQFF,0,4,1,4
TRBV6-2/3/5/6,TRBJ1-2,CASSYSDRANGYTF,0,4,1,4
TRBV13,TRBJ1-3,CASSLDGATNTIYF,0,4,1,4
TRBV7-9,TRBJ1-2,CASSLYTPEYGYTF,0,4,1,4
TRBV3-1,TRBJ2-5,CASSPPTSKETQYF,0,4,1,4
TRBV5-4,TRBJ2-7,CASSPVFSSHEQYF,0,4,1,4
TRBV7-3,TRBJ2-3,CASSPGLAPDTQYF,0,4,1,4
TRBV3-1,TRBJ1-4,CASSPGRSNEKLFF,0,4,1,4
TRBV7-2,TRBJ2-4,CASSPWDGKNIQYF,0,4,1,4
TRBV7-6,TRBJ2-2,CASSPLQEAGELFF,0,4,1,4
TRBV6-4,TRBJ2-7,CASSPPGLAGGPIF,0,4,1,4
TRBV7-3,TRBJ2-1,CASSPPGQGTEQFF,0,4,1,4
TRBV5-5,TRBJ2-5,CASSPRTGTETQYF,0,4,1,4
TRBV7-2,TRBJ2-7,CASSPRAAGYEQYF,0,4,1,4
TRBV14,TRBJ1-1,CASSPRGQNTEAFF,0,4,1,4
TRBV11-2,TRBJ2-1,CASSPVGSYNEQFF,0,4,1,4
TRBV7-2,TRBJ2-3,CASSPGYSTDTQYF,0,4,1,4
TRBV7-2,TRBJ2-5,CASSPGRTQETQYF,0,4,1,4
TRBV9,TRBJ1-3,CASSPGGDGNTIYF,0,4,1,4
TRBV3-1,TRBJ1-4,CASSPSHGNEKLFF,0,4,1,4
TRBV13,TRBJ2-3,CASSPWPGTDTQYF,0,4,1,4
TRBV3-1,TRBJ2-7,CASSPVRGSYEQYF,0,4,1,4
TRBV7-2,TRBJ2-5,CASSPQGKQETKYF,0,4,1,4
TRBV12-3/4,TRBJ1-2,CASSRRRDFYGYTF,0,4,1,4
TRBV13,TRBJ2-1,CASSRRTPYNEQFF,0,4,1,4
TRBV14,TRBJ2-5,CASSRAGTPETQYF,0,4,1,4
TRBV3-1,TRBJ1-1,CASSHNRMNTEAFF,0,4,1,4
TRBV7-9,TRBJ2-7,CASSQRQSSYEQYF,0,4,1,4
TRBV4-2,TRBJ2-1,CASSQDSGLAEQFF,0,4,1,4
TRBV6-4,TRBJ2-3,CASSQDTSQGGQYF,0,4,1,4
TRBV3-1,TRBJ1-2,CASSQDRANYGYTF,0,4,1,4
TRBV3-1,TRBJ2-5,CASSQDLGGGTQYF,0,4,1,4
TRBV14,TRBJ2-1,CASSQDDFYNEQFF,0,4,1,4
TRBV13,TRBJ1-4,CASSVAGRNEKLFF,0,4,1,4
TRBV11-2,TRBJ2-4,CASSAGSGGSIQYF,0,4,1,4
TRBV7-2,TRBJ2-7,CASSGNRGPYEQYF,0,4,1,4
TRBV7-9,TRBJ1-5,CASSGDSSNQPQHF,0,4,1,4
TRBV7-3,TRBJ2-7,CASSGSGGNYEQYF,0,4,1,4
TRBV13,TRBJ2-1,CASSDRWGNNEQFF,0,4,1,4
TRBV6-4,TRBJ1-1,CASSDGTGADEAFF,0,4,1,4
TRBV7-6,TRBJ2-7,CASSMARDTYEQYF,0,4,1,4
TRBV6-2/3/5/6,TRBJ1-6,CASSIGGNNSPLHF,0,4,1,4
TRBV5-4,TRBJ1-1,CASSTPRQGGQRFF,0,4,1,4
TRBV7-6,TRBJ2-1,CASSTPSRALPWFF,0,4,1,4
TRBV7-9,TRBJ2-5,CASSKDRGQETQYF,0,4,1,4
TRBV12-3/4,TRBJ2-4,CASRPSGGKNIQYF,0,4,1,4
TRBV2,TRBJ2-3,CASRPGLASDTQYF,0,4,1,4
TRBV12-3/4,TRBJ2-3,CASRGTGRSNTQYF,0,4,1,4
TRBV12-3/4,TRBJ2-5,CASRSTGSQETQYF,0,4,1,4
TRBV7-9,TRBJ1-1,CASRQLTGYTEAFF,0,4,1,4
TRBV6-2/3/5/6,TRBJ1-1,CASRASGMNTEAFF,0,4,1,4
TRBV6-2/3/5/6,TRBJ2-7,CASKWEQGPYEPYF,0,4,1,4
TRBV6-2/3/5/6,TRBJ1-1,CASKVLRDTLEAFF,0,4,1,4
TRBV19,TRBJ2-5,CARSPASEQETQYF,0,4,1,4
TRBV4-3,TRBJ2-5,CASPAKGPQETQYF,0,4,1,4
TRBV5-1,TRBJ1-5,CASSRDGNNQPQHF,0,4,1,4
TRBV5-1,TRBJ1-2,CASSLVMGNYGYTF,0,4,1,4
TRBV5-1,TRBJ2-5,CASSLVDHQETQYF,0,4,1,4
TRBV5-1,TRBJ1-1,CASSLGGMNTEAFF,0,4,1,4
TRBV5-1,TRBJ2-7,CASSLGGRDYEQYF,0,4,1,4
TRBV5-1,TRBJ2-5,CASSLDSLIGTQYF,0,4,1,4
TRBV5-1,TRBJ2-7,CASSLTGGFYEQYF,0,4,1,4
TRBV5-1,TRBJ2-7,CASSSPGPTGEQYF,0,4,1,4
TRBV4-3,TRBJ2-3,CASSPAQRFVTQYF,0,4,1,4
TRBV4-3,TRBJ1-1,CASSHATGGTEAFF,0,4,1,4
TRBV5-1,TRBJ2-7,CASSQGRSSYEQYF,0,4,1,4
TRBV5-1,TRBJ1-1,CASSQWQGDTEAFF,0,4,1,4
TRBV4-1,TRBJ1-2,CASSQLQLTYGYTF,0,4,1,4
TRBV4-3,TRBJ1-1,CASSQDSVDTEAFF,0,4,1,4
TRBV4-1,TRBJ1-5,CASSQEEGDQPQHF,0,4,1,4
TRBV4-1,TRBJ2-7,CASSQEPGEYEQYF,0,4,1,4
TRBV5-1,TRBJ2-7,CASSDTESSYEQYF,0,4,1,4
TRBV5-1,TRBJ2-4,CASSETLAKNIQFF,0,4,1,4
TRBV20-1,TRBJ1-5,CSAGGRVGNQPQHF,0,4,1,4
TRBV20-1,TRBJ1-2,CSAETGTSRYGYTF,0,4,1,4
TRBV20-1,TRBJ2-3,CSAIDGTAQDTQYF,0,4,1,4
TRBV20-1,TRBJ2-5,CSATRLGNQETQYF,0,4,1,4
TRBV20-1,TRBJ2-4,CSATGKGDENIQYF,0,4,1,4
TRBV20-1,TRBJ2-1,CSASGGDPYNEQFF,0,4,1,4
TRBV20-1,TRBJ2-7,CSASETGDAYEQYF,0,4,1,4
TRBV20-1,TRBJ1-4,CSARSGSENEKLFF,0,4,1,4
TRBV20-1,TRBJ2-1,CSARPPSGYNEQFF,0,4,1,4
TRBV20-1,TRBJ2-3,CSARDLSFTDTQYF,0,4,1,4
TRBV20-1,TRBJ2-7,CSAFRDLGSYEQYF,0,4,1,4
TRBV20-1,TRBJ2-4,CSALTGVPLNIQYF,0,4,1,4
TRBV20-1,TRBJ2-7,CSAPGQGADYEQYF,0,4,1,4
TRBV20-1,TRBJ1-6,CSAQQGATNSPLHF,0,4,1,4
TRBV20-1,TRBJ2-1,CSAREPAQYNEQFF,0,4,1,4
TRBV20-1,TRBJ2-7,CSAPNAGASYEQYF,0,4,1,4
TRBV20-1,TRBJ2-7,CSAPLRGGTYEQYF,0,4,1,4
TRBV20-1,TRBJ2-1,CSAERTSTNNEQFF,0,4,1,4
TRBV20-1,TRBJ2-7,CSGEAGGPSYEQYF,0,4,1,4
TRBV29-1,TRBJ1-1,CSVQRGGGYTEAFF,0,4,1,4
TRBV29-1,TRBJ2-1,CSVVTGTIYNEQFF,0,4,1,4
TRBV29-1,TRBJ2-5,CSVGIAGGKETQYF,0,4,1,4
TRBV29-1,TRBJ2-7,CSVEVTGGSDEQYF,0,4,1,4
TRBV29-1,TRBJ1-2,CSVEETPPNYGYTF,0,4,1,4
TRBV29-1,TRBJ2-3,CSVEEGLAPDTQYF,0,4,1,4
TRBV29-1,TRBJ1-2,CSVKLDRGPYGYTF,0,4,1,4
TRBV29-1,TRBJ1-1,CSVKGGGLDTEAFF,0,4,1,4
TRBV29-1,TRBJ2-1,CSVHDQSSYNEQFF,0,4,1,4
TRBV29-1,TRBJ1-2,CSVAGDERSYGYTF,0,4,1,4
TRBV29-1,TRBJ1-2,CSAEVGQPTYGYTF,0,4,1,4
TRBV29-1,TRBJ2-3,CSARTISSTDTQYF,0,4,1,4
TRBV29-1,TRBJ1-1,CSGATGGVPTEAFF,0,4,1,4
TRBV2,TRBJ1-5,CASQGRENQPQHF,0,4,1,4
TRBV30,TRBJ2-3,CAWGTSGTDTQYF,0,4,1,4
TRBV30,TRBJ2-3,CAWIHSGTDTQYF,0,4,1,4
TRBV30,TRBJ1-2,CAWSAGTDYGYTF,0,4,1,4
TRBV30,TRBJ2-3,CAWSRPGGDTQYF,0,4,1,4
TRBV30,TRBJ2-2,CAWSRQNTGELFF,0,4,1,4
TRBV30,TRBJ1-1,CALQGTLNTEAFF,0,4,1,4
TRBV24-1,TRBJ2-5,CAASDGYQETQYF,0,4,1,4
TRBV19,TRBJ2-3,CAGPGAHTDTQYF,0,4,1,4
TRBV24-1,TRBJ2-3,CATSEWGAATQYF,0,4,1,4
TRBV2,TRBJ1-3,CATQEDSGNTIYF,0,4,1,4
TRBV19,TRBJ1-1,CASFGTANTEAFF,0,4,1,4
TRBV19,TRBJ2-5,CASAPSAQETQYF,0,4,1,4
TRBV19,TRBJ2-7,CASGIGSSYEQYF,0,4,1,4
TRBV12-3/4,TRBJ1-1,CASGLRTYTEAVF,0,4,1,4
TRBV19,TRBJ2-1,CASTRSGNNEQFF,0,4,1,4
TRBV19,TRBJ2-7,CASTPGGIYEQYF,0,4,1,4
TRBV19,TRBJ2-1,CASSLAVYNEQFF,0,4,1,4
TRBV19,TRBJ2-1,CASSPPRYNEQFF,0,4,1,4
TRBV19,TRBJ1-5,CASSPAENQPQHF,0,4,1,4
TRBV19,TRBJ2-7,CASSANQGREQYF,0,4,1,4
TRBV19,TRBJ1-2,CASSIEPNYGYTF,0,4,1,4
TRBV19,TRBJ1-1,CASSRDRGTEAFF,0,4,1,4
TRBV19,TRBJ2-3,CASRPTSTDTQYF,0,4,1,4
TRBV18,TRBJ2-1,CASSLGTSGEQFF,0,4,1,4
TRBV18,TRBJ1-1,CASSPPQSKKAFF,0,4,1,4
TRBV13,TRBJ2-3,CASPLKDRDTQYF,0,4,1,4
TRBV6-4,TRBJ1-1,CASGRGLNTEAFF,0,4,1,4
TRBV2,TRBJ2-7,CASGRDRGYEQYF,0,4,1,4
TRBV6-2/3/5/6,TRBJ2-3,CASIQRSTDTQYF,0,4,1,4
TRBV6-2/3/5/6,TRBJ1-4,CASIGPSAEKLFF,0,4,1,4
TRBV9,TRBJ1-4,CASTGPTNEKLFF,0,4,1,4
TRBV6-2/3/5/6,TRBJ1-1,CASTSTGGTEAFF,0,4,1,4
TRBV7-2,TRBJ1-1,CASTRTGDTEAFF,0,4,1,4
TRBV6-2/3/5/6,TRBJ2-5,CASTGRAAETQYF,0,4,1,4
TRBV28,TRBJ1-5,CASTDSWNQPQHF,0,4,1,4
TRBV12-3/4,TRBJ2-7,CASSFQGSYEQYF,0,4,1,4
TRBV6-2/3/5/6,TRBJ2-3,CASSFLGTDTQYF,0,4,1,4
TRBV12-3/4,TRBJ2-2,CASSFPGAGELFF,0,4,1,4
TRBV7-9,TRBJ2-7,CASSFRGGNEQYF,0,4,1,4
TRBV27,TRBJ2-7,CASSLDNAYEQYF,0,4,1,4
TRBV6-2/3/5/6,TRBJ2-7,CASSLPTGDEQYF,0,4,1,4
TRBV12-3/4,TRBJ1-6,CASSLQGNSPLHF,0,4,1,4
TRBV12-3/4,TRBJ1-2,CASSLVEEYGYTF,0,4,1,4
TRBV28,TRBJ2-7,CASSLKLFGEQYF,0,4,1,4
TRBV12-3/4,TRBJ2-5,CASSSGTGGGQYF,0,4,1,4
TRBV6-2/3/5/6,TRBJ1-1,CASSYQRNTEAFF,0,4,1,4
TRBV6-2/3/5/6,TRBJ2-1,CASSYLTRNEQFF,0,4,1,4
TRBV6-2/3/5/6,TRBJ2-7,CASSYSQGGEQYF,0,4,1,4
TRBV6-2/3/5/6,TRBJ2-1,CASSYRENNEQFF,0,4,1,4
TRBV5-1,TRBJ1-5,CASSYGGNQPQHF,0,7,1,7
TRBV5-4,TRBJ2-7,CASSYRGRGEQYF,0,4,1,4
TRBV12-3/4,TRBJ1-6,CASSPQAGSRLHF,0,4,1,4
TRBV12-3/4,TRBJ2-4,CASSPQGVDIQYF,0,4,1,4
TRBV6-2/3/5/6,TRBJ1-1,CASSRDSYTEAFF,0,4,1,4
TRBV6-2/3/5/6,TRBJ1-6,CASSRIGASPLHF,0,4,1,4
TRBV6-1,TRBJ1-1,CASSATGGTEAFF,0,4,1,4
TRBV6-1,TRBJ2-5,CASSGARIETQYF,0,4,1,4
TRBV2,TRBJ1-1,CASSDLRDSEAFF,0,4,1,4
TRBV25-1,TRBJ2-7,CASSESATYDQYF,0,4,1,4
TRBV6-1,TRBJ1-5,CASSEGSNQPQHF,0,4,1,4
TRBV6-1,TRBJ2-7,CASSELHQAKQYF,0,4,1,4
TRBV7-2,TRBJ1-2,CASSFLSDYGYTF,0,4,1,4
TRBV7-6,TRBJ2-7,CASSFRETYEQYF,0,4,1,4
TRBV5-6,TRBJ2-7,CASSFQGTKEQYF,0,4,1,4
TRBV5-4,TRBJ2-7,CASSLWGTYEQYF,0,4,1,4
TRBV5-4,TRBJ2-3,CASSLLTRDTQYF,0,4,1,4
TRBV5-6,TRBJ1-1,CASSLVSNTEAFS,0,4,1,4
TRBV5-8,TRBJ1-2,CASSLGQGGGYTF,0,4,1,4
TRBV7-2,TRBJ1-2,CASSLDTSYGYTF,0,4,1,4
TRBV5-6,TRBJ1-2,CASSLIGDYGYAF,0,4,1,4
TRBV11-2,TRBJ2-2,CASSLLTTGELFF,0,4,1,4
TRBV7-9,TRBJ1-6,CASSLSSNSPLHF,0,4,1,4
TRBV5-8,TRBJ1-1,CASSLSGTAEAFF,0,4,1,4
TRBV7-7,TRBJ2-3,CASSLSGRDTQYF,0,4,1,4
TRBV13,TRBJ1-1,CASSLRGKTEAFF,0,6,1,6
TRBV7-2,TRBJ2-1,CASSLVAPGGQFF,0,4,1,4
TRBV13,TRBJ2-5,CASSLGPEETQYF,0,4,1,4
TRBV7-9,TRBJ1-1,CASSLDIGAEAFF,0,4,1,4
TRBV11-2,TRBJ2-7,CASSLDQGGEQYF,0,4,1,4
TRBV7-9,TRBJ1-1,CASSLDIGSEAFF,0,4,1,4
TRBV7-2,TRBJ2-1,CASSLTRGNEQFF,0,4,1,4
TRBV7-2,TRBJ1-1,CASSLTPNTEAFF,0,4,1,4
TRBV7-8,TRBJ2-7,CASSSVGAYEQYF,0,4,1,4
TRBV7-9,TRBJ1-2,CASSSRQNYGYTF,0,4,1,4
TRBV5-5,TRBJ2-5,CASSWGAEETQYF,0,7,1,7
TRBV7-2,TRBJ2-7,CASSLGQWYEQFF,0,4,1,4
TRBV7-9,TRBJ1-2,CASSLQRFDGYTF,0,4,1,4
TRBV4-2,TRBJ2-7,CASSLGQFNEQYF,0,4,1,4
TRBV11-2,TRBJ2-1,CASSLSGRHEQFF,0,4,1,4
TRBV6-2/3/5/6,TRBJ1-2,CASSPGQGRGYTF,0,4,1,4
TRBV9,TRBJ1-1,CASSPNGGTEAFF,0,4,1,4
TRBV6-2/3/5/6,TRBJ2-7,CASSPGTNYEQYF,0,4,1,4
TRBV2,TRBJ1-1,CASSRPVNTEAFF,0,4,1,4
TRBV4-2,TRBJ2-7,CASSRDSLYEQYF,0,4,1,4
TRBV5-4,TRBJ1-2,CASSRRDRYGYTF,0,4,1,4
TRBV14,TRBJ1-2,CASSRTLGSGYTF,0,4,1,4
TRBV11-3,TRBJ1-1,CASSRSGDTEAFF,0,4,1,4
TRBV5-6,TRBJ1-2,CASSRALFYGYTF,0,4,1,4
TRBV4-2,TRBJ1-1,CASSRGGIVEAFF,0,4,1,4
TRBV6-2/3/5/6,TRBJ1-3,CASSHQGGNTIYF,0,4,1,4
TRBV3-1,TRBJ1-1,CASSQQGRAEAFF,0,4,1,4
TRBV3-1,TRBJ1-1,CASSQSGGQAAFF,0,4,1,4
TRBV7-9,TRBJ1-2,CASSQRGGYGYTF,0,4,1,4
TRBV9,TRBJ2-7,CASSVGGSYEQYF,0,4,1,4
TRBV5-8,TRBJ2-1,CASSGPDYNEQFF,0,4,1,4
TRBV12-3/4,TRBJ1-2,CASRGISNYGYTF,0,4,1,4
TRBV6-2/3/5/6,TRBJ1-1,CASRRSGDTEAFF,0,4,1,4
TRBV7-8,TRBJ2-7,CASRHRGGYEQYF,0,4,1,4
TRBV12-3/4,TRBJ1-5,CASRRDSYQPQHF,0,4,1,4
TRBV12-3/4,TRBJ2-7,CASNGKNSYEQYF,0,4,1,4
TRBV5-1,TRBJ1-1,CASSLGINTEAFF,0,4,1,4
TRBV5-1,TRBJ2-5,CASSLGSGETQYF,0,4,1,4
TRBV5-1,TRBJ2-7,CASSLERGNEQYF,0,4,1,4
TRBV5-1,TRBJ1-1,CASSWGTGSEAFF,0,4,1,4
TRBV5-1,TRBJ1-2,CASSPDRVNGYTF,0,4,1,4
TRBV5-1,TRBJ1-1,CASSPAGDTEAFF,0,4,1,4
TRBV4-3,TRBJ1-6,CASSHGGQTPLHF,0,4,1,4
TRBV4-3,TRBJ2-7,CASSQPVWGEQYF,0,4,1,4
TRBV4-1,TRBJ2-1,CASSQGVDNEQFF,0,4,1,4
TRBV5-1,TRBJ1-5,CANRTVPDQPQHF,0,4,1,4
TRBV20-1,TRBJ2-1,CSPRDPRSNEQFF,0,4,1,4
TRBV20-1,TRBJ2-5,CSAAPGAGETQYF,0,4,1,4
TRBV20-1,TRBJ1-2,CSARDGSYYGYTF,0,4,1,4
TRBV20-1,TRBJ1-1,CSARALGANEAFF,0,4,1,4
TRBV20-1,TRBJ2-2,CSARAPGAGELFF,0,4,1,4
TRBV20-1,TRBJ1-1,CSARDHGETEAFF,0,4,1,4
TRBV20-1,TRBJ2-5,CSAEGRGLETQYF,0,4,1,4
TRBV20-1,TRBJ2-1,CSASITGVNEQFF,0,4,1,4
TRBV20-1,TRBJ1-1,CSAMGQGGTEAFF,0,4,1,4
TRBV20-1,TRBJ2-7,CSATTRTGVEQYF,0,4,1,4
TRBV20-1,TRBJ1-1,CSAEDGLNTEAFF,0,4,1,4
TRBV29-1,TRBJ2-1,CSVFPLRYNEQFF,0,4,1,4
TRBV29-1,TRBJ2-7,CSVPGPSFYEQYF,0,4,1,4
TRBV29-1,TRBJ1-2,CSVVVPGHYGYTF,0,4,1,4
TRBV29-1,TRBJ1-5,CSVAYRVDQPQHF,0,4,1,4
TRBV29-1,TRBJ2-7,CSVAGSGIDEQYF,0,4,1,4
TRBV29-1,TRBJ1-1,CSVDARRDTEAFF,0,4,1,4
TRBV29-1,TRBJ1-2,CSVEEGQNYGYTF,0,4,1,4
TRBV29-1,TRBJ1-2,CSVEFAGIYGYTF,0,4,1,4
TRBV29-1,TRBJ1-1,CSVERGTSTEAFF,0,4,1,4
TRBV29-1,TRBJ2-7,CSVEGGTGYEQYF,0,4,1,4
TRBV29-1,TRBJ2-1,CSVEMAAGNEQFF,0,4,1,4
TRBV29-1,TRBJ2-7,CSVETPLLGEQYF,0,4,1,4
TRBV29-1,TRBJ1-1,CSVPPQGNTEAFF,0,4,1,4
TRBV29-1,TRBJ2-7,CSVRGTAAYEQYF,0,4,1,4
TRBV29-1,TRBJ2-1,CSVEEGVYNEQFF,0,4,1,4
TRBV29-1,TRBJ2-5,CSVVTGSGETQYF,0,4,1,4
TRBV29-1,TRBJ2-7,CSVALAGALEQYF,0,4,1,4
TRBV29-1,TRBJ2-7,CSVESGRGYEQYF,0,4,1,4
TRBV29-1,TRBJ2-5,CSVRDRVTETQYF,0,4,1,4
TRBV29-1,TRBJ1-1,CSVDDQMNTEAFF,0,4,1,4
TRBV29-1,TRBJ2-7,CSASSQGAGEQYF,0,4,1,4
TRBV29-1,TRBJ1-1,CSAQQGGNTEAFF,0,4,1,4
TRBV29-1,TRBJ1-1,CSAAWTENTEAFF,0,4,1,4
TRBV29-1,TRBJ1-2,CSAEAALGDGYTF,0,4,1,4
TRBV29-1,TRBJ1-3,CSASGTDGNTIYF,0,4,1,4
TRBV29-1,TRBJ2-7,CSGRGTGMGEQYF,0,4,1,4
TRBV29-1,TRBJ2-1,CSGAPSGYNEQFF,0,4,1,4
TRBV29-1,TRBJ2-7,YSGGDGPLGEQYF,0,4,1,4
TRBV14,TRBJ1-2,GASSQSTTGGYTF,0,4,1,4
TRBV12-3/4,TRBJ1-1,SASSFRGTTEAFF,0,4,1,4
TRBV5-4,TRBJ2-3,CACRDFPDTQYF,0,4,1,4
TRBV30,TRBJ1-1,CAWRSWNTEAFF,0,4,1,4
TRBV10-3,TRBJ2-7,CAIRGDSYEQYF,0,4,1,4
TRBV10-3,TRBJ2-1,CATEPAGGHPFF,0,4,1,4
TRBV19,TRBJ1-5,CASSIGGQPQHF,0,4,1,4
TRBV18,TRBJ1-6,CASSPEKSPLHF,0,4,1,4
TRBV11-2,TRBJ1-1,CASPPDPTEAFF,0,4,1,4
TRBV12-3/4,TRBJ2-5,CASAEGAKTQYF,0,4,1,4
TRBV6-2/3/5/6,TRBJ1-1,CASDQGRTEAFF,0,4,1,4
TRBV6-1,TRBJ2-2,CASIGVRGELFF,0,4,1,4
TRBV6-2/3/5/6,TRBJ1-1,CASTEIRGEAFF,0,4,1,4
TRBV12-3/4,TRBJ2-1,CASSFFQNEQFF,0,4,1,4
TRBV6-2/3/5/6,TRBJ1-1,CASSFPGAEAFF,0,4,1,4
TRBV7-9,TRBJ1-1,CASSFGSIEAFF,0,4,1,4
TRBV6-2/3/5/6,TRBJ2-3,CASSLTGSTQYF,0,4,1,4
TRBV7-2,TRBJ2-1,CASSSPDSKQFF,0,4,1,4
TRBV27,TRBJ2-7,CASSLTGGEQYF,0,4,1,4
TRBV12-3/4,TRBJ2-1,CASSRSGDEQFF,0,4,1,4
TRBV2,TRBJ1-1,CASSGAWTEAFF,0,4,1,4
TRBV27,TRBJ1-4,CASSGPPGRLFF,0,4,1,4
TRBV2,TRBJ2-7,CASSESVGAQVF,0,4,1,4
TRBV6-2/3/5/6,TRBJ2-7,CASSTVPYEQYF,0,4,1,4
TRBV7-2,TRBJ1-2,CASSFGPEGYTF,0,4,1,4
TRBV5-6,TRBJ1-1,CASSFGGAEAFF,0,4,1,4
TRBV5-5,TRBJ2-1,CASSFDYNEQFF,0,4,1,4
TRBV7-9,TRBJ2-1,CASSFDINEQFF,0,4,1,4
TRBV5-6,TRBJ2-7,CASSLLGSEQYF,0,4,1,4
TRBV5-6,TRBJ2-1,CASSLDSMEQFF,0,4,1,4
TRBV7-6,TRBJ2-7,CASSLQAYEQYF,0,4,1,4
TRBV7-9,TRBJ1-6,CASSLAGSPLHF,0,4,1,4
TRBV13,TRBJ2-2,CASSLGAGELFF,0,4,1,4
TRBV7-9,TRBJ1-2,CASSLGARGYTF,0,4,1,4
TRBV11-2,TRBJ1-1,CASSYHQGEAFF,0,4,1,4
TRBV7-9,TRBJ1-6,CASSLVSSPLHF,0,4,1,4
TRBV14,TRBJ1-2,CASSRVQMGYTF,0,4,1,4
TRBV12-3/4,TRBJ2-1,CASSRTVGEQFF,0,4,1,4
TRBV14,TRBJ2-1,CASSQWDLRQFF,0,4,1,4
TRBV3-1,TRBJ1-6,CASSQASSPLHF,0,4,1,4
TRBV6-4,TRBJ1-1,CASSAPNTEAFF,0,4,1,4
TRBV9,TRBJ2-3,CASSATPDTQYF,0,4,1,4
TRBV11-2,TRBJ1-2,CASSGGGDGYTF,0,4,1,4
TRBV6-2/3/5/6,TRBJ2-2,CASRWRAGELFF,0,4,1,4
TRBV12-3/4,TRBJ1-1,CASRTGGGEAFF,0,4,1,4
TRBV7-2,TRBJ2-1,CASRRTSYEQFF,0,4,1,4
TRBV2,TRBJ1-5,CASKEPNQPQHF,0,4,1,4
TRBV5-1,TRBJ1-1,CASSPTGLEAFF,0,4,1,4
TRBV10-2,TRBJ2-5,CASSEVQETQYF,0,4,1,4
TRBV5-1,TRBJ1-1,CASSLPGGEAFF,0,4,1,4
TRBV4-1,TRBJ2-3,CASSQVTDTQYF,0,4,1,4
TRBV5-1,TRBJ1-2,CASSGDRVGYTF,0,4,1,4
TRBV5-1,TRBJ2-6,CASRGGANVLTF,0,4,1,4
TRBV20-1,TRBJ2-1,CSAIWGGNEQFF,0,4,1,4
TRBV20-1,TRBJ2-5,CSARGVRETQYF,0,4,1,4
TRBV20-1,TRBJ2-5,CSARGVQETQYF,0,4,1,4
TRBV20-1,TRBJ2-5,CSARRRGGGQYF,0,4,1,4
TRBV20-1,TRBJ1-1,CSARGKNTEAFF,0,4,1,4
TRBV29-1,TRBJ2-2,CSVVRGPGELFF,0,4,1,4
TRBV29-1,TRBJ1-1,CSVAWATGEAFF,0,4,1,4
TRBV29-1,TRBJ1-2,CSVGDRGSGYTF,0,4,1,4
TRBV29-1,TRBJ1-2,CSVTGTGFGYTF,0,4,1,4
TRBV29-1,TRBJ2-5,CSVTRNQETQYF,0,4,1,4
TRBV29-1,TRBJ2-5,CSVTGSRETQYF,0,4,1,4
TRBV29-1,TRBJ2-7,CSAAGQTYEQYF,0,4,1,4
TRBV29-1,TRBJ2-5,CSARDNQETQFF,0,4,1,4
TRBV29-1,TRBJ2-2,CSGQGNTGELFF,0,4,1,4
TRBV10-3,TRBJ2-5,CAAGLQETQYF,0,4,1,4
TRBV19,TRBJ1-5,CASTSNAPQHF,0,4,1,4
TRBV19,TRBJ2-5,CASSIEETQYF,0,4,1,4
TRBV19,TRBJ2-1,CASSKANEQFF,0,4,1,4
TRBV18,TRBJ2-7,CASSPPHEQYF,0,4,1,4
TRBV12-3/4,TRBJ1-2,CASSRSHGYTF,0,4,1,4
TRBV6-2/3/5/6,TRBJ2-7,CASSRGNEQYF,0,4,1,4
TRBV2,TRBJ1-1,CASSVVSVAFF,0,4,1,4
TRBV25-1,TRBJ1-2,CASSTGAGYTF,0,4,1,4
TRBV5-6,TRBJ2-5,CASSFQETQYS,0,4,1,4
TRBV7-9,TRBJ1-1,CASSLNTEAFF,0,4,1,4
TRBV3-1,TRBJ2-7,CASSPGYEQYF,0,4,1,4
TRBV7-3,TRBJ2-3,CASSQGGTQYF,0,4,1,4
TRBV5-6,TRBJ1-1,CASSVGTEAFF,0,4,1,4
TRBV7-9,TRBJ2-7,CASSAEEEQYF,0,4,1,4
TRBV4-2,TRBJ1-2,CASSGPRGYTF,0,4,1,4
TRBV11-2,TRBJ2-1,CASSITNEQFF,0,4,1,4
TRBV14,TRBJ2-1,CASRVGDEQFF,0,4,1,4
TRBV6-2/3/5/6,TRBJ1-1,CASRTGTEAFF,0,4,1,4
TRBV5-1,TRBJ1-1,CASSLEGEAFF,0,4,1,4
TRBV5-1,TRBJ2-2,CASSLYGELFF,0,4,1,4
TRBV20-1,TRBJ2-7,CSAPFGVLSYF,0,4,1,4
TRBV20-1,TRBJ2-1,CSGTSGNEQFF,0,4,1,4
TRBV29-1,TRBJ2-1,CSPKAGAEQFF,0,4,1,4
TRBV29-1,TRBJ2-7,CSVVGGYEQYF,0,4,1,4
TRBV29-1,TRBJ2-1,CSVERGFGQFF,0,4,1,4
TRBV20-1,TRBJ1-1,CSAAGGSEAFF,0,4,1,4
TRBV29-1,TRBJ2-5,CSGDLQETQYF,0,4,1,4
TRBV29-1,TRBJ1-2,CSEQGNYGYTF,0,4,1,4
TRBV30,TRBJ2-1,CAWSVSEQFF,0,4,1,4
TRBV2,TRBJ2-5,CASSLSTQYF,0,4,1,4
TRBV20-1,TRBJ2-1,CSAGINEQFF,0,4,1,4
TRBV20-1,TRBJ1-5,CSAGGAAQHF,0,4,1,4
TRBV19,TRBJ1-5,CAGGQPQHF,0,4,1,4
TRBV7-9,TRBJ2-1,CASTGPEFF,0,4,1,4
TRBV29-1,TRBJ2-5,CSVEETQYF,0,4,1,4
TRBV7-9,TRBJ2-4,CASSAGTSGRVRNIQYF,0,4,1,4
TRBV12-3/4,TRBJ2-5,CASSIKQPGLQETQYF,0,4,1,4
TRBV11-1,TRBJ1-4,CASSRGTVDYNEKLFF,0,4,1,4
TRBV4-2,TRBJ1-3,CASSRELSFTGNTIYF,0,4,1,4
TRBV4-2,TRBJ2-5,CASSQEEWTRQETQYF,0,4,1,4
TRBV7-8,TRBJ1-1,CASSLDGPTGAEAFF,0,4,1,4
TRBV12-3/4,TRBJ1-6,CASSLRDPSPLHF,0,4,1,4
TRBV9,TRBJ1-2,CASSPQGDYGYTF,0,4,1,4
TRBV9,TRBJ2-3,CASSFYGTSGSSADTQYF,0,4,1,4
TRBV4-1,TRBJ1-5,CASSAQQGSSNQPQHF,0,4,1,4
TRBV6-1,TRBJ1-1,CASSGTEFMNTEAFF,0,4,1,4
TRBV5-4,TRBJ1-3,CASSLGPSGNTIYF,0,4,1,4
TRBV18,TRBJ1-5,CASSPVGDSNQPQHF,0,3,1,3
TRBV14,TRBJ2-1,CASSPRTDPLPPNEQFF,0,3,1,3
TRBV12-3/4,TRBJ1-3,CASSRRVLSGNTIYF,0,3,1,3
TRBV14,TRBJ2-7,CASSRRGLLYEQYF,0,3,1,3
TRBV28,TRBJ1-1,CASSLRRNTEAFF,0,3,1,3
TRBV6-2/3/5/6,TRBJ2-7,CASSPPGLAGYHEQYF,0,3,1,3
TRBV6-4,TRBJ2-1,CASSDGLAGGVQFF,0,3,1,3
TRBV27,TRBJ2-1,CASLPRARVEGSNEQFF,0,3,1,3
TRBV12-5,TRBJ1-1,CASGLVRGLNTEAFF,0,3,1,3
TRBV7-2,TRBJ2-5,CASSLYGSGKKTQYF,0,3,1,3
TRBV6-2/3/5/6,TRBJ1-5,CASSSGDVNQPQHF,0,3,1,3
TRBV2,TRBJ2-3,CASSGSAIRVEYF,0,3,1,3
TRBV29-1,TRBJ1-2,CSADGGLDGYTF,0,3,1,3
TRBV4-2,TRBJ2-1,CASSQDPSGRASYNEQFF,0,3,1,3
TRBV30,TRBJ2-6,CARSATASDSPGANVLTF,0,3,1,3
TRBV7-3,TRBJ2-1,CASSLSGRRAYNEQFF,0,3,1,3
TRBV6-1,TRBJ2-1,CASTVAGNSYNEQFF,0,3,1,3
TRBV29-1,TRBJ1-3,CSVSRGPGNTIYF,0,3,1,3
TRBV27,TRBJ2-1,CASTNWARRPPTDGDHNHDNEQFF,0,5,1,5
TRBV7-2,TRBJ1-5,CASSQLLWPAGDRDSGGNQPQHF,0,3,1,3
TRBV12-3/4,TRBJ2-2,CASSGPTSGGGRPANAGELFF,0,3,1,3
TRBV5-6,TRBJ2-1,CASSLVGYVQGARDIYNEQFF,0,3,1,3
TRBV3-1,TRBJ1-6,CASSQFPRALKRSSYNSPLHF,0,3,1,3
TRBV3-1,TRBJ2-1,CASSQDPNLAGVRDSYNEQFF,0,3,1,3
TRBV5-1,TRBJ2-7,CASSDLLPAPNMFGKSYEQYF,0,3,1,3
TRBV30,TRBJ1-5,CAWVGFDDLRFPYHFLPQHF,0,3,1,3
TRBV28,TRBJ2-7,CASSSNLGPAGVVFGYEQYF,0,3,1,3
TRBV6-1,TRBJ2-1,CASSVVVASHPQEVHNEQFF,0,3,1,3
TRBV7-2,TRBJ2-1,CASSFDRGGSVWRGVNEQFF,0,3,1,3
TRBV7-2,TRBJ2-7,CASSYGLAGGQSLVFYEQYF,0,3,1,3
TRBV14,TRBJ1-5,CASSRDGICRTAPGRQPQHF,0,3,1,3
TRBV3-1,TRBJ1-1,CASSQVAGFVSKERDTEAFF,0,3,1,3
TRBV4-3,TRBJ2-1,CASSQESGSLAGTSDNEQFF,0,3,1,3
TRBV29-1,TRBJ2-6,CSVEDRSVRQGIGGANVLTF,0,3,1,3
TRBV7-4,TRBJ1-1,RASSLEIRATVISLNTEAFF,0,3,1,3
TRBV2,TRBJ2-2,CASAVRGTSGGPNTGELFF,0,3,1,3
TRBV12-3/4,TRBJ2-1,CASSLISGIGRNSYNEQFF,0,3,1,3
TRBV6-2/3/5/6,TRBJ1-3,CASSYSMGPGINRGNTIYF,0,3,1,3
TRBV2,TRBJ2-1,CASSEGILAGDPHEDEQFF,0,3,1,3
TRBV5-6,TRBJ1-1,CASSFYVYRVILGWTEAFF,0,3,1,3
TRBV13,TRBJ1-6,CASSLWLGQGSSYNSPLHF,0,3,1,3
TRBV5-8,TRBJ2-2,CASSLGRGAGLLDTGELFF,0,3,1,3
TRBV11-2,TRBJ2-1,CASSLDRGTFYLKGNEQFF,0,3,1,3
TRBV13,TRBJ2-4,CASSLRAAGVEIAKNIQYF,0,3,1,3
TRBV13,TRBJ2-4,CASSLRAAGAEIAKNIQYF,0,3,1,3
TRBV3-1,TRBJ1-3,CASSLPGQRIEVSGNTIYF,0,3,1,3
TRBV7-3,TRBJ2-1,CASSLGPGQGSRPYNEQFF,0,3,1,3
TRBV4-2,TRBJ2-7,CASSHPVKVPSGGASEQYF,0,3,1,3
TRBV14,TRBJ2-3,CASSQVMASPIWTADTQYF,0,3,1,3
TRBV4-2,TRBJ2-1,CASSQDPPSGRGSRNEQFF,0,3,1,3
TRBV3-1,TRBJ2-6,CASSQDVGRERFGANVLTF,0,3,1,3
TRBV7-2,TRBJ2-2,CASRLSTSGGVEDAGELFF,0,3,1,3
TRBV27,TRBJ2-1,CASRGNPGLAGSSYNEQFF,0,3,1,3
TRBV5-1,TRBJ2-1,CASSLGSSGGAGSYNEQFF,0,3,1,3
TRBV4-1,TRBJ1-1,CASSQEPPEGFFGNTEAFF,0,3,1,3
TRBV5-1,TRBJ2-6,CASREPGKLRSSGANVLTF,0,3,1,3
TRBV20-1,TRBJ2-3,CSAGVGLAGGVLGTDTQYF,0,3,1,3
TRBV12-5,TRBJ2-2,CASGPPSGGTLGTGELFF,0,3,1,3
TRBV30,TRBJ2-3,CAWSRGTSGRAITDTQYF,0,3,1,3
TRBV10-3,TRBJ1-2,CAISNLDPGTLEYYGYTF,0,3,1,3
TRBV15,TRBJ2-3,CATSSQFRGLAGGDTQYF,0,3,1,3
TRBV15,TRBJ2-1,CATSRDRTSGSMYNEQFF,0,3,1,3
TRBV19,TRBJ2-1,CASSSLAGGPRSYNEQFF,0,3,1,3
TRBV19,TRBJ1-6,CASSTSSGWVRFFSPLHF,0,3,1,3
TRBV18,TRBJ2-7,CASSPRSGSTGLSYEQYF,0,3,1,3
TRBV18,TRBJ2-1,CASSPTAIGGSSYNEQFF,0,3,1,3
TRBV6-2/3/5/6,TRBJ1-5,CASSLPGRVANSNQPQHF,0,3,1,3
TRBV12-3/4,TRBJ2-4,CASSSGTSGGWAKNIQYF,0,3,1,3
TRBV12-3/4,TRBJ2-1,CASSYETRSRRSYNEQFF,0,3,1,3
TRBV6-2/3/5/6,TRBJ1-6,CASSYRQGRPSYNSPLHF,0,3,1,3
TRBV12-3/4,TRBJ2-3,CASSPNSGGPPHTDTQYF,0,3,1,3
TRBV2,TRBJ2-6,CASSDRLAGSSGANVPTF,0,3,1,3
TRBV2,TRBJ2-3,CASSEVRQRGTSTDTQYF,0,3,1,3
TRBV6-2/3/5/6,TRBJ2-6,CASSTSSSQGSGANVLTF,0,3,1,3
TRBV7-8,TRBJ2-3,CASSFRGGASGKTDTQYF,0,3,1,3
TRBV5-6,TRBJ2-2,CASSLPLAGASNTGELFF,0,3,1,3
TRBV5-4,TRBJ2-1,CASSLVLNYRDYYNEQFF,0,3,1,3
TRBV13,TRBJ2-2,CASSLLSLAGRYTGELFF,0,3,1,3
TRBV7-8,TRBJ2-7,CASSLVRRGRGSSYEQYF,0,3,1,3
TRBV7-3,TRBJ2-3,CASSLARTTSGDTDTQYF,0,3,1,3
TRBV7-9,TRBJ1-1,CASSLGGQVALGNTEAFF,0,3,1,3
TRBV6-2/3/5/6,TRBJ1-1,CASSLEGPDRDMNTEAFF,0,3,1,3
TRBV9,TRBJ2-7,CASSSGLAGGGDYYEQYF,0,3,1,3
TRBV11-1,TRBJ2-5,CASSSRWGAGDYQETQYF,0,3,1,3
TRBV28,TRBJ2-7,CASSPNKGDPLIGYEQYF,0,3,1,3
TRBV7-9,TRBJ2-6,CASSPRGQGEAGANVLTF,0,3,1,3
TRBV5-5,TRBJ2-1,CASSPGPGLADFYNEQFF,0,3,1,3
TRBV9,TRBJ2-5,CASSPGLAGGPGQETQYF,0,3,1,3
TRBV7-2,TRBJ2-1,CASSHRTSGVVSYNEQFF,0,3,1,3
TRBV4-2,TRBJ1-5,CASSQDGDNVASNQPQHF,0,3,1,3
TRBV9,TRBJ2-7,CASSVFTLAGGSSYEQYF,0,3,1,3
TRBV4-2,TRBJ2-2,CASSTWTGLTLNTGELFF,0,3,1,3
TRBV12-3/4,TRBJ2-1,CASRPFGGPTSGFNEQFF,0,3,1,3
TRBV4-1,TRBJ2-2,CPSSQEPLAASNTGELFF,0,3,1,3
TRBV5-1,TRBJ1-2,CASSLGKNRENGLNGYTF,0,3,1,3
TRBV4-3,TRBJ2-3,CASSQLTSGRPVTDTQYF,0,3,1,3
TRBV4-1,TRBJ1-4,CASRQETSGVLSNEKLFF,0,3,1,3
TRBV20-1,TRBJ2-1,CSASGEGGRLYYSNEQFF,0,3,1,3
TRBV20-1,TRBJ1-2,CSARDQWDRDGENYGYTF,0,3,1,3
TRBV20-1,TRBJ2-7,CSARDPYTGTVSSYEQYF,0,3,1,3
TRBV20-1,TRBJ2-1,CSAREKLSFSGRASEQFF,0,3,1,3
TRBV20-1,TRBJ2-3,CSASGTSGRGWGTDTQYF,0,3,1,3
TRBV29-1,TRBJ2-1,CSTRRAGSSAPPYNEQFF,0,3,1,3
TRBV13,TRBJ1-1,CACSLGLRRVSGTEAFF,0,3,1,3
TRBV30,TRBJ1-6,CAWRYSWQDKPNSPLHF,0,3,1,3
TRBV10-3,TRBJ2-1,CAITKHVGDRLFGEQFF,0,3,1,3
TRBV10-3,TRBJ1-5,CAIRRGGRGASNQPQHF,0,3,1,3
TRBV15,TRBJ2-7,CATSTEIGGESSYEQYF,0,3,1,3
TRBV19,TRBJ1-5,CASWAGTGGFSNQPQHF,0,3,1,3
TRBV6-2/3/5/6,TRBJ2-1,CASSPPSSGVSLNEQFF,0,3,1,3
TRBV19,TRBJ1-1,CASSIFGGGPGATEAFF,0,3,1,3
TRBV19,TRBJ2-2,CASSMGPFPSNTGELFF,0,3,1,3
TRBV19,TRBJ2-2,CASRPMGGAGGTGELFF,0,3,1,3
TRBV18,TRBJ1-1,CASSPSPGQGANTEAFF,0,3,1,3
TRBV18,TRBJ2-7,CASSPRQETSSSYEQYF,0,3,1,3
TRBV18,TRBJ2-3,CASSPPRDLSSTDTQYF,0,3,1,3
TRBV18,TRBJ2-3,CASSPGPSGASTDTQYF,0,3,1,3
TRBV7-9,TRBJ1-1,CASIPGGPGPMNTEAFF,0,3,1,3
TRBV6-2/3/5/6,TRBJ2-6,CASTDRQGRSGANVLTF,0,3,1,3
TRBV28,TRBJ2-3,CASSFPPTITSTDTQYF,0,3,1,3
TRBV12-3/4,TRBJ1-3,CASSFNFQGILGNTIYF,0,3,1,3
TRBV28,TRBJ2-4,CASSLTGSPRAKNILYF,0,3,1,3
TRBV6-2/3/5/6,TRBJ1-6,CASSSAPGTAVYSPLHF,0,3,1,3
TRBV6-2/3/5/6,TRBJ1-2,CASSYFTTGTANYGYTF,0,3,1,3
TRBV6-2/3/5/6,TRBJ2-7,CASSYSLGGVNSYEQYF,0,3,1,3
TRBV6-2/3/5/6,TRBJ2-1,CASSYSWRLKSYNEQFF,0,3,1,3
TRBV6-2/3/5/6,TRBJ2-1,CASSYSNSRPGGNEQFF,0,3,1,3
TRBV6-2/3/5/6,TRBJ2-1,CASSYSKRLVSYNEQFF,0,3,1,3
TRBV6-2/3/5/6,TRBJ2-1,CASSYGLAGSRGNEQFF,0,3,1,3
TRBV12-3/4,TRBJ2-6,CASSLPGRNSGANVLTF,0,3,1,3
TRBV6-1,TRBJ1-5,CASSEPAGRITNQPQHF,0,3,1,3
TRBV25-1,TRBJ2-3,CASSELWRLNLPPTQYF,0,3,1,3
TRBV12-3/4,TRBJ2-5,CASSTQLRLAGAETQYF,0,3,1,3
TRBV7-2,TRBJ2-6,CASSFGQGTTGANVLTF,0,3,1,3
TRBV5-6,TRBJ2-1,CASSLSGTSGPYNEQFF,0,3,1,3
TRBV7-2,TRBJ1-5,CASSLDSAEISNQPQHF,0,3,1,3
TRBV5-5,TRBJ1-5,CASSLEVTFYSNQPQHF,0,3,1,3
TRBV7-2,TRBJ2-1,CASSLPPGTSGYNEQFF,0,3,1,3
TRBV7-8,TRBJ2-3,CASSLGGARAWADTQYF,0,3,1,3
TRBV11-2,TRBJ2-3,CASSLDRRGYRPDTQYF,0,3,1,3
TRBV7-2,TRBJ2-1,CASSLMVTSSPFYEQFF,0,3,1,3
TRBV12-3/4,TRBJ1-1,CASSLTFKGDRNTEAFF,0,3,1,3
TRBV7-2,TRBJ2-5,CASSLRPFGGGQEAQYF,0,3,1,3
TRBV7-8,TRBJ1-1,CASSSLRDRTMNTEAFF,0,3,1,3
TRBV7-6,TRBJ2-2,CASSSRPGTGVSGELFF,0,3,1,3
TRBV6-2/3/5/6,TRBJ2-7,CASSSARGTSGSYEQYF,0,3,1,3
TRBV7-3,TRBJ1-3,CASSSTGTGFSGNTIYS,0,3,1,3
TRBV7-9,TRBJ2-7,CASSPSGTGGRSEEQYF,0,3,1,3
TRBV13,TRBJ1-1,CASSPQGEGGRNTEAFF,0,3,1,3
TRBV25-1,TRBJ1-2,CASSPGVESAQKYGYTF,0,3,1,3
TRBV7-2,TRBJ2-3,CASSPWDSSLSTDTQYF,0,3,1,3
TRBV12-3/4,TRBJ2-7,CASSRAAGTRASYEQYF,0,3,1,3
TRBV3-1,TRBJ2-7,CASSQPGLAGVPVEQYF,0,3,1,3
TRBV3-1,TRBJ1-5,CASSQGPGQGAGQPQHF,0,3,1,3
TRBV3-1,TRBJ2-7,CASSQDFGGRQPLEQYF,0,3,1,3
TRBV3-1,TRBJ2-3,CASSQDLLAEYTDPQYF,0,3,1,3
TRBV4-2,TRBJ2-1,CASSQDPGLAGHNEQFF,0,3,1,3
TRBV3-1,TRBJ2-1,CASSQEFFGSIYNEQFF,0,3,1,3
TRBV7-9,TRBJ1-6,CASSQTGGESYNSPLHF,0,3,1,3
TRBV9,TRBJ2-4,CASSVSRLVGSYHIQYF,0,3,1,3
TRBV9,TRBJ2-1,CASSVPRAGVSYNEQFF,0,3,1,3
TRBV9,TRBJ2-5,CASSVGLAGGPVETQYF,0,3,1,3
TRBV3-1,TRBJ2-1,CASSTGTSGRIWNEQFF,0,3,1,3
TRBV5-6,TRBJ1-1,CASRLSPGAPSNTEAFF,0,3,1,3
TRBV4-2,TRBJ2-3,CASRPALAGGQRDTQYF,0,3,1,3
TRBV2,TRBJ1-1,CASKDFGPQGPSTEAFF,0,3,1,3
TRBV4-3,TRBJ2-7,CASGQETSGQATGEQYF,0,3,1,3
TRBV5-1,TRBJ2-1,CASSLVASGRGSNEQFF,0,3,1,3
TRBV5-1,TRBJ1-3,CASSLSVTGLSGNTIYF,0,3,1,3
TRBV5-1,TRBJ1-6,CASSSPEGSDYNSPLHF,0,3,1,3
TRBV5-1,TRBJ1-1,CASSYIVIGGPGTEAFF,0,3,1,3
TRBV4-3,TRBJ1-1,CASSLLFRGSVFTEAFF,0,3,1,3
TRBV5-1,TRBJ2-1,CASSPGGLASSYNEQFF,0,3,1,3
TRBV5-1,TRBJ2-7,CASSPGLAGASSYEQYF,0,3,1,3
TRBV5-1,TRBJ2-1,CASSPSGLAGGYNEQFF,0,3,1,3
TRBV4-1,TRBJ1-3,CASSPTEGRSSGNTIYF,0,3,1,3
TRBV4-1,TRBJ2-3,CASSQGNGRKSTDTQYF,0,3,1,3
TRBV4-1,TRBJ1-5,CASSQGPAQGGNQPQHF,0,3,1,3
TRBV4-3,TRBJ2-1,CASSQDDPGSSYNEQFF,0,3,1,3
TRBV4-1,TRBJ1-2,CASSQDLGTGGASGYTF,0,3,1,3
TRBV4-1,TRBJ2-3,CASSQKAVKGVGDTQYF,0,3,1,3
TRBV5-1,TRBJ2-1,CASSQKSDLASYNEQFF,0,3,1,3
TRBV4-1,TRBJ2-3,CASSDGTSGIGEDTQYF,0,3,1,3
TRBV20-1,TRBJ1-1,CSARVSETNLRNTEAFF,0,3,1,3
TRBV20-1,TRBJ2-4,CSARAPWTSGGSDIQYF,0,3,1,3
TRBV20-1,TRBJ1-4,CSARATGKRTANEKLFF,0,3,1,3
TRBV20-1,TRBJ1-5,CSARDYGQAKGFQPQHF,0,3,1,3
TRBV20-1,TRBJ1-6,CSARDLRTGVGNSPLHF,0,3,1,3
TRBV20-1,TRBJ2-1,CSARDISWGIKDNEQFF,0,3,1,3
TRBV29-1,TRBJ1-1,CSVRRPGTGERDTEAFF,0,3,1,3
TRBV29-1,TRBJ2-1,CSDTLAGGPMTYNEQFF,0,3,1,3
TRBV20-1,TRBJ2-1,CRARDPQLAVTSGEQFF,0,3,1,3
TRBV27,TRBJ1-5,RASSLRGAGMGNQPQHF,0,3,1,3
TRBV7-3,TRBJ2-2,RASSPPPDSPNTGELFF,0,3,1,3
TRBV30,TRBJ2-2,CAWSVLGAGGTGELFF,0,3,1,3
TRBV30,TRBJ2-5,CAWSVKTFSNQETQYF,0,3,1,3
TRBV30,TRBJ2-7,CAWSGRLGIVYHEQYF,0,3,1,3
TRBV10-3,TRBJ2-3,CAISETGTSGRDTQYF,0,3,1,3
TRBV7-2,TRBJ1-5,CAISLSRQGVGQPQRF,0,3,1,3
TRBV10-3,TRBJ1-5,CAIKDTIFDLHQPQHF,0,3,1,3
TRBV24-1,TRBJ2-5,CATSDSDPAAQETQYF,0,3,1,3
TRBV15,TRBJ2-3,CATSRRLAGHADTQYF,0,3,1,3
TRBV15,TRBJ1-1,CATSRRGQGSNTEAFF,0,3,1,3
TRBV15,TRBJ2-1,CATSRVGRDSYNEQFF,0,3,1,3
TRBV15,TRBJ1-5,CATSRDKGFSNQPQHF,0,3,1,3
TRBV19,TRBJ2-1,CASSLQTSRAHNEQFF,0,3,1,3
TRBV19,TRBJ2-1,CASSIPGVSGGNEQFF,0,3,1,3
TRBV19,TRBJ2-5,CASSIRLAGYQETQYF,0,3,1,3
TRBV19,TRBJ1-5,CASSIVGTGSNQPQHF,0,3,1,3
TRBV19,TRBJ2-5,CASSIDHILSQETQYF,0,3,1,3
TRBV18,TRBJ2-1,CASSPLTGALSNEQFF,0,3,1,3
TRBV18,TRBJ2-3,CASSPPPSGITDTQYF,0,3,1,3
TRBV18,TRBJ2-2,CASSPQSGGNTGELFF,0,3,1,3
TRBV7-2,TRBJ2-1,CASLFRGSGTGNEQFF,0,3,1,3
TRBV5-5,TRBJ2-5,CASRVAGPSYQETQYF,0,3,1,3
TRBV2,TRBJ2-2,CASITTGTGNTGELFF,0,3,1,3
TRBV12-3/4,TRBJ2-3,CASIDLNRFSTDTQYF,0,3,1,3
TRBV2,TRBJ1-5,CASTIMGARSNQPQHF,0,3,1,3
TRBV12-3/4,TRBJ2-5,CASTRRGREAQETQYF,0,3,1,3
TRBV2,TRBJ2-7,CASSFSLAGFSYEQYF,0,3,1,3
TRBV6-2/3/5/6,TRBJ2-1,CASSLSRTGLVFEQFF,0,3,1,3
TRBV12-3/4,TRBJ2-4,CASSLGQGLAKNIQYF,0,3,1,3
TRBV27,TRBJ2-3,CASSLSIAGGRDTQYF,0,3,1,3
TRBV27,TRBJ2-3,CASSLWSGTSTDTQYF,0,3,1,3
TRBV27,TRBJ1-6,CASSLPGQGRGSPLHF,0,3,1,3
TRBV12-3/4,TRBJ1-3,CASSLIRTVFGNTIYF,0,3,1,3
TRBV12-3/4,TRBJ1-2,CASSLSGRGGAHGYTF,0,3,1,3
TRBV12-3/4,TRBJ1-2,CASSSENRDRGYGYTF,0,3,1,3
TRBV11-1,TRBJ2-7,CASSSRSTSAAYEQYF,0,3,1,3
TRBV7-9,TRBJ2-7,CASSWGVGQTTYEQYF,0,3,1,3
TRBV27,TRBJ2-7,CASSWTGQPSRDEQYF,0,3,1,3
TRBV6-2/3/5/6,TRBJ1-2,CASSYRQGAVNYGYTF,0,3,1,3
TRBV6-2/3/5/6,TRBJ2-1,CASSYSSGLSYNEQFF,0,3,1,3
TRBV6-2/3/5/6,TRBJ1-4,CASSYSHASTDEKLFF,0,3,1,3
TRBV5-4,TRBJ2-3,CASSYPGTGTTDTQYF,0,3,1,3
TRBV6-2/3/5/6,TRBJ2-1,CASSYRHGQGANEQFF,0,3,1,3
TRBV6-2/3/5/6,TRBJ1-5,CASSYEGTRGDQPQHF,0,3,1,3
TRBV6-2/3/5/6,TRBJ2-2,CASSYTRDRFFGELFF,0,3,1,3
TRBV27,TRBJ2-1,CASSPNLAGEFNEQFF,0,3,1,3
TRBV12-3/4,TRBJ2-5,CASSPIAGGVQETQYF,0,3,1,3
TRBV7-2,TRBJ1-2,CASSHYRSLRNYGYTF,0,3,1,3
TRBV6-1,TRBJ2-4,CASSQPSDRGRNIQYF,0,3,1,3
TRBV2,TRBJ2-7,CASSGFGTANSYEQYF,0,3,1,3
TRBV25-1,TRBJ2-3,CASSGTSGMFTDTQYF,0,3,1,3
TRBV6-1,TRBJ2-5,CASSGPKTEPGETQYF,0,3,1,3
TRBV6-4,TRBJ2-1,CASSDSDLNNYNEQFF,0,3,1,3
TRBV12-3/4,TRBJ2-1,CASSDLTSGRAYEQFF,0,3,1,3
TRBV6-4,TRBJ2-4,CASSDRGRGAKNIQYF,0,3,1,3
TRBV6-1,TRBJ1-1,CASSEWSSSGPTEAFF,0,3,1,3
TRBV2,TRBJ2-1,CASSEVLAGPFSEQFF,0,3,1,3
TRBV2,TRBJ1-1,CASSEIGTGWATEAFF,0,3,1,3
TRBV12-3/4,TRBJ2-1,CASSIPTSGSLAEQFF,0,3,1,3
TRBV7-9,TRBJ2-3,CASSFPGQEGTDTQYF,0,3,1,3
TRBV5-4,TRBJ1-2,CASSFQVGQGGNGYTF,0,3,1,3
TRBV7-9,TRBJ2-5,CASSFGRQGNQETQYF,0,3,1,3
TRBV7-2,TRBJ2-2,CASSFTGGTGPGGLFF,0,3,1,3
TRBV9,TRBJ2-1,CASSFLAGDPTNEQFF,0,3,1,3
TRBV5-4,TRBJ2-5,CASSFPAGGPQETQYF,0,3,1,3
TRBV5-4,TRBJ2-1,CASSFPTGSSYNEQFF,0,3,1,3
TRBV7-9,TRBJ2-5,CASSFGSGGYGETQYF,0,3,1,3
TRBV5-5,TRBJ2-1,CASSLLAGGPSNEQFF,0,3,1,3
TRBV5-6,TRBJ1-4,CASSLWRTATNEKLFF,0,3,1,3
TRBV5-4,TRBJ2-5,CASSLPFSGDKETQYF,0,3,1,3
TRBV7-9,TRBJ2-1,CASSLRLAGGVNEQFF,0,3,1,3
TRBV5-5,TRBJ2-7,CASSLGLAGVGDEQYF,0,3,1,3
TRBV7-9,TRBJ1-1,CASSLGGRGPNTEAFF,0,3,1,3
TRBV7-2,TRBJ2-1,CASSLLPDNSYNEQFF,0,3,1,3
TRBV7-9,TRBJ2-1,CASSLSSGFSYNEQFF,0,3,1,3
TRBV7-6,TRBJ2-5,CASSLSPRQTQETQYF,0,3,1,3
TRBV7-9,TRBJ1-2,CASSLSGETPTYGYTF,0,3,1,3
TRBV6-2/3/5/6,TRBJ1-1,CASSLLWSPRNTEAFF,0,3,1,3
TRBV7-2,TRBJ2-1,CASSLVSLAGRNEQFF,0,3,1,3
TRBV7-9,TRBJ2-5,CASSLVDSPSQETQYF,0,3,1,3
TRBV7-9,TRBJ1-4,CASSLVSGVTNEKLFF,0,3,1,3
TRBV7-6,TRBJ2-7,CASSLVEGTTSYEQYF,0,3,1,3
TRBV7-2,TRBJ2-5,CASSLVASGRWETQYF,0,3,1,3
TRBV7-9,TRBJ1-2,CASSLAQGTGGYGYTF,0,3,1,3
TRBV5-6,TRBJ2-7,CASSLATGTGIYEQYF,0,3,1,3
TRBV7-9,TRBJ1-3,CASSLGQGSVTDTIYF,0,3,1,3
TRBV11-1,TRBJ2-1,CASSLDWASGQNEQFF,0,3,1,3
TRBV11-3,TRBJ2-2,CASSLIGGTNTGELFF,0,3,1,3
TRBV7-2,TRBJ2-3,CASSLTPGLGTDTQYF,0,3,1,3
TRBV7-2,TRBJ1-4,CASSSFPRGRYEKLFF,0,3,1,3
TRBV7-9,TRBJ2-7,CASSSWDRGNSYEQYF,0,3,1,3
TRBV11-2,TRBJ2-3,CASSSPRGGRGDTQYF,0,3,1,3
TRBV7-2,TRBJ2-3,CASSSQGGRATDTQYF,0,3,1,3
TRBV7-9,TRBJ1-1,CASSSRRPGVNTEAFF,0,3,1,3
TRBV7-9,TRBJ2-5,CASSSKAGTEKETQYF,0,3,1,3
TRBV7-9,TRBJ1-1,CASSSALGTGNTEAFF,0,3,1,3
TRBV7-9,TRBJ1-5,CASSSEEDSANQPQHS,0,3,1,3
TRBV11-3,TRBJ2-1,CASSSRTSGPYNEQFF,0,3,1,3
TRBV7-2,TRBJ2-3,CASSSNPSGGADTQYF,0,3,1,3
TRBV7-9,TRBJ1-1,CASSSTRRLEDTEAFF,0,3,1,3
TRBV7-6,TRBJ2-5,CASSSSSGTGEETQYF,0,3,1,3
TRBV6-2/3/5/6,TRBJ1-4,CASSWRGAATNEKLFF,0,3,1,3
TRBV14,TRBJ2-7,CASSLRPGGESYEQYF,0,3,1,3
TRBV27,TRBJ1-1,CASSLRGDRVGTEAFF,0,3,1,3
TRBV7-3,TRBJ2-1,CASSLSGTGSSIEQFF,0,3,1,3
TRBV4-2,TRBJ2-1,CASSLPSRGGYNEQFF,0,3,1,3
TRBV7-2,TRBJ2-2,CASSLRGGANTGELFF,0,3,1,3
TRBV7-3,TRBJ2-7,CASSLKGGQPIYEQYF,0,3,1,3
TRBV7-2,TRBJ2-5,CASSPLLAGEAETQYF,0,3,1,3
TRBV13,TRBJ2-3,CASSPPGTSGVDTQYF,0,3,1,3
TRBV5-4,TRBJ2-5,CASSPPGLASKETQYF,0,3,1,3
TRBV3-1,TRBJ2-3,CASSPGTSGVRDTQYF,0,3,1,3
TRBV7-9,TRBJ1-1,CASSPDRGRGDTEAFF,0,3,1,3
TRBV7-9,TRBJ2-7,CASSPNSGEEYYEQYF,0,3,1,3
TRBV7-2,TRBJ2-5,CASSPRGGLGGEAQYF,0,3,1,3
TRBV11-2,TRBJ2-1,CASSPQRGASYNEQFF,0,3,1,3
TRBV7-9,TRBJ1-3,CASSPQGGASGNTIYF,0,3,1,3
TRBV11-2,TRBJ2-1,CASSPVGLWEYNEQFF,0,3,1,3
TRBV7-2,TRBJ2-7,CASSPAPDRSAYEQYF,0,3,1,3
TRBV7-9,TRBJ1-1,CASSPGGVTSHTEAFF,0,3,1,3
TRBV7-8,TRBJ1-2,CASSPGTGNMVYGYTF,0,3,1,3
TRBV7-3,TRBJ2-3,CASSPSRRTSTDTQYF,0,3,1,3
TRBV4-2,TRBJ2-5,CASSPTSGAQRETQYF,0,3,1,3
TRBV7-2,TRBJ1-1,CASSPRDPTGRASAFF,0,3,1,3
TRBV11-3,TRBJ1-2,CASSPHPGGRNYGYTF,0,3,1,3
TRBV7-9,TRBJ2-1,CASSPQGGALYNEQFF,0,3,1,3
TRBV7-3,TRBJ2-3,CASSPVGLGGTDTQYF,0,3,1,3
TRBV5-8,TRBJ2-2,CASSRSGFLQGGELFF,0,3,1,3
TRBV7-9,TRBJ2-5,CASSRMSGSATRTQYF,0,3,1,3
TRBV14,TRBJ1-1,CASSRTSWGRNTEAFF,0,3,1,3
TRBV4-2,TRBJ2-3,CASSQVFGGGTDTQYF,0,3,1,3
TRBV14,TRBJ1-4,CASSQVALKGNEKPFF,0,3,1,3
TRBV14,TRBJ2-2,CASSQGGDWNTGELFF,0,3,1,3
TRBV4-2,TRBJ1-1,CASSQGAWSGNTEAFF,0,3,1,3
TRBV3-1,TRBJ2-3,CASSQDPQPGTDTQYF,0,3,1,3
TRBV3-1,TRBJ1-2,CASSQDPQLDAYGYTF,0,3,1,3
TRBV14,TRBJ1-1,CASSQDEGGLNTEAFF,0,3,1,3
TRBV4-2,TRBJ2-1,CASSQESSGPFGEQFF,0,3,1,3
TRBV3-1,TRBJ2-6,CASSQEGYSGANVLTF,0,3,1,3
TRBV4-2,TRBJ2-7,CASSQELAGTSYEQYF,0,3,1,3
TRBV4-2,TRBJ2-7,CASSQERQGGLWEQYF,0,3,1,3
TRBV9,TRBJ2-7,CASSVGGDRLSYEQYF,0,3,1,3
TRBV9,TRBJ1-2,CASSVAWTGVGYGYTF,0,3,1,3
TRBV7-2,TRBJ2-2,CASSARTSAYTGELFF,0,3,1,3
TRBV9,TRBJ2-1,CASSGRQGSSYNEQFF,0,3,1,3
TRBV4-2,TRBJ2-2,CASSGGREGNTGELFF,0,3,1,3
TRBV5-4,TRBJ2-5,CASSGDQGQRAETQYF,0,3,1,3
TRBV7-6,TRBJ2-1,CASSDRAGGAHNEQFF,0,3,1,3
TRBV7-9,TRBJ2-5,CASSEGTRGGGETQYF,0,3,1,3
TRBV5-8,TRBJ1-2,CASSEDGGLEFYGYTF,0,3,1,3
TRBV14,TRBJ2-3,CASSKTSGGRTDTQYF,0,3,1,3
TRBV12-3/4,TRBJ2-3,CASRLRSGAGTDTQYF,0,3,1,3
TRBV11-2,TRBJ2-3,CASRGLAGGALGAQYF,0,3,1,3
TRBV5-8,TRBJ1-1,CASRIPRSPRDTEAFF,0,3,1,3
TRBV7-9,TRBJ1-1,CASRSGQTGRGTEAFF,0,3,1,3
TRBV12-3/4,TRBJ2-2,CASRSRGGGITGELFF,0,3,1,3
TRBV3-1,TRBJ2-5,CASRWTGANFQETQYF,0,3,1,3
TRBV6-2/3/5/6,TRBJ1-1,CASRPGTVGLNTEAFF,0,3,1,3
TRBV6-2/3/5/6,TRBJ2-5,CASRPDRGSKPETQYF,0,3,1,3
TRBV28,TRBJ1-4,CASRRGGVLGEEKLFF,0,3,1,3
TRBV5-5,TRBJ2-2,CASNKRGYSNTGELFF,0,3,1,3
TRBV6-2/3/5/6,TRBJ1-5,CASKVGTVYSNQPQHF,0,3,1,3
TRBV13,TRBJ2-1,CTSSPTFGQGYNEQFF,0,3,1,3
TRBV4-1,TRBJ2-7,CACSQVPGTKNYEQYF,0,3,1,3
TRBV10-2,TRBJ2-5,CASGDVGLAAQETQYF,0,3,1,3
TRBV4-1,TRBJ2-1,CASSPGIAGGGNEQFF,0,3,1,3
TRBV5-1,TRBJ2-5,CASSFVSGGPQETQYF,0,3,1,3
TRBV5-1,TRBJ1-1,CASSLFAPALNTEAFF,0,3,1,3
TRBV5-1,TRBJ2-1,CASSLSRDRVVNEQFF,0,3,1,3
TRBV5-1,TRBJ2-5,CASSLALASGQETQYF,0,3,1,3
TRBV5-1,TRBJ2-7,CASSLAPAGSAYEQYF,0,3,1,3
TRBV5-1,TRBJ2-7,CASSLGRDRGNPEQYF,0,3,1,3
TRBV5-1,TRBJ2-7,CASSLESGVYLYEQYF,0,3,1,3
TRBV5-1,TRBJ1-2,CASSSPSGQGAYGYAF,0,3,1,3
TRBV5-1,TRBJ2-4,CASSWGLGGTKNIQYF,0,3,1,3
TRBV5-1,TRBJ2-5,CASSPGTGGGLETQYF,0,3,1,3
TRBV5-1,TRBJ2-3,CASSPRRGDLTDTQYF,0,3,1,3
TRBV4-1,TRBJ2-7,CASSQTRLAGSYEQYF,0,3,1,3
TRBV4-3,TRBJ2-1,CASSQSVAGGGNGQFF,0,3,1,3
TRBV4-3,TRBJ2-1,CASSQSVAGGGNEQFF,0,3,1,3
TRBV4-1,TRBJ1-3,CASSQYSGPGGNTIYF,0,3,1,3
TRBV4-1,TRBJ1-2,CASSQVFPETSYGYTF,0,3,1,3
TRBV4-3,TRBJ2-7,CASSQDPGGLLDEQYF,0,3,1,3
TRBV4-3,TRBJ2-1,CASSQEGAGGPNEQFF,0,3,1,3
TRBV20-1,TRBJ2-1,CSVQGTSGRRYNEQFF,0,3,1,3
TRBV20-1,TRBJ1-3,CSAILRTGNSGNTIYF,0,3,1,3
TRBV20-1,TRBJ2-3,CSARGLTSGSWDTQYF,0,3,1,3
TRBV20-1,TRBJ2-1,CSARSPGTSGGGEQFF,0,3,1,3
TRBV20-1,TRBJ1-5,CSARLYGQGDNQPQHF,0,3,1,3
TRBV20-1,TRBJ2-1,CSARGGPTRSYNEQFF,0,3,1,3
TRBV20-1,TRBJ1-5,CSARGRTLYSNQPQHF,0,3,1,3
TRBV20-1,TRBJ2-1,CSARDEGTSSPNEQFF,0,3,1,3
TRBV20-1,TRBJ2-7,CSARITGLDPSYEQYF,0,3,1,3
TRBV20-1,TRBJ2-5,CSARKKLAGGRETQYF,0,3,1,3
TRBV20-1,TRBJ1-4,CSTTGTPFATNEKLFF,0,3,1,3
TRBV29-1,TRBJ2-1,CSVRGKGPSSYNEQFF,0,3,1,3
TRBV29-1,TRBJ2-3,CSVVGPSGSSTDTQYF,0,3,1,3
TRBV29-1,TRBJ2-1,CSVEITLGSAGDEQFF,0,3,1,3
TRBV29-1,TRBJ2-1,CSVELRDPSSYNEQFF,0,3,1,3
TRBV29-1,TRBJ1-6,CSADPRAETYNSPLHF,0,3,1,3
TRBV29-1,TRBJ2-5,CSGAWWEEPPQETQYF,0,3,1,3
TRBV5-5,TRBJ2-2,YASSLDGGTNTGELFF,0,3,1,3
TRBV11-2,TRBJ2-6,RASSLGAHSGANVLTF,0,3,1,3
TRBV20-1,TRBJ1-3,RSARITFGFSGNTIYF,0,3,1,3
TRBV12-5,TRBJ2-1,CASGNPGLAFNKQFF,0,3,1,3
TRBV30,TRBJ1-2,CAWSPPGGPFYGYTF,0,3,1,3
TRBV10-3,TRBJ2-1,CAISEVADPPNEQFF,0,3,1,3
TRBV10-3,TRBJ2-1,CAISTSGKNRNEQFF,0,3,1,3
TRBV10-3,TRBJ2-2,CAIRKSGEATGELFF,0,3,1,3
TRBV12-3/4,TRBJ2-1,CATTGQGGGFYEQFF,0,3,1,3
TRBV15,TRBJ1-5,CATSTLLRDYQPQHF,0,3,1,3
TRBV12-3/4,TRBJ2-2,CASSLRQRNTGELFF,0,3,1,3
TRBV19,TRBJ1-1,CASSMSSGTNTEAFF,0,3,1,3
TRBV19,TRBJ2-7,CASSILPDLSYEQYF,0,3,1,3
TRBV19,TRBJ2-7,CASSIGASLGYEQYF,0,3,1,3
TRBV19,TRBJ2-3,CASSIEQGPGATQYF,0,3,1,3
TRBV19,TRBJ1-5,CASSTDAGWNQPQHF,0,3,1,3
TRBV19,TRBJ1-5,CASSTAISGNQPQHF,0,3,1,3
TRBV19,TRBJ1-5,CASSRGQEGNQPQHF,0,3,1,3
TRBV19,TRBJ1-2,CASSNSKPLNYGYTF,0,3,1,3
TRBV19,TRBJ1-5,CASSKGTGGDQPQHF,0,3,1,3
TRBV19,TRBJ2-1,CASSRLAGDFDAQFF,0,3,1,3
TRBV19,TRBJ1-3,CASRPQGTLENTIYF,0,3,1,3
TRBV6-2/3/5/6,TRBJ1-1,CASFLGLGAHTEAFF,0,3,1,3
TRBV18,TRBJ2-2,CASSPPRGNTGELFF,0,3,1,3
TRBV5-6,TRBJ2-2,CASSGLAENTGELFF,0,3,1,3
TRBV18,TRBJ2-5,CASSPEGGWGETQYF,0,3,1,3
TRBV18,TRBJ2-1,CASSPGQGSKNEQFF,0,3,1,3
TRBV18,TRBJ1-2,CASSPGGTGWHGYTF,0,3,1,3
TRBV18,TRBJ2-7,CASSPTGVRSYEQYF,0,3,1,3
TRBV18,TRBJ1-6,CASSRGHPPNSPLHF,0,3,1,3
TRBV27,TRBJ2-7,CASQPGRGFSYEQYY,0,3,1,3
TRBV6-2/3/5/6,TRBJ2-1,CASGGGTSGYLEQFF,0,3,1,3
TRBV6-2/3/5/6,TRBJ1-6,CASIRGDLVNSPLHF,0,3,1,3
TRBV12-3/4,TRBJ2-1,CASIGGSGGLNEQFF,0,3,1,3
TRBV5-6,TRBJ2-1,CASIHSGGHYNEQFF,0,3,1,3
TRBV6-2/3/5/6,TRBJ1-1,CASTSREVLDTEAFF,0,3,1,3
TRBV11-2,TRBJ2-5,CASTLDGGQGETQYF,0,3,1,3
TRBV6-2/3/5/6,TRBJ2-7,CASTRRLAGVNEQYF,0,3,1,3
TRBV12-3/4,TRBJ2-1,CASSFQESSYNEQFF,0,3,1,3
TRBV12-3/4,TRBJ2-1,CASSFALPYNNEQFF,0,3,1,3
TRBV6-2/3/5/6,TRBJ2-3,CASSFGQGGTDTQYF,0,3,1,3
TRBV12-3/4,TRBJ2-1,CASSFSTVSYNEQFF,0,3,1,3
TRBV27,TRBJ2-3,CASSFSGTGGSTQYF,0,3,1,3
TRBV6-2/3/5/6,TRBJ1-5,CASSFWTGPNQPQHF,0,3,1,3
TRBV12-3/4,TRBJ2-5,CASSFGREPLATQYF,0,3,1,3
TRBV27,TRBJ2-3,CASSLRAGDTDTQYF,0,3,1,3
TRBV6-2/3/5/6,TRBJ2-5,CASSLREVTRETQYF,0,3,1,3
TRBV6-2/3/5/6,TRBJ2-3,CASSLFSARPDTQYF,0,3,1,3
TRBV6-2/3/5/6,TRBJ2-7,CASSLSYTETYEQYF,0,3,1,3
TRBV12-3/4,TRBJ2-5,CASSLLLDRAQTQYF,0,3,1,3
TRBV12-3/4,TRBJ1-5,CASSLAPGGLQPQHF,0,3,1,3
TRBV12-3/4,TRBJ1-2,CASSLAGFGFYGYTF,0,3,1,3
TRBV6-2/3/5/6,TRBJ1-2,CASSLGTRMVYGYTF,0,3,1,3
TRBV12-3/4,TRBJ2-3,CASSLELAETDTQHF,0,3,1,3
TRBV12-3/4,TRBJ2-1,CASSLRGGYYNEQFF,0,3,1,3
TRBV12-3/4,TRBJ2-7,CASSSRDWHSYEQYF,0,3,1,3
TRBV28,TRBJ1-1,CASSSPGQGSSKAFF,0,3,1,3
TRBV6-2/3/5/6,TRBJ1-6,CASSSQRSEDSPLHF,0,3,1,3
TRBV6-2/3/5/6,TRBJ2-3,CASSSGTGFTDTQYF,0,3,1,3
TRBV6-2/3/5/6,TRBJ2-7,CASSSGTIYTYEQYF,0,3,1,3
TRBV6-2/3/5/6,TRBJ2-3,CASSWAGKSTDTQYF,0,3,1,3
TRBV6-2/3/5/6,TRBJ1-5,CASSWRQGDRQPQHF,0,3,1,3
TRBV6-2/3/5/6,TRBJ1-2,CASSYRGGANYGYTL,0,3,1,3
TRBV6-2/3/5/6,TRBJ1-1,CASSYSGQGNTEAFF,0,3,1,3
TRBV27,TRBJ1-6,CASSYSGTAGSPLHF,0,3,1,3
TRBV6-2/3/5/6,TRBJ2-7,CASSYGTGSGDEQYF,0,3,1,3
TRBV6-2/3/5/6,TRBJ1-5,CASSYGQGSNQPQHF,0,3,1,3
TRBV6-2/3/5/6,TRBJ1-6,CASSYDQGWNSPLHF,0,3,1,3
TRBV6-2/3/5/6,TRBJ1-5,CASSYTGQQNQPQHF,0,3,1,3
TRBV6-2/3/5/6,TRBJ1-4,CASSLEVQDHEKLFF,0,3,1,3
TRBV6-2/3/5/6,TRBJ2-3,CASSLQGARGDTQYF,0,3,1,3
TRBV27,TRBJ2-2,CASSLEGAGTGELFF,0,3,1,3
TRBV6-2/3/5/6,TRBJ1-2,CASSPRAGWLYGYTF,0,3,1,3
TRBV12-3/4,TRBJ2-2,CASSPIAGSTGELFF,0,3,1,3
TRBV2,TRBJ2-1,CASSPLAGGGNEQFF,0,3,1,3
TRBV6-2/3/5/6,TRBJ2-3,CASSPRTSGKNTQYF,0,3,1,3
TRBV27,TRBJ2-7,CASSHWVSTVYEQYF,0,3,1,3
TRBV2,TRBJ1-5,CASSQKGQGYQPQHF,0,3,1,3
TRBV6-1,TRBJ2-3,CASSARQGSTDTQYL,0,3,1,3
TRBV6-1,TRBJ2-5,CASSATSGAGETQYF,0,3,1,3
TRBV12-3/4,TRBJ2-1,CASSDTSGRDNEQFF,0,3,1,3
TRBV6-4,TRBJ2-3,CASSDSGQGSDTQYF,0,3,1,3
TRBV2,TRBJ2-1,CASSERDSAYNEQFF,0,3,1,3
TRBV25-1,TRBJ2-3,CASSELTTSTDTQYF,0,3,1,3
TRBV6-1,TRBJ2-7,CASSEPGTGSYEQYF,0,3,1,3
TRBV2,TRBJ2-5,CASSEVAGAGETQYF,0,3,1,3
TRBV2,TRBJ1-5,CASSEARQGLGPQHF,0,3,1,3
TRBV6-1,TRBJ2-3,CASSEAYRSTDTQYF,0,3,1,3
TRBV6-1,TRBJ1-2,CASSEARGFHYGYTF,0,3,1,3
TRBV2,TRBJ1-2,CASSEAGRSGYGYTF,0,3,1,3
TRBV6-1,TRBJ1-1,CASSEDWNLNTEAFF,0,3,1,3
TRBV2,TRBJ1-5,CASSEEGLPNQPQHF,0,3,1,3
TRBV2,TRBJ2-1,CASSEETGPYNEQFF,0,3,1,3
TRBV27,TRBJ2-1,CASSIETSGGGGQFF,0,3,1,3
TRBV6-2/3/5/6,TRBJ2-7,CASSTTDRRYYEQYF,0,3,1,3
TRBV7-8,TRBJ2-7,CASSFPWDRVNEQYF,0,3,1,3
TRBV7-2,TRBJ2-1,CASSFSGRVYNEQFF,0,3,1,3
TRBV11-1,TRBJ1-4,CASSFSDVADEKLFF,0,3,1,3
TRBV5-4,TRBJ2-7,CASSFRTGRSYEQYF,0,3,1,3
TRBV5-6,TRBJ2-7,CASSLLGPNPYEQYF,0,3,1,3
TRBV5-6,TRBJ2-5,CASSLLDRNQETQYF,0,3,1,3
TRBV5-6,TRBJ1-1,CASSLWVEPGTEAFF,0,3,1,3
TRBV5-6,TRBJ2-7,CASSLLQGWSGEQYF,0,3,1,3
TRBV7-3,TRBJ2-1,CASSLLAGSYNEQFF,0,3,1,3
TRBV5-6,TRBJ2-7,CASSLPPGASYEQYF,0,3,1,3
TRBV5-4,TRBJ2-3,CASSLRLADTDTQYF,0,3,1,3
TRBV5-6,TRBJ2-5,CASSLVAAVQETQYF,0,3,1,3
TRBV7-9,TRBJ2-3,CASSLASGITDTQYF,0,3,1,3
TRBV5-4,TRBJ1-2,CASSLAGRPDYGYTF,0,3,1,3
TRBV5-4,TRBJ2-1,CASSLGPTDYNEQFF,0,3,1,3
TRBV7-6,TRBJ2-2,CASSLGTGYTGELFF,0,3,1,3
TRBV7-3,TRBJ1-2,CASSLGGHANYGYTF,0,3,1,3
TRBV12-3/4,TRBJ1-1,CASSLTGGLNTEASF,0,3,1,3
TRBV5-6,TRBJ2-7,CASSLRQGVAYEQYF,0,3,1,3
TRBV7-2,TRBJ1-2,CASSLSRTVNYGYTF,0,3,1,3
TRBV7-2,TRBJ1-1,CASSLWGEGNTEAFF,0,3,1,3
TRBV11-2,TRBJ2-1,CASSLRGRALDEQYF,0,3,1,3
TRBV7-2,TRBJ2-6,CASSLVGAGANVLTF,0,3,1,3
TRBV11-2,TRBJ2-3,CASSLVGGGTSVMYF,0,3,1,3
TRBV7-2,TRBJ2-1,CASSLAASSYNEQFF,0,3,1,3
TRBV7-7,TRBJ2-1,CASSLAVGSYNEQFF,0,3,1,3
TRBV11-2,TRBJ2-5,CASSLATRGLETQYF,0,3,1,3
TRBV7-2,TRBJ1-1,CASSLALQGAAEAFF,0,3,1,3
TRBV7-4,TRBJ2-7,CASSLGLAVTYEQYF,0,3,1,3
TRBV7-2,TRBJ2-3,CASSLGDSSTDTQYF,0,3,1,3
TRBV7-9,TRBJ2-7,CASSLGDRGPYEQYF,0,3,1,3
TRBV7-9,TRBJ2-1,CASSLGEALYNEQFF,0,3,1,3
TRBV7-2,TRBJ2-7,CASSLGTGYGYEQYF,0,3,1,3
TRBV7-6,TRBJ1-5,CASSLGQGRRQPQHF,0,3,1,3
TRBV6-2/3/5/6,TRBJ2-7,CASSLGGGGTYEQYF,0,3,1,3
TRBV7-2,TRBJ2-5,CASSLDWGRQESQYF,0,3,1,3
TRBV11-2,TRBJ2-7,CASSLDLATSYELYF,0,3,1,3
TRBV7-9,TRBJ2-7,CASSLEGIWLPEQYF,0,3,1,3
TRBV7-9,TRBJ1-1,CASSLEGKKNTEAFF,0,3,1,3
TRBV5-6,TRBJ2-5,CASSLEEGVQETQYF,0,3,1,3
TRBV7-2,TRBJ2-7,CASSLSDGIPYEQYF,0,3,1,3
TRBV5-6,TRBJ2-1,CASSSSGRGYNEQFF,0,3,1,3
TRBV5-6,TRBJ2-1,CASSSLTASYNEQFF,0,3,1,3
TRBV7-2,TRBJ2-1,CASSSLAGAYNEQFF,0,3,1,3
TRBV7-2,TRBJ1-5,CASSSGGGSNQPQHF,0,3,1,3
TRBV7-9,TRBJ2-2,CASSSGTSYTGELFF,0,3,1,3
TRBV7-3,TRBJ1-5,CASSSDRTSNQPQHF,0,3,1,3
TRBV7-9,TRBJ2-1,CASSSEGGNYNEQFF,0,3,1,3
TRBV6-2/3/5/6,TRBJ1-6,CASSSGGAGNSPLHF,0,3,1,3
TRBV5-4,TRBJ1-1,CASSSSGGWGTEAFF,0,3,1,3
TRBV7-2,TRBJ2-3,CASSSGEGSVSTQYF,0,3,1,3
TRBV7-3,TRBJ2-1,CASSSGTSVYNEQFF,0,3,1,3
TRBV7-2,TRBJ2-1,CASSWGASRHNEQFF,0,3,1,3
TRBV7-6,TRBJ2-3,CASSYRDRSTDAQYF,0,3,1,3
TRBV7-8,TRBJ1-3,CASSYGQGDWNTIYF,0,3,1,3
TRBV3-1,TRBJ1-5,CASSLGAGVGQPQHF,0,3,1,3
TRBV3-1,TRBJ2-2,CASSLGQGATGELFF,0,3,1,3
TRBV6-4,TRBJ2-1,CASSLTGGGYNEQFF,0,3,1,3
TRBV5-4,TRBJ2-7,CASSLFASGTYEQYF,0,3,1,3
TRBV7-2,TRBJ1-4,CASSLDGATNEKLFF,0,3,1,3
TRBV7-9,TRBJ1-2,CASSPPSGGVYGYTF,0,3,1,3
TRBV14,TRBJ1-1,CASSPPGTENTEAFF,0,3,1,3
TRBV6-2/3/5/6,TRBJ1-2,CASSPDGAIDYGYTF,0,3,1,3
TRBV4-2,TRBJ1-1,CASSPEGQSNTEAFF,0,3,1,3
TRBV7-3,TRBJ2-1,CASSPFGQPYNEQFF,0,3,1,3
TRBV5-6,TRBJ1-1,CASSPLGARNTEAFF,0,3,1,3
TRBV11-3,TRBJ2-7,CASSPRTARVNEQYF,0,3,1,3
TRBV12-3/4,TRBJ2-6,CASSPAGTGANVLTF,0,3,1,3
TRBV7-9,TRBJ2-7,CASSPGTGRPSEQYF,0,3,1,3
TRBV5-6,TRBJ2-2,CASSPVARDVGELFF,0,3,1,3
TRBV14,TRBJ1-3,CASSPGVSPGNTIYF,0,3,1,3
TRBV6-2/3/5/6,TRBJ1-5,CASSPMRGGFWPQHF,0,3,1,3
TRBV7-2,TRBJ2-1,CASSPTGLAGGGQFF,0,3,1,3
TRBV7-9,TRBJ2-1,CASSPRQGAFSGQFF,0,3,1,3
TRBV7-9,TRBJ2-7,CASSPRQKTTYEQYF,0,3,1,3
TRBV4-2,TRBJ2-1,CASSPFFSLGNEQFF,0,3,1,3
TRBV14,TRBJ1-2,CASSPLGRGLYGYTF,0,3,1,3
TRBV7-9,TRBJ1-4,CASSPGGRTNEKLFF,0,3,1,3
TRBV4-2,TRBJ1-1,CASSPSGKRDTEAFF,0,3,1,3
TRBV7-6,TRBJ2-3,CASSPRRGGTDTQYF,0,3,1,3
TRBV28,TRBJ2-7,CASSRWEEGYHEQYF,0,3,1,3
TRBV7-2,TRBJ2-1,CASSRRASGHNEQFF,0,3,1,3
TRBV11-2,TRBJ2-1,CASSRRLAGYNEQFF,0,3,1,3
TRBV3-1,TRBJ2-3,CASSRGLTPSDTQYF,0,3,1,3
TRBV7-9,TRBJ2-2,CASSRTGRSTGELFF,0,3,1,3
TRBV13,TRBJ1-5,CASSHRGSGNQPQHF,0,3,1,3
TRBV9,TRBJ2-1,CASSHRDGSGNEQFF,0,3,1,3
TRBV4-2,TRBJ1-2,CASSQGGGSNYGYTF,0,3,1,3
TRBV14,TRBJ2-1,CASSQGTSEYNEQFF,0,3,1,3
TRBV6-4,TRBJ2-3,CASSQLQGTTDTQYF,0,3,1,3
TRBV7-9,TRBJ1-5,CASSQPGTGSQPQHF,0,3,1,3
TRBV3-1,TRBJ1-4,CASSQAFQGRMGLFF,0,3,1,3
TRBV14,TRBJ2-1,CASSQGPRSYNEQFF,0,3,1,3
TRBV3-1,TRBJ2-3,CASSQDLLVADTQYF,0,3,1,3
TRBV3-1,TRBJ1-5,CASSQDIGRDQPQHF,0,3,1,3
TRBV3-1,TRBJ2-3,CASSQDQARTDTQYF,0,3,1,3
TRBV3-1,TRBJ2-5,CASSQDGQGQETQYF,0,3,1,3
TRBV9,TRBJ1-5,CASSVGPGFGQPQHF,0,3,1,3
TRBV13,TRBJ2-3,CASSVGTSDWDTQYF,0,3,1,3
TRBV9,TRBJ1-3,CASSVGGDSGNTIYF,0,3,1,3
TRBV7-6,TRBJ1-3,CASSVDNFSGNTIYF,0,3,1,3
TRBV7-3,TRBJ2-1,CASSASSGRLNEQFF,0,3,1,3
TRBV9,TRBJ2-7,CASSARTSGRAEQYF,0,3,1,3
TRBV5-4,TRBJ2-3,CASSGTSGGTDTQYF,0,3,1,3
TRBV7-2,TRBJ2-5,CASSTLAGALETQYF,0,3,1,3
TRBV7-9,TRBJ2-2,CASSTDRGPTGELFF,0,3,1,3
TRBV7-9,TRBJ2-7,CASSTTLAGGYEQYF,0,3,1,3
TRBV5-4,TRBJ2-7,CASSKPSGESYEQYF,0,3,1,3
TRBV12-3/4,TRBJ2-2,CASRSRDLNTGELFF,0,3,1,3
TRBV11-1,TRBJ2-1,CASRPRGSSYNEQFF,0,3,1,3
TRBV2,TRBJ2-7,CASRQTGTRAYEQYF,0,3,1,3
TRBV7-9,TRBJ2-5,CASRGRDRGRETQYF,0,3,1,3
TRBV6-2/3/5/6,TRBJ1-1,CASRGQGAGNTEAFF,0,3,1,3
TRBV12-3/4,TRBJ2-2,CASRDTRGPAGELFF,0,3,1,3
TRBV12-3/4,TRBJ2-5,CASRLLGTEQETQYF,0,3,1,3
TRBV6-2/3/5/6,TRBJ2-5,CASRPDPWSQETQYF,0,3,1,3
TRBV6-2/3/5/6,TRBJ2-4,CASRPSLRTGNIQYF,0,3,1,3
TRBV2,TRBJ1-4,CASRGLRDRNEKLFF,0,3,1,3
TRBV6-2/3/5/6,TRBJ2-7,CASRGDPQLLYEQYF,0,3,1,3
TRBV6-2/3/5/6,TRBJ2-7,CASRIETGTLYEQYF,0,3,1,3
TRBV12-3/4,TRBJ1-1,CASNPRQGGNTEAFF,0,3,1,3
TRBV2,TRBJ2-4,CASKSGALAKNIQYL,0,3,1,3
TRBV30,TRBJ2-2,CARGMGLLSPGELFF,0,3,1,3
TRBV4-2,TRBJ2-3,CARSPQREGTDTQYF,0,3,1,3
TRBV5-1,TRBJ1-1,CVSSPDRSTNTEAFF,0,3,1,3
TRBV19,TRBJ2-1,CASSKKRTNYNEQFF,0,3,1,3
TRBV5-1,TRBJ2-1,CASPARDREDNEQFF,0,3,1,3
TRBV4-1,TRBJ2-1,CASRLAGASYNEQFF,0,3,1,3
TRBV5-1,TRBJ2-1,CASTSGTLPSNEQFF,0,3,1,3
TRBV5-1,TRBJ1-1,CASSFSVSQNTEAFF,0,3,1,3
TRBV5-1,TRBJ2-7,CASSFGRDPIYEQYF,0,3,1,3
TRBV5-1,TRBJ2-3,CASSLLGQFTDTQYF,0,3,1,3
TRBV5-1,TRBJ1-1,CASSLGAGSATEAFF,0,3,1,3
TRBV5-1,TRBJ2-1,CASSLDDPSYNEQFF,0,3,1,3
TRBV5-1,TRBJ2-3,CASSLEGNGADTQYF,0,3,1,3
TRBV5-1,TRBJ2-2,CASSLGGGNTGELFF,0,3,1,3
TRBV5-1,TRBJ2-1,CASSLTSGGASEQFF,0,3,1,3
TRBV5-1,TRBJ2-1,CASSSDRGTVNEQFF,0,3,1,3
TRBV4-3,TRBJ2-7,CASSLGTTFSNEQYF,0,3,1,3
TRBV5-1,TRBJ2-7,CASSLTGMDLDEQYF,0,3,1,3
TRBV4-1,TRBJ2-4,CASSLLQGAKNIQYF,0,3,1,3
TRBV4-1,TRBJ2-2,CASSLRQMNTGELFF,0,3,1,3
TRBV4-1,TRBJ1-2,CASSLGTGNNYGYTF,0,3,1,3
TRBV5-1,TRBJ2-7,CASSLTGSPSYEQYF,0,3,1,3
TRBV4-1,TRBJ2-7,CASSPGAGGPYEQYF,0,3,1,3
TRBV4-3,TRBJ1-2,CASSPLGQRAGGYTF,0,3,1,3
TRBV4-3,TRBJ2-2,CASSRAPENTGELFF,0,3,1,3
TRBV5-1,TRBJ2-5,CASSRNTRIQETQYF,0,3,1,3
TRBV4-1,TRBJ2-7,CASSHDRGLAYEQYF,0,3,1,3
TRBV4-1,TRBJ2-5,CASSHTGTRGETQYF,0,3,1,3
TRBV4-1,TRBJ1-1,CASSQTQDPNTEAFF,0,3,1,3
TRBV4-1,TRBJ2-1,CASSQVGGAWGEQFF,0,3,1,3
TRBV4-3,TRBJ2-1,CASSQGGLVGGEQFF,0,3,1,3
TRBV4-3,TRBJ1-1,CASSQDSGMNTEAFF,0,3,1,3
TRBV4-3,TRBJ2-4,CASSQDRGLGNIQYF,0,3,1,3
TRBV4-1,TRBJ1-5,CASSQDGESNQPQHF,0,3,1,3
TRBV4-1,TRBJ1-3,CASSQDMGPGNTIYF,0,3,1,3
TRBV4-3,TRBJ2-2,CASSQESGGAGELFF,0,3,1,3
TRBV4-3,TRBJ2-6,CASSQELRGGNVLTF,0,3,1,3
TRBV4-3,TRBJ2-7,CASSQEHRGSYEQYF,0,3,1,3
TRBV4-3,TRBJ2-7,CASSQEVRGSYEQYF,0,3,1,3
TRBV4-3,TRBJ2-7,CASSQEAGGLYEQYF,0,3,1,3
TRBV5-1,TRBJ2-1,CASSTGLAGVLEQFF,0,3,1,3
TRBV5-1,TRBJ1-6,CASRGSWTGHSPLHF,0,3,1,3
TRBV20-1,TRBJ2-5,CSAFLSGRPGETQYF,0,3,1,3
TRBV20-1,TRBJ1-4,CSAFGTATTNEKLFF,0,3,1,3
TRBV20-1,TRBJ1-4,CSAPTALATNEKLFF,0,3,1,3
TRBV20-1,TRBJ2-1,CSAAHRGGRYNEQFF,0,3,1,3
TRBV20-1,TRBJ2-2,CSAGSGRAFSRELFF,0,3,1,3
TRBV20-1,TRBJ1-6,CSAENTDSYNSPLHF,0,3,1,3
TRBV20-1,TRBJ2-1,CSAISGVLSYNEQFF,0,3,1,3
TRBV20-1,TRBJ1-4,CSATNPGGGKEKLFF,0,3,1,3
TRBV20-1,TRBJ2-1,CSARYDPGGRDEQFF,0,3,1,3
TRBV20-1,TRBJ2-1,CSARPSSGSLYEQFF,0,3,1,3
TRBV20-1,TRBJ1-5,CSARVGGPGYQPQHF,0,3,1,3
TRBV20-1,TRBJ2-1,CSARVGLASLHEQFF,0,3,1,3
TRBV20-1,TRBJ2-3,CSARVDSSYTDTQYF,0,3,1,3
TRBV20-1,TRBJ2-3,CSARVAWGGTDTQYF,0,3,1,3
TRBV20-1,TRBJ1-2,CSARGPQGVAYGYTF,0,3,1,3
TRBV20-1,TRBJ1-5,CSARGGRYSNQPQHF,0,3,1,3
TRBV20-1,TRBJ2-7,CSARGGQQRSYEQYF,0,3,1,3
TRBV20-1,TRBJ2-7,CSARGTSGGSYEQYF,0,3,1,3
TRBV20-1,TRBJ2-1,CSARDRDRAYNEQFF,0,3,1,3
TRBV20-1,TRBJ2-7,CSARDGDRSSYEQYF,0,3,1,3
TRBV20-1,TRBJ2-1,CSARDGTPSYNEQFF,0,3,1,3
TRBV20-1,TRBJ2-1,CSARNPGGPRDEQFF,0,3,1,3
TRBV20-1,TRBJ2-1,CSANPGGQDYNEQFF,0,3,1,3
TRBV20-1,TRBJ2-3,CSAKGHPVRRDTQYF,0,3,1,3
TRBV20-1,TRBJ2-1,CSAGRAGDQYNEQFF,0,3,1,3
TRBV29-1,TRBJ1-3,CSFQGPLDSGNTIYF,0,3,1,3
TRBV29-1,TRBJ2-3,CSVVVDRVWADTQYF,0,3,1,3
TRBV29-1,TRBJ2-1,CSVEEAGLARSEQFF,0,3,1,3
TRBV29-1,TRBJ1-1,CSVERGVRMNTEAFF,0,3,1,3
TRBV29-1,TRBJ2-3,CSVPRSSGNTDTQYF,0,3,1,3
TRBV29-1,TRBJ1-4,CSVGGTGSAPRKLFF,0,3,1,3
TRBV29-1,TRBJ2-5,CSAPPAGYLGETQYF,0,3,1,3
TRBV29-1,TRBJ2-3,CSAGGTGAPADTQYF,0,3,1,3
TRBV29-1,TRBJ2-5,CSATYFETGSETQYF,0,3,1,3
TRBV2,TRBJ2-1,YASVAVGTILDEQFF,0,3,1,3
TRBV6-2/3/5/6,TRBJ1-5,YASSQTAGSGQPQHF,0,3,1,3
TRBV14,TRBJ2-7,RASSHLPGQLYEQYF,0,3,1,3
TRBV14,TRBJ2-1,SARSSLAGLANEQFF,0,3,1,3
TRBV27,TRBJ1-6,SASSAGLTHSPLHF,0,3,1,3
TRBV7-2,TRBJ1-5,CVSSLVGSNQPQHF,0,3,1,3
TRBV7-8,TRBJ2-7,CVSSLTGSSYEQYF,0,3,1,3
TRBV12-5,TRBJ1-4,CASGRGPGGEKLFF,0,3,1,3
TRBV2,TRBJ2-5,CASYRTLDGETQYF,0,3,1,3
TRBV12-3/4,TRBJ1-4,CASTPGGTSEKLFF,0,3,1,3
TRBV7-2,TRBJ2-1,CASRDRLVWYEQFL,0,3,1,3
TRBV30,TRBJ1-4,CAWTTGRENEKLFF,0,3,1,3
TRBV30,TRBJ2-1,CAWSVLKRRNEQFF,0,3,1,3
TRBV30,TRBJ2-7,CAWNKWREWDEQYF,0,3,1,3
TRBV30,TRBJ1-2,CAWKVTGGAYGYTF,0,3,1,3
TRBV30,TRBJ2-6,CAWKVDSGANVLTF,0,3,1,3
TRBV10-3,TRBJ2-1,CAISSPHLYNEQFF,0,3,1,3
TRBV10-3,TRBJ2-5,CAISPQEYQETQYF,0,3,1,3
TRBV10-3,TRBJ2-3,CAIKREGRTDTQYF,0,3,1,3
TRBV28,TRBJ2-1,CATTLTGTDNEQFF,0,3,1,3
TRBV7-9,TRBJ1-5,CATDKGARDQPQHF,0,3,1,3
TRBV15,TRBJ2-7,CATTETGTLPPAYF,0,3,1,3
TRBV15,TRBJ1-1,CATSILRPGDEAFF,0,3,1,3
TRBV24-1,TRBJ2-1,CATRRGRLVNEQFF,0,3,1,3
TRBV19,TRBJ2-3,CASTGTSVADTQYF,0,3,1,3
TRBV19,TRBJ2-1,CASSSQSMSGEQFF,0,3,1,3
TRBV19,TRBJ1-1,CASSIQAMNTEAFF,0,3,1,3
TRBV19,TRBJ1-1,CASSKTGLNTEAFF,0,3,1,3
TRBV19,TRBJ2-1,CASSGPGTYNEQFF,0,3,1,3
TRBV19,TRBJ2-7,CASRRTGSSYEQYF,0,3,1,3
TRBV19,TRBJ2-7,CASRERRPPDEQYF,0,3,1,3
TRBV19,TRBJ2-4,CASKLLAGGNIQYF,0,3,1,3
TRBV6-2/3/5/6,TRBJ2-7,CASLERGLRDEQYF,0,3,1,3
TRBV18,TRBJ1-1,CASSPGLSVAEAFF,0,3,1,3
TRBV18,TRBJ2-7,CASSPYRGSYEQYF,0,3,1,3
TRBV18,TRBJ2-1,CASSPPGQYNEQFF,0,3,1,3
TRBV2,TRBJ1-5,CASRVTGIWQPQHF,0,3,1,3
TRBV12-3/4,TRBJ2-1,CASRTQKNYNEQFF,0,3,1,3
TRBV2,TRBJ1-2,CASQGQGSRYGYTF,0,3,1,3
TRBV11-2,TRBJ2-7,CASASTGGPYEQYF,0,3,1,3
TRBV11-2,TRBJ2-3,CASGPWLSTDTQYF,0,3,1,3
TRBV2,TRBJ2-7,CASGGQRFSYEQYF,0,3,1,3
TRBV6-2/3/5/6,TRBJ2-3,CASGISGARDTQYF,0,3,1,3
TRBV7-3,TRBJ1-3,CASIRQVSGNTIYF,0,3,1,3
TRBV7-8,TRBJ2-1,CASTRASGSHEQFF,0,3,1,3
TRBV27,TRBJ1-1,CASTLTGMNTEAFF,0,3,1,3
TRBV12-3/4,TRBJ1-2,CASTPDREGGGYTF,0,3,1,3
TRBV12-3/4,TRBJ1-6,CASTRTGEGSPLHF,0,3,1,3
TRBV12-3/4,TRBJ1-2,CASTHSGGAYGYTF,0,3,1,3
TRBV12-3/4,TRBJ2-2,CASTGTGPTGELFF,0,3,1,3
TRBV6-2/3/5/6,TRBJ2-3,CASTGARNTDTQYF,0,3,1,3
TRBV6-2/3/5/6,TRBJ2-7,CASSFRRKAYEQYF,0,3,1,3
TRBV6-2/3/5/6,TRBJ2-5,CASSFQFVRETQYF,0,3,1,3
TRBV12-3/4,TRBJ2-3,CASSFQLAADTQYF,0,3,1,3
TRBV12-3/4,TRBJ1-1,CASSFGQGVTEAFF,0,3,1,3
TRBV6-2/3/5/6,TRBJ2-3,CASSFDTSTDTQYF,0,3,1,3
TRBV28,TRBJ2-2,CASSLTGPTGELFF,0,3,1,3
TRBV6-2/3/5/6,TRBJ1-1,CASSLLGGSTEAFL,0,3,1,3
TRBV12-3/4,TRBJ1-2,CASSLVGQSYGYTF,0,3,1,3
TRBV12-3/4,TRBJ1-6,CASSLAEGNSPLHF,0,3,1,3
TRBV12-3/4,TRBJ1-1,CASSLARAVAEAFF,0,3,1,3
TRBV6-2/3/5/6,TRBJ1-6,CASSLRQGSSPLHF,0,3,1,3
TRBV12-3/4,TRBJ1-2,CASSLRGQGYGYTY,0,3,1,3
TRBV5-4,TRBJ1-2,CASSSVTGGHGYTF,0,3,1,3
TRBV6-2/3/5/6,TRBJ1-2,CASSSRIPNYGYTF,0,3,1,3
TRBV6-2/3/5/6,TRBJ2-1,CASSWGSQYNEQFF,0,3,1,3
TRBV6-2/3/5/6,TRBJ1-2,CASSYSAGYGGYTF,0,3,1,3
TRBV6-2/3/5/6,TRBJ1-5,CASSYSRPNQPQHF,0,3,1,3
TRBV6-2/3/5/6,TRBJ2-3,CASSYVTAGDTQYF,0,3,1,3
TRBV6-2/3/5/6,TRBJ1-2,CASSYVSGYYGYTF,0,3,1,3
TRBV6-2/3/5/6,TRBJ2-1,CASSYGLAGVLQFY,0,3,1,3
TRBV6-2/3/5/6,TRBJ1-1,CASSYGGADTEAFF,0,3,1,3
TRBV6-2/3/5/6,TRBJ2-7,CASSYGQSSYEQYF,0,3,1,3
TRBV27,TRBJ1-1,CASSPATGATEAFF,0,3,1,3
TRBV12-3/4,TRBJ1-5,CASSPGLLSQPQHF,0,3,1,3
TRBV6-2/3/5/6,TRBJ1-4,CASSPGQGHEKLFF,0,3,1,3
TRBV12-3/4,TRBJ2-4,CASSPLDPVNIQYF,0,3,1,3
TRBV6-4,TRBJ1-2,CASSRGTGDYGYTF,0,3,1,3
TRBV12-3/4,TRBJ2-3,CASSRDRTTDTQYF,0,3,1,3
TRBV6-2/3/5/6,TRBJ1-1,CASSRTGASTEAFF,0,3,1,3
TRBV6-1,TRBJ2-1,CASSQSGTNNEQFF,0,3,1,3
TRBV27,TRBJ2-7,CASSQFRGWVEQYF,0,3,1,3
TRBV12-3/4,TRBJ1-1,CASSVQGGYTEAFF,0,3,1,3
TRBV6-1,TRBJ2-7,CASSAVGQSYEQYF,0,3,1,3
TRBV2,TRBJ1-2,CASSGGAGVYGYTF,0,3,1,3
TRBV7-2,TRBJ2-7,CASSGRGLVYEQYF,0,3,1,3
TRBV6-4,TRBJ2-3,CASSDSPGTDTQYF,0,3,1,3
TRBV6-4,TRBJ2-3,CASSDPGPTDTQYF,0,3,1,3
TRBV3-1,TRBJ1-5,CASSDTGNFQPQHF,0,3,1,3
TRBV2,TRBJ1-2,CASSEWRTTFGYTF,0,3,1,3
TRBV25-1,TRBJ2-5,CASSELSGQETQYF,0,3,1,3
TRBV6-1,TRBJ1-1,CASSERGGVGEAFF,0,3,1,3
TRBV13,TRBJ1-5,CASSKGPINQPQHF,0,3,1,3
TRBV11-3,TRBJ1-1,CASSFGPQNTEAFF,0,3,1,3
TRBV7-9,TRBJ2-1,CASSFNSGFAEQFF,0,3,1,3
TRBV5-4,TRBJ1-1,CASSFSSGGTEAFF,0,3,1,3
TRBV5-6,TRBJ1-1,CASSFPDKNTEAFF,0,3,1,3
TRBV13,TRBJ2-5,CASSFGRRRETQYF,0,3,1,3
TRBV7-2,TRBJ2-1,CASSFGSVHNEQFF,0,3,1,3
TRBV7-2,TRBJ1-6,CASSFGADNSPLHF,0,3,1,3
TRBV5-4,TRBJ2-1,CASSLSGTRYEQFF,0,3,1,3
TRBV5-5,TRBJ1-1,CASSLHGGNTEAFF,0,3,1,3
TRBV5-4,TRBJ2-1,CASSLVSGRNEQFF,0,3,1,3
TRBV5-5,TRBJ2-5,CASSLVFDWETQYF,0,3,1,3
TRBV5-5,TRBJ2-5,CASSLASVQETQYF,0,3,1,3
TRBV6-2/3/5/6,TRBJ2-3,CASSLGGGRDTQYF,0,3,1,3
TRBV5-4,TRBJ1-2,CASSLGSLGYGYTF,0,3,1,3
TRBV5-6,TRBJ2-1,CASSLGGRGNEQFF,0,3,1,3
TRBV5-6,TRBJ1-6,CASSLDSALRDLHF,0,3,1,3
TRBV7-9,TRBJ2-1,CASSLYSPGYEQFF,0,3,1,3
TRBV11-2,TRBJ1-1,CASSLQGGNTEAFF,0,3,1,3
TRBV7-7,TRBJ2-1,CASSLQGVYNEQFF,0,3,1,3
TRBV7-8,TRBJ1-5,CASSLVGSNQPQHF,0,3,1,3
TRBV7-2,TRBJ1-1,CASSLVGRHTEAFF,0,3,1,3
TRBV7-6,TRBJ1-1,CASSLAAGNTEAFF,0,3,1,3
TRBV7-9,TRBJ2-7,CASSLAGSFEEQYF,0,3,1,3
TRBV7-8,TRBJ2-5,CASSLGRRAETQYF,0,3,1,3
TRBV7-2,TRBJ2-1,CASSLGTAYNEQFF,0,3,1,3
TRBV7-6,TRBJ2-5,CASSLGGGKETQYF,0,3,1,3
TRBV5-5,TRBJ2-5,CASSLGTGKETQYF,0,3,1,3
TRBV7-2,TRBJ2-5,CASSLGVRQETQYF,0,3,1,3
TRBV7-2,TRBJ1-2,CASSLGVGNYGYTF,0,3,1,3
TRBV7-6,TRBJ2-1,CASSLITSGIEQFF,0,3,1,3
TRBV5-5,TRBJ2-5,CASSSGTSQETQYF,0,3,1,3
TRBV5-6,TRBJ2-1,CASSSVPGRNEQFF,0,3,1,3
TRBV7-9,TRBJ1-1,CASSSGQGITEAFF,0,3,1,3
TRBV5-6,TRBJ2-7,CASSSLTGGHEQYF,0,3,1,3
TRBV11-2,TRBJ2-1,CASSWETLFKEQFF,0,3,1,3
TRBV12-3/4,TRBJ2-7,CASSLPNRLREQYF,0,3,1,3
TRBV7-2,TRBJ2-4,CASSLTGGRNIQYF,0,3,1,3
TRBV12-3/4,TRBJ1-5,CASSLDRLNQPQHF,0,3,1,3
TRBV7-9,TRBJ1-2,CASSLGSTSHGYTF,0,3,1,3
TRBV5-6,TRBJ1-3,CASSLGNSGNTIYF,0,3,1,3
TRBV7-3,TRBJ2-7,CASSLNAGPHEQYF,0,3,1,3
TRBV5-6,TRBJ2-7,CASSPLGDLHEQYF,0,3,1,3
TRBV13,TRBJ1-2,CASSPGTGSYGYTF,0,3,1,3
TRBV9,TRBJ2-1,CASSPSGVDNEQFF,0,3,1,3
TRBV13,TRBJ1-1,CASSPPPGNTEAFF,0,3,1,3
TRBV13,TRBJ1-2,CASSPPVRKNGYTF,0,3,1,3
TRBV3-1,TRBJ2-7,CASSPPGGGYEQYF,0,3,1,3
TRBV12-3/4,TRBJ2-1,CASSPRDYYNEQFF,0,3,1,3
TRBV7-2,TRBJ1-5,CASSPRGTHQPQHF,0,3,1,3
TRBV7-9,TRBJ1-2,CASSPPWGDYGYTL,0,3,1,3
TRBV28,TRBJ1-3,CASSPGQPGNTIYF,0,3,1,3
TRBV13,TRBJ2-3,CASSPGQGGDTQYF,0,3,1,3
TRBV5-6,TRBJ1-2,CASSPDRVAEGYTF,0,3,1,3
TRBV12-3/4,TRBJ1-1,CASSPDRGNTEAFF,0,3,1,3
TRBV7-8,TRBJ2-1,CASSPRQGAYEQFF,0,3,1,3
TRBV5-5,TRBJ1-3,CASSPVGRANTIYF,0,3,1,3
TRBV7-9,TRBJ2-7,CASSRSGDIYEQYF,0,3,1,3
TRBV5-4,TRBJ2-7,CASSRLGLDYEQYF,0,3,1,3
TRBV7-2,TRBJ1-2,CASSRDLGGSGYTF,0,3,1,3
TRBV7-9,TRBJ2-1,CASSRTGGDAGQFF,0,3,1,3
TRBV4-2,TRBJ1-5,CASSRYSSNQPQHF,0,3,1,3
TRBV14,TRBJ2-3,CASSRAGGPPAQYF,0,3,1,3
TRBV5-6,TRBJ2-1,CASSRGDSYNEQFF,0,3,1,3
TRBV13,TRBJ2-1,CASSHAGLGRPKFF,0,3,1,3
TRBV7-9,TRBJ2-1,CASSHYTRPDEQFF,0,3,1,3
TRBV7-9,TRBJ2-1,CASSHDRAYNEQFF,0,3,1,3
TRBV3-1,TRBJ2-2,CASSQGGNTGELFF,0,3,1,3
TRBV7-6,TRBJ2-7,CASSQDRESYEQYF,0,3,1,3
TRBV14,TRBJ1-1,CASSQWGMNTEAFF,0,3,1,3
TRBV12-3/4,TRBJ1-1,CASSQQGRNTEAFF,0,3,1,3
TRBV3-1,TRBJ2-1,CASSQVTVGGEQFF,0,3,1,3
TRBV4-2,TRBJ2-7,CASSQDGAISEQYF,0,3,1,3
TRBV7-6,TRBJ2-1,CASSQTRTYNEQLF,0,3,1,3
TRBV3-1,TRBJ1-2,CASSQRDRLYSYTF,0,3,1,3
TRBV9,TRBJ1-1,CASSVRGRNTEAFF,0,3,1,3
TRBV5-6,TRBJ2-5,CASSVTSGQETQYF,0,3,1,3
TRBV9,TRBJ2-3,CASSVAATGDTQYF,0,3,1,3
TRBV9,TRBJ2-7,CASSVGTAALGQYF,0,3,1,3
TRBV9,TRBJ2-7,CASSVDGQEDEQYF,0,3,1,3
TRBV9,TRBJ1-3,CASSVEPRRNTIYF,0,3,1,3
TRBV9,TRBJ2-7,CASSVTGTPYEQYF,0,3,1,3
TRBV7-3,TRBJ2-5,CASSAMGQSETQYF,0,3,1,3
TRBV7-9,TRBJ2-5,CASSGGRKQETQYF,0,3,1,3
TRBV7-6,TRBJ2-4,CASSGTGGSDIQYF,0,3,1,3
TRBV9,TRBJ2-3,CASSGKSDRDTQYF,0,3,1,3
TRBV13,TRBJ1-1,CASSGQGWGTEAFF,0,3,1,3
TRBV9,TRBJ2-2,CASSDPRATGELFF,0,3,1,3
TRBV13,TRBJ2-7,CASSEYRGQDEQYF,0,3,1,3
TRBV6-1,TRBJ1-4,CASSETVGDGKLFF,0,3,1,3
TRBV7-9,TRBJ2-1,CASSIPDEYNEQFF,0,3,1,3
TRBV7-6,TRBJ1-1,CASSIGQGNTEAFF,0,3,1,3
TRBV7-9,TRBJ2-7,CASSTSRTVYEQYF,0,3,1,3
TRBV9,TRBJ1-1,CASSTTGAESEAFF,0,3,1,3
TRBV7-9,TRBJ1-1,CASSTGQRNTEAFF,0,3,1,3
TRBV7-9,TRBJ1-1,CASSTDRVNTEAFF,0,3,1,3
TRBV7-9,TRBJ2-3,CASSTTSFPDTQYF,0,3,1,3
TRBV7-2,TRBJ1-4,CASSTGATNEKLFF,0,3,1,3
TRBV7-9,TRBJ2-7,CASSSRAGSYERYF,0,3,1,3
TRBV5-6,TRBJ2-1,CASSKTSGYNEQFF,0,3,1,3
TRBV2,TRBJ1-4,CASRGTGPNEKLFF,0,3,1,3
TRBV6-2/3/5/6,TRBJ2-1,CASRGTRESNEQFF,0,3,1,3
TRBV7-9,TRBJ1-1,CASRDAGTGKEAFF,0,3,1,3
TRBV2,TRBJ2-1,CASRMASSYNEQFF,0,3,1,3
TRBV6-2/3/5/6,TRBJ1-5,CASRRDRGGQPQHF,0,3,1,3
TRBV12-3/4,TRBJ2-7,CASRHLGQGHEQYF,0,3,1,3
TRBV27,TRBJ1-6,CASRQTGRGSPLHF,0,3,1,3
TRBV6-2/3/5/6,TRBJ1-5,CASRATGGYQPQHF,0,3,1,3
TRBV6-4,TRBJ1-2,CASRRSRSLSGYTF,0,3,1,3
TRBV6-2/3/5/6,TRBJ1-1,CASNAGQGQDEAFF,0,3,1,3
TRBV12-3/4,TRBJ2-5,CASKRSTDQETQYF,0,3,1,3
TRBV7-9,TRBJ1-1,CASKVQGADTEAFF,0,3,1,3
TRBV27,TRBJ2-3,CASKSVRAADTQYF,0,3,1,3
TRBV2,TRBJ2-1,CARSTAGMYNEQFF,0,3,1,3
TRBV5-6,TRBJ2-7,CDSSWGQGSYEQYF,0,3,1,3
TRBV20-1,TRBJ2-1,CSAKSPSGDNEQFL,0,3,1,3
TRBV4-1,TRBJ1-2,CASSLGVGPYGYTF,0,3,1,3
TRBV5-1,TRBJ2-7,CASAGQGGPYEQYF,0,3,1,3
TRBV4-3,TRBJ2-3,CASSLGQGPDTQYF,0,3,1,3
TRBV5-1,TRBJ2-7,CASSFGQGAYEQYF,0,3,1,3
TRBV5-1,TRBJ2-1,CASSLARGGDEQFF,0,3,1,3
TRBV5-1,TRBJ2-2,CASSLALNTGELFF,0,3,1,3
TRBV5-1,TRBJ2-7,CASSLAPAGYEQYF,0,3,1,3
TRBV5-1,TRBJ2-1,CASSLGGGNNEQFF,0,3,1,3
TRBV5-1,TRBJ2-7,CASSLDGELYEQYF,0,3,1,3
TRBV5-1,TRBJ1-2,CASSLDRTNYGYTF,0,3,1,3
TRBV5-1,TRBJ2-7,CASSLEANSYEQYF,0,3,1,3
TRBV5-1,TRBJ1-1,CASSLTAQGTEAFF,0,3,1,3
TRBV5-1,TRBJ1-1,CASSLDQGNTEAFF,0,3,1,3
TRBV4-1,TRBJ2-1,CASSPPGGWNEQFF,0,3,1,3
TRBV5-1,TRBJ2-7,CASSPGGQAYEQYF,0,3,1,3
TRBV5-1,TRBJ2-5,CASSRGQDQETQYF,0,3,1,3
TRBV4-3,TRBJ2-7,CASSRSSGTYEQYF,0,3,1,3
TRBV5-1,TRBJ2-7,CASSRTGETYEQYF,0,3,1,3
TRBV4-1,TRBJ2-7,CASSRLAESYEQYF,0,3,1,3
TRBV4-3,TRBJ2-1,CASSQGLARDEQFF,0,3,1,3
TRBV4-1,TRBJ2-5,CASSQVRGVETQYF,0,3,1,3
TRBV4-1,TRBJ1-2,CASSQAYRAYGYTF,0,3,1,3
TRBV4-1,TRBJ1-4,CASSQGGGREKLFF,0,3,1,3
TRBV4-3,TRBJ2-7,CASSQGTSGYEQYF,0,3,1,3
TRBV4-1,TRBJ1-1,CASSQDQGNTEAFF,0,3,1,3
TRBV4-3,TRBJ1-1,CASSQDGRSFEAFF,0,3,1,3
TRBV4-3,TRBJ2-3,CASSQDSRTDTQYF,0,3,1,3
TRBV4-3,TRBJ2-2,CASSQDRVTGGLFF,0,3,1,3
TRBV4-1,TRBJ1-1,CASSQDAGNTEAFF,0,3,1,3
TRBV5-1,TRBJ2-3,CASSVGTSTDTQYF,0,3,1,3
TRBV5-1,TRBJ2-1,CASSAGGAYNEQFF,0,3,1,3
TRBV4-1,TRBJ2-7,CASSEGQGGRKQYF,0,3,1,3
TRBV5-1,TRBJ1-6,CASSERGTNSPLHF,0,3,1,3
TRBV5-1,TRBJ2-7,CASSIGTGGYEQYF,0,3,1,3
TRBV5-1,TRBJ2-1,CASSTDSLYNEQFF,0,3,1,3
TRBV4-3,TRBJ2-7,CASSKGGLYGEQYF,0,3,1,3
TRBV5-1,TRBJ2-7,CASRDGAATYEQYF,0,3,1,3
TRBV5-1,TRBJ2-2,CASNDGQNTGELFF,0,3,1,3
TRBV4-3,TRBJ2-5,CTSRPGQGLETQYF,0,3,1,3
TRBV20-1,TRBJ2-3,CSAPRQGVRDTQYF,0,3,1,3
TRBV20-1,TRBJ2-3,CSAEGVPSTDTQYF,0,3,1,3
TRBV20-1,TRBJ1-1,CSATRDRVDGEAFF,0,3,1,3
TRBV20-1,TRBJ2-5,CSATTERLGETQYF,0,3,1,3
TRBV20-1,TRBJ1-5,CSASSRDRGQPQHF,0,3,1,3
TRBV20-1,TRBJ2-5,CSASDLRRQETQYF,0,3,1,3
TRBV20-1,TRBJ2-7,CSASLGQGGYEQYF,0,3,1,3
TRBV20-1,TRBJ2-3,CSASPTSGGDTQYF,0,3,1,3
TRBV20-1,TRBJ2-5,CSASPTGYQETQYF,0,3,1,3
TRBV20-1,TRBJ2-7,CSASAALITYEQYF,0,3,1,3
TRBV20-1,TRBJ2-6,CSARGSSGANVLTF,0,3,1,3
TRBV20-1,TRBJ2-7,CSARVSGLTYEQYF,0,3,1,3
TRBV20-1,TRBJ1-2,CSARVQGFGDGYTF,0,3,1,3
TRBV20-1,TRBJ2-7,CSARGAGESGEQYF,0,3,1,3
TRBV29-1,TRBJ1-1,CSAYRTGIYTEAFF,0,3,1,3
TRBV20-1,TRBJ2-3,CSAGLAGGQDTQYF,0,3,1,3
TRBV29-1,TRBJ2-5,CSAGIQRGQETQYF,0,3,1,3
TRBV20-1,TRBJ1-4,CSAGQPGGNEKLFF,0,3,1,3
TRBV20-1,TRBJ2-3,CSAESGRAPDTQYF,0,3,1,3
TRBV29-1,TRBJ2-2,CSVLSVVNTGELFF,0,3,1,3
TRBV29-1,TRBJ2-3,CSVWGDVSTDTQYF,0,3,1,3
TRBV29-1,TRBJ1-3,CSVREPSSGNTIYF,0,3,1,3
TRBV29-1,TRBJ1-5,CSVVVLGADQPQHF,0,3,1,3
TRBV29-1,TRBJ2-7,CSVAGGLHSYEQYF,0,3,1,3
TRBV29-1,TRBJ2-3,CSVALARFTDTQYF,0,3,1,3
TRBV29-1,TRBJ1-2,CSVGGPDRNYGYTF,0,3,1,3
TRBV29-1,TRBJ2-1,CSVGGLAVYNEQFF,0,3,1,3
TRBV29-1,TRBJ2-2,CSVGQGLITGELFF,0,3,1,3
TRBV29-1,TRBJ2-3,CSVDGQEGTDTQYF,0,3,1,3
TRBV29-1,TRBJ2-1,CSVEPSGNYNEQFF,0,3,1,3
TRBV29-1,TRBJ1-2,CSVEKMRSNYGYTF,0,3,1,3
TRBV29-1,TRBJ2-5,CSVGLAGEGETQYF,0,3,1,3
TRBV29-1,TRBJ1-4,CSVLGWTRGEKLFF,0,3,1,3
TRBV29-1,TRBJ2-5,CSVVAGGPGETQYL,0,3,1,3
TRBV20-1,TRBJ2-5,CSALSGRAGETQYF,0,3,1,3
TRBV29-1,TRBJ2-1,CSAEASGSGKKQFF,0,3,1,3
TRBV29-1,TRBJ2-2,CSARAAANTGELVF,0,3,1,3
TRBV29-1,TRBJ2-1,CSARLESSYNEQFF,0,3,1,3
TRBV29-1,TRBJ2-3,CSAGRPSGTDTQYF,0,3,1,3
TRBV29-1,TRBJ2-3,CSARTGPSTDTQYF,0,3,1,3
TRBV29-1,TRBJ2-2,CSGRAGISTGELFF,0,3,1,3
TRBV7-9,TRBJ2-7,YASSWGLAGREQYF,0,3,1,3
TRBV5-6,TRBJ2-3,YASSLGGSTDTQYF,0,3,1,3
TRBV2,TRBJ1-1,YASSLDGLNTEAFF,0,3,1,3
TRBV7-3,TRBJ2-7,RASSLSPGCGEQYF,0,3,1,3
TRBV12-5,TRBJ2-7,CASSDVGGREQYF,0,3,1,3
TRBV12-5,TRBJ2-5,CASGSGPWETQYF,0,3,1,3
TRBV12-5,TRBJ2-7,CASGGKSSYEQYF,0,3,1,3
TRBV30,TRBJ1-2,CAWSVGQGYGYTF,0,3,1,3
TRBV30,TRBJ2-1,CAWSGMGLGEQFF,0,3,1,3
TRBV30,TRBJ2-5,CAWSGAGVETQYF,0,3,1,3
TRBV30,TRBJ1-2,CAWSRDRPYGYTF,0,3,1,3
TRBV2,TRBJ2-2,CAALAGGTGELFF,0,3,1,3
TRBV10-3,TRBJ2-1,CAISAQGYNEQFF,0,3,1,3
TRBV24-1,TRBJ2-1,CATSDPKRAEQFF,0,3,1,3
TRBV24-1,TRBJ2-1,CATSEPGQYEQFF,0,3,1,3
TRBV7-9,TRBJ2-5,CATSLLTRETQYF,0,3,1,3
TRBV2,TRBJ2-4,CASQQGAQNIQYF,0,3,1,3
TRBV19,TRBJ1-1,CASIHGGGTEAFF,0,3,1,3
TRBV19,TRBJ1-5,CASTRTQNQPQHF,0,3,1,3
TRBV19,TRBJ1-1,CASSFTGNTEAFF,0,3,1,3
TRBV19,TRBJ2-1,CASSIGGIDEQFF,0,3,1,3
TRBV19,TRBJ1-1,CASSIGLNTEAFF,0,3,1,3
TRBV19,TRBJ2-5,CASSIINQETQYF,0,3,1,3
TRBV19,TRBJ1-4,CASSISTNEKLFF,0,3,1,3
TRBV19,TRBJ1-5,CASSIVVDQPQHF,0,3,1,3
TRBV19,TRBJ2-1,CASSIAQYNEQFF,0,3,1,3
TRBV19,TRBJ2-7,CASSTGQGEGQYF,0,3,1,3
TRBV19,TRBJ2-3,CASRTEAADTQYF,0,3,1,3
TRBV2,TRBJ1-2,CASSGGRDHGYTF,0,3,1,3
TRBV18,TRBJ2-1,CASSSRQLNEQFF,0,3,1,3
TRBV18,TRBJ2-1,CASSPGTPNEQFF,0,3,1,3
TRBV18,TRBJ2-7,CASSPVSDVGQYF,0,3,1,3
TRBV12-3/4,TRBJ1-1,CASYNHGDTEAFF,0,3,1,3
TRBV7-9,TRBJ2-5,CASLLGQGETQYF,0,3,1,3
TRBV12-3/4,TRBJ2-1,CASIDNREYEQFF,0,3,1,3
TRBV5-6,TRBJ2-5,CASILSPEETQYF,0,3,1,3
TRBV6-2/3/5/6,TRBJ1-5,CASTSRPDQPQHF,0,3,1,3
TRBV27,TRBJ2-1,CASTLMWGDEQFF,0,3,1,3
TRBV12-3/4,TRBJ1-3,CASTPDFRYTIYF,0,3,1,3
TRBV2,TRBJ2-5,CASTGGSGETQYF,0,3,1,3
TRBV12-3/4,TRBJ1-5,CASSFGDYQPQHF,0,3,1,3
TRBV6-2/3/5/6,TRBJ2-7,CASSFGESYEQYF,0,3,1,3
TRBV27,TRBJ1-5,CASSLATNQPQHF,0,3,1,3
TRBV6-2/3/5/6,TRBJ1-5,CASSLGQNQPQHF,0,3,1,3
TRBV27,TRBJ2-5,CASSLDIQETQYF,0,3,1,3
TRBV12-3/4,TRBJ1-2,CASSLEGRYGYTF,0,3,1,3
TRBV12-3/4,TRBJ1-1,CASSLKGVTEAFF,0,3,1,3
TRBV6-2/3/5/6,TRBJ2-1,CASSSRGRNEQFF,0,3,1,3
TRBV6-2/3/5/6,TRBJ1-1,CASSYSGLTEAFF,0,3,1,3
TRBV6-2/3/5/6,TRBJ2-7,CASSYRASHEQYF,0,3,1,3
TRBV12-3/4,TRBJ1-2,CASSLDGSSGYTF,0,3,1,3
TRBV6-2/3/5/6,TRBJ1-5,CASSLTENQPQHF,0,3,1,3
TRBV6-2/3/5/6,TRBJ1-1,CASSPIGGYEAFF,0,3,1,3
TRBV7-9,TRBJ2-5,CASSPTDRETQYF,0,3,1,3
TRBV12-3/4,TRBJ1-6,CASSRTGASPLHL,0,3,1,3
TRBV12-3/4,TRBJ2-5,CASSRPQAGTQYF,0,3,1,3
TRBV6-4,TRBJ1-1,CASSHQRNTEAFF,0,3,1,3
TRBV6-4,TRBJ1-2,CASSQEDRYGYTF,0,3,1,3
TRBV6-1,TRBJ2-3,CASSAQGLGTQYF,0,3,1,3
TRBV2,TRBJ1-1,CASSAQGITEAFF,0,3,1,3
TRBV6-1,TRBJ2-5,CASSAGGRETRYF,0,3,1,3
TRBV12-3/4,TRBJ1-5,CASSGDRNQPQHF,0,3,1,3
TRBV7-6,TRBJ1-1,CASSDTPNTEAFF,0,3,1,3
TRBV12-3/4,TRBJ2-7,CASSEGSSYEQYF,0,3,1,3
TRBV6-4,TRBJ1-2,CASSETPNYGYTF,0,3,1,3
TRBV6-1,TRBJ1-1,CASSEQWDTEAFF,0,3,1,3
TRBV2,TRBJ1-1,CASSEVAETEAFF,0,3,1,3
TRBV2,TRBJ2-7,CASSEAQAGYPTF,0,3,1,3
TRBV6-1,TRBJ1-2,CASSEGRRSGYTF,0,3,1,3
TRBV2,TRBJ2-1,CASSEEAYNEQFF,0,3,1,3
TRBV5-4,TRBJ2-3,CASSTAVGDTQYF,0,3,1,3
TRBV7-9,TRBJ2-5,CASSLPGGETQYF,0,3,1,3
TRBV5-4,TRBJ1-1,CASSLAAPSEAFF,0,3,1,3
TRBV5-4,TRBJ2-3,CASSLAGTDTQYF,0,3,1,3
TRBV5-6,TRBJ1-2,CASSLAGPGGYTF,0,3,1,3
TRBV7-6,TRBJ2-3,CASSLGTGDTQYF,0,3,1,3
TRBV5-4,TRBJ2-7,CASSLGPKGLGNF,0,3,1,3
TRBV11-1,TRBJ2-1,CASSLESGYEQFF,0,3,1,3
TRBV11-2,TRBJ1-5,CASSLSRNQPQHF,0,3,1,3
TRBV6-2/3/5/6,TRBJ1-1,CASSLLSSTGAFF,0,3,1,3
TRBV11-1,TRBJ2-5,CASSLPGQETQYF,0,3,1,3
TRBV13,TRBJ2-7,CASSLGLSYEQYF,0,3,1,3
TRBV7-2,TRBJ2-1,CASSLGLYSEQFF,0,3,1,3
TRBV7-2,TRBJ2-7,CASSLGGFGEQYF,0,3,1,3
TRBV7-2,TRBJ2-7,CASSLGTVYEQYF,0,3,1,3
TRBV11-1,TRBJ2-1,CASSLGLAREQFF,0,3,1,3
TRBV7-9,TRBJ1-2,CASSLGQDGGYTF,0,3,1,3
TRBV7-6,TRBJ2-5,CASSLDPQETQYF,0,3,1,3
TRBV7-2,TRBJ1-1,CASSLEISTEAFF,0,3,1,3
TRBV7-3,TRBJ1-1,CASSLIGNTEAFF,0,3,1,3
TRBV7-2,TRBJ1-1,CASSLKEGTEAFF,0,3,1,3
TRBV11-3,TRBJ2-7,CASSSSGAYEQYF,0,3,1,3
TRBV7-2,TRBJ1-5,CASSSAGHQPQHF,0,3,1,3
TRBV4-2,TRBJ2-3,CASSSKMGSTQYF,0,3,1,3
TRBV7-6,TRBJ1-3,CASSSAAGNTIYF,0,3,1,3
TRBV5-4,TRBJ2-1,CASSSAGGREQFF,0,3,1,3
TRBV7-2,TRBJ1-4,CASSWDRDEKLFF,0,3,1,3
TRBV6-2/3/5/6,TRBJ1-1,CASSLMENTEAFF,0,3,1,3
TRBV12-3/4,TRBJ2-5,CASSLRGGETQYF,0,3,1,3
TRBV5-6,TRBJ2-3,CASSLGGSDTQYF,0,3,1,3
TRBV7-3,TRBJ2-7,CASSPWPGSEQYF,0,3,1,3
TRBV11-3,TRBJ2-5,CASSPAPRETQYF,0,3,1,3
TRBV12-3/4,TRBJ2-7,CASSPDRGREQYF,0,3,1,3
TRBV14,TRBJ2-1,CASSPNSYNEQFF,0,3,1,3
TRBV12-3/4,TRBJ1-1,CASSPTQGSEAFF,0,3,1,3
TRBV12-3/4,TRBJ2-7,CASSRDRVNEQYF,0,3,1,3
TRBV7-6,TRBJ1-1,CASSRTPNTEAFF,0,3,1,3
TRBV7-9,TRBJ2-3,CASSRVNTDTQYF,0,3,1,3
TRBV12-3/4,TRBJ2-5,CASSRDSQETQYF,0,3,1,3
TRBV3-1,TRBJ2-5,CASSHPRLETQYF,0,3,1,3
TRBV7-2,TRBJ2-5,CASSHTLEETQYF,0,3,1,3
TRBV4-2,TRBJ1-5,CASSHFIGQPQHF,0,3,1,3
TRBV3-1,TRBJ2-5,CASSQSGQATQYF,0,3,1,3
TRBV14,TRBJ2-5,CASSQVRGETQYF,0,3,1,3
TRBV14,TRBJ2-2,CASSQVDSRELFF,0,3,1,3
TRBV4-2,TRBJ2-1,CASSQVEGNEQFF,0,3,1,3
TRBV4-2,TRBJ2-3,CASSQGRTDTQYF,0,3,1,3
TRBV3-1,TRBJ1-5,CASSQDLDQPQHF,0,3,1,3
TRBV7-6,TRBJ2-7,CASSQDRTYEQYF,0,3,1,3
TRBV3-1,TRBJ1-1,CASSQTGGTEAFF,0,3,1,3
TRBV6-2/3/5/6,TRBJ2-1,CASSVDVGYEQFF,0,3,1,3
TRBV9,TRBJ2-1,CASSVVGGNEQFF,0,3,1,3
TRBV9,TRBJ1-1,CASSVGGYTEAFF,0,3,1,3
TRBV9,TRBJ1-2,CASSARQDGGYTF,0,3,1,3
TRBV7-9,TRBJ2-1,CASSAGTSDEQFF,0,3,1,3
TRBV6-2/3/5/6,TRBJ2-1,CASSADRGFEQFF,0,3,1,3
TRBV7-9,TRBJ2-1,CASSTSGWGEQFF,0,3,1,3
TRBV7-9,TRBJ1-4,CASSRDRGEKLFF,0,3,1,3
TRBV7-2,TRBJ2-7,CASSKTGAYEQYF,0,3,1,3
TRBV6-2/3/5/6,TRBJ1-1,CASRVTGVTEAFF,0,3,1,3
TRBV7-9,TRBJ1-6,CASRAGSGSPLHF,0,3,1,3
TRBV6-2/3/5/6,TRBJ2-4,CASRGTGTDIQYF,0,3,1,3
TRBV2,TRBJ1-1,CASRGQGDTEAFF,0,3,1,3
TRBV12-3/4,TRBJ1-2,CASRMTGSYGYTF,0,3,1,3
TRBV27,TRBJ2-7,CASRTGAPYEQYF,0,3,1,3
TRBV2,TRBJ1-2,CASRTGGDYGYTF,0,3,1,3
TRBV2,TRBJ2-3,CASRRRITDTQYF,0,3,1,3
TRBV12-3/4,TRBJ2-7,CASRPGLTYEQYF,0,3,1,3
TRBV6-2/3/5/6,TRBJ2-2,CASRPNSPGELFF,0,3,1,3
TRBV12-3/4,TRBJ2-7,CASRRDRGYEQYF,0,3,1,3
TRBV12-3/4,TRBJ1-6,CASRGPRISPLHF,0,3,1,3
TRBV6-2/3/5/6,TRBJ2-2,CASRNPGLGELFF,0,3,1,3
TRBV12-3/4,TRBJ2-2,CASRNPGPGELFF,0,3,1,3
TRBV25-1,TRBJ2-1,CASNLKLGGEQFF,0,3,1,3
TRBV2,TRBJ2-7,CASKVGRYYEQYF,0,3,1,3
TRBV18,TRBJ2-5,CTSSPVRQETQYF,0,3,1,3
TRBV4-3,TRBJ1-2,CASSPDRDYGYTF,0,3,1,3
TRBV5-1,TRBJ2-7,CASSVSGEIEQYF,0,3,1,3
TRBV5-1,TRBJ1-1,CASSFRQNTEAFF,0,3,1,3
TRBV5-1,TRBJ2-5,CASSLAPGETQYF,0,3,1,3
TRBV5-1,TRBJ2-7,CASSLEGRYEQYF,0,3,1,3
TRBV11-3,TRBJ2-5,CASSSGIQETQYF,0,3,1,3
TRBV5-4,TRBJ2-1,CASSSGPINEQFF,0,3,1,3
TRBV5-1,TRBJ2-7,CASSLGLSDEQYF,0,3,1,3
TRBV5-1,TRBJ1-1,CASSLGQHTEAFF,0,3,1,3
TRBV5-1,TRBJ1-2,CASSPLGDYGYTF,0,3,1,3
TRBV5-1,TRBJ2-5,CASSRQGEETQYF,0,3,1,3
TRBV5-1,TRBJ1-2,CASSRDRGFYDTF,0,3,1,3
TRBV4-1,TRBJ2-1,CASSHLVENEQFF,0,3,1,3
TRBV4-1,TRBJ2-5,CASSQLTEETQYF,0,3,1,3
TRBV4-1,TRBJ1-2,CASSNQSGRGYTF,0,3,1,3
TRBV4-3,TRBJ1-1,CASRRDLNTEAFF,0,3,1,3
TRBV29-1,TRBJ2-4,CIITMSGSNIQYF,0,3,1,3
TRBV20-1,TRBJ2-5,CSACRDNKETQYF,0,3,1,3
TRBV20-1,TRBJ2-5,CSAPPPTTETQYF,0,3,1,3
TRBV20-1,TRBJ2-5,CSAREGPQETQYF,0,3,1,3
TRBV20-1,TRBJ1-3,CSAQTPRRNTIYF,0,3,1,3
TRBV29-1,TRBJ1-3,CSAQDRAGNTIYF,0,3,1,3
TRBV20-1,TRBJ1-1,CSAVTGDNTEAFF,0,3,1,3
TRBV20-1,TRBJ1-4,CSATTAVNENLFF,0,3,1,3
TRBV20-1,TRBJ2-3,CSASQRGPDTQYF,0,3,1,3
TRBV20-1,TRBJ1-5,CSARGRGGQPQHF,0,3,1,3
TRBV20-1,TRBJ1-5,CSARGRGNQPQHF,0,3,1,3
TRBV20-1,TRBJ1-5,CSARSRANQPQHF,0,3,1,3
TRBV20-1,TRBJ1-1,CSARDLREGGAFF,0,3,1,3
TRBV20-1,TRBJ2-7,CSARDPRIGEQYF,0,3,1,3
TRBV20-1,TRBJ2-5,CSARDRGGETQYF,0,3,1,3
TRBV20-1,TRBJ1-1,CSAKGQGGTEAFF,0,3,1,3
TRBV20-1,TRBJ1-3,CSADGTGGNTIYF,0,3,1,3
TRBV20-1,TRBJ2-2,CSAMDSNTGELFF,0,3,1,3
TRBV29-1,TRBJ2-5,CSVASATQETQYF,0,3,1,3
TRBV29-1,TRBJ1-1,CSVADRWDTEAFF,0,3,1,3
TRBV29-1,TRBJ1-1,CSVEAQAGTEAFF,0,3,1,3
TRBV29-1,TRBJ2-1,CSVEGLRYNEQFF,0,3,1,3
TRBV29-1,TRBJ1-2,CSVESGGGFGYTF,0,3,1,3
TRBV29-1,TRBJ2-5,CSVETGGEETQYF,0,6,1,6
TRBV29-1,TRBJ2-7,CSVKTPTTLEQYF,0,3,1,3
TRBV29-1,TRBJ2-5,CSVSGTGKETQYF,0,3,1,3
TRBV29-1,TRBJ2-7,CSVAPRDNYEQYF,0,3,1,3
TRBV29-1,TRBJ1-5,CSVARGPDQPQHF,0,3,1,3
TRBV29-1,TRBJ2-1,CSVIAGGSNEQFF,0,3,1,3
TRBV29-1,TRBJ1-2,CSVAGRHRSGYTF,0,3,1,3
TRBV29-1,TRBJ1-3,CSVTRGPGNTMYF,0,3,1,3
TRBV29-1,TRBJ1-5,CSVRQGFDQPQHF,0,3,1,3
TRBV29-1,TRBJ1-5,CSVNGGAGQPQHF,0,3,1,3
TRBV29-1,TRBJ1-1,CSALNRGGTEAFF,0,3,1,3
TRBV29-1,TRBJ2-7,CSAQSGFGYEQYF,0,3,1,3
TRBV29-1,TRBJ2-7,CSAGTGTGYEQYF,0,3,1,3
TRBV29-1,TRBJ2-7,CSAKPGQGAEQYF,0,3,1,3
TRBV29-1,TRBJ1-1,CSGGGSMNTEAFF,0,3,1,3
TRBV29-1,TRBJ1-1,CSSSTGGNTEAFF,0,3,1,3
TRBV19,TRBJ1-1,RASSTAGNTEAFF,0,3,1,3
TRBV28,TRBJ1-2,RASSLTGAPGYTF,0,3,1,3
TRBV7-4,TRBJ2-5,RASSPRKQETQYF,0,3,1,3
TRBV4-3,TRBJ2-1,RASSQDFYNEQFF,0,3,1,3
TRBV30,TRBJ1-1,CAWGGAKFEAFF,0,3,1,3
TRBV30,TRBJ2-1,CARGTRFDEQSF,0,3,1,3
TRBV7-9,TRBJ2-7,CAADGGDYEQYF,0,3,1,3
TRBV4-2,TRBJ2-1,CATQTGGNEQFF,0,3,1,3
TRBV2,TRBJ1-2,CATNRANYGYTF,0,3,1,3
TRBV19,TRBJ1-5,CASSFKDQPQHF,0,3,1,3
TRBV19,TRBJ1-2,CASSLPGQGYTF,0,3,1,3
TRBV19,TRBJ2-1,CASSSSRLGQFF,0,3,1,3
TRBV19,TRBJ2-5,CASSLAGETQYF,0,3,1,3
TRBV19,TRBJ2-7,CASSSGKYEQYF,0,3,1,3
TRBV19,TRBJ1-2,CASSIMDYGYTF,0,3,1,3
TRBV2,TRBJ2-7,CASEYRVHEQYF,0,3,1,3
TRBV7-9,TRBJ2-1,CASTRGSYEQFF,0,3,1,3
TRBV12-3/4,TRBJ2-1,CASTFSKNARFF,0,3,1,3
TRBV6-2/3/5/6,TRBJ2-7,CASSFRGYEQYF,0,3,1,3
TRBV12-3/4,TRBJ2-1,CASSFWTAEQFF,0,3,1,3
TRBV6-2/3/5/6,TRBJ2-5,CASSLNGETQYF,0,3,1,3
TRBV27,TRBJ2-3,CASSLRGDTQYF,0,3,1,3
TRBV12-3/4,TRBJ1-2,CASSLAPAGYTF,0,3,1,3
TRBV27,TRBJ2-1,CASSSDYNEQFF,0,3,1,3
TRBV27,TRBJ2-1,CASSSWGNEQFF,0,3,1,3
TRBV6-2/3/5/6,TRBJ2-1,CASSYVGTEQFF,0,3,1,3
TRBV27,TRBJ2-2,CASSLLGGELFF,0,3,1,3
TRBV2,TRBJ2-1,CASSPTGDEQFF,0,3,1,3
TRBV25-1,TRBJ1-2,CASSEYGEGYTF,0,3,1,3
TRBV6-1,TRBJ2-1,CASSEGYRGQFF,0,3,1,3
TRBV6-1,TRBJ1-5,CASSENGQPQHF,0,3,1,3
TRBV5-4,TRBJ1-1,CASSLHSGEAFF,0,3,1,3
TRBV5-6,TRBJ2-7,CASSLQTYEQYF,0,3,1,3
TRBV5-5,TRBJ2-7,CASSLVQGEQYF,0,3,1,3
TRBV5-6,TRBJ1-5,CASSLGDQPQHF,0,3,1,3
TRBV7-9,TRBJ1-5,CASSLEDQPQHF,0,3,1,3
TRBV7-9,TRBJ1-1,CASSLRGTEAFF,0,3,1,3
TRBV13,TRBJ2-5,CASSLGRETQYF,0,3,1,3
TRBV7-2,TRBJ1-2,CASSLDTYGYTF,0,3,1,3
TRBV7-9,TRBJ2-1,CASSLTSDEQFF,0,3,1,3
TRBV13,TRBJ2-4,CASSLNRDIQYL,0,3,1,3
TRBV7-2,TRBJ2-3,CASSSLAGAQYL,0,3,1,3
TRBV7-9,TRBJ1-6,CASSYAEGPLHF,0,3,1,3
TRBV7-2,TRBJ1-1,CASSLGGPEALF,0,3,1,3
TRBV12-3/4,TRBJ1-5,CASSLSPQPQHF,0,3,1,3
TRBV7-9,TRBJ1-5,CASSPSNQPQHF,0,3,1,3
TRBV7-9,TRBJ2-5,CASSPSGETQYF,0,3,1,3
TRBV12-3/4,TRBJ1-5,CASSPRNQPQHF,0,3,1,3
TRBV7-9,TRBJ2-5,CASSPGDGTQYF,0,3,1,3
TRBV7-2,TRBJ2-1,CASSPGRVQQFF,0,3,1,3
TRBV6-2/3/5/6,TRBJ2-5,CASSPDRETQYF,0,3,1,3
TRBV6-2/3/5/6,TRBJ2-7,CASSHTEYEQYF,0,3,1,3
TRBV3-1,TRBJ2-7,CASSQTTYEQYF,0,3,1,3
TRBV3-1,TRBJ2-3,CASSQVTHTQYF,0,3,1,3
TRBV7-9,TRBJ2-7,CASSQNRYEQYF,0,3,1,3
TRBV7-6,TRBJ1-2,CASSADLYGYTF,0,3,1,3
TRBV11-2,TRBJ2-1,CASSERGIKQFF,0,3,1,3
TRBV14,TRBJ2-7,CASSIGPGEQYF,0,3,1,3
TRBV5-4,TRBJ2-1,CASSSGPREQFF,0,3,1,3
TRBV9,TRBJ2-1,CASSNRGDEQFF,0,3,1,3
TRBV7-9,TRBJ2-5,CASRGYQETQYF,0,3,1,3
TRBV12-3/4,TRBJ2-7,CASRYVGYEQYF,0,3,1,3
TRBV5-6,TRBJ1-6,CASRRELSPLHF,0,3,1,3
TRBV12-3/4,TRBJ1-1,CASRVMNTEAFS,0,3,1,3
TRBV2,TRBJ2-7,CASNGASYEQYF,0,3,1,3
TRBV6-2/3/5/6,TRBJ1-4,CASKTANEKLFF,0,3,1,3
TRBV12-3/4,TRBJ2-5,CACSSAEETQYF,0,3,1,3
TRBV5-1,TRBJ1-6,CASGDSNSPLHF,0,3,1,3
TRBV5-1,TRBJ2-7,CASSRTGDEQYF,0,3,1,3
TRBV4-1,TRBJ1-1,CASSQGFTEAFF,0,3,1,3
TRBV5-1,TRBJ2-1,CASSTGPTSQFF,0,3,1,3
TRBV20-1,TRBJ2-1,CTSGLSYNEQFF,0,3,1,3
TRBV29-1,TRBJ2-7,CSVGTSFDEQYF,0,3,1,3
TRBV20-1,TRBJ2-7,CSAISRSAEQYF,0,3,1,3
TRBV20-1,TRBJ2-7,CSASGSGYEQYF,0,3,1,3
TRBV20-1,TRBJ2-1,CSARVPGDEQFF,0,3,1,3
TRBV20-1,TRBJ1-1,CSARGPNTEAFF,0,3,1,3
TRBV20-1,TRBJ2-5,CSARNGQETQYF,0,3,1,3
TRBV20-1,TRBJ1-1,CSAKVLNTEAFF,0,3,1,3
TRBV20-1,TRBJ1-3,CSGQGPGNTIYF,0,3,1,3
TRBV29-1,TRBJ2-1,CSVVQGPGEQFF,0,3,1,3
TRBV29-1,TRBJ2-2,CSVARSTGELFF,0,3,1,3
TRBV29-1,TRBJ1-3,CSVAGDGNTIYF,0,3,1,3
TRBV29-1,TRBJ2-5,CSVGDPGETQYF,0,3,1,3
TRBV29-1,TRBJ2-1,CSVGTGIHEQFF,0,3,1,3
TRBV29-1,TRBJ2-1,CSVGRARYEQFF,0,3,1,3
TRBV29-1,TRBJ1-1,CSVDLGGTEAFF,0,3,1,3
TRBV29-1,TRBJ2-7,CSVRVTSYEQYF,0,3,1,3
TRBV29-1,TRBJ2-1,CSVKQGYDEQFF,0,3,1,3
TRBV29-1,TRBJ1-1,CSVQQTGSEAFF,0,3,1,3
TRBV29-1,TRBJ1-1,CSGKRQGAEAFF,0,3,1,3
TRBV18,TRBJ1-1,CACSTTGKAFF,0,3,1,3
TRBV30,TRBJ1-3,CAWMIGNTIYF,0,3,1,3
TRBV30,TRBJ2-2,CAWSVAGELFF,0,3,1,3
TRBV2,TRBJ2-1,CASGTDNEQFF,0,3,1,3
TRBV25-1,TRBJ2-1,CASGSGGRQFF,0,3,1,3
TRBV2,TRBJ1-1,CASTGNGEAFF,0,3,1,3
TRBV28,TRBJ2-1,CASSLVDEQFF,0,3,1,3
TRBV12-3/4,TRBJ2-6,CASSSGAVLTF,0,3,1,3
TRBV6-2/3/5/6,TRBJ2-1,CASSYLDEQFF,0,3,1,3
TRBV12-3/4,TRBJ2-1,CASSVALEQFF,0,3,1,3
TRBV7-9,TRBJ1-6,CASSLGSPLHF,0,3,1,3
TRBV7-9,TRBJ2-7,CASSLSSEQYF,0,3,1,3
TRBV7-2,TRBJ1-2,CASSSRYGYTF,0,3,1,3
TRBV3-1,TRBJ1-2,CASSLTGGYTF,0,3,1,3
TRBV6-2/3/5/6,TRBJ2-1,CASSPVGEQFS,0,3,1,3
TRBV11-2,TRBJ2-1,CASSPGIELFF,0,3,1,3
TRBV3-1,TRBJ2-7,CASSRTWEQYF,0,3,1,3
TRBV12-3/4,TRBJ1-2,CASSRRGGYTF,0,3,1,3
TRBV3-1,TRBJ2-1,CASSQGATEIF,0,3,1,3
TRBV4-2,TRBJ2-1,CASSQDRWQFF,0,3,1,3
TRBV7-4,TRBJ2-7,CASSTRYERYF,0,3,1,3
TRBV25-1,TRBJ1-1,CASSRGTEAFF,0,3,1,3
TRBV10-3,TRBJ2-7,CASRWVDEQYF,0,3,1,3
TRBV2,TRBJ2-5,CASRLWETQYF,0,3,1,3
TRBV30,TRBJ1-2,CAVVGIYGYTF,0,3,1,3
TRBV10-2,TRBJ2-4,CASWTGEVQYF,0,3,1,3
TRBV5-1,TRBJ2-5,CASSLLETQYF,0,3,1,3
TRBV5-1,TRBJ2-1,CASSLHNEQFF,0,3,1,3
TRBV5-1,TRBJ2-7,CASSLGHEQYF,0,3,1,3
TRBV20-1,TRBJ2-1,CSPSVGNEQFF,0,3,1,3
TRBV20-1,TRBJ1-1,CSASSNTEAFF,0,3,1,3
TRBV20-1,TRBJ2-1,CSANLPVEQFF,0,3,1,3
TRBV20-1,TRBJ2-2,CSAKRAGELFF,0,3,1,3
TRBV29-1,TRBJ2-3,CSVYSTDTQYF,0,3,1,3
TRBV29-1,TRBJ2-7,CSVKSADEQYF,0,3,1,3
TRBV29-1,TRBJ2-1,CSVEMGLEQFF,0,3,1,3
TRBV29-1,TRBJ2-1,CSVRTSCEQFF,0,3,1,3
TRBV29-1,TRBJ2-1,CSVAGVHEQFF,0,3,1,3
TRBV20-1,TRBJ1-2,CSAGVVYGYTF,0,3,1,3
TRBV29-1,TRBJ2-5,CSKTDQESQYF,0,3,1,3
TRBV29-1,TRBJ2-1,CRVGGGNEQFF,0,3,1,3
TRBV27,TRBJ2-3,CASGRGTQYF,0,3,1,3
TRBV20-1,TRBJ2-1,CSADRHEQFF,0,3,1,3
TRBV20-1,TRBJ2-5,CSASRETQYF,0,3,1,3
TRBV29-1,TRBJ1-1,CSVVIGEAFF,0,3,1,3
TRBV29-1,TRBJ2-7,CSGWEGEQYL,0,3,1,3
TRBV19,TRBJ2-7,CASRQGQYF,0,3,1,3
TRBV7-9,TRBJ2-1,CASTGPGFF,0,3,1,3
TRBV3-1,TRBJ1-1,CASSQTAFI,0,3,1,3
TRBV20-1,TRBJ1-2,CMTGYTF,0,3,1,3
TRBV9,TRBJ1-4,CASANPPGRGPTNEKLFF,0,3,1,3
TRBV30,TRBJ1-6,CAWSGQFAYNSPLHF,0,3,1,3
TRBV4-2,TRBJ2-4,CASSQVFARGNFQYF,0,3,1,3
TRBV6-2/3/5/6,TRBJ1-1,CASSSTGSRTEAFF,0,3,1,3
TRBV27,TRBJ2-7,CASSIGGASYEQYF,0,3,1,3
TRBV6-1,TRBJ1-6,CASSVRGSPLHI,0,3,1,3
TRBV25-1,TRBJ2-7,CASSGQPYEQYF,0,3,1,3
TRBV29-1,TRBJ2-3,CSVEGGSTSGRTDTQYF,0,2,1,2
TRBV19,TRBJ1-5,CASSRPLQGGNQPQHF,0,2,1,2
TRBV5-1,TRBJ2-1,CASRVSLDWAQERFF,0,2,1,2
TRBV3-1,TRBJ1-1,CASSQKWTGATEAFF,0,2,1,2
TRBV3-1,TRBJ2-7,CASSSVRGGYEQYF,0,2,1,2
TRBV5-1,TRBJ2-7,CASSIGTSGNEQYF,0,2,1,2
TRBV20-1,TRBJ2-4,CSASDVAKNIQYL,0,2,1,2
TRBV18,TRBJ1-1,CASSPRVSISEDTEAFL,0,2,1,2
TRBV7-9,TRBJ2-7,CASSLSGTASSYEQYF,0,2,1,2
TRBV15,TRBJ2-4,CATSRDRRDTGLAGVNLAKNIQYF,0,2,1,2
TRBV11-2,TRBJ2-1,CASSFRLPGGLAGEGSYNEQFF,0,2,1,2
TRBV9,TRBJ2-1,CASSGGPKQWAITSGDYNEQFF,0,2,1,2
TRBV18,TRBJ2-1,CASSPPKPLAGFLEREDEQFF,0,2,1,2
TRBV28,TRBJ2-3,CASSFSSRPSGRQGSTDTQYF,0,2,1,2
TRBV6-2/3/5/6,TRBJ2-3,CASSWVWAREPEAVSTDTQYF,0,2,1,2
TRBV13,TRBJ2-1,CASSLGFPGLSGSGKYNEQFF,0,2,1,2
TRBV14,TRBJ1-1,CASSHSLKVLRQGRTNTEAFF,0,2,1,2
TRBV7-9,TRBJ2-3,CASSHGIGTTIAALLVDTQYF,0,2,1,2
TRBV30,TRBJ1-1,CAWSVLGMRRQGAPNTEAFF,0,2,1,2
TRBV15,TRBJ2-2,CATSREPVSGRAFNTGELFF,0,2,1,2
TRBV12-3/4,TRBJ2-2,CASCYSSLGLAGEITGELFF,0,2,1,2
TRBV7-8,TRBJ2-5,CASSSRTGASGGRPRETQYS,0,2,1,2
TRBV5-6,TRBJ2-1,CASSLELAGGPGLIGNEQFF,0,2,1,2
TRBV7-3,TRBJ2-2,CASSLTLGIAGATNTGELFF,0,2,1,2
TRBV7-2,TRBJ2-1,CASSSKYLGIRHEDNNEQFF,0,2,1,2
TRBV14,TRBJ2-6,CASSPRVPVHRASGANVLTF,0,2,1,2
TRBV5-1,TRBJ2-1,CASSWSSGLAGSRAENEQFF,0,2,1,2
TRBV19,TRBJ2-2,CATLAGGLPNFANTGELFF,0,2,1,2
TRBV15,TRBJ1-4,CATSRDYPAGTPEIGKLFF,0,2,1,2
TRBV6-2/3/5/6,TRBJ2-5,CASSYSPGTSGRSQETQYF,0,2,1,2
TRBV6-2/3/5/6,TRBJ2-1,CASSYDSRTGFIRYNEQFF,0,2,1,2
TRBV6-2/3/5/6,TRBJ2-5,CASSYTAGTSAQYQETQYF,0,2,1,2
TRBV12-3/4,TRBJ2-7,CASSPGSLTGGRFSYEQYF,0,2,1,2
TRBV7-2,TRBJ1-4,CASSLEATGGLATNEKLFF,0,2,1,2
TRBV7-2,TRBJ2-7,CASSWPGTSGTMSSYEQYF,0,2,1,2
TRBV7-9,TRBJ2-1,CASSLFSTRTGDRYNEQFF,0,2,1,2
TRBV7-9,TRBJ2-3,CASSPTSGGLQGYTDTQYF,0,2,1,2
TRBV4-2,TRBJ1-2,CASSQSPTWKGGLFYGYTF,0,2,1,2
TRBV14,TRBJ2-1,CASSQWGTGTPSSYNEQFF,0,2,1,2
TRBV4-2,TRBJ2-7,CASSQRPAGTSGRVDEQYF,0,2,1,2
TRBV7-9,TRBJ2-6,CASRAQLRTREFWANVLTF,0,2,1,2
TRBV5-1,TRBJ2-1,CASSSRPSGSAVRGNEQFF,0,2,1,2
TRBV4-1,TRBJ2-3,CASSQAVGRQRLNMGGQYF,0,2,1,2
TRBV4-3,TRBJ2-1,CASSQDAGPIYSSYNEQFF,0,2,1,2
TRBV4-3,TRBJ2-1,CASSQEPLGAGTSYNEQFF,0,2,1,2
TRBV4-1,TRBJ2-6,CASSQEIFQGASGANVLTF,0,2,1,2
TRBV20-1,TRBJ2-3,CSAPRVAGGPSFVPDTQYF,0,2,1,2
TRBV29-1,TRBJ2-1,CSVEDLDRRLFGSYNEQFF,0,2,1,2
TRBV12-5,TRBJ2-5,CASGLTPVTRGPVGTQYF,0,2,1,2
TRBV24-1,TRBJ2-2,CATSDNPQGPWNTGELFF,0,2,1,2
TRBV15,TRBJ2-1,CATSRVDGGRNPYNEQFF,0,2,1,2
TRBV19,TRBJ2-3,CASSYATGTGLLGDTQYF,0,2,1,2
TRBV12-3/4,TRBJ1-5,CASPRPGEGSMSNQPQHF,0,2,1,2
TRBV6-2/3/5/6,TRBJ2-1,CASTHDRVDLATRDEQFF,0,2,1,2
TRBV12-3/4,TRBJ2-2,CASSLPPGQGDHTGELFF,0,2,1,2
TRBV12-3/4,TRBJ2-6,CASSLGQVFSDEANVLTF,0,2,1,2
TRBV12-3/4,TRBJ2-1,CASSLGSGDSRSYNEQFF,0,2,1,2
TRBV12-3/4,TRBJ2-1,CASSSVIYSGSINNEQFF,0,2,1,2
TRBV6-2/3/5/6,TRBJ1-2,CASSYSRDHRGLSYGYTF,0,2,1,2
TRBV6-2/3/5/6,TRBJ2-3,CASSYGLLADGSTDTQYF,0,2,1,2
TRBV12-3/4,TRBJ1-3,CASSRLLQGKYSGNTIYF,0,2,1,2
TRBV25-1,TRBJ2-2,CASSAPSLARANTGELFF,0,2,1,2
TRBV6-4,TRBJ2-1,CASSDLPPGEGSYNEQFF,0,2,1,2
TRBV12-3/4,TRBJ2-4,CASSTQSGTSGAKNIQYF,0,2,1,2
TRBV7-2,TRBJ1-5,CASSFGQGGSYSNQPQHF,0,2,1,2
TRBV5-6,TRBJ2-1,CASSLGVTGTGDNNEQFF,0,2,1,2
TRBV7-7,TRBJ2-7,CASSLSHRSGIFSYEQYF,0,2,1,2
TRBV6-2/3/5/6,TRBJ2-6,CASSLSERDYSGANVPTF,0,2,1,2
TRBV7-6,TRBJ2-1,CASSLRPASGSSYNEQFF,0,2,1,2
TRBV7-6,TRBJ1-2,CASSLAVQRDSPWYGYTF,0,2,1,2
TRBV11-2,TRBJ2-1,CASSLGYRGRRPDNEQFF,0,2,1,2
TRBV7-9,TRBJ1-5,CASSLGEVRLRDNQPQHF,0,2,1,2
TRBV7-2,TRBJ2-1,CASSLTSGGSSSYNEQFF,0,2,1,2
TRBV7-9,TRBJ2-7,CASSSSTQRYSSSYEQYF,0,2,1,2
TRBV5-4,TRBJ1-1,CASSSPDAGGGGLTEAFF,0,2,1,2
TRBV5-6,TRBJ1-2,CASSSTRWGGQSSPGYTF,0,2,1,2
TRBV7-8,TRBJ2-1,CASSSTIAGGPSNNEQFF,0,2,1,2
TRBV7-2,TRBJ2-6,CASSLGGGSRSGANVLTF,0,2,1,2
TRBV7-9,TRBJ2-3,CASSLRRATSGTPHTQYF,0,2,1,2
TRBV5-6,TRBJ2-4,CASSPKIGTNIAKNIQYF,0,2,1,2
TRBV7-9,TRBJ2-5,CASSPPTSGRASEETQYF,0,2,1,2
TRBV3-1,TRBJ2-1,CASSRWTSRGTQGNEQFS,0,2,1,2
TRBV3-1,TRBJ2-1,CASSHETGRTVSYNEQFL,0,2,1,2
TRBV3-1,TRBJ2-1,CASSQDTRAGGGLDEQFF,0,2,1,2
TRBV9,TRBJ2-3,CASSVEGLAADSTDTQYF,0,2,1,2
TRBV7-9,TRBJ2-7,CASSVKLGTAGRLYEQYF,0,2,1,2
TRBV2,TRBJ2-4,CASRDRTGGISAKNIQYF,0,2,1,2
TRBV7-2,TRBJ2-3,CASRPISLAGRNTDTQYF,0,2,1,2
TRBV6-2/3/5/6,TRBJ2-7,CASRRPGQGKSLGYEQYF,0,2,1,2
TRBV5-1,TRBJ2-6,CASSFGRPDRTGANVLTF,0,2,1,2
TRBV5-1,TRBJ1-3,CASSFGTPEYTSGNTIYF,0,2,1,2
TRBV5-1,TRBJ2-6,CASSLPRQVPPGANVLTF,0,2,1,2
TRBV5-1,TRBJ1-4,CASSLRSLRDSANEKLFF,0,2,1,2
TRBV4-3,TRBJ1-2,CASSLGRNFRTANYGYTF,0,2,1,2
TRBV4-1,TRBJ2-2,CASSPFETGLVNTGELFF,0,2,1,2
TRBV4-1,TRBJ1-5,CASSQGGRQGYGNQPQHF,0,2,1,2
TRBV4-1,TRBJ2-5,CASSQDFTRAHYQETQYF,0,2,1,2
TRBV4-3,TRBJ2-3,CASSQDPTSGRAGDTQYF,0,2,1,2
TRBV4-3,TRBJ2-7,CASSQDRVLAGGSAKQYF,0,2,1,2
TRBV4-3,TRBJ2-3,CASSQDLLAGELGDTQYF,0,2,1,2
TRBV20-1,TRBJ2-2,CSAASLRASELNTGELFF,0,2,1,2
TRBV20-1,TRBJ1-2,CSAILLSGDLPSGYGYTF,0,2,1,2
TRBV29-1,TRBJ2-3,CSVALVLVATEITDTQYF,0,2,1,2
TRBV7-2,TRBJ1-6,CAGSLVGGGEYNSPLHF,0,2,1,2
TRBV12-3/4,TRBJ2-7,CAIPLPTGTGNTYEQYS,0,2,1,2
TRBV15,TRBJ2-5,CATSREQGGGAVETQYF,0,2,1,2
TRBV15,TRBJ2-2,CATSRDGRTRTTGELFF,0,2,1,2
TRBV24-1,TRBJ2-1,CATKDRQGVSSCNEQFF,0,2,1,2
TRBV19,TRBJ2-6,CASSIGWITSGANVLTF,0,2,1,2
TRBV19,TRBJ2-1,CASSMRVGASSYNEQFF,0,2,1,2
TRBV19,TRBJ1-4,CASSIGPEGATNEKLFF,0,2,1,2
TRBV18,TRBJ1-1,CASSLQGSGAMNTEAFF,0,2,1,2
TRBV18,TRBJ1-1,CASSPSGQGLWETEAFF,0,2,1,2
TRBV2,TRBJ2-7,CASLSTGGLAGGYEQYF,0,2,1,2
TRBV5-4,TRBJ2-1,CASGPRIGTGSRDEQFF,0,2,1,2
TRBV6-2/3/5/6,TRBJ2-6,CASTDRRGRSGANVLTF,0,2,1,2
TRBV12-3/4,TRBJ2-5,CASSFLVRGSVQETQYF,0,2,1,2
TRBV6-2/3/5/6,TRBJ2-1,CASSLFQRGATRYEQFF,0,2,1,2
TRBV12-3/4,TRBJ2-7,CASSLVGPGQGVHEQYF,0,2,1,2
TRBV12-3/4,TRBJ2-1,CASSLEFLAGGNNERFF,0,2,1,2
TRBV12-3/4,TRBJ2-1,CASSLEFLAGGNNEQFF,0,2,1,2
TRBV6-2/3/5/6,TRBJ2-2,CASSSPSGSGNTGELFF,0,2,1,2
TRBV6-2/3/5/6,TRBJ1-6,CASSSPAGGSYNSPLHF,0,2,1,2
TRBV12-3/4,TRBJ2-2,CASSSGLAGTNTGELFF,0,2,1,2
TRBV6-2/3/5/6,TRBJ2-5,CASSYSNSPGQQETQYF,0,2,1,2
TRBV7-2,TRBJ2-6,CASSPGAGNSGANVLTF,0,2,1,2
TRBV6-2/3/5/6,TRBJ1-2,CASSPSFAGGLHYGYTF,0,2,1,2
TRBV12-3/4,TRBJ2-1,CASSPRLAGGLYNEQFF,0,2,1,2
TRBV13,TRBJ2-1,CASSRTSGGSSYNEQFF,0,2,1,2
TRBV6-4,TRBJ2-2,CASSARTSGGYTGELFF,0,2,1,2
TRBV6-1,TRBJ2-1,CASSDLLPKVHDKWQFF,0,2,1,2
TRBV28,TRBJ1-5,CASSEGGAGRPNQPQHF,0,2,1,2
TRBV25-1,TRBJ2-3,CASSEPRDRAGTDTQYF,0,2,1,2
TRBV2,TRBJ1-1,CASSEVRSRTGHTEAFF,0,2,1,2
TRBV2,TRBJ2-2,CASSEVGGQSLTGELFF,0,2,1,2
TRBV5-6,TRBJ1-1,CASSLRIWARLNTEAFF,0,2,1,2
TRBV5-4,TRBJ2-1,CASSLDSGRFPYNEQFF,0,2,1,2
TRBV5-5,TRBJ2-7,CASSLEPSGRNSYEQYF,0,2,1,2
TRBV7-6,TRBJ2-1,CASSLTSGRAAYNEQFF,0,2,1,2
TRBV7-2,TRBJ2-5,CASSLSTGPGVQETQYF,0,2,1,2
TRBV7-2,TRBJ2-6,CASSLYTRDSGANVLTF,0,2,1,2
TRBV5-4,TRBJ2-2,CASSLLAGGPPSGELFF,0,2,1,2
TRBV7-2,TRBJ2-6,CASSLLAGGIGANVLTF,0,2,1,2
TRBV7-2,TRBJ1-5,CASSLVAGQLEGQPQHF,0,2,1,2
TRBV7-2,TRBJ2-1,CASSLVPTSGRRREQFF,0,2,1,2
TRBV7-6,TRBJ2-6,CASSLVGSLAGANVLTF,0,2,1,2
TRBV7-9,TRBJ2-1,CASSLVSSRNPPYEQFF,0,2,1,2
TRBV7-6,TRBJ2-7,CASSLASGLAGVYEQYF,0,2,1,2
TRBV7-9,TRBJ2-5,CASSLASLAGGGETQHF,0,2,1,2
TRBV11-2,TRBJ2-7,CASSLAAGVWSNYEQYF,0,2,1,2
TRBV7-9,TRBJ2-1,CASSLDPYAGDYNEQFF,0,2,1,2
TRBV7-2,TRBJ2-2,CASSLDGLAGGSGELFF,0,2,1,2
TRBV7-3,TRBJ2-1,CASSLMPSGASYNEQFF,0,2,1,2
TRBV7-2,TRBJ2-2,CASSLRGLSGGTGELLF,0,2,1,2
TRBV7-2,TRBJ2-3,CASSSLPEGPSTDTQYF,0,2,1,2
TRBV5-6,TRBJ1-5,CASSSRTGGIGNQPQHF,0,2,1,2
TRBV7-9,TRBJ2-1,CASSSGERGGLRNEQFF,0,2,1,2
TRBV5-6,TRBJ2-6,CASSSTGRVSGANVLTF,0,2,1,2
TRBV7-9,TRBJ2-7,CASSSIETDRGDYEQYF,0,2,1,2
TRBV7-2,TRBJ2-2,CASSLYRTGGLIGELFF,0,2,1,2
TRBV6-2/3/5/6,TRBJ2-3,CASSPGSGQAYADTQYF,0,2,1,2
TRBV11-2,TRBJ2-1,CASSPMGGGGFYNEQFF,0,2,1,2
TRBV11-2,TRBJ2-1,CASSPLGGSGSLREQFF,0,2,1,2
TRBV6-2/3/5/6,TRBJ2-7,CASSPTQGRLPTYEQYF,0,2,1,2
TRBV5-5,TRBJ2-3,CASSPSRTSGSTDTQYF,0,2,1,2
TRBV3-1,TRBJ2-3,CASSHGLAGGQTDTQYF,0,2,1,2
TRBV4-2,TRBJ2-6,CASSQALQGTGANVLTF,0,2,1,2
TRBV4-2,TRBJ2-5,CASSQGTRGSNQETQYF,0,2,1,2
TRBV4-2,TRBJ2-5,CASSQGLAGGPDKTQYF,0,2,1,2
TRBV4-2,TRBJ2-5,CASSQGDSLLYQETQYF,0,2,1,2
TRBV4-2,TRBJ1-2,CASSQDPVGTSGYGYTF,0,2,1,2
TRBV3-1,TRBJ2-1,CASSQEGGGSSYNEQFF,0,2,1,2
TRBV14,TRBJ2-7,CASSQTYTGGFAYEQYF,0,2,1,2
TRBV9,TRBJ2-1,CASSVAAEGGPGNEQFF,0,2,1,2
TRBV7-8,TRBJ2-1,CASSAFLAGGPHNEQFF,0,2,1,2
TRBV9,TRBJ1-1,CASSADPNRAMNTEAFF,0,2,1,2
TRBV5-5,TRBJ2-3,CASSENRLAGGTDTQYF,0,2,1,2
TRBV5-4,TRBJ2-1,CASRPSGAPSSYNEQFF,0,2,1,2
TRBV27,TRBJ1-4,CASRARQMPAANEKLFF,0,2,1,2
TRBV2,TRBJ2-1,CASRGGTRGSTYNEQFF,0,2,1,2
TRBV19,TRBJ1-5,CASSMGGAGGSNQPQHF,0,2,1,2
TRBV5-1,TRBJ2-7,CASSFDVSARRYYEQYF,0,2,1,2
TRBV5-1,TRBJ2-7,CASSLVAGGSFSYEQYF,0,2,1,2
TRBV5-1,TRBJ2-6,CASSLAGPNSGANVLTF,0,2,1,2
TRBV5-1,TRBJ2-7,CASSLDLAGGGFYEQYF,0,2,1,2
TRBV5-1,TRBJ2-3,CASSLRPMGGLFDTQYF,0,2,1,2
TRBV7-9,TRBJ2-7,CASSLAGGQGGSYEQYF,0,2,1,2
TRBV4-1,TRBJ2-3,CASSLRGTGGVTDTQYF,0,2,1,2
TRBV4-1,TRBJ1-4,CASSPRTGGITNEKLFF,0,2,1,2
TRBV4-1,TRBJ2-5,CASSRLPTGASVETQYF,0,2,1,2
TRBV4-1,TRBJ2-2,CASSHPSGGPNTGELFF,0,2,1,2
TRBV4-3,TRBJ2-3,CASSQAGTSGSTDTQYF,0,2,1,2
TRBV4-1,TRBJ1-5,CASSQVVGQGVDQPQHF,0,2,1,2
TRBV4-1,TRBJ1-3,CASSQAALVGSGNTIYF,0,2,1,2
TRBV4-3,TRBJ1-3,CASSQGVGTNSGNTIYF,0,2,1,2
TRBV4-1,TRBJ2-3,CASSQDPIAAGTDTQYF,0,2,1,2
TRBV4-3,TRBJ2-3,CASSQDRGQGVADTQYF,0,2,1,2
TRBV4-3,TRBJ2-1,CASSQDGGLANYNEQFF,0,2,1,2
TRBV4-3,TRBJ2-6,CASSQDGKGSGANVLTF,0,2,1,2
TRBV4-3,TRBJ2-1,CASSQESPLAGGDEQFF,0,2,1,2
TRBV4-3,TRBJ2-1,CASSQEVAGGIYNEQFF,0,2,1,2
TRBV4-3,TRBJ2-7,CASSQERTSGGPYEQYF,0,2,1,2
TRBV4-1,TRBJ1-1,CASSDPRNRGLNTEAFF,0,2,1,2
TRBV4-1,TRBJ2-1,CASRAKSALGPYDGQFF,0,2,1,2
TRBV20-1,TRBJ2-3,CSARPDGGAGGPDTQYF,0,2,1,2
TRBV20-1,TRBJ2-1,CSARVVWREASYNEQFF,0,2,1,2
TRBV20-1,TRBJ2-1,CSARDLLVASTYNEQFF,0,2,1,2
TRBV20-1,TRBJ2-1,CSARDLSGSLSYNEQFF,0,2,1,2
TRBV20-1,TRBJ1-4,CSARDLLEGALNEKLFF,0,2,1,2
TRBV20-1,TRBJ2-3,CSARDPQGRGSTDTQYF,0,2,1,2
TRBV20-1,TRBJ1-5,CSARDPSRSGANQPQHF,0,2,1,2
TRBV29-1,TRBJ2-2,CSVKLAGSLGGTGELFF,0,2,1,2
TRBV14,TRBJ2-7,WASSQTYTGGFAYEQYF,0,2,1,2
TRBV12-5,TRBJ2-4,CASGLVLGVAKNIQYF,0,2,1,2
TRBV12-5,TRBJ1-5,CASGLGDTYSNQPQHF,0,2,1,2
TRBV30,TRBJ2-5,CAWSPPGQGLRETQYF,0,2,1,2
TRBV30,TRBJ2-1,CAWRHPLQGASNEQFF,0,2,1,2
TRBV2,TRBJ2-1,CAIEPGQGGVDNEQFF,0,2,1,2
TRBV10-3,TRBJ2-3,CAITLGTGLASDTQYF,0,2,1,2
TRBV10-3,TRBJ2-5,CAISESWAKSQETQYF,0,2,1,2
TRBV10-3,TRBJ2-3,CAIRTGERDGTDTQYF,0,2,1,2
TRBV10-3,TRBJ2-7,CATYRGRDAQAYEQYF,0,2,1,2
TRBV15,TRBJ1-4,CATTPTGERTNEKLFF,0,2,1,2
TRBV15,TRBJ2-7,CATSPLREGVTYEQYF,0,2,1,2
TRBV15,TRBJ2-1,CATSTFSGGALDEQFF,0,2,1,2
TRBV15,TRBJ1-2,CATSRDQGPHAYGYTF,0,2,1,2
TRBV15,TRBJ2-5,CATSREDGVFNRDQYF,0,2,1,2
TRBV24-1,TRBJ2-2,CATRGEGQVHTGELFF,0,2,1,2
TRBV15,TRBJ2-2,CATGQGDFANTGKLFF,0,2,1,2
TRBV18,TRBJ1-1,CASRTGETGGASEAFF,0,2,1,2
TRBV19,TRBJ1-5,CASSYPRGQSNQPQHF,0,2,1,2
TRBV19,TRBJ1-5,CASSLYRGDSNQPQHF,0,2,1,2
TRBV19,TRBJ2-1,CASSIPGASGGNEQFF,0,2,1,2
TRBV19,TRBJ2-2,CASSIRGRTNTGELFF,0,2,1,2
TRBV19,TRBJ2-3,CASSIGGDRRTDTQYF,0,2,1,2
TRBV19,TRBJ2-1,CASSTGSLGLYNEQFF,0,2,1,2
TRBV18,TRBJ2-1,CASSPVRSGSYNEQFF,0,2,1,2
TRBV18,TRBJ2-3,CASSPFSQGNTDTQYF,0,2,1,2
TRBV18,TRBJ2-1,CASSPKRGEVFNEQFF,0,2,1,2
TRBV19,TRBJ1-5,CASPGQDHDSNQPQHF,0,2,1,2
TRBV4-2,TRBJ2-3,CASGQTSGKGTDTQYF,0,2,1,2
TRBV12-3/4,TRBJ2-7,CASGYRRGAGSYEQYF,0,2,1,2
TRBV7-9,TRBJ2-7,CASEAVTGQDAYEQYF,0,2,1,2
TRBV6-2/3/5/6,TRBJ1-5,CASTGRQGGSNQPQHF,0,2,1,2
TRBV2,TRBJ2-1,CASTRSLAEQYNEQFF,0,2,1,2
TRBV6-2/3/5/6,TRBJ2-7,CASTRGEGGGTYEQYF,0,2,1,2
TRBV2,TRBJ2-1,CASTRTSGPSYNEQFF,0,2,1,2
TRBV6-2/3/5/6,TRBJ2-5,CASSFYLSSFKETQYF,0,2,1,2
TRBV12-3/4,TRBJ2-5,CASSFYLSPFKETQYF,0,2,1,2
TRBV12-3/4,TRBJ2-7,CASSFGGTSGRDEQYF,0,2,1,2
TRBV6-2/3/5/6,TRBJ2-5,CASSFLAGTIGETQYF,0,2,1,2
TRBV12-3/4,TRBJ2-7,CASSFGDRAARNEQYF,0,2,1,2
TRBV28,TRBJ2-1,CASSLGVRAQGDEQFF,0,2,1,2
TRBV27,TRBJ1-6,CASSLSGQGVTSPLHF,0,2,1,2
TRBV27,TRBJ2-5,CASSLSWVTTRETQYF,0,2,1,2
TRBV28,TRBJ2-7,CASSLPTGGINDEQYF,0,2,1,2
TRBV12-3/4,TRBJ2-6,CASSLRWGDGANVLTF,0,2,1,2
TRBV12-3/4,TRBJ2-1,CASSLQSGTALNEQFF,0,2,1,2
TRBV6-2/3/5/6,TRBJ1-6,CASSLGTGGRNSPLHF,0,2,1,2
TRBV7-3,TRBJ2-1,CASSLIVTSGNNEQFF,0,2,1,2
TRBV6-2/3/5/6,TRBJ2-1,CASSSLWVRTYNEQFF,0,2,1,2
TRBV6-2/3/5/6,TRBJ2-1,CASSYFRDGLYNEQFF,0,2,1,2
TRBV6-2/3/5/6,TRBJ1-4,CASSYSNRATNEKLFF,0,2,1,2
TRBV6-2/3/5/6,TRBJ1-3,CASSYSRASSGNTIYF,0,2,1,2
TRBV6-2/3/5/6,TRBJ2-1,CASSYSGGRRYNEQFF,0,2,1,2
TRBV6-2/3/5/6,TRBJ1-1,CASSYSKGAENTEAFF,0,2,1,2
TRBV6-2/3/5/6,TRBJ1-2,CASSYSRGQGGDGYTF,0,2,1,2
TRBV6-2/3/5/6,TRBJ2-5,CASSYLTSGGPETQYF,0,2,1,2
TRBV6-2/3/5/6,TRBJ2-1,CASSYPTGPSGNEQFF,0,2,1,2
TRBV6-2/3/5/6,TRBJ2-7,CASSYPSGSGRVEQYF,0,2,1,2
TRBV6-2/3/5/6,TRBJ2-2,CASSYPLRGDTGELFF,0,2,1,2
TRBV6-2/3/5/6,TRBJ1-1,CASSYRRGTGDTEAFF,0,2,1,2
TRBV6-2/3/5/6,TRBJ1-5,CASSYVWDSSNQPQHF,0,2,1,2
TRBV6-2/3/5/6,TRBJ2-1,CASSYAPVSSYNEQFF,0,2,1,2
TRBV6-2/3/5/6,TRBJ1-2,CASSYGGSLSNYGYTF,0,2,1,2
TRBV7-9,TRBJ2-3,CASSPRTSGGQDTQYF,0,2,1,2
TRBV7-2,TRBJ2-3,CASSPHVAGGLNTQYF,0,2,1,2
TRBV12-3/4,TRBJ2-2,CASSPAPAGTTGELFF,0,2,1,2
TRBV12-3/4,TRBJ2-7,CASSRPTSGRPLEQYF,0,2,1,2
TRBV28,TRBJ1-1,CASSRDRGRMNTEAFF,0,2,1,2
TRBV7-2,TRBJ2-1,CASSRTSGRSYNEQFF,0,2,1,2
TRBV6-2/3/5/6,TRBJ2-2,CASSQTGLVGTGELFF,0,2,1,2
TRBV6-1,TRBJ2-7,CASSQTRGQGSSEQYF,0,2,1,2
TRBV6-4,TRBJ2-1,CASSDSGTSSYNEQFF,0,2,1,2
TRBV6-4,TRBJ1-3,CASSDLGQPRGNTIYF,0,2,1,2
TRBV6-4,TRBJ1-6,CASSDPFHRYNSPLHF,0,2,1,2
TRBV6-4,TRBJ2-7,CASSDRTRFQSYEQYF,0,2,1,2
TRBV2,TRBJ1-5,CASSERIGGGNQPQHF,0,2,1,2
TRBV2,TRBJ2-5,CASSEVGGRFPETQYF,0,2,1,2
TRBV6-1,TRBJ2-1,CASSEGFGRLQDEQFF,0,2,1,2
TRBV6-1,TRBJ1-2,CASSKQGNPDYYGYTF,0,2,1,2
TRBV6-2/3/5/6,TRBJ2-1,CASSFSALSSYNEQFF,0,2,1,2
TRBV13,TRBJ2-1,CASSFYRGSRYNEQFF,0,2,1,2
TRBV5-6,TRBJ2-7,CASSFGGRDRAYEQYF,0,2,1,2
TRBV7-8,TRBJ2-5,CASSFSSGGASETQYF,0,2,1,2
TRBV7-9,TRBJ2-2,CASSFWGLANTGELFF,0,2,1,2
TRBV7-9,TRBJ2-5,CASSFGTSGIQETQYF,0,2,1,2
TRBV13,TRBJ2-7,CASSFTSGGPSYEQYF,0,2,1,2
TRBV5-4,TRBJ1-5,CASSLYGTGGNQPQHF,0,2,1,2
TRBV5-4,TRBJ2-7,CASSLPSGGASYEQYF,0,2,1,2
TRBV7-2,TRBJ2-1,CASSLHPGPWGDEQFF,0,2,1,2
TRBV7-9,TRBJ2-7,CASSLGLAGNAYEQYF,0,2,1,2
TRBV5-5,TRBJ2-7,CASSLGQGRISYERYF,0,2,1,2
TRBV5-4,TRBJ2-1,CASSLDPSGRTNEQFF,0,2,1,2
TRBV5-6,TRBJ2-2,CASSLDGRAGGGELFF,0,2,1,2
TRBV5-6,TRBJ1-1,CASSLELTGLDFEAFF,0,2,1,2
TRBV7-2,TRBJ1-5,CASSLTAVRGNQPQHF,0,2,1,2
TRBV7-9,TRBJ2-1,CASSLFRGASYNEQFF,0,2,1,2
TRBV7-2,TRBJ2-6,CASSLSGAFGANVLTF,0,2,1,2
TRBV5-6,TRBJ2-1,CASSLLTSGDYNGQFF,0,2,1,2
TRBV12-3/4,TRBJ1-5,CASSLLRGGGSRPQHV,0,2,1,2
TRBV7-9,TRBJ1-1,CASSLPRDSLGTEAFF,0,2,1,2
TRBV11-2,TRBJ2-7,CASSLVAWTDSYEQYF,0,2,1,2
TRBV11-2,TRBJ2-7,CASSLVAGGPVGEQYF,0,2,1,2
TRBV7-2,TRBJ2-7,CASSLAGLAGRWEQYF,0,2,1,2
TRBV7-2,TRBJ2-7,CASSLARTGALGERYF,0,2,1,2
TRBV5-5,TRBJ2-2,CASSLGVRGVTGELFF,0,2,1,2
TRBV13,TRBJ1-3,CASSLGPNPSGNTIYF,0,2,1,2
TRBV7-6,TRBJ2-5,CASSLGGGGAGETQYF,0,2,1,2
TRBV7-6,TRBJ2-1,CASSLGGASGMHEQFF,0,2,1,2
TRBV7-2,TRBJ2-2,CASSLGVRQDTGELFF,0,2,1,2
TRBV11-2,TRBJ1-2,CASSLEGDRANYGYTF,0,2,1,2
TRBV7-6,TRBJ2-2,CASSLEDPGRTGELFF,0,2,1,2
TRBV7-2,TRBJ2-1,CASSLIPPNLNNEQFV,0,2,1,2
TRBV7-2,TRBJ2-5,CASSLRLLAGEETQYL,0,2,1,2
TRBV5-8,TRBJ1-2,CASSSPWGLTNYGYTF,0,2,1,2
TRBV11-3,TRBJ2-1,CASSSRTSGSYDEQFF,0,2,1,2
TRBV5-6,TRBJ2-2,CASSSSWVLNTGELFF,0,2,1,2
TRBV7-9,TRBJ2-3,CASSSSPGLATDTQYF,0,2,1,2
TRBV7-9,TRBJ2-6,CASSSRPNSGANVLTF,0,2,1,2
TRBV7-2,TRBJ1-5,CASSSGLEGSNQPQHF,0,2,1,2
TRBV7-9,TRBJ2-7,CASSSGGGLAAYEQYF,0,2,1,2
TRBV5-6,TRBJ1-2,CASSWTRQAERYGYTF,0,2,1,2
TRBV7-9,TRBJ1-6,CASSYAQFSYNSPLHF,0,2,1,2
TRBV9,TRBJ1-6,CASSLRQGSVNSPLHF,0,2,1,2
TRBV5-4,TRBJ2-2,CASSLGGHDRTGELFF,0,2,1,2
TRBV5-4,TRBJ2-3,CASSLGLAGRTDTQYS,0,2,1,2
TRBV7-2,TRBJ2-5,CASSLGTSGSQETQYF,0,2,1,2
TRBV14,TRBJ2-3,CASSPFESSSTDTQYF,0,2,1,2
TRBV7-9,TRBJ2-1,CASSPSRGAWSNEQFF,0,2,1,2
TRBV3-1,TRBJ2-6,CASSPGWFSGANVLTF,0,2,1,2
TRBV6-2/3/5/6,TRBJ2-1,CASSPNLAGGPSEQFF,0,2,1,2
TRBV4-2,TRBJ1-3,CASSPLGFFTGNTIYF,0,2,1,2
TRBV4-2,TRBJ2-1,CASSPWTRWEEAEQFF,0,2,1,2
TRBV5-6,TRBJ2-7,CASSPRGHSEFYEQYF,0,2,1,2
TRBV11-2,TRBJ2-5,CASSPRDRFNQETQYF,0,2,1,2
TRBV6-2/3/5/6,TRBJ1-1,CASSPGQGLLNTEAFF,0,2,1,2
TRBV12-3/4,TRBJ2-7,CASSPRQGAFSYEQYF,0,2,1,2
TRBV7-3,TRBJ2-5,CASSPSRGGYTETQYF,0,2,1,2
TRBV3-1,TRBJ2-7,CASSPGTSGNLYEQYF,0,2,1,2
TRBV7-9,TRBJ2-3,CASSPGTGVSTDTQYF,0,2,1,2
TRBV5-6,TRBJ2-7,CASSPDPSGRKYEQYF,0,2,1,2
TRBV13,TRBJ2-7,CASSPLTNSPPYEQYF,0,2,1,2
TRBV7-9,TRBJ2-3,CASSPAVTSSTDTQYF,0,2,1,2
TRBV7-9,TRBJ2-3,CASSPTGSLLADTQYF,0,2,1,2
TRBV3-1,TRBJ2-5,CASSRTGDGIKETQYF,0,2,1,2
TRBV6-2/3/5/6,TRBJ2-6,CASSRKQGSGANVLTF,0,2,1,2
TRBV2,TRBJ1-5,CASSHWDRGFVQPQHF,0,2,1,2
TRBV7-9,TRBJ1-4,CASSHRGQGAREKLFF,0,2,1,2
TRBV4-2,TRBJ1-2,CASSHHNFRDTYGYTF,0,2,1,2
TRBV6-2/3/5/6,TRBJ1-6,CASSHGQSSYNSPLHF,0,2,1,2
TRBV6-2/3/5/6,TRBJ1-4,CASSQLPGGLNEKLVF,0,2,1,2
TRBV3-1,TRBJ1-4,CASSQPSDATNEKLFF,0,2,1,2
TRBV14,TRBJ2-3,CASSQVGPRSTDTQYF,0,2,1,2
TRBV14,TRBJ1-2,CASSQAGWGARDGYTF,0,2,1,2
TRBV4-2,TRBJ1-2,CASSQGQETLDYGYTF,0,2,1,2
TRBV14,TRBJ1-1,CASSQGGLGWTTEAFF,0,2,1,2
TRBV3-1,TRBJ1-2,CASSQGGGQTNYGYTF,0,2,1,2
TRBV3-1,TRBJ2-1,CASSQGSGGANNEQFF,0,2,1,2
TRBV3-1,TRBJ2-1,CASSQDLSSAYNEQFF,0,2,1,2
TRBV4-2,TRBJ2-1,CASSQDQTGTINEQFF,0,2,1,2
TRBV3-1,TRBJ2-5,CASSQDVLAGQETQYF,0,2,1,2
TRBV3-1,TRBJ2-7,CASSQDIPQASYEQYF,0,2,1,2
TRBV4-2,TRBJ1-2,CASSQEITGVVYGYTF,0,2,1,2
TRBV9,TRBJ2-3,CASSVRAGDGTDTQYF,0,2,1,2
TRBV9,TRBJ1-4,CASSVAGGDGEVKLFF,0,2,1,2
TRBV9,TRBJ2-4,CASSVGVEVAKNIQYF,0,2,1,2
TRBV13,TRBJ2-7,CASSVGAGGPSYEQYF,0,2,1,2
TRBV9,TRBJ1-2,CASSVEVVGRGYGYTF,0,2,1,2
TRBV9,TRBJ2-5,CASSVSTSGGQETQYF,0,2,1,2
TRBV7-9,TRBJ2-7,CASSASGTGDSYEQYF,0,2,1,2
TRBV6-2/3/5/6,TRBJ2-1,CASSALAGELDGEQFF,0,2,1,2
TRBV5-6,TRBJ1-5,CASSGTGDGDNQPQHF,0,2,1,2
TRBV7-2,TRBJ1-3,CASSGGGGGSGNTIYF,0,2,1,2
TRBV13,TRBJ2-1,CASSDGGTSGSREQFF,0,2,1,2
TRBV7-2,TRBJ2-5,CASSDRGSLWGETQYF,0,2,1,2
TRBV6-4,TRBJ1-1,CASSEVQTGKNTEAFF,0,2,1,2
TRBV27,TRBJ2-3,CASSISGTVPTDTQYF,0,2,1,2
TRBV7-9,TRBJ2-1,CASSTSGGTSYNEQFF,0,2,1,2
TRBV7-2,TRBJ2-6,CASSTMTSGGANVLTF,0,2,1,2
TRBV5-4,TRBJ2-1,CASSSLTSGRLNEQFF,0,2,1,2
TRBV5-4,TRBJ1-2,CASSKKQEWAMAGYTF,0,2,1,2
TRBV7-9,TRBJ1-6,CASRPPWTEINSPLHF,0,2,1,2
TRBV6-1,TRBJ2-1,CASRDTGGRPYNEQFF,0,2,1,2
TRBV6-2/3/5/6,TRBJ2-2,CASRRTGGVDTGELFF,0,2,1,2
TRBV12-3/4,TRBJ2-6,CASRFYRVEGANVLTF,0,2,1,2
TRBV7-9,TRBJ2-1,CASRLGRTSGYNEQFF,0,2,1,2
TRBV6-2/3/5/6,TRBJ2-7,CASRLEGLGSSYEQYF,0,2,1,2
TRBV6-4,TRBJ1-1,CASRAPRVRLSTEAFF,0,2,1,2
TRBV11-1,TRBJ2-1,CASNTGQASSYNEQFF,0,2,1,2
TRBV7-2,TRBJ2-1,CASKERGGFAYNEQFF,0,2,1,2
TRBV6-2/3/5/6,TRBJ2-3,CTSSTGTGFLTDTQYF,0,2,1,2
TRBV4-3,TRBJ2-1,CASTSGQGSSYNEQFF,0,2,1,2
TRBV12-3/4,TRBJ2-5,CASSLAVGSGQETQYF,0,2,1,2
TRBV2,TRBJ2-3,CASSVETGWETDTQYF,0,2,1,2
TRBV5-1,TRBJ2-7,CASSFGLAGGYYEQYF,0,2,1,2
TRBV5-1,TRBJ2-3,CASSFTRGTGTDTQYF,0,2,1,2
TRBV5-1,TRBJ1-6,CASSLSNRDGNSPLHF,0,2,1,2
TRBV5-1,TRBJ2-2,CASSLGLAANTGELFF,0,2,1,2
TRBV5-1,TRBJ2-1,CASSSTGTGVGNEQFF,0,2,1,2
TRBV5-1,TRBJ2-1,CASSWRQGSSYNEQFF,0,2,1,2
TRBV4-3,TRBJ2-3,CASSLRAGRTLDTQYF,0,2,1,2
TRBV4-1,TRBJ1-5,CASSLGHRAFNQPQHF,0,2,1,2
TRBV4-3,TRBJ2-1,CASSPGTSGPYNEQFF,0,2,1,2
TRBV5-1,TRBJ1-4,CASSPLSPATNEKLFF,0,2,1,2
TRBV5-1,TRBJ2-1,CASSPAGLARGNEQFF,0,2,1,2
TRBV4-3,TRBJ1-1,CASSPDPTGPDPEAFF,0,2,1,2
TRBV4-3,TRBJ2-3,CASSPLEGGWTDTQYF,0,2,1,2
TRBV4-3,TRBJ2-3,CASSRSDTSSTDTQYF,0,2,1,2
TRBV4-1,TRBJ1-3,CASSRPPTGPGNTIYF,0,2,1,2
TRBV4-1,TRBJ2-5,CASSRDSGLGRETQYF,0,2,1,2
TRBV4-1,TRBJ1-1,CASSHLGTGRNTEAFF,0,2,1,2
TRBV4-3,TRBJ1-2,CASSHDFETENYGYTF,0,2,1,2
TRBV4-1,TRBJ1-3,CASSHSFVPSGNTIYF,0,2,1,2
TRBV4-1,TRBJ2-6,CASSQVRSSGANVLTF,0,2,1,2
TRBV4-1,TRBJ2-6,CASSQVDRAGANVLTF,0,2,1,2
TRBV4-3,TRBJ2-7,CASSQDWNGWSGEQYF,0,2,1,2
TRBV4-3,TRBJ2-6,CASSQDPASGANVLTF,0,2,1,2
TRBV4-3,TRBJ2-2,CASSQDVSGNTGELFF,0,2,1,2
TRBV4-3,TRBJ2-7,CASSQDATGPFYEQYF,0,2,1,2
TRBV4-3,TRBJ2-7,CASSQDSGLASDEQYF,0,2,1,2
TRBV4-3,TRBJ2-1,CASSQEFQYHSNEQFF,0,2,1,2
TRBV4-1,TRBJ1-2,CASSQEGGGPNYGYTF,0,2,1,2
TRBV4-3,TRBJ2-3,CASSQESGRRLDTQYF,0,2,1,2
TRBV5-1,TRBJ1-1,CASSTAARRGVNEAFF,0,2,1,2
TRBV5-1,TRBJ2-5,CASSRTGTGGQETQYF,0,2,1,2
TRBV5-1,TRBJ2-1,CASRRGLAGSSDEQFF,0,2,1,2
TRBV20-1,TRBJ1-6,CSASPRDGSYNSPLHF,0,2,1,2
TRBV20-1,TRBJ2-7,CSARVSRPLPSYEQYF,0,2,1,2
TRBV20-1,TRBJ2-7,CSARGLTSGDDYEQYF,0,2,1,2
TRBV20-1,TRBJ1-6,CSARGDGHPQIPPLHF,0,2,1,2
TRBV20-1,TRBJ2-3,CSARDSSGGSGDTQYF,0,2,1,2
TRBV20-1,TRBJ2-7,CSARDRTGIPPYEQYF,0,2,1,2
TRBV20-1,TRBJ2-3,CSARDEARVNTDTQYF,0,2,1,2
TRBV20-1,TRBJ2-7,CSARDHLAGDYYEQYF,0,2,1,2
TRBV20-1,TRBJ1-6,CSARDQDRVKNSPLHF,0,2,1,2
TRBV20-1,TRBJ2-6,CSALGAWDSGANVLTF,0,2,1,2
TRBV29-1,TRBJ2-1,CSVELAGAQPRREQFI,0,2,1,2
TRBV29-1,TRBJ2-1,CSVEGLAGRSYNEQFF,0,2,1,2
TRBV29-1,TRBJ2-1,CSVEGGGRTSYNEQFF,0,2,1,2
TRBV29-1,TRBJ1-2,CSVEDLGTGGLHGYTF,0,2,1,2
TRBV29-1,TRBJ2-3,CSVEDFSGPSTDTQYF,0,2,1,2
TRBV29-1,TRBJ2-1,CSVETWGGGSYNEQFF,0,2,1,2
TRBV29-1,TRBJ2-1,CSVGTSGGGRMSEQFF,0,2,1,2
TRBV29-1,TRBJ2-1,CSVVGARTGRSDEQFF,0,2,1,2
TRBV29-1,TRBJ2-1,CSVGTWEPELLNEQFF,0,2,1,2
TRBV29-1,TRBJ2-1,CSAVPLQRSSYNEQFF,0,2,1,2
TRBV29-1,TRBJ1-3,CSAAGTGGANGNTIYF,0,2,1,2
TRBV12-3/4,TRBJ1-2,RASSLSGRGGAHGYTF,0,2,1,2
TRBV4-2,TRBJ2-1,RASSQDKAGGPNEQFF,0,2,1,2
TRBV4-2,TRBJ2-2,RASSQETSVNTGELFF,0,2,1,2
TRBV30,TRBJ2-1,CVLRRAGSPHNEQFF,0,2,1,2
TRBV6-2/3/5/6,TRBJ2-1,CVSSYVGLAADEQFF,0,2,1,2
TRBV7-6,TRBJ2-1,CASSGLIVEDNEQFF,0,4,1,4
TRBV30,TRBJ2-1,CAWHPSGRARNEQFF,0,2,1,2
TRBV30,TRBJ1-6,CAWSVLGQGALPLHF,0,2,1,2
TRBV15,TRBJ1-4,CAVPLGDATNEKLFF,0,2,1,2
TRBV30,TRBJ2-5,CAGHLSGRAGETQYF,0,2,1,2
TRBV10-3,TRBJ2-7,CAISDLAGSVYEQYF,0,2,1,2
TRBV10-3,TRBJ1-3,CAISESRRAGNTIYF,0,2,1,2
TRBV10-3,TRBJ1-1,CAISETDRRNTEAFF,0,2,1,2
TRBV19,TRBJ2-2,CATCGTTFNTGELFF,0,2,1,2
TRBV10-3,TRBJ1-5,CATQGGGDSNQPQHF,0,2,1,2
TRBV15,TRBJ1-5,CATSQNRVNNQPQHF,0,2,1,2
TRBV24-1,TRBJ2-1,CATSGGQASYNEQFF,0,2,1,2
TRBV24-1,TRBJ2-1,CATSDTGGSYNEQFF,0,2,1,2
TRBV15,TRBJ2-2,CATSSRLANTGELFF,0,2,1,2
TRBV15,TRBJ2-5,CATSRGTGTGETQYF,0,2,1,2
TRBV15,TRBJ2-2,CATSRPTGNTGELFF,0,2,1,2
TRBV15,TRBJ2-5,CATSRVGSDQETQYF,0,2,1,2
TRBV15,TRBJ1-1,CATSRVPPRDTEAFF,0,2,1,2
TRBV15,TRBJ2-1,CATSRVTGGYNEQFF,0,2,1,2
TRBV15,TRBJ1-1,CATSRGKGLNTGAFF,0,2,1,2
TRBV15,TRBJ1-2,CATSRDSRTDVGYTF,0,2,1,2
TRBV15,TRBJ2-1,CATSRDGGEVSEQFF,0,2,1,2
TRBV15,TRBJ2-7,CATSRDKTGDYEQYF,0,2,1,2
TRBV19,TRBJ1-5,CASLQSGTGNQPQHF,0,2,1,2
TRBV7-9,TRBJ2-5,CASAPRATAIETQYF,0,2,1,2
TRBV19,TRBJ1-5,CASTYSGHSNQPQHF,0,2,1,2
TRBV19,TRBJ2-7,CASTKGSASSYEQYF,0,2,1,2
TRBV19,TRBJ2-1,CASSSGSYPNDEQFF,0,2,1,2
TRBV19,TRBJ1-1,CASSHAGTVNTEAFF,0,2,1,2
TRBV19,TRBJ1-1,CASSDRDRVTQGAFF,0,2,1,2
TRBV19,TRBJ2-5,CASSIDGKGEETQYF,0,2,1,2
TRBV19,TRBJ2-1,CASSIETGGLVEQFF,0,2,1,2
TRBV19,TRBJ1-1,CASSIMGVEDTEAFF,0,2,1,2
TRBV19,TRBJ1-2,CASSIKGRDRGRYTF,0,2,1,2
TRBV19,TRBJ2-7,CASSTGTSGQYEQYF,0,2,1,2
TRBV19,TRBJ1-1,CASSSLRQGRAEAFF,0,2,1,2
TRBV19,TRBJ2-2,CASRRTDDFTGELFF,0,2,1,2
TRBV12-3/4,TRBJ1-6,CASSARQGYNSPLHF,0,2,1,2
TRBV6-2/3/5/6,TRBJ2-5,CASSWGAVRQETQYF,0,2,1,2
TRBV18,TRBJ2-3,CASSPATGGTDTQYF,0,2,1,2
TRBV18,TRBJ2-1,CASSPDRGSYNEQFF,0,2,1,2
TRBV18,TRBJ2-7,CASSPSGYGSYEQYF,0,2,1,2
TRBV11-2,TRBJ2-7,CASCLSPLRGQEQYF,0,2,1,2
TRBV19,TRBJ1-2,CASHKGRTGDYGYTF,0,2,1,2
TRBV7-9,TRBJ2-1,CASGLRASVYNEQFF,0,2,1,2
TRBV2,TRBJ2-3,CASGLAVTSTDTQYF,0,2,1,2
TRBV12-3/4,TRBJ1-3,CASISRGVLGNTIYF,0,2,1,2
TRBV7-8,TRBJ1-6,CASTYLQIYNSPLHF,0,2,1,2
TRBV6-2/3/5/6,TRBJ2-1,CASTLRLAGTNEQFF,0,2,1,2
TRBV9,TRBJ2-1,CASTTGTSSYNEQFF,0,2,1,2
TRBV12-3/4,TRBJ2-5,CASTKGMGSRETQYF,0,2,1,2
TRBV9,TRBJ2-3,CASTVGGGATDTQYF,0,2,1,2
TRBV12-3/4,TRBJ2-1,CASSFYGGGDNEQFF,0,2,1,2
TRBV12-3/4,TRBJ1-2,CASSFPGTPGQGYTF,0,2,1,2
TRBV12-3/4,TRBJ2-2,CASSFVPREFGELFF,0,2,1,2
TRBV12-3/4,TRBJ1-1,CASSFVDTGRPEAFF,0,2,1,2
TRBV6-2/3/5/6,TRBJ1-2,CASSFAGGEGYGYTF,0,2,1,2
TRBV6-2/3/5/6,TRBJ2-3,CASSFGTVSTDTQYF,0,2,1,2
TRBV12-3/4,TRBJ1-2,CASSFEGTGVNGYTF,0,2,1,2
TRBV12-3/4,TRBJ2-5,CASSFNLRGRQTQYF,0,2,1,2
TRBV12-3/4,TRBJ2-1,CASSFKGDSQVEQFF,0,2,1,2
TRBV6-2/3/5/6,TRBJ1-1,CASSFQGIMNTEAFF,0,2,1,2
TRBV6-2/3/5/6,TRBJ2-1,CASSLSLLAWNEQFF,0,2,1,2
TRBV12-3/4,TRBJ2-2,CASSLRRVNTGELFF,0,2,1,2
TRBV27,TRBJ2-6,CASSLEFSGANVLTF,0,2,1,2
TRBV6-2/3/5/6,TRBJ2-1,CASSLSGGQLHEQFF,0,2,1,2
TRBV27,TRBJ1-2,CASSLVAGGGYGYTF,0,2,1,2
TRBV12-3/4,TRBJ2-7,CASSLADFEGGEQYF,0,2,1,2
TRBV27,TRBJ2-1,CASSLAGAGYNEQFF,0,2,1,2
TRBV6-2/3/5/6,TRBJ2-5,CASSLGLAGAETQYF,0,2,1,2
TRBV12-3/4,TRBJ1-5,CASSLGAGDDQPQHF,0,2,1,2
TRBV12-3/4,TRBJ2-1,CASSLGGGPYNEQFF,0,2,1,2
TRBV13,TRBJ1-5,CASSLGGRTNQPQHF,0,2,1,2
TRBV6-2/3/5/6,TRBJ1-1,CASSLITGRAAEAFF,0,2,1,2
TRBV6-2/3/5/6,TRBJ2-3,CASSSGRGDTDTQYF,0,2,1,2
TRBV12-3/4,TRBJ2-1,CASSWVASGYNEQFF,0,2,1,2
TRBV6-2/3/5/6,TRBJ2-1,CASSYSWVGYNEQFF,0,2,1,2
TRBV12-3/4,TRBJ2-6,CASSYQGTGANVLTF,0,2,1,2
TRBV6-2/3/5/6,TRBJ2-3,CASSYAGEETDTQYF,0,2,1,2
TRBV6-2/3/5/6,TRBJ1-5,CASSYSNRELQPQHF,0,2,1,2
TRBV6-2/3/5/6,TRBJ1-1,CASSYSSGGVDEAFF,0,2,1,2
TRBV6-2/3/5/6,TRBJ1-5,CASSYSRGSNQPQHF,0,2,1,2
TRBV6-2/3/5/6,TRBJ1-1,CASSYPGQGNTEAFF,0,2,1,2
TRBV6-2/3/5/6,TRBJ2-7,CASSYRRQVGYEQYF,0,2,1,2
TRBV6-2/3/5/6,TRBJ2-7,CASSYRTGERNEQYF,0,2,1,2
TRBV28,TRBJ2-1,CASSYGRNSYNEQFF,0,2,1,2
TRBV6-2/3/5/6,TRBJ2-7,CASSYTNEPRDEQYF,0,2,1,2
TRBV6-2/3/5/6,TRBJ2-7,CASSYSAGTFYEQYF,0,2,1,2
TRBV6-2/3/5/6,TRBJ2-1,CASSYSGSGHNEQFF,0,2,1,2
TRBV5-4,TRBJ2-6,CASSLGGSGANVLTF,0,2,1,2
TRBV2,TRBJ1-2,CASSLTTRVTRGYTF,0,2,1,2
TRBV2,TRBJ2-1,CASSLASGSYNEQFF,0,2,1,2
TRBV12-3/4,TRBJ2-1,CASSPPTGSYNEQFF,0,2,1,2
TRBV28,TRBJ2-1,CASSPSRGRGNEQFF,0,2,1,2
TRBV7-9,TRBJ1-5,CASSPGTGSNQPQHF,0,2,1,2
TRBV6-2/3/5/6,TRBJ2-1,CASSRRDPPRNEQFF,0,2,1,2
TRBV12-3/4,TRBJ2-3,CASSRRTAGTDTQYF,0,2,1,2
TRBV27,TRBJ1-5,CASSHLGTWNQPQHF,0,2,1,2
TRBV6-1,TRBJ1-1,CASSQMTGVNTEAFF,0,2,1,2
TRBV6-1,TRBJ2-1,CASSAGTSVYNEQFF,0,2,1,2
TRBV28,TRBJ2-7,CASSGRGGDTVEQYF,0,2,1,2
TRBV6-1,TRBJ2-7,CASSGETPYSYEQYF,0,2,1,2
TRBV2,TRBJ2-7,CASSGTDRPPYEQYF,0,2,1,2
TRBV6-4,TRBJ1-6,CASSDSWRGGSPLHF,0,2,1,2
TRBV6-4,TRBJ2-1,CASSDSAGEYNEQFF,0,2,1,2
TRBV6-1,TRBJ2-5,CASSELLLRGETQYF,0,2,1,2
TRBV25-1,TRBJ1-1,CASSESGPRGTEAFF,0,2,1,2
TRBV6-1,TRBJ2-5,CASSEPGAGWETQYF,0,2,1,2
TRBV2,TRBJ2-1,CASSEDLSSYNEQFF,0,2,1,2
TRBV5-5,TRBJ1-6,CASSFSAQNNSPLHF,0,2,1,2
TRBV7-9,TRBJ2-2,CASSFLLGEGGELFF,0,2,1,2
TRBV3-1,TRBJ1-2,CASSFPGQGPFGYTF,0,2,1,2
TRBV6-2/3/5/6,TRBJ2-3,CASSFHSGSEDTQCF,0,2,1,2
TRBV5-4,TRBJ2-7,CASSFGRAGGYEQYF,0,2,1,2
TRBV5-5,TRBJ2-7,CASSFRQGGISEQYF,0,2,1,2
TRBV7-9,TRBJ2-1,CASSFGRGASDEQFF,0,2,1,2
TRBV7-9,TRBJ2-5,CASSFGQGYQETQYF,0,2,1,2
TRBV7-8,TRBJ2-5,CASSFGRGDQETQYF,0,2,1,2
TRBV7-2,TRBJ2-1,CASSFGLAGRGEQFF,0,2,1,2
TRBV7-9,TRBJ2-1,CASSFDRAYYNEQFF,0,2,1,2
TRBV5-6,TRBJ2-7,CASSFETWGPYEQYF,0,2,1,2
TRBV7-3,TRBJ2-2,CASSFRRDHTGELFF,0,2,1,2
TRBV7-2,TRBJ2-5,CASSLLDLYKETQYF,0,2,1,2
TRBV5-8,TRBJ2-5,CASSLSGVSRETQYF,0,2,1,2
TRBV7-7,TRBJ2-3,CASSLAGGPTDTQYF,0,2,1,2
TRBV7-9,TRBJ2-1,CASSLGQQGTHEQFF,0,2,1,2
TRBV5-4,TRBJ2-7,CASSLGGLGDDEQYF,0,2,1,2
TRBV7-9,TRBJ2-4,CASSLGDRGSSIQYF,0,2,1,2
TRBV7-2,TRBJ1-6,CASSLGRSSNSPLHF,0,2,1,2
TRBV5-4,TRBJ2-1,CASSLDRGGYNEQFF,0,2,1,2
TRBV11-1,TRBJ2-3,CASSLELAGADTQYF,0,2,1,2
TRBV5-6,TRBJ2-1,CASSLTEGAHNEQFF,0,2,1,2
TRBV5-6,TRBJ1-1,CASSLRVGVNTEAFF,0,2,1,2
TRBV7-9,TRBJ2-2,CASSLKNRHTGELFF,0,2,1,2
TRBV7-2,TRBJ2-1,CASSLSESSYNEQFF,0,2,1,2
TRBV7-2,TRBJ2-4,CASSLSGGPPNIQYF,0,2,1,2
TRBV7-2,TRBJ2-1,CASSLRLAGGNEQFF,0,2,1,2
TRBV7-2,TRBJ2-7,CASSLVWRNPDEQYF,0,2,1,2
TRBV7-8,TRBJ1-1,CASSLVRGGSPEAFF,0,2,1,2
TRBV7-9,TRBJ1-6,CASSLVGGWNSPLHF,0,2,1,2
TRBV11-2,TRBJ1-2,CASSLVGDRADGYTF,0,2,1,2
TRBV7-9,TRBJ1-2,CASSLVAGDKSGYTF,0,2,1,2
TRBV7-9,TRBJ2-7,CASSLVGSLTGEQYF,0,2,1,2
TRBV11-2,TRBJ1-1,CASSLVDIPNTEAFF,0,2,1,2
TRBV11-1,TRBJ2-3,CASSLAYAYTDTQYF,0,2,1,2
TRBV7-9,TRBJ1-2,CASSLAQTGGYGYTF,0,2,1,2
TRBV7-2,TRBJ2-7,CASSLATSDSYEQYF,0,2,1,2
TRBV7-2,TRBJ1-5,CASSLARTPYQPQHF,0,2,1,2
TRBV7-9,TRBJ2-3,CASSLAGTNSDTQYF,0,2,1,2
TRBV7-6,TRBJ2-3,CASSLATGRTDTQYF,0,2,1,2
TRBV13,TRBJ1-6,CASSLGSVARSPLHF,0,2,1,2
TRBV7-9,TRBJ1-1,CASSLGPIGGAEAFF,0,2,1,2
TRBV13,TRBJ2-7,CASSLGPGLQDEQYF,0,2,1,2
TRBV7-9,TRBJ2-7,CASSLGSFGASEQYF,0,2,1,2
TRBV7-9,TRBJ2-7,CASSLGLAGGREQYF,0,2,1,2
TRBV7-9,TRBJ2-1,CASSLGGRPYNEQFF,0,2,1,2
TRBV7-2,TRBJ2-7,CASSLDYGTAYEQYF,0,2,1,2
TRBV7-3,TRBJ2-2,CASSLEGISTGELFF,0,2,1,2
TRBV7-9,TRBJ2-2,CASSLEGISTGELFS,0,2,1,2
TRBV7-3,TRBJ2-1,CASSLEGSSYNEQFF,0,2,1,2
TRBV7-2,TRBJ2-7,CASSLICGPSYEQYF,0,2,1,2
TRBV7-3,TRBJ2-7,CASSLTAGREHEQYF,0,2,1,2
TRBV11-2,TRBJ2-1,CASSLREDSYNEQFF,0,2,1,2
TRBV7-9,TRBJ2-5,CASSLKLAGQETQYF,0,2,1,2
TRBV7-8,TRBJ1-5,CASSSPAGANQPQHF,0,2,1,2
TRBV7-9,TRBJ2-1,CASSSGENSYNEQFF,0,2,1,2
TRBV11-1,TRBJ2-7,CASSYPGQGYYEQYF,0,2,1,2
TRBV7-8,TRBJ1-1,CASSYQGDMNTEAFF,0,2,1,2
TRBV7-8,TRBJ2-7,CASSLNRDKTNEQYF,0,2,1,2
TRBV6-2/3/5/6,TRBJ1-5,CASSLGTGASQPQHF,0,2,1,2
TRBV11-1,TRBJ2-1,CASSLGLSSYNEQFF,0,2,1,2
TRBV5-6,TRBJ2-3,CASSLDFPHSDTQYF,0,2,1,2
TRBV7-9,TRBJ2-1,CASSLTSGYYNEQFF,0,2,1,2
TRBV6-2/3/5/6,TRBJ2-4,CASSLTGLAKNIQYF,0,2,1,2
TRBV7-9,TRBJ2-5,CASSLQSGGSETQYF,0,2,1,2
TRBV6-2/3/5/6,TRBJ1-1,CASSLARIMNTEAFF,0,2,1,2
TRBV14,TRBJ2-6,CASSPSWALSNVLTF,0,2,1,2
TRBV3-1,TRBJ2-1,CASSPSASGVDEQFF,0,2,1,2
TRBV12-3/4,TRBJ2-1,CASSPHSGTYNEQFF,0,2,1,2
TRBV5-5,TRBJ2-1,CASSPATGGYNEQFF,0,2,1,2
TRBV6-2/3/5/6,TRBJ2-7,CASSPTGGASYEQYF,0,2,1,2
TRBV7-9,TRBJ2-3,CASSPWDPPADTQYF,0,2,1,2
TRBV14,TRBJ1-5,CASSPWTGSNQPQHF,0,2,1,2
TRBV7-9,TRBJ1-6,CASSPLGSYNSPLHF,0,2,1,2
TRBV3-1,TRBJ2-3,CASSPRDRGGDTQYF,0,2,1,2
TRBV7-9,TRBJ2-1,CASSPAVGPYNEQFF,0,2,1,2
TRBV6-2/3/5/6,TRBJ2-7,CASSPGLAGPYEQYF,0,2,1,2
TRBV14,TRBJ2-5,CASSPGLAGVETQYF,0,2,1,2
TRBV7-3,TRBJ2-1,CASSPGLAGGLEQFF,0,2,1,2
TRBV11-3,TRBJ2-3,CASSPGRTETDTQYF,0,2,1,2
TRBV7-9,TRBJ1-3,CASSPTTPSGNTIYF,0,2,1,2
TRBV9,TRBJ2-1,CASSPSTGSYSEQFF,0,2,1,2
TRBV7-8,TRBJ1-5,CASSPRFAQAKNQHF,0,2,1,2
TRBV7-6,TRBJ2-1,CASSPLAGVQNEQFF,0,2,1,2
TRBV14,TRBJ2-7,CASSPRTGGEDEQYF,0,2,1,2
TRBV7-9,TRBJ2-6,CASSPGQSGANVLTF,0,2,1,2
TRBV13,TRBJ2-1,CASSPGGGRRDEQFF,0,2,1,2
TRBV5-6,TRBJ2-1,CASSPGLLNYNEQFF,0,2,1,2
TRBV3-1,TRBJ2-7,CASSPGQGVDYEQYF,0,2,1,2
TRBV11-3,TRBJ1-1,CASSPGGDSNTEAFF,0,2,1,2
TRBV5-6,TRBJ1-2,CASSPDRFFNYGYTF,0,2,1,2
TRBV3-1,TRBJ2-3,CASSPVGVNTDTQYF,0,2,1,2
TRBV7-9,TRBJ2-6,CASSPGSFGANVLTF,0,2,1,2
TRBV14,TRBJ1-2,CASSRYTGGNYGYTF,0,2,1,2
TRBV7-2,TRBJ2-7,CASSRRGQGAYEQYF,0,2,1,2
TRBV6-2/3/5/6,TRBJ2-2,CASSRGTSVAGELFF,0,2,1,2
TRBV5-8,TRBJ2-3,CASSRYGAHTDTQYF,0,2,1,2
TRBV11-2,TRBJ2-1,CASSRQGGPYNEQFF,0,2,1,2
TRBV7-9,TRBJ2-7,CASSRPGQGFYEQYF,0,2,1,2
TRBV3-1,TRBJ2-1,CASSHLAGIYNEQFF,0,2,1,2
TRBV6-2/3/5/6,TRBJ2-2,CASSHRTRSPGELFF,0,2,1,2
TRBV4-2,TRBJ2-1,CASSQSGGFYNEQFF,0,2,1,2
TRBV4-2,TRBJ2-1,CASSQGLASSNEQFF,0,2,1,2
TRBV4-2,TRBJ2-1,CASSQETSAGAQQFF,0,2,1,2
TRBV3-1,TRBJ1-3,CASSQTDGGLNTIYF,0,2,1,2
TRBV3-1,TRBJ2-1,CASSQREFPNNEQLF,0,2,1,2
TRBV5-6,TRBJ2-5,CASSQVGQGVGAQYF,0,2,1,2
TRBV7-3,TRBJ2-5,CASSQVRGGKETQYF,0,2,1,2
TRBV3-1,TRBJ2-7,CASSQARANSYEQYF,0,2,1,2
TRBV3-1,TRBJ2-5,CASSQAGRAWETQYF,0,2,1,2
TRBV3-1,TRBJ2-1,CASSQGAGPHNEQFF,0,2,1,2
TRBV3-1,TRBJ2-7,CASSQGRDSYYEQYF,0,2,1,2
TRBV6-2/3/5/6,TRBJ2-7,CASSQGWGDSYEQYF,0,2,1,2
TRBV4-2,TRBJ1-1,CASSQGLDGNTEAFF,0,2,1,2
TRBV3-1,TRBJ1-5,CASSQDLGGNQPQHF,0,2,1,2
TRBV14,TRBJ2-5,CASSQDWTVQETQYF,0,2,1,2
TRBV3-1,TRBJ1-5,CASSQDARVDQPQHF,0,2,1,2
TRBV3-1,TRBJ2-1,CASSQDMGEGDEQFF,0,2,1,2
TRBV4-2,TRBJ1-1,CASSQEGEENTQAFF,0,2,1,2
TRBV3-1,TRBJ1-4,CASSQKQVANEKLFF,0,2,1,2
TRBV5-4,TRBJ1-3,CASSVTGTGGNTIYF,0,2,1,2
TRBV7-2,TRBJ2-1,CASSVLSGLYNEQFF,0,2,1,2
TRBV7-2,TRBJ2-1,CASSVRLAGGNEQFF,0,2,1,2
TRBV9,TRBJ2-1,CASSVVAGAYNEQFF,0,2,1,2
TRBV9,TRBJ1-4,CASSVGGRNNEKLFF,0,2,1,2
TRBV9,TRBJ1-2,CASSVDPGTNYGYTF,0,2,1,2
TRBV9,TRBJ1-5,CASSVEGGGNQPQHF,0,2,1,2
TRBV11-2,TRBJ1-1,CASSVTQGAFTEAFF,0,2,1,2
TRBV7-6,TRBJ2-1,CASSALAGEWNEQFF,0,2,1,2
TRBV6-2/3/5/6,TRBJ2-7,CASSAGLADSYEQYF,0,2,1,2
TRBV7-2,TRBJ2-5,CASSAGQPWQETQYF,0,2,1,2
TRBV7-2,TRBJ1-2,CASSAGQGANYGYTF,0,2,1,2
TRBV12-3/4,TRBJ1-1,CASSADPQGNTEAFF,0,2,1,2
TRBV11-1,TRBJ2-7,CASSAEGSSGYEQYF,0,2,1,2
TRBV7-9,TRBJ2-7,CASSGSSGGPPEQYF,0,2,1,2
TRBV7-2,TRBJ2-1,CASSGQRGGVNGQFF,0,2,1,2
TRBV7-2,TRBJ2-4,CASSGTSGRENIQYF,0,2,1,2
TRBV12-3/4,TRBJ2-3,CASSDRANRADTQYF,0,2,1,2
TRBV7-6,TRBJ1-4,CASSMNRRLSEKLFF,0,2,1,2
TRBV6-2/3/5/6,TRBJ2-1,CASSIAGGRYNEQFF,0,2,1,2
TRBV12-3/4,TRBJ2-7,CASSRPGTGYDEQYF,0,2,1,2
TRBV9,TRBJ2-7,CASSRRTGTEYEQYF,0,2,1,2
TRBV7-2,TRBJ2-5,CASSNQKTGEETQYF,0,2,1,2
TRBV12-3/4,TRBJ2-5,CASSNDRDPQETQYF,0,2,1,2
TRBV7-3,TRBJ2-1,CASRVSGSSYNEQFF,0,2,1,2
TRBV7-2,TRBJ2-7,CASRAGQNIGYEQYF,0,2,1,2
TRBV2,TRBJ2-3,CASRDLAGGTDTQYF,0,2,1,2
TRBV6-4,TRBJ2-5,CASRTTGVNLETQYF,0,2,1,2
TRBV7-3,TRBJ2-1,CASRLSGSSYNEQFF,0,2,1,2
TRBV7-2,TRBJ1-1,CASRSSPGQGIEAFF,0,2,1,2
TRBV2,TRBJ2-3,CASRLGLALRDTQYF,0,2,1,2
TRBV5-6,TRBJ2-2,CASRPGTGGTGELFF,0,2,1,2
TRBV7-9,TRBJ1-3,CASRPDTSSGNTIYF,0,2,1,2
TRBV7-9,TRBJ1-3,CASRAQGYSGNTIYF,0,2,1,2
TRBV2,TRBJ1-6,CASRGSGHNNSPLHF,0,2,1,2
TRBV12-3/4,TRBJ2-1,CASRTGTSGANEQFF,0,2,1,2
TRBV7-2,TRBJ2-2,CASNYNQGGTGELFF,0,2,1,2
TRBV6-2/3/5/6,TRBJ1-5,CASNPGGGGNQPQHF,0,2,1,2
TRBV2,TRBJ1-5,CASKGTTGSNQPQHF,0,2,1,2
TRBV6-2/3/5/6,TRBJ2-7,CASKITVDGSYEQYF,0,2,1,2
TRBV7-3,TRBJ2-1,CTSRQSGSIYNEQFF,0,2,1,2
TRBV4-3,TRBJ2-1,CASSRGTSGPNEQFF,0,2,1,2
TRBV5-1,TRBJ2-1,CASEAVAGSYNEQFF,0,2,1,2
TRBV5-1,TRBJ1-1,CASTGGTSRNTEAFF,0,2,1,2
TRBV4-1,TRBJ2-1,CASTPGTGDYNEQFF,0,2,1,2
TRBV5-1,TRBJ2-1,CASSPGESSYNEQFF,0,2,1,2
TRBV12-3/4,TRBJ2-2,CASSPTGGFAGELFF,0,2,1,2
TRBV10-2,TRBJ1-2,CASSEFRTDVYGYTF,0,2,1,2
TRBV5-1,TRBJ2-7,CASSFSGLLPYEQYF,0,2,1,2
TRBV5-1,TRBJ2-1,CASSFTGTGPVLQFF,0,2,1,2
TRBV5-1,TRBJ2-3,CASSLWSGSTDTQYL,0,2,1,2
TRBV5-1,TRBJ2-5,CASSLASGKQETQYF,0,2,1,2
TRBV5-1,TRBJ1-5,CASSLGTVGNQPQHF,0,2,1,2
TRBV5-1,TRBJ2-3,CASSLDTGRADTQYF,0,2,1,2
TRBV5-1,TRBJ1-1,CASSLDRERNTEAFF,0,2,1,2
TRBV5-1,TRBJ1-1,CASSLEGTLNTEAFF,0,2,1,2
TRBV5-1,TRBJ2-5,CASSLIAGAQETQYF,0,2,1,2
TRBV5-1,TRBJ1-2,CASSLSAGANYGYTF,0,2,1,2
TRBV5-1,TRBJ2-3,CASSLQGAGTDTQYF,0,2,1,2
TRBV5-1,TRBJ1-2,CASSWATGYDYGYTF,0,2,1,2
TRBV5-1,TRBJ2-1,CASSWTSGSGREQFF,0,2,1,2
TRBV5-1,TRBJ1-5,CASSWTTGDHQPQHF,0,2,1,2
TRBV5-1,TRBJ2-3,CASSWTGVFTDTQYF,0,2,1,2
TRBV4-1,TRBJ1-1,CASSYPGQGSAEAFF,0,2,1,2
TRBV4-1,TRBJ1-1,CASSPRTFLDTEAFF,0,2,1,2
TRBV5-1,TRBJ2-1,CASSPQEGSYNEQFF,0,2,1,2
TRBV4-1,TRBJ1-5,CASSPGQHSNQPQHF,0,2,1,2
TRBV5-1,TRBJ2-1,CASSPGGVGYNEQFF,0,2,1,2
TRBV4-3,TRBJ2-1,CASSPMGLADNEQFF,0,2,1,2
TRBV5-1,TRBJ2-5,CASSRYPTEQETQYF,0,2,1,2
TRBV4-3,TRBJ2-7,CASSHIGTSGNEQYF,0,2,1,2
TRBV4-1,TRBJ2-7,CASSHDLQDSNEQHF,0,2,1,2
TRBV4-1,TRBJ2-7,CASSHNSGGPYEQYF,0,2,1,2
TRBV4-3,TRBJ1-1,CASSQYNGGNTEAFF,0,2,1,2
TRBV4-3,TRBJ2-1,CASSQVGTSGNEQFF,0,2,1,2
TRBV4-1,TRBJ2-1,CASSQVQHSANEQFF,0,2,1,2
TRBV4-1,TRBJ2-1,CASSQAQTSGSEQFF,0,2,1,2
TRBV4-3,TRBJ2-1,CASSQGTASYNEQFF,0,2,1,2
TRBV4-1,TRBJ1-2,CASSQGRIQDYGYTF,0,2,1,2
TRBV4-1,TRBJ1-5,CASSQGPGGNQPQHF,0,2,1,2
TRBV4-3,TRBJ1-2,CASSQGVGRPYGYTF,0,2,1,2
TRBV4-3,TRBJ2-5,CASSQDLAPPQTQYF,0,2,1,2
TRBV4-1,TRBJ2-5,CASSQDVGVSETQYF,0,2,1,2
TRBV4-3,TRBJ1-2,CASSQDGTGDYGYTF,0,2,1,2
TRBV4-3,TRBJ1-2,CASSQDRTGAFGYTF,0,2,1,2
TRBV4-3,TRBJ1-1,CASSQDKQMNTEAFF,0,2,1,2
TRBV4-3,TRBJ2-3,CASSQDRLSTDTQYF,0,2,1,2
TRBV4-1,TRBJ2-2,CASSQESGGTGELFF,0,2,1,2
TRBV5-1,TRBJ2-1,CASSVVAGLDNEQFF,0,2,1,2
TRBV4-1,TRBJ2-3,CASSTRRGVPDTQYF,0,2,1,2
TRBV4-1,TRBJ1-3,CASRVEGSSGNTIYF,0,2,1,2
TRBV5-1,TRBJ2-3,CASRAGPTMTDTQYF,0,2,1,2
TRBV4-1,TRBJ2-5,CASRELAGGRETQYF,0,2,1,2
TRBV5-1,TRBJ2-5,CASRPGQSTGETQYF,0,2,1,2
TRBV4-1,TRBJ2-6,CASRQYNSGANVLTF,0,2,1,2
TRBV20-1,TRBJ2-1,CSVVWWGGAYNEQFF,0,2,1,2
TRBV20-1,TRBJ2-3,CSAFREAFLTDTQYF,0,2,1,2
TRBV20-1,TRBJ2-1,CSAAPLAGVYNEQFF,0,2,1,2
TRBV20-1,TRBJ2-1,CSAGVAGVAYNEQFL,0,2,1,2
TRBV20-1,TRBJ1-5,CSAEGGAVGNQPQHF,0,2,1,2
TRBV20-1,TRBJ2-1,CSATPGESAYSEQFF,0,2,1,2
TRBV20-1,TRBJ1-5,CSATPGQGSNQPQHF,0,2,1,2
TRBV20-1,TRBJ1-1,CSASAPGHQNTEAFF,0,2,1,2
TRBV20-1,TRBJ2-2,CSARVVGDDTGELFF,0,2,1,2
TRBV20-1,TRBJ1-4,CSARASDRFNEKLVF,0,2,1,2
TRBV20-1,TRBJ2-5,CSARGKLAGGRTQYF,0,2,1,2
TRBV20-1,TRBJ2-3,CSARLAGRRKDTQYF,0,2,1,2
TRBV20-1,TRBJ2-1,CSARDLLAVYNEQFF,0,2,1,2
TRBV20-1,TRBJ2-5,CSARDLASGQETQYF,0,2,1,2
TRBV20-1,TRBJ1-5,CSARDRMWGNQPQHF,0,2,1,2
TRBV20-1,TRBJ2-7,CSARDGREDSYEQYF,0,2,1,2
TRBV20-1,TRBJ2-3,CSAREGGTSTDTQYF,0,2,1,2
TRBV20-1,TRBJ1-2,CSAKNRDRAINGYTF,0,2,1,2
TRBV20-1,TRBJ2-7,CSALQRAFLNYEQYF,0,2,1,2
TRBV20-1,TRBJ2-3,CSAQGLAGSTDTQYF,0,2,1,2
TRBV20-1,TRBJ2-1,CSAGLAGGLYNEQFF,0,2,1,2
TRBV20-1,TRBJ2-1,CSAIPPLGRGDEQFF,0,2,1,2
TRBV20-1,TRBJ2-3,CSATHGQGARDTQYF,0,2,1,2
TRBV20-1,TRBJ2-1,CSAIPGTSGGNEQFF,0,2,1,2
TRBV20-1,TRBJ2-7,CSAKDPRTGPYEQYF,0,2,1,2
TRBV29-1,TRBJ2-5,CSLRRRGITGETQYF,0,2,1,2
TRBV29-1,TRBJ2-7,CSVAPRENSPYEQYF,0,2,1,2
TRBV29-1,TRBJ2-3,CSVGISGGGPDTQYF,0,2,1,2
TRBV29-1,TRBJ2-7,CSVEVPSGTTYEQYF,0,2,1,2
TRBV29-1,TRBJ2-7,CSVEVASGSSYEQYF,0,2,1,2
TRBV29-1,TRBJ1-4,CSVEAGGAFNEKLFF,0,2,1,2
TRBV29-1,TRBJ2-7,CSVEGSLASPYEQYF,0,2,1,2
TRBV29-1,TRBJ2-3,CSVEGGAGGTDTQYF,0,2,1,2
TRBV29-1,TRBJ2-2,CSVEDLDRVTGELFF,0,2,1,2
TRBV29-1,TRBJ2-1,CSVGGGYTMGDEQFF,0,2,1,2
TRBV29-1,TRBJ1-5,CSVLDRGASNQPQHF,0,2,1,2
TRBV29-1,TRBJ2-1,CSVRTSGRARDEQFF,0,2,1,2
TRBV29-1,TRBJ1-2,CSAGTGLGTNYGYTF,0,2,1,2
TRBV29-1,TRBJ2-7,CSGSGGAGLFDEQYF,0,2,1,2
TRBV7-2,TRBJ1-2,WASSPSTRGAGRYTF,0,2,1,2
TRBV4-3,TRBJ1-2,YASSQDLGGSYGYTF,0,2,1,2
TRBV20-1,TRBJ2-5,YSAFPSAGPRETQYF,0,2,1,2
TRBV9,TRBJ2-3,RASSVGLIRTDTQYF,0,2,1,2
TRBV11-1,TRBJ2-1,RASSIGAEDYNEQFF,0,2,1,2
TRBV12-5,TRBJ2-5,CASAPGLEKRTQYF,0,2,1,2
TRBV12-5,TRBJ2-3,CASGFPGPRDTQYF,0,2,1,2
TRBV30,TRBJ1-4,CAWAATVQLEKLFF,0,2,1,2
TRBV30,TRBJ2-2,CAWSYRGRGGELFF,0,2,1,2
TRBV30,TRBJ2-1,CAWSRLAGNNEQFF,0,2,1,2
TRBV30,TRBJ1-1,CAWSVLGGNTEAFF,0,2,1,2
TRBV30,TRBJ2-7,CAWSVQGGVYEQYF,0,2,1,2
TRBV30,TRBJ2-1,CAWSVVSSEVTQFF,0,2,1,2
TRBV30,TRBJ2-2,CAWSGIRYTGELFF,0,2,1,2
TRBV10-3,TRBJ1-2,CAISVGTPNYGYTF,0,2,1,2
TRBV10-3,TRBJ1-1,CAISASNKATEAFF,0,2,1,2
TRBV10-3,TRBJ2-7,CAISDRDRSYEQYF,0,2,1,2
TRBV10-3,TRBJ1-2,CAISEELTDYGYTF,0,2,1,2
TRBV10-3,TRBJ1-2,CAISETGARYGYTF,0,2,1,2
TRBV10-3,TRBJ1-1,CAISFRDHGTEAFF,0,2,1,2
TRBV10-3,TRBJ2-1,CAIRGLESYNEQFF,0,2,1,2
TRBV10-3,TRBJ2-5,CAIRPDRGGETQYF,0,2,1,2
TRBV10-3,TRBJ2-3,CAIRGTALGDTQYF,0,2,1,2
TRBV15,TRBJ2-1,CATLPSGSSGEQFF,0,2,1,2
TRBV10-3,TRBJ2-1,CATRDRGGVDEQFF,0,2,1,2
TRBV10-3,TRBJ2-5,CATAHRGLGETQYF,0,2,1,2
TRBV24-1,TRBJ2-1,CATSEAGGTDEQFF,0,2,1,2
TRBV15,TRBJ2-7,CATSRLAGAYEQYF,0,2,1,2
TRBV24-1,TRBJ2-3,CATSNAGQADTQYF,0,2,1,2
TRBV24-1,TRBJ2-5,CATSSRDPRETQYF,0,2,1,2
TRBV15,TRBJ1-1,CATSRDRGRDEAFF,0,2,1,2
TRBV12-3/4,TRBJ1-1,CATRHTRLNTEAFF,0,2,1,2
TRBV15,TRBJ2-1,CATKPGLEYNEQFF,0,2,1,2
TRBV2,TRBJ2-7,CATKERAISYEQYF,0,2,1,2
TRBV2,TRBJ2-7,CASQPRALTYEQYF,0,2,1,2
TRBV19,TRBJ1-1,CASSPFGPNTEAFF,0,2,1,2
TRBV19,TRBJ1-4,CASSPRTAFEELFF,0,2,1,2
TRBV19,TRBJ2-4,CASSVGVEVNIQYF,0,2,1,2
TRBV19,TRBJ2-1,CASSIRGQGGEQFF,0,2,1,2
TRBV19,TRBJ1-5,CASSTSDGFRPQHF,0,2,1,2
TRBV19,TRBJ2-5,CASSTWDSQETQYF,0,2,1,2
TRBV19,TRBJ1-5,CASSPGQGIQPQHF,0,2,1,2
TRBV19,TRBJ1-2,CASSPSWTNYGYTF,0,2,1,2
TRBV19,TRBJ2-7,CASSGYRGSYEQYF,0,2,1,2
TRBV19,TRBJ1-1,CASSTLPGGTEAFF,0,2,1,2
TRBV19,TRBJ2-1,CASRPIFRANVQFF,0,2,1,2
TRBV19,TRBJ2-4,CASKDIGDKNIQYF,0,2,1,2
TRBV13,TRBJ2-7,CASSPLGSLHEQYF,0,2,1,2
TRBV18,TRBJ2-3,CASSPVKNTDTQYF,0,2,1,2
TRBV18,TRBJ2-7,CASSPKTGPYEQYF,0,2,1,2
TRBV18,TRBJ1-1,CASSPGAAGAEAFF,0,2,1,2
TRBV18,TRBJ2-4,CASSPPHQGNIQYF,0,2,1,2
TRBV2,TRBJ2-2,CASWTTRNTGELFF,0,2,1,2
TRBV7-2,TRBJ2-3,CASLPGLASDTQYF,0,2,1,2
TRBV6-2/3/5/6,TRBJ1-5,CASVRDIVNQPQHF,0,2,1,2
TRBV27,TRBJ2-4,CASAPGQGGNIQYF,0,2,1,2
TRBV6-1,TRBJ2-3,CASGEGQGGDTQYF,0,2,1,2
TRBV5-4,TRBJ2-3,CASGRTGGTDTQYF,0,2,1,2
TRBV2,TRBJ1-5,CASGDGVSNQPQHF,0,2,1,2
TRBV12-3/4,TRBJ1-1,CASGPVGENTEAFF,0,2,1,2
TRBV12-3/4,TRBJ2-1,CASIPGGLNNEQFF,0,2,1,2
TRBV6-2/3/5/6,TRBJ2-2,CASIRAANTGELFF,0,2,1,2
TRBV6-2/3/5/6,TRBJ1-2,CASIRTGGNYGYTF,0,2,1,2
TRBV2,TRBJ1-1,CASIGRGLSTEAFF,0,2,1,2
TRBV6-2/3/5/6,TRBJ2-2,CASTRDGNTGELFF,0,2,1,2
TRBV12-3/4,TRBJ1-2,CASTISERGYGYTF,0,2,1,2
TRBV6-2/3/5/6,TRBJ2-1,CASTPRGVQNEQFF,0,2,1,2
TRBV12-3/4,TRBJ2-7,CASTRLAGYYEQYF,0,2,1,2
TRBV28,TRBJ1-5,CASTAPRGFGPQHF,0,2,1,2
TRBV28,TRBJ2-5,CASTGTARGETQYF,0,2,1,2
TRBV6-2/3/5/6,TRBJ2-7,CASSFSHKTYEQYF,0,2,1,2
TRBV12-3/4,TRBJ1-1,CASSFVSGGTEAFF,0,2,1,2
TRBV6-2/3/5/6,TRBJ2-3,CASSFGQYTDTQYF,0,2,1,2
TRBV6-2/3/5/6,TRBJ2-7,CASSFDAPAHEQYF,0,2,1,2
TRBV6-2/3/5/6,TRBJ2-1,CASSFFAGGNEQFF,0,2,1,2
TRBV6-2/3/5/6,TRBJ1-6,CASSFGGENSPLHF,0,2,1,2
TRBV6-2/3/5/6,TRBJ2-7,CASSLSPGPYEQYF,0,2,1,2
TRBV6-2/3/5/6,TRBJ2-5,CASSLRRIQETQYF,0,2,1,2
TRBV6-2/3/5/6,TRBJ2-4,CASSLQIAKNIQYF,0,2,1,2
TRBV12-3/4,TRBJ1-4,CASSLVTTNEKLFF,0,2,1,2
TRBV6-2/3/5/6,TRBJ2-1,CASSLVGLDNEQFF,0,2,1,2
TRBV12-3/4,TRBJ1-1,CASSLGQGDTEAFF,0,2,1,2
TRBV6-2/3/5/6,TRBJ2-1,CASSLGSGSNEQFF,0,2,1,2
TRBV6-2/3/5/6,TRBJ1-1,CASSLDSPNTEAFF,0,2,1,2
TRBV6-2/3/5/6,TRBJ2-7,CASSLTPRMNEQYF,0,2,1,2
TRBV12-3/4,TRBJ2-4,CASSLSRTGNIQYF,0,2,1,2
TRBV6-2/3/5/6,TRBJ1-6,CASSLRLYNSPLHF,0,2,1,2
TRBV12-3/4,TRBJ2-7,CASSLNGGAYEQYF,0,2,1,2
TRBV12-3/4,TRBJ2-7,CASSSGTGAYEQYF,0,2,1,2
TRBV6-2/3/5/6,TRBJ1-2,CASSSSAEGYGYTF,0,2,1,2
TRBV12-3/4,TRBJ2-1,CASSSYRGYNEQFF,0,2,1,2
TRBV6-2/3/5/6,TRBJ2-7,CASSSSSFGYEQYF,0,2,1,2
TRBV27,TRBJ2-5,CASSSTGLQETQYF,0,2,1,2
TRBV12-3/4,TRBJ2-1,CASSSQTGNNEQLF,0,2,1,2
TRBV6-2/3/5/6,TRBJ2-3,CASSWTGDTDTQYF,0,2,1,2
TRBV12-3/4,TRBJ1-1,CASSYRTGGAEAFF,0,2,1,2
TRBV6-2/3/5/6,TRBJ1-6,CASSYSFGDSPLHF,0,2,1,2
TRBV6-2/3/5/6,TRBJ1-4,CASSYSGPHEKLFF,0,2,1,2
TRBV6-2/3/5/6,TRBJ2-1,CASSYSGAGNEQFF,0,2,1,2
TRBV6-2/3/5/6,TRBJ2-7,CASSYSGGRDEQYF,0,2,1,2
TRBV6-2/3/5/6,TRBJ1-6,CASSYRQGNSPLHF,0,2,1,2
TRBV6-2/3/5/6,TRBJ2-7,CASSYRDSAYEQYF,0,2,1,2
TRBV6-2/3/5/6,TRBJ1-1,CASSYAGGSPEAFF,0,2,1,2
TRBV6-2/3/5/6,TRBJ2-5,CASSYGLLQETQYF,0,2,1,2
TRBV6-2/3/5/6,TRBJ1-5,CASSYKADNQPQHF,0,2,1,2
TRBV7-2,TRBJ2-2,CASSLRGNTGELFF,0,2,1,2
TRBV12-3/4,TRBJ2-7,CASSPTGTGYEQYF,0,2,1,2
TRBV27,TRBJ1-5,CASSPSQGNQPQHF,0,2,1,2
TRBV7-9,TRBJ2-5,CASSPGTTEKTQYF,0,2,1,2
TRBV6-2/3/5/6,TRBJ2-1,CASSPGTTYNEQFF,0,2,1,2
TRBV6-2/3/5/6,TRBJ1-6,CASSPSRNNSPLHF,0,2,1,2
TRBV12-3/4,TRBJ2-1,CASSPGFEYNEQFF,0,2,1,2
TRBV12-3/4,TRBJ1-5,CASSPMGGNQPQHF,0,2,1,2
TRBV6-2/3/5/6,TRBJ2-7,CASSRRSYSYEQYF,0,2,1,2
TRBV12-3/4,TRBJ2-3,CASSRPTSAGTQYF,0,2,1,2
TRBV12-3/4,TRBJ1-5,CASSRGQGRQPQHF,0,2,1,2
TRBV6-2/3/5/6,TRBJ2-2,CASSRTRNTGELVF,0,2,1,2
TRBV6-2/3/5/6,TRBJ1-5,CASSHDRTYQPQHF,0,2,1,2
TRBV6-2/3/5/6,TRBJ1-2,CASSHTGLGYGYTF,0,2,1,2
TRBV6-2/3/5/6,TRBJ1-1,CASSHHSGNTEAFF,0,2,1,2
TRBV12-3/4,TRBJ1-5,CASSAHREAQPQHF,0,2,1,2
TRBV6-1,TRBJ2-7,CASSAGAHSYEQYF,0,2,1,2
TRBV6-1,TRBJ1-2,CASSAMTANYGYAF,0,2,1,2
TRBV6-1,TRBJ2-3,CASSGGTETDTQYF,0,2,1,2
TRBV25-1,TRBJ1-2,CASSDGRGQNGYTF,0,2,1,2
TRBV2,TRBJ1-5,CASSDKTANQPQHF,0,2,1,2
TRBV10-3,TRBJ1-1,CASSEWTGSTEAFF,0,2,1,2
TRBV6-1,TRBJ2-3,CASSERGGTDTQYF,0,2,1,2
TRBV6-1,TRBJ1-3,CASSEWISGNAIYF,0,2,1,2
TRBV25-1,TRBJ1-2,CASSEIGQPVGYTF,0,2,1,2
TRBV6-1,TRBJ1-5,CASSESRVNQPQHF,0,2,1,2
TRBV6-2/3/5/6,TRBJ1-1,CASSTDRGLSEAFF,0,2,1,2
TRBV6-2/3/5/6,TRBJ1-1,CASSNRGADTEAFF,0,2,1,2
TRBV11-2,TRBJ1-2,CASSFLGGYYGYTF,0,2,1,2
TRBV11-2,TRBJ1-5,CASSFHGSNQPQHF,0,2,1,2
TRBV7-9,TRBJ2-5,CASSFQSSFATQYF,0,2,1,2
TRBV4-2,TRBJ2-7,CASSFVGSGYEQYF,0,2,1,2
TRBV7-2,TRBJ2-7,CASSFGGSSYEQYF,0,2,1,2
TRBV7-2,TRBJ2-7,CASSFGDYPYEQYF,0,2,1,2
TRBV5-5,TRBJ2-7,CASSFGTGLDEQYF,0,2,1,2
TRBV7-9,TRBJ1-1,CASSFGREATEAFF,0,2,1,2
TRBV7-2,TRBJ1-3,CASSLSNSGNTIYF,0,2,1,2
TRBV5-4,TRBJ2-7,CASSLVGVTYEQYF,0,2,1,2
TRBV5-6,TRBJ2-7,CASSLVGGPYEQYF,0,2,1,2
TRBV5-6,TRBJ1-1,CASSLGWGNTEAFF,0,2,1,2
TRBV5-5,TRBJ2-1,CASSLGLDYNEQFF,0,2,1,2
TRBV5-6,TRBJ2-7,CASSLEGNPYEQYF,0,2,1,2
TRBV7-9,TRBJ2-1,CASSLSTPGMGLFF,0,2,1,2
TRBV5-4,TRBJ2-7,CASSLSRGPYEQYF,0,2,1,2
TRBV12-3/4,TRBJ1-1,CASSLRQGNTEAFF,0,2,1,2
TRBV7-9,TRBJ2-7,CASSLVAGDYEQYF,0,2,1,2
TRBV7-9,TRBJ2-2,CASSLVVGPGELFF,0,2,1,2
TRBV7-9,TRBJ1-1,CASSLATVGTEAFF,0,2,1,2
TRBV7-9,TRBJ1-2,CASSLGQVPYGYTF,0,2,1,2
TRBV11-2,TRBJ1-5,CASSLGFGDQPQHF,0,2,1,2
TRBV7-2,TRBJ2-1,CASSLGYGLDNMTF,0,2,1,2
TRBV7-2,TRBJ2-5,CASSLGPGSETQYF,0,2,1,2
TRBV7-9,TRBJ1-1,CASSLGVVNTEAFF,0,2,1,2
TRBV7-9,TRBJ1-6,CASSLGGLNSPLHF,0,2,1,2
TRBV7-6,TRBJ1-1,CASSLDFRGSEAFF,0,2,1,2
TRBV11-3,TRBJ1-1,CASSLDRMNSEAFF,0,2,1,2
TRBV5-4,TRBJ2-7,CASSLINRRYEQYF,0,2,1,2
TRBV7-9,TRBJ2-1,CASSLSLSYNEQFF,0,2,1,2
TRBV12-3/4,TRBJ2-5,CASSLSGSWETQYF,0,2,1,2
TRBV7-6,TRBJ2-1,CASSLNGLADEQFF,0,2,1,2
TRBV7-2,TRBJ2-7,CASSLKRFNYEQYF,0,2,1,2
TRBV7-2,TRBJ2-3,CASSSRGDTDTQYF,0,2,1,2
TRBV7-2,TRBJ2-5,CASSSTLGARTQYF,0,2,1,2
TRBV2,TRBJ2-7,CASSSGGSFYEQYF,0,2,1,2
TRBV5-4,TRBJ1-1,CASSSGGWDTEAFF,0,2,1,2
TRBV5-4,TRBJ1-1,CASSSTGGEVEAFF,0,2,1,2
TRBV7-9,TRBJ1-1,CASSSSQMLRQAFF,0,2,1,2
TRBV7-2,TRBJ2-3,CASSSRGSSDTQYF,0,2,1,2
TRBV6-2/3/5/6,TRBJ1-2,CASSWGQEAYGYTF,0,2,1,2
TRBV7-2,TRBJ2-7,CASSWDRGGYEQYF,0,2,1,2
TRBV5-5,TRBJ1-4,CASSWESGHEKLFF,0,2,1,2
TRBV11-1,TRBJ1-1,CASSYGQNRAEAFF,0,2,1,2
TRBV14,TRBJ1-6,CASSLDEQTGPLHF,0,2,1,2
TRBV6-2/3/5/6,TRBJ1-6,CASSLRQGNSPLHF,0,2,1,2
TRBV7-2,TRBJ2-3,CASSLGGSTDTQYF,0,2,1,2
TRBV6-2/3/5/6,TRBJ2-2,CASSLAGDTGELFF,0,2,1,2
TRBV5-5,TRBJ1-1,CASSLGIMNTEAFF,0,2,1,2
TRBV3-1,TRBJ1-2,CASSLDSQGYGYTF,0,2,1,2
TRBV13,TRBJ2-4,CASSPRTGGNIQYF,0,2,1,2
TRBV9,TRBJ2-7,CASSPANRGREQYF,0,2,1,2
TRBV9,TRBJ2-7,CASSPRLALYEQYF,0,2,1,2
TRBV13,TRBJ2-1,CASSPRLKANEQFF,0,2,1,2
TRBV7-2,TRBJ2-7,CASSPQVQIYEQYF,0,2,1,2
TRBV7-9,TRBJ2-2,CASSPGTYTGELFF,0,2,1,2
TRBV7-6,TRBJ1-2,CASSPIDGVYGYTF,0,2,1,2
TRBV7-9,TRBJ1-1,CASSPRVVNTEAFF,0,2,1,2
TRBV7-9,TRBJ2-7,CASSPRGTGDEQYF,0,2,1,2
TRBV7-2,TRBJ1-2,CASSPKGEGYGYTF,0,2,1,2
TRBV9,TRBJ2-7,CASSPRDVTYEQYF,0,2,1,2
TRBV4-2,TRBJ2-5,CASSPGGGEETQYF,0,2,1,2
TRBV7-9,TRBJ2-3,CASSPGMATDTQYF,0,2,1,2
TRBV5-6,TRBJ2-5,CASSPGLELETQYF,0,2,1,2
TRBV7-2,TRBJ2-1,CASSPTTGSDEQFF,0,2,1,2
TRBV5-6,TRBJ2-2,CASSPTANTGELFF,0,2,1,2
TRBV7-3,TRBJ1-2,CASSPTGDGYGYTF,0,2,1,2
TRBV7-9,TRBJ1-1,CASSPTRENTEAFF,0,2,1,2
TRBV9,TRBJ2-2,CASSPRTNTGELFF,0,2,1,2
TRBV9,TRBJ2-7,CASSPRLAVYEQYF,0,2,1,2
TRBV4-2,TRBJ1-3,CASSPGWNGNTIYF,0,2,1,2
TRBV12-3/4,TRBJ2-1,CASSPGSSYNEQFF,0,2,1,2
TRBV7-2,TRBJ2-5,CASSRGRKEETQYF,0,2,1,2
TRBV7-9,TRBJ2-1,CASSRTSGNNEQFF,0,2,1,2
TRBV5-6,TRBJ1-1,CASSHPRGNTEAFF,0,2,1,2
TRBV14,TRBJ2-2,CASSQLTGSGELFF,0,2,1,2
TRBV14,TRBJ1-1,CASSQGYGHTEAFF,0,2,1,2
TRBV4-2,TRBJ1-1,CASSQVGGPTEAFF,0,2,1,2
TRBV4-2,TRBJ2-7,CASSQAAVAYEQYF,0,2,1,2
TRBV14,TRBJ2-1,CASSQGYGFNEQFF,0,2,1,2
TRBV3-1,TRBJ1-2,CASSQDLRNYGYTF,0,2,1,2
TRBV27,TRBJ1-5,CASSQEPWIQPQHF,0,2,1,2
TRBV14,TRBJ2-7,CASSQNGQGGEQYF,0,2,1,2
TRBV7-9,TRBJ1-1,CASSVTGSNTEAFF,0,2,1,2
TRBV9,TRBJ1-5,CASSVDSGNQPQHF,0,2,1,2
TRBV9,TRBJ1-6,CASSVEQRNSPLHF,0,2,1,2
TRBV9,TRBJ2-2,CASSVRAGTGELFF,0,2,1,2
TRBV5-6,TRBJ2-3,CASSAPGAADTQYF,0,2,1,2
TRBV9,TRBJ2-5,CASSAGDRQETQYF,0,2,1,2
TRBV5-6,TRBJ2-5,CASSGLAGEETQYF,0,2,1,2
TRBV7-2,TRBJ2-7,CASSGQGATYEQYF,0,2,1,2
TRBV7-9,TRBJ1-5,CASSGGHSNQPQHF,0,2,1,2
TRBV5-4,TRBJ1-1,CASSGGTYNTEAFF,0,2,1,2
TRBV5-5,TRBJ2-7,CASSERLSSYEQYF,0,2,1,2
TRBV7-2,TRBJ2-5,CASSTHPGGETQYF,0,2,1,2
TRBV7-9,TRBJ1-5,CASSTVNSNQPQHF,0,2,1,2
TRBV12-3/4,TRBJ1-2,CASRLSTLNYGYTF,0,2,1,2
TRBV6-2/3/5/6,TRBJ1-5,CASRSTGPNQPQHF,0,2,1,2
TRBV2,TRBJ1-1,CASRWDRENTEAFF,0,2,1,2
TRBV12-3/4,TRBJ2-7,CASRPVASGEQQYF,0,2,1,2
TRBV6-2/3/5/6,TRBJ1-5,CASRRPGENQPQHF,0,2,1,2
TRBV2,TRBJ2-5,CASRVRGLGETQYF,0,2,1,2
TRBV12-3/4,TRBJ1-2,CASRAPGTKRGYTF,0,2,1,2
TRBV6-2/3/5/6,TRBJ2-5,CASRGAGQGETQYF,0,2,1,2
TRBV12-3/4,TRBJ2-2,CASRGTGHTGELFF,0,2,1,2
TRBV5-4,TRBJ2-7,CASREAGVHYEQYF,0,2,1,2
TRBV27,TRBJ2-3,CASRTGYGTDTQYF,0,2,1,2
TRBV6-4,TRBJ2-5,CASRSTTTRETQYF,0,2,1,2
TRBV7-9,TRBJ2-2,CASRLRGNTGELFF,0,2,1,2
TRBV7-9,TRBJ2-1,CASRPGPLGGEQFF,0,2,1,2
TRBV27,TRBJ1-6,CASRPSSYNSPLHF,0,2,1,2
TRBV7-2,TRBJ2-7,CASRPDPNTYEQYF,0,2,1,2
TRBV3-1,TRBJ2-2,CASRGTGDTGELFF,0,2,1,2
TRBV2,TRBJ2-5,CASRGQGRGETQYF,0,2,1,2
TRBV6-2/3/5/6,TRBJ2-3,CASNPPGTADTQYF,0,2,1,2
TRBV6-2/3/5/6,TRBJ1-4,CASNPGPPNEKLFF,0,2,1,2
TRBV3-1,TRBJ2-5,CASNPTYSQETQYF,0,2,1,2
TRBV7-9,TRBJ1-2,CASNPFGGNYGYTF,0,2,1,2
TRBV6-2/3/5/6,TRBJ1-3,CASNQAGSGNTIYF,0,2,1,2
TRBV5-4,TRBJ2-2,CASNTRTGTGELFF,0,2,1,2
TRBV6-2/3/5/6,TRBJ2-7,CASKAGTGSDEQYF,0,2,1,2
TRBV12-5,TRBJ1-5,CARGSRDIDQPQHF,0,2,1,2
TRBV10-3,TRBJ2-4,CAKNQGNKKNIQYF,0,2,1,2
TRBV12-3/4,TRBJ1-5,CTSSLADFYQPQHF,0,2,1,2
TRBV29-1,TRBJ1-1,CCAPRTGRNTEAFF,0,2,1,2
TRBV29-1,TRBJ2-3,CCASTPTGSDTQYF,0,2,1,2
TRBV5-1,TRBJ2-7,CASATWDRGSEQYF,0,2,1,2
TRBV5-1,TRBJ1-3,CASQRDSSGNTIYF,0,2,1,2
TRBV5-1,TRBJ2-1,CASGLGQDLDEQFF,0,2,1,2
TRBV4-3,TRBJ2-3,CASSPSDSTDTQYF,0,2,1,2
TRBV4-1,TRBJ1-6,CASSQQGGYSPLHF,0,2,1,2
TRBV5-1,TRBJ2-1,CASSLVWTSTEQFF,0,2,1,2
TRBV5-1,TRBJ2-7,CASSLGLQIGEQYF,0,2,1,2
TRBV5-1,TRBJ1-6,CASSLGTGNSPLHF,0,2,1,2
TRBV5-1,TRBJ2-5,CASSLGQGQETQYF,0,2,1,2
TRBV5-1,TRBJ2-7,CASSLGGQGLEQYF,0,2,1,2
TRBV5-1,TRBJ2-7,CASSLERGYYEQYF,0,2,1,2
TRBV7-9,TRBJ1-1,CASSLVLGNTEAFF,0,2,1,2
TRBV7-2,TRBJ1-2,CASSLRTGGYGYTF,0,2,1,2
TRBV5-1,TRBJ2-4,CASSSGIAKNIQYF,0,2,1,2
TRBV4-1,TRBJ1-1,CASSSPTGGTEAFF,0,2,1,2
TRBV5-1,TRBJ2-5,CASSYDLGPETQYF,0,2,1,2
TRBV5-1,TRBJ2-5,CASSYLDSRETQYF,0,2,1,2
TRBV5-1,TRBJ1-1,CASSLLDRNTEAFF,0,2,1,2
TRBV4-1,TRBJ1-5,CASSPWTEGQPQHF,0,2,1,2
TRBV4-3,TRBJ2-1,CASSPTRTYNEQFF,0,2,1,2
TRBV5-1,TRBJ1-2,CASSPGTPDYGYTF,0,2,1,2
TRBV5-1,TRBJ1-1,CASSRRTADTEAFF,0,2,1,2
TRBV4-1,TRBJ2-1,CASSHPGLGVEQFF,0,2,1,2
TRBV4-3,TRBJ2-2,CASSQVSGDGELFF,0,2,1,2
TRBV4-3,TRBJ1-5,CASSQGQMDQPQHF,0,2,1,2
TRBV4-3,TRBJ2-7,CASSQDYSSYEQYF,0,2,1,2
TRBV4-1,TRBJ2-5,CASSQDPTSETQYL,0,2,1,2
TRBV4-3,TRBJ2-2,CASSQDRVTGELFF,0,2,1,2
TRBV4-3,TRBJ2-7,CASSQEWSSYEQYF,0,2,1,2
TRBV5-1,TRBJ2-1,CASSDGRGGGQKFF,0,2,1,2
TRBV5-1,TRBJ2-3,CASSTFPGTDTQYF,0,2,1,2
TRBV5-1,TRBJ2-7,CASSREGAFYEQYF,0,2,1,2
TRBV5-1,TRBJ2-1,CASKTGDSYNEQFF,0,2,1,2
TRBV20-1,TRBJ1-4,CSPARLQPNEKLFF,0,2,1,2
TRBV20-1,TRBJ2-3,CSVRDSGEKDTQYF,0,2,1,2
TRBV20-1,TRBJ2-5,CSASDTRAWETQYF,0,2,1,2
TRBV20-1,TRBJ2-3,CSAPGLIPGDTQYF,0,2,1,2
TRBV20-1,TRBJ2-3,CSAMTSRGTDTQYF,0,2,1,2
TRBV20-1,TRBJ2-5,CSASYAGTRETQYF,0,2,1,2
TRBV20-1,TRBJ2-7,CSARSDRISYEQYF,0,2,1,2
TRBV20-1,TRBJ2-1,CSARGVSSYNEQFF,0,2,1,2
TRBV20-1,TRBJ1-6,CSARLGETSSPLHF,0,2,1,2
TRBV20-1,TRBJ1-1,CSARVLGPRTEAFF,0,2,1,2
TRBV20-1,TRBJ1-5,CSALGQESNQPQHF,0,2,1,2
TRBV20-1,TRBJ1-1,CSAPRTGRNTEAFF,0,2,1,2
TRBV20-1,TRBJ2-5,CSARPGGQQETQYF,0,2,1,2
TRBV20-1,TRBJ2-1,CSAQSGGDYNEQFF,0,2,1,2
TRBV20-1,TRBJ1-6,CSASRGRGSAPLHF,0,2,1,2
TRBV20-1,TRBJ1-3,CSAPGQGSGNTIYF,0,2,1,2
TRBV20-1,TRBJ1-5,CSAASGQGHQPQHF,0,2,1,2
TRBV20-1,TRBJ2-3,CSAPGAVGTDTQYF,0,2,1,2
TRBV20-1,TRBJ2-3,CSARTSGTTDTQYF,0,2,1,2
TRBV29-1,TRBJ2-7,CSVLGLAGAYEQYF,0,2,1,2
TRBV29-1,TRBJ2-7,CSVVDASGVYEQYF,0,2,1,2
TRBV29-1,TRBJ2-5,CSVAGGPGGETQYF,0,2,1,2
TRBV29-1,TRBJ2-5,CSVGSGGAVETQYF,0,2,1,2
TRBV29-1,TRBJ2-3,CSVGRDRGPDTQYF,0,2,1,2
TRBV29-1,TRBJ1-1,CSVGAGGLNTEAFF,0,2,1,2
TRBV29-1,TRBJ1-1,CSVGRGQLNTEAFF,0,2,1,2
TRBV29-1,TRBJ2-2,CSVEAGQGTGELFF,0,2,1,2
TRBV29-1,TRBJ2-5,CSVEDREDQETQYF,0,2,1,2
TRBV29-1,TRBJ1-5,CSVRVRQDNQPQHF,0,2,1,2
TRBV29-1,TRBJ2-7,CSVYTGLNSYEQYF,0,2,1,2
TRBV29-1,TRBJ2-7,CSVIDRGKSYEQYF,0,2,1,2
TRBV29-1,TRBJ2-1,CSVLGGGTHNEQFF,0,2,1,2
TRBV29-1,TRBJ1-1,CSAEVQRGDTEAFF,0,2,1,2
TRBV29-1,TRBJ1-1,CSAWDRGMNTEAFF,0,2,1,2
TRBV29-1,TRBJ1-1,CSGGMTGANTEAFF,0,2,1,2
TRBV29-1,TRBJ2-3,CSDDGRFSTDTQYF,0,2,1,2
TRBV3-1,TRBJ1-5,WASSPGQRNQPQHF,0,2,1,2
TRBV20-1,TRBJ2-3,YSATRLAGADTQYF,0,2,1,2
TRBV24-1,TRBJ2-1,CASSSGGLNEQFF,0,2,1,2
TRBV30,TRBJ2-5,CASLGTGQETQYF,0,2,1,2
TRBV30,TRBJ1-2,CAWTVDGSYGYTF,0,2,1,2
TRBV30,TRBJ1-5,CAWSHRDNQPQHF,0,2,1,2
TRBV30,TRBJ2-7,CAWSVRGSGEQYF,0,2,1,2
TRBV30,TRBJ1-1,CAWSVSRNTEAFF,0,2,1,2
TRBV30,TRBJ1-3,CAWSGDSGNTIYF,0,2,1,2
TRBV30,TRBJ1-5,CAWSGGFNQPQHF,0,2,1,2
TRBV30,TRBJ2-1,CAWSGLADNEQFF,0,2,1,2
TRBV30,TRBJ1-1,CAWSTWGNTEAFF,0,2,1,2
TRBV11-2,TRBJ2-5,CAGSFNSQETQYF,0,2,1,2
TRBV2,TRBJ1-3,CAIGTAAGNTIYF,0,2,1,2
TRBV10-3,TRBJ1-2,CAISERVDYGYTF,0,2,1,2
TRBV10-3,TRBJ2-7,CAISEKREYEQYF,0,2,1,2
TRBV7-9,TRBJ2-7,CATTSGSTYEQYF,0,2,1,2
TRBV19,TRBJ2-1,CASSLRGGNEQFF,0,2,1,2
TRBV19,TRBJ1-5,CASSIGPHQPQHF,0,2,1,2
TRBV19,TRBJ1-1,CASSIGLSTEAFF,0,2,1,2
TRBV19,TRBJ2-1,CASSIDKGDEQFF,0,2,1,2
TRBV18,TRBJ1-3,CASSSGGGNTIYF,0,2,1,2
TRBV12-3/4,TRBJ1-2,CASSRSGDGGYTF,0,2,1,2
TRBV18,TRBJ1-2,CASSPAGIHGYTF,0,2,1,2
TRBV7-6,TRBJ2-1,CASCDSSYNEQFF,0,2,1,2
TRBV6-4,TRBJ2-1,CASVTGFDNEQFF,0,2,1,2
TRBV4-2,TRBJ2-7,CASGSGSGYEQYF,0,2,1,2
TRBV6-2/3/5/6,TRBJ2-7,CASDISGGYEQYF,0,2,1,2
TRBV2,TRBJ2-3,CASEPTYTDTQYF,0,2,1,2
TRBV7-9,TRBJ2-7,CASEAGASYEQYF,0,2,1,2
TRBV7-9,TRBJ2-5,CASILADLETQYF,0,2,1,2
TRBV6-2/3/5/6,TRBJ2-7,CASTSGQHHEQYF,0,2,1,2
TRBV11-2,TRBJ2-7,CASTALAGVEQYF,0,2,1,2
TRBV7-9,TRBJ2-5,CASTKIGAETQYF,0,2,1,2
TRBV6-2/3/5/6,TRBJ2-2,CASTGPYTGELFF,0,2,1,2
TRBV6-2/3/5/6,TRBJ1-1,CASSFRMNTEAFF,0,2,1,2
TRBV12-3/4,TRBJ1-2,CASSFRQSYGYTF,0,2,1,2
TRBV6-2/3/5/6,TRBJ1-1,CASSFGAGTEAFF,0,2,1,2
TRBV12-3/4,TRBJ1-2,CASSLVGSYGYTF,0,2,1,2
TRBV6-2/3/5/6,TRBJ1-1,CASSLTLSTEAFF,0,2,1,2
TRBV6-2/3/5/6,TRBJ1-2,CASSLQHSDGYTF,0,2,1,2
TRBV6-2/3/5/6,TRBJ1-1,CASSSGRDTEAFF,0,2,1,2
TRBV6-2/3/5/6,TRBJ2-5,CASSYNRGETQYF,0,2,1,2
TRBV6-2/3/5/6,TRBJ1-1,CASSYSKIWVAFF,0,2,1,2
TRBV12-3/4,TRBJ2-5,CASSPGGPGAQYF,0,2,1,2
TRBV12-3/4,TRBJ2-5,CASSPGTEETQYF,0,2,1,2
TRBV12-3/4,TRBJ2-3,CASSPLQKGTQYF,0,2,1,2
TRBV6-2/3/5/6,TRBJ2-7,CASSPGLSYEQYF,0,2,1,2
TRBV12-3/4,TRBJ2-7,CASSRTSFYEQYF,0,2,1,2
TRBV2,TRBJ1-1,CASSVRGNTEAFF,0,2,1,2
TRBV2,TRBJ1-1,CASSDEGNTEAFF,0,2,1,2
TRBV6-1,TRBJ1-1,CASSEHQDTEAFF,0,2,1,2
TRBV12-3/4,TRBJ1-1,CASSTRTVLGAFF,0,2,1,2
TRBV7-6,TRBJ2-1,CASSRTNSNEQFF,0,2,1,2
TRBV5-6,TRBJ1-1,CASSLVSNTEAFF,0,2,1,2
TRBV5-6,TRBJ2-1,CASSLVGSNEQFF,0,2,1,2
TRBV5-4,TRBJ2-1,CASSLAFRNEQFF,0,2,1,2
TRBV5-6,TRBJ2-1,CASSLGGYGEQFF,0,2,1,2
TRBV5-6,TRBJ1-4,CASSLGSGEKLFS,0,2,1,2
TRBV5-4,TRBJ1-1,CASSLSPNTEACF,0,2,1,2
TRBV7-2,TRBJ2-7,CASSLRGSYEQYF,0,2,1,2
TRBV7-6,TRBJ2-2,CASSLSATGELFF,0,2,1,2
TRBV7-9,TRBJ2-5,CASSLPQTETQYF,0,2,1,2
TRBV13,TRBJ2-7,CASSLAGGGEQYF,0,2,1,2
TRBV7-9,TRBJ2-7,CASSLASVYEQYF,0,2,1,2
TRBV7-2,TRBJ2-4,CASSLATLNIQYF,0,2,1,2
TRBV7-2,TRBJ1-2,CASSLAGNYGYTF,0,2,1,2
TRBV7-9,TRBJ1-1,CASSLARQAEAFF,0,2,1,2
TRBV13,TRBJ2-1,CASSLGRGSEQFF,0,2,1,2
TRBV7-9,TRBJ2-1,CASSLGRGNEQFF,0,2,1,2
TRBV5-6,TRBJ1-1,CASSLGRYTEAFF,0,2,1,2
TRBV11-2,TRBJ1-5,CASSLDPGGARHF,0,2,1,2
TRBV7-2,TRBJ1-2,CASSLEGGHSYTF,0,2,1,2
TRBV7-2,TRBJ2-7,CASSLETGYEQYF,0,2,1,2
TRBV7-3,TRBJ2-5,CASSLTSLETQYF,0,2,1,2
TRBV7-9,TRBJ1-2,CASSLNTLEGYTF,0,2,1,2
TRBV7-2,TRBJ2-1,CASSLKRYNEQFF,0,2,1,2
TRBV7-9,TRBJ1-1,CASSSGQTSEAFF,0,2,1,2
TRBV7-3,TRBJ1-1,CASSSAPWQEAFF,0,2,1,2
TRBV7-9,TRBJ2-1,CASSSDSYNEQFF,0,2,1,2
TRBV7-9,TRBJ2-7,CASSSTTPYEQYF,0,2,1,2
TRBV7-2,TRBJ2-7,CASSSGTSYEQYF,0,2,1,2
TRBV7-7,TRBJ2-5,CASSSMNPGTQYF,0,2,1,2
TRBV5-5,TRBJ2-5,CASSSQGGETQYF,0,2,1,2
TRBV5-5,TRBJ1-4,CASSWAGDEKLFF,0,2,1,2
TRBV4-2,TRBJ2-7,CASSLGTTYEQYF,0,2,1,2
TRBV13,TRBJ2-7,CASSLSRRYEQYF,0,2,1,2
TRBV6-2/3/5/6,TRBJ2-2,CASSLARTGELFL,0,2,1,2
TRBV3-1,TRBJ2-1,CASSLDLGVAEFF,0,2,1,2
TRBV7-2,TRBJ1-5,CASSLDMQTPQHF,0,2,1,2
TRBV7-9,TRBJ1-2,CASSLTYWNGYTF,0,2,1,2
TRBV4-2,TRBJ1-1,CASSPDQNTEAFF,0,2,1,2
TRBV9,TRBJ1-1,CASSPGGGTEAFF,0,2,1,2
TRBV13,TRBJ2-5,CASSPGGEETQYF,0,2,1,2
TRBV7-9,TRBJ2-7,CASSPNGGGEQYF,0,2,1,2
TRBV7-2,TRBJ2-7,CASSPREGFEQYF,0,2,1,2
TRBV9,TRBJ2-7,CASSPGPSGEQYF,0,2,1,2
TRBV7-9,TRBJ1-1,CASSPPGWTEAFF,0,2,1,2
TRBV14,TRBJ1-1,CASSPTRNTEAFF,0,2,1,2
TRBV9,TRBJ2-7,CASSPRSSYEQYF,0,2,1,2
TRBV7-9,TRBJ1-2,CASSRPGQRGYTF,0,2,1,2
TRBV16,TRBJ2-7,CASSRGTEVGQYF,0,2,1,2
TRBV6-2/3/5/6,TRBJ2-5,CASSRKNTETQYF,0,2,1,2
TRBV7-9,TRBJ2-3,CASSRTRTDTQYF,0,2,1,2
TRBV4-2,TRBJ2-1,CASSRDGYNEQFF,0,2,1,2
TRBV13,TRBJ1-4,CASSHDRGEKLFF,0,2,1,2
TRBV14,TRBJ1-4,CASSQGVGEKLFF,0,2,1,2
TRBV4-2,TRBJ2-3,CASSQGRSDTQYF,0,2,1,2
TRBV4-2,TRBJ2-7,CASSQGGPYEQYF,0,2,1,2
TRBV9,TRBJ2-7,CASSVSKGHEQYF,0,2,1,2
TRBV9,TRBJ2-5,CASSVGLAETQYF,0,2,1,2
TRBV9,TRBJ1-1,CASSVEGQVEAFF,0,2,1,2
TRBV11-3,TRBJ2-1,CASSAQGYNEQFF,0,2,1,2
TRBV11-3,TRBJ2-2,CASSAGPTGELFF,0,2,1,2
TRBV7-9,TRBJ2-1,CASSAGLALTQFF,0,2,1,2
TRBV5-6,TRBJ2-7,CASSGALRVEQYF,0,2,1,2
TRBV7-3,TRBJ1-1,CASSIGQGTEAFF,0,2,1,2
TRBV7-3,TRBJ1-1,CASSIDRGSEAFF,0,2,1,2
TRBV12-3/4,TRBJ2-2,CASSTLLGGELFF,0,2,1,2
TRBV7-9,TRBJ1-1,CASSRGKGTEAFF,0,2,1,2
TRBV6-2/3/5/6,TRBJ2-5,CASSRTEEETQYF,0,2,1,2
TRBV7-9,TRBJ2-7,CASSKDRDYEQYF,0,2,1,2
TRBV27,TRBJ2-7,CASRLAGDHEQYF,0,2,1,2
TRBV5-4,TRBJ2-2,CASRVQNTGELFF,0,2,1,2
TRBV6-2/3/5/6,TRBJ2-7,CASRGTMSHEQYF,0,2,1,2
TRBV7-2,TRBJ2-5,CASRDRAGETQYF,0,2,1,2
TRBV7-2,TRBJ2-5,CASRDRAGETQNF,0,2,1,2
TRBV2,TRBJ1-5,CASREGLNQPQHF,0,2,1,2
TRBV6-2/3/5/6,TRBJ1-1,CASRIFGDTEAFL,0,2,1,2
TRBV6-4,TRBJ2-2,CASRTSETGELFF,0,2,1,2
TRBV7-3,TRBJ2-7,CASRSNSAYEQYF,0,2,1,2
TRBV6-2/3/5/6,TRBJ1-6,CASRYRENSPLHF,0,2,1,2
TRBV7-9,TRBJ2-3,CASRPTVTDTQYF,0,2,1,2
TRBV6-2/3/5/6,TRBJ2-7,CASRRTISYEQYF,0,2,1,2
TRBV12-3/4,TRBJ2-7,CASRQGANYEQYF,0,2,1,2
TRBV12-3/4,TRBJ1-1,CASRGGAYTEAFF,0,2,1,2
TRBV11-1,TRBJ1-2,CASRDRGLYGYTF,0,2,1,2
TRBV12-3/4,TRBJ2-3,CASNGLAGETQYF,0,2,1,2
TRBV6-2/3/5/6,TRBJ2-5,CASKAQLQETQYF,0,2,1,2
TRBV12-3/4,TRBJ2-1,CASKQTSGGGPFF,0,2,1,2
TRBV2,TRBJ2-1,CAREKDREDEQFF,0,2,1,2
TRBV7-6,TRBJ1-4,CTSSLFGSEKLFF,0,2,1,2
TRBV5-1,TRBJ2-1,CASSSRQGNEQFF,0,2,1,2
TRBV5-1,TRBJ2-7,CASQGGGNLEQYF,0,2,1,2
TRBV4-3,TRBJ2-1,CASGRGWRYEQFF,0,2,1,2
TRBV5-1,TRBJ2-2,CASGTANTGELFF,0,2,1,2
TRBV5-1,TRBJ2-7,CASSFGIAYEQYF,0,2,1,2
TRBV5-1,TRBJ2-2,CASSFRGTGELFF,0,2,1,2
TRBV5-1,TRBJ1-2,CASSLRQGQGYTF,0,2,1,2
TRBV5-1,TRBJ2-7,CASSLGQTYEQYF,0,2,1,2
TRBV5-1,TRBJ1-1,CASSLGGGTEAFF,0,2,1,2
TRBV5-1,TRBJ1-2,CASSLDHSRGYTF,0,2,1,2
TRBV5-1,TRBJ2-2,CASSLEVAGELFF,0,2,1,2
TRBV5-1,TRBJ2-7,CASSLTGFDELYF,0,2,1,2
TRBV5-1,TRBJ2-1,CASSSHRDNEQFF,0,2,1,2
TRBV5-1,TRBJ2-1,CASSLDLFNEQFF,0,2,1,2
TRBV4-3,TRBJ2-7,CASSPGHQYEQYF,0,2,1,2
TRBV12-3/4,TRBJ1-5,CASSPQGAQPQHF,0,2,1,2
TRBV5-1,TRBJ1-2,CASSPDRPRSYTF,0,2,1,2
TRBV4-3,TRBJ2-7,CASSRQGSYEQYF,0,2,1,2
TRBV4-1,TRBJ2-1,CASSRGTDNEQFF,0,2,1,2
TRBV4-3,TRBJ2-7,CASSQYQGDEQYF,0,2,1,2
TRBV4-3,TRBJ2-7,CASSQVLQGEQYF,0,2,1,2
TRBV4-3,TRBJ1-1,CASSQDLGGEAFF,0,2,1,2
TRBV4-3,TRBJ2-5,CASSQDREETQYF,0,2,1,2
TRBV4-1,TRBJ2-7,CASSQILSYEQYF,0,2,1,2
TRBV5-1,TRBJ1-5,CASSRGDDQPQHF,0,2,1,2
TRBV5-1,TRBJ2-7,CASRRDDSYEQYF,0,2,1,2
TRBV20-1,TRBJ1-5,CSVSRGSRQPQHF,0,2,1,2
TRBV20-1,TRBJ2-3,CSAPRGAEDTQYF,0,2,1,2
TRBV20-1,TRBJ2-7,CSARTGVSYEQYF,0,2,1,2
TRBV20-1,TRBJ2-3,CSARGLTSDTQYF,0,2,1,2
TRBV20-1,TRBJ2-5,CSAGGTTQETQYF,0,2,1,2
TRBV20-1,TRBJ1-4,CSAEGQSNEKLFF,0,2,1,2
TRBV20-1,TRBJ2-5,CSASSALTETQYF,0,2,1,2
TRBV20-1,TRBJ2-7,CSASSGLEFGQYF,0,2,1,2
TRBV20-1,TRBJ1-5,CSASYRGGQPQHF,0,2,1,2
TRBV20-1,TRBJ1-1,CSASFSQGSEAFF,0,2,1,2
TRBV20-1,TRBJ2-7,CSASRTSGREQYF,0,2,1,2
TRBV20-1,TRBJ2-5,CSARLQPQETQYF,0,2,1,2
TRBV20-1,TRBJ1-5,CSARAYSNQPQHF,0,2,1,2
TRBV20-1,TRBJ2-7,CSARAGPGYEQYF,0,2,1,2
TRBV20-1,TRBJ2-5,CSARGASGGAAYF,0,2,1,2
TRBV20-1,TRBJ2-7,CSARGEQDYEQYF,0,2,1,2
TRBV20-1,TRBJ2-3,CSARDRPVDTQYF,0,2,1,2
TRBV20-1,TRBJ2-7,CSAREPGGNEQYF,0,2,1,2
TRBV20-1,TRBJ1-2,CSARELPGLGYTF,0,2,1,2
TRBV20-1,TRBJ2-5,CSARDQGEETQYF,0,2,1,2
TRBV20-1,TRBJ2-5,CSARDRDRETQYF,0,2,1,2
TRBV20-1,TRBJ2-3,CSATSGSTDTQYF,0,2,1,2
TRBV20-1,TRBJ2-7,CSKTSGRGREQYF,0,2,1,2
TRBV29-1,TRBJ2-5,CSLTVIGRETQYF,0,2,1,2
TRBV29-1,TRBJ2-5,CSLAGTRAETQYF,0,2,1,2
TRBV29-1,TRBJ2-7,CSVSGTNLYEQYF,0,2,1,2
TRBV29-1,TRBJ2-2,CSVVAGGTGELFF,0,2,1,2
TRBV29-1,TRBJ1-1,CSVAGTGGTEAFF,0,2,1,2
TRBV29-1,TRBJ1-1,CSVGGGQNTEALF,0,2,1,2
TRBV29-1,TRBJ2-2,CSVGTTNTGELFF,0,2,1,2
TRBV29-1,TRBJ2-2,CSVGQMDTGELFF,0,2,1,2
TRBV29-1,TRBJ1-3,CSVGGGERNTIYF,0,2,1,2
TRBV29-1,TRBJ1-1,CSVDTAQNTEAFF,0,2,1,2
TRBV29-1,TRBJ2-7,CSVDTGGIGEQYF,0,2,1,2
TRBV29-1,TRBJ1-2,CSVDRVRDYGYTF,0,2,1,2
TRBV29-1,TRBJ1-2,CSVERFSSNGYTF,0,2,1,2
TRBV29-1,TRBJ1-2,CSVEPFGGHGYTF,0,2,1,2
TRBV29-1,TRBJ2-5,CSVEVRSKETQYF,0,2,1,2
TRBV29-1,TRBJ2-5,CSVEEQQPWTQYF,0,2,1,2
TRBV29-1,TRBJ2-5,CSVTSGGQETQYF,0,2,1,2
TRBV29-1,TRBJ2-7,CSVRASGSYEQYF,0,2,1,2
TRBV29-1,TRBJ2-1,CSVSGQGGDEQFF,0,2,1,2
TRBV29-1,TRBJ2-1,CSVPKLSSNEQFF,0,2,1,2
TRBV29-1,TRBJ2-5,CSVALRLAETQYF,0,2,1,2
TRBV29-1,TRBJ1-1,CSVETGGWTEAFF,0,2,1,2
TRBV29-1,TRBJ2-5,CSVGTSDQETQYF,0,2,1,2
TRBV29-1,TRBJ1-3,CSVEDTAGNTIYF,0,2,1,2
TRBV29-1,TRBJ1-5,CSADTGYGQPQHF,0,2,1,2
TRBV29-1,TRBJ1-1,CSAPSPGNTEAFF,0,2,1,2
TRBV29-1,TRBJ1-1,CSAPDDRNTEAFF,0,2,1,2
TRBV29-1,TRBJ2-6,CSARTGGANVLTF,0,2,1,2
TRBV29-1,TRBJ2-7,CSAEGGSSYEQYF,0,2,1,2
TRBV29-1,TRBJ2-3,CSGCQVGADTQYF,0,2,1,2
TRBV29-1,TRBJ1-1,CSGGDRMNTEAFF,0,2,1,2
TRBV29-1,TRBJ2-1,CSGSGGLYNEQFF,0,2,1,2
TRBV20-1,TRBJ2-7,CSITSGRWGEQYF,0,2,1,2
TRBV20-1,TRBJ1-4,CNASNRVGEKLFF,0,2,1,2
TRBV29-1,TRBJ1-1,RSVGTRGDTEAFF,0,2,1,2
TRBV30,TRBJ1-1,CAGGTIWGGAFF,0,2,1,2
TRBV30,TRBJ1-1,CAGNPGRTEAFF,0,2,1,2
TRBV7-9,TRBJ1-2,CAITYGVYGYTF,0,2,1,2
TRBV15,TRBJ1-5,CATSTEGQPQHF,0,2,1,2
TRBV15,TRBJ1-2,CATSRDGYGYTF,0,2,1,2
TRBV19,TRBJ1-2,CASSLGGDGYTF,0,2,1,2
TRBV19,TRBJ2-5,CASSGGRETQYF,0,2,1,2
TRBV19,TRBJ1-1,CASSIGGTEAFF,0,2,1,2
TRBV19,TRBJ2-7,CASSYNSYEQYF,0,2,1,2
TRBV27,TRBJ2-1,CASSGAYNEQFF,0,2,1,2
TRBV19,TRBJ2-7,CASSRQGSEQYF,0,2,1,2
TRBV6-1,TRBJ2-4,CASCGLGNIQYF,0,2,1,2
TRBV7-9,TRBJ2-3,CASQGSTDTQYF,0,2,1,2
TRBV6-2/3/5/6,TRBJ2-2,CASGTRTGELFF,0,2,1,2
TRBV7-2,TRBJ2-7,CASGLGGPEQYF,0,2,1,2
TRBV6-2/3/5/6,TRBJ1-6,CASGPGNSPLHF,0,2,1,2
TRBV6-2/3/5/6,TRBJ1-5,CASGSQGLAQHF,0,2,1,2
TRBV12-3/4,TRBJ2-3,CASGSSTDTQYF,0,2,1,2
TRBV12-3/4,TRBJ2-7,CASTFRGDEQYF,0,2,1,2
TRBV27,TRBJ2-1,CASTQDRDEQFF,0,2,1,2
TRBV2,TRBJ2-1,CASTSVGDEQFF,0,2,1,2
TRBV27,TRBJ2-1,CASSFRHNEQFF,0,2,1,2
TRBV6-2/3/5/6,TRBJ1-1,CASSFAGIEAFF,0,2,1,2
TRBV28,TRBJ1-5,CASSFRDQPQHS,0,2,1,2
TRBV12-3/4,TRBJ1-5,CASSLLYQPQHF,0,2,1,2
TRBV12-3/4,TRBJ1-1,CASSLPNTEAFF,0,2,1,2
TRBV12-3/4,TRBJ2-5,CASSLAPMGQYF,0,2,1,2
TRBV12-3/4,TRBJ2-7,CASSLGFNGQYF,0,2,1,2
TRBV6-2/3/5/6,TRBJ2-7,CASSSRGYEQYF,0,2,1,2
TRBV27,TRBJ2-7,CASSSLAHEQYF,0,2,1,2
TRBV9,TRBJ2-5,CASSSLQETQYF,0,2,1,2
TRBV6-2/3/5/6,TRBJ1-2,CASSSRTEINTF,0,2,1,2
TRBV6-2/3/5/6,TRBJ2-1,CASSSNIWEQFF,0,2,1,2
TRBV6-2/3/5/6,TRBJ1-1,CASSYRNTEAFF,0,2,1,2
TRBV6-2/3/5/6,TRBJ1-5,CASSYVGQPQHF,0,2,1,2
TRBV6-2/3/5/6,TRBJ2-7,CASSYTGYEQYF,0,2,1,2
TRBV6-2/3/5/6,TRBJ2-1,CASSYNKNEQFF,0,2,1,2
TRBV12-3/4,TRBJ2-5,CASSPPGETQYF,0,2,1,2
TRBV6-2/3/5/6,TRBJ2-1,CASSPQLGEQFF,0,2,1,2
TRBV2,TRBJ2-1,CASSGLNNEQFF,0,2,1,2
TRBV12-3/4,TRBJ1-2,CASSGTRYGYTF,0,2,1,2
TRBV6-1,TRBJ2-7,CASSELAYEQYF,0,2,1,2
TRBV11-1,TRBJ2-7,CASSRGVHEQYF,0,2,1,2
TRBV7-9,TRBJ2-1,CASSFQGYEQFF,0,2,1,2
TRBV7-2,TRBJ2-7,CASSFRLNEQYF,0,2,1,2
TRBV5-6,TRBJ2-7,CASSLSANKQYF,0,2,1,2
TRBV7-9,TRBJ1-2,CASSLGDWGYTF,0,2,1,2
TRBV5-6,TRBJ1-2,CASSLEGLGYTF,0,2,1,2
TRBV5-4,TRBJ2-2,CASSLKTGELFF,0,2,1,2
TRBV7-2,TRBJ1-2,CASSLAGGGYTF,0,2,1,2
TRBV7-2,TRBJ1-2,CASSLGPNGYTF,0,2,1,2
TRBV5-4,TRBJ2-2,CASSSGGGELFF,0,2,1,2
TRBV5-4,TRBJ2-1,CASSSSGNEQFF,0,2,1,2
TRBV5-5,TRBJ2-3,CASSSDLDTQYF,0,2,1,2
TRBV5-6,TRBJ1-2,CASSSDSGGYTF,0,2,1,2
TRBV7-3,TRBJ2-1,CASSSPNNEQFF,0,2,1,2
TRBV6-2/3/5/6,TRBJ1-1,CASSWGGTEAFF,0,2,1,2
TRBV7-2,TRBJ2-1,CASSYQGHEQFF,0,2,1,2
TRBV7-2,TRBJ2-1,CASSLLTDEQFF,0,2,1,2
TRBV3-1,TRBJ1-1,CASSLRTGEAFF,0,2,1,2
TRBV7-2,TRBJ1-2,CASSPQFPGYTF,0,2,1,2
TRBV3-1,TRBJ1-2,CASSPRTGGYTF,0,2,1,2
TRBV6-2/3/5/6,TRBJ2-1,CASSPTLNEQFF,0,2,1,2
TRBV4-2,TRBJ2-7,CASSHNGVEQYF,0,2,1,2
TRBV7-2,TRBJ2-3,CASSHPQDTQYF,0,2,1,2
TRBV11-1,TRBJ2-7,CASSHRVYEQYF,0,2,1,2
TRBV7-9,TRBJ1-3,CASSQSGNTIYF,0,2,1,2
TRBV12-3/4,TRBJ1-2,CASSQTGHGYTF,0,2,1,2
TRBV5-5,TRBJ1-1,CASSQRGAEAFF,0,2,1,2
TRBV14,TRBJ1-2,CASSQGTYGYTF,0,2,1,2
TRBV9,TRBJ2-2,CASSVGGGELFF,0,2,1,2
TRBV7-9,TRBJ2-5,CASSVRELGIYF,0,2,1,2
TRBV11-2,TRBJ2-7,CASSEGQSEQYF,0,2,1,2
TRBV7-9,TRBJ2-3,CASSIGTDTQYF,0,2,1,2
TRBV2,TRBJ2-5,CASSRGGETQYF,0,2,1,2
TRBV13,TRBJ2-1,CASSRTGVEQFF,0,2,1,2
TRBV12-3/4,TRBJ2-4,CASSRITGLQYF,0,2,1,2
TRBV12-3/4,TRBJ2-7,CASRRTGHEQYF,0,2,1,2
TRBV27,TRBJ2-7,CASRSSRGQQYF,0,2,1,2
TRBV3-1,TRBJ1-2,CASRQGAGGYTF,0,2,1,2
TRBV2,TRBJ1-5,CASRQGSQPQHF,0,2,1,2
TRBV6-2/3/5/6,TRBJ1-2,CASRAGDYGYTF,0,2,1,2
TRBV7-9,TRBJ2-7,CASRINSYEQYF,0,2,1,2
TRBV7-6,TRBJ1-4,CASRKVGEKLFF,0,2,1,2
TRBV5-6,TRBJ2-3,CASNLGTDTQYF,0,2,1,2
TRBV2,TRBJ2-3,CASKQITDTQYF,0,2,1,2
TRBV2,TRBJ1-3,CASKGDGNTIYF,0,2,1,2
TRBV5-1,TRBJ1-6,CASSLGTSPLHF,0,2,1,2
TRBV4-1,TRBJ2-3,CASSQVWATQYF,0,2,1,2
TRBV4-1,TRBJ1-5,CASSQGQQPQHF,0,2,1,2
TRBV5-1,TRBJ1-2,CDSGSRGYGYTF,0,2,1,2
TRBV20-1,TRBJ1-6,CSARLGNSPLHF,0,2,1,2
TRBV20-1,TRBJ2-5,CSATATGETQYF,0,2,1,2
TRBV20-1,TRBJ2-7,CSASLISYEQYF,0,2,1,2
TRBV20-1,TRBJ2-1,CSASRRRNEQFF,0,2,1,2
TRBV20-1,TRBJ1-2,CSARLTNYGYTF,0,2,1,2
TRBV20-1,TRBJ1-1,CSARDDGTKAFF,0,2,1,2
TRBV20-1,TRBJ1-2,CSAREAGTGYTF,0,2,1,2
TRBV20-1,TRBJ2-3,CSALGVADTQYF,0,2,1,2
TRBV20-1,TRBJ2-1,CSARREELEQFF,0,2,1,2
TRBV29-1,TRBJ2-7,CSVVVRTYEQYF,0,2,1,2
TRBV29-1,TRBJ2-1,CSVDHPYNEQFF,0,2,1,2
TRBV29-1,TRBJ2-5,CSVDGRLETQYF,0,2,1,2
TRBV29-1,TRBJ2-4,CSVDADGNIQYF,0,2,1,2
TRBV29-1,TRBJ2-3,CSVEPGTDTQYF,0,2,1,2
TRBV29-1,TRBJ2-1,CSVEAGRDEQFF,0,2,1,2
TRBV29-1,TRBJ1-2,CSVEGTENGYTF,0,2,1,2
TRBV29-1,TRBJ2-1,CSVEDRGNEQFF,0,2,1,2
TRBV29-1,TRBJ1-2,CSVETDNYGYTF,0,2,1,2
TRBV29-1,TRBJ2-7,CSVRLGVGEQYF,0,2,1,2
TRBV29-1,TRBJ2-7,CSVEQETYEQYF,0,2,1,2
TRBV29-1,TRBJ2-2,CSADRGPGELFF,0,2,1,2
TRBV7-4,TRBJ1-2,RASSGTGGGYTF,0,2,1,2
TRBV27,TRBJ2-1,CVSTQGMEQFF,0,2,1,2
TRBV12-5,TRBJ2-7,CASGFSYEQYF,0,2,1,2
TRBV12-5,TRBJ1-2,CARAGIYGYTF,0,2,1,2
TRBV10-3,TRBJ1-2,CAITGGVGYTF,0,2,1,2
TRBV19,TRBJ2-1,CATGLHNEQFF,0,2,1,2
TRBV14,TRBJ2-7,CATGQTCEQHF,0,2,1,2
TRBV19,TRBJ2-1,CASSRFGEQFF,0,2,1,2
TRBV19,TRBJ2-7,CASRENYEQYF,0,2,1,2
TRBV7-3,TRBJ2-7,CASRGRYEQYF,0,2,1,2
TRBV25-1,TRBJ2-1,CASQLNNEQFF,0,2,1,2
TRBV2,TRBJ2-5,CASMLWETQYF,0,2,1,2
TRBV11-2,TRBJ2-3,CASISSGTQYF,0,2,1,2
TRBV6-2/3/5/6,TRBJ2-7,CASSFNYEQYF,0,2,1,2
TRBV12-3/4,TRBJ2-3,CASSLADTQYF,0,2,1,2
TRBV6-2/3/5/6,TRBJ2-7,CASSYLTEQYF,0,2,1,2
TRBV27,TRBJ2-7,CASSLSYEQYF,0,2,1,2
TRBV6-1,TRBJ1-1,CASSGRAEAFF,0,2,1,2
TRBV6-1,TRBJ2-1,CASSKGNEQFF,0,2,1,2
TRBV7-2,TRBJ2-7,CASSFQYEQYF,0,2,1,2
TRBV7-8,TRBJ2-7,CASSFSHEQYF,0,2,1,2
TRBV5-6,TRBJ2-5,CASSLDETQYF,0,2,1,2
TRBV7-9,TRBJ2-5,CASSLGRDQYF,0,2,1,2
TRBV7-9,TRBJ1-2,CASSLDISYTF,0,2,1,2
TRBV3-1,TRBJ2-7,CASSRSYEQYF,0,2,1,2
TRBV7-9,TRBJ2-1,CASSQYNEQFF,0,2,1,2
TRBV5-4,TRBJ1-1,CASSGGTEAFF,0,2,1,2
TRBV7-9,TRBJ2-5,CASSNPETQYF,0,2,1,2
TRBV10-3,TRBJ2-7,CAKNRGHEQYF,0,2,1,2
TRBV5-1,TRBJ2-1,CASGEYNEQFF,0,2,1,2
TRBV4-1,TRBJ2-7,CASSQGYEQYF,0,2,1,2
TRBV20-1,TRBJ1-1,CGTRVNTEAFF,0,2,1,2
TRBV20-1,TRBJ2-1,CSVEIRNEQFF,0,2,1,2
TRBV20-1,TRBJ1-1,CSAPSSMGAFF,0,2,1,2
TRBV20-1,TRBJ2-3,CSASSADTQYF,0,2,1,2
TRBV20-1,TRBJ1-1,CSARGGIEAFF,0,2,1,2
TRBV20-1,TRBJ1-1,CSARVGPEAFF,0,2,1,2
TRBV29-1,TRBJ2-3,CSVYSTDTRYF,0,2,1,2
TRBV29-1,TRBJ1-2,CSVLTEYGYTF,0,2,1,2
TRBV29-1,TRBJ2-1,CSVVEYNEQFF,0,2,1,2
TRBV29-1,TRBJ2-7,CSVGGKREQYF,0,2,1,2
TRBV29-1,TRBJ2-1,CSVEDSHEQFF,0,2,1,2
TRBV29-1,TRBJ1-1,CSVVRDREAFF,0,2,1,2
TRBV29-1,TRBJ2-4,CSAAGQGVQYF,0,2,1,2
TRBV7-9,TRBJ2-1,CASEGQRQLF,0,2,1,2
TRBV2,TRBJ1-1,CASIRRVAFF,0,2,1,2
TRBV11-2,TRBJ2-1,CASSLGEQFF,0,2,1,2
TRBV2,TRBJ2-7,CGSGENEQYF,0,2,1,2
TRBV20-1,TRBJ2-7,CSASSYEQHF,0,2,1,2
TRBV20-1,TRBJ2-4,CSARDNIQYF,0,2,1,2
TRBV29-1,TRBJ1-1,CSGQGAEAFF,0,2,1,2
TRBV29-1,TRBJ2-2,CSVRLGELFF,0,2,1,2
TRBV29-1,TRBJ2-2,CSVVSGELFF,0,2,1,2
TRBV29-1,TRBJ2-7,CSVAGTEQYF,0,2,1,2
TRBV28,TRBJ1-1,CAGDTEAFF,0,2,1,2
TRBV20-1,TRBJ2-7,CSAPSEQYF,0,2,1,2
TRBV29-1,TRBJ1-1,CSIPPAFF,0,2,1,2
TRBV29-1,TRBJ1-1,CSVEAFF,0,2,1,2
TRBV18,TRBJ1-4,CASSPPRGVSATNEKLFF,0,2,1,2
TRBV6-2/3/5/6,TRBJ1-6,CASSYSRGSSSPLHF,0,2,1,2
TRBV13,TRBJ1-6,CASSLGRLRSPLHF,0,2,1,2
TRBV11-1,TRBJ1-1,CASSWSRRTEAFF,0,2,1,2
