v_hit,j_hit,cdr3,S2-10ng_S7,S2-10ng_S19,freq,count_sum
TRAV23DV6,TRAJ56,CAASGGGANSKLTF,23,25,2,48
TRAV12-3,TRAJ30,CAIPPMNRDDKIIF,14,35,2,49
TRAV9-2,TRAJ49,CALSEAGNQFYF,16,28,2,44
TRAV36DV7,TRAJ23,CAVEALNQGGKLIF,12,19,2,31
TRAV3,TRAJ6,CAPRGSGGSYIPTF,16,18,2,34
TRAV12-3,TRAJ37,CAMSLWVSNTGKLIF,1,0,1,1
TRAV13-2,TRAJ3,CAKPGYSSASKIIF,11,11,2,22
TRAV14DV4,TRAJ37,CAMREGSSNTGKLIF,2,4,2,6
TRAV27,TRAJ33,CLGSNYQLIW,2,0,1,2
TRAV17,TRAJ54,CATSRGAQKLVF,3,6,2,9
TRAV26-2,TRAJ21,CILEYNFNKFYF,1,0,1,1
TRAV21,TRAJ15,CAVRAQAGTALIF,5,5,2,10
TRAV14DV4,TRAJ12,CAMREGLDSSYKLIF,2,0,1,2
TRAV12-3,TRAJ13,CASSGGYQKVTF,6,2,2,8
TRAV4,TRAJ27,CLVGDIGNAGKSTF,4,10,2,14
TRAV13-1,TRAJ11,CAARRYSTLTF,6,5,2,11
TRAV12-2,TRAJ23,CAVDYNQGGKLIF,4,13,2,17
TRAV27,TRAJ23,CAGTLDTQGGKLIF,2,1,2,3
TRAV12-1,TRAJ23,CVVTRDQGGKLIF,2,0,1,2
TRAV23DV6,TRAJ49,CAPSNTGNQFYF,4,3,2,7
TRAV26-2,TRAJ44,CILRALTGTASKLTF,2,1,2,3
TRAV38-1,TRAJ34,CAFMKLHNTDKLIF,1,0,1,1
TRAV9-2,TRAJ22,CASEGSARQLTF,1,0,1,1
TRAV20,TRAJ11,CAGFSGYSTLTF,1,0,1,1
TRAV12-2,TRAJ34,CAVRKLIF,8,7,2,15
TRAV5,TRAJ6,CAVPPGGSYIPTF,5,2,2,7
TRAV17,TRAJ54,CATERLLINQGAQKLVF,1,0,1,1
TRAV36DV7,TRAJ52,CAVGGGTSYGKLTF,5,12,2,17
TRAV12-2,TRAJ31,CAVANARLMF,4,1,2,5
TRAV19,TRAJ39,CALSPSMNNNAGNMLTF,1,1,2,2
TRAV19,TRAJ30,CALSDPRDDKIIF,1,0,1,1
TRAV17,TRAJ56,CASTGANSKLTF,1,1,2,2
TRAV12-2,TRAJ49,CAVVRAGNQFYF,2,1,2,3
TRAV17,TRAJ39,CAPNNAGNMLTF,2,3,2,5
TRAV12-1,TRAJ52,CVVNQANAGGTSYGKLTF,1,0,1,1
TRAV9-2,TRAJ15,CALSPYQAGTALIF,1,0,1,1
TRAV14DV4,TRAJ47,CAMRLMEYGNKLVF,5,2,2,7
TRAV3,TRAJ6,CAVREVGSYIPTF,1,0,1,1
TRAV27,TRAJ12,CAGVKDSSYKLIF,2,3,2,5
TRAV5,TRAJ49,CAERPSNQFYF,2,5,2,7
TRAV13-1,TRAJ37,CAAETGKLIF,1,0,1,1
TRAV3,TRAJ8,CAVRANTGFQKLVF,5,10,2,15
TRAV21,TRAJ13,CAVGFSGGYQKVTF,4,2,2,6
TRAV12-3,TRAJ3,CAMTPYSSASKIIF,1,0,1,1
TRAV12-2,TRAJ23,CAVLGDQGGKLIF,5,4,2,9
TRAV38-2DV8,TRAJ49,CAYSPGNQFYF,1,0,1,1
TRAV8-3,TRAJ48,CGDFGNEKLTF,2,0,1,2
TRAV12-3,TRAJ49,CAMTRAQVYF,2,0,1,2
TRAV9-2,TRAJ9,CAPHTGGFKTIF,2,0,1,2
TRAV26-2,TRAJ58,CILRDAYGSGSRLTF,2,0,1,2
TRAV12-2,TRAJ39,CAVNINNAGNMLTF,1,0,1,1
TRAV2,TRAJ27,CAVAYNTNAGKSTF,4,6,2,10
TRAV13-1,TRAJ37,CAALRSSNTGKLIF,2,0,1,2
TRAV20,TRAJ36,CAVPGPGANNLFF,2,1,2,3
TRAV17,TRAJ34,CATDATNTDKLIF,1,0,1,1
TRAV27,TRAJ31,CAGAGQNNARLMF,1,0,1,1
TRAV2,TRAJ34,CAPRDTDKLIF,3,0,1,3
TRAV9-2,TRAJ45,CALSPGYSGGGADGLTF,1,0,1,1
TRAV13-1,TRAJ27,CAASIQNNTNAGKSTF,1,0,1,1
TRAV25,TRAJ52,CAGRRTGGTSYGKLTF,2,0,1,2
TRAV12-1,TRAJ28,CVVTVIPPGSYQLTF,3,1,2,4
TRAV19,TRAJ40,CALSGHLPGTYKYIF,1,0,1,1
TRAV16,TRAJ29,CALRNSGNTPLVF,2,1,2,3
TRAV3,TRAJ20,CAVRDSNDYKLSF,4,0,1,4
TRAV25,TRAJ43,CAGRDNDMRF,3,0,1,3
TRAV4,TRAJ48,CLVGPNFGNEKLTF,1,0,1,1
TRAV13-2,TRAJ37,CAEIPFRPGKLIF,1,0,1,1
TRAV12-3,TRAJ42,CAMRSLNYGGSQGNLIF,1,0,1,1
TRAV9-2,TRAJ28,CALSPISGAGSYQLTF,1,0,1,1
TRAV12-1,TRAJ38,CVVTPNAGNNRKLIW,1,3,2,4
TRAV9-2,TRAJ3,CALSDGRSSVSKIIF,1,0,1,1
TRAV21,TRAJ12,CAVRMDSSYKLIF,1,1,2,2
TRAV20,TRAJ9,CAVQADGGFKTIF,3,6,2,9
TRAV38-2DV8,TRAJ33,CACMDSNYQLIW,2,0,1,2
TRAV21,TRAJ34,CAVKGGYNTDKLIF,1,0,1,1
TRAV24,TRAJ29,CASARRSGNTPLVF,1,0,1,1
TRAV38-2DV8,TRAJ52,CAYRAAINAGGTSYGKLTF,1,0,1,1
TRAV9-2,TRAJ23,CALRGIYNQGGKLIF,2,0,1,2
TRAV14DV4,TRAJ45,CAMREGHLKEGGADGLTF,1,0,1,1
TRAV13-1,TRAJ28,CAAPSLPGAGSYQLTF,2,0,1,2
TRAV39,TRAJ42,CAVPSYGGSQGNLIF,1,0,1,1
TRAV29DV5,TRAJ53,CAAKGSGGSNYKLTF,3,8,2,11
TRAV9-2,TRAJ13,CALSPSGGYQKVTF,1,0,1,1
TRAV21,TRAJ17,CAVPQAAGNKLTF,2,0,1,2
TRAV2,TRAJ9,CAVGNTGGFKTIF,1,1,2,2
TRAV12-2,TRAJ40,CAVEPSGTYKYIF,1,0,1,1
TRAV13-1,TRAJ29,CAASMAGNTPLVF,1,0,1,1
TRAV38-1,TRAJ43,CAFTFNNNDMRF,1,0,1,1
TRAV2,TRAJ39,CATDNAGNMLTF,1,1,2,2
TRAV23DV6,TRAJ10,CAATGGGNKLTF,1,0,1,1
TRAV26-1,TRAJ16,CIVSLSDGQKLLF,1,0,1,1
TRAV14DV4,TRAJ53,CAMREGRSGGSDYKLTF,1,0,1,1
TRAV14DV4,TRAJ20,CAMREAAGDYKLSF,1,0,1,1
TRAV17,TRAJ26,CATADNYGQNFVF,1,0,1,1
TRAV12-3,TRAJ9,CAMSAGGTGGFKTIF,1,0,1,1
TRAV13-1,TRAJ10,CAASLGILTGGGNKLTF,2,0,1,2
TRAV20,TRAJ6,CAVQAGSAGGSYIPTF,2,9,2,11
TRAV8-3,TRAJ12,CAVGGTRMDSSYKLIF,1,0,1,1
TRAV2,TRAJ3,CAVELGSSASKIIF,2,0,1,2
TRAV13-2,TRAJ48,CAEKGKLGNEKLTF,1,0,1,1
TRAV21,TRAJ21,CAVTLYNFNKFYF,1,0,1,1
TRAV8-3,TRAJ30,CAVAQNRDDKIIF,1,0,1,1
TRAV8-3,TRAJ44,CAVAYGTASKLTF,2,2,2,4
TRAV13-1,TRAJ6,CAVISGGSYIPTF,1,0,1,1
TRAV5,TRAJ29,CAESRSGNTPLVF,1,0,1,1
TRAV34,TRAJ22,CGADSGSARQLTF,2,0,1,2
TRAV8-3,TRAJ20,CAVAPNDYKLSF,2,0,1,2
TRAV22,TRAJ27,CAVLYAGKSTF,1,0,1,1
TRAV20,TRAJ43,CAVQEVYDMRF,2,0,1,2
TRAV20,TRAJ29,CAVQARSGNTPLVF,1,0,1,1
TRAV8-3,TRAJ10,CAVGPDILTGGGNKLTF,1,0,1,1
TRAV36DV7,TRAJ58,CAVESLNQETSGSRLTF,1,0,1,1
TRAV3,TRAJ18,CAVSRHRGSTLGRLYF,3,12,2,15
TRAV12-1,TRAJ30,CVVVQVRDRDDKIIF,1,0,1,1
TRAV12-1,TRAJ36,CVATKAQTGANNLFF,1,0,1,1
TRAV16,TRAJ37,CALSGDSSNTGKLIF,1,1,2,2
TRAV8-3,TRAJ3,CAVGAGYSSASKIIF,2,0,1,2
TRAV29DV5,TRAJ53,CAARWSGGSNYKLTF,1,0,1,1
TRAV27,TRAJ37,CAGTYGSSNTGKLIF,1,0,1,1
TRAV14DV4,TRAJ42,CAMRGYGGSQGNLIF,2,0,1,2
TRAV38-2DV8,TRAJ45,CAPRGGGGADGLTF,1,1,2,2
TRAV21,TRAJ26,CAVIGRNYGQNFVF,3,0,1,3
TRAV22,TRAJ57,CAVEWAGGSEKLVF,1,0,1,1
TRAV12-2,TRAJ12,CAVISGDSSYKLIF,1,0,1,1
TRAV8-1,TRAJ33,CAVRLMDSNYQLIW,1,0,1,1
TRAV5,TRAJ10,CAEIFTGGGNKLTF,1,0,1,1
TRAV13-2,TRAJ49,CAENRGRTGNQFYF,1,0,1,1
TRAV12-2,TRAJ9,CVFPGTGGFKTIF,1,0,1,1
TRAV16,TRAJ49,CALKPNTGNQFYF,1,0,1,1
TRAV2,TRAJ21,CAVEDYNFNKFYF,1,0,1,1
TRAV12-2,TRAJ49,CAVNIRGGNQFYF,1,0,1,1
TRAV25,TRAJ54,CAGQIQGAQKLVF,1,0,1,1
TRAV13-2,TRAJ20,CAEISPNDYKLSF,1,0,1,1
TRAV10,TRAJ40,CVVRSGTYKYIF,1,0,1,1
TRAV17,TRAJ24,CALTDSGGKLQF,1,0,1,1
TRAV12-2,TRAJ5,CALYTGRRALTF,1,0,1,1
TRAV14DV4,TRAJ27,CAMVSNAGKSTF,1,0,1,1
TRAV12-1,TRAJ20,CVVNIGELSF,3,0,1,3
TRAV27,TRAJ54,CAGLRFQGAQKLVF,1,0,1,1
TRAV30,TRAJ17,CGTESTAGNKLTF,1,0,1,1
TRAV3,TRAJ37,CAVRVTSNTGKLIF,1,0,1,1
TRAV12-2,TRAJ20,CAVIFLGNDYKLSF,1,0,1,1
TRAV13-2,TRAJ21,CAENMGPVGDNFNKFYF,2,0,1,2
TRAV13-1,TRAJ13,CAATPRNSGGYQKVTF,1,0,1,1
TRAV13-1,TRAJ53,CAASRNSGGSNYKLTF,1,0,1,1
TRAV14DV4,TRAJ52,CAMSPKRGTSYGKLTF,2,1,2,3
TRAV20,TRAJ44,CAVRRNTGTASKLTF,1,0,1,1
TRAV20,TRAJ6,CAVQAVAGGSYIPTF,1,0,1,1
TRAV36DV7,TRAJ57,CAVGRSQGGSEKLVF,1,0,1,1
TRAV13-1,TRAJ37,CAASRAPSNTGKLIF,1,0,1,1
TRAV4,TRAJ36,CLVGDMSIGANNLFF,1,0,1,1
TRAV4,TRAJ28,CLVGGSGAGSYQLTF,2,0,1,2
TRAV30,TRAJ24,CGTEYSTDSWGKLQF,1,0,1,1
TRAV9-2,TRAJ10,CALRVTGGGNKLTF,1,0,1,1
TRAV20,TRAJ15,CAVPLNQAGTALIF,3,4,2,7
TRAV8-3,TRAJ15,CAVAPNQAGTALIF,1,0,1,1
TRAV8-3,TRAJ5,CAVAIDTGRRALTF,2,2,2,4
TRAV21,TRAJ39,CAVRPGNAGNMLTF,2,3,2,5
TRAV13-1,TRAJ3,CAASIGPPASKIIF,2,0,1,2
TRAV13-2,TRAJ13,CAETAPPGYQKVTF,1,0,1,1
TRAV14DV4,TRAJ29,CAMRDAPGNTPLVF,1,0,1,1
TRAV38-2DV8,TRAJ48,CAYEGFGNEKLTF,3,0,1,3
TRAV38-2DV8,TRAJ30,CAYRSAGDDKIIF,1,0,1,1
TRAV9-2,TRAJ4,CALSSGGYNKLIF,1,0,1,1
TRAV9-2,TRAJ41,CALTENSGYALNF,1,0,1,1
TRAV36DV7,TRAJ38,CAVDAGNNRKLIW,1,0,1,1
TRAV3,TRAJ16,CAVSAPDGQKLLF,1,0,1,1
TRAV13-1,TRAJ20,CAASISGDYKLSF,3,0,1,3
TRAV13-2,TRAJ40,CAETGSGTYKYIF,1,0,1,1
TRAV34,TRAJ33,CGGLPDSNYQLIW,1,0,1,1
TRAV4,TRAJ9,CLVGGSGGFKTIF,1,0,1,1
TRAV26-1,TRAJ12,CIARMDSSYKLIF,1,0,1,1
TRAV34,TRAJ29,CVSRSGNTPLVF,1,0,1,1
TRAV20,TRAJ20,CAVQASDYKLSF,2,0,1,2
TRAV13-1,TRAJ9,CAAYTGGFKTIF,1,0,1,1
TRAV14DV4,TRAJ43,CAMRERGNDMRF,1,0,1,1
TRAV30,TRAJ20,CGTERNDYKLSF,1,0,1,1
TRAV16,TRAJ40,CALPGTYKYIF,3,1,2,4
TRAV9-2,TRAJ27,CALVFAGKSTF,1,1,2,2
TRAV20,TRAJ43,CAVQAIGDMRF,1,1,2,2
TRAV26-2,TRAJ43,CILRDNDMRF,1,0,1,1
TRAV16,TRAJ58,CALSGQNSGSRLTF,1,0,1,1
TRAV12-1,TRAJ5,CKIMDTGRRALTF,1,0,1,1
TRAV26-2,TRAJ53,CILRGGGGSNYKLTF,1,0,1,1
TRAV12-2,TRAJ3,CAVNDYSSASKIIF,1,0,1,1
TRAV30,TRAJ57,CGTVATKRPATQGGSEKLVF,1,0,1,1
TRAV38-1,TRAJ53,CAFMGSSNSGGSNYKLTF,1,1,2,2
TRAV26-2,TRAJ42,CILRDVGYGGSQGNLIF,2,0,1,2
TRAV41,TRAJ45,CAVRYGSGGGADGLTF,1,0,1,1
TRAV22,TRAJ42,CAVERGYGGSQGNLIF,1,0,1,1
TRAV21,TRAJ29,CAVSGPAISGNTPLVF,1,0,1,1
TRAV3,TRAJ6,CAVRDGASGGSYIPTF,2,0,1,2
TRAV4,TRAJ28,CLVGAYSGAGSYQLTF,2,1,2,3
TRAV12-1,TRAJ38,CVVNLNAGNNRKLIW,2,0,1,2
TRAV12-1,TRAJ28,CVVKGSGAGSYQLTF,2,0,1,2
TRAV38-2DV8,TRAJ39,CAYRTGNNAGNMLTF,1,0,1,1
TRAV9-2,TRAJ38,CALEPHAGNNRKLIW,1,0,1,1
TRAV21,TRAJ57,CAVSGAQGGSEKLVF,1,0,1,1
TRAV3,TRAJ33,CAVRDLVDSNYQLIW,1,0,1,1
TRAV12-2,TRAJ50,CAVNSRETSYDKVIF,1,0,1,1
TRAV13-1,TRAJ20,CAATRTPSNDYKLSF,2,0,1,2
TRAV13-1,TRAJ45,CAASRSGGGADGLTF,1,0,1,1
TRAV26-1,TRAJ39,CIVRAFNNAGNMLTF,2,0,1,2
TRAV16,TRAJ28,CALYSGAGSYQLTF,1,0,1,1
TRAV9-2,TRAJ9,CALTGRAGGFKTIF,1,1,2,2
TRAV9-2,TRAJ44,CALSVPGTASKLTF,1,0,1,1
TRAV16,TRAJ23,CALSGRNQGGKLIF,1,0,1,1
TRAV16,TRAJ9,CALRVNTGGFKTIF,1,0,1,1
TRAV8-3,TRAJ6,CAVGTSGGSYIPTF,1,0,1,1
TRAV24,TRAJ48,CAFISNFGNEKLTF,1,0,1,1
TRAV23DV6,TRAJ10,CAAKHGGGGNKLTF,1,0,1,1
TRAV29DV5,TRAJ44,CAASETGTASKLTF,1,0,1,1
TRAV4,TRAJ3,CLVGERGGASKIIF,1,0,1,1
TRAV26-2,TRAJ9,CILSLDTGGFKTIF,1,0,1,1
TRAV26-2,TRAJ58,CTLIKETSGSRLTF,1,0,1,1
TRAV13-1,TRAJ49,SAASTNTGNQFYF,1,0,1,1
TRAV16,TRAJ6,CALRGGGSYIPTF,1,0,1,1
TRAV2,TRAJ22,CAVFSGSARQLTF,1,0,1,1
TRAV29DV5,TRAJ49,CAVVSDTGNQFYF,2,0,1,2
TRAV8-3,TRAJ37,CAVGDRNTGKLIF,1,0,1,1
TRAV2,TRAJ34,CAVEDNDTDKLIF,1,0,1,1
TRAV3,TRAJ31,CAVRGPNDARLMF,1,0,1,1
TRAV24,TRAJ57,CASTQGGSEKLVF,3,6,2,9
TRAV12-2,TRAJ21,CAVNPDGFNKFYF,1,0,1,1
TRAV12-1,TRAJ30,CADEGNRDDKIIF,1,0,1,1
TRAV13-1,TRAJ37,CAARLGDTGKLIF,2,0,1,2
TRAV13-1,TRAJ20,CAATKRGDYKLSF,2,0,1,2
TRAV13-1,TRAJ16,CAAISSDGQKLLF,2,0,1,2
TRAV13-1,TRAJ13,CAASIAGYQKVTF,1,0,1,1
TRAV12-3,TRAJ6,CATPPGGSYIPTF,1,0,1,1
TRAV4,TRAJ33,CLVGESSNYQLIW,1,0,1,1
TRAV12-1,TRAJ37,CVVISNTGKLIF,2,1,2,3
TRAV3,TRAJ9,CAVNTGGFKTIF,2,1,2,3
TRAV12-2,TRAJ35,CAALGFGNVLHC,1,0,1,1
TRAV36DV7,TRAJ26,CAGFYYGQNFVF,1,0,1,1
TRAV12-2,TRAJ3,CAVYSSASKIIF,1,0,1,1
TRAV27,TRAJ42,CAGGGSQGNLIF,1,0,1,1
TRAV5,TRAJ36,CAEKTGANNPFF,1,0,1,1
TRAV4,TRAJ36,CLVVGGANNLFF,2,1,2,3
TRAV30,TRAJ21,CGTENNFNKFYF,1,0,1,1
TRAV16,TRAJ43,CALSPNNDMRF,1,0,1,1
TRAV36DV7,TRAJ27,CAVLNAGKSTF,1,0,1,1
TRAV21,TRAJ6,CAVGGSYIPTF,1,0,1,1
TRAV21,TRAJ43,CAVKNNNDMRF,1,0,1,1
TRAV17,TRAJ23,CAAQEGGKLIF,1,0,1,1
TRAV27,TRAJ21,CAAYNFNKFYF,1,1,2,2
TRAV23DV6,TRAJ37,CAAHNTGKLIF,2,0,1,2
TRAV26-1,TRAJ37,CITSNTGKLIF,1,0,1,1
TRAV2,TRAJ7,WLGYGNNRLAF,1,0,1,1
TRAV12-2,TRAJ23,CAVLGGKLIF,1,0,1,1
TRAV36DV7,TRAJ43,CAACDNDMRF,1,0,1,1
TRAV26-2,TRAJ52,CETSYGKLTF,1,0,1,1
TRAV26-2,TRAJ38,CILRGLIW,1,0,1,1
TRAV29DV5,TRAJ40,CAASAVTSGTYKYIF,1,1,2,2
TRAV16,TRAJ37,CALCTSNTGKLIF,1,0,1,1
TRAV12-3,TRAJ52,CAMSGAGGTSYGKLTF,1,0,1,1
TRAV22,TRAJ28,CAVPYSGAGSYQLTF,1,0,1,1
TRAV21,TRAJ15,CAVSANQAGTALIF,1,0,1,1
TRAV12-3,TRAJ20,CAMSSANDYKLSF,1,0,1,1
TRAV9-2,TRAJ57,CALSQGQGGSEKLVF,1,0,1,1
TRAV9-2,TRAJ21,CAPNNFNKFYF,1,0,1,1
TRAV9-2,TRAJ42,CALSDMNYGGSQGNLIF,2,0,1,2
TRAV12-1,TRAJ11,CVVNMSQNSGYSTPTF,1,0,1,1
TRAV9-2,TRAJ5,CALSDLGGTGRRALTF,1,0,1,1
TRAV8-3,TRAJ53,CAVATRGGGSNYKLTF,1,0,1,1
TRAV13-1,TRAJ11,CAAAGVLNSGYSTLTF,1,0,1,1
TRAV4,TRAJ27,CLVGDMGYTNAGKSTF,1,0,1,1
TRAV26-2,TRAJ29,CILRDVGKTGNTPLVF,1,0,1,1
TRAV26-1,TRAJ57,CIVRVALQGGSEKLVF,1,0,1,1
TRAV10,TRAJ39,CVVSAFRNAGNMLTF,1,0,1,1
TRAV38-2DV8,TRAJ48,CAYRSAGFGNEKLTF,1,0,1,1
TRAV19,TRAJ47,CALSEAEEYGNKLVF,2,0,1,2
TRAV19,TRAJ30,CALSEKENRDDKIIF,1,0,1,1
TRAV6,TRAJ40,CALDWRNTGTYKYIF,1,0,1,1
TRAV20,TRAJ31,CAVHPRDYNNARLMF,1,0,1,1
TRAV20,TRAJ42,CAVQATRGSQGNLIF,1,0,1,1
TRAV21,TRAJ53,CAVSSSGGSNYKLTF,1,0,1,1
TRAV13-1,TRAJ49,CAATPRTNTGNQFYF,2,0,1,2
TRAV29DV5,TRAJ53,CAASALRGSNYKLTF,1,0,1,1
TRAV5,TRAJ42,CAEILYGGSQGNLIF,2,0,1,2
TRAV13-2,TRAJ23,CAETGGNNQGGKLIF,1,4,2,5
TRAV12-3,TRAJ10,CAMVRLTGGGNKLTF,2,0,1,2
TRAV14DV4,TRAJ41,CAMREGGNSGYALNF,1,0,1,1
TRAV4,TRAJ36,CLVGADQTGANNLFF,1,0,1,1
TRAV26-2,TRAJ4,CILRAHSGGYNKLIF,1,0,1,1
TRAV26-2,TRAJ39,CILRDYNNAGNMLTF,1,0,1,1
TRAV10,TRAJ29,CVVSSYSGNTPLVF,1,0,1,1
TRAV12-1,TRAJ5,CVVNRGTGRRALTF,1,0,1,1
TRAV16,TRAJ29,CALTPYSGNTPLVF,1,0,1,1
TRAV9-2,TRAJ50,CALTTETSYDKVIF,1,0,1,1
TRAV9-2,TRAJ45,CALSDRGGADGLTF,1,0,1,1
TRAV6,TRAJ39,CALAPNNAGNMLTF,1,0,1,1
TRAV6,TRAJ46,CALDEGSSGDKLTF,1,0,1,1
TRAV21,TRAJ21,CAVGSWDNFSKFYF,1,0,1,1
TRAV8-3,TRAJ10,CAVDPGGGGNKLTF,1,0,1,1
TRAV2,TRAJ16,CAVEDGSDGQKLLF,1,0,1,1
TRAV3,TRAJ30,CAVSRMNRDDKIIF,1,0,1,1
TRAV3,TRAJ45,CAVRRGGGADGLTF,1,0,1,1
TRAV12-1,TRAJ37,CAFFPPSNTGKLIF,2,0,1,2
TRAV24,TRAJ41,CAFIQENSGYALNF,1,0,1,1
TRAV8-1,TRAJ5,CAVNAGPGRRALTF,1,0,1,1
TRAV12-2,TRAJ39,CAVNGDNAGNMLTF,1,0,1,1
TRAV13-1,TRAJ11,CAAAPMEGYSTLTF,1,0,1,1
TRAV13-1,TRAJ13,CAASIREGYQKVTF,1,0,1,1
TRAV13-1,TRAJ15,CAASRHQAGTALIF,1,0,1,1
TRAV13-1,TRAJ40,CAASKGSGTYKYIF,1,0,1,1
TRAV27,TRAJ15,CAGYNNQAGTALIF,1,2,2,3
TRAV13-2,TRAJ3,CAEPGYSSASKIIF,1,0,1,1
TRAV5,TRAJ4,CAESISGGYNKLIF,2,0,1,2
TRAV12-3,TRAJ37,CAMSISSNTGKLIF,2,0,1,2
TRAV12-3,TRAJ17,CAMSGEAAGNKLTF,1,0,1,1
TRAV4,TRAJ40,CLVAHTSGTYKYIF,1,0,1,1
TRAV4,TRAJ18,CLVGPRGTLGRLYF,1,0,1,1
TRAV4,TRAJ10,CLVGGTGGGNKLTF,2,0,1,2
TRAV12-1,TRAJ26,CVVNQEYGQNFVF,1,0,1,1
TRAV12-1,TRAJ21,CVVNPGNFNKFYF,1,0,1,1
TRAV2,TRAJ21,CASPEYNFNKFYF,2,0,1,2
TRAV9-2,TRAJ48,CALSNFGNEKLTF,2,0,1,2
TRAV16,TRAJ48,CALDDFGNEKLTF,1,0,1,1
TRAV16,TRAJ33,CALSGDSNYQLIW,1,0,1,1
TRAV16,TRAJ29,CALRRSGNTPLVF,1,0,1,1
TRAV20,TRAJ9,CAVQADGDFKTIF,1,0,1,1
TRAV8-4,TRAJ22,CAVSDGSARQLTF,2,1,2,3
TRAV12-2,TRAJ50,CAVRETSYDKVIF,1,0,1,1
TRAV3,TRAJ20,CAVKGTSDYKLSF,2,0,1,2
TRAV23DV6,TRAJ12,CAPGMDSSYKLIF,1,0,1,1
TRAV12-2,TRAJ48,CAVEVFGNERLTF,1,0,1,1
TRAV29DV5,TRAJ27,CAASDDNAGKSTF,1,0,1,1
TRAV13-1,TRAJ50,CAARATSYDKVIF,1,0,1,1
TRAV27,TRAJ32,CAGYGGATNKLIF,1,1,2,2
TRAV13-2,TRAJ33,CAEKGNSNYQLIW,1,1,2,2
TRAV14DV4,TRAJ9,CAMSPTGGFKTIF,1,1,2,2
TRAV36DV7,TRAJ38,CTIHAGNNRKLIW,1,1,2,2
TRAV30,TRAJ17,CGTAKAAGNKLTF,1,0,1,1
TRAV26-1,TRAJ50,CIVTWTSYDKVIF,1,0,1,1
TRAV38-2DV8,TRAJ34,CAYRSNTDKLIF,1,0,1,1
TRAV38-2DV8,TRAJ49,CAYRRSGNQFYF,1,0,1,1
TRAV16,TRAJ53,CALRGSNYKLTF,1,0,1,1
TRAV9-2,TRAJ4,CALKGGYNKLIF,1,0,1,1
TRAV8-3,TRAJ40,CAVASGTYKYVF,1,0,1,1
TRAV8-3,TRAJ34,CAVGEDTDKLIF,1,0,1,1
TRAV8-3,TRAJ40,CAVGSGTYKYIF,2,1,2,3
TRAV12-2,TRAJ21,CAVRNNFNKFYF,1,1,2,2
TRAV12-2,TRAJ9,CAVEDGGFKTIF,1,0,1,1
TRAV25,TRAJ10,CAAGGGGNKLTF,1,0,1,1
TRAV29DV5,TRAJ40,CAASPGTYKYIF,2,0,1,2
TRAV13-1,TRAJ8,CAASRSFQKLVF,1,0,1,1
TRAV12-3,TRAJ20,CAMSSNDYKLSF,1,0,1,1
TRAV26-2,TRAJ49,CILSATGNQFYF,1,0,1,1
TRAV16,TRAJ47,CALRGLNKLVF,1,0,1,1
TRAV9-2,TRAJ34,CAPEGTDKLIF,1,0,1,1
TRAV21,TRAJ20,CAVNHDYKLSF,1,0,1,1
TRAV12-3,TRAJ20,CAMSDDYKLSF,1,0,1,1
TRAV9-2,TRAJ20,CAPNDYKLSF,1,0,1,1
TRAV13-1,TRAJ31,CAASMDRLMF,1,0,1,1
TRAV27,TRAJ37,CAIHPGKLIF,1,0,1,1
TRAV24,TRAJ43,CAFNNDMRF,2,0,1,2
TRAV21,TRAJ52,CAVSSPPYAGGTSYGKLTF,2,1,2,3
TRAV14DV4,TRAJ52,CAMREGTAGGTSYGKLTF,1,0,1,1
TRAV38-1,TRAJ42,CAFMKPYFGGSQGNLIF,1,0,1,1
TRAV38-1,TRAJ38,CAFMKPVNAGNNRKLIW,1,0,1,1
TRAV19,TRAJ57,CALSGPLIQGGSEKLVF,1,0,1,1
TRAV13-1,TRAJ52,CAASQGAGGTSYGKLTF,1,0,1,1
TRAV14DV4,TRAJ10,CAMREVILTGGGNKPTF,1,0,1,1
TRAV10,TRAJ42,CVVNLNYGGSQGNLIF,4,1,2,5
TRAV41,TRAJ48,CAVVECPNFGNEKLTF,1,0,1,1
TRAV36DV7,TRAJ52,CAVPDAGGTSYGKLTF,1,0,1,1
TRAV12-2,TRAJ37,CAVNDWGSSNTGKLIF,1,0,1,1
TRAV13-1,TRAJ5,CASLAPGGTGRRALTF,1,0,1,1
TRAV5,TRAJ32,CAESRWYGGATNKLIF,1,0,1,1
TRAV12-1,TRAJ23,CVVTSFYNQGGKLIF,2,0,1,2
TRAV12-1,TRAJ18,CVVNDRGSTLGRLYF,1,1,2,2
TRAV38-1,TRAJ42,CAFMSYGGSQGNLIF,1,0,1,1
TRAV19,TRAJ6,CALSAAGGGSYIPTF,1,0,1,1
TRAV9-2,TRAJ6,CALSVASGGSYIPTF,1,0,1,1
TRAV9-2,TRAJ32,CALRLYGGATNKLIF,1,0,1,1
TRAV9-2,TRAJ37,CALRRGSSNTGKLIF,1,0,1,1
TRAV23DV6,TRAJ45,CAPPKGGGGADGLTF,1,0,1,1
TRAV12-3,TRAJ30,CAVWNPMNRDDKIIF,1,0,1,1
TRAV22,TRAJ24,CAVYGTTDSWGKLQF,1,0,1,1
TRAV20,TRAJ32,CAVQENGGATNKLIF,1,0,1,1
TRAV20,TRAJ37,CAVAQGSSNTGKLIF,1,0,1,1
TRAV36DV7,TRAJ18,CAVEDRGSTLGRLYF,1,0,1,1
TRAV8-4,TRAJ40,CAVTLTTSGTYKYIF,2,0,1,2
TRAV3,TRAJ22,CAVSSYSGSARQLTF,2,0,1,2
TRAV21,TRAJ10,CAVSPKGGGGNKLTF,1,0,1,1
TRAV29DV5,TRAJ57,CAASSTQGGSEKLVF,1,0,1,1
TRAV35,TRAJ24,CAGHPAPDSWGKLQF,1,2,2,3
TRAV35,TRAJ37,CAGQLRSSNTGKLIF,1,0,1,1
TRAV17,TRAJ47,CATALTMEYGNKLVF,1,0,1,1
TRAV41,TRAJ45,CAVSYSGGGADGLTF,2,1,2,3
TRAV39,TRAJ48,CAVDMSNFGNEKLTF,1,0,1,1
TRAV13-1,TRAJ10,CASDILTGGGNKLTF,1,0,1,1
TRAV12-3,TRAJ21,CAPVSKAGNFNKFYF,1,0,1,1
TRAV13-1,TRAJ45,CAAIFPGGGADGLTF,1,0,1,1
TRAV13-1,TRAJ13,CAASIGSGGYQKVTF,1,0,1,1
TRAV23DV6,TRAJ39,CAARSGHNAGNMLTF,1,0,1,1
TRAV23DV6,TRAJ52,CAAKGGGTSYGKLTF,1,0,1,1
TRAV27,TRAJ18,CAGVSRGSTLGRLYF,1,0,1,1
TRAV13-2,TRAJ48,CAERRSNFGNEKLTF,1,0,1,1
TRAV12-3,TRAJ37,CAMSVRNSNTGKLIF,1,0,1,1
TRAV12-3,TRAJ6,CAMSAGSGGSYIPTF,1,4,2,5
TRAV14DV4,TRAJ49,CAMREAPNTGNQFYF,1,0,1,1
TRAV14DV4,TRAJ47,CAMREGTEYGNKLVF,1,0,1,1
TRAV12-3,TRAJ28,CAIPNSGAGSYQLTF,1,1,2,2
TRAV4,TRAJ5,CLVGDRDTGRRALTF,1,0,1,1
TRAV34,TRAJ37,CVVIPSSNTGKLIF,1,0,1,1
TRAV10,TRAJ47,CVVSLMEYGNKLVF,1,0,1,1
TRAV36DV7,TRAJ39,CAFSPGNAGNMLTF,2,0,1,2
TRAV38-2DV8,TRAJ54,CAYRDLQGAQKLVF,1,0,1,1
TRAV9-2,TRAJ11,CALTTNSGYSTLTF,1,1,2,2
TRAV9-2,TRAJ9,CALSSNTGGFKTIF,1,0,1,1
TRAV20,TRAJ24,CAVRTSDSWGKLQF,1,0,1,1
TRAV20,TRAJ24,CAVRATDSWGKLQF,1,0,1,1
TRAV20,TRAJ9,CAVQAVSGGFKTIF,1,0,1,1
TRAV20,TRAJ20,CAVQAGSKDYKLSF,1,0,1,1
TRAV8-3,TRAJ39,CAVGAKNAGNMLTF,1,0,1,1
TRAV8-3,TRAJ10,CAVGLTGGGNKLTF,1,0,1,1
TRAV36DV7,TRAJ15,CAVGLNQAGTALIF,1,0,1,1
TRAV2,TRAJ40,CAVEDNSGTYKYIF,1,0,1,1
TRAV2,TRAJ36,CAVEVGAGANNLFF,1,0,1,1
TRAV2,TRAJ6,CAVEKSGGSYIPTF,1,0,1,1
TRAV35,TRAJ17,CAGQLKAAGNKLTF,1,0,1,1
TRAV35,TRAJ41,CAGRDTNSGYALNF,1,4,2,5
TRAV36DV7,TRAJ48,CALISNFGNEKLTF,1,0,1,1
TRAV14DV4,TRAJ52,CALAGGTSYGKLTF,1,0,1,1
TRAV12-2,TRAJ13,CAVFYSGGYQKVTF,1,0,1,1
TRAV8-1,TRAJ3,CAVSPYSSASKIIF,1,0,1,1
TRAV12-2,TRAJ36,CAVNSRTGANNLFF,2,2,2,4
TRAV12-2,TRAJ12,CAVNNKDSSYKLIF,1,0,1,1
TRAV23DV6,TRAJ8,CAALGITGFQKLVF,1,0,1,1
TRAV13-1,TRAJ3,CAAGISSSASKIIF,1,0,1,1
TRAV41,TRAJ57,CAATAQGGPEKLVF,1,0,1,1
TRAV13-1,TRAJ10,CAASFTGGGNKLTF,1,0,1,1
TRAV13-1,TRAJ20,CAASHQLSDYKLSF,2,0,1,2
TRAV13-1,TRAJ29,CAASPNSGNTPLVF,1,0,1,1
TRAV27,TRAJ58,CAGAKETSGSRLTF,1,0,1,1
TRAV5,TRAJ3,CAESTYSSASKIIF,1,0,1,1
TRAV13-2,TRAJ39,CAENSGNAGNMLTF,1,0,1,1
TRAV12-3,TRAJ56,CAMSLSGANSKLTF,1,0,1,1
TRAV12-3,TRAJ11,CAMSWNSGYSTLTF,2,0,1,2
TRAV4,TRAJ15,CLVRSNQAGTALIF,1,0,1,1
TRAV4,TRAJ13,CLVVKSGGYQKVTF,1,0,1,1
TRAV4,TRAJ8,CLVAQNTGFQKLVF,1,0,1,1
TRAV4,TRAJ11,CLVGAPSGYSTLTF,1,1,2,2
TRAV4,TRAJ9,CLVGGNTGGFKTIF,1,0,1,1
TRAV4,TRAJ4,CLVDDPGGYNKLIF,1,0,1,1
TRAV26-1,TRAJ39,RIVRANNAGNMLTF,1,0,1,1
TRAV12-1,TRAJ24,CVVISDSWGKLQF,1,0,1,1
TRAV10,TRAJ15,CVVTGQAGTALIF,1,0,1,1
TRAV10,TRAJ33,CVVSARSNYQLIW,1,0,1,1
TRAV12-1,TRAJ12,CVVKKDSSYKLIF,1,0,1,1
TRAV9-2,TRAJ48,CALNPGGNEKLTF,1,0,1,1
TRAV8-3,TRAJ7,CAVGAYGNNRLAF,1,0,1,1
TRAV8-3,TRAJ44,CAVGAGTASKLTF,1,0,1,1
TRAV36DV7,TRAJ29,CAVGWSGNTPLVF,1,0,1,1
TRAV21,TRAJ30,CAVIYARDDKIIF,2,0,1,2
TRAV12-2,TRAJ36,CAVMQTGANNLFF,1,0,1,1
TRAV3,TRAJ20,CAVRDMRDYKLSF,2,0,1,2
TRAV2,TRAJ33,CAAGRDSNYQLIW,1,0,1,1
TRAV36DV7,TRAJ49,CAATRREGNQFYF,1,0,1,1
TRAV35,TRAJ26,CAGHRNYGQNFVF,1,0,1,1
TRAV23DV6,TRAJ57,CASTQGGSEKLVL,1,0,1,1
TRAV21,TRAJ10,CAVFTGGGNKLTF,2,0,1,2
TRAV12-3,TRAJ33,CAVPGDSNYQLIW,1,0,1,1
TRAV8-1,TRAJ23,CAVHNNQGGKLIF,1,0,1,1
TRAV12-2,TRAJ48,CAARNFGNEKLTF,1,0,1,1
TRAV13-1,TRAJ21,CAAARDNFNKFYF,1,0,1,1
TRAV13-1,TRAJ12,CAASMDSSYKLIF,1,0,1,1
TRAV23DV6,TRAJ16,CAASGRDGQKLLF,1,0,1,1
TRAV23DV6,TRAJ34,CAARRSTADKLIF,1,0,1,1
TRAV25,TRAJ8,CAGTGTGFQKLVF,1,0,1,1
TRAV27,TRAJ22,CAGFSGSARQLTF,1,0,1,1
TRAV27,TRAJ27,CAGELPHAGKSTF,1,0,1,1
TRAV13-2,TRAJ48,CAENSFGNEKLTF,1,0,1,1
TRAV12-3,TRAJ48,CAIGSFGNEKLTF,1,0,1,1
TRAV14DV4,TRAJ43,CAMREDANNDMRF,1,0,1,1
TRAV4,TRAJ37,CLFPSSNTGKLIF,1,0,1,1
TRAV4,TRAJ7,CLVGDHGNNRLAF,1,0,1,1
TRAV38-2DV8,TRAJ56,CSVGGANSKLTF,1,0,1,1
TRAV12-1,TRAJ20,CVVIPNDYKLSF,1,0,1,1
TRAV38-1,TRAJ5,CASTTGRRALTF,1,0,1,1
TRAV16,TRAJ52,CALIVSYGKLTF,1,0,1,1
TRAV22,TRAJ15,CAPHQAGTALIF,1,0,1,1
TRAV21,TRAJ16,CAVERDGQKLLF,1,0,1,1
TRAV8-3,TRAJ5,CAVDTGRRVLTF,1,0,1,1
TRAV20,TRAJ37,CAVRVDTGKLIF,1,0,1,1
TRAV8-3,TRAJ34,CAVGYNTDKLIF,2,0,1,2
TRAV21,TRAJ20,CAARSNDYKLSF,1,0,1,1
TRAV24,TRAJ3,CAFYSSASKIIF,1,0,1,1
TRAV25,TRAJ29,CAPNSGNTPLVF,1,0,1,1
TRAV38-1,TRAJ41,CARSNPGYALNF,1,0,1,1
TRAV20,TRAJ58,CAQETSGSRLTF,1,0,1,1
TRAV8-6,TRAJ53,CAVGGSNYKLTF,1,2,2,3
TRAV6,TRAJ13,CAISGGYQKVTF,2,0,1,2
TRAV13-1,TRAJ26,CAASNYGQNFVF,1,0,1,1
TRAV29DV5,TRAJ54,CAASQGAQKLVF,1,0,1,1
TRAV27,TRAJ11,CAGDPGYSTLTF,1,0,1,1
TRAV27,TRAJ27,CAGRTNAGKSTF,1,0,1,1
TRAV13-2,TRAJ49,CAERQWGNQFYF,1,0,1,1
TRAV13-2,TRAJ12,CAERKSSYKLIF,1,0,1,1
TRAV27,TRAJ58,CKGETSGSRLTF,1,0,1,1
TRAV3,TRAJ39,CASNAGNMLTF,1,0,1,1
TRAV9-2,TRAJ31,CALIVTARLMF,1,0,1,1
TRAV23DV6,TRAJ20,CAFSDDYKLSF,1,0,1,1
TRAV16,TRAJ47,CALQNGNKLVF,1,0,1,1
TRAV12-2,TRAJ20,CAVGYDYKLSF,1,0,1,1
TRAV12-2,TRAJ43,CAVTGNNDMRF,1,0,1,1
TRAV13-1,TRAJ49,CAANSGNQFYF,2,0,1,2
TRAV27,TRAJ29,CAGEGNTPLVF,1,0,1,1
TRAV14DV4,TRAJ16,CAMTDGQKLLF,1,0,1,1
TRAV4,TRAJ24,CPLGSWGKLQF,1,0,1,1
TRAV20,TRAJ22,CAVRPRQLTF,2,0,1,2
TRAV3,TRAJ20,CAVREGKLSF,1,0,1,1
TRAV13-1,TRAJ43,CAASPGDMRF,1,0,1,1
TRAV4,TRAJ3,CLVGASKIIF,1,0,1,1
TRAV16,TRAJ11,PPTLTF,1,0,1,1
TRAV35,TRAJ48,CAGRSNFGNEKLTF,1,0,1,1
TRAV13-2,TRAJ15,CAETLNQAGTALIF,1,0,1,1
TRAV14DV4,TRAJ12,CAMRAGSYKLIF,1,0,1,1
TRAV23DV6,TRAJ47,CAANLEYGNKLVF,1,0,1,1
TRAV12-1,TRAJ37,CVVASNTGKLIF,1,3,2,4
TRAV19,TRAJ53,CALSEAHLESGGSNYKLTF,1,0,1,1
TRAV13-1,TRAJ52,CAASNRGNAGGTSYGKLTF,1,0,1,1
TRAV38-2DV8,TRAJ42,CAYRSAQNYGGSQGNLIF,1,0,1,1
TRAV12-3,TRAJ52,CAMRASNAGGTSYGKLTF,1,0,1,1
TRAV14DV4,TRAJ4,CAMREGGYPSGGYNKLIF,1,0,1,1
TRAV12-1,TRAJ52,CVVNVNAGGTSYGKLTF,1,0,1,1
TRAV9-2,TRAJ32,CALSALNYGGATNKLIF,1,0,1,1
TRAV12-2,TRAJ52,CAVNGRAGGTSYGKLTF,1,0,1,1
TRAV13-2,TRAJ42,CAENGGNYGGSQGNLIF,2,0,1,2
TRAV12-3,TRAJ53,CAMGAWNSGGSNYKLTF,1,0,1,1
TRAV12-3,TRAJ28,CAMTAGYSGAGSYQLTF,1,0,1,1
TRAV12-3,TRAJ53,CAMSGGYSGGSNYKLTF,1,0,1,1
TRAV14DV4,TRAJ37,CAMRGLHGSSNTGKLIF,1,0,1,1
TRAV14DV4,TRAJ52,CAMRESAGGTSYGKLTF,1,0,1,1
TRAV4,TRAJ28,CLVGDKYSGAGSYQLTF,1,1,2,2
TRAV4,TRAJ42,CLVGEGLYGGSQGNLIF,1,0,1,1
TRAV38-1,TRAJ26,CAFMKQGYNYGQNFVF,1,0,1,1
TRAV19,TRAJ31,CALSEANGNNNARLMF,1,0,1,1
TRAV20,TRAJ57,CAVRDPSQGGSEKLVF,2,0,1,2
TRAV20,TRAJ18,CAVQAGRGSTLGRLYF,1,0,1,1
TRAV20,TRAJ18,CAVQGDRGSTLGRLYF,1,0,1,1
TRAV8-3,TRAJ45,CAVGSYSGGGADGLTF,1,0,1,1
TRAV2,TRAJ22,CAVEVTPSGSARQLTF,1,0,1,1
TRAV3,TRAJ23,CAVRDLDYNQGGKLIF,1,1,2,2
TRAV3,TRAJ38,CAVRDTLAGNNRKLIW,1,0,1,1
TRAV39,TRAJ52,CASSNAGGTSYGKLTF,1,0,1,1
TRAV13-1,TRAJ18,CAATPRRGSTLGRLYF,1,0,1,1
TRAV23DV6,TRAJ53,CAASMNSGGSNYKLTF,1,1,2,2
TRAV12-3,TRAJ52,CAMSVAGGTSYGKLTF,1,1,2,2
TRAV14DV4,TRAJ52,CAMREWRGTSYGKLTF,1,0,1,1
TRAV12-3,TRAJ53,CAMNREGGGSNYKLTF,1,0,1,1
TRAV4,TRAJ4,CLVGPRGSGGYNKLIF,1,0,1,1
TRAV4,TRAJ37,CLVGDNGSSNTGKLIF,1,0,1,1
TRAV12-1,TRAJ45,CVVSMAGGGADGLTF,1,0,1,1
TRAV9-2,TRAJ52,CALGRFGTSYGKLTF,1,0,1,1
TRAV16,TRAJ10,CALSGLTGGGNKLTF,1,0,1,1
TRAV20,TRAJ3,CAVHDVHSSASKIIF,1,0,1,1
TRAV2,TRAJ37,CAVEKGSSNTGKLIF,1,0,1,1
TRAV3,TRAJ6,CAVTIATGGSCIPTF,1,0,1,1
TRAV3,TRAJ29,CAVRDSNSGNTPLVF,1,0,1,1
TRAV3,TRAJ13,CAVRDLSGGYQKVTF,1,0,1,1
TRAV3,TRAJ13,CAVRDGPGGYQKVTF,1,0,1,1
TRAV3,TRAJ4,CAVRDMGGGYNKLIF,1,0,1,1
TRAV3,TRAJ15,CAVRDTHQAGTALIF,1,0,1,1
TRAV3,TRAJ17,CAVRDKGAAGNKLTF,1,0,1,1
TRAV20,TRAJ37,CAALLGSSNTGKLIF,1,0,1,1
TRAV17,TRAJ3,CATAPPYSSASKIIF,1,0,1,1
TRAV8-1,TRAJ6,CAVRLASGGSYIPTF,1,0,1,1
TRAV29DV5,TRAJ54,CAATSSIQGAQKLVF,1,0,1,1
TRAV29DV5,TRAJ29,CAASDFLSGNTPLVF,1,0,1,1
TRAV27,TRAJ53,CAGSNSGGSNYKLTF,1,0,1,1
TRAV5,TRAJ45,CAEAVGGGGADGLTF,2,0,1,2
TRAV5,TRAJ13,CAESRDSGGYQKVTF,1,0,1,1
TRAV12-3,TRAJ37,CAMSFFSSNTGKLIF,1,0,1,1
TRAV14DV4,TRAJ36,CAMREGETGANNLFF,1,0,1,1
TRAV12-3,TRAJ24,CASGGTTDSWGKLQF,1,0,1,1
TRAV4,TRAJ9,CLVGGSNTGGFKTIF,1,0,1,1
TRAV4,TRAJ8,CLVGDLRTGFQKLVF,1,0,1,1
TRAV30,TRAJ40,CGTGKSTSGTYKYIF,1,0,1,1
TRAV26-1,TRAJ39,CIVRVENNAGNMLTF,1,0,1,1
TRAV12-1,TRAJ3,CVVLPYSSASKIIF,1,0,1,1
TRAV12-1,TRAJ48,CVVILAFGNEKLTF,1,0,1,1
TRAV12-1,TRAJ3,CVVRIYSSASKIIF,1,0,1,1
TRAV12-1,TRAJ45,CVVNSGGGADGLTF,2,3,2,5
TRAV38-2DV8,TRAJ34,CAYRSAGNTDKLIF,1,0,1,1
TRAV9-2,TRAJ52,CALIGGTSYGKLTF,1,0,1,1
TRAV9-2,TRAJ30,CALSYLNRDDKIIF,1,0,1,1
TRAV9-2,TRAJ38,CALSDRGNNRKLIW,1,3,2,4
TRAV16,TRAJ3,CALTSRSSASKIIF,1,7,2,8
TRAV16,TRAJ39,CALSADNAGNMLTF,1,0,1,1
TRAV16,TRAJ18,CALKGGSTLGRLYF,1,0,1,1
TRAV2,TRAJ8,CAVPMNTGFQKLVF,2,0,1,2
TRAV41,TRAJ47,CAVASMEYGNKLVF,1,0,1,1
TRAV22,TRAJ40,CAVGLTSGTYKYIF,1,0,1,1
TRAV20,TRAJ43,CAVQARGNNNDMRF,1,0,1,1
TRAV8-3,TRAJ37,CAVGGSSNTGKLIF,2,1,2,3
TRAV8-3,TRAJ28,CAVGPGAGSYQLTF,1,0,1,1
TRAV12-1,TRAJ40,CAVTGTSGTYKYIF,1,0,1,1
TRAV21,TRAJ50,CAAPGRASYDKVIF,1,0,1,1
TRAV35,TRAJ42,CAGQDGGSQGNLIF,1,0,1,1
TRAV17,TRAJ6,CATVLSGGSYIPTF,1,1,2,2
TRAV17,TRAJ9,CATAPSGGGFKTIF,1,0,1,1
TRAV24,TRAJ6,CAFRGSGGSYIPTF,1,0,1,1
TRAV24,TRAJ50,CAFNGKTSYDKVIF,1,0,1,1
TRAV12-2,TRAJ49,CAPRGGNTGNQFYF,1,0,1,1
TRAV12-2,TRAJ50,CAVGPQTSYDKVIF,1,0,1,1
TRAV12-2,TRAJ48,CAVISNFGNEKLTF,1,0,1,1
TRAV12-2,TRAJ33,CAVRDPDSNYQLIW,1,0,1,1
TRAV12-2,TRAJ13,CAVKSRGGYQKVTF,1,0,1,1
TRAV12-2,TRAJ9,CAVKLLTGGFKTIF,1,0,1,1
TRAV13-1,TRAJ38,CAPSNGGNNRKLIW,1,0,1,1
TRAV13-1,TRAJ29,CAAPGRSGNTPLVF,1,0,1,1
TRAV29DV5,TRAJ50,CAATSKTSYDKVIF,1,0,1,1
TRAV13-1,TRAJ40,CAASPASGTYKYIF,1,0,1,1
TRAV13-1,TRAJ6,CAASEGGGSYIPTF,1,0,1,1
TRAV13-1,TRAJ29,CAASRFAGNTPLVF,1,0,1,1
TRAV23DV6,TRAJ34,CAASSNYNTDKLIF,1,0,1,1
TRAV23DV6,TRAJ12,CAASSGDSSCKLIF,1,0,1,1
TRAV27,TRAJ50,CAGERGASYDKVIF,1,0,1,1
TRAV27,TRAJ24,CAGEDSDGWGKLQF,1,0,1,1
TRAV5,TRAJ37,CAEFGSSNTGKLIF,1,0,1,1
TRAV5,TRAJ8,CAEDLNTGFQKLVF,1,0,1,1
TRAV5,TRAJ10,CAEMYTGGGNKLTF,1,2,2,3
TRAV5,TRAJ39,CAESLNNAGNMLTF,1,0,1,1
TRAV5,TRAJ13,CAERPSGGYQKVTF,1,0,1,1
TRAV13-2,TRAJ23,CAEKWSHQGGKLIF,1,1,2,2
TRAV12-3,TRAJ53,CAIHSGGSNYKLTS,1,0,1,1
TRAV14DV4,TRAJ11,CAMRIPSGYSTLTF,1,0,1,1
TRAV34,TRAJ40,CGADNRSGTYKYIF,1,0,1,1
TRAV4,TRAJ7,CLVPPTHGNNRLAF,1,0,1,1
TRAV4,TRAJ11,CLVASNSGYSTLTF,1,0,1,1
TRAV4,TRAJ9,CLVGDNTGGFKTIF,1,0,1,1
TRAV21,TRAJ57,CAVRTQGGSEKLVF,1,1,2,2
TRAV12-1,TRAJ5,CVVKDTGRRALTF,1,0,1,1
TRAV10,TRAJ33,CVVLKDSNYQLIW,1,0,1,1
TRAV38-2DV8,TRAJ49,CAYRRRTGNQFYF,1,0,1,1
TRAV9-2,TRAJ30,CALSARRDDKIIF,1,0,1,1
TRAV16,TRAJ29,CALKHSGNTPLVF,1,0,1,1
TRAV6,TRAJ34,CALAGYNTDKLIF,1,0,1,1
TRAV6,TRAJ9,CALGETGGFKTIF,1,0,1,1
TRAV16,TRAJ34,CALSPGNTDKLIF,1,0,1,1
TRAV16,TRAJ12,CALRGDSSYKLIF,1,0,1,1
TRAV17,TRAJ30,CAPRRMGDDKIIF,1,0,1,1
TRAV3,TRAJ4,CAVFSGGYNKLIF,1,0,1,1
TRAV22,TRAJ6,CAVLSGGSYIPTF,1,1,2,2
TRAV20,TRAJ48,CAVRGFGNEKLTF,1,0,1,1
TRAV20,TRAJ38,CAVQAGNNRKLIW,1,0,1,1
TRAV20,TRAJ47,CAVQAPYGNKLVF,1,0,1,1
TRAV22,TRAJ17,CAVVLAAGNKLTL,1,0,1,1
TRAV8-3,TRAJ11,CAVGGQGYSTLTF,1,0,1,1
TRAV8-3,TRAJ13,CAVGGLPGQKVTF,1,0,1,1
TRAV8-3,TRAJ49,CAVGRVTGNQFYF,1,0,1,1
TRAV2,TRAJ6,CAVEKGGSYIPTF,1,0,1,1
TRAV12-2,TRAJ40,CAVITSGTYKYIF,1,0,1,1
TRAV21,TRAJ58,CAVTETSGSRLTF,1,0,1,1
TRAV3,TRAJ34,CAVSRYNTDKLIF,2,0,1,2
TRAV3,TRAJ43,CAVRGWDNNDMRF,1,0,1,1
TRAV3,TRAJ20,CAVRDGNDYKLSF,1,1,2,2
TRAV36DV7,TRAJ31,CAGPLNNNARLMF,1,0,1,1
TRAV35,TRAJ49,CAGEPNTGNQFYF,1,0,1,1
TRAV17,TRAJ20,CATGRSNDYKLSF,1,0,1,1
TRAV17,TRAJ39,CATEDNAGNMLTF,1,0,1,1
TRAV12-2,TRAJ37,CASLSSNTGKLIF,1,0,1,1
TRAV41,TRAJ58,CALHRTSGSRLTF,1,0,1,1
TRAV12-2,TRAJ20,CAVIRSNDYKLSF,1,0,1,1
TRAV12-2,TRAJ34,CAVRLYNTDKLIF,1,0,1,1
TRAV12-2,TRAJ22,CAVTSGSARQLTF,1,0,1,1
TRAV25,TRAJ23,CAGHYNQGGKLIF,1,0,1,1
TRAV12-3,TRAJ34,CASRSYNTDKLIF,1,0,1,1
TRAV39,TRAJ13,CASNSGGYQKVTF,1,0,1,1
TRAV12-3,TRAJ22,CACSSGSARQLTF,1,0,1,1
TRAV13-1,TRAJ15,CAALNQAGTALIF,1,0,1,1
TRAV13-1,TRAJ4,CAAPSGGYNKLIF,1,0,1,1
TRAV13-1,TRAJ40,CAAQDPGTYKYIF,1,0,1,1
TRAV23DV6,TRAJ57,CAATQGGSEKLVF,1,0,1,1
TRAV23DV6,TRAJ15,CAATSRAGTALIF,1,1,2,2
TRAV13-1,TRAJ47,CAATMEYGNKLVF,1,0,1,1
TRAV13-1,TRAJ45,CAASGGGADGLTF,1,0,1,1
TRAV13-1,TRAJ40,CAASITGTYKYIF,1,0,1,1
TRAV13-1,TRAJ9,CAASKTGGFKTIF,1,0,1,1
TRAV23DV6,TRAJ21,CAASRGNFNKFYF,2,0,1,2
TRAV27,TRAJ35,CAGSIGFGNVLHC,1,0,1,1
TRAV25,TRAJ29,CAGRRPGNTPLVF,2,0,1,2
TRAV25,TRAJ27,CAGINTNAGKSTF,1,0,1,1
TRAV25,TRAJ39,CAGRDNAGNMLTF,1,0,1,1
TRAV5,TRAJ5,CAESIAGRRALTF,1,0,1,1
TRAV14DV4,TRAJ39,CAMRGNAGNMLTF,1,0,1,1
TRAV4,TRAJ17,CLVGDGGGNKLTF,1,0,1,1
TRAV4,TRAJ23,CLVDFNQGGKLIF,1,0,1,1
TRAV4,TRAJ27,CLAEGTNAGKSTF,1,0,1,1
TRAV26-1,TRAJ43,CIVRSYNNNDMRF,1,0,1,1
TRAV26-1,TRAJ41,CIDHSNSGYALNF,1,0,1,1
TRAV12-3,TRAJ3,YAMSGSSASKIIF,1,0,1,1
TRAV12-1,TRAJ34,CVVNTYTDKLIF,1,0,1,1
TRAV12-1,TRAJ27,CVVNTNAGKSTF,1,3,2,4
TRAV21,TRAJ8,CASHTGFQKLVF,1,0,1,1
TRAV9-2,TRAJ26,CALLDYGQSFVF,1,0,1,1
TRAV9-2,TRAJ5,CALGRGRRALTF,1,0,1,1
TRAV9-2,TRAJ47,CALSGGGNKLVF,1,0,1,1
TRAV20,TRAJ16,CAVLDGGQKLLF,1,0,1,1
TRAV2,TRAJ49,CAVSNTGNQFYF,1,1,2,2
TRAV2,TRAJ9,CAVFTGGFKTIF,1,0,1,1
TRAV8-3,TRAJ39,CAVGNAGNMLTF,1,0,1,1
TRAV21,TRAJ45,CAVGGGADGLTF,2,1,2,3
TRAV22,TRAJ30,CAVDVADDKIIF,1,0,1,1
TRAV8-6,TRAJ21,CAVSAPFNKFYF,1,0,1,1
TRAV3,TRAJ33,CAVRYSNYQLIW,1,0,1,1
TRAV22,TRAJ26,CAAAARGQNFVF,1,0,1,1
TRAV35,TRAJ48,CAGDFGNEKLTF,1,0,1,1
TRAV13-1,TRAJ48,CAFHFGNEKLTF,1,0,1,1
TRAV23DV6,TRAJ5,CASGTGRRALTF,1,0,1,1
TRAV41,TRAJ54,CALRRGAQKLVF,1,0,1,1
TRAV6,TRAJ39,CAPLEAGNMLTF,1,0,1,1
TRAV39,TRAJ47,CAVDIWGNKLVF,1,0,1,1
TRAV13-1,TRAJ37,CAAPLDTGKLIF,1,0,1,1
TRAV39,TRAJ27,CAAALLGGKSTF,1,0,1,1
TRAV23DV6,TRAJ34,CAASYNTDKLIF,1,0,1,1
TRAV27,TRAJ34,CAGDPNTDKLIF,1,0,1,1
TRAV27,TRAJ7,CAGARGNNRLAF,1,0,1,1
TRAV14DV4,TRAJ31,CAMWGIRARLMF,2,0,1,2
TRAV14DV4,TRAJ27,CAMRDRAGKSTF,1,0,1,1
TRAV14DV4,TRAJ49,CAMREYGNQFYF,1,0,1,1
TRAV26-2,TRAJ9,CILNTGGFKTIF,2,0,1,2
TRAV26-2,TRAJ47,CILRGYGNKLVF,1,0,1,1
TRAV12-1,TRAJ20,CAVGGDYKLSF,1,0,1,1
TRAV22,TRAJ33,CAVDTNYQLIW,1,0,1,1
TRAV2,TRAJ20,CAVEDDYKFSF,1,0,1,1
TRAV21,TRAJ16,CAVRGGQKLLF,1,0,1,1
TRAV20,TRAJ43,CAVNNNNDMRF,1,0,1,1
TRAV21,TRAJ40,CAAGGTYKYIF,1,0,1,1
TRAV35,TRAJ43,CAGSNNNDMRF,1,0,1,1
TRAV12-2,TRAJ16,CAPSDGQKLLF,1,0,1,1
TRAV13-1,TRAJ13,CAPGGYQKVTF,1,0,1,1
TRAV25,TRAJ43,CAPKRNNDMRF,1,0,1,1
TRAV16,TRAJ16,CAPVRGQKLLF,1,1,2,2
TRAV13-1,TRAJ33,CAADSNYQLIW,2,1,2,3
TRAV13-1,TRAJ30,CAARRDDKIIF,1,0,1,1
TRAV13-2,TRAJ52,CAENIPPKLTF,1,0,1,1
TRAV4,TRAJ49,CLGTFGNQFYF,1,0,1,1
TRAV26-1,TRAJ43,CIVRVLGDMRF,1,0,1,1
TRAV38-2DV8,TRAJ43,CAPPPRDMRF,1,0,1,1
TRAV2,TRAJ34,CAVRTDKLIF,1,0,1,1
TRAV13-1,TRAJ20,CAANDYKLSF,2,1,2,3
TRAV24,TRAJ58,CALGGSRLTF,1,0,1,1
TRAV13-1,TRAJ30,CAAPKGKIIF,1,0,1,1
TRAV4,TRAJ20,CPSDYKLSF,1,0,1,1
TRAV34,TRAJ21,CAGAVTHF,1,0,1,1
TRAV12-1,TRAJ21,CVVNGADNFNKFYF,1,0,1,1
TRAV24,TRAJ34,CAFHPWNTDKLIF,1,0,1,1
TRAV24,TRAJ12,CAFAMDSSYKLIF,1,0,1,1
TRAV36DV7,TRAJ43,CAVDDNDMRF,1,0,1,1
TRAV21,TRAJ45,CAVPMYSGGGADGLTF,1,1,2,2
TRAV17,TRAJ43,CATDAIVNNNDMRF,1,0,1,1
TRAV12-1,TRAJ42,CVVNGGSQGNLII,1,0,1,1
TRAV2,TRAJ36,CAPLTGANNLFF,1,0,1,1
TRAV38-1,TRAJ52,CAFMKRLRAGGTSYGKLTF,1,0,1,1
TRAV20,TRAJ42,CAVQSSAWNYGGSQGNLIF,1,0,1,1
TRAV5,TRAJ38,CAETPPAHNAGNNRKLIW,1,4,2,5
TRAV26-2,TRAJ53,CILRDEWRSGGSNYKLTF,1,0,1,1
TRAV12-1,TRAJ37,CVVNLPRSSSNTGKLIF,1,0,1,1
TRAV16,TRAJ53,CALRALNSGGSNYKLTF,1,0,1,1
TRAV41,TRAJ57,CAVTHLGAQGGSEKLVF,1,0,1,1
TRAV41,TRAJ58,CAVRYWALETSGSRLTF,1,0,1,1
TRAV22,TRAJ18,CAVGAADRGSTLGRLYF,1,0,1,1
TRAV3,TRAJ36,CAVRPREGRTGANNLFF,1,0,1,1
TRAV24,TRAJ38,CAFIWSGNAGNNRKLIW,1,0,1,1
TRAV29DV5,TRAJ37,CAATMLYGSSNTGKLIF,1,0,1,1
TRAV14DV4,TRAJ41,CAMREQQLRNSGYALSF,1,0,1,1
TRAV14DV4,TRAJ12,CAMREGGEKGSSYKLIF,1,0,1,1
TRAV4,TRAJ32,CLVGDINYGGATNKLIF,1,0,1,1
TRAV26-1,TRAJ42,CIVRVGPYGGSQGNLIF,1,0,1,1
TRAV26-1,TRAJ48,CIVRVDPSNFGNEKLTF,1,0,1,1
TRAV12-1,TRAJ23,CVVDLHPYNQGGKLIF,1,0,1,1
TRAV12-1,TRAJ37,CVVSRLGSSNTGKLIF,1,0,1,1
TRAV38-2DV8,TRAJ32,CAYRSNYGGATNKLIF,1,0,1,1
TRAV38-2DV8,TRAJ26,CAYRSGDRNYGQNFVF,1,0,1,1
TRAV19,TRAJ4,CALWIRGSGGYNKLIF,1,0,1,1
TRAV3,TRAJ37,CAVRDIGSSNTGKLIF,1,0,1,1
TRAV3,TRAJ26,CAVRDKADNYGQNFVF,1,0,1,1
TRAV12-2,TRAJ45,CAAGMYSGGGADGLTF,1,0,1,1
TRAV8-1,TRAJ3,CAVNDPRDSSASKIIF,1,0,1,1
TRAV12-2,TRAJ52,CAVNISGGTSYGKLTF,1,0,1,1
TRAV8-1,TRAJ40,CAVKGEGTSGTYKYIF,1,0,1,1
TRAV13-1,TRAJ52,CAATLWRGTSYGKLTF,1,0,1,1
TRAV23DV6,TRAJ52,CAASGAGGTSYGKLTF,1,0,1,1
TRAV29DV5,TRAJ53,CAARGNSGGSNYKLTF,1,0,1,1
TRAV13-1,TRAJ40,CAAKAPSTSGTYKYIL,1,0,1,1
TRAV27,TRAJ20,CAGAVAPRASWETLSF,1,1,2,2
TRAV5,TRAJ44,CAESISPSGTASKLTF,1,0,1,1
TRAV12-3,TRAJ22,CAMSPVEAGSARQLTF,1,0,1,1
TRAV14DV4,TRAJ15,CAMRVAGGQAGTALIF,1,0,1,1
TRAV14DV4,TRAJ4,CAMREVFSGGYNKLIF,1,0,1,1
TRAV14DV4,TRAJ6,CAMREGPAGGSYIPTF,1,0,1,1
TRAV4,TRAJ42,CLFLGDYGGSQGNLIF,1,0,1,1
TRAV26-2,TRAJ13,CILRDMNSGGYQKVTF,1,0,1,1
TRAV26-1,TRAJ40,CIVRVGTTSGTYKYIF,1,1,2,2
TRAV12-1,TRAJ18,CVVLDRGSTLGRPYF,1,0,1,1
TRAV10,TRAJ15,CVVTSFNQAGTALIF,1,0,1,1
TRAV10,TRAJ46,CVVSWKKSSGDKLTF,1,0,1,1
TRAV12-1,TRAJ13,CVVNVNSGGYQKVTF,1,0,1,1
TRAV12-1,TRAJ41,CVVNTLSNSGYALNF,1,0,1,1
TRAV9-2,TRAJ7,CALRLPYYGNNRLAF,1,0,1,1
TRAV9-2,TRAJ44,CALSDLTGTASKLTF,1,0,1,1
TRAV9-2,TRAJ48,CALSKSNFGNEKLTF,1,0,1,1
TRAV9-2,TRAJ53,CALRNSGGSNYKLTF,1,0,1,1
TRAV16,TRAJ37,CALHHGSSNTGKLIF,1,0,1,1
TRAV16,TRAJ57,CALSPTQGGSEKLVF,1,0,1,1
TRAV16,TRAJ26,CALKLGDNYGQNFVF,1,0,1,1
TRAV23DV6,TRAJ50,CAVVRMKTSYDKVIF,1,0,1,1
TRAV20,TRAJ17,CAVQAVEAAGNKLTF,1,0,1,1
TRAV20,TRAJ18,CAVQERGSTLGRLYF,1,0,1,1
TRAV8-3,TRAJ13,CAVGAGSGGYQKVTF,1,0,1,1
TRAV8-3,TRAJ4,CAVGPVSGGYNKLIF,1,0,1,1
TRAV20,TRAJ45,CAVGDSGGGADGLTF,1,0,1,1
TRAV2,TRAJ36,CAVEWIPTGANNLFF,1,0,1,1
TRAV12-2,TRAJ42,CAVTTSGGSQGNLIF,1,0,1,1
TRAV8-3,TRAJ27,CAVSPYNTNAGKSTF,1,0,1,1
TRAV3,TRAJ44,CAVRDDTGTASKLTF,1,0,1,1
TRAV3,TRAJ21,CAVRDILYNFNKFYF,1,3,2,4
TRAV3,TRAJ18,CAVRDRGSTLGRLYF,1,0,1,1
TRAV12-2,TRAJ18,CALCGGGSTLGRLYF,1,0,1,1
TRAV8-1,TRAJ37,CAVIPGSSNTGKLIF,1,0,1,1
TRAV12-2,TRAJ13,CAVNSWDGGYQKVTF,1,1,2,2
TRAV12-2,TRAJ38,CAVNMYAGNNRKLIW,1,0,1,1
TRAV14DV4,TRAJ12,CAMRGPMDSSYKLIF,1,0,1,1
TRAV13-1,TRAJ45,CAASIQGGGADGLTF,1,0,1,1
TRAV13-1,TRAJ24,CAASIKSDSWGKLQF,1,0,1,1
TRAV13-1,TRAJ13,CAASKNSGGYQKVTF,1,0,1,1
TRAV23DV6,TRAJ13,CAASLQTGGYQKVTF,1,0,1,1
TRAV13-1,TRAJ26,CAASPFHNYGQNFVF,1,0,1,1
TRAV29DV5,TRAJ45,CAASATGGGADGLTF,1,0,1,1
TRAV29DV5,TRAJ52,CAASGSGTSYGKLTF,1,0,1,1
TRAV29DV5,TRAJ58,CAASGGETSGSRLTF,1,0,1,1
TRAV23DV6,TRAJ34,CAASKDPPNTDKLIF,1,0,1,1
TRAV23DV6,TRAJ40,CAARDVQAGTYKYIF,1,0,1,1
TRAV13-2,TRAJ32,CAETTPFGATNKLIF,1,0,1,1
TRAV13-2,TRAJ49,CAETGAKGTGNQFYF,1,0,1,1
TRAV13-2,TRAJ4,CAENGFSGGYNKLIF,1,0,1,1
TRAV13-2,TRAJ45,CAENESGGGADGLTF,1,0,1,1
TRAV12-3,TRAJ57,CAMSEAQGGSEKLVF,1,0,1,1
TRAV14DV4,TRAJ41,CAMRSISNSGYALNF,1,0,1,1
TRAV14DV4,TRAJ22,CAMRGFSGSARQLTF,1,0,1,1
TRAV14DV4,TRAJ9,CAMREGPGGGFKTIF,1,2,2,3
TRAV14DV4,TRAJ53,CAMREGGGSNYKLTF,1,0,1,1
TRAV4,TRAJ3,CLVAPEESSASKIIF,1,0,1,1
TRAV4,TRAJ48,CLVGDYNFGNEKLTF,1,0,1,1
TRAV4,TRAJ9,CLVGDPYTGGFKTIF,1,6,2,7
TRAV4,TRAJ23,CLVGDAYNQGGKLIF,1,0,1,1
TRAV4,TRAJ41,CLVGDMTGSGYALNF,1,0,1,1
TRAV4,TRAJ4,CLVGVISGGYNKLIF,1,0,1,1
TRAV26-2,TRAJ49,CILRDEEGTGNQFYF,1,0,1,1
TRAV26-2,TRAJ3,CILREEYSSASKIIF,1,0,1,1
TRAV26-1,TRAJ32,CIVRAKGGATNKLIF,1,0,1,1
TRAV12-1,TRAJ7,CVVTIRYGNNRLAF,1,0,1,1
TRAV12-1,TRAJ9,CVVNFGTGGFKTIF,2,0,1,2
TRAV12-1,TRAJ21,CVVNEGNNFNKFYF,1,0,1,1
TRAV38-1,TRAJ54,CAFMRIQGAQKLVF,1,0,1,1
TRAV9-2,TRAJ48,CALMRDFGNEKLTF,1,0,1,1
TRAV9-2,TRAJ42,CALTLGRSQGNLIF,1,0,1,1
TRAV9-2,TRAJ16,CALSDGTDGQKLLF,1,0,1,1
TRAV19,TRAJ12,CALSERDSSYKLIF,1,0,1,1
TRAV6,TRAJ6,CALEDTGGSYIPTF,1,0,1,1
TRAV16,TRAJ15,CALTSIQAGTALIF,1,0,1,1
TRAV16,TRAJ57,CAPCTQGGSERLVF,1,1,2,2
TRAV8-3,TRAJ39,CAVLNNNAGNMLTF,1,0,1,1
TRAV12-2,TRAJ45,CAVDSGGGADGLTF,1,0,1,1
TRAV20,TRAJ15,CAVRDNQAGTALIF,1,0,1,1
TRAV20,TRAJ26,CAVQARNYGQNFVF,1,0,1,1
TRAV20,TRAJ20,CAVQAPSNDYKLSF,1,0,1,1
TRAV22,TRAJ11,CAVVDGSGYSTLTF,1,0,1,1
TRAV8-3,TRAJ40,CAVVTTSGTYKYIF,2,0,1,2
TRAV8-3,TRAJ4,CAVALSGGYNKLIF,1,0,1,1
TRAV8-3,TRAJ6,CAVGAEGGSYIPTF,1,0,1,1
TRAV8-3,TRAJ39,CAVGDNNAGNMLTF,1,1,2,2
TRAV8-3,TRAJ42,CAVGKGGSQGNLIF,1,0,1,1
TRAV22,TRAJ45,CAVGAGGGTDGLTF,1,0,1,1
TRAV36DV7,TRAJ26,CAVEPDNYGQNFVF,1,0,1,1
TRAV2,TRAJ13,CAVEDWGGYQKVTF,1,0,1,1
TRAV3,TRAJ40,CAVSSFSGTYKYIF,1,0,1,1
TRAV3,TRAJ7,CAVRDSIGNNRLAF,1,0,1,1
TRAV35,TRAJ42,CAGLPGGSQGNLIF,1,0,1,1
TRAV12-2,TRAJ52,CAVLGGTSYGKLTF,1,0,1,1
TRAV12-2,TRAJ33,CAVMNRDSNYQLIW,1,0,1,1
TRAV8-1,TRAJ28,CAVSTGAGSYQLTF,1,0,1,1
TRAV8-1,TRAJ9,CAVNAYTGGFKTIF,1,0,1,1
TRAV12-2,TRAJ33,CAVNFRDSNYQLIW,1,0,1,1
TRAV8-1,TRAJ12,CAVNRMDSSYKLIF,1,1,2,2
TRAV12-2,TRAJ10,CAVNGAGGGNKLTF,1,0,1,1
TRAV12-2,TRAJ27,CAVNTHTNAGKSTF,1,0,1,1
TRAV12-2,TRAJ49,CAVNKRNTGNQFYF,1,0,1,1
TRAV13-1,TRAJ15,CAPTANQAGTALIF,1,1,2,2
TRAV23DV6,TRAJ13,CAARRAGGYQKVTF,1,0,1,1
TRAV13-1,TRAJ6,CAAAPLRGSYIPTF,1,0,1,1
TRAV23DV6,TRAJ21,CAALTTGNFNKFYF,1,0,1,1
TRAV29DV5,TRAJ44,CAAGRTGTASKLTF,1,0,1,1
TRAV13-1,TRAJ42,CAASWGGSQGNLIF,1,0,1,1
TRAV13-1,TRAJ7,CAASYGYGNNRLAF,1,0,1,1
TRAV13-1,TRAJ3,CAASIDSSASKIIF,1,0,1,1
TRAV13-1,TRAJ3,CAASIGPPASMIIF,1,0,1,1
TRAV23DV6,TRAJ47,CAASSMEYGNKLVF,1,0,1,1
TRAV29DV5,TRAJ39,CAASENNAGNMLTF,1,0,1,1
TRAV36DV7,TRAJ53,CAGGSGGSNYKLTF,1,1,2,2
TRAV27,TRAJ18,CAGGRGSTLGRLYF,1,1,2,2
TRAV27,TRAJ40,CAGARASGTYKYIF,1,0,1,1
TRAV5,TRAJ34,CAEPGDYNTDKLIF,1,0,1,1
TRAV5,TRAJ9,CAETFGTGGFKTIF,1,0,1,1
TRAV12-3,TRAJ5,CAMAGDTGRRALTF,1,0,1,1
TRAV12-3,TRAJ10,CAMSFTGGGNKLTF,1,0,1,1
TRAV12-3,TRAJ6,CAMSAGGGSYIPTF,1,0,1,1
TRAV12-3,TRAJ27,CAMSDGTNAGKSTF,1,0,1,1
TRAV14DV4,TRAJ30,CAMREPNRDDKIIF,1,0,1,1
TRAV14DV4,TRAJ29,CAMREFQGNTPLVF,1,0,1,1
TRAV4,TRAJ40,CLVGVASGTYKYIF,1,0,1,1
TRAV4,TRAJ22,CLVGGLGSARQLTF,1,0,1,1
TRAV4,TRAJ43,CLVGDPLPYNDMRF,1,0,1,1
TRAV4,TRAJ27,CLVGDSTNAGKSTF,1,0,1,1
TRAV26-2,TRAJ48,CILTPPFGNEKLTF,1,0,1,1
TRAV26-1,TRAJ39,CIVRGDNAGNMLTL,1,0,1,1
TRAV26-1,TRAJ29,CIVRPHSGNTPLVF,1,0,1,1
TRAV26-1,TRAJ40,CIVRASSGTYKYIF,1,0,1,1
TRAV12-1,TRAJ22,CVVPPGSARLLTF,1,0,1,1
TRAV12-1,TRAJ49,CVVDTNTGNQFYF,1,0,1,1
TRAV12-1,TRAJ37,CVVNPSNTGKLIF,1,0,1,1
TRAV38-1,TRAJ43,CAFMKGNNNDMRF,1,0,1,1
TRAV38-2DV8,TRAJ44,CAYRTGTASKLTF,1,0,1,1
TRAV16,TRAJ40,CALLTSGTYKYIF,1,0,1,1
TRAV9-2,TRAJ49,CALGLFTGNQFYF,1,0,1,1
TRAV16,TRAJ16,CALGLSDGQKLLF,1,0,1,1
TRAV9-2,TRAJ27,CALNPTHAGKSTF,1,0,1,1
TRAV16,TRAJ5,CALMRTGRRALTF,1,0,1,1
TRAV12-2,TRAJ10,CAVFTGGGNKLTL,1,0,1,1
TRAV3,TRAJ20,CAVLSSNDYKLSF,1,0,1,1
TRAV21,TRAJ48,CAVPDFGNEKLTF,1,0,1,1
TRAV20,TRAJ8,CAVQSRGFQKLVF,1,0,1,1
TRAV20,TRAJ17,CAVVEAAGNKLTF,1,0,1,1
TRAV20,TRAJ12,CAVGLDSSYKLIF,1,0,1,1
TRAV8-3,TRAJ7,CAVGNYGNNRLAF,1,0,1,1
TRAV2,TRAJ47,CAVEVLYGNKLVF,1,0,1,1
TRAV2,TRAJ16,CAVEGPDGQKLLF,1,0,1,1
TRAV2,TRAJ13,CAVEDRGYQKVTF,1,0,1,1
TRAV21,TRAJ35,CAVMIGFGNVLHC,1,0,1,1
TRAV12-3,TRAJ50,CAVTKTSYDKVIF,1,0,1,1
TRAV21,TRAJ33,CAVTGDSNYQLIW,1,0,1,1
TRAV3,TRAJ29,CAVRDSGNTPLVF,1,0,1,1
TRAV3,TRAJ12,CAVRDDSSYKLIF,1,0,1,1
TRAV3,TRAJ43,CAVRDDNNNDMRF,1,0,1,1
TRAV21,TRAJ44,CAVKAGTASKLTF,1,0,1,1
TRAV12-2,TRAJ39,CAGNNNAGNMLTF,1,0,1,1
TRAV17,TRAJ20,CATASSNDYKLSF,1,0,1,1
TRAV24,TRAJ39,CAFTGNAGNMLTF,1,0,1,1
TRAV12-2,TRAJ27,CAVGDTNAGKSTF,1,0,1,1
TRAV12-2,TRAJ30,CAVTSNRDDKIIF,1,0,1,1
TRAV12-2,TRAJ47,CAVTPSYGNKLVF,1,0,1,1
TRAV12-2,TRAJ53,CAVKRGSNYKLTF,1,0,1,1
TRAV12-2,TRAJ22,CAALSGSARQLTF,1,0,1,1
TRAV12-2,TRAJ32,CAIHGGATNKLIF,1,0,1,1
TRAV25,TRAJ26,CAGPDNYGQNFVF,1,0,1,1
TRAV12-3,TRAJ28,CAASGAGSYQLTF,1,0,1,1
TRAV29DV5,TRAJ54,CAASVPGAQKLVF,1,0,1,1
TRAV29DV5,TRAJ21,CAASEENFNKFYF,1,0,1,1
TRAV23DV6,TRAJ48,CAARSFGNEKLTF,1,0,1,1
TRAV27,TRAJ20,CAGTDSNDYKLSF,1,1,2,2
TRAV13-2,TRAJ5,CAENDTGRRALTF,1,0,1,1
TRAV5,TRAJ16,CAEKGSDGQKLLF,1,0,1,1
TRAV12-3,TRAJ34,CAMSLYNTDKLIF,1,0,1,1
TRAV14DV4,TRAJ16,CAMSSTDGQKLLF,1,0,1,1
TRAV12-3,TRAJ43,CAMSAEDNNDMRF,1,0,1,1
TRAV12-3,TRAJ9,CAMSGSGGFKTIF,1,0,1,1
TRAV12-3,TRAJ58,CAMSETSGSRLTF,1,0,1,1
TRAV12-3,TRAJ23,CAMSRNQGGKLIF,1,0,1,1
TRAV14DV4,TRAJ12,CAMNVDSSYKLIF,1,4,2,5
TRAV12-2,TRAJ50,CTVNRILYDKVIF,1,0,1,1
TRAV4,TRAJ37,CLFLSSNTGKLIF,1,0,1,1
TRAV4,TRAJ13,CLVGDRGYQKVTF,1,0,1,1
TRAV4,TRAJ4,CLVGDRGYNKLIF,1,1,2,2
TRAV4,TRAJ8,CLVGNTGFQKLVF,1,0,1,1
TRAV26-1,TRAJ31,CIVPRNNNARLMF,1,6,2,7
TRAV12-1,TRAJ30,CVVEQGGDKIIF,1,0,1,1
TRAV12-1,TRAJ27,CVVRTNAGKSTF,1,0,1,1
TRAV12-1,TRAJ7,CVVNGGNNRLAF,1,0,1,1
TRAV13-1,TRAJ45,CVAGGGADGLTF,1,0,1,1
TRAV38-2DV8,TRAJ34,CAYRGNTDKLIF,1,0,1,1
TRAV16,TRAJ48,CALLGGNEKLTF,1,0,1,1
TRAV9-2,TRAJ26,CALDNYGQNFVF,1,0,1,1
TRAV9-2,TRAJ49,CALSEADNQFYF,1,0,1,1
TRAV17,TRAJ24,CALTDSWGKLQF,2,3,2,5
TRAV2,TRAJ20,CAVHSNDYKLSF,1,0,1,1
TRAV21,TRAJ22,CAVYGSARQLTF,1,0,1,1
TRAV41,TRAJ54,CAVRPGAQKLVF,1,0,1,1
TRAV20,TRAJ20,CAVQANDYKLSF,1,0,1,1
TRAV20,TRAJ26,CAVQDYGQNFVF,1,0,1,1
TRAV22,TRAJ27,CAVGTNAGKSTF,1,0,1,1
TRAV36DV7,TRAJ57,CAVEPLSEKLVF,1,0,1,1
TRAV2,TRAJ8,CAVEEGFQKLVF,1,0,1,1
TRAV3,TRAJ7,CAVREWDNRLAF,1,0,1,1
TRAV12-2,TRAJ36,CAVNAGANNLFF,1,0,1,1
TRAV34,TRAJ35,CAAIGFGNVLHC,1,0,1,1
TRAV12-2,TRAJ31,CATLNNNARLMF,1,0,1,1
TRAV17,TRAJ5,CATDTGRRALTF,1,2,2,3
TRAV24,TRAJ9,CAFRTGGFKTIF,1,0,1,1
TRAV2,TRAJ23,CAVYNQGGKLIF,1,1,2,2
TRAV12-2,TRAJ20,CAVNFNDYKLSF,1,0,1,1
TRAV12-2,TRAJ49,CAVNEFGNQFYF,1,0,1,1
TRAV12-3,TRAJ9,CASHTGGFKTIF,1,0,1,1
TRAV12-3,TRAJ13,CAPGWGYQKVTF,1,0,1,1
TRAV13-1,TRAJ49,CAVTPSGNQFYF,1,0,1,1
TRAV5,TRAJ41,CAVSNSGYALNF,1,0,1,1
TRAV13-1,TRAJ40,CAAQSRTYKYIF,1,0,1,1
TRAV13-1,TRAJ27,CAAIENAGKSTF,1,0,1,1
TRAV13-1,TRAJ12,CAASTSSYKLIF,1,0,1,1
TRAV13-1,TRAJ16,CAASKDGQKLLF,1,0,1,1
TRAV23DV6,TRAJ49,CAASSSGNQFYF,1,0,1,1
TRAV29DV5,TRAJ43,CAASRGGNDMRF,1,0,1,1
TRAV29DV5,TRAJ34,CAASVGTDKLIF,1,0,1,1
TRAV29DV5,TRAJ20,CAASANDYKLSF,1,0,1,1
TRAV23DV6,TRAJ31,CAASRGNARLMF,1,0,1,1
TRAV27,TRAJ34,CAGRYNTDKLIF,1,0,1,1
TRAV25,TRAJ54,CAGCRGAQKLVF,1,0,1,1
TRAV25,TRAJ13,CAESGGYQKVTF,1,0,1,1
TRAV5,TRAJ34,CAESGDTDKLIF,1,0,1,1
TRAV13-2,TRAJ20,CAENRSDYKLSF,1,0,1,1
TRAV12-3,TRAJ54,CAMAQGAQKLVF,1,0,1,1
TRAV12-3,TRAJ23,CAMGLQGGKLIF,1,0,1,1
TRAV12-3,TRAJ3,CAMDSSASKIIF,1,0,1,1
TRAV12-3,TRAJ50,CAMKTSYDKVIF,1,0,1,1
TRAV12-3,TRAJ43,CAIGRNNNDMRF,1,0,1,1
TRAV34,TRAJ57,CGAKGGSEKLVF,1,0,1,1
TRAV4,TRAJ34,CLVGYNTDKLIF,1,0,1,1
TRAV23DV6,TRAJ37,CHKRSNTGKLIF,1,0,1,1
TRAV8-3,TRAJ50,VTSETSYDKVIF,1,0,1,1
TRAV13-2,TRAJ32,SAGGATNKLIF,1,0,1,1
TRAV38-1,TRAJ54,CAFPGAQKLVF,1,0,1,1
TRAV12-3,TRAJ9,CALDGGFKTIF,1,0,1,1
TRAV36DV7,TRAJ57,CAQGGSEKLVF,1,0,1,1
TRAV21,TRAJ20,CAVRNDYKLSF,1,1,2,2
TRAV20,TRAJ43,CAVGNNNDMRF,1,0,1,1
TRAV21,TRAJ43,CAGYNNNDMRF,1,1,2,2
TRAV35,TRAJ12,CAGRSSYKLIF,2,0,1,2
TRAV22,TRAJ43,CAGHNNNDMRF,1,0,1,1
TRAV17,TRAJ43,CATDGVNDMRF,1,0,1,1
TRAV17,TRAJ43,CATDINNDMRF,1,0,1,1
TRAV17,TRAJ20,CATDSDYKLSF,1,0,1,1
TRAV12-2,TRAJ37,CAVSNTGKLIF,1,2,2,3
TRAV12-2,TRAJ26,CAVNSGQNFVF,1,0,1,1
TRAV13-1,TRAJ5,CAVTPGRALTF,1,0,1,1
TRAV25,TRAJ9,CAAPGGFKTIF,1,0,1,1
TRAV13-1,TRAJ34,CAASSTDKLIF,1,0,1,1
TRAV12-3,TRAJ43,CAMSPAEDMRF,1,0,1,1
TRAV4,TRAJ30,CLVGPRDKIIF,1,0,1,1
TRAV9-2,TRAJ43,CALSVDDMRF,1,0,1,1
TRAV12-2,TRAJ31,CAVRAARLMF,1,0,1,1
TRAV35,TRAJ43,CAGREYDMRF,1,0,1,1
TRAV13-1,TRAJ43,CAASPGDKRF,1,0,1,1
TRAV13-2,TRAJ22,CAEAARQLTF,1,0,1,1
TRAV39,TRAJ32,CAVENKLIF,1,0,1,1
TRAV3,TRAJ15,CRAGTALIF,1,0,1,1
TRAV25,TRAJ23,WGKLIF,1,0,1,1
TRAV21,TRAJ52,CAAHNAGGASYGKLTF,1,0,1,1
TRAV12-1,TRAJ15,CVVSLNQAGTALTF,1,0,1,1
TRAV13-2,TRAJ45,CAEKGGGADGLTF,1,0,1,1
TRAV12-3,TRAJ30,CAMSVGRDDKIIF,1,0,1,1
TRAV38-2DV8,TRAJ57,CAYRIPIITQGGSEKLVF,1,0,1,1
TRAV41,TRAJ52,CAVSGTDAGGTSYGKLTF,1,0,1,1
TRAV3,TRAJ45,CAVRALMYSGGGADGLTF,1,0,1,1
TRAV12-2,TRAJ18,CAVNKEADRGSTLGRLYF,1,0,1,1
TRAV29DV5,TRAJ45,CAATQTEYSGGGADGLTF,1,0,1,1
TRAV25,TRAJ28,CAGSSPPYSGAGSYQLTF,1,0,1,1
TRAV14DV4,TRAJ56,CAMREVTYYTGANSKLTF,1,2,2,3
TRAV10,TRAJ18,CVVSSADRGSTLGRLYF,1,0,1,1
TRAV38-1,TRAJ40,CAFMSTISTSGTYKYIF,1,0,1,1
TRAV38-1,TRAJ38,CAFTFPVNAGNNRKLIW,1,0,1,1
TRAV3,TRAJ18,CAVRDMYRGSTLGRLYF,1,0,1,1
TRAV12-2,TRAJ42,CAVNMGQYGGSQGNLIF,1,0,1,1
TRAV12-2,TRAJ48,CAVKGRISNFGNEKLTF,1,0,1,1
TRAV29DV5,TRAJ42,CAASGAYYGGSQGNLIF,1,0,1,1
TRAV13-1,TRAJ13,CAANPPPESGGYQKVTF,1,0,1,1
TRAV13-2,TRAJ45,CAENIGNSGGGADGLTF,1,0,1,1
TRAV12-3,TRAJ37,CAMSASHGSSNAGKLIF,1,0,1,1
TRAV14DV4,TRAJ10,CAMRELQLTGGGNKLTF,1,0,1,1
TRAV34,TRAJ45,CGADKIAVGGGADGLTF,1,0,1,1
TRAV4,TRAJ37,CLVGDHYGSSNTGKLIF,1,0,1,1
TRAV4,TRAJ17,CLVGDMAVKAAGNKLTF,1,0,1,1
TRAV4,TRAJ39,CLVGDRYTNNAGNMLTF,1,0,1,1
TRAV12-1,TRAJ48,CVVSRGSNFGNEKLTL,1,0,1,1
TRAV10,TRAJ42,CVVRTNYGGSQGNLIF,1,0,1,1
TRAV38-2DV8,TRAJ37,CAYGPRGSSNTGKLIF,1,2,2,3
TRAV38-2DV8,TRAJ45,CAYRWYSGGGADGLTF,1,0,1,1
TRAV38-2DV8,TRAJ40,CAYRSASTSGTYKYIF,1,0,1,1
TRAV9-1,TRAJ16,CALSGPRFSDGQKLLF,1,0,1,1
TRAV9-2,TRAJ42,CALSLNYGGSQGNLIF,1,0,1,1
TRAV9-2,TRAJ52,CALRGAGGTSYGKLTF,1,0,1,1
TRAV8-3,TRAJ16,CAVAAVSFSDGQKLLF,1,0,1,1
TRAV8-3,TRAJ42,CAVGALPGGSQGNLIF,1,0,1,1
TRAV36DV7,TRAJ28,CAVEGYSGAGSYQLTF,1,0,1,1
TRAV2,TRAJ37,CAVEDWGSSNTGKLIF,1,0,1,1
TRAV3,TRAJ38,CAVSLPNAGNNRKLIW,1,1,2,2
TRAV21,TRAJ45,CAVRMYSGGGADGLTF,1,0,1,1
TRAV3,TRAJ4,CAVRDSISGGYNKLIF,1,0,1,1
TRAV3,TRAJ4,CAVRDVFSGGYNKLIF,1,0,1,1
TRAV3,TRAJ40,CAVRDMSASGTYKYIF,1,0,1,1
TRAV3,TRAJ20,CAVRDTPLSNDYKLSF,1,0,1,1
TRAV35,TRAJ53,CAGQLGSGGSNYKLTF,1,0,1,1
TRAV39,TRAJ57,CAVDSYTQGGSEKLVF,1,0,1,1
TRAV12-2,TRAJ10,CAVRGRLTGGGNKLTF,1,0,1,1
TRAV13-1,TRAJ15,CAADEGANQAGTALIF,1,0,1,1
TRAV29DV5,TRAJ53,CAASSNSGGSNYKLTF,1,0,1,1
TRAV25,TRAJ52,CAGVGAGGTSYGKLTF,1,0,1,1
TRAV5,TRAJ42,CAEGGNYGGSQGNLIF,1,0,1,1
TRAV5,TRAJ44,CAESPLREGTASKLTF,1,0,1,1
TRAV13-2,TRAJ28,CAENLMPGAGSYQLTF,1,0,1,1
TRAV14DV4,TRAJ22,CAMSHWDSGSARQLTF,1,0,1,1
TRAV14DV4,TRAJ49,CAMREGGRGTGNQFYF,1,0,1,1
TRAV14DV4,TRAJ26,CAMREGGDNYGQNFVF,1,0,1,1
TRAV4,TRAJ44,CLVGEVNTGTASKLTF,1,0,1,1
TRAV26-2,TRAJ52,CILRPAGGTSYGKLTF,1,3,2,4
TRAV26-2,TRAJ41,CILRDANSNSGYALNF,1,0,1,1
TRAV26-1,TRAJ44,CIVRVVRPGTASKLTF,1,0,1,1
TRAV26-1,TRAJ13,CIVRVEDSGGYQKVTF,1,0,1,1
TRAV26-1,TRAJ53,CIVRASSGGSNYKLTF,1,0,1,1
TRAV10,TRAJ13,CVVSPNSGGYQKVTF,1,0,1,1
TRAV12-1,TRAJ32,CVVNLYGGATNELIF,1,0,1,1
TRAV38-2DV8,TRAJ28,CASVHSGAGSYQLTF,1,0,1,1
TRAV38-2DV8,TRAJ28,CAYRTSGAGSYQLTF,1,0,1,1
TRAV29DV5,TRAJ54,CALTPNLQGAQKLVF,1,0,1,1
TRAV9-2,TRAJ22,CALSALSGSARQLTF,1,0,1,1
TRAV9-2,TRAJ44,CALSDAPGTASKLTF,1,0,1,1
TRAV9-2,TRAJ54,CALSEVIQGAQKLVF,1,0,1,1
TRAV41,TRAJ54,CAVFPIIQGAQKLVF,1,0,1,1
TRAV21,TRAJ53,CAVPYSGGSNYKLTF,1,0,1,1
TRAV21,TRAJ28,CAVSYSGAGSYQLTF,1,0,1,1
TRAV41,TRAJ22,CAVRISSGSARQLTF,1,1,2,2
TRAV20,TRAJ42,CAVRGYGGSQGNLIF,1,0,1,1
TRAV20,TRAJ4,CAVQLFSGGYNKLIF,1,0,1,1
TRAV20,TRAJ13,CAVQAGSGGYQKVTF,1,0,1,1
TRAV20,TRAJ21,CAVQDEGYNFNKFYF,1,1,2,2
TRAV8-3,TRAJ22,CAVVSTSGSARQLTF,1,0,1,1
TRAV8-3,TRAJ17,CAVGSYGAAGNKLTF,1,0,1,1
TRAV8-3,TRAJ10,CAVGAWKGGGNKLTF,1,0,1,1
TRAV8-3,TRAJ39,CAVGAQNNAGNMLTF,1,0,1,1
TRAV8-3,TRAJ42,CAVGGYGGSQGNLIF,1,0,1,1
TRAV2,TRAJ29,CAVESPYSGNTPLVF,1,0,1,1
TRAV2,TRAJ39,CAVEDENNAGNMLTF,1,0,1,1
TRAV8-6,TRAJ12,CAVSVAMDSSYKLIF,1,0,1,1
TRAV21,TRAJ6,CAVRPPSGGSYIPTF,1,0,1,1
TRAV20,TRAJ39,CAVKSPNNAGNMLTF,1,0,1,1
TRAV8-3,TRAJ38,CAAGAEAGNNRKLIW,1,0,1,1
TRAV35,TRAJ42,CAGPNYGGSQGNLIF,1,0,1,1
TRAV17,TRAJ37,CATGHGSSNTGKLIF,1,0,1,1
TRAV17,TRAJ45,CATDLSGGGADGLTF,1,0,1,1
TRAV12-2,TRAJ37,CAVTGGSSNTGKLIF,1,0,1,1
TRAV8-1,TRAJ40,CAVNAQDSGTYKYIF,1,0,1,1
TRAV12-2,TRAJ48,CAVNRPNFGNEKLTF,1,0,1,1
TRAV12-2,TRAJ42,CAARGAGGSQGNLIF,1,0,1,1
TRAV13-1,TRAJ13,CAASMTSGGYQKVTL,1,0,1,1
TRAV13-1,TRAJ36,CAASSAVAGANNLFF,1,0,1,1
TRAV29DV5,TRAJ40,CAASAWTSGTYKYIF,1,0,1,1
TRAV13-1,TRAJ48,CAANPPNFGNEKLTF,1,0,1,1
TRAV25,TRAJ37,CAGPFGSSNTGKLIF,1,0,1,1
TRAV27,TRAJ53,CAGENSGGSNYKLTF,1,0,1,1
TRAV27,TRAJ53,CAGAYRGGSNYKLTF,1,0,1,1
TRAV13-2,TRAJ10,CAEISLTGGGNKLTF,1,0,1,1
TRAV13-2,TRAJ3,CAENIGYSSASKIIF,1,0,1,1
TRAV14DV4,TRAJ9,CAMREANTGGFKTIF,1,0,1,1
TRAV14DV4,TRAJ6,CAMREGGGGSYIPTF,1,0,1,1
TRAV23DV6,TRAJ10,CATSILTGGGNKLTF,1,0,1,1
TRAV4,TRAJ3,CLVGAKYSSASKIIF,1,0,1,1
TRAV4,TRAJ16,CLVGDRFSDGQKLLF,1,0,1,1
TRAV4,TRAJ5,CLVGDGNTGRRALTF,1,0,1,1
TRAV26-2,TRAJ22,CILRGLSGSARQLTF,1,0,1,1
TRAV26-2,TRAJ39,CILRDRNNAGNMLTF,1,0,1,1
TRAV26-1,TRAJ23,CIVRVGNNQGGKLIF,1,0,1,1
TRAV26-1,TRAJ48,CIVRVGNFGNEKLTF,1,0,1,1
TRAV8-2,TRAJ13,CVVSYSGGYQKVTF,1,1,2,2
TRAV36DV7,TRAJ31,CVISDRNNNARLMF,1,0,1,1
TRAV12-1,TRAJ10,CVVILTGGGNKLTF,1,0,1,1
TRAV12-1,TRAJ23,CVVTPYNQGGKLIF,1,0,1,1
TRAV10,TRAJ15,CVVSAWQAGTALIF,1,1,2,2
TRAV12-1,TRAJ4,CVVRGSGGYNKLIF,1,1,2,2
TRAV12-1,TRAJ3,CVVRRGSSASKIIF,1,2,2,3
TRAV12-1,TRAJ4,CVVNPAGGYNKLIF,1,0,1,1
TRAV38-2DV8,TRAJ39,CAFMGYGAGNMLTF,1,0,1,1
TRAV38-2DV8,TRAJ53,CAFPSGGSNYKLTF,1,0,1,1
TRAV38-1,TRAJ54,CAFMNLQGAQKLVF,1,0,1,1
TRAV17,TRAJ50,CASYKKTSYDKVIF,1,1,2,2
TRAV9-2,TRAJ28,CALTSGAGSYHLTF,1,0,1,1
TRAV9-2,TRAJ15,CALSFNQAGTALIF,1,1,2,2
TRAV9-2,TRAJ20,CALSLIRNDYKLSF,1,0,1,1
TRAV19,TRAJ34,CALSEPHNTDKLIF,1,0,1,1
TRAV9-2,TRAJ39,CALSTNNAGNMLTF,1,0,1,1
TRAV19,TRAJ40,CALRFRNGTYKYIF,1,0,1,1
TRAV16,TRAJ15,CALSGSQAGTALIF,1,0,1,1
TRAV9-2,TRAJ35,CAPCRGGFGNVLHC,1,0,1,1
TRAV2,TRAJ23,CAVLIYNQGGKLIF,1,0,1,1
TRAV8-3,TRAJ10,CAVLLTGGGNKLTF,1,0,1,1
TRAV41,TRAJ45,CAVRLGGGADGLTF,1,0,1,1
TRAV8-3,TRAJ30,CAVVPMNRDDKIIF,1,2,2,3
TRAV2,TRAJ5,CAVAADTGRRALTF,1,0,1,1
TRAV8-3,TRAJ40,CAVGSAAGTYKYIF,1,0,1,1
TRAV8-3,TRAJ9,CAVGALDGGFKTIF,1,0,1,1
TRAV2,TRAJ23,CAVGGYNQGGKLIF,1,0,1,1
TRAV22,TRAJ56,CAVGVTGANSKLTF,1,0,1,1
TRAV21,TRAJ37,CAVDGSSNTGKLIF,1,0,1,1
TRAV36DV7,TRAJ40,CAVERYSGTYKYIF,1,0,1,1
TRAV36DV7,TRAJ23,CAVEALSQGGKLIF,1,0,1,1
TRAV2,TRAJ9,CAVEDPTGGFKTIF,1,0,1,1
TRAV2,TRAJ6,CAVEEGGGSYIPTF,1,0,1,1
TRAV3,TRAJ3,CAVTRYSSASKIIF,1,0,1,1
TRAV8-4,TRAJ48,CAVTTIFGNEKLTF,1,0,1,1
TRAV8-4,TRAJ4,CAVSFSGGYNKLIF,1,0,1,1
TRAV3,TRAJ7,CAVRDPYGNNRLAF,1,0,1,1
TRAV3,TRAJ36,CAVRDQTGANNLFF,1,0,1,1
TRAV3,TRAJ22,CAVRDRGSARQLTF,1,0,1,1
TRAV3,TRAJ41,CAVRDNYSGYALNF,1,0,1,1
TRAV3,TRAJ3,CAALSEGSASKIIF,1,0,1,1
TRAV41,TRAJ42,CAARSEGSQGNLIF,1,0,1,1
TRAV22,TRAJ53,CAAGAGGSNYKLTF,1,0,1,1
TRAV12-2,TRAJ17,CAPMIKAAGNKLTF,1,0,1,1
TRAV24,TRAJ18,CAPDRGSTLGRLYF,1,0,1,1
TRAV36DV7,TRAJ57,CARLTQGGSEKLVF,1,0,1,1
TRAV39,TRAJ40,CAVAGTSGTYKYIF,1,0,1,1
TRAV12-2,TRAJ50,CAVIIETSYDKVIF,1,0,1,1
TRAV12-2,TRAJ15,CAVKSLQAGTALIF,1,0,1,1
TRAV12-2,TRAJ27,CAVKGHTNAGKSTF,1,0,1,1
TRAV12-2,TRAJ10,CAAPRSGGGNKLTF,1,0,1,1
TRAV12-2,TRAJ40,CAATGVSGTYKCIF,1,0,1,1
TRAV20,TRAJ22,CALWWGGSARQLTF,1,0,1,1
TRAV13-2,TRAJ54,CASPVYGGAQKLVF,1,0,1,1
TRAV25,TRAJ42,CAVSDGGSQGNLIF,1,0,1,1
TRAV13-1,TRAJ53,CAANSGGSNYKLTF,1,0,1,1
TRAV23DV6,TRAJ13,CAASRSGGYQKVTF,1,0,1,1
TRAV13-1,TRAJ45,CAAPQGGGADGLTF,1,0,1,1
TRAV23DV6,TRAJ10,CAATPTGGGNKLTF,1,0,1,1
TRAV13-1,TRAJ48,CAALSNFGNEKLTF,1,0,1,1
TRAV13-1,TRAJ15,CAATLNQAGTALIF,1,0,1,1
TRAV29DV5,TRAJ54,CAATPGQGAQKLVF,1,0,1,1
TRAV29DV5,TRAJ43,CAATELHNNNDMRF,1,0,1,1
TRAV13-1,TRAJ48,CAASPVFGNEKLTF,1,0,1,1
TRAV13-1,TRAJ53,CAASSGGSNYKLTF,1,0,1,1
TRAV13-1,TRAJ57,CAASNVGGSEKLVF,1,0,1,1
TRAV21,TRAJ4,CAASLSGGYNKLIF,1,0,1,1
TRAV29DV5,TRAJ40,CAASAISGTYKYIF,1,0,1,1
TRAV29DV5,TRAJ27,CAASGRTNAGKSTF,1,0,1,1
TRAV29DV5,TRAJ45,CAASEGGGADGLTF,1,0,1,1
TRAV13-1,TRAJ13,CAARYSGGYQKVTF,1,2,2,3
TRAV23DV6,TRAJ26,CAAKTGNYGQNFVF,1,0,1,1
TRAV27,TRAJ22,CAGAIRGSARQLTF,1,0,1,1
TRAV5,TRAJ10,CAETPPRGGNKLTF,1,0,1,1
TRAV13-2,TRAJ4,CAERSSGGYNKLIF,1,0,1,1
TRAV5,TRAJ41,CAERFVNSGYALNF,1,4,2,5
TRAV13-2,TRAJ6,CAENPSGGSYIPTF,1,0,1,1
TRAV13-2,TRAJ6,CAENIAGGSYIPTF,1,0,1,1
TRAV12-3,TRAJ18,CAMDRGSTLGRLYF,1,0,1,1
TRAV12-3,TRAJ12,CAMSPMDSSYKLIF,1,0,1,1
TRAV12-3,TRAJ50,CAMSAKTSYDKVIF,1,0,1,1
TRAV12-3,TRAJ44,CAMSKTGTASKLTF,1,0,1,1
TRAV14DV4,TRAJ42,CAMRPGGSQGNLIF,1,0,1,1
TRAV14DV4,TRAJ35,CAMRGLGFGNVLHC,1,0,1,1
TRAV14DV4,TRAJ7,CAMRTPYGNIRLAF,1,0,1,1
TRAV12-3,TRAJ32,CATRNGGATNKLIF,1,0,1,1
TRAV13-2,TRAJ3,CAKPGYGSASKIIF,1,0,1,1
TRAV4,TRAJ29,CLVVGPLGNTPLVF,1,0,1,1
TRAV4,TRAJ17,CLVGVITAGNKLTF,1,0,1,1
TRAV4,TRAJ13,CLVGDRGGYQKVTF,1,0,1,1
TRAV4,TRAJ40,CLVGTGSGTYKYIF,1,0,1,1
TRAV4,TRAJ3,CLVGEYSSASKIIF,1,0,1,1
TRAV26-2,TRAJ45,CIPRSGGGADGLTF,1,0,1,1
TRAV12-1,TRAJ35,CVVDIGFGNVLHC,1,0,1,1
TRAV10,TRAJ40,CVVIGSGTYKYIF,1,0,1,1
TRAV39,TRAJ48,CVVRPFGNEKLTF,1,0,1,1
TRAV12-1,TRAJ24,CVVNKSSWGKLQF,1,0,1,1
TRAV12-1,TRAJ43,CVVKAYNNNDMRF,1,0,1,1
TRAV10,TRAJ52,CVVGGTSYGKLTF,1,0,1,1
TRAV38-2DV8,TRAJ20,CAYRSAGDYKLSF,1,0,1,1
TRAV16,TRAJ35,CALGGGFGNVLHC,1,0,1,1
TRAV19,TRAJ40,CALTTSGTYKYIF,1,0,1,1
TRAV9-2,TRAJ31,CALGRNNNARLMF,1,0,1,1
TRAV9-2,TRAJ20,CALTVSNDYKLSF,1,0,1,1
TRAV9-2,TRAJ35,CALSEGFGNVLHC,1,0,1,1
TRAV9-2,TRAJ50,CALRTTSYDKVIF,1,0,1,1
TRAV16,TRAJ11,CALTNSGYSTLTF,1,0,1,1
TRAV16,TRAJ5,CALRGTGRRALTF,1,0,1,1
TRAV6,TRAJ29,CAPLNSGNTPLVF,1,0,1,1
TRAV9-2,TRAJ5,CAPMDTGRRALTF,1,0,1,1
TRAV38-2DV8,TRAJ29,CARADSGNTPLVF,1,0,1,1
TRAV12-2,TRAJ38,CAVYAGNNRKLIW,1,0,1,1
TRAV41,TRAJ43,CAVLPYNNNDMRF,1,0,1,1
TRAV21,TRAJ15,CAVLNQAGTALIF,1,0,1,1
TRAV3,TRAJ9,CAVLNTGGFKTIF,1,0,1,1
TRAV21,TRAJ49,CAVYGRAGNQFYF,1,3,2,4
TRAV20,TRAJ36,CAVQAAGANNLFF,1,0,1,1
TRAV20,TRAJ6,CAVQSGGSYIPTF,1,0,1,1
TRAV8-3,TRAJ6,CAVGAGGSYIPTF,1,1,2,2
TRAV8-3,TRAJ24,CAVGEILWGKLQF,1,0,1,1
TRAV2,TRAJ13,CAVGSGGYQKVTF,1,0,1,1
TRAV20,TRAJ5,CAVGRTGRRALTF,1,0,1,1
TRAV2,TRAJ15,CAVESQAGTALIF,1,0,1,1
TRAV21,TRAJ40,CAVEGSGTYKYIF,1,0,1,1
TRAV12-2,TRAJ58,CAVEETSGSRLTF,1,0,1,1
TRAV3,TRAJ40,CAVSPSGTYKYIF,1,0,1,1
TRAV12-2,TRAJ38,CAVRAGNNRKLIW,2,0,1,2
TRAV3,TRAJ11,CAVRAPGYSTLTF,1,0,1,1
TRAV3,TRAJ8,CAVRDIRFQKLAL,1,0,1,1
TRAV20,TRAJ15,CAVTNQAGTALIF,1,0,1,1
TRAV21,TRAJ39,CAASNNAGNMLTF,1,0,1,1
TRAV8-6,TRAJ33,CAAGMDSNYQLIW,1,0,1,1
TRAV21,TRAJ20,CAALYSNDYKLSF,1,0,1,1
TRAV12-2,TRAJ57,CAGAQGGSEKLVF,1,0,1,1
TRAV2,TRAJ38,CAGGAGNNRKLIW,1,0,1,1
TRAV17,TRAJ17,CATVKAAGNKLTF,1,0,1,1
TRAV17,TRAJ17,CATIKAAGNKLTF,1,0,1,1
TRAV8-3,TRAJ27,CASLYPNAGKSTF,1,0,1,1
TRAV3,TRAJ37,CAVDSSNTGKLIF,1,0,1,1
TRAV12-2,TRAJ34,CAVQSYNTDKLIF,1,0,1,1
TRAV12-2,TRAJ23,CAVDYNQGGKLIL,1,0,1,1
TRAV12-2,TRAJ43,CAVELRGNNDMRF,1,0,1,1
TRAV12-2,TRAJ11,CAVNRVMDSTLTF,1,0,1,1
TRAV21,TRAJ26,CACETDYGQNFVF,1,0,1,1
TRAV27,TRAJ33,CAGVMDSNYQLIW,1,0,1,1
TRAV27,TRAJ22,CADFSGSARQLTF,1,0,1,1
TRAV5,TRAJ13,CAVHSGGYQKVTF,1,0,1,1
TRAV12-3,TRAJ10,CAAHTGGGNKLTF,1,0,1,1
TRAV23DV6,TRAJ40,CAAGPSGTYKYIF,1,0,1,1
TRAV29DV5,TRAJ37,CAASYGNTGKLIF,1,0,1,1
TRAV23DV6,TRAJ37,CAARRENTGKLIF,1,0,1,1
TRAV13-1,TRAJ17,CAASSAAGNKLTF,1,0,1,1
TRAV13-1,TRAJ9,CAASEAGGFKTIF,1,0,1,1
TRAV13-1,TRAJ26,CAASMGYGQNFVF,1,0,1,1
TRAV29DV5,TRAJ53,CAASGRSNYKLTF,1,0,1,1
TRAV23DV6,TRAJ29,CAASMIRNTPLVF,1,0,1,1
TRAV13-1,TRAJ9,CAARNTGGFKTIF,1,0,1,1
TRAV13-1,TRAJ8,CAARNTGFQKLVF,1,0,1,1
TRAV27,TRAJ37,CAGLPSNTGKLIF,1,0,1,1
TRAV25,TRAJ40,CAGPSSGTYKYIF,1,0,1,1
TRAV25,TRAJ34,CAGTHIGTDKLIF,1,0,1,1
TRAV27,TRAJ33,CAGPLDSNYQLIW,1,0,1,1
TRAV27,TRAJ37,CAGESGNTGKLIF,1,0,1,1
TRAV5,TRAJ15,CAERGQAGTALIF,1,0,1,1
TRAV13-2,TRAJ11,CAENYSGYSTLTF,1,0,1,1
TRAV13-2,TRAJ21,CAENMNNFNKFYF,1,0,1,1
TRAV13-2,TRAJ6,CAENIGGSYIPTF,1,0,1,1
TRAV12-3,TRAJ24,CAMGKGSWGKLQF,1,0,1,1
TRAV12-3,TRAJ37,CAMDSSNTGELIF,1,0,1,1
TRAV12-3,TRAJ9,CAMMATGGFKTIF,1,0,1,1
TRAV12-3,TRAJ34,CAMSPYNTDKLIF,1,0,1,1
TRAV12-3,TRAJ40,CAMSVGGTYKNIF,1,0,1,1
TRAV12-3,TRAJ21,CAMSAGNFNKFYF,1,0,1,1
TRAV12-3,TRAJ17,CAMRKAAGNKLTF,1,0,1,1
TRAV14DV4,TRAJ21,CAMRVGDFNKFYF,1,0,1,1
TRAV12-3,TRAJ7,CATSVYGNNRLAF,1,0,1,1
TRAV4,TRAJ5,CLVVATGRRALTF,1,0,1,1
TRAV4,TRAJ9,CLVGVNGGFKTIF,1,0,1,1
TRAV4,TRAJ26,CLVGDNYGQNFVF,1,0,1,1
TRAV4,TRAJ34,CLVGDRYTDKLIF,1,0,1,1
TRAV4,TRAJ21,CLVGDSYFNKFYF,1,0,1,1
TRAV30,TRAJ28,CGTLRAGSYQLTF,1,0,1,1
TRAV30,TRAJ15,CGTSNQAGTALIF,1,1,2,2
TRAV26-2,TRAJ40,CILTTSGTYKYIF,1,0,1,1
TRAV26-2,TRAJ56,CILLSGANSKLTF,1,0,1,1
TRAV26-2,TRAJ37,CILRKGNTGKLIF,1,0,1,1
TRAV12-1,TRAJ27,CVVILNAGKSTF,2,0,1,2
TRAV38-1,TRAJ43,CAFMKGSNDMRF,1,0,1,1
TRAV8-3,TRAJ9,CALGTGGFKTIF,1,0,1,1
TRAV6,TRAJ11,CALPSGYSTLTF,1,0,1,1
TRAV9-2,TRAJ26,CALSLYGQNFVF,1,0,1,1
TRAV6,TRAJ49,CALDLGGNQFYF,1,0,1,1
TRAV6,TRAJ33,CALETSNYQLIW,1,0,1,1
TRAV3,TRAJ24,CAPADSWGKLQL,1,0,1,1
TRAV9-2,TRAJ31,CAPRNNNARLMF,1,0,1,1
TRAV2,TRAJ5,CAVDTGRRALTF,1,0,1,1
TRAV2,TRAJ27,CAVRLNAGKTTF,1,0,1,1
TRAV3,TRAJ20,CAVRSNDYKLSF,1,0,1,1
TRAV20,TRAJ30,CAVQAGDDKIIF,1,0,1,1
TRAV20,TRAJ20,CAVQAYDYKLSF,1,0,1,1
TRAV20,TRAJ34,CAVQGDTDKLIF,1,0,1,1
TRAV20,TRAJ26,CAVQNYGQNFVF,1,1,2,2
TRAV2,TRAJ16,CAVEDSGRKLLF,1,0,1,1
TRAV8-3,TRAJ26,CAVENYGQNFVF,1,0,1,1
TRAV22,TRAJ21,CAVIYNFNKFYF,1,0,1,1
TRAV3,TRAJ34,CAVRGKTEKLIF,1,0,1,1
TRAV17,TRAJ29,CATASGNTPLVF,1,0,1,1
TRAV17,TRAJ20,CATDGNDYKLSF,1,0,1,1
TRAV17,TRAJ29,CATELGNTPLVF,1,3,2,4
TRAV24,TRAJ26,CAFNNYGQNFVF,1,0,1,1
TRAV24,TRAJ42,CARERSQGNLIF,1,0,1,1
TRAV39,TRAJ48,CAVLFGNEKLTF,1,0,1,1
TRAV12-2,TRAJ39,CAVIWAGNMLTF,1,0,1,1
TRAV12-2,TRAJ43,CAVIPNNNDMRF,1,0,1,1
TRAV2,TRAJ6,CAASGGSYIPTF,1,0,1,1
TRAV12-3,TRAJ9,CASYTGGFKTIF,1,0,1,1
TRAV13-1,TRAJ9,CAAPTGGFKTIF,1,0,1,1
TRAV29DV5,TRAJ43,CAANGNNNDMRF,1,0,1,1
TRAV13-1,TRAJ44,CAAAGTASKLTF,1,0,1,1
TRAV13-1,TRAJ6,CAALRGSYVPTF,1,0,1,1
TRAV13-1,TRAJ39,CAASGAGNMLTF,1,0,1,1
TRAV13-1,TRAJ31,CAATINNARLMF,1,0,1,1
TRAV13-1,TRAJ9,CAASTGGFKTIF,1,0,1,1
TRAV27,TRAJ7,CAGFYGNNRLAF,1,0,1,1
TRAV25,TRAJ48,CAGNFGNEKLTF,1,1,2,2
TRAV5,TRAJ20,CAEAANDYKLSF,1,0,1,1
TRAV13-2,TRAJ10,CAEGGGGNKLTF,1,0,1,1
TRAV14DV4,TRAJ37,CAMVGNTGKLIF,1,0,1,1
TRAV12-3,TRAJ34,CAMTEHTDKLIF,1,0,1,1
TRAV12-3,TRAJ49,CAMSVAGNQFYF,1,0,1,1
TRAV25,TRAJ18,CGRGSTLGRLYF,1,0,1,1
TRAV4,TRAJ21,CLVGDNFNKFYF,1,0,1,1
TRAV26-2,TRAJ36,CIPNTGANNLFF,1,0,1,1
TRAV26-1,TRAJ12,CIVADSSYKLIF,1,0,1,1
TRAV26-1,TRAJ43,CIVRVANNDMRF,1,0,1,1
TRAV26-1,TRAJ52,CTGGTSYGKLTF,1,3,2,4
TRAV9-2,TRAJ49,RALSEAGNQFYF,1,0,1,1
TRAV6,TRAJ23,CALAQGGKLIF,1,0,1,1
TRAV16,TRAJ8,CALRGFQKLVF,1,0,1,1
TRAV41,TRAJ49,CAVFTGNQFYF,1,0,1,1
TRAV2,TRAJ24,CAVVFWGKLQF,1,0,1,1
TRAV12-3,TRAJ49,CAVDTGNQFYF,1,0,1,1
TRAV12-2,TRAJ20,CAVIKDYKLSF,1,0,1,1
TRAV12-1,TRAJ47,CAAEYGNKLVF,1,0,1,1
TRAV20,TRAJ43,CAAYNNNDMRF,1,0,1,1
TRAV12-2,TRAJ6,CAAGGSYIPTF,1,0,1,1
TRAV24,TRAJ49,CAPNTGNQFYF,1,1,2,2
TRAV39,TRAJ15,CAVDTGTALIF,1,0,1,1
TRAV12-2,TRAJ49,CAVNRGNQFYF,1,0,1,1
TRAV39,TRAJ12,CAADSSYKLIF,1,0,1,1
TRAV23DV6,TRAJ34,CAASHTDKLIF,1,0,1,1
TRAV25,TRAJ43,CAGPDNNDMRF,1,0,1,1
TRAV25,TRAJ21,CAGRNFNKFYF,1,0,1,1
TRAV27,TRAJ49,CAGVSGNQFYF,1,5,2,6
TRAV12-3,TRAJ20,CAMSSDYKLSF,1,0,1,1
TRAV12-3,TRAJ56,CATGANSKLTF,1,0,1,1
TRAV25,TRAJ31,CTRNNNARLMF,1,0,1,1
TRAV4,TRAJ8,CLVGGFQKLVF,1,0,1,1
TRAV26-1,TRAJ34,CIAPLGDKLIF,1,0,1,1
TRAV13-1,TRAJ39,CVWAGNMLTF,1,0,1,1
TRAV9-2,TRAJ9,CALSGFKTIF,1,0,1,1
TRAV3,TRAJ30,CARAGDKIIF,1,0,1,1
TRAV12-2,TRAJ20,CAVRNYKLSF,1,0,1,1
TRAV12-2,TRAJ28,CASGSYQLTF,1,0,1,1
TRAV29DV5,TRAJ37,CAADTGKLIF,1,0,1,1
TRAV13-1,TRAJ47,CAASRHKLVF,1,1,2,2
TRAV29DV5,TRAJ49,CAASGNQFYF,1,0,1,1
TRAV25,TRAJ34,CAGPSDKLIF,1,0,1,1
TRAV25,TRAJ20,CAGTDYKLSF,1,0,1,1
TRAV27,TRAJ31,CADNNARLMF,1,1,2,2
TRAV25,TRAJ11,CADRYSTLTF,1,0,1,1
TRAV14DV4,TRAJ34,CAMITDKLIF,1,0,1,1
TRAV12-3,TRAJ23,CAMKGGKLIF,1,0,1,1
TRAV23DV6,TRAJ49,CEVTGNQFYF,1,0,1,1
TRAV4,TRAJ27,CLVVAGKSTF,1,0,1,1
TRAV26-2,TRAJ40,CISGTYKYIF,1,0,1,1
TRAV23DV6,TRAJ43,CAVNNDMRF,1,0,1,1
TRAV12-2,TRAJ29,CAVNTPLVF,1,0,1,1
TRAV12-2,TRAJ43,CAVNYDMRF,1,0,1,1
TRAV16,TRAJ20,CAQGDKLSF,1,0,1,1
TRAV12-3,TRAJ49,CAMRNQFYF,1,0,1,1
TRAV12-1,TRAJ23,ALGGGKLIF,1,0,1,1
TRAV21,TRAJ22,CFSRQLTF,1,0,1,1
TRAV12-2,TRAJ34,RAVRKLIF,1,0,1,1
TRAV27,TRAJ37,CAGDRPKGSSNTGKLIF,1,0,1,1
TRAV9-2,TRAJ32,CALRGGVEGATNKLIF,1,0,1,1
TRAV4,TRAJ11,CLVGDMNSGYSTLTF,1,0,1,1
TRAV21,TRAJ38,CAVHNAGNNRKLIW,1,1,2,2
TRAV36DV7,TRAJ58,CAVVKETSGSRLTF,1,1,2,2
TRAV3,TRAJ17,CAVREGGAGNKLTF,1,0,1,1
TRAV12-1,TRAJ41,CVVNMNSGYALNF,1,0,1,1
TRAV20,TRAJ13,CAVLSGGYQKVTF,1,0,1,1
TRAV26-2,TRAJ17,CIRYKAAGNKLTF,1,0,1,1
TRAV38-1,TRAJ52,CAFMKHESYGGTSYGKLTF,1,0,1,1
TRAV14DV4,TRAJ52,CAMSPSHAAGGTSYGKLTF,1,0,1,1
TRAV9-2,TRAJ54,CALSDSPYPGQGAQKLVF,1,0,1,1
TRAV9-2,TRAJ42,CALSDRWGYGGSQGNLIF,1,0,1,1
TRAV14DV4,TRAJ52,CAMREGHAGGTSYGKLTF,1,2,2,3
TRAV38-1,TRAJ30,CAFMKQTIMNRDDKIIF,1,0,1,1
TRAV38-2DV8,TRAJ45,CAYRSSYSGGGADGLTF,1,1,2,2
TRAV16,TRAJ17,CALSRLMIKAAGNKLTF,1,0,1,1
TRAV36DV7,TRAJ42,CAVEAEDYGGSQGNLIF,1,1,2,2
TRAV2,TRAJ39,CAVEDRHNNNAGNMLTF,1,0,1,1
TRAV12-2,TRAJ39,CAVNIRPSNNAGNMLTF,1,0,1,1
TRAV13-1,TRAJ45,CAASIYGSGGGADGLTF,1,0,1,1
TRAV13-1,TRAJ53,CAASSGNSGGSNYKLTF,1,0,1,1
TRAV23DV6,TRAJ22,CAASRDGTSGSARQLTF,1,0,1,1
TRAV27,TRAJ32,CAGASFLGGGATNKLIF,1,0,1,1
TRAV12-3,TRAJ52,CAMSANAGGTSYGKLTF,1,0,1,1
TRAV14DV4,TRAJ41,CAMREQQLRNSGYALNF,1,0,1,1
TRAV8-2,TRAJ32,CVVSDGYGGATSKLIF,1,0,1,1
TRAV8-2,TRAJ32,CVVSDGYGGATNKLIF,1,0,1,1
TRAV12-1,TRAJ37,CVVTSPLSSNTGKLIF,1,0,1,1
TRAV10,TRAJ20,CVVSLALVVNDYKLSF,1,0,1,1
TRAV38-2DV8,TRAJ41,CAYRRADPNSGYALNF,1,0,1,1
TRAV9-2,TRAJ9,CALYPTRNTGGFKTIF,1,0,1,1
TRAV9-2,TRAJ52,CALILAGGTSYGKLTF,1,0,1,1
TRAV9-2,TRAJ10,CALIPILTGGGNKLTF,1,0,1,1
TRAV29DV5,TRAJ44,CALSFINTGTASKLTF,1,0,1,1
TRAV6,TRAJ38,CALGSPNAGNNRKLIW,1,0,1,1
TRAV41,TRAJ42,CAVVMNYGGSQGNLIF,1,0,1,1
TRAV8-3,TRAJ10,CAVGDSLTGGGNKLTF,1,0,1,1
TRAV8-4,TRAJ38,CAVSGLGAGNNRKLIW,1,0,1,1
TRAV8-4,TRAJ52,CAVSLLGGTSYGKLTF,1,0,1,1
TRAV12-2,TRAJ42,CAVSIDYGGSQGNLIF,1,0,1,1
TRAV8-4,TRAJ48,CAVRSPSNFGNEKLTF,1,0,1,1
TRAV41,TRAJ45,CAAAVPSGGGADGLTF,1,0,1,1
TRAV17,TRAJ22,CATLPGSSGSARQLTF,1,0,1,1
TRAV17,TRAJ18,CATDSRRGSTLGRLYF,1,0,1,1
TRAV9-2,TRAJ22,CALIRISSGSARQLAF,1,0,1,1
TRAV12-2,TRAJ52,CAVGNAGGTSYGKLTF,1,0,1,1
TRAV14DV4,TRAJ50,CAVRESSKTSYDKVIF,1,0,1,1
TRAV13-1,TRAJ42,CAASNAYGGSQGNLIF,1,0,1,1
TRAV13-2,TRAJ52,CAESYAGGTSYGKLTF,1,0,1,1
TRAV12-3,TRAJ18,CAMSALRGSTLGRLYF,1,0,1,1
TRAV12-3,TRAJ10,CAMSGWGTGGGNKLTF,1,0,1,1
TRAV14DV4,TRAJ26,CAMREGPNNYGQNFVF,1,0,1,1
TRAV14DV4,TRAJ28,CAMRENSGAGSYQLTF,1,0,1,1
TRAV12-3,TRAJ52,CATPGAGGTSYGKLTF,1,0,1,1
TRAV34,TRAJ8,CGADPIPDTGFQKLVF,1,0,1,1
TRAV4,TRAJ28,CLVGGYSGAGSYQLTF,1,0,1,1
TRAV26-2,TRAJ52,CILRLAGGTSYGKLTF,1,0,1,1
TRAV26-2,TRAJ26,CILRDGGDNYGQNFVF,1,0,1,1
TRAV26-2,TRAJ52,CIPRLAGGTSYGKLTF,1,0,1,1
TRAV25,TRAJ18,CSGFDRGSTLGRLYF,1,0,1,1
TRAV10,TRAJ42,CVVVGYGGSQGSLIF,1,0,1,1
TRAV12-1,TRAJ42,CVVMNYGGSQGNLIF,1,0,1,1
TRAV12-1,TRAJ6,CVVNPSSGGSYIPTF,1,0,1,1
TRAV12-1,TRAJ35,CVVNIPGGFGNVLHC,1,0,1,1
TRAV38-1,TRAJ48,CAFMTSNFGNEKLTF,1,0,1,1
TRAV38-2DV8,TRAJ43,CAYRTPLLQNNDMRF,1,0,1,1
TRAV38-2DV8,TRAJ54,CAYRSEIQGAQKLVF,1,0,1,1
TRAV38-2DV8,TRAJ31,CAYRSAPRDNARLMF,1,0,1,1
TRAV9-2,TRAJ52,CALGRFGTSYGKLTY,1,0,1,1
TRAV9-2,TRAJ24,CALIPPTDSWGKLQF,1,0,1,1
TRAV9-2,TRAJ49,CALREGANTGNQFYF,1,0,1,1
TRAV21,TRAJ28,CAPLYSGAGSYQLTF,1,0,1,1
TRAV41,TRAJ42,CAVCRLGGSQGNLIF,1,0,1,1
TRAV8-3,TRAJ42,CAVLNYGGSQGNLIF,1,1,2,2
TRAV41,TRAJ50,CAVSTVETSYDKVIF,1,0,1,1
TRAV41,TRAJ45,CAVRSGGGGADGLTF,1,0,1,1
TRAV41,TRAJ58,CAVRNLETSGSRLTF,1,0,1,1
TRAV34,TRAJ42,CAVSNYGGSQGNLIF,1,0,1,1
TRAV20,TRAJ11,CAVQARNSGYSTLTF,1,0,1,1
TRAV22,TRAJ48,CAVAISNFGNEKLTF,1,0,1,1
TRAV2,TRAJ32,CAVETGSGATNKLIF,1,0,1,1
TRAV12-2,TRAJ38,CAVTGNAGNNRKLIW,1,0,1,1
TRAV8-4,TRAJ17,CAVSPGEAAGNKLTF,1,0,1,1
TRAV8-4,TRAJ13,CAVSVRSGGYQKVTF,1,0,1,1
TRAV12-2,TRAJ42,CAVSPRGGSQGNLIF,1,0,1,1
TRAV8-4,TRAJ22,CAVRFFSGSARQLTF,1,0,1,1
TRAV21,TRAJ40,CAVRPGTSGTYKYIF,1,0,1,1
TRAV3,TRAJ40,CAVRVTTSGTYKYIF,1,0,1,1
TRAV3,TRAJ21,CAVRDSGGNFNKFYF,1,0,1,1
TRAV3,TRAJ26,CAVRDLVYYGQNFVF,1,0,1,1
TRAV12-2,TRAJ42,CAVKNYGGSRGNLIF,1,0,1,1
TRAV24,TRAJ42,CAFRNYGGSQGNLIF,1,0,1,1
TRAV12-2,TRAJ28,CAFRNSGAGSYQLTF,1,0,1,1
TRAV8-1,TRAJ42,CAVNNYGGSQGNLIF,1,0,1,1
TRAV25,TRAJ53,CAALDSGGSNYKLTF,1,0,1,1
TRAV23DV6,TRAJ45,CAARYSGGGADGLTF,1,0,1,1
TRAV29DV5,TRAJ28,CAAPLSGAGSYQLTF,1,0,1,1
TRAV13-1,TRAJ22,CAASPLSGSARQLTF,1,0,1,1
TRAV13-1,TRAJ57,CAASPLQGGSEKLVF,1,0,1,1
TRAV13-1,TRAJ3,CAASKGYSSASKIIF,1,0,1,1
TRAV13-1,TRAJ8,CAASLMNTGFQKLVF,1,0,1,1
TRAV29DV5,TRAJ29,CAASGLNSGNTPLVF,1,0,1,1
TRAV23DV6,TRAJ40,CAASTATSGTYKYIF,1,0,1,1
TRAV29DV5,TRAJ53,CAARGSGGSNYKLTF,1,0,1,1
TRAV13-1,TRAJ13,CAAKLNSGGYQKVTF,1,0,1,1
TRAV27,TRAJ52,CAGNAGGTSYGKLTF,1,0,1,1
TRAV13-2,TRAJ53,CAEILSGGSNYKLTF,1,0,1,1
TRAV12-3,TRAJ42,CAMVDYGGSQGNLIF,1,0,1,1
TRAV12-3,TRAJ57,CAMSQTQGGSEKLVF,1,0,1,1
TRAV4,TRAJ3,CLRRGPYSSASKIIF,1,0,1,1
TRAV4,TRAJ5,CLVPPRNTGRRALTF,1,0,1,1
TRAV4,TRAJ5,CLVGGLDTGRRALTF,1,0,1,1
TRAV4,TRAJ9,CLVGDVNTGGFKTIF,1,0,1,1
TRAV4,TRAJ23,CLVGDGYNQGGKLIF,1,0,1,1
TRAV4,TRAJ15,CLVGERNQAGTALIF,1,0,1,1
TRAV26-2,TRAJ42,CILENYGGSQGNLIF,1,0,1,1
TRAV26-2,TRAJ23,CILRDVYNQGGKLIF,1,0,1,1
TRAV8-2,TRAJ6,CVVTRSGGSYIPTF,1,0,1,1
TRAV12-1,TRAJ17,CVVIVKAAGNKLTF,1,0,1,1
TRAV10,TRAJ40,CVVTPASGTYKYIF,1,0,1,1
TRAV12-1,TRAJ35,CVVSPIGFGNVLHC,1,0,1,1
TRAV12-1,TRAJ15,CVVNPSQAGTALIF,1,0,1,1
TRAV12-1,TRAJ29,CVVNPNSGNTPLVF,1,0,1,1
TRAV12-1,TRAJ31,CVVNTGGNNARLMF,1,0,1,1
TRAV38-1,TRAJ31,CAFMASSNNARLMF,1,0,1,1
TRAV38-2DV8,TRAJ12,CAYSPMDSSYKLIF,1,0,1,1
TRAV38-2DV8,TRAJ56,CAYRSTGANSKLTF,1,0,1,1
TRAV38-2DV8,TRAJ41,CAYRRLNSGYALNF,1,0,1,1
TRAV38-2DV8,TRAJ21,CAYRGVYNFNKFYF,1,0,1,1
TRAV38-2DV8,TRAJ49,CAYRSANTGNQFYF,1,0,1,1
TRAV6,TRAJ44,CALANTGTASKLTF,1,0,1,1
TRAV6,TRAJ10,CALILTGGGNKLTF,1,0,1,1
TRAV6,TRAJ37,CALAGSSNTGKLIF,1,0,1,1
TRAV9-2,TRAJ15,CALIPQQAGTALIF,1,0,1,1
TRAV9-2,TRAJ50,CALSLKTSYDKVIF,1,0,1,1
TRAV9-2,TRAJ9,CALSGLTGGFKTIF,1,0,1,1
TRAV9-2,TRAJ49,CALSETNTGNQFYF,1,0,1,1
TRAV6,TRAJ27,CALVPNTNAGKSTF,1,0,1,1
TRAV6,TRAJ49,CALDIGNTGNQFYF,1,0,1,1
TRAV16,TRAJ58,CALSRTLSGSRLTF,1,0,1,1
TRAV36DV7,TRAJ42,CAPYVGGSRGNLIF,1,0,1,1
TRAV41,TRAJ18,CAVTRGSTLGRLYF,1,0,1,1
TRAV41,TRAJ58,CAVNLRTSGSRLTF,1,0,1,1
TRAV22,TRAJ4,CAVPFSGGYNKLIF,1,0,1,1
TRAV20,TRAJ40,CAVRPYSGTYKYIF,1,0,1,1
TRAV20,TRAJ29,CAVQAPSGNTPLVF,1,0,1,1
TRAV22,TRAJ22,CAVAASGSARQLTF,1,0,1,1
TRAV8-3,TRAJ23,CAVGLYNQGGKLIF,1,0,1,1
TRAV8-3,TRAJ30,CAVGVGNRDDKIIF,1,0,1,1
TRAV8-3,TRAJ38,CAVGVTGNNRKLIW,1,0,1,1
TRAV8-3,TRAJ47,CAVGDMEYGNKLVF,1,0,1,1
TRAV20,TRAJ22,CAVGRAGSARQLTF,1,1,2,2
TRAV2,TRAJ23,CAVEVYNQGGKLIF,1,0,1,1
TRAV2,TRAJ40,CAVEITSGTYKYIF,1,0,1,1
TRAV12-2,TRAJ26,CAVTGGNYGQNFVF,1,0,1,1
TRAV8-4,TRAJ27,CAVSLNTNAGKSTF,1,0,1,1
TRAV8-4,TRAJ29,CAVSEIAGNTPLVF,1,0,1,1
TRAV3,TRAJ21,CAVSGPYNFNKFYF,1,0,1,1
TRAV21,TRAJ53,CAVRPEGSNYKLTF,1,0,1,1
TRAV12-3,TRAJ29,CAVRRNSGITPLVF,1,0,1,1
TRAV12-2,TRAJ45,CAVRQGGGADGLTF,1,0,1,1
TRAV3,TRAJ34,CAVRVFLNTDKLIF,1,0,1,1
TRAV3,TRAJ31,CAVRDSLNNARLMF,1,0,1,1
TRAV3,TRAJ29,CAVRDFRGNTPLVF,1,0,1,1
TRAV3,TRAJ5,CAVRDLGGRRALTF,1,0,1,1
TRAV3,TRAJ11,CAVRDMTGYSTLTF,1,2,2,3
TRAV3,TRAJ37,CAVRDISNTGKLIF,1,0,1,1
TRAV35,TRAJ35,CAGYVIGFGNVLHC,1,0,1,1
TRAV17,TRAJ16,CATARFSDGQKLLF,1,0,1,1
TRAV17,TRAJ54,CATGGIQGAQKLVF,1,0,1,1
TRAV24,TRAJ18,CASDRGSTLGRLYF,1,0,1,1
TRAV6,TRAJ54,CASTRSGGAQKLVF,1,0,1,1
TRAV6,TRAJ39,CALENNNAGNMLTF,1,0,1,1
TRAV13-1,TRAJ52,CAPAGGTSYGKLTF,1,0,1,1
TRAV6,TRAJ38,CAPTGAGNNRKLIW,1,0,1,1
TRAV23DV6,TRAJ45,CAPDSGGGADGLTF,1,0,1,1
TRAV39,TRAJ50,CAVRDITSYDKVTF,1,0,1,1
TRAV39,TRAJ24,CAVGRTDSWGKLQF,1,0,1,1
TRAV12-2,TRAJ39,CAVGLNNAGNMLTF,1,0,1,1
TRAV29DV5,TRAJ23,CAVRIYNQGGKLIF,1,0,1,1
TRAV8-1,TRAJ33,CAVNDKDSNYQLIW,1,0,1,1
TRAV12-2,TRAJ3,CAVNSYSSASKVIF,1,0,1,1
TRAV12-2,TRAJ30,CAVNIMNRDDKIIF,1,0,1,1
TRAV13-1,TRAJ26,CAVLTGGYGQNFVF,1,0,1,1
TRAV25,TRAJ52,CAVAGGTSYGKLTF,1,0,1,1
TRAV13-1,TRAJ11,CAAPLFSGYSTLTF,1,0,1,1
TRAV13-1,TRAJ6,CAAPPPGGSYIPTF,1,0,1,1
TRAV13-1,TRAJ48,CAAPRPFGNEKLTF,1,0,1,1
TRAV23DV6,TRAJ44,CAATVTGTASKLTF,1,1,2,2
TRAV23DV6,TRAJ36,CAARGETGANNLFF,1,0,1,1
TRAV13-1,TRAJ3,CAASSYSSASKIIF,1,0,1,1
TRAV13-1,TRAJ3,CAASQGSSASKIIF,1,0,1,1
TRAV13-1,TRAJ44,CAASISGTASKLTF,1,0,1,1
TRAV13-1,TRAJ16,CAASILSDGQKLLF,1,0,1,1
TRAV13-1,TRAJ8,CAASINTGFQKLVF,1,0,1,1
TRAV13-1,TRAJ9,CAASTRGGGFKTIF,1,0,1,1
TRAV23DV6,TRAJ57,CAASTGGGSEKLVF,1,0,1,1
TRAV13-1,TRAJ27,CAASTGTNAGKSTF,2,0,1,2
TRAV13-1,TRAJ13,CAASKAGGYQKVTF,1,0,1,1
TRAV23DV6,TRAJ34,CAASSNSNTDKLIF,1,0,1,1
TRAV29DV5,TRAJ41,CAASVADSGYALNF,1,0,1,1
TRAV29DV5,TRAJ57,CAASEQGGSEKLVF,1,1,2,2
TRAV12-3,TRAJ30,CAAKREYRDDRIIF,1,0,1,1
TRAV23DV6,TRAJ30,CAAKREYRDDKIIF,1,0,1,1
TRAV27,TRAJ20,CAGEASFNDYKLSS,1,0,1,1
TRAV27,TRAJ17,CAGKNKAAGNKLTF,1,0,1,1
TRAV13-2,TRAJ49,CADYPTNTGNQFYF,1,0,1,1
TRAV5,TRAJ29,CAEIPNSGNTPLVF,1,0,1,1
TRAV5,TRAJ9,CAETSNTGGFKTIF,1,0,1,1
TRAV5,TRAJ9,CAESLNTGGFKAIF,1,0,1,1
TRAV5,TRAJ4,CAESPSGGYNKLIF,1,0,1,1
TRAV13-2,TRAJ15,CAEKIRQAGTALIF,1,0,1,1
TRAV12-3,TRAJ44,CAIGQTGTASKLTF,1,0,1,1
TRAV12-3,TRAJ26,CAMTYYNYGQNFVF,1,0,1,1
TRAV12-3,TRAJ37,CAMSFSSNTGKLIF,1,0,1,1
TRAV34,TRAJ10,CAMSVKGGGNKLTF,1,0,1,1
TRAV12-3,TRAJ40,CAMSADSGTYKYIF,1,0,1,1
TRAV14DV4,TRAJ44,CAMRPTGTASKLTF,1,0,1,1
TRAV14DV4,TRAJ26,CAMREDDYGQNFVF,1,0,1,1
TRAV17,TRAJ28,CGATKGAGSYQLTF,1,0,1,1
TRAV4,TRAJ6,CLVALSGGSYIPTF,1,0,1,1
TRAV4,TRAJ5,CLVGDDTGRRALTF,1,0,1,1
TRAV4,TRAJ27,CLVGDIANAGKSTF,1,0,1,1
TRAV4,TRAJ27,CLVGDIGNAGKTTF,1,0,1,1
TRAV4,TRAJ39,CLVTRKNAGNMLTF,1,0,1,1
TRAV26-2,TRAJ22,CILTVAGSARQLTF,1,0,1,1
TRAV5,TRAJ10,RAETPPRGGNKLTF,1,0,1,1
TRAV3,TRAJ28,CVHSGAGSYQLTF,1,0,1,1
TRAV8-2,TRAJ33,CVVSGGSNYQLIW,1,0,1,1
TRAV12-1,TRAJ23,CVNFYNQGGKLIF,1,0,1,1
TRAV12-1,TRAJ22,CVVPPGSARQLTF,1,3,2,4
TRAV10,TRAJ42,CVVPRGSQGNLIF,1,0,1,1
TRAV12-1,TRAJ16,CVVIVSDGQKLLF,1,0,1,1
TRAV12-1,TRAJ26,CVVRDNYGQNFVF,1,0,1,1
TRAV12-1,TRAJ5,CVVNRAGRRALTF,1,0,1,1
TRAV12-1,TRAJ5,CVVKGTGRRALTF,1,0,1,1
TRAV38-1,TRAJ48,CAFKNDGNEKLTF,1,0,1,1
TRAV38-2DV8,TRAJ45,CAYLSGGADGLTF,1,0,1,1
TRAV38-2DV8,TRAJ43,CAYRSAGFDDMRF,1,0,1,1
TRAV9-2,TRAJ40,CALFTSGTYKYIF,1,0,1,1
TRAV16,TRAJ52,CALRGTSYGKLTF,1,0,1,1
TRAV16,TRAJ48,CALGSFGNERLTF,1,0,1,1
TRAV9-2,TRAJ40,CALGNSGTYKYIF,1,0,1,1
TRAV9-2,TRAJ12,CALSDDSSYKLIF,1,0,1,1
TRAV9-2,TRAJ30,CALSEVGDDKIIF,1,0,1,1
TRAV9-2,TRAJ58,CALRETSGSRLTF,1,0,1,1
TRAV6,TRAJ45,CALGEGGADGLTS,1,0,1,1
TRAV6,TRAJ40,CALDMGGTYKYIF,1,0,1,1
TRAV16,TRAJ49,CALRSPTGNQFYF,1,0,1,1
TRAV2,TRAJ39,CAPVRNAGNMLTF,1,0,1,1
TRAV23DV6,TRAJ44,CAQNTGTASKLTF,1,0,1,1
TRAV2,TRAJ6,CAVASGGSYIPTF,1,0,1,1
TRAV12-2,TRAJ30,CAVSLNRDDKIIF,1,0,1,1
TRAV12-2,TRAJ34,CAVQFYNTDKLIF,1,0,1,1
TRAV41,TRAJ32,CAVGGGPTNKLIF,1,0,1,1
TRAV41,TRAJ32,CAVGGGATNKLIF,1,0,1,1
TRAV41,TRAJ53,CAVGGGSNYKLTF,1,0,1,1
TRAV41,TRAJ48,CAVISFGNEKLTF,1,1,2,2
TRAV12-2,TRAJ42,CAVLGGSQGNLIF,1,0,1,1
TRAV20,TRAJ20,CAVQPSNDYKLSF,1,0,1,1
TRAV20,TRAJ22,CAVQGGSARQLTF,1,0,1,1
TRAV2,TRAJ24,CAVVTDSWGKLQF,1,0,1,1
TRAV8-3,TRAJ8,CAVGPTGFQKLVF,1,0,1,1
TRAV8-3,TRAJ39,CAVGPGAGNMLTF,1,0,1,1
TRAV8-3,TRAJ41,CAVGARSGYALNF,1,0,1,1
TRAV8-3,TRAJ3,CAVGYSSASKIIF,1,0,1,1
TRAV20,TRAJ9,CAVGGTGGFKTIF,1,0,1,1
TRAV12-2,TRAJ43,CAVTFYNNNDMRF,1,0,1,1
TRAV8-4,TRAJ36,CAVTQTGANNLFF,1,0,1,1
TRAV8-6,TRAJ49,CAVSSNSGNQFYF,1,0,1,1
TRAV12-2,TRAJ45,CAVRPQGADGLTF,1,0,1,1
TRAV3,TRAJ8,CAVRGGSFQKLVF,1,0,1,1
TRAV21,TRAJ15,CAVNDQAGTALIF,1,1,2,2
TRAV12-2,TRAJ20,CAAGLSNDYKLSF,1,0,1,1
TRAV35,TRAJ39,CAGHNNAGNMLTF,1,0,1,1
TRAV41,TRAJ34,CAGGGDNTDKLVF,1,0,1,1
TRAV23DV6,TRAJ57,CAEFQGGSEKLVF,1,0,1,1
TRAV8-3,TRAJ48,CAISNFGNEKLTF,1,0,1,1
TRAV17,TRAJ58,CATEETSGSRLTF,1,0,1,1
TRAV13-1,TRAJ36,CASQGPGANNLFF,1,0,1,1
TRAV29DV5,TRAJ40,CAVSTSGTYKYIF,1,0,1,1
TRAV2,TRAJ41,CAVNSNSGYALNF,1,2,2,3
TRAV12-2,TRAJ33,CAVNPDSNYQLIW,1,1,2,2
TRAV12-2,TRAJ21,CAVNANNFDKFYF,1,0,1,1
TRAV12-2,TRAJ34,CAVNTGNTDKLIF,1,0,1,1
TRAV12-2,TRAJ39,CAVKDNAGNMLTF,1,0,1,1
TRAV12-2,TRAJ41,CAVKIDSGYALNF,1,0,1,1
TRAV12-2,TRAJ39,CAARRGAGNMLTF,1,0,1,1
TRAV12-2,TRAJ17,CAAHKAAGNKLTF,1,0,1,1
TRAV36DV7,TRAJ53,CAEGGGSNYKLTF,1,0,1,1
TRAV24,TRAJ6,CAILSGGSYIPTF,1,0,1,1
TRAV12-3,TRAJ3,CASPYSSASKIIF,1,0,1,1
TRAV25,TRAJ32,CASNGGATNKLIF,1,0,1,1
TRAV12-3,TRAJ50,CAPSGTSYDKVIF,1,0,1,1
TRAV13-1,TRAJ49,CAAHPPPGNQFYF,1,0,1,1
TRAV23DV6,TRAJ37,CAAGSSNTGKLIF,1,0,1,1
TRAV13-1,TRAJ40,CAAIPSGTYKYIF,1,0,1,1
TRAV13-1,TRAJ40,CAASTSGTYKYTF,1,0,1,1
TRAV13-1,TRAJ42,CAASRRSQGNLIF,1,0,1,1
TRAV23DV6,TRAJ42,CAASGGSQGNLIF,1,0,1,1
TRAV23DV6,TRAJ48,CAASMLGNEKLTF,1,0,1,1
TRAV25,TRAJ6,CAGPAGGSYIPTF,1,0,1,1
TRAV25,TRAJ3,CAGGNSSASKIIF,1,0,1,1
TRAV27,TRAJ39,CAGPFNAGNMLTF,1,0,1,1
TRAV27,TRAJ37,CAGGSSNTGKLIF,1,1,2,2
TRAV25,TRAJ37,CADGSSNTGKLIF,1,1,2,2
TRAV13-2,TRAJ34,CAETFYNTDKLIF,1,0,1,1
TRAV13-2,TRAJ5,CAESDTGRRALTF,1,0,1,1
TRAV13-2,TRAJ43,CAENLPPYNDMRF,1,0,1,1
TRAV12-3,TRAJ30,CAMSMNRDDKIIF,1,0,1,1
TRAV12-3,TRAJ13,CAMSYGGYQKVTF,1,0,1,1
TRAV12-3,TRAJ17,CAMSAAAGNKLTF,1,0,1,1
TRAV12-3,TRAJ4,CAMRVWGYNKLIF,1,0,1,1
TRAV14DV4,TRAJ29,CAMREGPGTPLVF,1,0,1,1
TRAV14DV4,TRAJ3,CAMREGSASKIIF,1,0,1,1
TRAV12-3,TRAJ6,CAMKPGGSYIPTF,1,0,1,1
TRAV12-3,TRAJ35,CATLIGFGNVLHC,1,0,1,1
TRAV4,TRAJ40,CLVGVEGTYKYIF,1,0,1,1
TRAV4,TRAJ43,CLVGDFSNNDMRF,1,0,1,1
TRAV12-3,TRAJ45,CAYSGGGADGLTF,1,0,1,1
TRAV26-2,TRAJ49,CILRPRAGNQFYF,1,0,1,1
TRAV26-2,TRAJ29,CILRDSGNTPLVF,1,0,1,1
TRAV26-1,TRAJ23,CIVRVGQGGKLIF,1,0,1,1
TRAV26-1,TRAJ37,CIDGSSNTGKLIF,1,0,1,1
TRAV12-1,TRAJ23,CVVSNQGGKLIF,1,0,1,1
TRAV12-1,TRAJ9,CVVNTGGFKTIF,1,0,1,1
TRAV9-2,TRAJ27,CALSVIAGKSTF,1,0,1,1
TRAV1-2,TRAJ33,CAPKDSNYQLIW,1,0,1,1
TRAV23DV6,TRAJ10,CAQTGGGNKLTF,1,0,1,1
TRAV12-2,TRAJ57,CAVQGGSEKLVF,1,1,2,2
TRAV8-6,TRAJ40,CAVSPGTYKYIF,1,0,1,1
TRAV41,TRAJ54,CAVLAGAQKLVF,1,0,1,1
TRAV41,TRAJ26,CAVRPYGQNFVF,1,0,1,1
TRAV41,TRAJ49,CAVRGAGNQFYF,1,0,1,1
TRAV8-3,TRAJ3,CAVGAGASKIIF,1,0,1,1
TRAV2,TRAJ16,CAVEDSGQKLLF,1,1,2,2
TRAV12-2,TRAJ40,CAVILRTYKYIF,1,0,1,1
TRAV36DV7,TRAJ33,CAVMDSNYQLIW,1,2,2,3
TRAV8-4,TRAJ43,CAVSGNNNDMRF,1,0,1,1
TRAV8-4,TRAJ34,CAVSDNTDKLIF,1,0,1,1
TRAV23DV6,TRAJ11,CAVSSGYSTLTF,1,0,1,1
TRAV12-2,TRAJ43,CAVRPNNNDMRF,1,0,1,1
TRAV12-2,TRAJ35,CAVRGFGNVLHC,1,0,1,1
TRAV1-2,TRAJ33,CAVRDSNCQLIW,1,0,1,1
TRAV3,TRAJ31,CAVRDGNARLMF,1,0,1,1
TRAV22,TRAJ29,CAGPSGNTPLVF,1,1,2,2
TRAV17,TRAJ49,CATGGTGNQFYF,1,0,1,1
TRAV17,TRAJ54,CATSRGAQKMVF,1,0,1,1
TRAV24,TRAJ30,CAFTNRDDKIIF,1,0,1,1
TRAV23DV6,TRAJ34,CAPRGNTDKLIF,1,0,1,1
TRAV12-2,TRAJ9,CAVGPGGFKTIF,1,0,1,1
TRAV8-1,TRAJ47,CAVNSYGNKLVF,1,0,1,1
TRAV12-2,TRAJ49,CAVNQIGNQFYF,1,0,1,1
TRAV8-1,TRAJ27,CAVNTNAGKSTF,1,0,1,1
TRAV23DV6,TRAJ26,CATDNYGQNFVF,1,0,1,1
TRAV23DV6,TRAJ29,CAKVSGNTPLVF,1,0,1,1
TRAV12-3,TRAJ9,CASNTGGFKTIF,1,0,1,1
TRAV23DV6,TRAJ24,CAAWEGWGKLQF,1,0,1,1
TRAV13-1,TRAJ40,CAAYSGTYKYIF,1,0,1,1
TRAV23DV6,TRAJ33,CAAEDSSYQLIW,1,0,1,1
TRAV13-1,TRAJ33,CAASRSYYQLIW,1,0,1,1
TRAV29DV5,TRAJ31,CAASEMNARLMF,1,0,1,1
TRAV23DV6,TRAJ31,CAASKGNARLMF,1,0,1,1
TRAV25,TRAJ58,CAGRASGSRLTF,1,0,1,1
TRAV25,TRAJ9,CAGGTGGFKTIF,1,0,1,1
TRAV12-3,TRAJ43,CAGDHNNNDMRF,1,0,1,1
TRAV12-3,TRAJ52,CARPASYGKLTF,1,0,1,1
TRAV26-1,TRAJ11,CIPPEGYSTLTF,1,0,1,1
TRAV26-1,TRAJ34,CIVRVDGDKLIF,1,0,1,1
TRAV9-2,TRAJ32,WAGGGATNKLIF,1,0,1,1
TRAV25,TRAJ31,CSRNNNARLMF,1,0,1,1
TRAV12-1,TRAJ20,CVVNNDYKLSF,1,0,1,1
TRAV9-2,TRAJ23,CALNAGGKLIF,1,0,1,1
TRAV16,TRAJ52,CAPSGYGKLTF,1,0,1,1
TRAV41,TRAJ34,CAVRFADKLTF,1,0,1,1
TRAV8-3,TRAJ20,CAVGDDYKVSF,1,0,1,1
TRAV8-6,TRAJ43,CAVSDQDDVRF,1,0,1,1
TRAV12-2,TRAJ17,CAEAAGNKLTF,1,0,1,1
TRAV24,TRAJ20,CAFIGDYKLSF,1,0,1,1
TRAV12-2,TRAJ20,CAVWNDYKLSF,1,0,1,1
TRAV39,TRAJ30,CAVEVDDKIIF,1,0,1,1
TRAV8-1,TRAJ27,CAVMNAGKSTF,1,0,1,1
TRAV12-2,TRAJ43,CAVNSGNDMRF,1,0,1,1
TRAV16,TRAJ36,CAGGGANNLFF,1,0,1,1
TRAV35,TRAJ40,CATSGTYKYIF,1,0,1,1
TRAV29DV5,TRAJ49,CAARTGNQFYF,1,0,1,1
TRAV13-1,TRAJ7,CAASTINRLAF,1,0,1,1
TRAV13-1,TRAJ13,CAARGYQKVTF,1,0,1,1
TRAV13-1,TRAJ12,CAARLSYKLIF,1,0,1,1
TRAV25,TRAJ49,CAGWTGNQFYF,1,0,1,1
TRAV27,TRAJ47,CAGEYGNKLVF,1,0,1,1
TRAV5,TRAJ35,CAEGLGNVLHC,1,0,1,1
TRAV29DV5,TRAJ52,CAMASYGKLTF,1,0,1,1
TRAV13-2,TRAJ52,CGCTSYGKLTF,1,0,1,1
TRAV4,TRAJ20,CLVSVDYKLSF,1,0,1,1
TRAV26-2,TRAJ43,CILRENNDMRF,1,0,1,1
TRAV38-2DV8,TRAJ41,CAYNGYALNF,1,0,1,1
TRAV6,TRAJ6,CALSGYIPTF,1,0,1,1
TRAV9-2,TRAJ31,CALSGDRLMF,1,0,1,1
TRAV36DV7,TRAJ43,CAVPVNDMRF,1,0,1,1
TRAV12-2,TRAJ54,CAINWQELVF,1,0,1,1
TRAV12-3,TRAJ20,CAMYDYKLSF,1,0,1,1
TRAV17,TRAJ34,CGRNTDKLIF,1,0,1,1
TRAV12-1,TRAJ54,CGWGAQKLVF,1,0,1,1
TRAV8-3,TRAJ45,CAVGFDGLTF,1,0,1,1
TRAV12-2,TRAJ43,CAVRGDMRF,1,0,1,1
TRAV25,TRAJ20,RGYRYKLSF,1,0,1,1
TRAV13-1,TRAJ20,CVPGKLSF,1,0,1,1
TRAV26-2,TRAJ40,CIAMEYIF,1,0,1,1
TRAV13-1,TRAJ29,CASHF,1,0,1,1
TRAV21,TRAJ27,CAVRGTNAGKSTF,1,0,1,1
TRAV13-1,TRAJ27,CAAQETNAVKSTF,1,0,1,1
TRAV12-3,TRAJ39,CAMSVGAGNMLTF,1,0,1,1
TRAV26-2,TRAJ54,CILQGAPKLVF,1,0,1,1
TRAV13-1,TRAJ46,QKSSGDKLTF,0,2,1,2
TRAV13-2,TRAJ13,CAEEESYQKVTF,0,6,1,6
TRAV14DV4,TRAJ37,CAMREGEGSSNTGKLIF,0,6,1,6
TRAV8-1,TRAJ20,CAVNPRASNDYKLSF,0,3,1,3
TRAV22,TRAJ48,CAVVSNFGNEKLTF,0,2,1,2
TRAV9-2,TRAJ28,CALSYSGAGSYQLTF,0,3,1,3
TRAV6,TRAJ22,CALEKGSARQLTF,0,1,1,1
TRAV16,TRAJ53,CALKGIGGSNYKLTF,0,1,1,1
TRAV6,TRAJ11,CALDPPDSTLTF,0,1,1,1
TRAV20,TRAJ13,CAVYSGGYQKVTF,0,3,1,3
TRAV14DV4,TRAJ3,CAMREGGSSASKIIF,0,1,1,1
TRAV9-2,TRAJ20,CALSEGDYKLSF,0,2,1,2
TRAV23DV6,TRAJ57,CAAIQGGSEKLVF,0,1,1,1
TRAV13-1,TRAJ45,CAASIAPGGGADGLTF,0,2,1,2
TRAV38-2DV8,TRAJ15,CAYKGSNQAGTALIF,0,1,1,1
TRAV9-2,TRAJ8,CALSDITGFQKLVF,0,2,1,2
TRAV21,TRAJ28,CAAYSGAGSYQLTF,0,4,1,4
TRAV2,TRAJ26,CAVPDNYGQNFVF,0,1,1,1
TRAV12-1,TRAJ49,CVVSNTGNQFYF,0,1,1,1
TRAV13-1,TRAJ16,CAPYARFSDGQKLLF,0,1,1,1
TRAV14DV4,TRAJ42,CAMREGFYYGGSQGNLIF,0,1,1,1
TRAV22,TRAJ4,CAVGSGGYNKLIF,0,1,1,1
TRAV8-3,TRAJ30,CAVGAVGRDDKIIF,0,2,1,2
TRAV17,TRAJ9,CATDTGGFKTIF,0,2,1,2
TRAV13-1,TRAJ49,CAASIRGTGNQFYF,0,1,1,1
TRAV9-2,TRAJ48,CALSQEGNEKLTF,0,3,1,3
TRAV14DV4,TRAJ7,CATSRGGNNRLAF,0,2,1,2
TRAV14DV4,TRAJ6,CAMREGISGGSYIPTF,0,4,1,4
TRAV14DV4,TRAJ20,CAMRGPLDGSNDYKLSF,0,2,1,2
TRAV14DV4,TRAJ11,CAMREGNSGYSTLTF,0,1,1,1
TRAV38-2DV8,TRAJ49,CAYGGTGNQFYF,0,1,1,1
TRAV16,TRAJ34,CALGGTDKLIF,0,2,1,2
TRAV8-3,TRAJ13,CAVVLSNSGGYQKVTF,0,2,1,2
TRAV14DV4,TRAJ32,CAMRELNYGGATNKLIF,0,2,1,2
TRAV9-2,TRAJ42,CALNYGGSQGNLIF,0,2,1,2
TRAV21,TRAJ52,CAGLNAGGTSYGKLTF,0,3,1,3
TRAV17,TRAJ27,CATDAGHNTNAGKSTF,0,4,1,4
TRAV27,TRAJ39,CAGVPNNNAGNMLTF,0,2,1,2
TRAV12-1,TRAJ5,CVVYFDTGRRALTF,0,1,1,1
TRAV20,TRAJ57,CAVQRGGGSEKLVF,0,2,1,2
TRAV21,TRAJ11,CAVKRLGGYSTLTF,0,3,1,3
TRAV17,TRAJ4,CATALSGGYNKLIF,0,2,1,2
TRAV12-3,TRAJ30,CAIPPMNGDDKIIF,0,2,1,2
TRAV9-2,TRAJ39,CALMDNAGNMLTF,0,1,1,1
TRAV39,TRAJ49,CAVDLDTGNQFYF,0,1,1,1
TRAV12-2,TRAJ21,CAVKDNFNKFYF,0,3,1,3
TRAV14DV4,TRAJ20,CASNDYKLSF,0,3,1,3
TRAV9-2,TRAJ5,CALSKSTGRRALTF,0,2,1,2
TRAV5,TRAJ29,CAESMRGNTPLVF,0,2,1,2
TRAV2,TRAJ4,CAVEDGSGGYNKLIF,0,1,1,1
TRAV20,TRAJ15,CAVQGNQAGTALIF,0,2,1,2
TRAV17,TRAJ11,CATDLNSGYSTLTF,0,1,1,1
TRAV9-2,TRAJ11,CALMNSGYSTLTF,0,4,1,4
TRAV23DV6,TRAJ35,CAYRGGFGNVLHC,0,2,1,2
TRAV12-3,TRAJ10,CAMSEGGGNKLTF,0,1,1,1
TRAV26-2,TRAJ39,CIAKRNAGNMLTF,0,1,1,1
TRAV2,TRAJ9,CAVDTGGFKTIF,0,2,1,2
TRAV25,TRAJ29,CAGRGNTPLVF,0,1,1,1
TRAV17,TRAJ34,CATDALSTDKLIF,0,1,1,1
TRAV6,TRAJ33,CALAHMDSNYQLIW,0,1,1,1
TRAV13-1,TRAJ58,CAASFSGLTF,0,1,1,1
TRAV26-2,TRAJ18,CILLDRGSTLGRLYF,0,1,1,1
TRAV21,TRAJ6,CAVSGGSYIPTF,0,1,1,1
TRAV12-3,TRAJ48,CAMSARSNFGNEKLTF,0,1,1,1
TRAV13-1,TRAJ6,CAATSGSYIPTF,0,1,1,1
TRAV4,TRAJ10,CLVAVTGGGNKLTF,0,2,1,2
TRAV8-1,TRAJ48,CAALISNFGNEKLTF,0,1,1,1
TRAV26-2,TRAJ57,CILRDLQGGSEKLVF,0,1,1,1
TRAV20,TRAJ52,CAVQPGVINAGGTSYGKLTF,0,3,1,3
TRAV4,TRAJ40,CLVAVSTSGTYKYIF,0,2,1,2
TRAV8-3,TRAJ18,CAVGRGSTLGRLYF,0,1,1,1
TRAV8-1,TRAJ6,CAVISSGGSYIPTF,0,1,1,1
TRAV12-2,TRAJ9,CAVNKGTGGFKTIF,0,2,1,2
TRAV13-1,TRAJ15,CAASIGQAGTALIF,0,1,1,1
TRAV9-2,TRAJ34,CALSDRNTDKLIF,0,1,1,1
TRAV8-3,TRAJ40,CAVAISGTYKYIF,0,1,1,1
TRAV25,TRAJ44,CAGPTGTASKLTF,0,1,1,1
TRAV4,TRAJ31,CLVGEGNNARLMF,0,2,1,2
TRAV9-2,TRAJ48,CALSFGNEKLTF,0,2,1,2
TRAV8-3,TRAJ7,CAVLYGNNRLAF,0,2,1,2
TRAV2,TRAJ29,CAVNSGNTPLVF,0,3,1,3
TRAV2,TRAJ33,CAVEGNYQLIW,0,3,1,3
TRAV6,TRAJ41,CALDLPLPNSGYALNF,0,2,1,2
TRAV4,TRAJ10,CLVGGHILTGGGNKLTF,0,1,1,1
TRAV26-1,TRAJ52,CIVSFNAGGTSYGKLTF,0,2,1,2
TRAV12-1,TRAJ45,CVVTLYSGGGADGLTF,0,2,1,2
TRAV9-2,TRAJ42,CALSPNYGGSQGNLIF,0,2,1,2
TRAV3,TRAJ4,CAMRDWGTGGYNKPIF,0,1,1,1
TRAV12-2,TRAJ52,CAVRRPGGTSYGKLTF,0,1,1,1
TRAV12-2,TRAJ29,CAVNSLGRSGNTPLVF,0,1,1,1
TRAV38-1,TRAJ39,CAFMKGEDAGNMLTF,0,3,1,3
TRAV38-2DV8,TRAJ40,CAYRSSVSGTYKYIF,0,2,1,2
TRAV30,TRAJ23,CGTENGHNQGGKLIF,0,3,1,3
TRAV12-1,TRAJ9,CVVTAGTGGFKTIF,0,1,1,1
TRAV38-1,TRAJ5,CAFMKRAGRRALTF,0,1,1,1
TRAV8-3,TRAJ43,CAVVRPYNNNDMRF,0,1,1,1
TRAV21,TRAJ58,CAVSRETSGSRLTF,0,1,1,1
TRAV3,TRAJ33,CAVRAFYSNYQLIW,0,2,1,2
TRAV12-3,TRAJ40,CAMSATSGTYKYIF,0,4,1,4
TRAV12-3,TRAJ54,CAMSANQGAQKLVF,0,1,1,1
TRAV14DV4,TRAJ13,CAMRDPGGYQKVTF,0,1,1,1
TRAV12-1,TRAJ11,CVVNTPGYSTLTF,0,2,1,2
TRAV8-3,TRAJ13,CAVGALGYQKVTF,0,2,1,2
TRAV41,TRAJ17,CAHSAAGNKLTF,0,1,1,1
TRAV8-3,TRAJ33,CAVGPNYQLIW,0,2,1,2
TRAV12-1,TRAJ28,CVVNEYSGAGSYQLTF,0,1,1,1
TRAV9-2,TRAJ58,CALSPRVASGSRLTF,0,1,1,1
TRAV21,TRAJ41,CAVRYPNSGYALNF,0,1,1,1
TRAV26-2,TRAJ37,CFLSSSNTGKLIF,0,1,1,1
TRAV9-2,TRAJ20,CALRNDYKLSF,0,1,1,1
TRAV4,TRAJ37,CLVGAAHGSSNTGKLNF,0,1,1,1
TRAV39,TRAJ43,CAVDMTDDMRF,0,1,1,1
TRAV16,TRAJ32,CALSGRGATNKLIF,0,1,1,1
TRAV3,TRAJ42,CAVRGFLFGGSQGNLIF,0,3,1,3
TRAV13-1,TRAJ42,CAASRMNYGGSQGNLIF,0,1,1,1
TRAV9-2,TRAJ45,CALSPYSGGGADGLTF,0,2,1,2
TRAV9-2,TRAJ4,CALSARLSGGYNKLIF,0,1,1,1
TRAV14DV4,TRAJ28,CAMSLTSGAGSYQLTF,0,1,1,1
TRAV12-3,TRAJ42,CAMSEGYGGSQGNLIF,0,1,1,1
TRAV8-3,TRAJ4,CAVGAFSGGYNKLIF,0,1,1,1
TRAV3,TRAJ10,CAVRLLTGGGNKLTF,0,1,1,1
TRAV14DV4,TRAJ3,CAMRVPWSSASKIIF,0,1,1,1
TRAV12-1,TRAJ4,CVVSPSGGYNKLIF,0,2,1,2
TRAV3,TRAJ24,CAVTSTDSWGKLQF,0,3,1,3
TRAV2,TRAJ9,CAVTNTGGFKTIF,0,2,1,2
TRAV12-2,TRAJ6,CAAASGGSYIPTF,0,2,1,2
TRAV13-1,TRAJ10,CAATTGGGNKLTF,0,2,1,2
TRAV23DV6,TRAJ26,CAATLNYGQNFVF,0,2,1,2
TRAV2,TRAJ29,CAVESGNTPLVF,0,1,1,1
TRAV24,TRAJ48,CALNFGNEKLTF,0,3,1,3
TRAV13-2,TRAJ9,CAENTGGFKTIF,0,1,1,1
TRAV38-2DV8,TRAJ54,CAYRRSQKLVF,0,2,1,2
TRAV21,TRAJ49,CAVSAGNQFYF,0,2,1,2
TRAV17,TRAJ49,CATGAGNQFYF,0,2,1,2
TRAV12-2,TRAJ16,CAVNGGQKLLF,0,3,1,3
TRAV4,TRAJ33,CLMDSNYQLIW,0,2,1,2
TRAV9-2,TRAJ30,CALRDDKIIF,0,2,1,2
TRAV36DV7,TRAJ20,CAPDYKLSF,0,1,1,1
TRAV17,TRAJ43,CATDARGRF,0,1,1,1
TRAV25,TRAJ43,CAERDNNDMRF,0,1,1,1
TRAV23DV6,TRAJ5,CAASVGTGRRALTF,0,1,1,1
TRAV25,TRAJ11,CAGFRGYSTLTF,0,1,1,1
TRAV13-1,TRAJ18,CAASINRKDRGSTLGRLYF,0,1,1,1
TRAV38-2DV8,TRAJ28,CAYRSATYSGAGCYQLTF,0,1,1,1
TRAV9-2,TRAJ45,CALSDPYSGGGADGLTF,0,3,1,3
TRAV8-3,TRAJ41,CAVALSGNSNSGYALNF,0,1,1,1
TRAV38-1,TRAJ22,CAFMKLPSGSARQLTF,0,1,1,1
TRAV8-3,TRAJ37,CAVGAHGSSNTGKLIF,0,1,1,1
TRAV21,TRAJ52,CAVSNAGGTSYGKLTF,0,1,1,1
TRAV3,TRAJ32,CAVRDTRGGATNKLIF,0,2,1,2
TRAV8-1,TRAJ17,CAAGHGIKAAGNKLTF,0,2,1,2
TRAV38-2DV8,TRAJ57,CAYRRTQGGSEKLVF,0,1,1,1
TRAV38-2DV8,TRAJ42,CAYRNYGGSQGNLIF,0,2,1,2
TRAV9-2,TRAJ32,CALSFYGGATNKLIF,0,1,1,1
TRAV17,TRAJ45,CATRGPGGGADGLTF,0,1,1,1
TRAV5,TRAJ3,CAESSPYSSASKIIF,0,3,1,3
TRAV5,TRAJ3,CAESPLGSSASKIIF,0,1,1,1
TRAV13-2,TRAJ48,CAERKSNFGNEKLTF,0,2,1,2
TRAV14DV4,TRAJ49,CAMREGFLHGNQFYF,0,2,1,2
TRAV34,TRAJ9,CGAAALGTGGFKTIF,0,1,1,1
TRAV4,TRAJ18,CLVGDRGSTLGRLYF,0,2,1,2
TRAV17,TRAJ29,CALRTNSGNTPLVF,0,1,1,1
TRAV3,TRAJ13,CAVRNSGGYQKVTF,0,2,1,2
TRAV29DV5,TRAJ40,CAAITTSGTYKYIF,0,1,1,1
TRAV23DV6,TRAJ41,CAASSLNSGYALNF,0,1,1,1
TRAV27,TRAJ32,CAGEDGGATNKLIF,0,1,1,1
TRAV13-2,TRAJ45,CAENIGGGADGLTF,0,1,1,1
TRAV5,TRAJ42,CGLRDGGSQGNLIF,0,3,1,3
TRAV26-2,TRAJ42,CILNYGGSQGNLIF,0,1,1,1
TRAV12-1,TRAJ34,CVVNIGDTDKLIF,0,1,1,1
TRAV38-1,TRAJ39,CAFQDGAGNMLTF,0,2,1,2
TRAV16,TRAJ30,CALGPNRDDKIIF,0,2,1,2
TRAV5,TRAJ6,CAPSSGGSYIPTF,0,1,1,1
TRAV21,TRAJ15,CAVNNQAGTALIF,0,2,1,2
TRAV2,TRAJ34,CAVEGRNTDKLIF,0,2,1,2
TRAV2,TRAJ43,CAVEDLDNNDMRF,0,2,1,2
TRAV2,TRAJ26,CAVEERDGQNFVF,0,1,1,1
TRAV2,TRAJ37,CAVRSSNTGKLIF,0,1,1,1
TRAV6,TRAJ41,CATPSNSGYALNF,0,2,1,2
TRAV5,TRAJ20,CAESRQDDYKLSF,0,1,1,1
TRAV12-3,TRAJ6,CASLKGGSYIPTF,0,1,1,1
TRAV12-1,TRAJ22,CVVNDSARQLTF,0,1,1,1
TRAV8-3,TRAJ31,CAVGAANARLMF,0,1,1,1
TRAV24,TRAJ39,CAFNNAGNMLTF,0,1,1,1
TRAV12-3,TRAJ29,CACHSGNTPLVF,0,1,1,1
TRAV17,TRAJ20,CAPFNDYELSF,0,1,1,1
TRAV27,TRAJ20,CVGNKLSF,0,2,1,2
TRAV16,TRAJ23,CALGGPFYNQGGKLIF,0,1,1,1
TRAV21,TRAJ10,CAVLILTGGGNKLTF,0,1,1,1
TRAV20,TRAJ42,CAVPNYGGSQGNLIF,0,2,1,2
TRAV8-1,TRAJ34,CAVNSFNTDKLIF,0,1,1,1
TRAV8-6,TRAJ23,CADQGGKLIF,0,2,1,2
TRAV9-2,TRAJ32,CALSVWDYGGATNKLIF,0,1,1,1
TRAV26-2,TRAJ44,CILRDWTGTASKLTF,0,2,1,2
TRAV13-1,TRAJ39,CAASVPRGSNMLTF,0,2,1,2
TRAV3,TRAJ42,CAVRDFGGSQGNLIF,0,1,1,1
TRAV16,TRAJ27,CALSGSRTNAGKSTF,0,1,1,1
TRAV4,TRAJ5,CLAPPEDTGRRALTF,0,1,1,1
TRAV41,TRAJ23,CAVSRGNQGGKLIF,0,1,1,1
TRAV25,TRAJ44,CAGPNTGTASKLTF,0,1,1,1
TRAV24,TRAJ27,CAFINTNAGKSTF,0,1,1,1
TRAV6,TRAJ10,CALGPLLYDILTGGGNKLTF,0,1,1,1
TRAV14DV4,TRAJ45,CAMSPASSSGGGADGLTF,0,4,1,4
TRAV26-2,TRAJ52,CILRGFNAGGTSYGKLTF,0,1,1,1
TRAV38-2DV8,TRAJ37,CAYRSAYGSSNTGKLIF,0,1,1,1
TRAV9-2,TRAJ52,CALRRSAGGTSYGKLTF,0,1,1,1
TRAV26-1,TRAJ33,CIVRASIAWDSNYQLIW,0,1,1,1
TRAV38-1,TRAJ33,CAFRGLTMDSNYQLIW,0,2,1,2
TRAV19,TRAJ56,CALSEKATGANSKLTF,0,1,1,1
TRAV8-3,TRAJ52,CAVTNAGGTSYGKLTF,0,1,1,1
TRAV12-2,TRAJ28,CAVSPYSGAGSYQLTF,0,1,1,1
TRAV27,TRAJ10,CAGGDGLTGGGNKLTF,0,1,1,1
TRAV14DV4,TRAJ40,CAMREIIASGTYKYIF,0,1,1,1
TRAV12-1,TRAJ42,CSAGDYGGSQGNLIF,0,1,1,1
TRAV12-1,TRAJ5,CVVNPSVTGRRALTF,0,1,1,1
TRAV38-2DV8,TRAJ57,CAYRRVQGGSEKLVF,0,2,1,2
TRAV8-3,TRAJ4,CAVGPLSGGYNKLIF,0,1,1,1
TRAV8-3,TRAJ48,CAVGPPNFGNEKLTF,0,1,1,1
TRAV2,TRAJ38,CAVEVYAGNNRKLIW,0,1,1,1
TRAV2,TRAJ3,CAVESRDSSASKIIF,0,2,1,2
TRAV23DV6,TRAJ42,CAASNYGGSQGNLIF,0,2,1,2
TRAV25,TRAJ45,CAGTRSGGGADGLTF,0,2,1,2
TRAV14DV4,TRAJ3,CAMREGVLSASKIIF,0,1,1,1
TRAV12-1,TRAJ44,CVVSTTGTASKLTF,0,1,1,1
TRAV38-1,TRAJ39,CAFMKGNAGNMLTF,0,2,1,2
TRAV38-1,TRAJ45,CAFTSGGGADGLTF,0,1,1,1
TRAV9-2,TRAJ48,CALVLGFGNEKLTF,0,1,1,1
TRAV9-2,TRAJ12,CALSDPDSSYKLIF,0,1,1,1
TRAV6,TRAJ26,CALDMGNYGQNFVF,0,1,1,1
TRAV20,TRAJ48,CAVLSDFGNEKLTF,0,2,1,2
TRAV8-3,TRAJ21,CAVGAPRGFNKFYF,0,1,1,1
TRAV22,TRAJ30,CAVEPMNRDDKIIF,0,1,1,1
TRAV2,TRAJ10,CAVEVSGGGNKLTF,0,1,1,1
TRAV12-2,TRAJ5,CAVEEDTGRRALTF,0,1,1,1
TRAV3,TRAJ11,CAVRGNSGYSTLTF,0,2,1,2
TRAV13-1,TRAJ37,CATGGSSNTGKLIF,0,1,1,1
TRAV12-2,TRAJ30,CAVKGVNRGDKIIL,0,1,1,1
TRAV13-1,TRAJ10,CAASIAGGGNKFTF,0,1,1,1
TRAV27,TRAJ52,CAGAGGTSYGKLTF,0,1,1,1
TRAV25,TRAJ6,CAGPKEGGSYIPTF,0,1,1,1
TRAV13-2,TRAJ42,CAENYGGSQGNLIF,0,1,1,1
TRAV13-2,TRAJ27,CAENRRTNAGKSTF,0,1,1,1
TRAV30,TRAJ44,CGTENTGTASKLTF,0,1,1,1
TRAV26-2,TRAJ6,CILRSSGGSYIPTF,0,1,1,1
TRAV12-1,TRAJ20,CVVNPSNDYKLSF,0,1,1,1
TRAV12-1,TRAJ22,CVVNKGSARQLTF,0,2,1,2
TRAV38-2DV8,TRAJ56,CAYKSGANSKLTF,0,1,1,1
TRAV9-2,TRAJ6,CALLSGGSYIPTF,0,1,1,1
TRAV16,TRAJ20,CALSGSNDYKLSF,0,1,1,1
TRAV17,TRAJ13,CATDAGGYQKVTF,0,1,1,1
TRAV17,TRAJ11,CATDGEGYSTLTF,0,1,1,1
TRAV17,TRAJ54,CATDDRGAQKLVF,0,1,1,1
TRAV12-2,TRAJ13,CAVGAGGYQKVTF,0,1,1,1
TRAV27,TRAJ23,CAGFYNQGGKLIF,0,1,1,1
TRAV5,TRAJ49,CADQRDTGNQFYF,0,1,1,1
TRAV13-2,TRAJ21,CAETSSHFNKFYF,0,1,1,1
TRAV14DV4,TRAJ43,CAMRPNSGNDMRF,0,1,1,1
TRAV14DV4,TRAJ11,CAMRDPGYSTLTF,0,1,1,1
TRAV26-2,TRAJ41,CARLRYSGYALNF,0,1,1,1
TRAV38-1,TRAJ43,CASRFNNNDMRF,0,1,1,1
TRAV16,TRAJ42,CALRGSQGNLIF,0,1,1,1
TRAV6,TRAJ13,CAPAGGYQKVTF,0,1,1,1
TRAV2,TRAJ3,CAVVSSASKIIF,0,1,1,1
TRAV21,TRAJ43,CAVIYNNNDMRF,0,2,1,2
TRAV21,TRAJ21,CAVRYNFDKFYF,0,1,1,1
TRAV17,TRAJ9,CALYTGGFKTIF,0,2,1,2
TRAV29DV5,TRAJ37,CAASSNTGKLIF,0,3,1,3
TRAV23DV6,TRAJ29,CAAKARNTPLVF,0,1,1,1
TRAV13-2,TRAJ10,CAEKGGGNKLTF,0,1,1,1
TRAV4,TRAJ43,CLVGPINNDMRF,0,1,1,1
TRAV26-2,TRAJ43,CILRRDNNDMRF,0,1,1,1
TRAV26-2,TRAJ23,CILRDERGKLIF,0,1,1,1
TRAV26-1,TRAJ57,CIVRGGSEKLVF,0,2,1,2
TRAV17,TRAJ57,CVPGGSEKLVF,0,2,1,2
TRAV9-2,TRAJ21,CALSDFNKFYF,0,1,1,1
TRAV17,TRAJ31,CATLNNARLMF,0,2,1,2
TRAV8-1,TRAJ20,CAVNGDYKLSF,0,2,1,2
TRAV27,TRAJ43,CAATNNNDMRF,0,1,1,1
TRAV26-1,TRAJ20,CMERNDYKLSF,0,1,1,1
TRAV14DV4,TRAJ31,SDRGARLMF,0,1,1,1
TRAV21,TRAJ31,CAVLPRLMF,0,1,1,1
TRAV9-2,TRAJ22,CALSDRAFSSGSARQLTF,0,1,1,1
TRAV25,TRAJ42,CAGSNYGGSQGNLIF,0,1,1,1
TRAV27,TRAJ50,CAGAKATSYDKVIF,0,1,1,1
TRAV16,TRAJ7,CGYYGNNRLAF,0,1,1,1
TRAV12-1,TRAJ42,CVVTNYGGSQGNLIF,0,2,1,2
TRAV21,TRAJ34,CAVSLYVYNTDKLIF,0,1,1,1
TRAV27,TRAJ53,CAGAESGDSNYKLTF,0,1,1,1
TRAV26-1,TRAJ38,CIAFAWAGINRTLIW,0,1,1,1
TRAV13-1,TRAJ20,CAATLVRDYKLSF,0,2,1,2
TRAV26-2,TRAJ49,CILRDTGNQFYF,0,1,1,1
TRAV9-2,TRAJ8,CALNTGYQKLVF,0,1,1,1
TRAV26-2,TRAJ45,CILRDVSGGGADGLTY,0,2,1,2
TRAV14DV4,TRAJ44,CAMREGRGGTGTASKLTF,0,1,1,1
TRAV5,TRAJ13,CAEGPSGGYQKVTF,0,1,1,1
TRAV14DV4,TRAJ30,CAMGLRDDKIIF,0,1,1,1
TRAV13-1,TRAJ4,FSGGYNKLIF,0,1,1,1
TRAV41,TRAJ45,CAVGDEMYSGGGADGLTF,0,1,1,1
TRAV23DV6,TRAJ57,CAANSSHLQGGSEKLVF,0,1,1,1
TRAV4,TRAJ52,CLVGDPAGGTSYGKLTF,0,1,1,1
TRAV26-1,TRAJ22,CIVRFPISSGSARQLTF,0,1,1,1
TRAV38-2DV8,TRAJ15,CAYRSASGQAGTALIF,0,2,1,2
TRAV9-2,TRAJ53,CALSDPGGGSNYKLTF,0,1,1,1
TRAV12-2,TRAJ52,CAVPNAGGTSYGKLTF,0,1,1,1
TRAV2,TRAJ20,CAVDPRRHFNDYKLSF,0,1,1,1
TRAV3,TRAJ45,CAVRDIRRGGADGLTF,0,1,1,1
TRAV8-3,TRAJ44,CAEGEGQDGTASKLTF,0,1,1,1
TRAV12-2,TRAJ42,CAVNRGYGGSQGNLIF,0,1,1,1
TRAV23DV6,TRAJ35,CAASGPMVGFGNVLHC,0,1,1,1
TRAV27,TRAJ45,CAGDGNSGGGADGLTF,0,1,1,1
TRAV27,TRAJ44,CAGGGLRAGTASKLTF,0,1,1,1
TRAV14DV4,TRAJ41,CAMREPSGYSGYALNF,0,1,1,1
TRAV14DV4,TRAJ49,CAMREGRFDTGNQFYF,0,1,1,1
TRAV26-2,TRAJ49,CILRDVGFTTGNQFYF,0,2,1,2
TRAV12-1,TRAJ28,CVVFLSGAGSYQLTF,0,1,1,1
TRAV21,TRAJ52,CAFLPGGTSYGKLTS,0,1,1,1
TRAV38-2DV8,TRAJ48,CAYRTSNFGNEKLTF,0,1,1,1
TRAV9-2,TRAJ53,CALSNSGGSNYKLTF,0,1,1,1
TRAV16,TRAJ56,CALSTYTGANSKLTF,0,1,1,1
TRAV8-3,TRAJ48,CAVGSINFGNEKLTF,0,1,1,1
TRAV22,TRAJ42,CAVEGDGGSQGNLIF,0,1,1,1
TRAV17,TRAJ53,CATDRSGGSNYKLTF,0,1,1,1
TRAV12-2,TRAJ52,CAASAGGTSYGKLTF,0,1,1,1
TRAV23DV6,TRAJ48,CAASGANFGNEKLTF,0,1,1,1
TRAV14DV4,TRAJ23,CAMRFPYNQGGKLIF,0,1,1,1
TRAV12-3,TRAJ10,CAMKQAAGGGNKLTF,0,2,1,2
TRAV12-3,TRAJ39,CAILQLKDAGNMLTF,0,1,1,1
TRAV4,TRAJ5,CLVGGPGTGRRALTF,0,2,1,2
TRAV26-1,TRAJ23,CIVRTYYNQGGKLIF,0,1,1,1
TRAV26-1,TRAJ40,CIVRLFTSGTYKYIF,0,1,1,1
TRAV26-1,TRAJ23,CIVRVIYNQGGKLIF,0,1,1,1
TRAV38-2DV8,TRAJ57,CAYIRQGGSEKLVF,0,1,1,1
TRAV16,TRAJ29,CALSRNSGNTPLVF,0,1,1,1
TRAV20,TRAJ57,CAVQAPGGSEKLVF,0,1,1,1
TRAV8-3,TRAJ17,CAVGARAAGNKLTF,0,1,1,1
TRAV21,TRAJ42,CAVSSRGSQGNLIF,0,1,1,1
TRAV17,TRAJ39,CATVDNNAGNMLTF,0,1,1,1
TRAV17,TRAJ27,CATGQNTNAGKSTF,0,1,1,1
TRAV12-2,TRAJ40,CAVHTTSGTYKYIF,0,1,1,1
TRAV13-1,TRAJ10,CAAEFTGGGNKLTF,0,2,1,2
TRAV13-1,TRAJ17,CAASPWAAGNKLTF,0,1,1,1
TRAV13-1,TRAJ39,CAASRDNAGNMLTF,0,1,1,1
TRAV23DV6,TRAJ48,CAARGDFGNEKLTF,0,1,1,1
TRAV5,TRAJ10,CAELFTGGGNKLTF,0,3,1,3
TRAV5,TRAJ21,CAEPYTGNFNKFYF,0,1,1,1
TRAV5,TRAJ6,CAEDASGGSYIPTF,0,2,1,2
TRAV12-3,TRAJ5,CAMSAHTGRRALTF,0,1,1,1
TRAV12-3,TRAJ5,CAMRGDTGRRALTF,0,2,1,2
TRAV14DV4,TRAJ40,CAMREGRGTYKYIF,0,1,1,1
TRAV26-2,TRAJ13,CILTNSGGYQKVTF,0,1,1,1
TRAV26-2,TRAJ58,CILMKETSGSRLTF,0,2,1,2
TRAV9-2,TRAJ43,CALSSSNNNDMRF,0,1,1,1
TRAV9-2,TRAJ56,CALRHGANSKLTF,0,1,1,1
TRAV9-2,TRAJ43,CARIQRDNNDMRF,0,1,1,1
TRAV3,TRAJ26,CAVRDNYGQNFVF,0,2,1,2
TRAV8-3,TRAJ42,CAVGAGSQGNLIF,0,2,1,2
TRAV21,TRAJ40,CAVGVGGTYKYIF,0,1,1,1
TRAV2,TRAJ34,CAVELPNTDKLIF,0,1,1,1
TRAV21,TRAJ49,CAVSFVTGNQFYF,0,2,1,2
TRAV17,TRAJ41,CATDENSGYALNF,0,2,1,2
TRAV24,TRAJ50,CAFIETSYDKVIF,0,1,1,1
TRAV12-2,TRAJ7,CAVLDYGNNRLAF,0,1,1,1
TRAV12-2,TRAJ21,CAVNPYNFNKFYF,0,1,1,1
TRAV8-1,TRAJ37,CAVKSGNTGKLIF,0,1,1,1
TRAV21,TRAJ58,CAAKETSGSRLTF,0,2,1,2
TRAV23DV6,TRAJ40,CAAGTSGTYKYIF,0,1,1,1
TRAV13-1,TRAJ17,CAASTAAGNKLTF,0,1,1,1
TRAV13-1,TRAJ13,CAASKGGYQKVTF,0,1,1,1
TRAV27,TRAJ22,CAGGSGSARQLTF,0,1,1,1
TRAV27,TRAJ22,CAGARGSARQLTF,0,2,1,2
TRAV12-3,TRAJ7,CAMEAYGNNRLAF,0,1,1,1
TRAV14DV4,TRAJ43,CAMRDGNNNDMRF,0,1,1,1
TRAV4,TRAJ31,CLVGTNNNARLMF,0,1,1,1
TRAV9-2,TRAJ6,CVSPGGSYIPTF,0,1,1,1
TRAV9-2,TRAJ49,CALGFTGNQFYF,0,1,1,1
TRAV21,TRAJ9,CAVYTGGFKTIF,0,1,1,1
TRAV21,TRAJ15,CAVNQAGTALIF,0,2,1,2
TRAV29DV5,TRAJ49,CAADLTGNQFYF,0,1,1,1
TRAV13-1,TRAJ27,CAASSNAGKSTF,0,1,1,1
TRAV23DV6,TRAJ11,CAARRGYSTLTF,0,2,1,2
TRAV23DV6,TRAJ49,CAAKGTGNQFYF,0,2,1,2
TRAV27,TRAJ30,CAGLWGDDKIIF,0,1,1,1
TRAV38-2DV8,TRAJ26,CAYNYGQNFVF,0,1,1,1
TRAV21,TRAJ20,CAVLLDYKLSF,0,1,1,1
TRAV17,TRAJ22,CATGSARQLTF,0,2,1,2
TRAV17,TRAJ24,CATDSWGKLQF,0,1,1,1
TRAV5,TRAJ47,CAENGNKLVF,0,1,1,1
TRAV13-1,TRAJ20,SAAESGKLSF,0,1,1,1
TRAV38-1,TRAJ31,CAFIDNNNARLMF,0,1,1,1
TRAV30,TRAJ43,CGTAYNNNDMRF,0,2,1,2
TRAV3,TRAJ9,CAVRNTGGFKTIF,0,3,1,3
TRAV8-3,TRAJ26,CAVWDNYGQNFVL,0,1,1,1
TRAV23DV6,TRAJ22,CAARPISSGSARQLTF,0,1,1,1
TRAV26-2,TRAJ52,CIPFNAGGTSYGKLTF,0,1,1,1
TRAV17,TRAJ57,CATEMQGGSEKLVF,0,1,1,1
TRAV3,TRAJ23,CAVRDRYNQGGKLIF,0,1,1,1
TRAV38-2DV8,TRAJ49,CAYRSKNTGNQFYF,0,1,1,1
TRAV8-6,TRAJ58,CAVRETSGSRLTF,0,1,1,1
TRAV17,TRAJ17,CATIKAAGDKLTF,0,1,1,1
TRAV13-2,TRAJ6,CAENGATGNQFYFGTGTSLTVIPRGSYIPTF,0,1,1,1
TRAV13-2,TRAJ52,CAENANEVPNAGGTSYGKLTF,0,1,1,1
TRAV26-1,TRAJ10,CIVRVPLGLTGGGNKLTF,0,2,1,2
TRAV38-1,TRAJ28,CAFMKLYSGAGSYQLTF,0,1,1,1
TRAV8-3,TRAJ6,CAVGALPTSGGSYIPTF,0,1,1,1
TRAV3,TRAJ28,CAVRDRHSGAGSYQLTF,0,2,1,2
TRAV13-1,TRAJ32,CAASRGNYGGATNKLIF,0,1,1,1
TRAV25,TRAJ45,CADAAPDSGGGADGLTF,0,1,1,1
TRAV26-1,TRAJ39,CIVRVEVVGNAGNMLTF,0,1,1,1
TRAV12-1,TRAJ17,CVVMAMIKAAGNKLTF,0,1,1,1
TRAV10,TRAJ42,CVVSEDYGGSQGNLIF,0,1,1,1
TRAV23DV6,TRAJ42,CASYMNYGGSQGNLIF,0,2,1,2
TRAV38-2DV8,TRAJ42,CAYMTGYGGSQGNLIF,0,1,1,1
TRAV16,TRAJ44,CALEGSNTGTASKLTF,0,1,1,1
TRAV9-2,TRAJ4,CALTDRVSGGYNKLIF,0,1,1,1
TRAV8-3,TRAJ4,CAVVSIFSGGYNKLIF,0,1,1,1
TRAV8-3,TRAJ44,CAVVLPNTGTASKLTF,0,1,1,1
TRAV8-3,TRAJ42,CAVGDPYGGSQGNLIF,0,1,1,1
TRAV3,TRAJ3,CAVRVVPGGSASKIIF,0,1,1,1
TRAV12-2,TRAJ52,CAVKSAGGTSYGKLTF,0,1,1,1
TRAV14DV4,TRAJ57,CAMRAYSQGGSEKLVF,0,2,1,2
TRAV4,TRAJ23,CLVGRGLYNQGGKLIF,0,2,1,2
TRAV4,TRAJ28,CHSTLYSGAGSYQLTF,0,2,1,2
TRAV26-2,TRAJ28,CILRGLSGAGSYQLTF,0,1,1,1
TRAV26-2,TRAJ8,CILRDFLNTGFQKLVF,0,2,1,2
TRAV26-1,TRAJ38,CIVRAYNAGNNRKLIW,0,1,1,1
TRAV26-1,TRAJ22,CIVRVGSSGSARQLTF,0,1,1,1
TRAV27,TRAJ40,FLTPLHGHGTYKYIF,0,2,1,2
TRAV12-1,TRAJ4,CVVTLFSGGYNKLIF,0,1,1,1
TRAV12-1,TRAJ30,CVVNSAMNRDDKIIF,0,1,1,1
TRAV38-1,TRAJ30,CAFMIPPNRDDKIIF,0,1,1,1
TRAV9-2,TRAJ42,CALMNYGGSQGNLIF,0,1,1,1
TRAV9-2,TRAJ44,CALTALTGTASKLTF,0,1,1,1
TRAV9-2,TRAJ6,CALSAASGGSYIPTF,0,1,1,1
TRAV9-2,TRAJ27,CALSDPRTNAGKSTF,0,1,1,1
TRAV20,TRAJ37,CAVLRGSSNTGKLIF,0,1,1,1
TRAV22,TRAJ18,CAVPDRGSTLGRLYF,0,1,1,1
TRAV21,TRAJ58,CAVVLQETSGSRLTL,0,1,1,1
TRAV8-3,TRAJ42,CAVGSYGGSQGNLIF,0,1,1,1
TRAV2,TRAJ13,CAVEPPSGGYQKVTF,0,1,1,1
TRAV3,TRAJ39,CAVRDGGNAGNMLTF,0,1,1,1
TRAV17,TRAJ34,CATDLRSYNTDKLIF,0,1,1,1
TRAV8-3,TRAJ18,CALAGRGSTLGRLYF,0,1,1,1
TRAV12-1,TRAJ45,CAPSYSGGGADGLTF,0,1,1,1
TRAV12-2,TRAJ3,CAAPLSYSSASKIIF,0,1,1,1
TRAV13-1,TRAJ8,CAALDPNTGFQKLVF,0,1,1,1
TRAV29DV5,TRAJ40,CAATPDTSGTYKYIF,0,1,1,1
TRAV13-1,TRAJ44,CAASTGTGTASKLTF,0,1,1,1
TRAV25,TRAJ45,CAGPKSGGGADGLTF,0,1,1,1
TRAV27,TRAJ37,CAGARSSSNTGKLIF,0,1,1,1
TRAV27,TRAJ28,CAGANSGAGSYQLTF,0,1,1,1
TRAV14DV4,TRAJ29,CAMRESLSGNTPLVF,0,1,1,1
TRAV26-2,TRAJ48,CILTFRDFGNEKLTF,0,2,1,2
TRAV26-2,TRAJ45,CILPNSGGGADGLTF,0,1,1,1
TRAV26-1,TRAJ48,CIAPESNFGNEKLTF,0,2,1,2
TRAV26-1,TRAJ33,RIVRVRGDSNYQLIW,0,1,1,1
TRAV10,TRAJ9,CVVSLNTGGFKTIF,0,1,1,1
TRAV12-1,TRAJ5,CVVNMGTGRRALTF,0,1,1,1
TRAV38-2DV8,TRAJ37,CAYRRGGNTGKLIF,0,1,1,1
TRAV9-2,TRAJ6,CALLASGGSYIPTF,0,1,1,1
TRAV9-2,TRAJ57,CALRKQGGSEELVF,0,1,1,1
TRAV8-3,TRAJ4,CAVSLSGGYNKLIF,0,1,1,1
TRAV20,TRAJ16,CAVHLFENGQKLLF,0,1,1,1
TRAV8-3,TRAJ40,CAVASTSGTYKYIF,0,1,1,1
TRAV8-3,TRAJ27,CAVGHNTNAGKSTF,0,2,1,2
TRAV2,TRAJ34,CAVEALVRTDKLIF,0,1,1,1
TRAV12-2,TRAJ36,CAVREKTGANNLFF,0,1,1,1
TRAV41,TRAJ33,CAAGTMDSNYQLIW,0,1,1,1
TRAV35,TRAJ41,CAGPHSNSGYALNF,0,2,1,2
TRAV24,TRAJ20,CASFTLSNDYKLSF,0,2,1,2
TRAV12-2,TRAJ27,CAVRRGTNAGKSTF,0,1,1,1
TRAV12-2,TRAJ13,CAVSPPGGYQKVTF,0,1,1,1
TRAV12-2,TRAJ21,CAVITLYNFNKFYF,0,1,1,1
TRAV36DV7,TRAJ17,CAASIKAAGNKLTF,0,1,1,1
TRAV29DV5,TRAJ42,CAPNYGGSQGNLIF,0,1,1,1
TRAV23DV6,TRAJ21,CAACGVYNFNKFYF,0,1,1,1
TRAV13-1,TRAJ43,CAATITYNNNDMRF,0,1,1,1
TRAV23DV6,TRAJ57,CAASLQGGSEKLVF,0,1,1,1
TRAV13-1,TRAJ10,CAASITGGGNKLTF,0,1,1,1
TRAV13-1,TRAJ12,CAASKADSSYKLIF,0,1,1,1
TRAV13-1,TRAJ49,CAASLLFTGNQFYF,0,1,1,1
TRAV23DV6,TRAJ34,CAASPTYNTDKLIF,0,2,1,2
TRAV29DV5,TRAJ41,CAARGPNSGYALNF,0,2,1,2
TRAV25,TRAJ13,CAGSISGGYQKVTF,0,1,1,1
TRAV12-3,TRAJ9,CAMTHITGGFKTIF,0,1,1,1
TRAV12-3,TRAJ21,CAMRSRNNFNKFYF,0,2,1,2
TRAV4,TRAJ29,CLVAERSGNTPLVF,0,1,1,1
TRAV26-1,TRAJ49,CIVRVKGTGNQFYF,0,1,1,1
TRAV12-1,TRAJ49,CVVNTNTGNQFYF,0,1,1,1
TRAV38-2DV8,TRAJ43,CAFLSYNNNDMRF,0,1,1,1
TRAV38-2DV8,TRAJ29,CAYRNSGNTPLVF,0,1,1,1
TRAV38-2DV8,TRAJ37,CAHGSSNTGKLIF,0,1,1,1
TRAV8-3,TRAJ7,CAVPYYGNSRLAF,0,1,1,1
TRAV21,TRAJ17,CAVPQAAGNKLTS,0,1,1,1
TRAV41,TRAJ50,CAVKWTSYDKVIF,0,2,1,2
TRAV8-3,TRAJ9,CAVGATGGFKTIF,0,1,1,1
TRAV2,TRAJ16,CAVEVLDGQKLLF,0,1,1,1
TRAV8-3,TRAJ39,CAVINNAGNMLTF,0,1,1,1
TRAV21,TRAJ57,CAVTLGGSEKLVF,0,1,1,1
TRAV21,TRAJ36,CAVRDPGANNLFF,0,1,1,1
TRAV12-2,TRAJ39,CAVNNNAGNMLTF,0,1,1,1
TRAV21,TRAJ37,CAVCSSNTGKLIF,0,1,1,1
TRAV21,TRAJ40,CAASTSGTYKYIF,0,1,1,1
TRAV35,TRAJ49,CAGQQNTGNQFYF,0,1,1,1
TRAV17,TRAJ37,CATDASNTGKLIF,0,2,1,2
TRAV2,TRAJ39,CAVDNNAGNMLTF,0,1,1,1
TRAV13-2,TRAJ3,CAAMYSSASKIIF,0,1,1,1
TRAV13-1,TRAJ6,CAALKGGSYIPTF,0,1,1,1
TRAV29DV5,TRAJ13,CAALAGGYQKVTF,0,1,1,1
TRAV13-1,TRAJ27,CAASPTNAGKSTF,0,1,1,1
TRAV13-1,TRAJ22,CAASSGSARQLTF,0,1,1,1
TRAV13-1,TRAJ33,CAASNWGNYQLIW,0,2,1,2
TRAV13-1,TRAJ41,CAASKNSGYALNF,0,1,1,1
TRAV23DV6,TRAJ40,CAASWAGTYKYIF,0,2,1,2
TRAV13-1,TRAJ20,CAASRPNDYKLSF,0,2,1,2
TRAV23DV6,TRAJ33,CAASMLSNYQLIW,0,1,1,1
TRAV27,TRAJ44,CAGRTGTASKLTF,0,2,1,2
TRAV27,TRAJ42,CAGAGGSQGNLIF,0,1,1,1
TRAV27,TRAJ36,CAGDQTGANNLFF,0,1,1,1
TRAV25,TRAJ12,CAEPMDSSYKLIF,0,1,1,1
TRAV12-3,TRAJ10,CAMTTGGGNKLTF,0,1,1,1
TRAV12-3,TRAJ29,CAMSYSGNTPLVF,0,1,1,1
TRAV12-2,TRAJ38,CATHAGNNRKLIW,0,2,1,2
TRAV4,TRAJ15,CLVGNQAGTALIF,0,1,1,1
TRAV30,TRAJ43,CGTERYNNNDMRF,0,1,1,1
TRAV26-1,TRAJ44,CIPQDGTASKLTF,0,1,1,1
TRAV25,TRAJ6,CPASGGSYIPTF,0,1,1,1
TRAV38-1,TRAJ43,CAFMKHADDMRF,0,1,1,1
TRAV9-2,TRAJ49,CALSEAVNQFYF,0,1,1,1
TRAV12-2,TRAJ21,CAVLYNFNKFYF,0,1,1,1
TRAV41,TRAJ29,CAVRSGNTPLVF,0,1,1,1
TRAV21,TRAJ49,CAVSSTGNQFYF,0,1,1,1
TRAV35,TRAJ49,CAGSTTGNQFYF,0,1,1,1
TRAV17,TRAJ45,CATSGGADGLTF,0,1,1,1
TRAV17,TRAJ4,CATDPSYNKLIF,0,2,1,2
TRAV12-2,TRAJ34,CAVNIPADKLIF,0,1,1,1
TRAV12-2,TRAJ43,CAVKNNNNDMRF,0,1,1,1
TRAV13-1,TRAJ43,CAASSHNNDMRF,0,1,1,1
TRAV13-1,TRAJ16,CAASVDGQKLLL,0,1,1,1
TRAV27,TRAJ33,CAGVGAAYQLIW,0,1,1,1
TRAV13-2,TRAJ20,CAENKSDYKLSF,0,1,1,1
TRAV12-3,TRAJ46,CAMKSSGDKLTF,0,1,1,1
TRAV13-1,TRAJ9,CATYTGGFKTIF,0,1,1,1
TRAV26-2,TRAJ43,CILLKLANDMRF,0,2,1,2
TRAV26-2,TRAJ29,CILRDRNTPLVF,0,1,1,1
TRAV26-1,TRAJ39,CIANNAGNMLTF,0,1,1,1
TRAV12-1,TRAJ43,CVALNNNDMRF,0,1,1,1
TRAV38-1,TRAJ24,CASESWGKLQF,0,1,1,1
TRAV12-3,TRAJ49,CAASRGNQFYF,0,1,1,1
TRAV12-2,TRAJ34,CAVGGTDKLIF,0,2,1,2
TRAV12-2,TRAJ20,CAAFNDYKLSF,0,1,1,1
TRAV27,TRAJ43,CADHNDMRF,0,1,1,1
TRAV20,TRAJ32,CAVQPNYGGATNKLIF,0,2,1,2
TRAV9-2,TRAJ35,CALSGGDFGNVLHC,0,1,1,1
TRAV17,TRAJ42,CATPFKGSQGNLIF,0,1,1,1
TRAV34,TRAJ29,CGAVVYSGNTPLVF,0,1,1,1
TRAV36DV7,TRAJ26,CAVSPLEGQNFVF,0,2,1,2
TRAV8-3,TRAJ16,CAVDTDGQKLLF,0,1,1,1
TRAV16,TRAJ30,CAPRGNDKIIF,0,1,1,1
TRAV16,TRAJ15,CALPAFNQAGTALIF,0,1,1,1
TRAV13-1,TRAJ9,CAASRDGGFKTIF,0,1,1,1
TRAV38-2DV8,TRAJ52,CAWTRNTNAGGTSYGKLTF,0,1,1,1
TRAV3,TRAJ48,CAVRDYLSNFGNEKLTF,0,1,1,1
TRAV3,TRAJ37,CAVRPPSNTGKLIF,0,2,1,2
TRAV23DV6,TRAJ45,CAINSGGGADGLTF,0,2,1,2
TRAV12-3,TRAJ49,CAMSERTGNQFYF,0,2,1,2
TRAV19,TRAJ40,CALRKGTYKYIF,0,1,1,1
TRAV29DV5,TRAJ45,CAASKSSGGGADELTF,0,1,1,1
TRAV25,TRAJ38,CAGRDAGNNRKLIW,0,1,1,1
TRAV9-2,TRAJ22,CALTTYVVSSGSARQLTF,0,2,1,2
TRAV20,TRAJ15,CAVQGRAEGDQAGTALIF,0,1,1,1
TRAV26-2,TRAJ52,CILRDENAGGTSYGKLTF,0,1,1,1
TRAV8-3,TRAJ42,CAVGGRPYGGSQGNLIF,0,1,1,1
TRAV3,TRAJ18,CAVGEPDRGSTLGRLYF,0,1,1,1
TRAV17,TRAJ28,CATAALYSGAGSYQLTF,0,1,1,1
TRAV29DV5,TRAJ53,CAATPGVGGGSNYKLTF,0,1,1,1
TRAV13-1,TRAJ45,CAASPMYSGGGADGLTF,0,1,1,1
TRAV14DV4,TRAJ40,CAMREGPRASGTYKYIF,0,1,1,1
TRAV26-1,TRAJ52,CIVRANAGGTSYGKLTF,0,1,1,1
TRAV38-2DV8,TRAJ57,CAYRSALWGGSEKLVF,0,1,1,1
TRAV38-2DV8,TRAJ32,CAYRVGYGGATNKLIF,0,1,1,1
TRAV9-2,TRAJ42,CALTPNYGGSQGNLIF,0,1,1,1
TRAV8-3,TRAJ18,CAVGTDRGSTLGRLYF,0,2,1,2
TRAV3,TRAJ18,CAVRDTRGSTLGRLYF,0,1,1,1
TRAV3,TRAJ5,CAVRDSPRTGRRALTF,0,1,1,1
TRAV23DV6,TRAJ53,CAASRSSGGSNYKLTF,0,1,1,1
TRAV14DV4,TRAJ46,CAMSPKKKSSGDKLTF,0,1,1,1
TRAV14DV4,TRAJ53,CAMREVIGGSNYKLTF,0,1,1,1
TRAV14DV4,TRAJ17,CAMREGLGAAGNKLTF,0,1,1,1
TRAV14DV4,TRAJ42,CAMREGLGGSQGNLIF,0,1,1,1
TRAV26-2,TRAJ45,CILRRPQGGGADGLTF,0,1,1,1
TRAV10,TRAJ48,CVVSSKAFGNEKLTF,0,1,1,1
TRAV12-1,TRAJ15,CVVNIVTQAGTALIF,0,1,1,1
TRAV12-1,TRAJ10,CVVKVLTGGGNKLTF,0,1,1,1
TRAV38-2DV8,TRAJ56,CAYRTRTGANSKLTF,0,1,1,1
TRAV38-2DV8,TRAJ29,CAYRSAYSGNTPLVF,0,1,1,1
TRAV38-2DV8,TRAJ33,CAYRRSQDSNYQLIW,0,1,1,1
TRAV21,TRAJ10,CALLILTGGGNKLTF,0,1,1,1
TRAV19,TRAJ56,CALSRVTGANSKLTF,0,1,1,1
TRAV9-2,TRAJ58,CALSGGETSGSRLTF,0,1,1,1
TRAV9-2,TRAJ6,CALSDLVGGSYIPTF,0,1,1,1
TRAV9-2,TRAJ58,CALSEGETSGSRLTF,0,1,1,1
TRAV9-2,TRAJ45,CALRHSGGGADGLTF,0,1,1,1
TRAV9-2,TRAJ32,CALRNYGGATNKLIF,0,1,1,1
TRAV6,TRAJ4,CALAPFSGGYNKLIF,0,1,1,1
TRAV27,TRAJ54,CAPYEGIGGAQKLVF,0,1,1,1
TRAV20,TRAJ3,CAVLSGYSSASKIIF,0,1,1,1
TRAV41,TRAJ45,CAVNGRRGGADGLTF,0,1,1,1
TRAV20,TRAJ42,CAVQADRGSQGNLIF,0,1,1,1
TRAV8-3,TRAJ36,CAVGPSQTGANNLFF,0,1,1,1
TRAV8-3,TRAJ34,CAVGAASGNTDKLIF,0,1,1,1
TRAV3,TRAJ3,CAVRASYSSASKIIF,0,1,1,1
TRAV3,TRAJ4,CAVRDISGDYNKLIF,0,2,1,2
TRAV21,TRAJ53,CAVGFRGGSNYKLTF,0,1,1,1
TRAV12-2,TRAJ42,CAAMNYGGSQGNLIF,0,1,1,1
TRAV17,TRAJ8,CATEKVNTGFQKLVF,0,1,1,1
TRAV12-2,TRAJ10,CAVRELTGGGNKLTF,0,1,1,1
TRAV12-2,TRAJ48,CAAPGGGFGNEKLTF,0,1,1,1
TRAV13-1,TRAJ15,CAASPTNQAGTALIF,0,1,1,1
TRAV29DV5,TRAJ10,CAASWGPGGGNKLTF,0,1,1,1
TRAV29DV5,TRAJ32,CAASAWRGATNKLIF,0,1,1,1
TRAV23DV6,TRAJ45,CAASIGRGGADGLTF,0,1,1,1
TRAV27,TRAJ47,CAGDRGMEYGNKLVF,0,1,1,1
TRAV13-2,TRAJ22,CAERGLSGSARQLTF,0,1,1,1
TRAV14DV4,TRAJ9,CAMREARRGGFKTIF,0,1,1,1
TRAV14DV4,TRAJ39,CAMRENNNAGNKLTF,0,1,1,1
TRAV14DV4,TRAJ3,CAMRERYSSASKIIF,0,1,1,1
TRAV4,TRAJ26,CLVGDRSNYGQNFVF,0,2,1,2
TRAV26-2,TRAJ28,CILRDSGAGSYQLTS,0,1,1,1
TRAV10,TRAJ3,CVVTVYSSASKIIF,0,1,1,1
TRAV10,TRAJ16,CVVTRLSDGQKLLF,0,1,1,1
TRAV12-1,TRAJ9,CVVNHGTGGFKTIF,0,2,1,2
TRAV38-1,TRAJ36,CAFESATGANNLFF,0,1,1,1
TRAV19,TRAJ38,CALVNAGNNRKLIW,0,1,1,1
TRAV9-2,TRAJ52,CALLGGTSYGKLTF,0,1,1,1
TRAV9-2,TRAJ13,CALGPSGGYQKVTF,0,1,1,1
TRAV19,TRAJ31,CALSEASNNARLMF,0,1,1,1
TRAV6,TRAJ3,CALDGYSSASKIIF,0,1,1,1
TRAV16,TRAJ57,CALTTQGGSEKLVF,0,2,1,2
TRAV16,TRAJ15,CALSAVQAGTALIF,0,1,1,1
TRAV9-2,TRAJ53,CALRSGGSNYNLTF,0,1,1,1
TRAV21,TRAJ5,CAVGMDTGRRALTF,0,1,1,1
TRAV41,TRAJ42,CAVDYGGSQGNLIF,0,1,1,1
TRAV41,TRAJ42,CAVRSGGSQGNLIF,0,2,1,2
TRAV8-3,TRAJ20,CAVGARSNDYKLSS,0,1,1,1
TRAV2,TRAJ26,CAVDRDNYGQNFVF,0,1,1,1
TRAV2,TRAJ13,CAVEDLGGYQKVTF,0,1,1,1
TRAV2,TRAJ42,CAVEDGGSQGNLIF,0,1,1,1
TRAV21,TRAJ26,CAVSSDNYGQNFVF,0,1,1,1
TRAV3,TRAJ35,CAVRAIGFGNVLHC,0,1,1,1
TRAV3,TRAJ7,CAVRAFYGNNRLAF,0,1,1,1
TRAV3,TRAJ21,CAVRDIDNFNKFYF,0,1,1,1
TRAV36DV7,TRAJ23,CAAEALNQGGKLIF,0,1,1,1
TRAV17,TRAJ16,CATAGFSDGQKLLF,0,1,1,1
TRAV17,TRAJ29,CATDAGSGNTPLVF,0,1,1,1
TRAV24,TRAJ54,CAFNLIQGAQKLVF,0,1,1,1
TRAV6,TRAJ31,CAPPEGENNARLMF,0,1,1,1
TRAV39,TRAJ22,CAVDRSGSARQLTF,0,1,1,1
TRAV39,TRAJ6,CAVDTTGGSYIPTF,0,1,1,1
TRAV8-1,TRAJ10,CAVISTGGGNKLTF,0,1,1,1
TRAV12-2,TRAJ42,CAVNYGGSQGNLIF,0,2,1,2
TRAV23DV6,TRAJ23,CAASRDNQGGKLIF,0,1,1,1
TRAV13-1,TRAJ57,CAAYYQGGSEKLVF,0,1,1,1
TRAV23DV6,TRAJ10,CAAVITGGGNKLTF,0,1,1,1
TRAV23DV6,TRAJ13,CAARHSGGYQKVTF,0,1,1,1
TRAV23DV6,TRAJ11,CAAALNPGYSTLTF,0,1,1,1
TRAV23DV6,TRAJ29,CAAGEFSGNTPLVF,0,1,1,1
TRAV13-1,TRAJ15,CAATDYQAGTALIF,0,1,1,1
TRAV13-1,TRAJ3,CAASIGSSASKIIF,0,1,1,1
TRAV29DV5,TRAJ41,CAASHLSSGYALNF,0,1,1,1
TRAV23DV6,TRAJ56,CAASGGGANSKLTL,0,1,1,1
TRAV29DV5,TRAJ42,CAASDSRSQGNLIF,0,1,1,1
TRAV29DV5,TRAJ40,CAASESAGTYKYIF,0,1,1,1
TRAV29DV5,TRAJ23,CAASMNNQGGKLIF,0,1,1,1
TRAV23DV6,TRAJ37,CAASSPSNTGKLIF,0,2,1,2
TRAV29DV5,TRAJ47,CAARTREYGNKLVF,0,1,1,1
TRAV13-2,TRAJ40,CAEERTSGTYKYIF,0,1,1,1
TRAV13-2,TRAJ15,CAETPNQAGTALIF,0,1,1,1
TRAV13-2,TRAJ5,CAENKRTGRRALTF,0,1,1,1
TRAV12-3,TRAJ16,CAMSSFSDGQKLLF,0,1,1,1
TRAV12-3,TRAJ7,CAMSSYYGNNRLAF,0,1,1,1
TRAV12-3,TRAJ35,CAMSKGGFGNVLHC,0,2,1,2
TRAV12-3,TRAJ41,CAMRSTDSGYALNF,0,1,1,1
TRAV14DV4,TRAJ48,CAMRGPSGNEKLTF,0,1,1,1
TRAV14DV4,TRAJ30,CAMREILEDDKVIL,0,1,1,1
TRAV12-3,TRAJ17,CAMNIKAAGNKLTF,0,1,1,1
TRAV26-2,TRAJ37,CILKVSSNTGKLIF,0,1,1,1
TRAV26-1,TRAJ43,CIVRPRGGNNDMRF,0,1,1,1
TRAV26-1,TRAJ26,CIVRVMDYGQNFVF,0,1,1,1
TRAV10,TRAJ48,CVPSNFGNEKLTF,0,1,1,1
TRAV12-1,TRAJ8,CVVTPTGFQKLVF,0,1,1,1
TRAV10,TRAJ15,CVVSSQAGTALIF,0,1,1,1
TRAV12-1,TRAJ32,CVVNGGATNKLIF,0,2,1,2
TRAV12-1,TRAJ39,CVVKENAGNMLTF,0,2,1,2
TRAV38-2DV8,TRAJ54,CAYRKQGAQKLVF,0,1,1,1
TRAV9-2,TRAJ4,CALSKGGYNKLIF,0,1,1,1
TRAV6,TRAJ7,CALGSWSNNRLAF,0,1,1,1
TRAV6,TRAJ30,CALDEGRDDKIIF,0,1,1,1
TRAV16,TRAJ34,CALSGYNTDKLIF,0,1,1,1
TRAV20,TRAJ37,CAVGGGNTGKLIF,0,1,1,1
TRAV21,TRAJ45,CAVPPPGADGLTF,0,2,1,2
TRAV2,TRAJ22,CAVVSGSARQLTF,0,1,1,1
TRAV2,TRAJ42,CAVVGGSQGNLIF,0,1,1,1
TRAV8-3,TRAJ9,CAVASTGGFKTIF,0,1,1,1
TRAV8-3,TRAJ36,CAVGAGGANNLFF,0,1,1,1
TRAV22,TRAJ6,CAVGSGGSYIPTF,0,1,1,1
TRAV22,TRAJ57,CAVEGGASEKLVF,0,1,1,1
TRAV22,TRAJ36,CAVRWAGANNLFF,0,1,1,1
TRAV12-3,TRAJ39,CAVRGNAGNMLTF,0,1,1,1
TRAV3,TRAJ34,CAVRDYNTDKLIF,0,1,1,1
TRAV3,TRAJ3,CAVRDGGASKIIF,0,1,1,1
TRAV21,TRAJ11,CAVNYSGYSTLTF,0,1,1,1
TRAV17,TRAJ12,CAAAMDSSYKLIF,0,1,1,1
TRAV17,TRAJ57,CATAQGGSEKLVF,0,1,1,1
TRAV17,TRAJ54,CATDGQGAQKLVF,0,1,1,1
TRAV13-1,TRAJ53,CASSGGSNYKLTF,0,1,1,1
TRAV36DV7,TRAJ40,CALSTSGTYKYIF,0,1,1,1
TRAV12-2,TRAJ22,CAVSSGSARQLTF,0,1,1,1
TRAV39,TRAJ49,CAVDIATGNQFYF,0,1,1,1
TRAV25,TRAJ33,CAGVGDSNYQLIW,0,1,1,1
TRAV23DV6,TRAJ38,CAASAGNNRKLIW,0,1,1,1
TRAV13-1,TRAJ22,CAASKGSARQLTF,0,1,1,1
TRAV23DV6,TRAJ26,CAASLNYGQNFVF,0,1,1,1
TRAV13-1,TRAJ3,CAASDSSASKIIF,0,2,1,2
TRAV23DV6,TRAJ37,CAASISNTGKLIF,0,1,1,1
TRAV27,TRAJ15,CAGLKWAGTALIF,0,1,1,1
TRAV25,TRAJ42,CAGPGGSQGNLIF,0,1,1,1
TRAV27,TRAJ40,CAGYKSGTYKYIF,0,1,1,1
TRAV5,TRAJ29,CAESFSGNTPLVF,0,1,1,1
TRAV13-2,TRAJ9,CAENYTGGFKTIF,0,1,1,1
TRAV12-3,TRAJ34,CAMGDYNTDKLIF,0,1,1,1
TRAV14DV4,TRAJ8,CAMTHTGFQKLVF,0,1,1,1
TRAV12-3,TRAJ42,CAMSRGSQGNLIF,0,1,1,1
TRAV26-2,TRAJ26,CPPALNYGQNFVF,0,1,1,1
TRAV26-2,TRAJ39,CILRDVPGNMLTS,0,1,1,1
TRAV26-1,TRAJ41,CIVPPGSGYALNF,0,1,1,1
TRAV26-1,TRAJ56,CIATLGANSKLTF,0,1,1,1
TRAV26-1,TRAJ48,CIAPRFGNEKLTF,0,1,1,1
TRAV12-1,TRAJ43,CVVPRGGNDMRF,0,2,1,2
TRAV36DV7,TRAJ37,CVGSSNTGKLIF,0,2,1,2
TRAV9-2,TRAJ33,CALRDSNYQLIW,0,1,1,1
TRAV9-2,TRAJ21,CALRRNFNKFYF,0,1,1,1
TRAV16,TRAJ26,CALSGYGQNFVF,0,1,1,1
TRAV23DV6,TRAJ37,CAVSSNTGKLIF,0,1,1,1
TRAV20,TRAJ27,CAVRANAGKSTF,0,1,1,1
TRAV8-3,TRAJ40,CAVGTGTYKYIF,0,1,1,1
TRAV21,TRAJ15,CAVDQAGTALIF,0,1,1,1
TRAV22,TRAJ47,CAVERGGNKLVF,0,1,1,1
TRAV2,TRAJ6,CAVEGGSYIPTF,0,1,1,1
TRAV2,TRAJ23,CAVRDQGGKLIF,0,2,1,2
TRAV12-2,TRAJ39,CAVRRAGNMLTF,0,1,1,1
TRAV1-2,TRAJ33,CAVRDSNYQLIW,0,2,1,2
TRAV2,TRAJ30,CAARPRDDKIIF,0,1,1,1
TRAV29DV5,TRAJ58,CAEETSGSRLTF,0,1,1,1
TRAV17,TRAJ41,CATSKSGYALNF,0,1,1,1
TRAV17,TRAJ34,CATDRNTDKLIF,0,1,1,1
TRAV17,TRAJ34,CATDPDTDKLIF,0,1,1,1
TRAV17,TRAJ12,CATMDSSYKLIF,0,1,1,1
TRAV20,TRAJ21,CAFQNNFNKFYF,0,1,1,1
TRAV12-2,TRAJ27,CAVSTNAGKSTF,0,1,1,1
TRAV13-1,TRAJ21,CAASRAFNKFYF,0,1,1,1
TRAV27,TRAJ16,CAGLLDGQKLLF,0,1,1,1
TRAV25,TRAJ40,CAGPTGTYKYIF,0,1,1,1
TRAV25,TRAJ39,CAGRGAGNMLTF,0,1,1,1
TRAV13-2,TRAJ43,CAETMNNNDMRF,0,1,1,1
TRAV13-2,TRAJ31,CAESSNNARLMF,0,1,1,1
TRAV12-3,TRAJ48,CAINFGNEKLTF,0,1,1,1
TRAV14DV4,TRAJ49,CAMREVIDQFYF,0,1,1,1
TRAV4,TRAJ29,CLVREGNTPLVF,0,1,1,1
TRAV26-1,TRAJ16,CIVSSYGQKLLF,0,1,1,1
TRAV25,TRAJ28,CSGAGSYQLTF,0,1,1,1
TRAV9-2,TRAJ21,CALRNFSKFYF,0,1,1,1
TRAV9-2,TRAJ29,CALRTQAPLVF,0,3,1,3
TRAV12-3,TRAJ34,CAPDNTDKLIF,0,1,1,1
TRAV41,TRAJ43,CAVRGNSDMRF,0,1,1,1
TRAV12-3,TRAJ49,CAVMTVGQFYF,0,1,1,1
TRAV20,TRAJ49,CAAGSPHQFYF,0,1,1,1
TRAV41,TRAJ34,CAADNTDKLIF,0,1,1,1
TRAV24,TRAJ31,CAFGNNARLMF,0,1,1,1
TRAV12-2,TRAJ43,CAVSNNNDMRF,0,1,1,1
TRAV12-2,TRAJ49,CAVNDGNQSYF,0,1,1,1
TRAV12-2,TRAJ16,CAAGDGQKLLF,0,1,1,1
TRAV13-2,TRAJ29,CADGGNTPLVF,0,1,1,1
TRAV23DV6,TRAJ29,CAARGNTPLVF,0,1,1,1
TRAV30,TRAJ43,CGTERNNDMRF,0,1,1,1
TRAV13-1,TRAJ22,CSGSARQLTF,0,2,1,2
TRAV3,TRAJ31,CALNNARLMF,0,1,1,1
TRAV17,TRAJ27,CATNAGKSTF,0,2,1,2
TRAV23DV6,TRAJ37,CAAYTGKLIF,0,1,1,1
TRAV14DV4,TRAJ43,CAMTVGGMRF,0,1,1,1
TRAV12-1,TRAJ43,CVVNLDMRF,0,2,1,2
TRAV25,TRAJ21,YNFNKFYF,0,2,1,2
TRAV3,TRAJ6,CAVRDIGGGSYIPTF,0,1,1,1
TRAV2,TRAJ17,CAVDLRAAGNKLTF,0,1,1,1
TRAV2,TRAJ6,CAVEGGGGSYIPTF,0,1,1,1
TRAV29DV5,TRAJ34,CAAPRSYNTDKLIF,0,2,1,2
TRAV3,TRAJ27,CAVRDMTTNAGKSTF,0,1,1,1
TRAV16,TRAJ44,CALSSGTASKLTF,0,1,1,1
TRAV26-2,TRAJ47,CILRREYGNKLVF,0,1,1,1
TRAV5,TRAJ5,CAATGRRALTF,0,1,1,1
TRAV8-3,TRAJ38,CAAGPARREAGNNRKLIW,0,1,1,1
TRAV8-1,TRAJ52,CAVKLPNAGGTSYGKLTF,0,1,1,1
TRAV38-2DV8,TRAJ42,CAYRRGNYGGSQGNLIF,0,1,1,1
TRAV8-3,TRAJ37,CAVGGYDGSSNTGKLIF,0,2,1,2
TRAV2,TRAJ10,CAVEVGILTGGGNKLTF,0,1,1,1
TRAV3,TRAJ28,CAVRVRTSGAGSYQLTF,0,1,1,1
TRAV17,TRAJ53,CATDASDSGGSSYKLTF,0,1,1,1
TRAV17,TRAJ42,CATDRVYYGGSQGNLIF,0,1,1,1
TRAV39,TRAJ45,CAVNGGRSGGGADGLTF,0,1,1,1
TRAV13-1,TRAJ53,CAASWSNSGGSNYKLTF,0,1,1,1
TRAV23DV6,TRAJ17,CAASNYLIKAAGNKLTF,0,1,1,1
TRAV14DV4,TRAJ23,CAMRELPIYNQGGKLIF,0,1,1,1
TRAV14DV4,TRAJ37,CAMREGAGSSSTGKLIF,0,1,1,1
TRAV14DV4,TRAJ37,CAMREGAGSSNTGTLIF,0,1,1,1
TRAV4,TRAJ36,CLVGDPGYQTGANNLFF,0,1,1,1
TRAV26-2,TRAJ42,CILRDVDYGGSQGNLIF,0,1,1,1
TRAV26-1,TRAJ48,CIVRVPISNFGNEKLTF,0,1,1,1
TRAV26-1,TRAJ44,CIVRASFNTGTASKLTF,0,1,1,1
TRAV38-2DV8,TRAJ16,CAYRSASRLRGQKLLF,0,1,1,1
TRAV38-2DV8,TRAJ48,CAYRSTPNFGNEKLTF,0,1,1,1
TRAV9-2,TRAJ52,CALTDTGGTSYGKLTF,0,1,1,1
TRAV9-2,TRAJ17,CALSDLVKAAGNKLTF,0,1,1,1
TRAV20,TRAJ52,CAVQARGGTSYGKLTF,0,1,1,1
TRAV3,TRAJ6,CAVSPNPPGGSYIPTF,0,1,1,1
TRAV21,TRAJ37,CAVNGSWSSNTGKLIF,0,1,1,1
TRAV12-2,TRAJ18,CAVNIDRGSTLGRLYF,0,1,1,1
TRAV13-1,TRAJ37,CAATPYGSSNTGKLIF,0,1,1,1
TRAV29DV5,TRAJ30,CAASDHSMNRDDKIIF,0,1,1,1
TRAV13-2,TRAJ53,CAENINSGGNNYKLTF,0,1,1,1
TRAV14DV4,TRAJ48,CAMQSVSNFGNEKLTF,0,1,1,1
TRAV14DV4,TRAJ17,CAMREAPKAAGNKLTF,0,1,1,1
TRAV34,TRAJ48,CGADILTNFGNEKLTF,0,1,1,1
TRAV4,TRAJ18,CLVGDPRGSTLGRLYF,0,1,1,1
TRAV4,TRAJ3,CLVGDMSYSSASKIIF,0,1,1,1
TRAV4,TRAJ6,CLVGDRASGGSYIPTF,0,1,1,1
TRAV4,TRAJ37,CLVGPLGSSNTGKLIF,0,1,1,1
TRAV26-1,TRAJ42,CIVSQDYGGSQGNLIF,0,1,1,1
TRAV10,TRAJ48,CVVTHSKVGNEKLTF,0,1,1,1
TRAV10,TRAJ10,CVVSASTGGGNKLTF,0,1,1,1
TRAV10,TRAJ42,CVVRPYGGSQGNLIF,0,1,1,1
TRAV12-1,TRAJ10,CVVNVLTVGGNKLTF,0,1,1,1
TRAV12-1,TRAJ42,CVVNDYGGSQGNLIF,0,1,1,1
TRAV12-1,TRAJ28,CVVNEPGAGSYQLTF,0,1,1,1
TRAV38-2DV8,TRAJ48,CAYILPNFGNEKLTF,0,1,1,1
TRAV38-2DV8,TRAJ57,CAYRTTQGGSEKLVF,0,1,1,1
TRAV38-2DV8,TRAJ44,CAYRSARGTASKLTF,0,1,1,1
TRAV38-2DV8,TRAJ48,CAYRSANFGNEKLTF,0,1,1,1
TRAV9-2,TRAJ39,CALSDRNNAGNMLTF,0,2,1,2
TRAV19,TRAJ26,CALSEGSDYGQNFVL,0,1,1,1
TRAV9-2,TRAJ57,CALSPFQGGSEELVF,0,1,1,1
TRAV16,TRAJ9,CALSPQNTGGFKTIF,0,1,1,1
TRAV41,TRAJ44,CAVLRSAGTASKLTF,0,1,1,1
TRAV20,TRAJ10,CAVQPRTGGGSKLTF,0,1,1,1
TRAV8-3,TRAJ4,CAVVPFSGGYNKLIF,0,1,1,1
TRAV8-3,TRAJ10,CAVVGLTGGGNKLTF,0,3,1,3
TRAV2,TRAJ18,CAVGDRGSTLGRLYF,0,1,1,1
TRAV2,TRAJ17,CAVGAIKAAGNKLTF,0,1,1,1
TRAV2,TRAJ39,CAVEAPYRAGNMLTF,0,1,1,1
TRAV21,TRAJ45,CAVIGPGGGADGLTF,0,1,1,1
TRAV21,TRAJ48,CAVMFIKFGSEKLTF,0,1,1,1
TRAV21,TRAJ56,CAVRPWAGANSKLTF,0,2,1,2
TRAV21,TRAJ8,CAVRPMNTGFQKLVF,0,1,1,1
TRAV3,TRAJ39,CAVRGLNNAGNMLTF,0,1,1,1
TRAV41,TRAJ53,CAAPNSGGSNYKLTF,0,1,1,1
TRAV17,TRAJ52,CATEALGTSYGKLTF,0,1,1,1
TRAV12-2,TRAJ10,CAVRRVTGGGNKLTF,0,1,1,1
TRAV12-2,TRAJ53,CAVNPTGGSNYKLTF,0,1,1,1
TRAV13-1,TRAJ22,CAACFHSGSARQLTF,0,1,1,1
TRAV23DV6,TRAJ5,CAAIPMDTGRRALTF,0,2,1,2
TRAV13-1,TRAJ27,CAASPAGTNAGKSTF,0,1,1,1
TRAV13-1,TRAJ7,CAASKENYGNNRLAF,0,1,1,1
TRAV29DV5,TRAJ34,CAASSFMGNTDKLIF,0,1,1,1
TRAV23DV6,TRAJ32,CAASSSGGATNKLIF,0,1,1,1
TRAV23DV6,TRAJ58,CAASIRETSGSRLTF,0,1,1,1
TRAV23DV6,TRAJ42,CAARTPLGSQGNLIF,0,1,1,1
TRAV25,TRAJ53,CAGRASGGSNYKLTF,0,1,1,1
TRAV25,TRAJ53,CAGRESGGSNYKLTF,0,1,1,1
TRAV12-3,TRAJ45,CAMSVSGGGADGLTF,0,1,1,1
TRAV14DV4,TRAJ32,CAMRGAGGATNKLIF,0,1,1,1
TRAV14DV4,TRAJ3,CAMRDPYSSASKIIF,0,1,1,1
TRAV14DV4,TRAJ9,CAMREAYTGGFKTIF,0,1,1,1
TRAV14DV4,TRAJ17,CAMREAKAAGNKLTF,0,1,1,1
TRAV14DV4,TRAJ20,CAMREAISNDYKLSF,0,1,1,1
TRAV14DV4,TRAJ15,CAMREGDQAGTALIF,0,1,1,1
TRAV14DV4,TRAJ27,CAMREGDTNAGKSTF,0,1,1,1
TRAV14DV4,TRAJ23,CAMREAYNQGGKLIF,0,1,1,1
TRAV34,TRAJ13,CGGRLSSGGYQKVTF,0,1,1,1
TRAV12-2,TRAJ6,CTVNAAAGGSYIPTF,0,1,1,1
TRAV4,TRAJ6,CLVGDQPGGSYIPTF,0,1,1,1
TRAV26-2,TRAJ53,CILRRSGGSNYKLTF,0,1,1,1
TRAV26-1,TRAJ13,CIVGALGGGYQKVTF,0,1,1,1
TRAV26-1,TRAJ42,CIVRVAGGSQGNLIF,0,1,1,1
TRAV12-1,TRAJ42,CVVFYGGSQGNLIF,0,1,1,1
TRAV10,TRAJ4,CVVGWAGGYNKLIF,0,2,1,2
TRAV12-1,TRAJ4,CVVPPSGGYNKLIF,0,1,1,1
TRAV12-1,TRAJ40,CVVGAPSGTYKYIF,0,1,1,1
TRAV38-1,TRAJ40,CAFMRTSGTYKYIF,0,1,1,1
TRAV38-2DV8,TRAJ34,CAYRSGYNTDKLIF,0,1,1,1
TRAV38-2DV8,TRAJ42,CAYRREGSQGNLIF,0,1,1,1
TRAV9-2,TRAJ15,CALIPNQAGTALIF,0,2,1,2
TRAV19,TRAJ10,CALTITGGGNKLTL,0,1,1,1
TRAV19,TRAJ33,CALSCMDSNYQLIW,0,1,1,1
TRAV9-2,TRAJ15,CALSQYQAGTALIF,0,1,1,1
TRAV9-2,TRAJ35,CALSDQGFGNVLHC,0,1,1,1
TRAV9-2,TRAJ49,CALSLSNTGNQFYF,0,1,1,1
TRAV16,TRAJ33,CALSGWDSNYQLIW,0,1,1,1
TRAV9-2,TRAJ17,CAQRIKAAGNKLTF,0,1,1,1
TRAV41,TRAJ38,CAVLNAGNNRKLIW,0,1,1,1
TRAV20,TRAJ29,CAVLTNSGNTPLVF,0,1,1,1
TRAV20,TRAJ36,CAVRAQTGANNLFF,0,1,1,1
TRAV20,TRAJ39,CAVQGFNAGNMLTF,0,1,1,1
TRAV8-3,TRAJ4,CAVGEPGGYNKLIF,0,1,1,1
TRAV8-3,TRAJ34,CAVGLSYNTDKLIF,0,1,1,1
TRAV8-3,TRAJ17,CAVGKQAAGNKLTF,0,1,1,1
TRAV2,TRAJ22,CAVEDKGSARQLTF,0,2,1,2
TRAV36DV7,TRAJ33,CAVEIRDSNYQLIW,0,1,1,1
TRAV3,TRAJ9,CAVRANTGGFKTIF,0,1,1,1
TRAV3,TRAJ13,CAVRDEGGYQKVTF,0,1,1,1
TRAV36DV7,TRAJ45,CAVKSGGGADGLTF,0,1,1,1
TRAV17,TRAJ58,CATAQETSGSRLTF,0,1,1,1
TRAV17,TRAJ53,CATDGRSSNYKLTF,0,1,1,1
TRAV20,TRAJ38,CALCGAGNNRKLIW,0,1,1,1
TRAV9-2,TRAJ27,CALREGTNAGKSTF,0,1,1,1
TRAV12-2,TRAJ49,CAVHLTNTGNQFYF,0,1,1,1
TRAV12-2,TRAJ53,CAVIGGGSNYKLTF,0,1,1,1
TRAV12-2,TRAJ6,CAVIGSGGSYIPTF,0,1,1,1
TRAV12-2,TRAJ26,CAVRNWNYGQNFVF,0,1,1,1
TRAV8-1,TRAJ13,CAVNGGGGYQKVTF,0,1,1,1
TRAV39,TRAJ47,CAALSAPYGNKLVF,0,1,1,1
TRAV12-2,TRAJ13,CAGPGSGGYQRVTF,0,1,1,1
TRAV13-1,TRAJ9,CAARSNTGGFKTIF,0,1,1,1
TRAV23DV6,TRAJ8,CAADMNTGFQKLVF,0,1,1,1
TRAV13-1,TRAJ16,CAAGAFSDGQKLLF,0,1,1,1
TRAV13-1,TRAJ21,CAATSPYNFNKFYF,0,1,1,1
TRAV23DV6,TRAJ20,CAATIRSNDYKLSF,0,1,1,1
TRAV13-1,TRAJ26,CAASMGNYGQNFVF,0,1,1,1
TRAV29DV5,TRAJ39,CAASASNAGNMLTF,0,1,1,1
TRAV23DV6,TRAJ48,CAASMSAGNEKLTF,0,1,1,1
TRAV23DV6,TRAJ36,CAASKYTGANNLFF,0,1,1,1
TRAV27,TRAJ17,CAGSIKAAGNKLTF,0,1,1,1
TRAV27,TRAJ22,CAGTSSGSARQLTF,0,1,1,1
TRAV25,TRAJ38,CAGDNAGNNRKLIW,0,1,1,1
TRAV13-2,TRAJ44,CAESDTGTASKLTF,0,1,1,1
TRAV13-2,TRAJ20,CAENIEGSDYKLSF,0,1,1,1
TRAV12-3,TRAJ15,CAMSPNQAGTALIF,0,1,1,1
TRAV12-3,TRAJ15,CAMSASQAGTALIF,0,1,1,1
TRAV12-3,TRAJ21,CAMSALYNFNKFYF,0,1,1,1
TRAV14DV4,TRAJ5,CAMRSDTGRRALTF,0,1,1,1
TRAV14DV4,TRAJ20,CAMREPSNDYKLSF,0,1,1,1
TRAV14DV4,TRAJ43,CAMREKLRNNDMRF,0,1,1,1
TRAV14DV4,TRAJ53,CAMKGGGSNYKLTF,0,1,1,1
TRAV34,TRAJ29,CGAASNSGNTPLVF,0,1,1,1
TRAV4,TRAJ30,CLVGSMNRDDKIIF,0,1,1,1
TRAV26-2,TRAJ48,CILPTNFGNEKLTF,0,2,1,2
TRAV26-2,TRAJ57,CILSPRGGSEKLVF,0,1,1,1
TRAV26-1,TRAJ13,CIVRVMRGYQKVTF,0,1,1,1
TRAV20,TRAJ8,CVNGGTGFQKLVF,0,1,1,1
TRAV10,TRAJ36,CVVFQTGANNLFF,0,1,1,1
TRAV12-1,TRAJ8,CVVNPEGFQKLVF,0,1,1,1
TRAV12-1,TRAJ42,CVVNVGSQGNLIF,0,1,1,1
TRAV12-1,TRAJ29,CVVKNSGNTPLVF,0,1,1,1
TRAV12-1,TRAJ53,CVGSGGSNYKLTF,0,1,1,1
TRAV38-2DV8,TRAJ48,CAFPNFGNEKLTF,0,1,1,1
TRAV21,TRAJ43,CASQSYNNNDMRF,0,1,1,1
TRAV38-2DV8,TRAJ44,CAYIPGTASKLTF,0,1,1,1
TRAV38-2DV8,TRAJ21,CAYSVYNFNKFYF,0,1,1,1
TRAV38-2DV8,TRAJ26,CAYRSDYGQNFVF,0,1,1,1
TRAV9-2,TRAJ48,CALTNFGNEKLTF,0,1,1,1
TRAV9-2,TRAJ34,CALSARNTDKLIF,0,1,1,1
TRAV9-2,TRAJ16,CALSGRDGQKLLF,0,1,1,1
TRAV19,TRAJ39,CALSMNAGNMLTF,0,1,1,1
TRAV19,TRAJ3,CALRYSSASKIIF,0,1,1,1
TRAV6,TRAJ39,CALVARAGNMLTF,0,1,1,1
TRAV21,TRAJ16,CAPWFSDGQKLLF,0,1,1,1
TRAV9-2,TRAJ29,CARLSSGNTPLVY,0,1,1,1
TRAV20,TRAJ22,CAVLSGSARQLTF,0,1,1,1
TRAV21,TRAJ50,CAVPKTSYDKVIF,0,1,1,1
TRAV3,TRAJ39,CAVVLYAGNMLTF,0,1,1,1
TRAV21,TRAJ37,CAVGSSNTGKLIF,0,2,1,2
TRAV22,TRAJ53,CAVSGGSNYKLTF,0,1,1,1
TRAV41,TRAJ54,CAVFYQGAQKLVF,0,1,1,1
TRAV20,TRAJ43,CAVQAYNNNDMRF,0,1,1,1
TRAV20,TRAJ3,CAVQASSASKIIF,0,1,1,1
TRAV8-3,TRAJ34,CAVGARGTDKLIF,0,1,1,1
TRAV22,TRAJ15,CAVGPQAGTALIF,0,1,1,1
TRAV2,TRAJ16,CAVGFSDGQKLLF,0,1,1,1
TRAV2,TRAJ41,CAVGPNSGYALNF,0,1,1,1
TRAV21,TRAJ20,CAVGISNDYKLSF,0,1,1,1
TRAV20,TRAJ50,CAVGKTSYDKVIF,0,1,1,1
TRAV22,TRAJ12,CAVGMDSSYKLIF,0,2,1,2
TRAV2,TRAJ40,CAVDTSGTYKYIF,0,1,1,1
TRAV2,TRAJ26,CAVEGNYGQNFVF,0,1,1,1
TRAV8-3,TRAJ39,CAVSPNAGNMLTF,0,1,1,1
TRAV3,TRAJ5,CAVRVTGRRALTF,0,1,1,1
TRAV21,TRAJ57,CAVNKGGSEKLVF,0,1,1,1
TRAV21,TRAJ45,CAVKRGGADGLTF,0,1,1,1
TRAV17,TRAJ57,CATSQGGSEKLVS,0,1,1,1
TRAV17,TRAJ34,CATARYNTDKLIF,0,1,1,1
TRAV17,TRAJ49,CATGSNTGNQFYF,0,1,1,1
TRAV17,TRAJ20,CATGGKDDYKLSF,0,1,1,1
TRAV17,TRAJ39,CATEPNAGNMLTF,0,1,1,1
TRAV17,TRAJ37,CATRLRNTGKLIF,0,1,1,1
TRAV12-2,TRAJ5,CALPDTGRRALTF,0,1,1,1
TRAV8-1,TRAJ38,CAVNAGNNRKLIW,0,1,1,1
TRAV12-2,TRAJ38,CAVHAGNNRKLIW,0,1,1,1
TRAV12-2,TRAJ6,CAVRPGGSYIPTF,0,1,1,1
TRAV29DV5,TRAJ29,CAAPLSGNTPLVF,0,1,1,1
TRAV23DV6,TRAJ54,CAASGRGAQKLVF,0,1,1,1
TRAV12-3,TRAJ38,CAFNAGNNRKLIW,0,1,1,1
TRAV12-3,TRAJ13,CALYSGGYQKVTF,0,1,1,1
TRAV13-1,TRAJ10,CAADTGGGNKLTF,0,1,1,1
TRAV13-1,TRAJ33,CAALRDSNYQLIW,0,1,1,1
TRAV25,TRAJ34,CAARSYNTDKLIF,0,1,1,1
TRAV29DV5,TRAJ39,CAASRNAGNMLTF,0,1,1,1
TRAV13-1,TRAJ50,CAASEASYDKVIF,0,1,1,1
TRAV13-1,TRAJ48,CAASNFGNEKLTF,0,1,1,1
TRAV13-1,TRAJ47,CAASNRYGNKLVF,0,2,1,2
TRAV13-1,TRAJ27,CAASKTNAGKSTF,0,1,1,1
TRAV23DV6,TRAJ35,CAASLNFGNVLHC,0,1,1,1
TRAV23DV6,TRAJ31,CAASIGGNARLMF,0,1,1,1
TRAV23DV6,TRAJ50,CAASKTSYDKVIF,0,1,1,1
TRAV23DV6,TRAJ22,CAARAGSARQLTF,0,1,1,1
TRAV25,TRAJ40,CAGYTSGTYKYIF,0,1,1,1
TRAV27,TRAJ57,CAGPGGGSEKLVF,0,1,1,1
TRAV27,TRAJ16,CAGGISDGQKLLF,0,1,1,1
TRAV27,TRAJ33,CAGALGSNYQLIW,0,1,1,1
TRAV27,TRAJ54,CAGTPPGAQKLVF,0,1,1,1
TRAV13-2,TRAJ21,CAENIRDFNKFYF,0,2,1,2
TRAV12-3,TRAJ15,CAIRNQAGTALIF,0,1,1,1
TRAV12-3,TRAJ22,CAMPRGSARQLTF,0,1,1,1
TRAV12-3,TRAJ45,CAMGTGGADGLTF,0,2,1,2
TRAV12-3,TRAJ49,CAMSAGTGNQFYF,0,1,1,1
TRAV12-3,TRAJ36,CAMSNTGANDLFF,0,1,1,1
TRAV12-3,TRAJ34,CAMRLYNTDKLIF,0,1,1,1
TRAV12-3,TRAJ11,CAMRESGYSTLTF,0,1,1,1
TRAV14DV4,TRAJ6,CAMRDGGSYIPTF,0,1,1,1
TRAV14DV4,TRAJ13,CAMREVGYQKVTF,0,1,1,1
TRAV4,TRAJ15,CLVVNQAGTALIF,0,1,1,1
TRAV4,TRAJ33,CLVGAQSNYQLIW,0,1,1,1
TRAV4,TRAJ34,CLVGAYNTDKLIF,0,2,1,2
TRAV4,TRAJ6,CLVGAGGSYIPTF,0,2,1,2
TRAV26-2,TRAJ17,CILTKAAGNKLTF,0,1,1,1
TRAV26-2,TRAJ39,CILRDVPGNMLTF,0,1,1,1
TRAV26-1,TRAJ42,CIDYGGSQGNLIF,0,1,1,1
TRAV41,TRAJ50,RAVKWTSYDKVIF,0,1,1,1
TRAV21,TRAJ20,CVVRPYDYKLSF,0,1,1,1
TRAV12-1,TRAJ36,CVVQTGANNLFF,0,1,1,1
TRAV12-1,TRAJ17,CVVKAAGNKLTF,0,1,1,1
TRAV12-1,TRAJ36,CVVDGGANNLFF,0,1,1,1
TRAV10,TRAJ37,CVVSGNTGKLIF,0,1,1,1
TRAV12-1,TRAJ11,CVVNGGYSTLTF,0,1,1,1
TRAV12-1,TRAJ37,CVVKGNTGKLIF,0,1,1,1
TRAV38-1,TRAJ34,CAFGSYTDKLIF,0,1,1,1
TRAV9-2,TRAJ9,CALRTGGFKTIF,0,2,1,2
TRAV19,TRAJ27,CALETNAGKSTF,0,1,1,1
TRAV6,TRAJ23,CALYNQGGKLIF,0,1,1,1
TRAV36DV7,TRAJ27,CALGTNAGKSTF,0,1,1,1
TRAV16,TRAJ48,CALTPGNEKLTF,0,1,1,1
TRAV16,TRAJ35,CALKGFGNVLHC,0,1,1,1
TRAV36DV7,TRAJ34,CAPRRGADKLIF,0,1,1,1
TRAV20,TRAJ7,CARVHGNNRLAF,0,1,1,1
TRAV41,TRAJ33,CAVGRSNYQLIW,0,1,1,1
TRAV20,TRAJ43,CAVRLNNNDMRF,0,1,1,1
TRAV12-2,TRAJ36,CAVRGGANNLFF,0,1,1,1
TRAV8-3,TRAJ48,CAVGDGNEKLTF,0,1,1,1
TRAV12-2,TRAJ26,CAVSDYGQNFVF,0,1,1,1
TRAV8-4,TRAJ53,CAVSEGNYKLTF,0,1,1,1
TRAV17,TRAJ15,CATPETGTALIF,0,1,1,1
TRAV17,TRAJ34,CATDLLSDKLIF,0,1,1,1
TRAV17,TRAJ20,CATDADDCKLSF,0,1,1,1
TRAV13-1,TRAJ39,CAPRDAGNMLTF,0,1,1,1
TRAV23DV6,TRAJ24,CAPTDSWGKLQF,0,1,1,1
TRAV39,TRAJ41,CAVDDSGYALNF,0,1,1,1
TRAV36DV7,TRAJ43,CAVGYNNNDMRF,0,2,1,2
TRAV13-2,TRAJ16,CARRSDGQKLLF,0,1,1,1
TRAV29DV5,TRAJ48,CAAYFGNEKLTF,0,1,1,1
TRAV13-1,TRAJ48,CAAGFGNEKLTF,0,2,1,2
TRAV13-1,TRAJ34,CAAILNTDKLIF,0,1,1,1
TRAV23DV6,TRAJ29,CAARTGNTPLVF,0,1,1,1
TRAV13-1,TRAJ29,CAGCSGNTPLVF,0,1,1,1
TRAV25,TRAJ41,CAGPNSGYALNF,0,1,1,1
TRAV13-2,TRAJ37,CAEPSNTGKLIF,0,1,1,1
TRAV5,TRAJ7,CAEKEGNNRLAF,0,1,1,1
TRAV12-3,TRAJ17,CAMSKQGNKLTF,0,1,1,1
TRAV12-3,TRAJ42,CAMGGSQGNLIF,0,1,1,1
TRAV14DV4,TRAJ43,CAMREDNNDMRF,0,1,1,1
TRAV4,TRAJ13,CLVGRGYQKVTF,0,1,1,1
TRAV30,TRAJ30,CGTWERDDKIIF,0,1,1,1
TRAV30,TRAJ20,CGTVSNDYKLSF,0,1,1,1
TRAV26-2,TRAJ40,CILFSGTYKYIS,0,1,1,1
TRAV26-2,TRAJ36,CIPHGGANNLFF,0,1,1,1
TRAV26-1,TRAJ28,CIVEAGSYQLTF,0,1,1,1
TRAV13-1,TRAJ35,CLIGFGNVLHC,0,1,1,1
TRAV17,TRAJ50,CRKTSYDKVIF,0,1,1,1
TRAV2,TRAJ21,CASYNFNKFYF,0,1,1,1
TRAV12-2,TRAJ15,CACQAGTALIF,0,1,1,1
TRAV9-2,TRAJ29,CALRTRAPLVF,0,2,1,2
TRAV16,TRAJ40,CALPGTCKYIF,0,1,1,1
TRAV9-2,TRAJ3,CALSSASKIIF,0,1,1,1
TRAV21,TRAJ49,CAVMSVGQFYF,0,1,1,1
TRAV35,TRAJ49,CAGVTGNQFYF,0,1,1,1
TRAV12-2,TRAJ20,CAVTGGYKLSF,0,1,1,1
TRAV13-1,TRAJ43,CAASFIGDMRF,0,1,1,1
TRAV27,TRAJ34,CAGVYTDKLIF,0,1,1,1
TRAV27,TRAJ21,CAGDNFNKFYF,0,1,1,1
TRAV5,TRAJ29,CAESGNTPLVF,0,1,1,1
TRAV12-3,TRAJ9,CAMGGGFKTIF,0,1,1,1
TRAV34,TRAJ49,CGTSTGNQFYF,0,1,1,1
TRAV16,TRAJ13,CAPLEQNVTF,0,1,1,1
TRAV17,TRAJ49,CATVYNQFYF,0,1,1,1
TRAV12-2,TRAJ20,CAVSLNKLSF,0,1,1,1
TRAV13-1,TRAJ49,CAASRGQFYF,0,1,1,1
TRAV13-1,TRAJ37,CAANTGKLIF,0,1,1,1
TRAV8-3,TRAJ9,CAPYFKTIF,0,1,1,1
TRAV26-1,TRAJ20,CIVGYKLSF,0,1,1,1
TRAV6,TRAJ37,FTTGKLIF,0,1,1,1
TRAV12-2,TRAJ36,CAVQTGANNLFF,0,1,1,1
TRAV8-3,TRAJ18,CAVGARDRGSTLGRLYF,0,1,1,1
TRAV26-1,TRAJ37,CIVRWLNGSSNTGKLIF,0,1,1,1
TRAV26-1,TRAJ54,CIVRVGRIIQGAQKLVF,0,1,1,1
TRAV3,TRAJ17,CAVRDMGEAAGNKLTF,0,1,1,1
TRAV41,TRAJ58,CAVRSEETSGSRLTF,0,1,1,1
TRAV27,TRAJ57,CAGALGQGGSEKLVF,0,1,1,1
TRAV4,TRAJ6,CLVDPSTGGSYIPTF,0,1,1,1
TRAV12-1,TRAJ26,CVVNMGNYGQNFVF,0,1,1,1
TRAV9-2,TRAJ39,CALRLNNAGNMLTF,0,1,1,1
TRAV17,TRAJ12,CAPKGMDSSYKLIF,0,1,1,1
TRAV13-1,TRAJ12,CAASKMDSSYKLIF,0,1,1,1
TRAV36DV7,TRAJ45,CAVFSGGADGLTF,0,1,1,1
TRAV23DV6,TRAJ20,CAASMRNDYKLSF,0,1,1,1
TRAV4,TRAJ30,CLVGPLRDDKIIF,0,2,1,2
TRAV8-6,TRAJ49,CAVRNTGNQFYF,0,1,1,1
TRAV17,TRAJ32,CATEVSYGGATNKLIF,0,1,1,1
TRAV30,TRAJ3,CGTGFGYSSASKIIF,0,1,1,1
TRAV20,TRAJ27,CAAQDPNAGKSTF,0,1,1,1
TRAV29DV5,TRAJ49,CAAMGSTGNLFYF,0,1,1,1
TRAV12-1,TRAJ16,CVPRDGQKLLF,0,1,1,1
TRAV29DV5,TRAJ31,CAASDARLMF,0,1,1,1
TRAV16,TRAJ52,CAFKNAGGTSYGKLTF,0,1,1,1
TRAV38-2DV8,TRAJ52,CAYRSAGVRAGGTSYGKLTF,0,1,1,1
TRAV12-2,TRAJ52,CAVNRAPGAGGSSYGKLTF,0,1,1,1
TRAV9-2,TRAJ22,CALTTYEVSSGSARQLTF,0,1,1,1
TRAV12-2,TRAJ24,CAVNRRCLTTDSWGKLQF,0,1,1,1
TRAV23DV6,TRAJ48,CAASLASISNFGNEKLTF,0,1,1,1
TRAV13-1,TRAJ38,CAASIHRYYAGNNRKLIW,0,1,1,1
TRAV13-1,TRAJ48,CAASRPLLSNFGNEKLTF,0,1,1,1
TRAV14DV4,TRAJ28,CAMRELSYSGAGSYQLTF,0,1,1,1
TRAV14DV4,TRAJ48,CAMREGGVSNFGNEKLTF,0,1,1,1
TRAV9-2,TRAJ52,CALSVRAGGTSYGKLTS,0,1,1,1
TRAV8-3,TRAJ38,CAVGPTTYAGNNRKLIW,0,1,1,1
TRAV12-2,TRAJ52,CAVSTNAGGTSYGKLTF,0,1,1,1
TRAV3,TRAJ4,CAVRDMITSGVYNKLIF,0,1,1,1
TRAV39,TRAJ42,CAVVTLNYGGSQGNLIF,0,1,1,1
TRAV13-1,TRAJ18,CAASTPDRGSTLGRLYF,0,1,1,1
TRAV29DV5,TRAJ42,CAARVMNYGGSQGNLIF,0,1,1,1
TRAV14DV4,TRAJ57,CAMRVLGTQGGSEKLVF,0,1,1,1
TRAV14DV4,TRAJ12,CAMREGRTMDSSYKLIF,0,1,1,1
TRAV14DV4,TRAJ37,CAMREGKGSSNTGKLIF,0,1,1,1
TRAV4,TRAJ4,CLVGDSLLSGGYNKLIF,0,1,1,1
TRAV26-2,TRAJ42,CILSGLRYGGSQGNLIF,0,1,1,1
TRAV26-1,TRAJ23,CIVRVPALYNQGGKLIF,0,1,1,1
TRAV26-1,TRAJ52,SIVRVSAGGTSYGKLTF,0,1,1,1
TRAV12-1,TRAJ27,CVAPRAQDTNAGKSTF,0,1,1,1
TRAV38-1,TRAJ57,CAFMSTAQGGSEKLVF,0,1,1,1
TRAV38-2DV8,TRAJ34,CAYRSVRSYNTDKLIF,0,1,1,1
TRAV9-2,TRAJ45,CALSPYSGGGADGLTL,0,1,1,1
TRAV9-2,TRAJ17,CALSDQAKAAGNKLTF,0,1,1,1
TRAV36DV7,TRAJ53,CAVKENSGGSNYKLTF,0,1,1,1
TRAV41,TRAJ30,CAVSLGPRGRRDKIIF,0,1,1,1
TRAV21,TRAJ56,CAVLIFDTGANSKLTF,0,2,1,2
TRAV20,TRAJ22,CAVQVPSSGSARQLTF,0,1,1,1
TRAV21,TRAJ42,CAVRPHYGGSQGNLIF,0,1,1,1
TRAV21,TRAJ24,CAVRPGTTDSWGKLQF,0,1,1,1
TRAV3,TRAJ42,CAVRDYYGGSQGNLIF,0,1,1,1
TRAV17,TRAJ57,CAAAPHLEGGSEKLVL,0,1,1,1
TRAV17,TRAJ52,CATPWGGGTSYGKLTF,0,1,1,1
TRAV12-2,TRAJ24,CAVNFMTTDSWGKLQF,0,1,1,1
TRAV13-1,TRAJ28,CAPFSYSGAGSYQLTF,0,1,1,1
TRAV29DV5,TRAJ53,CAASYNSGGSNYKLTF,0,1,1,1
TRAV29DV5,TRAJ42,CAASASYGGSQGNLIF,0,1,1,1
TRAV23DV6,TRAJ17,CAASGRTGAAGNKLTF,0,1,1,1
TRAV29DV5,TRAJ53,CAASGPSGGSNYKLTF,0,1,1,1
TRAV29DV5,TRAJ57,CAASEKDQGGSEELVF,0,1,1,1
TRAV29DV5,TRAJ36,CAANRGYQTGANNLFF,0,1,1,1
TRAV14DV4,TRAJ42,CAMWMNYGGSQGNLIF,0,1,1,1
TRAV12-3,TRAJ48,CAMSGASNFGNEKLTF,0,1,1,1
TRAV14DV4,TRAJ20,CAMREGHRSNDYKLSF,0,1,1,1
TRAV14DV4,TRAJ9,CAMREGGSTGGFKTIF,0,1,1,1
TRAV14DV4,TRAJ10,CAKREALGRGGNKLTF,0,1,1,1
TRAV4,TRAJ37,CLVGDAPPSNTGKLIF,0,1,1,1
TRAV4,TRAJ37,CLVGDIGASNTGKLIF,0,1,1,1
TRAV4,TRAJ37,CLEGPLGSSNTGKLIF,0,1,1,1
TRAV30,TRAJ6,CGSEREASGGSYIPTF,0,1,1,1
TRAV26-1,TRAJ40,CIVRVASTSGTYKYIF,0,1,1,1
TRAV26-1,TRAJ32,CIVRVDYGGATNKLIF,0,1,1,1
TRAV12-1,TRAJ9,CVVELEGTGGFKTIF,0,1,1,1
TRAV12-1,TRAJ18,CVVIDRGSTLGRLYF,0,1,1,1
TRAV12-1,TRAJ6,CVVTLASGGSYIPTF,0,1,1,1
TRAV12-1,TRAJ33,CVVNLGMDSNYQLIW,0,1,1,1
TRAV12-1,TRAJ32,CVVNHYGGATNKLIF,0,1,1,1
TRAV12-1,TRAJ42,CVAKWYGGSQGNLIF,0,1,1,1
TRAV38-1,TRAJ44,CAFMTFTGTASKLTF,0,1,1,1
TRAV38-1,TRAJ40,CAFMSPTSGTYKYIF,0,1,1,1
TRAV38-1,TRAJ39,CAFMKGANAGNMLTF,0,1,1,1
TRAV38-2DV8,TRAJ15,CAYRTINQAGTALIF,0,1,1,1
TRAV38-2DV8,TRAJ48,CAYRSFNFGNEKLTL,0,1,1,1
TRAV38-2DV8,TRAJ58,CAYRREETSGSRLTF,0,1,1,1
TRAV19,TRAJ54,CALSVINQGAQKLVF,0,1,1,1
TRAV9-2,TRAJ37,CALSEITSNTGKLIF,0,1,1,1
TRAV9-2,TRAJ5,CALSELGPGRRALTF,0,1,1,1
TRAV9-2,TRAJ6,CALRTSSGGSYIPTF,0,1,1,1
TRAV9-2,TRAJ27,CALSDRDTNAGKSTF,0,1,1,1
TRAV16,TRAJ37,CALRDGSSNTGKLIF,0,1,1,1
TRAV6,TRAJ28,CAPLSKGAGSYKLTF,0,1,1,1
TRAV12-2,TRAJ18,CAPDDRGSTLGRLYF,0,1,1,1
TRAV20,TRAJ42,CARGVYGGSQGNLIF,0,1,1,1
TRAV12-3,TRAJ42,CAVQNYGGSQGNLIF,0,1,1,1
TRAV41,TRAJ57,CAVSRMQGGSEKLVF,0,1,1,1
TRAV41,TRAJ57,CAVRSPQGGSEKLVF,0,1,1,1
TRAV3,TRAJ12,CAVRPRMDSSYKLIF,0,2,1,2
TRAV20,TRAJ49,CAVQAYPNTGNQFYF,0,1,1,1
TRAV20,TRAJ21,CAVQDEGYNFNKFHF,0,1,1,1
TRAV21,TRAJ53,CAVDYSGGSNYKLTF,0,2,1,2
TRAV22,TRAJ44,CAVEHDTGTASKLTF,0,1,1,1
TRAV3,TRAJ4,CAVTLGAGGYNKLIF,0,1,1,1
TRAV8-4,TRAJ40,CAVSSYTSGTYKYIF,0,1,1,1
TRAV8-4,TRAJ40,CAVSSYTSGTYKYIL,0,1,1,1
TRAV12-2,TRAJ26,CAVRPWDNYGQNFVF,0,1,1,1
TRAV3,TRAJ30,CAVRGDMNRDDKIIF,0,1,1,1
TRAV21,TRAJ17,CAATLFKAAGNKLTF,0,1,1,1
TRAV17,TRAJ28,CATSYSGAGSYQLTF,0,1,1,1
TRAV17,TRAJ32,CATAAYGGATNKLIF,0,1,1,1
TRAV17,TRAJ37,CATDDRASNTGKLIF,0,1,1,1
TRAV20,TRAJ4,CALPPSSGGYNKLIF,0,1,1,1
TRAV39,TRAJ40,CAVDSWASGTYKYIF,0,1,1,1
TRAV12-2,TRAJ8,CAVNKMNTGFQKLVF,0,1,1,1
TRAV38-2DV8,TRAJ52,CANNAGGTSYGKLAF,0,1,1,1
TRAV23DV6,TRAJ40,CAASPTTSGTYKYIF,0,1,1,1
TRAV13-1,TRAJ28,CAATRSGAGSYQLTF,0,1,1,1
TRAV13-1,TRAJ44,CAASAPPGTASKLTF,0,1,1,1
TRAV13-1,TRAJ45,CAASRWGGGADGLTF,0,1,1,1
TRAV13-1,TRAJ53,CAASRSGGSNYKLTF,0,2,1,2
TRAV29DV5,TRAJ28,CAASAGGAGSYQLTF,0,1,1,1
TRAV29DV5,TRAJ36,CAASEGIAGANNLFF,0,1,1,1
TRAV29DV5,TRAJ40,CAARLTTSGTYKYIS,0,1,1,1
TRAV27,TRAJ45,CAGSYSGGGADGLTF,0,1,1,1
TRAV27,TRAJ41,CAGLLGANSGYALNF,0,1,1,1
TRAV5,TRAJ38,CAESMYAGNNRKLIW,0,1,1,1
TRAV13-2,TRAJ45,CAENPPGGGADGLTF,0,1,1,1
TRAV12-3,TRAJ11,CAMSIMNSGYSTLTF,0,1,1,1
TRAV12-3,TRAJ53,CAMSLSGGSNYKLTF,0,1,1,1
TRAV14DV4,TRAJ4,CAMRAFSGGYNKLIL,0,1,1,1
TRAV14DV4,TRAJ39,CAMREYNNAGNMLTF,0,1,1,1
TRAV14DV4,TRAJ21,CAMREPIYNFNKFYF,0,1,1,1
TRAV14DV4,TRAJ20,CAMRETRSNDYKLSF,0,1,1,1
TRAV12-3,TRAJ22,CATPEPGGSARQLTF,0,1,1,1
TRAV4,TRAJ35,CLVAPGIGFGNVLHC,0,1,1,1
TRAV4,TRAJ37,CLVGAGSSNTGKLIF,0,1,1,1
TRAV4,TRAJ36,CLVGDAQTGANNLFF,0,1,1,1
TRAV26-2,TRAJ37,CPWPFDSSNTGKLIF,0,1,1,1
TRAV26-2,TRAJ40,CILRGSTSGAYKYIF,0,1,1,1
TRAV26-2,TRAJ21,CILRDVVRNFNKFYF,0,1,1,1
TRAV26-2,TRAJ48,CILRDTIFGNEKLTF,0,1,1,1
TRAV26-1,TRAJ13,CIVRGYSGGYQKVTF,0,1,1,1
TRAV8-3,TRAJ39,CVVGHNNAGNMLTF,0,1,1,1
TRAV12-1,TRAJ10,CVVTLTGGGNKLTF,0,1,1,1
TRAV10,TRAJ15,CVVTSNQAGTALIF,0,1,1,1
TRAV12-1,TRAJ9,CVVTGNTGGFKTIF,0,1,1,1
TRAV12-1,TRAJ10,CVVSPTGGGNKLTF,0,1,1,1
TRAV10,TRAJ26,CVVSAKNYGQNFVF,0,1,1,1
TRAV10,TRAJ47,CVVNPMEYGNKLVF,0,1,1,1
TRAV12-1,TRAJ37,CVVNISSNTGKLIF,0,1,1,1
TRAV38-1,TRAJ33,CAFMKHDSNYQLIW,0,1,1,1
TRAV38-2DV8,TRAJ30,CAYRSSNRDDKIIF,0,1,1,1
TRAV38-2DV8,TRAJ30,CAYRSARRDNKIIF,0,1,1,1
TRAV6,TRAJ5,CALPGGTGRRALTF,0,1,1,1
TRAV9-2,TRAJ23,CALGGNNQGGKLIF,0,1,1,1
TRAV19,TRAJ3,CALGVDSSASKIIF,0,1,1,1
TRAV9-2,TRAJ57,CALTPQGGSEKLVF,0,1,1,1
TRAV9-2,TRAJ21,CALSDRDNFNKFYF,0,1,1,1
TRAV9-2,TRAJ56,CALSDQGKRSKLTF,0,1,1,1
TRAV9-2,TRAJ48,CALRTNFGNEKLTF,0,1,1,1
TRAV16,TRAJ13,CALSGVGGYQKVTF,0,1,1,1
TRAV12-2,TRAJ37,CAPGGPSNTGKLIF,0,1,1,1
TRAV22,TRAJ29,CAVLGNSGNTPLVF,0,1,1,1
TRAV2,TRAJ39,CAVLPSNAGNMLTF,0,1,1,1
TRAV12-2,TRAJ34,CAVETPYNTDKLIF,0,1,1,1
TRAV41,TRAJ33,CAVIVRGSNYQLIW,0,1,1,1
TRAV41,TRAJ42,CAVSRGGSQGNLIF,0,1,1,1
TRAV21,TRAJ37,CAVWSSSNTGKLIF,0,1,1,1
TRAV8-3,TRAJ33,CAVPMVDSNYQLIW,0,1,1,1
TRAV2,TRAJ5,CAVHQDTGRRALTF,0,1,1,1
TRAV2,TRAJ27,CAVAYNTNAGRSTF,0,1,1,1
TRAV8-3,TRAJ30,CAVGAPSRDDKIIF,0,1,1,1
TRAV2,TRAJ26,CAVDADNYGQNFVF,0,1,1,1
TRAV2,TRAJ34,CAVEDLFNTDKLIF,0,1,1,1
TRAV2,TRAJ20,CAVEDRSNDYKLSF,0,1,1,1
TRAV8-4,TRAJ57,CAVSVKSGSEKLVF,0,1,1,1
TRAV8-4,TRAJ9,CAVSDRTGGFKTIF,0,1,1,1
TRAV3,TRAJ7,CAVSLLYGNNRLAF,0,1,1,1
TRAV3,TRAJ26,CAVSAIIYGQNFVF,0,1,1,1
TRAV21,TRAJ32,CAVRPGGATNKLIF,0,1,1,1
TRAV21,TRAJ37,CAVRPISNTGKLIF,0,1,1,1
TRAV1-2,TRAJ4,CAVRVSGGYNKLIF,0,1,1,1
TRAV12-2,TRAJ37,CAVNRSGNTGKLIF,0,1,1,1
TRAV21,TRAJ39,CAVKDNNAGNMLTF,0,1,1,1
TRAV21,TRAJ3,CAATLYSSASKIIF,0,1,1,1
TRAV13-1,TRAJ32,CADMRGGATNKLIF,0,1,1,1
TRAV12-2,TRAJ52,CADSGGTSYGKLTF,0,1,1,1
TRAV41,TRAJ32,CADRDGGATNMLIF,0,1,1,1
TRAV17,TRAJ40,CATPPLDGPYKYIF,0,1,1,1
TRAV17,TRAJ16,CATDFISDGQKLLF,0,1,1,1
TRAV17,TRAJ8,CATDRRAGFQKLVI,0,1,1,1
TRAV17,TRAJ24,CATNPGDSWGKLQF,0,1,1,1
TRAV24,TRAJ40,CAFISTSGTYKYIF,0,1,1,1
TRAV12-2,TRAJ8,CAFRGNTGFQKLVF,0,1,1,1
TRAV12-2,TRAJ37,CAVALTSNTGKLIF,0,1,1,1
TRAV12-2,TRAJ5,CAVRVDTGRRALTF,0,1,1,1
TRAV12-2,TRAJ29,CAVNLNSGNTPLVF,0,1,1,1
TRAV12-2,TRAJ9,CAVNENTGGFKTIF,0,1,1,1
TRAV12-2,TRAJ45,CAVNEGGGADGLTF,0,1,1,1
TRAV12-2,TRAJ21,CAIFRGYNFNKFYF,0,1,1,1
TRAV38-2DV8,TRAJ53,CAKWEGGSNYKLTF,0,1,1,1
TRAV13-1,TRAJ52,CAATGGTSYGKLTF,0,1,1,1
TRAV13-1,TRAJ42,CAAPYGGSQGNLIF,0,2,1,2
TRAV23DV6,TRAJ49,CAAIDPNTGNQFNF,0,1,1,1
TRAV23DV6,TRAJ31,CAALPAGNNARLMF,0,1,1,1
TRAV29DV5,TRAJ56,CAARGTGANSKLTF,0,1,1,1
TRAV29DV5,TRAJ45,CAAQRGGGADGLTF,0,1,1,1
TRAV29DV5,TRAJ40,CAAGLFSGTYKYIF,0,1,1,1
TRAV13-1,TRAJ50,CAADMKTSYDKVIL,0,1,1,1
TRAV23DV6,TRAJ57,CAADYQGGSEKLVF,0,1,1,1
TRAV13-1,TRAJ34,CAATLSYNTDKLIF,0,1,1,1
TRAV29DV5,TRAJ48,CAASLPFGNEKLTF,0,1,1,1
TRAV13-1,TRAJ7,CAASPPYGNNRLAF,0,1,1,1
TRAV29DV5,TRAJ33,CAASGTDSNYQLIW,0,1,1,1
TRAV13-1,TRAJ48,CAASGEFGNEKLTF,0,1,1,1
TRAV13-1,TRAJ5,CAASINTGRRALTF,0,1,1,1
TRAV13-1,TRAJ3,CAASMGSSASKIIF,0,1,1,1
TRAV13-1,TRAJ39,CAASMGNAGNMLTF,0,1,1,1
TRAV13-1,TRAJ49,CAASIVGTGNQFYF,0,2,1,2
TRAV23DV6,TRAJ17,CAASSGPAGNKLTF,0,1,1,1
TRAV13-1,TRAJ37,CAASRGSNTGKLIF,0,1,1,1
TRAV29DV5,TRAJ22,CAASPTGSARQLTF,0,1,1,1
TRAV29DV5,TRAJ40,CAASAYGGTYKYIF,0,1,1,1
TRAV29DV5,TRAJ37,CAASGLSNTGKLIF,0,1,1,1
TRAV23DV6,TRAJ13,CAASIGGGYQKVTF,0,1,1,1
TRAV23DV6,TRAJ47,CAASRMEYGNKLVF,0,1,1,1
TRAV23DV6,TRAJ44,CAASRTGTASKLTF,0,1,1,1
TRAV23DV6,TRAJ41,CAASRVNSGYALNF,0,1,1,1
TRAV25,TRAJ53,CAGHRGGSNYKLTF,0,1,1,1
TRAV27,TRAJ32,CAGADGGATNKLIF,0,1,1,1
TRAV27,TRAJ23,CAGTLDIQGGKLIF,0,1,1,1
TRAV27,TRAJ37,CAGARSSNTGKLIF,0,2,1,2
TRAV5,TRAJ10,CAEMYTGGGNNLTF,0,1,1,1
TRAV5,TRAJ16,CAETRFSDGQKLLF,0,1,1,1
TRAV5,TRAJ4,CAESGSGGYNKLIF,0,1,1,1
TRAV5,TRAJ42,CAESNGGSQGNLIF,0,1,1,1
TRAV13-2,TRAJ54,CAERLIQGAQKLVF,0,1,1,1
TRAV13-2,TRAJ47,CAENIVEYGNKLVF,0,1,1,1
TRAV12-3,TRAJ48,CAMSSFFGNEKLTF,0,1,1,1
TRAV12-3,TRAJ54,CAMSDIQGAQKLVF,0,1,1,1
TRAV14DV4,TRAJ44,CAMSLTGTASKHTF,0,1,1,1
TRAV12-3,TRAJ3,CAMSAYSSASKIIF,0,1,1,1
TRAV12-3,TRAJ6,CAMSGTGGSYIPTF,0,1,1,1
TRAV12-3,TRAJ54,CAMRVLQGAQKLVF,0,1,1,1
TRAV14DV4,TRAJ54,CAMRAIQGAQKLVF,0,1,1,1
TRAV14DV4,TRAJ20,CAMRRRPNDYKLSF,0,1,1,1
TRAV14DV4,TRAJ34,CAMRPRYNTDKLIF,0,1,1,1
TRAV14DV4,TRAJ21,CAMRGRYNFNKFYF,0,1,1,1
TRAV14DV4,TRAJ49,CAMREYSSGNQFYF,0,1,1,1
TRAV14DV4,TRAJ49,CAMREVNTGNQFYF,0,1,1,1
TRAV12-2,TRAJ48,CAIPSNFGNEKLTF,0,1,1,1
TRAV34,TRAJ39,CGADAHGAGNMLTF,0,1,1,1
TRAV34,TRAJ6,CGADRTGGSYIPTF,0,1,1,1
TRAV4,TRAJ7,CLVVKVDGNNRLAF,0,1,1,1
TRAV4,TRAJ39,CLVAPDNAGNMLTF,0,1,1,1
TRAV4,TRAJ27,CLVGANTNAGKSTF,0,1,1,1
TRAV12-1,TRAJ37,CPRTGSSNTGKLIF,0,1,1,1
TRAV5,TRAJ27,CAASDNTNAGKSTF,0,1,1,1
TRAV30,TRAJ49,CGTVSPHTGNQFYF,0,1,1,1
TRAV30,TRAJ40,CGTDYTSGTYKYIF,0,1,1,1
TRAV26-2,TRAJ17,CILIIKAAGNKLTF,0,1,1,1
TRAV26-2,TRAJ36,CILRIVAGANNLFF,0,1,1,1
TRAV26-1,TRAJ22,CIVHFSGSARQLTF,0,1,1,1
TRAV26-1,TRAJ17,CIVVGEAAGNKLTF,0,1,1,1
TRAV26-1,TRAJ42,CIVYYGGSQGNLIF,0,1,1,1
TRAV26-1,TRAJ48,CIVRPPFGNEKLTF,0,1,1,1
TRAV26-1,TRAJ34,CIVRDPLGADKLIF,0,1,1,1
TRAV17,TRAJ47,YATDAEEYGNKLVF,0,1,1,1
TRAV13-1,TRAJ6,RAASSRGGSYIPTF,0,1,1,1
TRAV8-3,TRAJ40,CPNPPPGTYIYIF,0,1,1,1
TRAV12-1,TRAJ24,CVVSPDSWGKLQF,0,1,1,1
TRAV12-1,TRAJ22,CVVISGSARQLTF,0,1,1,1
TRAV10,TRAJ31,CVVRGNNNARLMF,0,1,1,1
TRAV12-1,TRAJ10,CVVNKGGGDKLTF,0,1,1,1
TRAV9-2,TRAJ33,CASYMDSNYQLIW,0,1,1,1
TRAV17,TRAJ9,CASRNTGGFKTIF,0,1,1,1
TRAV38-2DV8,TRAJ54,CASIIQGAQKLVF,0,1,1,1
TRAV38-2DV8,TRAJ37,CACSGSNTGKLIF,0,1,1,1
TRAV38-2DV8,TRAJ31,CAYSRPNNARLMF,0,1,1,1
TRAV38-2DV8,TRAJ30,CAYRTNRDDKIIL,0,1,1,1
TRAV9-2,TRAJ20,CALFGSNDYKLSF,0,1,1,1
TRAV9-2,TRAJ13,CALLSGGYQKVTF,0,1,1,1
TRAV9-2,TRAJ12,CALLMDSSYKLIF,0,1,1,1
TRAV6,TRAJ9,CALVRTGGFKTIF,0,1,1,1
TRAV16,TRAJ48,CALKGFGNEKLTF,0,1,1,1
TRAV36DV7,TRAJ40,CAPLLSGTYKYIF,0,1,1,1
TRAV21,TRAJ44,CAVPTGTASKLTF,0,1,1,1
TRAV22,TRAJ20,CAVPPFNDYKLSF,0,1,1,1
TRAV41,TRAJ44,CAVLTGTASKLTF,0,1,1,1
TRAV8-3,TRAJ7,CAVLYYGNNRLAF,0,1,1,1
TRAV41,TRAJ57,CAVNQGGSEKLVF,0,1,1,1
TRAV12-2,TRAJ49,CAVLRSTGNQFYF,0,1,1,1
TRAV8-3,TRAJ34,CAVVRCNTDKLIF,0,1,1,1
TRAV20,TRAJ5,CAVAMEGRRALTF,0,1,1,1
TRAV8-3,TRAJ29,CAVGPRGNTPLVF,0,1,1,1
TRAV8-3,TRAJ45,CAVGGGGADGLTF,0,1,1,1
TRAV2,TRAJ33,CAVEDASNYQLIW,0,1,1,1
TRAV12-2,TRAJ33,CAVMEDSNYQLIW,0,1,1,1
TRAV3,TRAJ37,CAVRGSNTGKLIF,0,1,1,1
TRAV2,TRAJ13,CAVNSGGYQKVTF,0,1,1,1
TRAV12-2,TRAJ29,CAVNYLRNTPLVF,0,1,1,1
TRAV20,TRAJ5,CAVMDTGRRALTF,0,1,1,1
TRAV41,TRAJ49,CAAPQNTGNQFYF,0,1,1,1
TRAV21,TRAJ27,CAALNTNAGKSTF,0,1,1,1
TRAV17,TRAJ36,CATRQTGANNLFF,0,1,1,1
TRAV17,TRAJ48,CATANFGNEKLTF,0,1,1,1
TRAV17,TRAJ31,CATDAIGNARLMF,0,1,1,1
TRAV17,TRAJ58,CATDETSGSRLTF,0,1,1,1
TRAV17,TRAJ45,CATRGGGADGLTF,0,2,1,2
TRAV24,TRAJ26,CAFKRDYGQNFVF,0,1,1,1
TRAV3,TRAJ13,CAYPSGGYQKVTF,0,1,1,1
TRAV13-2,TRAJ39,CALGGNAGNMLTF,0,1,1,1
TRAV12-2,TRAJ12,CAVGRDSSYKLIF,0,1,1,1
TRAV8-1,TRAJ22,CAVNALSARQLTF,0,1,1,1
TRAV12-2,TRAJ47,CAVNHGYGNKLVF,0,1,1,1
TRAV12-2,TRAJ42,CAVNVGSQGNLIF,0,1,1,1
TRAV8-1,TRAJ23,CAVKKNQGGKLIF,0,1,1,1
TRAV8-1,TRAJ39,CAAHNNAGNMLTF,0,1,1,1
TRAV13-2,TRAJ20,CAVLAPEDYKLSF,0,1,1,1
TRAV29DV5,TRAJ50,CAAEKTSYDKVIF,0,1,1,1
TRAV13-1,TRAJ36,CAAFQTGANNLFF,0,1,1,1
TRAV13-1,TRAJ4,CAALSGGYNKLIF,0,1,1,1
TRAV13-1,TRAJ20,CAALNPNDYKLSF,0,1,1,1
TRAV13-1,TRAJ5,CAAGDTGRRALTF,0,1,1,1
TRAV27,TRAJ49,CAAPSNTGNQFYF,0,2,1,2
TRAV13-1,TRAJ48,CAAFNFGNEKLTF,0,1,1,1
TRAV13-1,TRAJ27,CAAWNTNAGKSTF,0,1,1,1
TRAV23DV6,TRAJ9,CAAALVGGFKTIF,0,1,1,1
TRAV13-1,TRAJ6,CAAIWGGSYIPTF,0,1,1,1
TRAV13-1,TRAJ40,CAATLSGTYKYIF,0,1,1,1
TRAV23DV6,TRAJ34,CAASFLGTDKLIF,0,2,1,2
TRAV13-1,TRAJ48,CAASMGGNEKLTF,0,1,1,1
TRAV13-1,TRAJ15,CAASKKAGTALIF,0,1,1,1
TRAV23DV6,TRAJ37,CAASVSNTGKLIF,0,1,1,1
TRAV29DV5,TRAJ43,CAASAINNNDMRF,0,1,1,1
TRAV29DV5,TRAJ43,CAASALENNDMRF,0,1,1,1
TRAV23DV6,TRAJ23,CAASDNQGGKLIF,0,1,1,1
TRAV23DV6,TRAJ31,CAASIHNNARLMF,0,1,1,1
TRAV23DV6,TRAJ40,CAASNTGTYKYIF,0,1,1,1
TRAV23DV6,TRAJ40,CAARTSGTYKYIF,0,1,1,1
TRAV13-1,TRAJ36,CAARTTGANNLFF,0,1,1,1
TRAV25,TRAJ9,CAGQDTGGFKTIF,0,1,1,1
TRAV25,TRAJ13,CAGRSGSYQKVTF,0,1,1,1
TRAV27,TRAJ9,CAGWDTGGFKTIF,0,1,1,1
TRAV25,TRAJ28,CAGHGAGSYQLTF,0,1,1,1
TRAV27,TRAJ43,CAGVRGYNNDMRF,0,1,1,1
TRAV27,TRAJ47,CAGVLGYRNKLVF,0,1,1,1
TRAV27,TRAJ4,CAGASGGYNKLIF,0,1,1,1
TRAV13-2,TRAJ24,CAETSDSWGKLQF,0,2,1,2
TRAV13-2,TRAJ9,CAETDTGGFKTIF,0,1,1,1
TRAV5,TRAJ13,CAESLGGYQKVTF,0,1,1,1
TRAV13-2,TRAJ34,CAERAYNTDKLVF,0,1,1,1
TRAV13-2,TRAJ10,CAERTGGGNKLTF,0,2,1,2
TRAV13-2,TRAJ26,CAENYNYGQNFVF,0,1,1,1
TRAV13-2,TRAJ44,CAENTGTASKLTF,0,1,1,1
TRAV13-2,TRAJ5,CAENNTGRRALTF,0,1,1,1
TRAV14DV4,TRAJ34,CAMAPYNTDKLIF,0,1,1,1
TRAV12-3,TRAJ9,CAMTNTGGFKTIF,0,1,1,1
TRAV12-3,TRAJ20,CAMSFSNDYKLSF,0,1,1,1
TRAV12-3,TRAJ5,CAMSEAGRRALTF,0,1,1,1
TRAV12-3,TRAJ34,CAMRAYNTDKLIF,0,1,1,1
TRAV12-3,TRAJ58,CAMRGTSGSRLTF,0,1,1,1
TRAV14DV4,TRAJ23,CAMRDRQGGKLIF,0,1,1,1
TRAV14DV4,TRAJ49,CAMRRNTGNQFYF,0,1,1,1
TRAV12-3,TRAJ13,CAMKTGGYQKVTF,0,1,1,1
TRAV4,TRAJ5,CLVWGTGRRALTF,0,1,1,1
TRAV4,TRAJ34,CLVGDHNTDKLIF,0,1,1,1
TRAV30,TRAJ36,CGTEQTGANNLFF,0,1,1,1
TRAV26-2,TRAJ43,CILGQYNNNDMRF,0,1,1,1
TRAV26-2,TRAJ34,CILRRYNTDKLIF,0,1,1,1
TRAV26-2,TRAJ49,CILRDDTGIQFYF,0,1,1,1
TRAV26-1,TRAJ32,CIALGGATNKLIF,0,1,1,1
TRAV12-1,TRAJ3,RGALYSSASKIIF,0,1,1,1
TRAV12-1,TRAJ3,CVVGSSASKIIF,0,1,1,1
TRAV12-1,TRAJ33,CVVIPSNYQLIW,0,1,1,1
TRAV12-1,TRAJ49,CVVITTGNQFYF,0,1,1,1
TRAV12-1,TRAJ29,CVVNSGNTPLVF,0,1,1,1
TRAV12-1,TRAJ41,CVVGNSGYALNF,0,1,1,1
TRAV38-1,TRAJ31,CAFIKFDARLMF,0,1,1,1
TRAV38-1,TRAJ47,CAFTEYGNKLVF,0,1,1,1
TRAV9-2,TRAJ21,CALRYNFNKFYF,0,1,1,1
TRAV9-2,TRAJ35,CALSGFENVLHC,0,1,1,1
TRAV9-2,TRAJ36,CALSTGANNLFF,0,1,1,1
TRAV9-2,TRAJ49,CALANTGNQFYF,0,1,1,1
TRAV9-2,TRAJ29,CALDSGDTPLVF,0,1,1,1
TRAV9-2,TRAJ34,CALSKNTDKLIF,0,1,1,1
TRAV9-2,TRAJ27,CALRTNAGKSTF,0,1,1,1
TRAV9-2,TRAJ36,CALKAGANNLFF,0,1,1,1
TRAV16,TRAJ30,CALSRGDDRIIF,0,1,1,1
TRAV17,TRAJ12,CAPMDSSYKLIL,0,1,1,1
TRAV38-2DV8,TRAJ39,CAHNNAGNMLTF,0,1,1,1
TRAV21,TRAJ39,CAVPNAGNTLTF,0,1,1,1
TRAV21,TRAJ16,CAVHSDGQKLLF,0,1,1,1
TRAV20,TRAJ49,CAVQAPGNQFYF,0,1,1,1
TRAV21,TRAJ34,CAVQGNTDKLIF,0,1,1,1
TRAV8-3,TRAJ27,CAVGADAGKSTF,0,1,1,1
TRAV22,TRAJ49,CAVGITGNQFYF,0,1,1,1
TRAV2,TRAJ34,CAVDYNTDKLIF,0,1,1,1
TRAV2,TRAJ31,CAVEDWNARLMF,0,1,1,1
TRAV36DV7,TRAJ27,CAVETNAGKSTF,0,1,1,1
TRAV21,TRAJ47,CAVSRYGNKLVF,0,1,1,1
TRAV12-2,TRAJ20,CAVRPNDYKLSF,0,1,1,1
TRAV21,TRAJ20,CAVRFNDYKLSF,0,1,1,1
TRAV2,TRAJ21,CAVNGRLNKFYF,0,1,1,1
TRAV36DV7,TRAJ50,CAVKTSYDKVIF,0,1,1,1
TRAV2,TRAJ29,CAVLSGNTPLVF,0,1,1,1
TRAV8-3,TRAJ12,CAVEGSSYKLIF,0,1,1,1
TRAV8-6,TRAJ26,CAAHNYGQNFVF,0,1,1,1
TRAV38-2DV8,TRAJ52,CAGGTSYGKLTF,0,1,1,1
TRAV2,TRAJ9,CADKRGGFKTIF,0,1,1,1
TRAV3,TRAJ35,CATIGFGNVLHC,0,1,1,1
TRAV17,TRAJ45,CATVHLYAGLTF,0,1,1,1
TRAV17,TRAJ34,CATDLNTDKLIF,0,1,1,1
TRAV17,TRAJ45,CATDAFPDGLTF,0,1,1,1
TRAV24,TRAJ31,CAFIDNNARLMF,0,1,1,1
TRAV24,TRAJ41,CAFMNSGYALNF,0,1,1,1
TRAV12-2,TRAJ34,CALSLNTDKLIF,0,1,1,1
TRAV12-2,TRAJ9,CAPDLGGFKTIF,0,1,1,1
TRAV23DV6,TRAJ39,CAPQAAGNMLTF,0,1,1,1
TRAV12-2,TRAJ5,CAPGVGRRALTF,0,1,1,1
TRAV12-2,TRAJ40,CAVTSGTYKYIF,0,1,1,1
TRAV20,TRAJ7,CAVTRGNNRLVF,0,1,1,1
TRAV3,TRAJ33,CAAMDSNYQLIW,0,1,1,1
TRAV12-2,TRAJ44,CAATGTASKLTF,0,1,1,1
TRAV12-2,TRAJ23,CAGDNQGGKLIF,0,1,1,1
TRAV25,TRAJ16,CAAPSDGQKLLF,0,1,1,1
TRAV13-1,TRAJ49,CAAVGTGNQFYF,0,1,1,1
TRAV13-1,TRAJ29,CAAGRGNTPLVF,0,1,1,1
TRAV13-1,TRAJ47,CAASNEAGKLVF,0,1,1,1
TRAV23DV6,TRAJ22,CAASVNARQLTF,0,1,1,1
TRAV13-2,TRAJ54,CAASDRAQKLVF,0,1,1,1
TRAV13-1,TRAJ43,CAARLSNNDMRF,0,1,1,1
TRAV25,TRAJ33,CAGMDSNYQLIW,0,1,1,1
TRAV27,TRAJ36,CAGFTGANNLFF,0,1,1,1
TRAV27,TRAJ20,CAGPPNDYKLSF,0,1,1,1
TRAV27,TRAJ41,CAGDESGYALNF,0,1,1,1
TRAV5,TRAJ21,CAEMYNFNKFYF,0,1,1,1
TRAV12-3,TRAJ21,CAMVGNFNKFYF,0,1,1,1
TRAV23DV6,TRAJ52,CDGGTSYGKLTF,0,1,1,1
TRAV4,TRAJ6,CLVGGGSYIPTF,0,1,1,1
TRAV4,TRAJ13,CLVGGGYQKVTF,0,2,1,2
TRAV30,TRAJ34,CGTERDTDKLIF,0,1,1,1
TRAV27,TRAJ44,YKNTGTASKLTF,0,1,1,1
TRAV12-1,TRAJ43,CVVRDNNDMRF,0,1,1,1
TRAV12-1,TRAJ21,CVALNFNKFYF,0,1,1,1
TRAV17,TRAJ29,CAWGGNTPLVF,0,1,1,1
TRAV6,TRAJ49,CALERGNQFYF,0,1,1,1
TRAV16,TRAJ47,CALMGGNKLVF,0,1,1,1
TRAV41,TRAJ58,CAVRFSSRLTF,0,1,1,1
TRAV20,TRAJ43,CAVQDIGDMRF,0,1,1,1
TRAV2,TRAJ30,CAVEDHDKIIF,0,1,1,1
TRAV17,TRAJ40,CATEGTYKYIF,0,1,1,1
TRAV17,TRAJ20,CATENDYKLSF,0,1,1,1
TRAV12-2,TRAJ49,CATNTGNQFYF,0,1,1,1
TRAV17,TRAJ37,CAFSNTGKLIF,0,2,1,2
TRAV24,TRAJ7,CAFYGNNRLAF,0,1,1,1
TRAV17,TRAJ52,CARTSYGKLTF,0,1,1,1
TRAV12-2,TRAJ54,CAVQGAQKLVF,0,1,1,1
TRAV25,TRAJ50,CAVPPSDKVIF,0,1,1,1
TRAV5,TRAJ31,CAETPNARLMF,0,1,1,1
TRAV5,TRAJ16,CAERDGQKLLF,0,1,1,1
TRAV12-3,TRAJ21,CAMENFNKFYF,0,1,1,1
TRAV12-3,TRAJ31,CAMSNNARLMF,0,1,1,1
TRAV12-2,TRAJ11,YAVTGYSTLTF,0,1,1,1
TRAV38-2DV8,TRAJ22,CAYRRRQLTF,0,1,1,1
TRAV21,TRAJ43,CAVFEADMRF,0,1,1,1
TRAV24,TRAJ40,CAFKTYNYIF,0,1,1,1
TRAV29DV5,TRAJ48,CAAANEKLTF,0,1,1,1
TRAV13-1,TRAJ30,CAAPEGKIIF,0,1,1,1
TRAV5,TRAJ27,CAESHLKSTF,0,1,1,1
TRAV13-2,TRAJ43,CAEKPNDMRF,0,1,1,1
TRAV29DV5,TRAJ20,CGFNDYKLSF,0,1,1,1
TRAV26-1,TRAJ11,CIRGYSTLTF,0,2,1,2
TRAV12-1,TRAJ43,CVVNSAMRF,0,1,1,1
TRAV27,TRAJ43,CARGNDMRF,0,1,1,1
TRAV12-1,TRAJ31,CAANARLMF,0,1,1,1
TRAV12-2,TRAJ43,CAVRGMRF,0,1,1,1
TRAV38-2DV8,TRAJ43,CARDMRF,0,1,1,1
TRAV23DV6,TRAJ32,CTNKLIF,0,1,1,1
TRAV9-2,TRAJ10,CALSDQGVTGGGNKLTF,0,1,1,1
TRAV4,TRAJ28,CLVGDKYSGAGSYHLTF,0,1,1,1
TRAV21,TRAJ45,CAVNQRSGGGADGLTF,0,1,1,1
TRAV8-4,TRAJ4,CAVSAFSGGYNKLIF,0,1,1,1
TRAV23DV6,TRAJ49,CAASRSSDTGNQFYF,0,2,1,2
TRAV4,TRAJ3,CLVGLTYSSASKIIF,0,1,1,1
TRAV8-3,TRAJ36,CAVCDQTGANNLFF,0,1,1,1
TRAV16,TRAJ58,CALTGASGSRLTF,0,1,1,1
TRAV13-1,TRAJ26,CAACSDYGQNFVF,0,1,1,1
TRAV4,TRAJ8,CPAPERGFQKLVF,0,1,1,1
TRAV39,TRAJ48,CAVAFGNEKLTF,0,1,1,1
TRAV12-2,TRAJ16,CAAFSDGQKLLF,0,1,1,1
TRAV29DV5,TRAJ36,CAAPGGANNLFF,0,1,1,1
TRAV13-2,TRAJ21,CAEGGNFNKFYF,0,1,1,1
TRAV4,TRAJ23,CLVGDGGGKLIF,0,1,1,1
TRAV2,TRAJ20,CAERDYYKLSF,0,1,1,1
TRAV38-2DV8,TRAJ43,CAYSMYNNNDVRF,0,1,1,1
TRAV23DV6,TRAJ17,CAASKEIKAAGNKLTF,0,1,1,1
TRAV22,TRAJ42,CAVLEGSQGNLIF,0,1,1,1
TRAV12-1,TRAJ6,SLRWDRLAFGKGNQVVVIPRGSYIPTF,0,1,1,1
TRAV20,TRAJ52,CAAQPGVINAGGTSYGKLTF,0,1,1,1
TRAV35,TRAJ45,CAGPQIEMYSGGGADGLTF,0,1,1,1
TRAV26-1,TRAJ32,CIVRVPATMYGGATNKLIF,0,1,1,1
TRAV38-2DV8,TRAJ52,CAYWGYNAGGTSNGKLTF,0,1,1,1
TRAV21,TRAJ28,CAVRIGIDSGAGSYQLTF,0,1,1,1
TRAV23DV6,TRAJ45,CAASSLMYSGGGADGLTF,0,1,1,1
TRAV29DV5,TRAJ52,CAAKGRNAGGTSYGKLTF,0,1,1,1
TRAV12-1,TRAJ23,CVVKRPLNYNQGGKLIF,0,1,1,1
TRAV38-2DV8,TRAJ28,CAYRLLYSGAGSYQLTF,0,1,1,1
TRAV38-2DV8,TRAJ44,CAYRSARETGTASKLTF,0,1,1,1
TRAV9-2,TRAJ42,CALSPVNYGGSQGNLIF,0,1,1,1
TRAV12-2,TRAJ42,CAVEQVNYGGSQGNLIF,0,1,1,1
TRAV3,TRAJ4,CAVRDSPFSGGYNKLIF,0,1,1,1
TRAV12-2,TRAJ22,CAVPPTLSSGSARQLTF,0,1,1,1
TRAV13-1,TRAJ16,CAASLVPFLSDGQKLLF,0,1,1,1
TRAV23DV6,TRAJ18,CAARRTDRGSTLGRLYF,0,1,1,1
TRAV13-1,TRAJ10,CAASRGGLTGGGNKLTF,0,1,1,1
TRAV23DV6,TRAJ52,CAASIPWGGTSYGKLTF,0,1,1,1
TRAV27,TRAJ18,CAGSTLDRGSTLGRLYF,0,1,1,1
TRAV4,TRAJ22,CLVGDLISSGSARQLTF,0,1,1,1
TRAV4,TRAJ23,CLVGESMIYNQGGKLIF,0,1,1,1
TRAV26-1,TRAJ22,CIVRFPISSGSARQLTY,0,1,1,1
TRAV26-1,TRAJ42,CIVRVLPNGGSQGNLIF,0,1,1,1
TRAV26-1,TRAJ28,CIVRAPYSGAGSYQLTF,0,1,1,1
TRAV8-2,TRAJ38,CVVSAYNAGNNRKLIW,0,1,1,1
TRAV12-1,TRAJ40,CVVNPVTTSGTYKYIF,0,1,1,1
TRAV12-1,TRAJ15,CVVNKGLNQAGTALIF,0,1,1,1
TRAV38-2DV8,TRAJ45,CAYRSYSGGGADGLTF,0,1,1,1
TRAV38-2DV8,TRAJ38,CAYRTTNAGNNRKLIW,0,1,1,1
TRAV38-2DV8,TRAJ40,CAYRSARTSGTYKYIF,0,1,1,1
TRAV38-2DV8,TRAJ22,CAYRSTISGSARQLTF,0,1,1,1
TRAV9-2,TRAJ53,CALTPRSGGSNYKLTF,0,1,1,1
TRAV9-2,TRAJ45,CALSDRLVGGADGLTF,0,1,1,1
TRAV9-2,TRAJ52,CALSETGGTSYGKLTF,0,1,1,1
TRAV20,TRAJ52,CAVRSAGGTSYGKLTF,0,1,1,1
TRAV8-3,TRAJ42,CAVGPPYGGSQGNLIF,0,1,1,1
TRAV8-3,TRAJ57,CAVGAKGQGGSEKLVF,0,1,1,1
TRAV36DV7,TRAJ57,CAVGLLTQGGSEKLVF,0,1,1,1
TRAV8-6,TRAJ6,CAVSGHASGGSYIPTF,0,1,1,1
TRAV3,TRAJ22,CAVRLSSSGSARQLTF,0,1,1,1
TRAV3,TRAJ27,CAVRDPHNTNAGKSTF,0,1,1,1
TRAV3,TRAJ15,CAVRDIANQAGTALIF,0,1,1,1
TRAV12-2,TRAJ8,CAVKGGMNTGFQKLVF,0,1,1,1
TRAV20,TRAJ52,CAVPLDGGTSYGKLTF,0,1,1,1
TRAV21,TRAJ18,CAGSSSGGSTLGRLYF,0,1,1,1
TRAV17,TRAJ34,CATAFVRSYNTDKLIF,0,1,1,1
TRAV17,TRAJ6,CATGGPASGGSYIPTF,0,1,1,1
TRAV24,TRAJ37,CAFDNQGSSNTGKLIF,0,1,1,1
TRAV24,TRAJ48,CALFPLTNFGNEKLTF,0,1,1,1
TRAV24,TRAJ10,CALWLGLTGGGNKLTF,0,1,1,1
TRAV12-2,TRAJ52,CAVIGAGGTSYGKLTF,0,1,1,1
TRAV12-2,TRAJ36,CAVTPGDQTGANNLFF,0,1,1,1
TRAV8-1,TRAJ18,CAVNKNRGSTLGRLYF,0,1,1,1
TRAV12-2,TRAJ4,CAVNPEFSGGYNKLIF,0,1,1,1
TRAV12-2,TRAJ53,CAVNTRSGGSNYKLTF,0,1,1,1
TRAV25,TRAJ52,CAGRDAGGTSYGKLTF,0,1,1,1
TRAV25,TRAJ37,CAARLPGSSNTGKLIF,0,1,1,1
TRAV13-1,TRAJ3,CAAATPGYSSASKIIF,0,1,1,1
TRAV29DV5,TRAJ42,CAATYDYGGSQGNLIF,0,1,1,1
TRAV13-1,TRAJ38,CAATALNAGNNRKLIW,0,1,1,1
TRAV13-1,TRAJ52,CAASLGGGTSYGKLTF,0,1,1,1
TRAV29DV5,TRAJ52,CAASPIGGTSYGKLAF,0,1,1,1
TRAV13-1,TRAJ13,CAASPGPSGGCQKVTF,0,1,1,1
TRAV13-1,TRAJ13,CAASPGPSGGYQKVTF,0,1,1,1
TRAV29DV5,TRAJ38,CAASRHNAGNNRKLIW,0,1,1,1
TRAV29DV5,TRAJ52,CAASEAGGTSYGKLTF,0,1,1,1
TRAV13-1,TRAJ45,CAARAGGGGGADGLTF,0,1,1,1
TRAV13-2,TRAJ48,CAENIGSNFGNEKLTF,0,1,1,1
TRAV14DV4,TRAJ11,CAMREFTPSGYSTLTF,0,1,1,1
TRAV14DV4,TRAJ9,CAMREGENTGGFKTIF,0,1,1,1
TRAV4,TRAJ4,CLVVSVTSGGYNKLIF,0,1,1,1
TRAV4,TRAJ22,CLVGDPVYGSARQLTF,0,1,1,1
TRAV26-2,TRAJ53,CILRSLSGGSNYKPTF,0,1,1,1
TRAV26-2,TRAJ48,CILRDLTNFGNEKLTF,0,1,1,1
TRAV26-2,TRAJ49,CILRDGLMGTGNQFYF,0,1,1,1
TRAV8-2,TRAJ18,CVDARGGSTLGRLYF,0,1,1,1
TRAV10,TRAJ13,CVVTPGSGGYQKVTF,0,1,1,1
TRAV38-1,TRAJ42,CAFTDYGGSQGNLIF,0,1,1,1
TRAV38-2DV8,TRAJ56,CAYRSFTGANSKLTF,0,1,1,1
TRAV16,TRAJ6,CALPPSSGGSYIPTF,0,1,1,1
TRAV9-2,TRAJ52,CALHAGGTSYGKLTF,0,1,1,1
TRAV9-2,TRAJ37,CALTSGSSNTGKLIF,0,1,1,1
TRAV19,TRAJ39,CALSEADNAGNMLTF,0,1,1,1
TRAV6,TRAJ45,CALAYSGGGADGLTF,0,1,1,1
TRAV16,TRAJ8,CALIPMNTGFQKLVF,0,1,1,1
TRAV16,TRAJ40,CALSESTSGTYKYIF,0,1,1,1
TRAV16,TRAJ57,CALSPTQGGSEKLVL,0,1,1,1
TRAV20,TRAJ53,CAVPRVGGSNYKLTF,0,1,1,1
TRAV20,TRAJ53,CAVQAGGGSNYKLTF,0,1,1,1
TRAV36DV7,TRAJ45,CAVVTQGGGADGLTF,0,1,1,1
TRAV8-3,TRAJ45,CAVGRPGGGADGLTF,0,1,1,1
TRAV8-3,TRAJ44,CAVGVSAGTASKLTF,0,1,1,1
TRAV2,TRAJ32,CAVEDLGGATNKLIF,0,1,1,1
TRAV8-4,TRAJ16,CAVSDPVSDGQKLLF,0,1,1,1
TRAV3,TRAJ33,CAVSLPGGSNYQLIR,0,1,1,1
TRAV3,TRAJ41,CAVSPRSNSGYALNF,0,1,1,1
TRAV12-3,TRAJ24,CAVRRTTDSWGKLQL,0,1,1,1
TRAV3,TRAJ12,CAVRVRMDSSYKLIF,0,1,1,1
TRAV3,TRAJ5,CAVRALDTGRRALTF,0,1,1,1
TRAV3,TRAJ8,CAVRDKGTGFQKLVF,0,1,1,1
TRAV3,TRAJ42,CAVRDVEGSQGNLIF,0,1,1,1
TRAV3,TRAJ3,CAVRDGGSSASKIIF,0,1,1,1
TRAV3,TRAJ28,CAVRDIPAGSYQLTF,0,1,1,1
TRAV3,TRAJ29,CAVRDMKSGNTPLVF,0,1,1,1
TRAV35,TRAJ48,CAGLPPNFGNEKLTF,0,1,1,1
TRAV8-3,TRAJ52,CAGGAGGTSYGKLTF,0,1,1,1
TRAV17,TRAJ17,CATSFIKAAGNKLTF,0,1,1,1
TRAV17,TRAJ32,CATVYIGGATNKLIF,0,1,1,1
TRAV17,TRAJ4,CATDPSDGGYNKLIF,0,1,1,1
TRAV17,TRAJ45,CATDGSGGGADGLTF,0,1,1,1
TRAV17,TRAJ34,CATEGVTYNTDKLIF,0,1,1,1
TRAV12-2,TRAJ6,CAPSASSGGSYIPTF,0,1,1,1
TRAV12-2,TRAJ42,CAVVAYGGSQGNLIF,0,1,1,1
TRAV8-1,TRAJ3,CAVNAPYSSASKIIF,0,1,1,1
TRAV8-1,TRAJ37,CAVNNSSSNTGKLIF,0,1,1,1
TRAV12-2,TRAJ42,CAVNAYGGSQGNLIF,0,1,1,1
TRAV12-2,TRAJ28,CAGGNSGAGSYQLTF,0,1,1,1
TRAV25,TRAJ48,CAGDNPNFGNEKLTF,0,1,1,1
TRAV12-3,TRAJ8,CALGFMNTGFQKLVF,0,1,1,1
TRAV12-3,TRAJ35,CASLLVIGFGNVLHC,0,1,1,1
TRAV13-1,TRAJ3,CAAPPGYSSASKIIF,0,1,1,1
TRAV13-1,TRAJ23,CAARGIYNQGGKLIF,0,1,1,1
TRAV13-1,TRAJ40,CAATGGSSGTYKYIF,0,1,1,1
TRAV13-1,TRAJ13,CAATKNSGGYQKVTF,0,1,1,1
TRAV29DV5,TRAJ42,CAATYYGGSQGNLIF,0,1,1,1
TRAV13-1,TRAJ34,CAASMRWGNTDKLIF,0,1,1,1
TRAV13-1,TRAJ6,CAASTASGGSYIPTF,0,1,1,1
TRAV13-1,TRAJ56,CAASNLGGANSKLTF,0,1,1,1
TRAV29DV5,TRAJ28,CAASASGAGSYQLTF,0,1,1,1
TRAV29DV5,TRAJ39,CAASAGGNAGNMLTF,0,1,1,1
TRAV29DV5,TRAJ31,CAASEARNNNARLMF,0,1,1,1
TRAV23DV6,TRAJ42,CAASMNGGSQGNLIF,0,1,1,1
TRAV29DV5,TRAJ49,CAASIYSNTGNQFYF,0,1,1,1
TRAV25,TRAJ42,CAGLHYGGSQGNLIF,0,1,1,1
TRAV25,TRAJ37,CAGPKSSSNTGKLIF,0,1,1,1
TRAV27,TRAJ53,CAGAGGGGSNYKLTF,0,1,1,1
TRAV27,TRAJ58,CAGAGRETSGSRLTF,0,1,1,1
TRAV5,TRAJ42,CAEIPYGGSQGNLIF,0,1,1,1
TRAV13-2,TRAJ5,CAENPSWPGRRALTF,0,1,1,1
TRAV12-3,TRAJ52,CAMYAGGTSYGKLTF,0,1,1,1
TRAV12-3,TRAJ4,CAMSDGDGGYNKLIF,0,1,1,1
TRAV12-3,TRAJ45,CAMRYSGGGADGLTF,0,1,1,1
TRAV14DV4,TRAJ6,CAMRHLEGGSYIPTF,0,1,1,1
TRAV14DV4,TRAJ50,CAMREGWTSYDKVIF,0,1,1,1
TRAV14DV4,TRAJ6,CAMREGEGGSYIPTF,0,1,1,1
TRAV14DV4,TRAJ9,CAMREDGTGGFKTIF,0,1,1,1
TRAV4,TRAJ13,CLVGPPAGGYQKVTF,0,1,1,1
TRAV4,TRAJ6,CLVGDVPGGSYIPTF,0,1,1,1
TRAV4,TRAJ26,CLVGDGENYGQNFVF,0,1,1,1
TRAV4,TRAJ6,CLVGDRGRGSYIPTF,0,1,1,1
TRAV4,TRAJ29,CLVGDKSSGNTPLVF,0,1,1,1
TRAV4,TRAJ18,CLASDRGSTLGRLYF,0,1,1,1
TRAV30,TRAJ45,CGTEEAGGGADGLTF,0,1,1,1
TRAV26-2,TRAJ40,CILRATTSGTYKYIF,0,1,1,1
TRAV26-2,TRAJ9,CILRDRNTGGFKTIF,0,1,1,1
TRAV26-2,TRAJ40,CILRSHTSGTYKYIF,0,1,1,1
TRAV26-2,TRAJ53,CILRDVRGSNYKLTF,0,1,1,1
TRAV26-2,TRAJ30,CILRDEWNRDDKIIF,0,1,1,1
TRAV26-2,TRAJ53,CIQRWSGGSNYKLTF,0,1,1,1
TRAV26-1,TRAJ4,CIVRAFSGGYNKLIF,0,1,1,1
TRAV26-1,TRAJ41,CIVRVDVNSGYALNF,0,1,1,1
TRAV12-1,TRAJ37,CVVHGSSNTGKLIF,0,1,1,1
TRAV10,TRAJ4,CVVIPFWWLNKLIF,0,1,1,1
TRAV10,TRAJ44,CVVTLTGTASKLTF,0,1,1,1
TRAV10,TRAJ36,CVVSPRTGANNLFF,0,1,1,1
TRAV12-1,TRAJ39,CVVNWGNAGNMLTF,0,1,1,1
TRAV12-1,TRAJ48,CVVNRSWGNEKLTF,0,1,1,1
TRAV12-1,TRAJ6,CVVNESGGSYIPTF,0,1,1,1
TRAV38-1,TRAJ24,CAFVPTDSWGKLQF,0,1,1,1
TRAV38-1,TRAJ57,CAFMNWGGSEKLVF,0,1,1,1
TRAV38-1,TRAJ49,CAFMKHDAGNQFYF,0,1,1,1
TRAV16,TRAJ18,CALDRGSTLGRLYF,0,1,1,1
TRAV38-2DV8,TRAJ57,CAYSLQGGSEKLVF,0,1,1,1
TRAV20,TRAJ28,CAYYSGAGSYQLTF,0,1,1,1
TRAV38-2DV8,TRAJ43,CAYRSASNNNDMRF,0,1,1,1
TRAV38-2DV8,TRAJ49,CAYRNSNTGNQFYF,0,1,1,1
TRAV6,TRAJ38,CALFNAGNNRKLIW,0,1,1,1
TRAV6,TRAJ13,CALKNSGGYQKVTF,0,1,1,1
TRAV9-2,TRAJ50,CALIGATSYDKVIF,0,1,1,1
TRAV9-2,TRAJ34,CALSGAYNTDKLIF,0,1,1,1
TRAV9-2,TRAJ49,CALSDPNTGNQFYF,0,1,1,1
TRAV9-2,TRAJ26,CALSDRDYGQNFVF,0,1,1,1
TRAV9-2,TRAJ49,CALSDRNTGNQFYF,0,1,1,1
TRAV9-2,TRAJ35,CALSEGGFGNVLHC,0,1,1,1
TRAV9-2,TRAJ29,CALSEPSGNTPLVF,0,1,1,1
TRAV19,TRAJ23,CALSRYNQGGKLIF,0,1,1,1
TRAV9-2,TRAJ22,CALKTSGSARQLTF,0,1,1,1
TRAV16,TRAJ33,CALSAPDSNYQLIW,0,1,1,1
TRAV38-2DV8,TRAJ41,CAHTDSNSGYALNF,0,1,1,1
TRAV8-3,TRAJ6,CAVSPSGGSYIPTF,0,1,1,1
TRAV2,TRAJ4,CAVSTPGGYNKLIF,0,1,1,1
TRAV41,TRAJ42,CAVSYGGSQGNLIF,0,1,1,1
TRAV21,TRAJ47,CAVRNREYGNKLVF,0,1,1,1
TRAV21,TRAJ26,CAVAGTNYGQNFVF,0,1,1,1
TRAV20,TRAJ40,CAVRSSPGTYKYIF,0,1,1,1
TRAV20,TRAJ21,CAVQAKNNFDKFYF,0,1,1,1
TRAV20,TRAJ21,CAVQAKNNFNKFYF,0,1,1,1
TRAV2,TRAJ9,CAVQSYTGGFKTTF,0,1,1,1
TRAV2,TRAJ13,CAVVPSGGYQKVTF,0,1,1,1
TRAV8-3,TRAJ39,CAVAPNNAGNMLTF,0,1,1,1
TRAV8-3,TRAJ37,CAVGASSNTGKLIF,0,1,1,1
TRAV8-3,TRAJ8,CAVGADTGFQKLVF,0,1,1,1
TRAV8-3,TRAJ11,CAVGADSGYSTLTF,0,1,1,1
TRAV22,TRAJ44,CAVGGTGTASKLTF,0,1,1,1
TRAV2,TRAJ22,CAVESPGSARQLTF,0,1,1,1
TRAV2,TRAJ45,CAVEGGGGADGLTF,0,1,1,1
TRAV21,TRAJ58,CAVEGETSGSRLTF,0,1,1,1
TRAV12-2,TRAJ56,CAVTFAGANSKLTF,0,1,1,1
TRAV21,TRAJ47,CAVTRMEYGNKLVF,0,1,1,1
TRAV8-6,TRAJ10,CAVSFTGGGNKLTF,0,1,1,1
TRAV21,TRAJ32,CAVSLGGATNKLIF,0,1,1,1
TRAV3,TRAJ9,CAVSPYTGGFKTIF,0,1,1,1
TRAV8-4,TRAJ4,CAVSHSGGYNKLIF,0,1,1,1
TRAV3,TRAJ34,CAVSQSYNTDKLIF,0,1,1,1
TRAV8-6,TRAJ23,CAVSGSNQGGKLIF,0,1,1,1
TRAV8-4,TRAJ24,CAVSETDSWGKLQF,0,1,1,1
TRAV8-4,TRAJ15,CAVSENQAGTALIF,0,1,1,1
TRAV8-6,TRAJ12,CAVSRMDSSYKLIF,0,1,1,1
TRAV21,TRAJ24,CAVRRGDSWGKLQF,0,1,1,1
TRAV21,TRAJ15,CAVRRNQAGTALIF,0,1,1,1
TRAV3,TRAJ33,CAVRPPDSNYQLIW,0,1,1,1
TRAV3,TRAJ37,CAVRVSSNTGKLIF,0,1,1,1
TRAV3,TRAJ49,CAVRVSNTGNQFYF,0,1,1,1
TRAV3,TRAJ36,CAVRVLTGANNLFF,0,1,1,1
TRAV3,TRAJ6,CAVRDIGGSYIPTF,0,1,1,1
TRAV20,TRAJ4,CAASSSGGYNKLIF,0,1,1,1
TRAV35,TRAJ42,CAGQSGRSQGNLIF,0,1,1,1
TRAV35,TRAJ56,CAGQLSGANSKLTF,0,1,1,1
TRAV35,TRAJ33,CAGQLMDSNYQLIW,0,1,1,1
TRAV3,TRAJ24,CAEVSTDSWGKLQF,0,1,1,1
TRAV41,TRAJ32,CAIWDGGATNKLIF,0,1,1,1
TRAV17,TRAJ12,CATSRMDSSYKLIF,0,1,1,1
TRAV17,TRAJ22,CATVLRGSARQLTF,0,1,1,1
TRAV17,TRAJ58,CATDAGFRGSRLTF,0,1,1,1
TRAV12-2,TRAJ28,CAPYSGAGSYQLTF,0,1,1,1
TRAV12-3,TRAJ13,CAVARSGGYQKVTF,0,1,1,1
TRAV12-2,TRAJ6,CAVILGGGSYIPTF,0,1,1,1
TRAV12-2,TRAJ6,CAVTESGGSYIPTF,0,1,1,1
TRAV12-2,TRAJ52,CAVRGGTSYGKLTF,0,1,1,1
TRAV12-2,TRAJ52,CAVNSGTSYGKLAF,0,1,1,1
TRAV12-2,TRAJ26,CAVNGGDYGQNFVF,0,1,1,1
TRAV12-2,TRAJ26,CAVNMANYGQNFVF,0,1,1,1
TRAV36DV7,TRAJ42,CAGDYGGRQGNLIF,0,1,1,1
TRAV12-3,TRAJ54,CASGKFQGAQKLVF,0,1,1,1
TRAV27,TRAJ57,CAVPSRGGSEKLVF,0,1,1,1
TRAV13-1,TRAJ53,CAANSGGSNCKLTF,0,1,1,1
TRAV5,TRAJ12,CAASGRDSSYKLIF,0,1,1,1
TRAV13-1,TRAJ28,CAATRNAGSYQLTF,0,1,1,1
TRAV13-1,TRAJ10,CAAIPTGGGNKLTF,0,1,1,1
TRAV13-1,TRAJ27,CAATANTNAGKSTF,0,1,1,1
TRAV13-1,TRAJ54,CAASYGKGAQKLVF,0,1,1,1
TRAV13-1,TRAJ45,CAASGGGGADGLTF,0,1,1,1
TRAV13-1,TRAJ36,CAASGETGANNLFF,0,1,1,1
TRAV13-1,TRAJ39,CAASDNNAGNMLTF,0,1,1,1
TRAV13-1,TRAJ36,CAASEGAGANNLFF,0,1,1,1
TRAV13-1,TRAJ24,CAASISDSWGKLQF,0,1,1,1
TRAV13-1,TRAJ49,CAASKSNTGNQFYF,0,1,1,1
TRAV13-1,TRAJ29,CAASKGSGNTPLVF,0,1,1,1
TRAV29DV5,TRAJ30,CAASLMNRDDKIIF,0,1,1,1
TRAV23DV6,TRAJ37,CAASPASNTGKLIF,0,1,1,1
TRAV29DV5,TRAJ40,CAASATSGTYKYIF,0,1,1,1
TRAV23DV6,TRAJ8,CAASMNTGFQKLVF,0,1,1,1
TRAV23DV6,TRAJ13,CAASNSGGYQKVTF,0,1,1,1
TRAV23DV6,TRAJ5,CAASKQTGRRALTF,0,1,1,1
TRAV23DV6,TRAJ48,CAASKGFGNEKLTF,0,1,1,1
TRAV23DV6,TRAJ52,CAARGGTSYGKPTF,0,1,1,1
TRAV27,TRAJ15,CAGLFNQAGTALIF,0,1,1,1
TRAV5,TRAJ45,CAGATGGGADGLTF,0,1,1,1
TRAV25,TRAJ21,CAGPRGKVDNKFYF,0,1,1,1
TRAV27,TRAJ16,CAGRRASDGQKLLF,0,1,1,1
TRAV27,TRAJ40,CAGDPTSGTYKYIF,0,1,1,1
TRAV25,TRAJ3,CAGRGGSSASKIIF,0,1,1,1
TRAV25,TRAJ38,CAGSNAGNNRKLIW,0,1,1,1
TRAV27,TRAJ21,CAGLILYNFNKFYF,0,1,1,1
TRAV27,TRAJ42,CAGASRGSQGNLIF,0,1,1,1
TRAV27,TRAJ9,CAGGAHTGGFKTIF,0,1,1,1
TRAV27,TRAJ29,CAGERNSGNTPLVF,0,1,1,1
TRAV5,TRAJ10,CAEMYTGGGSKLTF,0,1,1,1
TRAV5,TRAJ3,CAETSYSSASKIIF,0,1,1,1
TRAV5,TRAJ9,CAESTNTGGFKTIF,0,1,1,1
TRAV13-2,TRAJ27,CAESSNTNAGKSTF,0,1,1,1
TRAV5,TRAJ13,CAERDSGGYQKVTF,0,1,1,1
TRAV13-2,TRAJ27,CAENTLINAGKTTF,0,1,1,1
TRAV13-2,TRAJ23,CAENKGNQGGKLIF,0,1,1,1
TRAV5,TRAJ42,CAEKLGGSQGNLIF,0,1,1,1
TRAV34,TRAJ30,CAIPPMYRVDKIIF,0,1,1,1
TRAV12-3,TRAJ43,CAMVSPPIGDDMRF,0,1,1,1
TRAV12-3,TRAJ52,CAMGDGTSYGKLTF,0,1,1,1
TRAV12-3,TRAJ54,CAMGRVLGAQKLVF,0,1,1,1
TRAV12-3,TRAJ23,CAMSLYNQGGKLIF,0,1,1,1
TRAV14DV4,TRAJ21,CAMSPRYNFNKFYF,0,1,1,1
TRAV12-3,TRAJ49,CAMSVRNTGNQFYF,0,1,1,1
TRAV12-3,TRAJ39,CAMSASNAGNMLTF,0,1,1,1
TRAV12-3,TRAJ5,CATRGDTGRRALTF,0,1,1,1
TRAV34,TRAJ48,CGADFNFGNEKLTF,0,1,1,1
TRAV34,TRAJ53,CGADTVGSNYKLTF,0,1,1,1
TRAV41,TRAJ57,CTVPVQGGSVKLVF,0,1,1,1
TRAV4,TRAJ20,CLVAAFSNDYKLSF,0,1,1,1
TRAV4,TRAJ11,CLVGLNSGYSTLTF,0,1,1,1
TRAV4,TRAJ9,CLVGPRAGGFKTIF,0,1,1,1
TRAV4,TRAJ27,CLVGDIGNAGKSTI,0,1,1,1
TRAV26-2,TRAJ31,CILRDYDNNARLMF,0,1,1,1
TRAV26-1,TRAJ10,CIVSPTGGGNKLTF,0,1,1,1
TRAV26-1,TRAJ47,CIVRAMEYGNKLVF,0,1,1,1
TRAV26-1,TRAJ42,CIVRGRGSQGNLIF,0,1,1,1
TRAV26-1,TRAJ45,CIVRVGGGADGLTF,0,1,1,1
TRAV26-1,TRAJ33,CIVRVTDSNYQLIW,0,1,1,1
TRAV26-1,TRAJ20,CIVRDPRGDYKLSF,0,1,1,1
TRAV26-1,TRAJ26,CIVNPRAYGQNFVF,0,1,1,1
TRAV26-1,TRAJ58,CIAPRETSGSRLTF,0,1,1,1
TRAV29DV5,TRAJ42,YAASPGGSRGNLIF,0,1,1,1
TRAV13-1,TRAJ13,RAAHLSGGYQKVTF,0,1,1,1
TRAV8-2,TRAJ42,CVVAGGSQGNLIF,0,1,1,1
TRAV12-1,TRAJ29,CVVGDSGNTPLVF,0,1,1,1
TRAV12-1,TRAJ15,CVVINQAGTALIF,0,1,1,1
TRAV10,TRAJ39,CVVSLRAGNMLTF,0,1,1,1
TRAV10,TRAJ9,CVVSDAGGFKTIF,0,1,1,1
TRAV12-1,TRAJ11,CVVRDSGYSTLTF,0,1,1,1
TRAV10,TRAJ6,CVVNPGGSYIPTF,0,1,1,1
TRAV12-1,TRAJ39,CVAANNAGNMLTF,0,1,1,1
TRAV10,TRAJ32,CVARGGATNKLIF,0,1,1,1
TRAV13-1,TRAJ5,CVAKDTGRRALTF,0,1,1,1
TRAV38-1,TRAJ49,CAFITLTGNQFYF,0,1,1,1
TRAV6,TRAJ38,CASPAGNNRKLIW,0,1,1,1
TRAV38-1,TRAJ23,CAWNINQGGKLIF,0,1,1,1
TRAV38-2DV8,TRAJ54,CAYLIQGAQKLVF,0,1,1,1
TRAV38-2DV8,TRAJ56,CAYRAGANSKLTF,0,1,1,1
TRAV38-2DV8,TRAJ34,CAYRSPNTDKLIF,0,1,1,1
TRAV38-2DV8,TRAJ17,CAYRRAAGNKLTF,0,1,1,1
TRAV6,TRAJ23,CALFYNQGGKLIF,0,1,1,1
TRAV16,TRAJ44,CALNTGTASKLTF,0,1,1,1
TRAV9-2,TRAJ9,CALTYTGGFKTIF,0,1,1,1
TRAV9-2,TRAJ20,CALSGGNDYKLSF,0,1,1,1
TRAV9-2,TRAJ13,CALSGVGYQKVTF,0,1,1,1
TRAV29DV5,TRAJ21,CALRRYNFDKFYF,0,1,1,1
TRAV16,TRAJ16,CALSGQGGQKLLF,0,1,1,1
TRAV16,TRAJ43,CALRPYNNNDMRF,0,1,1,1
TRAV16,TRAJ30,CALKVNRDDKIIF,0,1,1,1
TRAV6,TRAJ3,CAPIYSSASKIIF,0,1,1,1
TRAV12-2,TRAJ37,CAVLGSNTGKLIF,0,1,1,1
TRAV2,TRAJ24,CAVVPDSWGKLQF,0,1,1,1
TRAV22,TRAJ6,CAVSSGGSYIPTF,0,1,1,1
TRAV21,TRAJ29,CAVPNSGNTPLVF,0,1,1,1
TRAV2,TRAJ9,CAVPNTGGFKTIF,0,1,1,1
TRAV41,TRAJ42,CAVDGGSQGNLIF,0,1,1,1
TRAV36DV7,TRAJ26,CAVRGDYGQNFVF,0,1,1,1
TRAV41,TRAJ45,CAVKYGGADGLTF,0,1,1,1
TRAV8-3,TRAJ12,CAVLMDSSYKLIF,0,1,1,1
TRAV20,TRAJ40,CAVLPSGTYKYIF,0,1,1,1
TRAV20,TRAJ41,CAVQPNSGYALNF,0,1,1,1
TRAV20,TRAJ36,CAVQVTGANNLFF,0,1,1,1
TRAV8-3,TRAJ27,CAVANTNAGKSTF,0,1,1,1
TRAV8-3,TRAJ24,CAVGADSWGKLQF,0,1,1,1
TRAV8-3,TRAJ34,CAVGAVNTDKLIF,0,1,1,1
TRAV8-3,TRAJ42,CAVGAGSLGNLIF,0,1,1,1
TRAV8-3,TRAJ13,CAVGARGYQKVTF,0,1,1,1
TRAV21,TRAJ39,CAVTPEAGNMLTF,0,1,1,1
TRAV8-4,TRAJ20,CAVSEGYDYKLSF,0,1,1,1
TRAV8-4,TRAJ44,CAVSEGTASKLTF,0,1,1,1
TRAV21,TRAJ16,CAVRPSEGQKLLF,0,1,1,1
TRAV12-2,TRAJ27,CAVRNTNAGKSTF,0,1,1,1
TRAV3,TRAJ20,CAVRAANDYKLSF,0,1,1,1
TRAV3,TRAJ21,CAVRDNNFNKFYF,0,1,1,1
TRAV12-2,TRAJ8,CAVRNTGFQKLVF,0,1,1,1
TRAV12-2,TRAJ13,CAVNSGGYQKATF,0,1,1,1
TRAV21,TRAJ6,CAVKEGGSYIPTF,0,1,1,1
TRAV41,TRAJ56,CAALTGANSKLTF,0,1,1,1
TRAV6,TRAJ8,CAALNTGFQKLVF,0,1,1,1
TRAV41,TRAJ49,CAAPPGTGNQFYF,0,1,1,1
TRAV12-2,TRAJ13,CAAEERGYQKVTF,0,1,1,1
TRAV8-3,TRAJ44,CAGNTGTASKLTF,0,2,1,2
TRAV35,TRAJ22,CAGPSGSARQLTF,0,1,1,1
TRAV22,TRAJ3,CAGATSSASKIIF,0,1,1,1
TRAV38-2DV8,TRAJ12,CAGRMDSSYKLIF,0,1,1,1
TRAV23DV6,TRAJ36,CAGDGTGANNLFF,0,1,1,1
TRAV17,TRAJ26,CATSDNYGQNFVF,0,1,1,1
TRAV17,TRAJ53,CATGGGSNYKLTF,0,1,1,1
TRAV17,TRAJ20,CATDRANDYKLSF,0,1,1,1
TRAV24,TRAJ42,CAFLRGSQGNLIF,0,1,1,1
TRAV24,TRAJ4,CAFISGGYNKLIF,0,1,1,1
TRAV24,TRAJ45,CAFAGGGADGLTF,0,1,1,1
TRAV39,TRAJ28,CASDGAGSYQLTF,0,1,1,1
TRAV12-2,TRAJ10,CALGTGGGNKLTF,0,1,1,1
TRAV12-2,TRAJ12,CAPFMDSSYKLIF,0,1,1,1
TRAV12-2,TRAJ42,CAVFGGSQGNLIF,0,1,1,1
TRAV8-1,TRAJ21,CAVPLPLTNKFYF,0,1,1,1
TRAV39,TRAJ40,CAVEEKGTYKYIF,0,1,1,1
TRAV8-1,TRAJ30,CAVTLNRDDKIIF,0,1,1,1
TRAV8-1,TRAJ17,CAVNPAAGNKLTF,0,1,1,1
TRAV8-1,TRAJ29,CAVNTPRNTPLVF,0,1,1,1
TRAV12-2,TRAJ15,CAVNVGAGTALIF,0,1,1,1
TRAV8-1,TRAJ16,CAVKGSDGQKLLF,0,1,1,1
TRAV12-2,TRAJ9,CAVKNTGGFKTIF,0,1,1,1
TRAV12-2,TRAJ11,CAAPNSGYSTLTF,0,1,1,1
TRAV27,TRAJ7,CAGVPMGNNRLAF,0,1,1,1
TRAV12-2,TRAJ16,CAGRFSDGQKLLF,0,1,1,1
TRAV17,TRAJ3,CAPCGSSASKIIF,0,1,1,1
TRAV13-1,TRAJ8,CAVENTGFQKLVF,0,1,1,1
TRAV12-3,TRAJ21,CAAAPYNFNKFYF,0,1,1,1
TRAV29DV5,TRAJ53,CAAAGGSNYKLTF,0,1,1,1
TRAV23DV6,TRAJ39,CAAPDNAGNMLTF,0,1,1,1
TRAV23DV6,TRAJ8,CAAINTGFQKLVF,0,1,1,1
TRAV13-1,TRAJ30,CAATSSRDDKIIF,0,1,1,1
TRAV13-1,TRAJ39,CAASDNADNMLTF,0,1,1,1
TRAV13-1,TRAJ22,CAASMGSARQLTF,0,1,1,1
TRAV13-1,TRAJ6,CAASITGSYIPTF,0,1,1,1
TRAV13-1,TRAJ49,CAASISAGNQFYF,0,1,1,1
TRAV13-1,TRAJ48,CAASTGGNEKLTF,0,1,1,1
TRAV13-1,TRAJ42,CAASKRSQGNLIF,0,1,1,1
TRAV29DV5,TRAJ49,CAASSNTGNQFYF,0,1,1,1
TRAV23DV6,TRAJ20,CAASWSNDYKLSF,0,1,1,1
TRAV29DV5,TRAJ54,CAASYQGAQKLVF,0,1,1,1
TRAV7,TRAJ34,CAASPGGTDKLIF,0,1,1,1
TRAV23DV6,TRAJ33,CAASPDSNYQLIW,0,1,1,1
TRAV29DV5,TRAJ26,CAASVSYGQNFVF,0,1,1,1
TRAV29DV5,TRAJ44,CAANYGTASKLTF,0,1,1,1
TRAV25,TRAJ35,CAGLGGFGNVLHC,0,1,1,1
TRAV27,TRAJ33,CAGVRGSNYQLIW,0,1,1,1
TRAV27,TRAJ33,CAGAGNGNYQLIW,0,1,1,1
TRAV27,TRAJ43,CAGGPQNNNDMRF,0,1,1,1
TRAV25,TRAJ6,CAGDSGGSYIPTF,0,1,1,1
TRAV27,TRAJ33,CAGEVGSNYQLIW,0,1,1,1
TRAV25,TRAJ57,CAGTQGGSEKLVF,0,2,1,2
TRAV13-2,TRAJ45,CADPGGGADGLTF,0,1,1,1
TRAV5,TRAJ37,CAETWGNTGKLIF,0,1,1,1
TRAV13-2,TRAJ12,CAESMDSSYKLIF,0,1,1,1
TRAV5,TRAJ40,CAESTSGTYKYIF,0,1,1,1
TRAV5,TRAJ40,CAESSSGTYKYIF,0,1,1,1
TRAV5,TRAJ4,CAESPGGYNKLIF,0,1,1,1
TRAV13-2,TRAJ40,CAENVPGTYKYIF,0,1,1,1
TRAV13-2,TRAJ9,CAENRGGGFKTIF,0,1,1,1
TRAV14DV4,TRAJ29,CAITEGSNTPLVF,0,1,1,1
TRAV12-2,TRAJ3,CAIQNSSASKIIF,0,1,1,1
TRAV12-3,TRAJ6,CAMSSGGSYIPTF,0,1,1,1
TRAV12-3,TRAJ36,CAMGQTGANNLFF,0,1,1,1
TRAV14DV4,TRAJ34,CAMSYYNTDKLIF,0,1,1,1
TRAV12-3,TRAJ43,CAMSEYNNNDMRF,0,1,1,1
TRAV12-3,TRAJ9,CAMSATGGFKTIF,0,1,1,1
TRAV12-3,TRAJ7,CAMSADGNNRLAF,0,1,1,1
TRAV12-3,TRAJ49,CAMSGYTGNQFYF,0,1,1,1
TRAV12-3,TRAJ49,CAMSGITGNQFYF,0,1,1,1
TRAV12-3,TRAJ17,CAMSKAAGNKLTF,0,1,1,1
TRAV12-3,TRAJ32,CAMRDGATNKLIF,0,1,1,1
TRAV14DV4,TRAJ49,CAMRRYSGNQFYF,0,1,1,1
TRAV12-3,TRAJ37,CAMKTSNIGKLIF,0,1,1,1
TRAV41,TRAJ45,CGFSGGGADGLTF,0,1,1,1
TRAV34,TRAJ57,CGADIGGSEKLVF,0,1,1,1
TRAV14DV4,TRAJ16,CTMREEDGQKLLF,0,1,1,1
TRAV4,TRAJ39,CLVGGDAGNMLTF,0,1,1,1
TRAV4,TRAJ43,CLVGDINNNDMRF,0,1,1,1
TRAV4,TRAJ5,CHPRNTGRRALTF,0,1,1,1
TRAV30,TRAJ8,CGTDNTGFQKLVF,0,1,1,1
TRAV26-2,TRAJ38,CILVAGNNRKLIW,0,1,1,1
TRAV26-2,TRAJ17,CILRKAAGNKLTF,0,1,1,1
TRAV26-2,TRAJ27,CILKGTNAGKSTF,0,1,1,1
TRAV26-1,TRAJ9,CIVPPTGGFKTIF,0,1,1,1
TRAV39,TRAJ49,YAVDLDTGNQFYF,0,1,1,1
TRAV34,TRAJ27,RGAGAKRAGKSTF,0,1,1,1
TRAV23DV6,TRAJ26,SAATLNYGQNFVF,0,1,1,1
TRAV26-1,TRAJ48,SIATKPSYEKLTF,0,1,1,1
TRAV12-1,TRAJ30,CVVTNRDDKIIF,0,1,1,1
TRAV10,TRAJ20,CVVSVNGYKLSF,0,1,1,1
TRAV12-1,TRAJ15,CVVNQAGTALIF,0,1,1,1
TRAV38-2DV8,TRAJ36,CAFRTGANNLFF,0,1,1,1
TRAV38-1,TRAJ41,CAFMKAGYALNF,0,1,1,1
TRAV38-2DV8,TRAJ27,CAYRSNAGKSTF,0,1,1,1
TRAV9-2,TRAJ22,CALTGSARQLTF,0,1,1,1
TRAV16,TRAJ15,CALLTGGTALIF,0,1,1,1
TRAV6,TRAJ20,CALGLNDYKLSF,0,1,1,1
TRAV17,TRAJ24,CALTGSWGKLQF,0,1,1,1
TRAV36DV7,TRAJ43,CAVWYNNNDMRF,0,1,1,1
TRAV3,TRAJ43,CAVWGNNNDMRF,0,1,1,1
TRAV41,TRAJ34,CAVKSNPDKLIF,0,1,1,1
TRAV22,TRAJ45,CAVRGGADGLTF,0,1,1,1
TRAV21,TRAJ42,CAVVQSQGNLIF,0,1,1,1
TRAV2,TRAJ13,CAVAGGYQKVTF,0,1,1,1
TRAV8-4,TRAJ49,CAVASTGNQFYF,0,1,1,1
TRAV20,TRAJ30,CAVALSGDKIIF,0,1,1,1
TRAV2,TRAJ31,CAVARYNARLMF,0,1,1,1
TRAV8-3,TRAJ34,CAVGYNTDKLIL,0,1,1,1
TRAV2,TRAJ41,CAVGGSGYALNF,0,1,1,1
TRAV2,TRAJ31,CAVESNNARLMF,0,1,1,1
TRAV36DV7,TRAJ34,CAVEPNTDKLIF,0,1,1,1
TRAV12-2,TRAJ47,CAVRPGMGKLVF,0,1,1,1
TRAV3,TRAJ31,CAVRDVSARLMF,0,1,1,1
TRAV3,TRAJ43,CAVRDNNNEMRF,0,1,1,1
TRAV36DV7,TRAJ58,CAVETSGSRLTF,0,1,1,1
TRAV21,TRAJ23,CAVSPPGGKLIF,0,1,1,1
TRAV41,TRAJ49,CAASNTGNQFYF,0,1,1,1
TRAV21,TRAJ35,CAGYGLWECAAC,0,1,1,1
TRAV17,TRAJ8,CATPTGFQKPVF,0,1,1,1
TRAV17,TRAJ29,CATGSGNTPLVF,0,1,1,1
TRAV17,TRAJ45,CATDAFPDGLTL,0,1,1,1
TRAV24,TRAJ37,CAFTSNTGKLIF,0,1,1,1
TRAV13-1,TRAJ34,CAPPWNTDKLIF,0,1,1,1
TRAV12-2,TRAJ48,CAVNFGNEKLTF,0,1,1,1
TRAV12-2,TRAJ39,CAVGGAGNMLTF,0,1,1,1
TRAV39,TRAJ29,CAVDIENTPLVF,0,1,1,1
TRAV12-2,TRAJ42,CAVTGSQGNLIF,0,1,1,1
TRAV8-1,TRAJ43,CAVNARDNDMRF,0,1,1,1
TRAV12-2,TRAJ47,CAVNTGGNKLVF,0,1,1,1
TRAV12-2,TRAJ31,CAVKGNNARLMF,0,1,1,1
TRAV12-2,TRAJ53,CAVKGSNYKLTF,0,1,1,1
TRAV12-2,TRAJ13,CAAPGGYQKVTF,0,1,1,1
TRAV22,TRAJ49,CAANRRGNQFYF,0,1,1,1
TRAV12-2,TRAJ38,CAGAGNNRKLIW,0,1,1,1
TRAV12-2,TRAJ12,CAGMDSSYKLIF,0,1,1,1
TRAV36DV7,TRAJ49,CAVPNTGNQFYF,0,1,1,1
TRAV27,TRAJ54,CAGIQGAQKLVF,0,1,1,1
TRAV23DV6,TRAJ11,CASPGGYSTLTF,0,1,1,1
TRAV27,TRAJ40,CAHRSGTYKYIF,0,1,1,1
TRAV23DV6,TRAJ31,CAATNNNARLMF,0,1,1,1
TRAV23DV6,TRAJ49,CAALGTGNQFYF,0,1,1,1
TRAV13-1,TRAJ12,CAAEDSSYKLIF,0,1,1,1
TRAV13-1,TRAJ27,CAASTNAGKSTF,0,1,1,1
TRAV23DV6,TRAJ23,CAASYEGGKLIF,0,1,1,1
TRAV29DV5,TRAJ30,CAASATDDKIIF,0,1,1,1
TRAV23DV6,TRAJ34,CAASKETDKLIF,0,1,1,1
TRAV13-1,TRAJ6,CAAKGGSYIPTF,0,1,1,1
TRAV25,TRAJ17,CAGPIAGNKLTF,0,1,1,1
TRAV25,TRAJ26,CAGRSYGQNFVF,0,1,1,1
TRAV25,TRAJ13,CAGQGGYQKVTF,0,1,1,1
TRAV27,TRAJ20,CAGAPNDYKLSF,0,1,1,1
TRAV27,TRAJ30,CAGARRHDKIIF,0,1,1,1
TRAV13-2,TRAJ49,CAETSTGNQFYF,0,1,1,1
TRAV5,TRAJ3,CAERPSASKIIF,0,1,1,1
TRAV5,TRAJ12,CAERDSSYKLIF,0,1,1,1
TRAV5,TRAJ36,CAEKPGANNLFF,0,1,1,1
TRAV13-2,TRAJ43,CAEKGNNNDMRF,0,1,1,1
TRAV14DV4,TRAJ50,CAMETSYDKVIF,0,1,1,1
TRAV12-3,TRAJ20,CAMSAYDYKLSF,0,1,1,1
TRAV14DV4,TRAJ21,CAMRSFFNKIYF,0,1,1,1
TRAV14DV4,TRAJ43,CAMRDSNNDMRF,0,1,1,1
TRAV34,TRAJ36,CGAGTGANNLFF,0,1,1,1
TRAV4,TRAJ40,CLVDPGTYKYIF,0,1,1,1
TRAV4,TRAJ27,CLVSTNAGKSTF,0,1,1,1
TRAV4,TRAJ29,CLAYTGNTPLVF,0,1,1,1
TRAV8-4,TRAJ31,CAVSDREARLMF,0,1,1,1
TRAV26-2,TRAJ35,CILRGFGNVLHC,0,1,1,1
TRAV26-1,TRAJ34,CIVLYNTDKLIF,0,1,1,1
TRAV26-1,TRAJ20,CIVRVFDYKLSF,0,1,1,1
TRAV26-1,TRAJ7,CIVGYGNNRLAF,0,1,1,1
TRAV26-1,TRAJ49,CIAGNTGNQFYF,0,1,1,1
TRAV26-2,TRAJ28,CIAGAGSYQLTF,0,1,1,1
TRAV17,TRAJ35,FTIGFGNVLHC,0,1,1,1
TRAV20,TRAJ30,CSMNRDDKIIF,0,1,1,1
TRAV12-1,TRAJ49,CVVPTGNQFYF,0,1,1,1
TRAV12-1,TRAJ31,CVVSLGARLMF,0,1,1,1
TRAV12-1,TRAJ11,CVVRGYSTLTF,0,1,1,1
TRAV12-1,TRAJ30,CVVNRDDKIIF,0,1,1,1
TRAV9-2,TRAJ43,CALSDRGDMRF,0,1,1,1
TRAV17,TRAJ9,CAPNGGFKTIF,0,1,1,1
TRAV21,TRAJ49,CAVCTGNQFYF,0,1,1,1
TRAV41,TRAJ49,CAVCPSNQFYF,0,1,1,1
TRAV41,TRAJ33,CAVHSNYQLIW,0,1,1,1
TRAV12-2,TRAJ20,CAVHSGYKLSF,0,1,1,1
TRAV2,TRAJ20,CAVADDYKLSF,0,1,1,1
TRAV2,TRAJ20,CAVGNDYKLSF,0,1,1,1
TRAV22,TRAJ9,CAVERGFKTIF,0,1,1,1
TRAV21,TRAJ29,CAVSGNTPLVF,0,1,1,1
TRAV2,TRAJ16,CAVSDGQKLLF,0,1,1,1
TRAV21,TRAJ16,CAAQDGQKLLF,0,1,1,1
TRAV3,TRAJ24,CAANSWGKLQF,0,1,1,1
TRAV17,TRAJ26,CAHNYGQNFVF,0,1,1,1
TRAV12-3,TRAJ34,CAQEDTDKLIF,0,1,1,1
TRAV12-2,TRAJ12,CAVDSSYKLIF,0,1,1,1
TRAV17,TRAJ24,CATGSWGKLQF,0,1,1,1
TRAV27,TRAJ26,CAGSYGQNFVF,0,1,1,1
TRAV12-3,TRAJ16,CAWDDGQKLLF,0,1,1,1
TRAV23DV6,TRAJ41,CAAHSGYALNF,0,1,1,1
TRAV23DV6,TRAJ24,CAAHSWGKLQF,0,1,1,1
TRAV23DV6,TRAJ31,CAAGENARLMF,0,1,1,1
TRAV13-1,TRAJ4,CAASGYNKLIF,0,1,1,1
TRAV13-1,TRAJ17,CAANQGNKLTF,0,1,1,1
TRAV5,TRAJ34,CAESNTDKLIF,0,1,1,1
TRAV12-3,TRAJ54,CAMWGAQKLVF,0,1,1,1
TRAV12-3,TRAJ9,CAMTGGFKTIF,0,1,1,1
TRAV12-3,TRAJ23,CAMSAEGKLIF,0,1,1,1
TRAV30,TRAJ8,CGPGGFQKLVF,0,1,1,1
TRAV26-2,TRAJ49,CIPNTGNQFYF,0,1,1,1
TRAV38-2DV8,TRAJ43,CAYPRNDMRF,0,1,1,1
TRAV38-2DV8,TRAJ30,CAYGDDKIIF,0,1,1,1
TRAV41,TRAJ43,CAVCNNDMRF,0,1,1,1
TRAV3,TRAJ21,CAVRDLKFYF,0,1,1,1
TRAV24,TRAJ34,CAPCTDKLIF,0,1,1,1
TRAV8-6,TRAJ44,CAGTASKLTF,0,1,1,1
TRAV39,TRAJ30,CAGRDDKIIF,0,1,1,1
TRAV13-1,TRAJ20,CAPGDYKLSF,0,1,1,1
TRAV25,TRAJ27,CAGHAGKSTF,0,1,1,1
TRAV25,TRAJ34,CAGNTDKLIF,0,1,1,1
TRAV4,TRAJ16,CLVDGQKLLF,0,1,1,1
TRAV26-1,TRAJ34,CIVYTDKLIF,0,1,1,1
TRAV6,TRAJ3,WPRASKIIF,0,1,1,1
TRAV21,TRAJ36,CAPNNLFF,0,1,1,1
TRAV12-2,TRAJ30,CAVNEIIF,0,1,1,1
TRAV27,TRAJ43,CAGGDMRF,0,1,1,1
TRAV3,TRAJ41,ISGYALNF,0,1,1,1
TRAV13-2,TRAJ43,CDNDMRF,0,1,1,1
TRAV14DV4,TRAJ28,CAMRGPTYSGAGSYQLTF,0,1,1,1
TRAV12-2,TRAJ52,CAVKAGGTSYGELTF,0,1,1,1
TRAV12-1,TRAJ43,CVVTPNYNNNDMRF,0,1,1,1
TRAV38-2DV8,TRAJ40,CAYRDGSGTYKYIF,0,1,1,1
TRAV2,TRAJ44,CAVGNTGTASKLTF,0,1,1,1
TRAV3,TRAJ47,CAVRDMEYGNKLVF,0,1,1,1
TRAV14DV4,TRAJ16,CAMRARTDGQKLLF,0,1,1,1
TRAV4,TRAJ17,CLVGDRAAGNKLTF,0,1,1,1
TRAV13-2,TRAJ40,RAASALSGTYKYIF,0,1,1,1
TRAV36DV7,TRAJ58,CAVDGTSGSRLTF,0,1,1,1
TRAV12-3,TRAJ40,CAMIPSGTYKYIF,0,1,1,1
TRAV20,TRAJ52,CAVQSPRAGGTSYGKLTF,0,1,1,1
TRAV20,TRAJ13,CAVQAPALNSGGYQKVTF,0,1,1,1
TRAV36DV7,TRAJ52,CAVASLNAGGTSYGKLTF,0,1,1,1
TRAV17,TRAJ52,CATDAGRSGGTSYGKLTF,0,1,1,1
TRAV4,TRAJ42,CLVGDLANYGGSQGNLIF,0,1,1,1
TRAV4,TRAJ37,CLVGDARPLASNTGKLIF,0,1,1,1
TRAV4,TRAJ4,CLVGDRGSISGGYNKLIF,0,1,1,1
TRAV26-1,TRAJ53,CITPIQQNSGGSNYKLTF,0,1,1,1
TRAV12-1,TRAJ42,CVVNGGNYGGSQGNLIF,0,1,1,1
TRAV38-2DV8,TRAJ42,CAYSTLGYGGSQGNLIF,0,1,1,1
TRAV38-2DV8,TRAJ28,CAYRTLYSGAGSYQLTF,0,1,1,1
TRAV38-2DV8,TRAJ53,CAYRSPNSGGSNYKLTF,0,1,1,1
TRAV38-2DV8,TRAJ45,CAYRSAMSRGGADGLTF,0,1,1,1
TRAV9-2,TRAJ52,CALGPNAGGTSYGKLTF,0,1,1,1
TRAV6,TRAJ37,CALDEERGSSNTGKLIF,0,1,1,1
TRAV3,TRAJ36,CAVRDDADQTGANNLFF,0,1,1,1
TRAV12-2,TRAJ56,CAVDRSIHTGANSKLTF,0,1,1,1
TRAV8-1,TRAJ28,CAVNAPYSGAGSYQLTF,0,1,1,1
TRAV13-1,TRAJ6,CAASRRGTSGGSYIPTF,0,1,1,1
TRAV13-1,TRAJ18,CAASMEGRGSTLGRLYF,0,1,1,1
TRAV13-1,TRAJ44,CAASTRAVTGTASKLTF,0,2,1,2
TRAV29DV5,TRAJ40,CAASALRMASGTYKYIF,0,1,1,1
TRAV13-2,TRAJ11,CAERTPRGNSGYSTLTF,0,1,1,1
TRAV13-2,TRAJ37,CAEKDSRGSSNTGKLIF,0,1,1,1
TRAV12-3,TRAJ52,CAMSASAGGTSYGKLTF,0,1,1,1
TRAV14DV4,TRAJ36,CAMREGRALAGANNLFF,0,1,1,1
TRAV14DV4,TRAJ45,CAMREGHSGGGADGLTF,0,1,1,1
TRAV14DV4,TRAJ44,CAMREGSNTGTASKLTF,0,1,1,1
TRAV12-3,TRAJ18,CATPLAAGGSTLGRLYF,0,1,1,1
TRAV4,TRAJ23,CLVGVPLLYNQGGKLIF,0,1,1,1
TRAV4,TRAJ27,CLVGDGLRDTNAGKSTL,0,1,1,1
TRAV4,TRAJ3,CLVGDIPGYSSASKIIF,0,1,1,1
TRAV4,TRAJ42,CLVGDMIDGGSQGNLIF,0,1,1,1
TRAV4,TRAJ18,CLVGPADRGSTLGRLYF,0,1,1,1
TRAV26-1,TRAJ37,CIVRGMHGSSNTGKLIF,0,1,1,1
TRAV12-1,TRAJ22,CVVNPISSGSARQLTF,0,1,1,1
TRAV12-1,TRAJ42,CVVNGWYGGSQGNLIF,0,1,1,1
TRAV38-1,TRAJ52,CAFINAGGTSYGKLTF,0,1,1,1
TRAV17,TRAJ4,CASASWFSGGYNKLIF,0,1,1,1
TRAV6,TRAJ10,CALGAILTGGGNKLTF,0,1,1,1
TRAV19,TRAJ57,CALSVPFSGRSEKLVF,0,1,1,1
TRAV9-2,TRAJ13,CALSGRDSGGYQKVTF,0,1,1,1
TRAV9-2,TRAJ58,CALSEWGETSGSRLTF,0,1,1,1
TRAV16,TRAJ42,CALSLDYGGSQGNLIF,0,1,1,1
TRAV36DV7,TRAJ52,CAVLNAGGTSYGKLTL,0,1,1,1
TRAV8-3,TRAJ6,CAVGSLPSGGSYIPTF,0,1,1,1
TRAV8-3,TRAJ18,CAVGARRGSTLGRLYF,0,1,1,1
TRAV36DV7,TRAJ44,CAVEGRGTGTASKLTF,0,1,1,1
TRAV22,TRAJ35,CAVENERVGFGNVLHC,0,1,1,1
TRAV8-4,TRAJ52,CAVTYSGGTSYGKLTF,0,1,1,1
TRAV8-6,TRAJ13,CAVSAFNSGGYQKVTF,0,1,1,1
TRAV3,TRAJ28,CAVRMASGAGSYQLTF,0,1,1,1
TRAV35,TRAJ42,CAGPPNYGGSQGNLIF,0,1,1,1
TRAV12-2,TRAJ45,CAVNNRSGGGADGLTF,0,1,1,1
TRAV27,TRAJ42,CAAPSARGGSQGNLIF,0,1,1,1
TRAV29DV5,TRAJ32,CAASAFSSGATNKLIF,0,1,1,1
TRAV29DV5,TRAJ28,CAASALSGAGSYQLTF,0,1,1,1
TRAV29DV5,TRAJ37,CAASAKDSSNTGKLIF,0,1,1,1
TRAV23DV6,TRAJ42,CAASGSDGGSQGNLIF,0,1,1,1
TRAV23DV6,TRAJ10,CAASDGVTGGGNKLTF,0,1,1,1
TRAV23DV6,TRAJ18,CAASDDRGSTLGRLYF,0,1,1,1
TRAV23DV6,TRAJ53,CAASMGSGGSNYKLTF,0,1,1,1
TRAV23DV6,TRAJ57,CAASTLTQGGSEKLVF,0,1,1,1
TRAV27,TRAJ52,CAGANAGGTSYGKLTF,0,1,1,1
TRAV13-2,TRAJ23,CAEIRVPYNQGGKLIF,0,1,1,1
TRAV13-2,TRAJ22,CAEIRISSGSARQLTF,0,1,1,1
TRAV5,TRAJ32,CAESRWYGGATNKLIL,0,1,1,1
TRAV13-2,TRAJ53,CAENLGSGGSNYKLTF,0,1,1,1
TRAV12-3,TRAJ45,CAMSFYSGGGADGLTF,0,1,1,1
TRAV12-3,TRAJ58,CAMSSGWETSGSRLTF,0,1,1,1
TRAV12-3,TRAJ42,CAMSLNYGGSQGNLIF,0,1,1,1
TRAV12-3,TRAJ36,CAMSETTVTGANNLFF,0,1,1,1
TRAV14DV4,TRAJ57,CAMREATQGGSEKLVF,0,1,1,1
TRAV14DV4,TRAJ3,CAMREGRDSSASKIIF,0,1,1,1
TRAV14DV4,TRAJ35,CAMREERIGFGNVLHC,0,1,1,1
TRAV4,TRAJ37,CLVGDPLSSNTGKLIF,0,1,1,1
TRAV4,TRAJ36,CLVGDTVQTGANNLFF,0,1,1,1
TRAV30,TRAJ52,CGTENAGGTSYGKLTF,0,1,1,1
TRAV26-2,TRAJ48,CILSALTNFGNEKLTF,0,1,1,1
TRAV26-2,TRAJ58,CILRDGQETSGSRLTF,0,1,1,1
TRAV26-1,TRAJ20,CIVRVVDGYYDYKLSF,0,1,1,1
TRAV25,TRAJ3,CSRTSGYSSASKIIF,0,1,1,1
TRAV9-2,TRAJ57,CVLSPTQGGSEKLVF,0,1,1,1
TRAV8-2,TRAJ50,CVVSDRKTSYDKVIF,0,1,1,1
TRAV8-2,TRAJ13,CVVSGRSGGYQKVTF,0,1,1,1
TRAV10,TRAJ10,CVVIPITGGGNKLTF,0,1,1,1
TRAV12-1,TRAJ53,CVVTGSGGSNYKLTF,0,1,1,1
TRAV10,TRAJ13,CVVSPYSGGYQKVTF,0,1,1,1
TRAV12-1,TRAJ53,CVVRNSGGSNYKLTF,0,1,1,1
TRAV12-1,TRAJ42,CVVNLGGGSQGNLIF,0,1,1,1
TRAV12-1,TRAJ22,CVVNDPSGSARQLTF,0,1,1,1
TRAV12-1,TRAJ45,CVVNNGGGGADGLTF,0,1,1,1
TRAV38-1,TRAJ48,CAFMKANFGNEKLTF,0,1,1,1
TRAV38-2DV8,TRAJ42,CAYRGAWRSQGNLIF,0,1,1,1
TRAV38-2DV8,TRAJ29,CAYRTVSPGNTPLVF,0,1,1,1
TRAV38-2DV8,TRAJ58,CAYRSAETSGSRLTF,0,1,1,1
TRAV38-2DV8,TRAJ8,CAYRSADTGFQKLVF,0,1,1,1
TRAV38-2DV8,TRAJ32,CAYRRYGGATNKLIF,0,1,1,1
TRAV9-2,TRAJ52,CALNPGGTSYGKLTF,0,1,1,1
TRAV9-2,TRAJ35,CALILPIGFGNVLHC,0,1,1,1
TRAV9-2,TRAJ15,CALTSANQAGTALIF,0,1,1,1
TRAV9-2,TRAJ27,CALSDYNTNAGKSTF,0,1,1,1
TRAV9-2,TRAJ13,CALSDRPGGYQKVTF,0,1,1,1
TRAV9-2,TRAJ56,CALSDQTGANSKLTF,0,1,1,1
TRAV19,TRAJ27,CALSEKSLGAGKSTF,0,1,1,1
TRAV19,TRAJ39,CALSRTNNAGNMLTF,0,1,1,1
TRAV6,TRAJ28,CALEYSGAGSYQLTF,0,1,1,1
TRAV16,TRAJ10,CALSPLAGGGNKLTF,0,1,1,1
TRAV21,TRAJ32,CAVWNYGGATNKLIF,0,1,1,1
TRAV2,TRAJ27,CAVPGYNTNAGKSTF,0,1,1,1
TRAV12-2,TRAJ13,CAVPDYSGGYQKVTF,0,1,1,1
TRAV41,TRAJ42,CAVGIYGGSQGNLIL,0,1,1,1
TRAV41,TRAJ44,CAVSLNTGTASKLTF,0,1,1,1
TRAV20,TRAJ23,CAVQAIGDQGGKLIF,0,1,1,1
TRAV12-2,TRAJ42,CAVVFWSGSQGNLIF,0,1,1,1
TRAV8-3,TRAJ39,CAVAPGGNAGNMLTF,0,1,1,1
TRAV36DV7,TRAJ28,CAVAASGAGSYQLTF,0,1,1,1
TRAV8-3,TRAJ4,CAVGPFSGGYNKLIF,0,1,1,1
TRAV8-3,TRAJ39,CAVGAMVNAGNTLTF,0,1,1,1
TRAV8-4,TRAJ23,CAVGLIYNRGGKLIF,0,1,1,1
TRAV22,TRAJ58,CAVDPKETSGSRLTF,0,1,1,1
TRAV2,TRAJ22,CAVDILSGSARQLTF,0,1,1,1
TRAV8-4,TRAJ13,CAVSRPSGGYQKVTF,0,1,1,1
TRAV8-6,TRAJ47,CAVSERQEYGNKLVF,0,1,1,1
TRAV3,TRAJ24,CAVRSSTDSWGKLQF,0,1,1,1
TRAV21,TRAJ44,CAVRPWSGTASKLTF,0,1,1,1
TRAV21,TRAJ6,CAVRRMAGGSYIPTF,0,1,1,1
TRAV3,TRAJ35,CAVRDRIGFGNVLHC,0,1,1,1
TRAV3,TRAJ7,CAVRSPYYGNNRLAF,0,1,1,1
TRAV3,TRAJ30,CAVRVLMNRDDKIIF,0,1,1,1
TRAV3,TRAJ8,CAVRALNTGFQKLVF,0,1,1,1
TRAV3,TRAJ32,CAVRDYGGATNKLIF,0,1,1,1
TRAV3,TRAJ9,CAVRDGDTGGFKTIF,0,1,1,1
TRAV3,TRAJ9,CAVRDTGTGGFKTIF,0,1,1,1
TRAV3,TRAJ9,CAVRDRGTGGFKTIF,0,1,1,1
TRAV8-4,TRAJ48,CAVNEVGFGNEKLTF,0,1,1,1
TRAV20,TRAJ42,CAAGDYGGSQGNLIF,0,1,1,1
TRAV41,TRAJ42,CAGLRDGGSQGNLIF,0,1,1,1
TRAV36DV7,TRAJ38,CAEGLNAGNNRKLIW,0,1,1,1
TRAV17,TRAJ45,CATYGGGGGADGLTF,0,1,1,1
TRAV39,TRAJ32,CAVRLYGGATNKLIF,0,1,1,1
TRAV12-2,TRAJ57,CAVGLEEGGSEKLVF,0,1,1,1
TRAV12-2,TRAJ4,CAVTSGRGGYNKLIF,0,1,1,1
TRAV12-2,TRAJ29,CAVNPRNSGNTPLVF,0,1,1,1
TRAV12-2,TRAJ40,CAVNGGTSGTYKYIF,0,1,1,1
TRAV12-2,TRAJ10,CAVNGVTGGGNKLTF,0,1,1,1
TRAV12-2,TRAJ53,CAVNRSGGSNYKLTF,0,1,1,1
TRAV8-1,TRAJ4,CAVKSFSRGYNKLIF,0,1,1,1
TRAV12-1,TRAJ42,CAGNIYGGSQGNLIF,0,1,1,1
TRAV27,TRAJ52,CAPTAGGTSYGKLTF,0,1,1,1
TRAV13-1,TRAJ39,CAAHAPNNAGNMLTF,0,1,1,1
TRAV13-1,TRAJ45,CAAWYSGGGADGLTF,0,1,1,1
TRAV13-1,TRAJ40,CAAVVQSSGTYKYIF,0,1,1,1
TRAV13-1,TRAJ29,CAAGGGLSGNTPLVL,0,1,1,1
TRAV13-1,TRAJ50,CAASYMETSYDKVIF,0,1,1,1
TRAV13-1,TRAJ16,CAASPLGSDGQKLLF,0,1,1,1
TRAV13-1,TRAJ38,CAASRGAGSNRKLIW,0,1,1,1
TRAV13-1,TRAJ23,CAASLPWGQGGKLIF,0,1,1,1
TRAV23DV6,TRAJ41,CAASRNSNSGYALNF,0,1,1,1
TRAV29DV5,TRAJ22,CAASALDGSARQLTF,0,1,1,1
TRAV29DV5,TRAJ4,CAASEFSGGYNKLIF,0,1,1,1
TRAV13-1,TRAJ18,CAANPRGSTLGRLYF,0,1,1,1
TRAV25,TRAJ23,CAGPPPYNQGGKLIF,0,1,1,1
TRAV23DV6,TRAJ24,CAGGRKTDSWGKLQF,0,1,1,1
TRAV27,TRAJ53,CAGARSGGSNYKLTF,0,1,1,1
TRAV27,TRAJ42,CAGEGYGGSQGNLIF,0,1,1,1
TRAV13-2,TRAJ42,CAETLWGGSQGNLIF,0,1,1,1
TRAV5,TRAJ3,CAETPGYSSASKIIF,0,1,1,1
TRAV13-2,TRAJ4,CAENPQRGGYNKLIF,0,1,1,1
TRAV13-2,TRAJ50,CAENDPKTSYDKVIF,0,1,1,1
TRAV12-3,TRAJ9,CAMSSRARVGFKTIF,0,1,1,1
TRAV12-3,TRAJ52,CAMSALGTSYGKLTF,0,1,1,1
TRAV12-3,TRAJ38,CAMSANAGNNRKLIW,0,1,1,1
TRAV12-3,TRAJ21,CAMSGNWYNFNKFYF,0,1,1,1
TRAV12-3,TRAJ3,CAMSGYYSSASKIIF,0,1,1,1
TRAV14DV4,TRAJ8,CAMREPNTGFQKLVF,0,1,1,1
TRAV34,TRAJ32,CGADITGGATNKLIF,0,1,1,1
TRAV4,TRAJ38,CLVALNAGNNRKLIW,0,1,1,1
TRAV4,TRAJ8,CLVGALNTGFQKLVF,0,1,1,1
TRAV4,TRAJ40,CLVGAPTSGTYKYIF,0,1,1,1
TRAV4,TRAJ40,CLVGDGDSGTYKYIF,0,1,1,1
TRAV4,TRAJ8,CLVGDMNTGIQKLVF,0,1,1,1
TRAV4,TRAJ9,CLVGDRGTGGFKTIF,0,1,1,1
TRAV4,TRAJ32,CLVGDKNGATNKLIF,0,1,1,1
TRAV4,TRAJ10,CLVGPSTGGGNKLTF,0,1,1,1
TRAV4,TRAJ5,CLVGPMDTGRRALTF,0,1,1,1
TRAV13-2,TRAJ17,CAERPGKAAGNKLTF,0,1,1,1
TRAV26-2,TRAJ53,CILRSPGGSNYKLTF,0,1,1,1
TRAV26-2,TRAJ34,CILRDPPAIADKLIF,0,1,1,1
TRAV26-1,TRAJ52,CIVSPGGTSYGKLTF,0,1,1,1
TRAV26-1,TRAJ39,CIVRSRFNAGNMLTF,0,1,1,1
TRAV26-1,TRAJ16,CIVRPSFSDGQKLLF,0,1,1,1
TRAV26-1,TRAJ44,CIVRVGTGTASKLTF,0,1,1,1
TRAV26-1,TRAJ39,CIVRVGNNAGNMLTF,0,1,1,1
TRAV26-1,TRAJ33,CIVRVSRDSNYQLIW,0,1,1,1
TRAV8-2,TRAJ5,SVVSDTYTGRRALTF,0,1,1,1
TRAV25,TRAJ52,CRSAGGTSYGKLTF,0,1,1,1
TRAV8-2,TRAJ50,CVVSDPTSYDKVIF,0,1,1,1
TRAV8-2,TRAJ43,CVVSDRSNNNDMRF,0,1,1,1
TRAV8-2,TRAJ20,CVVSETTNDYKLSF,0,1,1,1
TRAV12-1,TRAJ37,CVVGGSSNTGKLIF,0,1,1,1
TRAV12-1,TRAJ22,CVVDQGGSARQLTF,0,1,1,1
TRAV12-1,TRAJ3,CVVIPYSCASKIIF,0,1,1,1
TRAV12-1,TRAJ27,CVVTDNTNAGKSTF,0,1,1,1
TRAV10,TRAJ45,CVVSVRGGADGLTF,0,1,1,1
TRAV10,TRAJ44,CVVSAAGTASKLTF,0,1,1,1
TRAV12-1,TRAJ13,CVVRGPGGYQKVTF,0,1,1,1
TRAV12-1,TRAJ34,CVVNYSYNTDKLIF,0,1,1,1
TRAV12-1,TRAJ27,CVVNVDTNAGKSTF,0,1,1,1
TRAV12-1,TRAJ48,CVVNINFGNEKLTF,0,1,1,1
TRAV12-1,TRAJ6,CVGQASGGSYIPTF,0,1,1,1
TRAV12-1,TRAJ12,CVESLMDSSYKLIF,0,1,1,1
TRAV38-1,TRAJ39,CAFMSYNTGNMLTF,0,1,1,1
TRAV38-2DV8,TRAJ44,CAYSTTGTAGKLTF,0,1,1,1
TRAV38-2DV8,TRAJ57,CAYISQGGSEKLVF,0,1,1,1
TRAV38-2DV8,TRAJ30,CAYRGRDRDDKIIF,0,1,1,1
TRAV38-2DV8,TRAJ56,CAYRSAGANSKLTF,0,1,1,1
TRAV38-2DV8,TRAJ9,CAYRSETGGFKTIF,0,1,1,1
TRAV38-2DV8,TRAJ30,CAYSLMNRDDKIIF,0,1,1,1
TRAV9-2,TRAJ57,CALRKQGGSEKLVF,0,1,1,1
TRAV9-2,TRAJ56,CALSYTGANSKLTF,0,1,1,1
TRAV9-2,TRAJ37,CALSDSSNTGKLIF,0,1,1,1
TRAV9-2,TRAJ56,CALSIAGANSKLTF,0,1,1,1
TRAV9-2,TRAJ44,CALSNTGTASKLTF,0,1,1,1
TRAV9-2,TRAJ53,CALRGGGSNYKLTF,0,1,1,1
TRAV21,TRAJ11,CALGALSGYSTLTF,0,1,1,1
TRAV6,TRAJ8,CALDPLTGFQKLVL,0,1,1,1
TRAV16,TRAJ3,CALEGYSSASKIIF,0,1,1,1
TRAV16,TRAJ30,CALTGGGRDDKIIF,0,1,1,1
TRAV19,TRAJ45,CARRSGGGADGLTF,0,1,1,1
TRAV2,TRAJ26,CAVSSTNYGQNFVF,0,1,1,1
TRAV12-2,TRAJ26,CAVIGRNYGQNLVF,0,1,1,1
TRAV20,TRAJ36,CAVFDQTGANNLFF,0,1,1,1
TRAV41,TRAJ45,CAVYSGGGADGLTF,0,1,1,1
TRAV22,TRAJ57,CAVLPQGGSEKLVF,0,1,1,1
TRAV41,TRAJ45,CAVPSGGGADGLTF,0,1,1,1
TRAV21,TRAJ52,CAVYGGTSYGKLTF,0,1,1,1
TRAV20,TRAJ17,CAVPKGAAGNKLTF,0,1,1,1
TRAV20,TRAJ37,CAVHGSSNTGKLIF,0,1,1,1
TRAV20,TRAJ23,CAVQSYNQGGKLIF,0,1,1,1
TRAV8-3,TRAJ6,CAVVTSGGSYIPTF,0,1,1,1
TRAV8-3,TRAJ23,CAVGPYNQGGKLIF,0,1,1,1
TRAV8-4,TRAJ4,CAVGHSGGYNKLIF,0,1,1,1
TRAV8-3,TRAJ40,CAVGAHSGTYKYIF,0,1,1,1
TRAV8-3,TRAJ20,CAVGARSNDYKLSF,0,1,1,1
TRAV2,TRAJ45,CAVERGGGADGLTF,0,1,1,1
TRAV2,TRAJ42,CAVEAGGSQGNLIF,0,1,1,1
TRAV2,TRAJ30,CAVEDQRRDDKIIF,0,1,1,1
TRAV1-2,TRAJ16,CAVILRRDGQKLLF,0,1,1,1
TRAV8-4,TRAJ29,CAVSSNSGNTPLVF,0,1,1,1
TRAV8-6,TRAJ37,CAVSPSSNTGKLIF,0,1,1,1
TRAV8-6,TRAJ34,CAVSPLGDTDKLIF,0,1,1,1
TRAV3,TRAJ3,CAVRLYSSASKIIF,0,1,1,1
TRAV21,TRAJ6,CAVRQTGGSYIPTF,0,1,1,1
TRAV21,TRAJ15,CAVRVNQAGTALIF,0,1,1,1
TRAV12-2,TRAJ23,CAVRGYNQGGKLIF,0,1,1,1
TRAV12-2,TRAJ39,CAVRGHNAGNMLTF,0,1,1,1
TRAV3,TRAJ35,CAVRGTGFGNVLHC,0,1,1,1
TRAV3,TRAJ9,CAVRDYTGGFKTIF,0,1,1,1
TRAV3,TRAJ31,CAVRDLNNNARLMF,0,1,1,1
TRAV3,TRAJ27,CAVRDGTNAGKSTF,0,1,1,1
TRAV8-4,TRAJ6,CAVKRAGGSYIPTF,0,1,1,1
TRAV3,TRAJ28,CAGGPGAGSYQLTF,0,1,1,1
TRAV35,TRAJ50,CAGQRGTSYDKVIF,0,1,1,1
TRAV35,TRAJ39,CAGQNRNAGNMLTF,0,1,1,1
TRAV8-6,TRAJ22,CAMSETGSARQLTF,0,1,1,1
TRAV17,TRAJ28,CATVAGAGSYQLTF,0,1,1,1
TRAV17,TRAJ29,CATDPHSGNTPLVF,0,1,1,1
TRAV17,TRAJ37,CATDARDNTGKLIF,0,1,1,1
TRAV17,TRAJ33,CATDEGDSNYQLIW,0,1,1,1
TRAV17,TRAJ16,CASYFSSDGQKLLF,0,1,1,1
TRAV24,TRAJ30,CAFKLGYRDDKIIF,0,1,1,1
TRAV8-1,TRAJ3,CAFAGYSSASKIIF,0,1,1,1
TRAV12-2,TRAJ5,CALAGSPGRRALTF,0,1,1,1
TRAV12-2,TRAJ6,CALTSAGGSYIPTF,0,1,1,1
TRAV29DV5,TRAJ9,CALSDNTGGFKTIF,0,1,1,1
TRAV12-2,TRAJ27,CALGGGTNAGKSTF,0,1,1,1
TRAV12-2,TRAJ40,CAVHTTSGTYKYIS,0,1,1,1
TRAV12-2,TRAJ40,CAVHSTSGTYKYIF,0,1,1,1
TRAV12-2,TRAJ4,CAVMFSGGYNKLIF,0,1,1,1
TRAV39,TRAJ41,CAVYQGNSGYALNF,0,1,1,1
TRAV12-2,TRAJ6,CAVRLSGGSYIPTF,0,1,1,1
TRAV12-2,TRAJ13,CAVIESGGYQKVTF,0,1,1,1
TRAV12-2,TRAJ38,CAVSTAGNNRKLIW,0,1,1,1
TRAV12-2,TRAJ8,CAVRKNTGFQKLVF,0,1,1,1
TRAV8-1,TRAJ12,CAVNAPDSSYKLIF,0,1,1,1
TRAV8-1,TRAJ27,CAVNAQTNAGKSTF,0,1,1,1
TRAV8-1,TRAJ7,CAVNAGYGNNRLAF,0,1,1,1
TRAV12-2,TRAJ11,CAVNGDSGYSTLTF,0,1,1,1
TRAV8-1,TRAJ9,CAVKSKAGGFKTIF,0,1,1,1
TRAV12-2,TRAJ4,CAADLSGGYNKLIF,0,1,1,1
TRAV13-1,TRAJ30,CAPSKGDRDDKIIF,0,1,1,1
TRAV13-1,TRAJ40,CAAYLTSGTYKYIF,0,1,1,1
TRAV23DV6,TRAJ57,CAAPYQGGSEKLVF,0,1,1,1
TRAV13-1,TRAJ39,CAAGVNNAGNVLTF,0,1,1,1
TRAV13-1,TRAJ41,CAAMNSNSGYALNF,0,1,1,1
TRAV23DV6,TRAJ39,CAATSNNAGNMLTF,0,1,1,1
TRAV13-1,TRAJ54,CAASWSSGAQKLVF,0,1,1,1
TRAV13-1,TRAJ39,CAASMNNAGNMLTF,0,1,1,1
TRAV13-1,TRAJ31,CAASIGGNNARLMF,0,1,1,1
TRAV13-1,TRAJ42,CAASTGGSQGNLIF,0,1,1,1
TRAV13-1,TRAJ29,CAASKGARNTPLVF,0,1,1,1
TRAV13-1,TRAJ5,CAASKEAGRRALTF,0,1,1,1
TRAV29DV5,TRAJ45,CAASPGDFDDGLTF,0,1,1,1
TRAV29DV5,TRAJ21,CAASAWDNFNKFYF,0,1,1,1
TRAV29DV5,TRAJ29,CAASANSGNTPLVF,0,1,1,1
TRAV29DV5,TRAJ11,CAASEGSGYSTLTF,0,1,1,1
TRAV23DV6,TRAJ54,CAASMSGGAQKLVF,0,1,1,1
TRAV23DV6,TRAJ58,CAASSKTSGSRLTF,0,1,1,1
TRAV23DV6,TRAJ57,CAASKKGGSEKLVF,0,1,1,1
TRAV13-1,TRAJ17,CAARFGAAGNKLTF,0,1,1,1
TRAV23DV6,TRAJ23,CAARSYNQGGKLIF,0,1,1,1
TRAV29DV5,TRAJ47,CAAKERKYGNKLVF,0,1,1,1
TRAV27,TRAJ54,CAGTRPRGAQKLVF,0,1,1,1
TRAV13-2,TRAJ23,CAEISYNQGGKLIF,0,1,1,1
TRAV5,TRAJ10,CAEMFTGGGNKLTF,0,1,1,1
TRAV13-2,TRAJ39,CAETDNNAGNMLTF,0,1,1,1
TRAV5,TRAJ42,CAERGGGSQGNLIF,0,1,1,1
TRAV13-2,TRAJ40,CAENRASGTYKYIF,0,1,1,1
TRAV12-3,TRAJ49,CAMIPTNTGNQFYF,0,1,1,1
TRAV14DV4,TRAJ54,CAMIFLQGAQKLVF,0,1,1,1
TRAV14DV4,TRAJ29,CAMSIFSGNTPLVF,0,1,1,1
TRAV12-3,TRAJ54,CAMSARGGAQKLVF,0,1,1,1
TRAV12-3,TRAJ32,CAMSDGGATNKLIF,0,1,1,1
TRAV14DV4,TRAJ24,CAMRRTDSWGKLQF,0,1,1,1
TRAV14DV4,TRAJ11,CAMRPNSGYSTLTF,0,1,1,1
TRAV14DV4,TRAJ9,CAMRGYTGGFKTIF,0,1,1,1
TRAV14DV4,TRAJ7,CAMRENRGNNRLAF,0,1,1,1
TRAV34,TRAJ56,CGAWKTGANSKLTF,0,1,1,1
TRAV34,TRAJ17,CGARGEAAGNKLTF,0,1,1,1
TRAV34,TRAJ53,CGADMGGSNYKLTF,0,1,1,1
TRAV4,TRAJ15,CLVLKNQAGTALIF,0,1,1,1
TRAV4,TRAJ9,CLVGDPTGGFKTIF,0,1,1,1
TRAV4,TRAJ32,CLVGDVGATSKLIF,0,1,1,1
TRAV30,TRAJ39,CGTDHNNAGNMLTF,0,1,1,1
TRAV30,TRAJ48,CGTEGNFGNEKLTF,0,1,1,1
TRAV30,TRAJ29,CGTEKGSGNTPLVF,0,1,1,1
TRAV26-2,TRAJ38,CILSNAGNNRKLIW,0,1,1,1
TRAV26-2,TRAJ54,CILRDEGGAQKLVF,0,1,1,1
TRAV26-1,TRAJ40,CIVREGSGTYKYIF,0,1,1,1
TRAV26-1,TRAJ58,CIVRRETSGSRLTF,0,1,1,1
TRAV13-2,TRAJ34,RAEIRSYNTDKLIF,0,1,1,1
TRAV12-1,TRAJ49,SVVQKPNTGNQFYF,0,1,1,1
TRAV26-1,TRAJ48,FIVRVIGNEKLTF,0,1,1,1
TRAV8-3,TRAJ20,CVSRGSNDYKLSF,0,1,1,1
TRAV8-2,TRAJ34,CVVSPYNTDKLIF,0,1,1,1
TRAV8-1,TRAJ20,CVVDAPNDYKLSF,0,1,1,1
TRAV12-1,TRAJ29,CVVSISGNTPLVF,0,1,1,1
TRAV12-1,TRAJ27,CVVGETNAGKSTF,0,1,1,1
TRAV12-1,TRAJ43,CVVGPYNNNDMRF,0,1,1,1
TRAV10,TRAJ9,CVVTHTGGFKTIF,0,1,1,1
TRAV10,TRAJ33,CVVSALSNYQLIW,0,1,1,1
TRAV10,TRAJ20,CVVSANRDYKLSF,0,1,1,1
TRAV10,TRAJ43,CVVRPDQGNDMRF,0,1,1,1
TRAV12-1,TRAJ39,CVVNWNAGNMLTF,0,1,1,1
TRAV12-1,TRAJ35,CVVNIGFGNVLYC,0,1,1,1
TRAV12-1,TRAJ7,CVVNMGGNNRLAF,0,1,1,1
TRAV12-1,TRAJ36,CVVNIYGANNLFF,0,1,1,1
TRAV12-1,TRAJ20,CVVNSADDHKLSF,0,1,1,1
TRAV12-1,TRAJ6,CVVNRGGSYIPTF,0,1,1,1
TRAV12-1,TRAJ11,CVARGSGYSTLTF,0,1,1,1
TRAV12-1,TRAJ24,CVILTDSWGKLQF,0,1,1,1
TRAV17,TRAJ45,CASPGGGADGLTF,0,1,1,1
TRAV3,TRAJ37,CASYLSNTGKLIF,0,1,1,1
TRAV38-2DV8,TRAJ44,CAYRAGTASKLTF,0,1,1,1
TRAV38-2DV8,TRAJ42,CAYRGGSQGNLIF,0,1,1,1
TRAV16,TRAJ22,CALISGSARQLTF,0,1,1,1
TRAV16,TRAJ48,CALSPFGNEKLTF,0,1,1,1
TRAV9-2,TRAJ15,CALLNQAGTALIF,0,1,1,1
TRAV16,TRAJ35,CALPIGFGNVLHC,0,1,1,1
TRAV9-2,TRAJ15,CALRSQAGTALIF,0,1,1,1
TRAV19,TRAJ29,CALATAGNTPLVF,0,1,1,1
TRAV6,TRAJ6,CALASGGSYIPTF,0,1,1,1
TRAV9-2,TRAJ23,CALIYNQGGKLIF,0,1,1,1
TRAV9-2,TRAJ30,CALTQVGDDKIIF,0,1,1,1
TRAV9-2,TRAJ37,CALTYSNTGKLIF,0,1,1,1
TRAV9-2,TRAJ9,CALSGTGGFKTIF,0,1,1,1
TRAV9-2,TRAJ38,CALKGGNNRKLIW,0,1,1,1
TRAV6,TRAJ43,CALDPYNNNDMRF,0,1,1,1
TRAV16,TRAJ8,CALSGHDFQKLVF,0,1,1,1
TRAV16,TRAJ31,CALSGQNNASLMF,0,1,1,1
TRAV23DV6,TRAJ16,CAPFETDGQKLLF,0,1,1,1
TRAV12-2,TRAJ45,CARKRRGADGLTF,0,1,1,1
TRAV2,TRAJ29,CAVWNSGNTPLVF,0,1,1,1
TRAV21,TRAJ17,CAVIKAAGNKLTF,0,1,1,1
TRAV41,TRAJ43,CAVLSYNNNDMRF,0,1,1,1
TRAV12-2,TRAJ39,CAVPNNAGNMLTF,0,1,1,1
TRAV41,TRAJ30,CAVRTNRDDKIIF,0,1,1,1
TRAV21,TRAJ41,CAVVSNSGYALNF,0,1,1,1
TRAV2,TRAJ5,CAVAPTGRRALTF,0,1,1,1
TRAV21,TRAJ45,CAVARGGADGLTF,0,1,1,1
TRAV8-3,TRAJ37,CAVGEVNTGKLIF,0,1,1,1
TRAV12-2,TRAJ39,CAVGKNAGNMLTF,0,1,1,1
TRAV22,TRAJ49,CAVERNTGNQFYF,0,1,1,1
TRAV3,TRAJ40,CAVILSGTYKYIF,0,1,1,1
TRAV8-4,TRAJ43,CAVIRYNNNDMRF,0,1,1,1
TRAV3,TRAJ8,CAVTGTGFQKLVF,0,1,1,1
TRAV8-4,TRAJ49,CAVSDPSGNQFYF,0,1,1,1
TRAV8-6,TRAJ20,CAVSDGNDYKLSF,0,1,1,1
TRAV8-4,TRAJ49,CAVSDRRGNHFYF,0,1,1,1
TRAV8-4,TRAJ29,CAVSYSGNTPLVF,0,1,1,1
TRAV21,TRAJ26,CAVRQNYGQNFVF,0,1,1,1
TRAV8-4,TRAJ34,CAVRVFNTDKLIF,0,1,1,1
TRAV12-2,TRAJ6,CAVRTGGSYIPTF,0,1,1,1
TRAV3,TRAJ30,CAVRLLRADKIIF,0,1,1,1
TRAV3,TRAJ29,CAVRGWGNTPLVF,0,1,1,1
TRAV3,TRAJ32,CAVRGGATNKLIF,0,1,1,1
TRAV1-2,TRAJ35,CAVRDGFGNVLHC,0,1,1,1
TRAV3,TRAJ13,CAVRDRGYQKVTF,0,1,1,1
TRAV3,TRAJ31,CAVRDQDNARLMF,0,1,1,1
TRAV3,TRAJ7,CAVRDDGNNRLAF,0,1,1,1
TRAV3,TRAJ11,CAVRDKGYSTLTF,0,1,1,1
TRAV12-2,TRAJ12,CAVGGDSSYKLII,0,1,1,1
TRAV20,TRAJ32,CAAYGGATNKLIF,0,1,1,1
TRAV21,TRAJ10,CAAPTGGGNKLTF,0,2,1,2
TRAV41,TRAJ49,CAADTNTGNQFYF,0,1,1,1
TRAV35,TRAJ56,CAGLSGANSKLTF,0,1,1,1
TRAV35,TRAJ58,CAGVETSGSRLTF,0,1,1,1
TRAV17,TRAJ5,CATLDTGRRALTF,0,1,1,1
TRAV17,TRAJ57,CATSQGGSEKLVF,0,1,1,1
TRAV17,TRAJ9,CATDVGGGFKTIF,0,1,1,1
TRAV17,TRAJ30,CATDAFGDDKIIF,0,1,1,1
TRAV17,TRAJ34,CATDAGNTDKLIF,0,1,1,1
TRAV17,TRAJ49,CAKSYDTGNQFYF,0,1,1,1
TRAV24,TRAJ41,CAFNSNSGYALNF,0,1,1,1
TRAV24,TRAJ40,CASGTSGTYKYIF,0,1,1,1
TRAV23DV6,TRAJ12,CAPNRGSSYELIF,0,1,1,1
TRAV16,TRAJ13,CAPQSRGYQKVTF,0,1,1,1
TRAV19,TRAJ22,CAHPAGSARQLTF,0,1,1,1
TRAV12-2,TRAJ3,CAVLYSSASKIIF,0,1,1,1
TRAV39,TRAJ40,CAVRTSGTYKYIF,0,1,1,1
TRAV12-2,TRAJ7,CAVLRRGNNRLAF,0,1,1,1
TRAV8-1,TRAJ43,CAVQKYNNNDMRF,0,1,1,1
TRAV12-2,TRAJ48,CAVGVFGNEKLTF,0,1,1,1
TRAV12-2,TRAJ29,CAVANSGNTPLDF,0,1,1,1
TRAV39,TRAJ49,CAVGGNTGNQFYF,0,1,1,1
TRAV12-2,TRAJ21,CAVTSYNFNKFYF,0,1,1,1
TRAV12-2,TRAJ7,CAVRDYGNNRLAF,0,1,1,1
TRAV8-1,TRAJ35,CAVNAGFGNVLHC,0,1,1,1
TRAV8-1,TRAJ31,CAVNRPNNARLMF,0,1,1,1
TRAV12-2,TRAJ9,CAVNSAGGFKTIF,0,1,1,1
TRAV12-2,TRAJ22,CAVNRGSARQLTF,0,1,1,1
TRAV12-2,TRAJ35,CAVNRSFGNVLHC,0,1,1,1
TRAV12-2,TRAJ26,CAVNKVDGQNFVF,0,1,1,1
TRAV12-3,TRAJ10,CAASTGGGNKLTF,0,1,1,1
TRAV8-1,TRAJ20,CAANKANDYKLSF,0,1,1,1
TRAV6,TRAJ41,CAITPDSGYALNF,0,1,1,1
TRAV8-3,TRAJ42,CATGGGSQGNLIF,0,1,1,1
TRAV21,TRAJ7,CAFPAGGNNRLAF,0,1,1,1
TRAV12-3,TRAJ11,CAVPNSGYSTLTF,0,1,1,1
TRAV13-1,TRAJ6,CAAFEGGSYIPTF,0,1,1,1
TRAV13-1,TRAJ20,CAASLANDYKLSF,0,1,1,1
TRAV29DV5,TRAJ37,CAALSSNTGKLIF,0,1,1,1
TRAV13-1,TRAJ8,CAASKRGFQKLVF,0,1,1,1
TRAV29DV5,TRAJ35,CAASRGFGNVLHC,0,1,1,1
TRAV13-1,TRAJ39,CAATLNAGNMLTF,0,1,1,1
TRAV13-1,TRAJ9,CAASDAGGFKTIF,0,1,1,1
TRAV13-1,TRAJ30,CAASRGGDDKIIF,0,1,1,1
TRAV29DV5,TRAJ21,CAASAHNFNKFYF,0,1,1,1
TRAV29DV5,TRAJ22,CAASESSPRQLTF,0,1,1,1
TRAV23DV6,TRAJ54,CAASMRGAQKLVF,0,1,1,1
TRAV29DV5,TRAJ48,CAARAFGNEKLTF,0,1,1,1
TRAV23DV6,TRAJ13,CAARNGGYQKVTF,0,1,1,1
TRAV25,TRAJ8,CAGLRTGFQKLVF,0,1,1,1
TRAV25,TRAJ50,CAGPKTSYDKVIF,0,1,1,1
TRAV25,TRAJ17,CAGPKAAGNKLTF,0,1,1,1
TRAV27,TRAJ3,CAGDHSSASKIIL,0,1,1,1
TRAV25,TRAJ26,CAGEDNYGQNFVF,0,1,1,1
TRAV25,TRAJ39,CAGTNNAGNMLTF,0,1,1,1
TRAV13-2,TRAJ21,CAENAINFNKFYF,0,1,1,1
TRAV13-2,TRAJ39,CAENSNAGNMLTF,0,1,1,1
TRAV29DV5,TRAJ48,CAESNFGNEKLTL,0,1,1,1
TRAV12-3,TRAJ43,CAIMTYNNNNMRF,0,1,1,1
TRAV12-3,TRAJ37,CAMGSSNTGKLIF,0,1,1,1
TRAV12-3,TRAJ42,CAMGGGSQGNLIF,0,1,1,1
TRAV12-3,TRAJ11,CAMTGGGYSTLTF,0,1,1,1
TRAV12-3,TRAJ43,CAMSPPEDNDMRF,0,1,1,1
TRAV12-3,TRAJ29,CAMSHSGNTPLVF,0,1,1,1
TRAV12-3,TRAJ13,CAMSVEGYQKVTF,0,1,1,1
TRAV12-3,TRAJ30,CAMSAPRDDKIIF,0,1,1,1
TRAV14DV4,TRAJ23,CAMSARGGGKLIF,0,1,1,1
TRAV14DV4,TRAJ34,CAMRGRNTDKLIF,0,1,1,1
TRAV14DV4,TRAJ30,CAMNRGEDDKIIF,0,1,1,1
TRAV12-3,TRAJ29,CAMKNSGNTPLVF,0,1,1,1
TRAV12-3,TRAJ17,CAIKRAAGNKLTF,0,1,1,1
TRAV12-3,TRAJ42,CATYGGSQGNLIF,0,1,1,1
TRAV8-3,TRAJ23,CATLYNQGGKLIF,0,1,1,1
TRAV34,TRAJ29,CGADMMGNTPLVF,0,1,1,1
TRAV4,TRAJ23,CLVVYNQGGKLIF,0,1,1,1
TRAV4,TRAJ9,CLVAKTGGFKTIF,0,1,1,1
TRAV4,TRAJ34,CLVGPLNTDKLIF,0,1,1,1
TRAV4,TRAJ34,CLVGDIFTDKLIF,0,1,1,1
TRAV4,TRAJ33,CLVGDRSNYQLIW,0,1,1,1
TRAV26-2,TRAJ37,CILSSSNTGKLIF,0,1,1,1
TRAV26-2,TRAJ20,CILRVWGDYKLSF,0,1,1,1
TRAV26-2,TRAJ30,CILRDNRDDKIIF,0,1,1,1
TRAV26-2,TRAJ30,CILREGRDDKIIF,0,1,1,1
TRAV26-1,TRAJ39,CIVGDNAGNMLTF,0,1,1,1
TRAV26-1,TRAJ58,CIVTETSGSRLTF,0,1,1,1
TRAV26-1,TRAJ34,CIVRVYNTDKLIF,0,1,1,1
TRAV17,TRAJ28,WANSGAGSYQLTF,0,1,1,1
TRAV12-1,TRAJ20,CVSSSNDYKLSF,0,1,1,1
TRAV12-1,TRAJ37,CVVNSNTGKLIF,0,1,1,1
TRAV12-1,TRAJ33,CVVQDSNYQLIW,0,1,1,1
TRAV12-1,TRAJ33,CVVTDSNYQLIW,0,1,1,1
TRAV10,TRAJ43,CVVSASYYDMRF,0,1,1,1
TRAV10,TRAJ8,CVVRTGFQKLVF,0,1,1,1
TRAV12-1,TRAJ31,CVVNYDNARLMF,0,1,1,1
TRAV12-1,TRAJ49,CVVNMAGNQFYF,0,1,1,1
TRAV12-1,TRAJ39,CVVNRAGNMLTF,0,1,1,1
TRAV21,TRAJ15,CASYQAGTALIF,0,1,1,1
TRAV9-2,TRAJ29,CALDSGNTPLVF,0,1,1,1
TRAV9-2,TRAJ54,CALRAGAQKLVS,0,1,1,1
TRAV6,TRAJ26,CALAHYGQNFVF,0,1,1,1
TRAV16,TRAJ53,CALEGSNYKLTF,0,1,1,1
TRAV16,TRAJ26,CALSGYGQNLVF,0,1,1,1
TRAV16,TRAJ21,CALRGNFNKFYF,0,1,1,1
TRAV16,TRAJ37,CAPASNTGKLIF,0,1,1,1
TRAV38-2DV8,TRAJ47,CAHGSGGDKLVF,0,1,1,1
TRAV21,TRAJ56,CAVPGANSKLTF,0,1,1,1
TRAV2,TRAJ11,CAVYSGYSTLTF,0,1,1,1
TRAV20,TRAJ6,CAVQGGSYIPTF,0,1,1,1
TRAV1-2,TRAJ33,CAVADSNYQLIW,0,1,1,1
TRAV8-3,TRAJ9,CAVGTGGFKTIF,0,1,1,1
TRAV8-3,TRAJ20,CAVGPNDYKLSF,0,1,1,1
TRAV2,TRAJ47,CAVEDVGNKLVF,0,1,1,1
TRAV2,TRAJ49,CAVTPTGNQFYF,0,1,1,1
TRAV8-6,TRAJ31,CAVSPNNARLMF,0,1,1,1
TRAV8-6,TRAJ23,CAVSRRAGKLIF,0,1,1,1
TRAV8-4,TRAJ33,CAVSESNYQLIW,0,1,1,1
TRAV3,TRAJ26,CAVRPRGQNFVF,0,1,1,1
TRAV21,TRAJ26,CAVRRGGQNFVF,0,1,1,1
TRAV3,TRAJ34,CAVRDRTDKLIF,0,1,1,1
TRAV20,TRAJ20,CAVRSNDYKLSS,0,1,1,1
TRAV8-3,TRAJ39,CAVNNAGNMLTF,0,1,1,1
TRAV36DV7,TRAJ31,CAARNNNARLMF,0,1,1,1
TRAV12-2,TRAJ40,CAAHSGTYKYIF,0,1,1,1
TRAV41,TRAJ43,CAAVFNNNDMRF,0,1,1,1
TRAV12-2,TRAJ29,CAANSGNTPLVF,0,1,1,1
TRAV3,TRAJ40,CAITSGTYKYIF,0,1,1,1
TRAV17,TRAJ11,CATDSGYSTLTF,0,1,1,1
TRAV17,TRAJ21,CATDGDFNKFYF,0,1,1,1
TRAV24,TRAJ21,CAFYGDFNKFYF,0,1,1,1
TRAV9-2,TRAJ41,CAWENSGYALNF,0,1,1,1
TRAV23DV6,TRAJ37,CAPRGNTGKLNF,0,1,1,1
TRAV23DV6,TRAJ52,CAPFDSYGKLTF,0,1,1,1
TRAV6,TRAJ8,CAPGEGFQKLVF,0,1,1,1
TRAV2,TRAJ12,CAPMDSSYKLIF,0,1,1,1
TRAV8-3,TRAJ22,CAVSGSARQLTF,0,1,1,1
TRAV12-2,TRAJ13,CAVSARYQKVTF,0,1,1,1
TRAV39,TRAJ41,CAVYFSGYALNF,0,1,1,1
TRAV8-1,TRAJ20,CAVNADDYKLSF,0,1,1,1
TRAV12-2,TRAJ48,CAVNDGNEKLTF,0,1,1,1
TRAV12-2,TRAJ26,CAGTNYGQNFVF,0,1,1,1
TRAV2,TRAJ29,CALNSGNTPLVF,0,1,1,1
TRAV12-3,TRAJ43,CAHMYNNNDMRF,0,1,1,1
TRAV13-2,TRAJ30,CAAPNRDDKIIF,0,1,1,1
TRAV13-1,TRAJ31,CAAILNNARLMF,0,1,1,1
TRAV13-1,TRAJ54,CAATAGAQKLVF,0,1,1,1
TRAV13-1,TRAJ3,CAATSSASKIIF,0,1,1,1
TRAV13-1,TRAJ15,CAASIKGTALIF,0,1,1,1
TRAV13-1,TRAJ20,CAASTGDYKLSF,0,1,1,1
TRAV29DV5,TRAJ34,CAASANTDKLIF,0,1,1,1
TRAV13-1,TRAJ49,CAARTTGNQFYF,0,1,1,1
TRAV23DV6,TRAJ20,CAAKDGDYKLSF,0,1,1,1
TRAV13-1,TRAJ27,CAAKPNAGKSTF,0,1,1,1
TRAV25,TRAJ6,CAGPGGSYIPTF,0,1,1,1
TRAV27,TRAJ39,CAGGNAGNMLTF,0,1,1,1
TRAV27,TRAJ49,CAGPRTGNQFYF,0,1,1,1
TRAV13-2,TRAJ17,CAERAAGNKLTF,0,1,1,1
TRAV29DV5,TRAJ34,CAESITADKLIF,0,1,1,1
TRAV12-3,TRAJ37,CAMSANTGKLIF,0,1,1,1
TRAV12-3,TRAJ20,CAMSEGDYKLSF,0,1,1,1
TRAV4,TRAJ34,CLGGENTDKLIF,0,1,1,1
TRAV4,TRAJ34,CLGSFNTDKLIF,0,1,1,1
TRAV26-2,TRAJ54,CIPTQGAQKLVF,0,1,1,1
TRAV26-1,TRAJ26,CIVGDYGQNFVF,0,1,1,1
TRAV2,TRAJ16,WAVEDSGQKLLF,0,1,1,1
TRAV12-1,TRAJ37,CVGSNTGKLIF,0,1,1,1
TRAV12-1,TRAJ49,CVVNTGNQFYF,0,1,1,1
TRAV2,TRAJ24,CAFDSWGKLQF,0,1,1,1
TRAV6,TRAJ29,CALEGNTPLVF,0,1,1,1
TRAV22,TRAJ15,CAPRGGTALIF,0,1,1,1
TRAV12-3,TRAJ26,CAPYYGQNFVF,0,1,1,1
TRAV6,TRAJ21,CARHNFNKFYF,0,1,1,1
TRAV21,TRAJ43,CAVYNNNDMRF,0,1,1,1
TRAV12-2,TRAJ34,CAVVNTDKLIF,0,1,1,1
TRAV3,TRAJ37,CAVTSTGKLIF,0,1,1,1
TRAV21,TRAJ26,CAVNYGQNFVF,0,1,1,1
TRAV41,TRAJ30,CAVNRDDKIIF,0,1,1,1
TRAV7,TRAJ40,CAVRGTYKYIF,0,1,1,1
TRAV2,TRAJ34,CAVVGTDKLIF,0,1,1,1
TRAV2,TRAJ33,CAVESNYQLIW,0,1,1,1
TRAV20,TRAJ48,CAVTGNEKLTF,0,1,1,1
TRAV8-6,TRAJ31,CAVRTDARLMF,0,1,1,1
TRAV1-2,TRAJ33,CAVRSNYQLIW,0,1,1,1
TRAV41,TRAJ49,CAVPTGNQFYF,0,1,1,1
TRAV21,TRAJ20,CAAHNDYKLSF,0,1,1,1
TRAV2,TRAJ33,CAEEGNYQLIW,0,1,1,1
TRAV8-3,TRAJ4,CAMGSSDKLIF,0,1,1,1
TRAV8-3,TRAJ33,CAMNSNYQLIW,0,1,1,1
TRAV17,TRAJ34,CATYTTDKLIF,0,1,1,1
TRAV17,TRAJ9,CATGGGFKTIF,0,1,1,1
TRAV8-1,TRAJ48,CALDLGEKLTF,0,1,1,1
TRAV25,TRAJ15,CAHQAGTALIF,0,1,1,1
TRAV12-2,TRAJ10,CAVGGGNKLTF,0,1,1,1
TRAV29DV5,TRAJ43,CAVELNNDMRF,0,1,1,1
TRAV25,TRAJ39,CAPNAGNMLTF,0,1,1,1
TRAV13-1,TRAJ49,CAALTGNQFYF,0,1,1,1
TRAV29DV5,TRAJ29,CAAGGNTPLVF,0,1,1,1
TRAV29DV5,TRAJ37,CAAVRTGKLIF,0,1,1,1
TRAV25,TRAJ21,CAGDGFNKFYF,0,1,1,1
TRAV25,TRAJ54,CAGEGAQKLVF,0,1,1,1
TRAV27,TRAJ6,CAGGGSYIPTF,0,1,1,1
TRAV12-3,TRAJ11,CAMVGYSTLTF,0,1,1,1
TRAV14DV4,TRAJ44,CAMRPRGKLTF,0,1,1,1
TRAV4,TRAJ43,CLVAPSGDMRF,0,1,1,1
TRAV1-1,TRAJ31,CAVRDHARLMF,0,1,1,1
TRAV26-2,TRAJ20,CILATDYKLSF,0,1,1,1
TRAV17,TRAJ31,WDCGGNARLMF,0,1,1,1
TRAV27,TRAJ45,GSGGGADGLTF,0,1,1,1
TRAV2,TRAJ42,LGGSQGNLIF,0,1,1,1
TRAV12-1,TRAJ5,CVVSRRALTF,0,1,1,1
TRAV12-1,TRAJ5,CVASRRALTF,0,1,1,1
TRAV21,TRAJ43,CAVFGNDMRF,0,1,1,1
TRAV8-4,TRAJ49,CAVTGNQFYF,0,1,1,1
TRAV3,TRAJ20,CAVREYKLSF,0,1,1,1
TRAV21,TRAJ49,CAVNGNQFYF,0,1,1,1
TRAV35,TRAJ43,CAGREYDMRL,0,1,1,1
TRAV39,TRAJ43,CAPRARDMRF,0,1,1,1
TRAV12-2,TRAJ43,CAVRGWDMRF,0,1,1,1
TRAV41,TRAJ43,CASSNNDMRF,0,1,1,1
TRAV13-1,TRAJ43,CAASRRDMRF,0,1,1,1
TRAV13-1,TRAJ43,CAASDNDMRF,0,1,1,1
TRAV13-2,TRAJ40,CAGGTYKYIF,0,1,1,1
TRAV4,TRAJ10,CLGGGNKLTF,0,1,1,1
TRAV21,TRAJ21,CAVGDKFYF,0,1,1,1
TRAV12-2,TRAJ47,CGGGNKLVF,0,1,1,1
TRAV12-2,TRAJ31,CAANASLMF,0,1,1,1
TRAV17,TRAJ43,CATDSLRF,0,1,1,1
TRAV12-2,TRAJ20,CAATLGGF,0,1,1,1
TRAV23DV6,TRAJ58,CAASIRSF,0,1,1,1
TRAV12-2,TRAJ43,CAAYMRF,0,1,1,1
TRAV24,TRAJ22,CAFAG,0,1,1,1
TRAV35,TRAJ53,CAGQDSVGSNYKLTF,0,1,1,1
TRAV24,TRAJ32,CAHPDYGGATNKLIF,0,1,1,1
TRAV3,TRAJ33,CAVSSMDSNYQLIW,0,1,1,1
TRAV9-2,TRAJ24,CALIRDSWGKLQF,0,1,1,1
TRAV3,TRAJ49,CAVNPWGNQFYF,0,1,1,1
