v_hit,j_hit,cdr3,S2-10ng_S7,S2-10ng_S19,freq,count_sum
TRBV4-3,TRBJ2-1,CASSQDVQGSYNEQFF,38,0,1,38
TRBV10-3,TRBJ2-3,CAISSQKTDTQYF,27,1,2,28
TRBV12-3/4,TRBJ2-1,CASSLRANEQFF,27,1,2,28
TRBV19,TRBJ2-1,CASSIVSGTHSYNEQFF,18,0,1,18
TRBV16,TRBJ2-1,CASSPNNEQFF,14,31,2,45
TRBV4-1,TRBJ2-1,CASRAKSALGPYNEQFF,30,1,2,31
TRBV4-3,TRBJ1-2,CASSQGVRTGPYGYTF,20,0,1,20
TRBV4-1,TRBJ2-7,CASSQTGGNYEQYF,11,0,1,11
TRBV7-6,TRBJ1-2,CASSPIDRVYGYTF,10,10,2,20
TRBV2,TRBJ2-3,CASTRDRGTDTQYF,10,19,2,29
TRBV20-1,TRBJ2-5,CSAPLSSGGAGAPQETQYF,12,0,1,12
TRBV5-1,TRBJ2-3,CASSLLVLDPTDTQYF,12,1,2,13
TRBV15,TRBJ2-1,CATSRANSIPYNEQFF,12,0,1,12
TRBV3-1,TRBJ1-6,CASSPRNSPLHF,8,4,2,12
TRBV15,TRBJ2-5,CATSRDFRDPRETQYF,6,5,2,11
TRBV27,TRBJ1-1,CASSFLSGGTEAFF,10,0,1,10
TRBV11-3,TRBJ2-1,CASSSRTSGSYNEQFF,12,4,2,16
TRBV5-4,TRBJ2-1,CASSRADRGLDEQFF,7,15,2,22
TRBV7-9,TRBJ1-1,CASSLALLGAGTEAFF,5,0,1,5
TRBV29-1,TRBJ2-4,CSADQGENIQYF,1,0,1,1
TRBV19,TRBJ1-3,CASSPFGPSSGNTIYL,1,0,1,1
TRBV7-6,TRBJ1-2,CASSFGTTGDLYGYTF,6,7,2,13
TRBV5-5,TRBJ1-1,CASSLWGAGTEAFF,8,6,2,14
TRBV14,TRBJ2-2,CASSQDGDWNTGELFF,2,6,2,8
TRBV2,TRBJ1-1,CASSEIGTGMNTEAFF,1,0,1,1
TRBV5-5,TRBJ2-2,CATKGLPYTGELFF,1,0,1,1
TRBV12-3/4,TRBJ1-1,CASSAEITGNTEAFF,4,0,1,4
TRBV6-2/3/5/6,TRBJ2-1,CASRGQSSYNEQFF,1,0,1,1
TRBV28,TRBJ2-7,CASSLALYEQYF,1,0,1,1
TRBV7-2,TRBJ2-7,CASSLDRVPNEQYF,5,0,1,5
TRBV28,TRBJ2-4,CASSLTGSPRAKNIQYF,4,5,2,9
TRBV7-8,TRBJ2-4,CASSNYRGEGKNIQYF,1,0,1,1
TRBV5-1,TRBJ2-1,CASRLAENYNEQFF,1,0,1,1
TRBV19,TRBJ1-1,CASSPGTVEAFF,4,0,1,4
TRBV7-2,TRBJ2-3,CASSFPPREGLGDTQYF,7,2,2,9
TRBV7-9,TRBJ2-5,CAIHSPRVGQETQYF,3,3,2,6
TRBV20-1,TRBJ1-2,CSARGPQAFNYGYTF,6,1,2,7
TRBV29-1,TRBJ2-1,CSVDLAGSLGEQFF,5,4,2,9
TRBV29-1,TRBJ2-2,CSVAPLGLGRGTGELFF,4,6,2,10
TRBV29-1,TRBJ2-1,CSVELAGAQPRREQFF,6,0,1,6
TRBV19,TRBJ2-3,CASSIAATSTDTQYF,1,0,1,1
TRBV5-8,TRBJ1-3,CASSLGHSPGNTIYF,1,0,1,1
TRBV12-3/4,TRBJ1-5,CASSLADFYQPQHF,3,6,2,9
TRBV29-1,TRBJ2-1,CSVEWLAGAEQFF,1,0,1,1
TRBV29-1,TRBJ1-1,CSVEERDGGVAFF,1,0,1,1
TRBV2,TRBJ2-3,CASSDSGGGRTDTQYF,7,2,2,9
TRBV6-1,TRBJ1-4,CASSESRIPTNEKLFF,2,0,1,2
TRBV12-3/4,TRBJ2-1,CASSGRGTARNEQFF,2,0,1,2
TRBV6-2/3/5/6,TRBJ1-1,CASSYSRVDEAFF,1,0,1,1
TRBV5-6,TRBJ1-2,CASSLIGDYGYTF,4,0,1,4
TRBV29-1,TRBJ2-3,CSVDDGSTDTQYF,5,5,2,10
TRBV7-2,TRBJ2-1,CASSVGGPEQFF,4,0,1,4
TRBV5-1,TRBJ2-2,CATRTDTGELFF,1,0,1,1
TRBV5-6,TRBJ2-1,CASSLLTSGDYNEQFF,3,3,2,6
TRBV7-2,TRBJ2-3,CASSLVVRPSTDTQYF,1,0,1,1
TRBV20-1,TRBJ2-5,CSATRSQMFGAQYF,1,0,1,1
TRBV27,TRBJ2-1,CASSSRNNEQFF,1,0,1,1
TRBV4-1,TRBJ1-3,CASSQEIFAGTGGNTIYF,1,0,1,1
TRBV5-1,TRBJ1-2,CASSLDINYGYTF,1,0,1,1
TRBV27,TRBJ2-6,CASSQGQVYIRAGANVLTF,2,0,1,2
TRBV13,TRBJ2-3,CASSIRRVDPADTQYF,1,0,1,1
TRBV11-2,TRBJ2-1,CASSPPEDLIMGEQFF,3,3,2,6
TRBV2,TRBJ2-3,CASSGDPAGNTDTQYF,2,1,2,3
TRBV12-3/4,TRBJ1-6,CASSRGQGSFSPLHF,1,0,1,1
TRBV12-3/4,TRBJ2-1,CASRFRGIDNEQFF,1,0,1,1
TRBV7-2,TRBJ2-4,CASSQRTGDIQYF,3,5,2,8
TRBV29-1,TRBJ2-3,CSPTSTDTQYF,1,0,1,1
TRBV10-3,TRBJ2-7,CAISLTSAFYEQYF,1,0,1,1
TRBV12-3/4,TRBJ2-7,CASSPPVPPRRQYF,1,0,1,1
TRBV9,TRBJ1-2,CASSVGGRSYGYTF,1,0,1,1
TRBV29-1,TRBJ2-1,CSVYRPSSYNEQFF,1,0,1,1
TRBV25-1,TRBJ1-1,CASSVQGGTEAFF,1,0,1,1
TRBV14,TRBJ1-1,CASSQSPRTEAFF,3,0,1,3
TRBV12-3/4,TRBJ2-2,CASSHLSSGRLMNTGELFF,2,1,2,3
TRBV12-3/4,TRBJ1-5,CASSFRGAGSNQPQHF,2,3,2,5
TRBV29-1,TRBJ2-3,CSVWGAWGANSGMQYF,1,0,1,1
TRBV12-3/4,TRBJ2-7,CASSYLAGSSYEQYF,2,0,1,2
TRBV6-1,TRBJ1-5,CASSVRTGVSQPQHF,1,0,1,1
TRBV5-4,TRBJ2-5,CASSLRGTLKETQYF,3,2,2,5
TRBV27,TRBJ1-5,CASSLFYSNQPQHF,4,1,2,5
TRBV5-1,TRBJ2-7,CASSLRQRGYEQYF,1,0,1,1
TRBV7-8,TRBJ2-7,CASSSGTEEQYF,4,3,2,7
TRBV12-3/4,TRBJ1-2,CASSPESGYTF,4,2,2,6
TRBV5-1,TRBJ2-5,CASSLVSPLAGPQETQYF,3,2,2,5
TRBV18,TRBJ2-1,CASSTSPSGEMRNEQFF,1,0,1,1
TRBV20-1,TRBJ2-6,CSATLGTSGGGANVLTF,2,1,2,3
TRBV7-3,TRBJ2-3,CASSPLAAGLDTQYS,1,0,1,1
TRBV2,TRBJ2-1,CASSAERGSYNEQFF,2,0,1,2
TRBV5-1,TRBJ2-1,CASSSDERGYNEQFF,1,0,1,1
TRBV20-1,TRBJ1-6,CSARVDGQGDSPLHF,1,0,1,1
TRBV12-3/4,TRBJ1-2,CASTPEDGNYGYTF,4,4,2,8
TRBV6-2/3/5/6,TRBJ2-7,CASSSRDFSYEQYF,2,0,1,2
TRBV2,TRBJ1-1,CASSEALMGTEAFF,1,0,1,1
TRBV7-2,TRBJ2-2,CASSFNRGTGELFF,4,0,1,4
TRBV5-5,TRBJ2-7,CASSAMGGYEQYF,1,0,1,1
TRBV29-1,TRBJ1-1,CSGRGVGNTEAFF,1,0,1,1
TRBV5-6,TRBJ2-7,CASSLSANEQYF,2,1,2,3
TRBV29-1,TRBJ2-4,CSVGDRGGIQYF,3,0,1,3
TRBV29-1,TRBJ1-1,CSAGQNTEAFF,1,0,1,1
TRBV3-1,TRBJ2-3,CASSQDLLAEYTDTQYF,3,8,2,11
TRBV2,TRBJ2-7,CASSEGRGLNYEQYF,1,0,1,1
TRBV12-5,TRBJ1-5,CASGPGQAVNQPQHF,1,3,2,4
TRBV27,TRBJ2-3,CASKFGGLVGPLAQYF,1,0,1,1
TRBV4-2,TRBJ2-3,CASSQTGIQGHTQYF,1,0,1,1
TRBV15,TRBJ1-1,CATSRDTTGGRVNTEAFF,2,1,2,3
TRBV12-3/4,TRBJ2-1,CASRTGASHEQFF,1,0,1,1
TRBV6-2/3/5/6,TRBJ2-7,CASRVGRGTFSSYEQYF,1,0,1,1
TRBV27,TRBJ2-1,CASSLRWETAYNEQFF,1,0,1,1
TRBV12-3/4,TRBJ2-2,CASSLRGPNTGELFF,1,0,1,1
TRBV6-2/3/5/6,TRBJ2-4,CASSPPPEAKNIQYF,1,0,1,1
TRBV7-6,TRBJ2-1,CASSGSRDGFREQFF,1,0,1,1
TRBV20-1,TRBJ2-7,CSARDGTGGSYGQYF,1,0,1,1
TRBV10-3,TRBJ1-1,CAISVRDRDTEAFF,1,0,1,1
TRBV5-6,TRBJ2-7,CASSWGQGSYEQYF,1,0,1,1
TRBV13,TRBJ1-2,CASSPGAANYGYTF,1,0,1,1
TRBV3-1,TRBJ1-1,CASSPATTISEAFF,1,0,1,1
TRBV7-9,TRBJ1-1,CASSLDTNTEAFF,2,0,1,2
TRBV11-1,TRBJ1-1,CASSATENTEAFF,1,1,2,2
TRBV20-1,TRBJ1-2,CSALRVAYGYTF,4,0,1,4
TRBV20-1,TRBJ2-7,CSARDQQGASSGDNYEQYF,3,2,2,5
TRBV29-1,TRBJ2-1,CSVEKTSGTTSEQFF,1,0,1,1
TRBV7-2,TRBJ1-5,CACSFGTGDGQPQHF,1,0,1,1
TRBV10-3,TRBJ2-1,CAISEPGTARGSYNEQFF,1,0,1,1
TRBV12-3/4,TRBJ2-1,CASSLGARTRDYNEQFF,1,0,1,1
TRBV11-2,TRBJ2-3,CASSQSVGRPTTDTQYF,1,0,1,1
TRBV11-2,TRBJ1-6,CASSLNYESYNSPLHF,1,0,1,1
TRBV5-6,TRBJ2-7,CASSEFTAGGIYEQYF,3,2,2,5
TRBV27,TRBJ2-1,CATRTGEGSYNEQFF,3,1,2,4
TRBV12-3/4,TRBJ2-4,CASSLVKQGGNIQYF,4,0,1,4
TRBV7-3,TRBJ2-5,CASSQTPGGPETQYF,1,0,1,1
TRBV9,TRBJ2-7,CASSVGVSNSYEQYF,3,2,2,5
TRBV2,TRBJ2-3,CASSAGTSRTDTQYF,1,0,1,1
TRBV7-2,TRBJ2-1,CASSAGGLNYNEQFF,1,0,1,1
TRBV29-1,TRBJ2-3,CSVEEGGMSTDTQYF,4,0,1,4
TRBV19,TRBJ1-1,CATRAPTGRTEAFF,1,0,1,1
TRBV19,TRBJ1-5,CASSSTGTNQPQHF,1,0,1,1
TRBV19,TRBJ1-1,CASSMRGFATEAFF,1,0,1,1
TRBV12-3/4,TRBJ1-1,CASSRRELNTEAFF,1,1,2,2
TRBV6-2/3/5/6,TRBJ1-4,CASSRGSTNEKLFF,2,1,2,3
TRBV7-2,TRBJ2-5,CASSRGHTQETQYF,1,0,1,1
TRBV12-3/4,TRBJ1-2,CASSGDRERYGYTF,2,0,1,2
TRBV7-9,TRBJ2-7,CASSLGTSVREQYF,1,0,1,1
TRBV29-1,TRBJ1-2,CSVEDKPGGNGYTF,1,0,1,1
TRBV29-1,TRBJ2-7,CSVTVQGRSYEQYF,2,0,1,2
TRBV12-3/4,TRBJ1-4,CASQRTGREKLFF,1,0,1,1
TRBV28,TRBJ1-5,CASSPDMDQPQHF,1,0,1,1
TRBV2,TRBJ1-2,CARGDSENYGYTF,2,0,1,2
TRBV5-1,TRBJ1-1,CASSSGQHTEAFF,1,0,1,1
TRBV20-1,TRBJ2-1,CSAQSSGQGEQFF,1,0,1,1
TRBV29-1,TRBJ2-1,CSVSEFTYNEQFF,1,0,1,1
TRBV29-1,TRBJ2-2,CSVEVLGLAGGPGELFF,1,0,1,1
TRBV12-3/4,TRBJ2-1,CASSHTSGGPWGEQFF,1,0,1,1
TRBV5-5,TRBJ1-4,CASSPHSRATNEKLFF,1,0,1,1
TRBV20-1,TRBJ1-6,CSARDGTVSTRTPLHF,1,0,1,1
TRBV20-1,TRBJ2-2,CSARKFLEENTGELFF,1,0,1,1
TRBV3-1,TRBJ1-5,CASSPGTMGNQPQHF,1,0,1,1
TRBV7-9,TRBJ1-4,CASSHRTGFYEKLFF,4,2,2,6
TRBV9,TRBJ2-7,CASSVGTSGGYEQYF,3,1,2,4
TRBV7-2,TRBJ2-3,CASSILAGRTDTQYF,3,0,1,3
TRBV5-1,TRBJ1-1,CASSPRAGGNTEAFF,1,0,1,1
TRBV29-1,TRBJ2-1,CSVDPLLGSYNEQFF,1,0,1,1
TRBV19,TRBJ2-1,CASSLNPRDGEQFF,2,1,2,3
TRBV12-3/4,TRBJ1-1,CASSGKGANTEAFF,1,0,1,1
TRBV7-2,TRBJ2-5,CASSSEDRLETQYF,1,0,1,1
TRBV5-6,TRBJ1-5,CASSLRTLHQPQHF,1,0,1,1
TRBV4-3,TRBJ2-5,CASSHRDLGETQYF,2,1,2,3
TRBV20-1,TRBJ1-1,CSVKGHSADTEAFF,1,0,1,1
TRBV27,TRBJ2-1,CASRQPDDNEQFF,1,1,2,2
TRBV29-1,TRBJ2-1,CSVGFLLDPEQFF,2,3,2,5
TRBV29-1,TRBJ1-4,CSVENRRGEKLFF,1,0,1,1
TRBV29-1,TRBJ2-1,CSAEREDNNEQFF,1,0,1,1
TRBV3-1,TRBJ2-1,CATKDRGLEQFF,1,2,2,3
TRBV5-1,TRBJ2-7,CASSEAYEQYF,2,0,1,2
TRBV4-2,TRBJ1-1,CASSQDARGPGNTEAFF,1,0,1,1
TRBV29-1,TRBJ1-4,CSVEEFPGEATNEKLFF,1,0,1,1
TRBV6-2/3/5/6,TRBJ2-1,CASNPIPTPSGRGSYNEQFF,2,0,1,2
TRBV2,TRBJ1-4,CATRAGGGETTNEKLFF,2,0,1,2
TRBV24-1,TRBJ1-5,CATSDDEILVDNQPQHF,1,0,1,1
TRBV2,TRBJ2-7,CASSEAHTGKPLNEQYF,2,1,2,3
TRBV20-1,TRBJ2-5,CSARASGGGGLGETQYF,1,0,1,1
TRBV12-3/4,TRBJ2-1,CASSFLAGGPGNEQFF,1,0,1,1
TRBV6-2/3/5/6,TRBJ2-5,CASSQGLTSGKETQYF,4,0,1,4
TRBV5-6,TRBJ1-1,CASSLAWGALWTEAFF,1,0,1,1
TRBV29-1,TRBJ2-1,CSVEGAQLLSYNEQFF,1,0,1,1
TRBV12-5,TRBJ1-5,CASSLGGALNQPQHF,1,1,2,2
TRBV7-2,TRBJ2-1,CATSIGVGKYNEQFF,3,0,1,3
TRBV19,TRBJ2-1,CASSIRLGDYNEQFF,1,0,1,1
TRBV6-2/3/5/6,TRBJ2-3,CASSLGDSETDTQYF,1,0,1,1
TRBV6-1,TRBJ1-5,CASSERTPSRVTQHF,2,0,1,2
TRBV3-1,TRBJ2-3,CASSSQGGGADTQYF,1,0,1,1
TRBV7-2,TRBJ2-1,CASSYSAGAYNEQFF,1,0,1,1
TRBV29-1,TRBJ2-2,CSVQGQGAGTGELFF,1,0,1,1
TRBV19,TRBJ1-2,CASSIPDKNYGYTF,1,0,1,1
TRBV19,TRBJ1-5,CASRGQGFNQPQHF,1,0,1,1
TRBV12-3/4,TRBJ1-5,CASSLADSNQPQHF,1,0,1,1
TRBV2,TRBJ1-2,CASSDMVHVYGYTF,2,0,1,2
TRBV5-4,TRBJ2-5,CASSPTEYQETQYF,1,0,1,1
TRBV27,TRBJ1-6,CASRQGVDNSPLHF,1,0,1,1
TRBV5-1,TRBJ2-1,CASSLVPGAHEQFF,4,0,1,4
TRBV5-1,TRBJ1-4,CASSLDSSNEKLFF,1,0,1,1
TRBV29-1,TRBJ1-3,CSVAQTGSGNTIYF,2,0,1,2
TRBV29-1,TRBJ2-1,CSVDRGKSYNEQFF,2,0,1,2
TRBV29-1,TRBJ1-1,CSATQGRANTEAFF,2,0,1,2
TRBV18,TRBJ1-5,CATTEGVNQPQHF,1,0,1,1
TRBV7-2,TRBJ1-4,CASSFGTGEKLFF,1,1,2,2
TRBV7-2,TRBJ1-1,CASSLFAEVEAFF,1,0,1,1
TRBV7-3,TRBJ1-1,CASSLTYDSEAFF,1,0,1,1
TRBV29-1,TRBJ2-7,CSVERTGGYEQYF,1,1,2,2
TRBV5-6,TRBJ2-7,CASSFIRSEQYF,1,0,1,1
TRBV7-2,TRBJ1-1,CASSLRLGQAFF,2,0,1,2
TRBV7-6,TRBJ1-1,CASSPFSDEAFF,3,4,2,7
TRBV3-1,TRBJ1-1,CASSHSSSGAFF,1,0,1,1
TRBV6-4,TRBJ2-1,CASSAYNEQFF,3,5,2,8
TRBV9,TRBJ2-1,CASSTPDEQFF,2,0,1,2
TRBV27,TRBJ1-1,CASCFLSGGTEAFF,1,0,1,1
TRBV20-1,TRBJ1-5,CSARKIRRDRGNHQPQHF,2,1,2,3
TRBV6-1,TRBJ2-2,CASSGRTSGGYTGELFF,3,3,2,6
TRBV18,TRBJ2-5,CASSPLARGRAETQYF,1,0,1,1
TRBV28,TRBJ2-5,CASSFHRTGGTETQYF,2,2,2,4
TRBV11-1,TRBJ2-1,CASSYPPRGSYNEQFF,2,0,1,2
TRBV7-8,TRBJ2-3,CASSPEGDWGTDTQYF,2,2,2,4
TRBV4-2,TRBJ2-1,CASSQPGQGTYNEQFF,3,3,2,6
TRBV2,TRBJ2-5,CASNRAGGNGQETQYF,2,0,1,2
TRBV20-1,TRBJ2-1,CSATSRGGISYNEQFF,3,2,2,5
TRBV19,TRBJ1-2,CASSTGGTETNGYTF,1,0,1,1
TRBV19,TRBJ2-7,CASSTGLNPLYEQYF,1,0,1,1
TRBV6-2/3/5/6,TRBJ2-7,CASSYLRQGPEEQYF,1,0,1,1
TRBV12-3/4,TRBJ2-5,CASSLRGTGVETQYF,1,0,1,1
TRBV12-3/4,TRBJ2-7,CASSPVSGRTYEQYF,1,0,1,1
TRBV7-6,TRBJ1-4,CASSLEGRTNEKLFF,1,0,1,1
TRBV4-2,TRBJ2-7,CASSQAFSASYEQYF,1,3,2,4
TRBV6-2/3/5/6,TRBJ2-5,CASSNYRGRRETQYF,2,0,1,2
TRBV4-1,TRBJ2-7,CASSLSGGPSYEQYF,1,0,1,1
TRBV20-1,TRBJ2-3,CSAGGDSVITDTQYF,1,0,1,1
TRBV29-1,TRBJ2-5,CSVALRLAVGETQYF,4,1,2,5
TRBV30,TRBJ1-1,CAWSAGQLNTEAFF,4,2,2,6
TRBV19,TRBJ2-7,CASTLSALSYEQYF,1,0,1,1
TRBV19,TRBJ1-5,CASSPDRGNQPQHF,1,0,1,1
TRBV18,TRBJ1-3,CASSLPGTGNTIYF,1,0,1,1
TRBV12-3/4,TRBJ1-1,CASEISGGETEAFF,1,0,1,1
TRBV6-2/3/5/6,TRBJ1-1,CASSIQGGNTEAFF,1,0,1,1
TRBV4-2,TRBJ1-1,CASSYAGSATEAFF,1,0,1,1
TRBV7-6,TRBJ1-1,CASSPLQEGTEAFF,1,0,1,1
TRBV28,TRBJ2-1,CASSGTGVSDEQFF,2,0,1,2
TRBV4-1,TRBJ1-4,CASRKTATNEKLFF,2,0,1,2
TRBV20-1,TRBJ2-1,CSASWQSSYNEQFF,2,2,2,4
TRBV20-1,TRBJ2-5,CSARDREGLETQYF,1,0,1,1
TRBV12-3/4,TRBJ2-6,CAIGTAGANVLTF,1,0,1,1
TRBV5-4,TRBJ1-1,CASSFRGNTEAFF,2,1,2,3
TRBV27,TRBJ1-1,CASSLQGTEAFF,2,0,1,2
TRBV7-2,TRBJ2-7,CASSLGHYEQYF,1,0,1,1
TRBV13,TRBJ2-1,CASSLRVNEQFF,1,0,1,1
TRBV2,TRBJ2-2,CASRKEPGELFF,1,0,1,1
TRBV5-1,TRBJ2-3,CASSLGEDTQYF,1,0,1,1
TRBV29-1,TRBJ1-5,CSVGHPNQPQHF,1,0,1,1
TRBV29-1,TRBJ2-1,CSVERTGGEQFF,2,0,1,2
TRBV19,TRBJ1-1,CASSTGGEAFF,1,0,1,1
TRBV6-4,TRBJ2-1,CASSDQGQVFF,1,0,1,1
TRBV7-7,TRBJ1-2,CASSLAGFRGFAPNYGYTF,1,1,2,2
TRBV4-1,TRBJ1-5,CASSQGAQVLDQPQHF,1,0,1,1
TRBV19,TRBJ2-7,CASSTAGTGGYEQYF,1,0,1,1
TRBV10-3,TRBJ1-6,CAISDGSHNSPLHF,1,0,1,1
TRBV5-1,TRBJ1-1,CASSLDDRAEAFF,1,1,2,2
TRBV20-1,TRBJ1-1,CSAPPLDLDQNTEAFF,1,0,1,1
TRBV5-4,TRBJ2-2,CACGATPNTGELFF,1,0,1,1
TRBV6-1,TRBJ1-1,CASSEAMGATEAFF,2,0,1,2
TRBV2,TRBJ2-1,CASTGLASYNEQFF,1,0,1,1
TRBV19,TRBJ1-1,CASSIDTGENTEAFF,1,2,2,3
TRBV20-1,TRBJ1-5,CSAMLGRGESQPQHF,1,5,2,6
TRBV5-1,TRBJ2-2,CASSLQPGAAGNTGELFF,1,0,1,1
TRBV4-1,TRBJ2-1,CASSRGLAGRSSYNEQFF,1,0,1,1
TRBV20-1,TRBJ2-1,CSARDRRTSGGLYNEQFF,1,0,1,1
TRBV29-1,TRBJ2-6,CSVSVRDRGLPGANVLTF,2,0,1,2
TRBV6-2/3/5/6,TRBJ1-5,CASSLGFRWGSNQPQHF,1,0,1,1
TRBV6-2/3/5/6,TRBJ2-1,CASSLSGGIRRDDEQFF,3,0,1,3
TRBV6-2/3/5/6,TRBJ1-4,CASSSAPPQATNEKLFF,1,0,1,1
TRBV6-2/3/5/6,TRBJ1-3,CASSYFGGNPSGNTIYF,1,0,1,1
TRBV3-1,TRBJ2-3,CASSQDRRGSSTDTQYF,1,0,1,1
TRBV4-3,TRBJ2-3,CASSQDGTSGSTDTQYF,1,0,1,1
TRBV15,TRBJ2-5,CATSHGLAEIQETQYF,1,0,1,1
TRBV19,TRBJ2-1,CASSLLAGGLANEQFF,1,0,1,1
TRBV27,TRBJ1-2,CASSLFPGQLTYGYTF,1,0,1,1
TRBV2,TRBJ1-2,CASSERTGGSIYGYTF,1,0,1,1
TRBV5-6,TRBJ1-1,CASSLESDSLGTEAFF,1,0,1,1
TRBV7-9,TRBJ2-2,CASSLSPPQDTGELFF,1,1,2,2
TRBV7-2,TRBJ2-1,CASSLLAGGHYNEQFF,1,0,1,1
TRBV3-1,TRBJ2-1,CASSQRTSGLYNEQFF,1,0,1,1
TRBV9,TRBJ2-2,CASSEERGPGGGELFF,2,1,2,3
TRBV2,TRBJ1-5,CASKGQGGYSNQPQHF,1,0,1,1
TRBV20-1,TRBJ1-2,CSARDIAWGQSYGYTF,1,0,1,1
TRBV29-1,TRBJ1-3,CSVSTATSFSGNTIYF,1,0,1,1
TRBV19,TRBJ2-3,CASSIVDGGTDTQYF,1,0,1,1
TRBV28,TRBJ2-7,CASSLATGGEYEQYF,2,1,2,3
TRBV5-4,TRBJ2-3,CASSLGGVDTDTQYF,1,0,1,1
TRBV27,TRBJ2-1,CASSLGLVGYNEQFF,1,0,1,1
TRBV7-9,TRBJ1-4,CASSLRDVLGEKLFF,1,0,1,1
TRBV7-2,TRBJ1-1,CASSLLPQGATEAFF,2,0,1,2
TRBV6-2/3/5/6,TRBJ2-6,CASSQATRGANVLTF,2,0,1,2
TRBV12-3/4,TRBJ2-5,CASSQTGLAKETQYF,1,0,1,1
TRBV5-6,TRBJ2-1,CASNPGTQGGNEQFF,2,0,1,2
TRBV5-1,TRBJ2-7,CASSLDGAWVGEQYF,1,0,1,1
TRBV4-1,TRBJ1-5,CASSQDPGSNQPQHF,1,2,2,3
TRBV20-1,TRBJ1-1,CSARVRDRGDTEAFF,1,0,1,1
TRBV29-1,TRBJ2-7,CSVEEGIGTTYEQYF,1,0,1,1
TRBV18,TRBJ1-1,CASSPGGLDTEAFF,1,0,1,1
TRBV12-3/4,TRBJ1-2,CASSLSGGAYGYTF,1,0,1,1
TRBV12-3/4,TRBJ2-7,CASSQTGTGNEQYF,2,0,1,2
TRBV12-3/4,TRBJ1-5,CASSQSYSNQPQHF,1,0,1,1
TRBV7-8,TRBJ2-1,CASSLTGDYNEQFF,2,4,2,6
TRBV7-9,TRBJ1-5,CASSPGQGFQPQHF,1,0,1,1
TRBV3-1,TRBJ1-2,CASSQGTGGHGYTF,1,0,1,1
TRBV7-2,TRBJ1-1,CASSQTDRVTEAFF,1,0,1,1
TRBV9,TRBJ1-6,CASSGRDRGSPLHF,1,0,1,1
TRBV12-3/4,TRBJ2-1,CASRGQGWLDEQFF,2,0,1,2
TRBV5-1,TRBJ2-2,CASSVTGDTGELFF,1,0,1,1
TRBV20-1,TRBJ2-3,CSARESSGSDTQYF,1,0,1,1
TRBV20-1,TRBJ2-7,CSARVSGRTYEQYF,1,1,2,2
TRBV29-1,TRBJ1-1,CSVAGFVEDTEAFF,1,0,1,1
TRBV29-1,TRBJ2-1,CSVAGTPLGDEQFF,2,0,1,2
TRBV29-1,TRBJ1-3,CSVARDGDGNTIYF,1,0,1,1
TRBV15,TRBJ2-1,CATSRVTGNEQFF,3,1,2,4
TRBV2,TRBJ1-1,CASSEGPVTEAFF,1,0,1,1
TRBV9,TRBJ2-2,CASSSTRSGELFF,1,0,1,1
TRBV6-2/3/5/6,TRBJ2-1,CASRKGMENEQFF,1,0,1,1
TRBV10-2,TRBJ1-4,CASRNATNEKLFF,1,0,1,1
TRBV5-1,TRBJ1-1,CASSFVGDTEAFF,1,0,1,1
TRBV29-1,TRBJ1-1,CSVVREGGTEAFF,1,0,1,1
TRBV29-1,TRBJ2-1,CSVGDRGWNEQFF,1,0,1,1
TRBV29-1,TRBJ1-2,CSVEYQENYGYTF,1,0,1,1
TRBV29-1,TRBJ1-5,CSVQQGGNQPQHF,1,0,1,1
TRBV6-2/3/5/6,TRBJ1-1,CASSYWTREAFF,1,0,1,1
TRBV7-9,TRBJ2-7,CASSLAFYEQYF,1,0,1,1
TRBV9,TRBJ1-2,CASSPGTEGYTF,3,8,2,11
TRBV3-1,TRBJ2-2,CASSQNFGELFF,1,0,1,1
TRBV20-1,TRBJ1-5,CSARRGDQPQHF,1,0,1,1
TRBV20-1,TRBJ2-3,CSAPHSTDTQYF,2,0,1,2
TRBV29-1,TRBJ2-3,CSVEWITDTQYF,1,0,1,1
TRBV12-3/4,TRBJ2-5,CASWGGETQYF,2,0,1,2
TRBV12-3/4,TRBJ2-5,CASRGETQYF,1,0,1,1
TRBV9,TRBJ1-5,CASSDGQQPQHF,1,0,1,1
TRBV12-5,TRBJ2-4,CASALGTGEAKNIQYF,1,0,1,1
TRBV20-1,TRBJ2-2,CSARLRIRGTYGTGELFF,1,0,1,1
TRBV29-1,TRBJ1-6,CSVDPGLGGPLHF,1,0,1,1
TRBV12-3/4,TRBJ2-5,CASSFGPSPYQETQYF,1,0,1,1
TRBV7-7,TRBJ2-2,CASSLANTGELFF,1,0,1,1
TRBV9,TRBJ2-7,CASSVGQGTYEQYF,1,0,1,1
TRBV3-1,TRBJ2-1,CASSGLSSYNEQFF,1,0,1,1
TRBV29-1,TRBJ2-7,CSVRGRENYEQYF,1,0,1,1
TRBV3-1,TRBJ1-4,CASSQDEGLLNNEKLFF,1,0,1,1
TRBV4-1,TRBJ2-2,CASSQVRVSTGELFF,2,0,1,2
TRBV24-1,TRBJ2-2,CATSEQGSTGELFF,1,0,1,1
TRBV14,TRBJ2-7,CASAPARGYYEQYF,1,0,1,1
TRBV7-3,TRBJ1-2,CASSPTRGGGYTF,1,0,1,1
TRBV28,TRBJ1-2,CASSGGSYGYTF,1,0,1,1
TRBV29-1,TRBJ1-1,CSASPRNTEAFF,1,0,1,1
TRBV12-5,TRBJ2-2,CASGLTVGVHATGELFF,1,0,1,1
TRBV6-2/3/5/6,TRBJ2-3,CASSASGSGLSTDTQYF,1,0,1,1
TRBV7-2,TRBJ2-4,CASSLVLTGGSKNIQYF,1,0,1,1
TRBV5-4,TRBJ1-1,CASSPQTRGGHQGEAFF,1,0,1,1
TRBV5-1,TRBJ2-1,CASSLMRGGKTSHEQFF,1,0,1,1
TRBV20-1,TRBJ1-5,CSARDERGRGYNQPQHF,2,0,1,2
TRBV18,TRBJ2-1,CASSPIDVLGYNEQFF,1,0,1,1
TRBV6-2/3/5/6,TRBJ2-1,CASSYSQKSSYNEQFF,1,0,1,1
TRBV12-3/4,TRBJ1-5,CASSQRQGRGNQPQHF,1,0,1,1
TRBV6-1,TRBJ2-1,CASSEFGPALGNEQFF,1,0,1,1
TRBV11-1,TRBJ2-1,CASSLGLAGAYNEQFF,1,0,1,1
TRBV5-6,TRBJ1-1,CASSLGATGLNTEAFF,1,1,2,2
TRBV3-1,TRBJ1-2,CASSPLSRGPEYGYTF,1,0,1,1
TRBV2,TRBJ2-1,CARELKGAQSRDEQFF,2,0,1,2
TRBV5-1,TRBJ1-1,CASSLDLVNPNTEAFF,1,0,1,1
TRBV5-1,TRBJ2-1,CASSLYPPPSYNEQFF,1,0,1,1
TRBV5-1,TRBJ1-6,CASSPGIQGGNSPLHF,1,0,1,1
TRBV5-1,TRBJ2-7,CASSDGIRVTGYEQYF,1,0,1,1
TRBV29-1,TRBJ1-2,CSVTPGRTPSGYGYTF,1,1,2,2
TRBV18,TRBJ1-1,CASSPPDRRNTEAFF,1,0,1,1
TRBV3-1,TRBJ1-2,CASTPDSPPAGGYTF,1,0,1,1
TRBV2,TRBJ1-1,CASTSPSTGNTEAFF,1,0,1,1
TRBV12-3/4,TRBJ2-1,CASSFVGQVNNEQFF,1,0,1,1
TRBV12-3/4,TRBJ2-2,CASSLGRAKAGELFF,1,0,1,1
TRBV12-3/4,TRBJ2-1,CASSLGGAGDGEQFF,1,0,1,1
TRBV12-3/4,TRBJ2-1,CASSLMGQGRNEQFF,1,0,1,1
TRBV12-3/4,TRBJ2-7,CASSSRGGSLYEQYF,1,0,1,1
TRBV6-2/3/5/6,TRBJ1-5,CASSWDGRSNQPQHF,1,0,1,1
TRBV12-3/4,TRBJ2-5,CASSWSFGEGETQYF,1,0,1,1
TRBV5-6,TRBJ1-2,CASSLAPSVGYGYTF,1,0,1,1
TRBV11-2,TRBJ1-2,CASSSRGTGVGSYTF,1,0,1,1
TRBV3-1,TRBJ1-2,CASSHNDSPGHGYTF,1,0,1,1
TRBV9,TRBJ2-1,CASSQKGDPYNEQFF,2,0,1,2
TRBV7-6,TRBJ2-5,CASSTGLAGTETQYF,1,0,1,1
TRBV12-3/4,TRBJ2-1,CASRAGQSSYNEQFF,1,0,1,1
TRBV4-1,TRBJ2-5,CASSQVGVGMETQYF,1,0,1,1
TRBV4-3,TRBJ2-1,CASSQDRTGDNEQFF,1,0,1,1
TRBV29-1,TRBJ2-4,CSVEGWGQGKNIQYF,1,0,1,1
TRBV29-1,TRBJ2-7,CSVEGWGQGADEQYF,2,0,1,2
TRBV12-5,TRBJ2-5,CASGLGGYQETQYF,2,0,1,2
TRBV30,TRBJ2-7,CAWNGRDSHYEQYF,2,1,2,3
TRBV19,TRBJ1-2,CASSARTGDYGYTF,1,0,1,1
TRBV2,TRBJ2-3,CASTRDRGTDAQYF,1,0,1,1
TRBV28,TRBJ1-5,CASSFAGITWPQHF,1,0,1,1
TRBV6-1,TRBJ2-3,CASSEGQGGDTQYF,3,0,1,3
TRBV2,TRBJ2-6,CASSERSGANVLTF,1,0,1,1
TRBV7-9,TRBJ1-5,CASSFTGANQPQHF,1,0,1,1
TRBV7-9,TRBJ2-1,CASSFSGTGNEQFF,2,0,1,2
TRBV7-2,TRBJ2-1,CASSLPNSYNEQFF,1,0,1,1
TRBV5-4,TRBJ2-3,CASSRGRHADTQYF,1,0,1,1
TRBV7-2,TRBJ1-5,CASSADSSNQPQHF,1,0,1,1
TRBV6-2/3/5/6,TRBJ1-1,CASKPRDMNTEAFF,1,0,1,1
TRBV20-1,TRBJ2-5,CSATKGQYQETQYF,1,0,1,1
TRBV20-1,TRBJ2-1,CSAPDRGHGNEQFF,1,0,1,1
TRBV12-5,TRBJ1-1,CASGFQGRAEAFF,1,0,1,1
TRBV12-5,TRBJ1-2,CASGSQGGGGYTF,1,0,1,1
TRBV10-3,TRBJ1-1,CAIAPQGYTEAFF,1,0,1,1
TRBV5-6,TRBJ2-2,CASTWGNTGELFF,1,0,1,1
TRBV6-2/3/5/6,TRBJ2-5,CASSLQSQETQYF,1,0,1,1
TRBV6-2/3/5/6,TRBJ1-1,CASSPSTNTEAFF,2,2,2,4
TRBV28,TRBJ2-3,CASSRGQADTQYF,1,0,1,1
TRBV5-6,TRBJ2-7,CASSLGAMFEQYF,1,0,1,1
TRBV13,TRBJ1-1,CASSLGLTGEAFF,1,0,1,1
TRBV14,TRBJ2-7,CASSQDPAYEQYF,2,0,1,2
TRBV9,TRBJ1-2,CASSAGQETSYTF,1,0,1,1
TRBV20-1,TRBJ2-5,CSVAPTSVETQYF,1,0,1,1
TRBV20-1,TRBJ2-1,CSAGNRPYNEQFF,3,7,2,10
TRBV20-1,TRBJ2-1,CSATGTSYNEQFF,1,0,1,1
TRBV20-1,TRBJ2-7,CSARGGRDYEQYF,1,0,1,1
TRBV20-1,TRBJ2-3,CSAREGSTDTQYF,1,0,1,1
TRBV20-1,TRBJ2-3,CSARSRGIDTQYF,1,0,1,1
TRBV30,TRBJ2-7,CAWGTVSYEQYF,1,0,1,1
TRBV19,TRBJ1-2,CASTAANYGYTF,1,0,1,1
TRBV6-2/3/5/6,TRBJ1-1,CASSYDGTEAFF,1,5,2,6
TRBV5-5,TRBJ1-1,CASSFLTTEAFF,1,0,1,1
TRBV7-2,TRBJ2-7,CASSLGAYEQYF,1,0,1,1
TRBV5-4,TRBJ2-3,CASSPRTDTQYF,1,1,2,2
TRBV12-3/4,TRBJ1-3,CATRGRGNTIYF,2,0,1,2
TRBV29-1,TRBJ1-2,CSVEGPSYGYTF,1,0,1,1
TRBV29-1,TRBJ2-3,CSVGRVTDTQYF,1,0,1,1
TRBV2,TRBJ2-5,CASKSGETQYF,1,0,1,1
TRBV19,TRBJ2-2,CASRTAGELFF,1,0,1,1
TRBV7-2,TRBJ1-2,CASSRVLGYTF,1,0,1,1
TRBV11-2,TRBJ2-1,CASIHSGSSYNEQFF,1,0,1,1
TRBV12-3/4,TRBJ1-3,CASSFRKTLSGNTIYF,1,36,2,37
TRBV5-6,TRBJ2-7,CASSQTLAGGPVTYEQYF,1,1,2,2
TRBV7-9,TRBJ2-7,CASSLASGQFTYEQYF,1,0,1,1
TRBV6-2/3/5/6,TRBJ1-1,CASSPFPRDIYLNTEAFF,1,0,1,1
TRBV2,TRBJ2-5,CASSVAQTGGPYQETQYF,1,1,2,2
TRBV7-8,TRBJ2-1,CASSLSRLAKSSYNEQFF,1,0,1,1
TRBV5-4,TRBJ2-1,CASSIPTSGRAGYNEQFF,2,1,2,3
TRBV4-1,TRBJ2-1,CASSQDPAVGGSYNEQFF,1,0,1,1
TRBV5-1,TRBJ2-1,CASSSGTSGGAGTNEQFF,1,0,1,1
TRBV7-8,TRBJ2-5,CASSSRTSGVRQETQYF,3,2,2,5
TRBV7-2,TRBJ2-5,CASSPGGVGQARETQYF,3,0,1,3
TRBV20-1,TRBJ2-3,CSARDPSGGGSTDTQYF,2,0,1,2
TRBV20-1,TRBJ2-1,CSARDRFPGQGFNEQFF,1,0,1,1
TRBV20-1,TRBJ2-5,CSARDKWGTGSQETQYF,1,0,1,1
TRBV27,TRBJ2-6,CATRGRGLSGANVLTF,1,0,1,1
TRBV19,TRBJ1-5,CASSTSGTGNNQPQHF,1,0,1,1
TRBV2,TRBJ2-3,CASTSPLGGGPDTQYF,1,0,1,1
TRBV12-3/4,TRBJ2-5,CASSSKFSGDQETQYF,1,0,1,1
TRBV6-2/3/5/6,TRBJ2-2,CASSYSGGTNTGELFF,1,0,1,1
TRBV5-6,TRBJ1-1,CASSLYRGLPNTEAFF,1,0,1,1
TRBV7-2,TRBJ1-1,CASSSRPLGLNTEAFF,2,0,1,2
TRBV5-4,TRBJ1-3,CASSQDSTPSGNTIYF,1,0,1,1
TRBV3-1,TRBJ2-3,CASSQDLKGSTDTQYF,1,0,1,1
TRBV9,TRBJ1-6,CASSVARLPGISPLHF,1,0,1,1
TRBV7-9,TRBJ2-2,CASSAQRPQGTGELFF,2,1,2,3
TRBV7-8,TRBJ1-1,CASSKKGQGERTEAFF,1,0,1,1
TRBV29-1,TRBJ1-4,CSVEGTTTGDNEKLFF,1,0,1,1
TRBV12-5,TRBJ2-7,CASGLFGTGGYEQYF,1,0,1,1
TRBV30,TRBJ1-1,CAWRDRGLPNTEAFF,1,0,1,1
TRBV10-3,TRBJ2-1,CAIEGGAGGHNEQFF,1,0,1,1
TRBV10-3,TRBJ1-3,CAISESGNSGNTIYF,1,0,1,1
TRBV10-3,TRBJ1-4,CAISENRRTNEKLFF,1,0,1,1
TRBV10-3,TRBJ2-2,CAISLTLQGTGELFF,1,0,1,1
TRBV10-3,TRBJ1-2,CAISLTGSLFYGYTF,2,1,2,3
TRBV19,TRBJ2-1,CASSEDRDSYNEQFF,1,0,1,1
TRBV19,TRBJ2-1,CASSTPTSGYNEQFF,1,0,1,1
TRBV5-6,TRBJ1-1,CASSIVGGRHSEAFF,1,0,1,1
TRBV12-3/4,TRBJ1-6,CASTFTGTSNSPLHF,1,0,1,1
TRBV6-2/3/5/6,TRBJ1-1,CASSYKGQGNTEAFF,1,0,1,1
TRBV6-1,TRBJ1-5,CASSEPQGLNQPQHF,1,0,1,1
TRBV2,TRBJ2-3,CASSEGQPSTDTQYF,1,0,1,1
TRBV2,TRBJ2-7,CASSERGGASYEQYF,1,0,1,1
TRBV12-3/4,TRBJ2-1,CASSIRAGRTNEQFF,1,0,1,1
TRBV12-3/4,TRBJ2-5,CASSSGTGGWETQYF,1,0,1,1
TRBV5-4,TRBJ1-2,CASSLVVGRGYGYTF,1,0,1,1
TRBV5-4,TRBJ2-1,CASSLERGGFDEQFF,1,0,1,1
TRBV7-2,TRBJ2-5,CASSLVVGQQETQYF,1,0,1,1
TRBV7-2,TRBJ2-2,CASSLRQGNTGELFF,2,2,2,4
TRBV7-6,TRBJ1-6,CASSLKTASNSPLHF,1,0,1,1
TRBV7-6,TRBJ2-7,CASSSLDRTRGEQYF,1,0,1,1
TRBV7-9,TRBJ2-1,CASSLDSSSYNEQFF,1,0,1,1
TRBV5-8,TRBJ1-1,CASSPGQGWNTEAFF,1,0,1,1
TRBV4-2,TRBJ2-7,CASSQETGARREQYF,1,0,1,1
TRBV3-1,TRBJ1-2,CASSQELGEYYGYTF,1,0,1,1
TRBV5-8,TRBJ1-5,CASSKRQGGNQPQHF,1,0,1,1
TRBV5-1,TRBJ2-1,CASSFTGTGTVLQFF,2,1,2,3
TRBV5-1,TRBJ2-1,CASSLVLAGSNEQFF,1,0,1,1
TRBV5-1,TRBJ2-2,CASSRGLSDTGELFF,1,0,1,1
TRBV4-1,TRBJ1-6,CASSQEAVYNSPLHF,1,2,2,3
TRBV20-1,TRBJ1-1,CSAADRGPMNTEAFF,1,0,1,1
TRBV20-1,TRBJ2-3,CSATPGTGNTDTQYF,1,0,1,1
TRBV20-1,TRBJ1-4,CSARGRPGQDEKLFF,1,0,1,1
TRBV20-1,TRBJ1-4,CSARETHGYDEKLFF,1,0,1,1
TRBV20-1,TRBJ2-2,CSAPAPGGDSGELFF,2,0,1,2
TRBV29-1,TRBJ1-3,CSVVLRGSSGNTIYF,1,0,1,1
TRBV29-1,TRBJ2-3,CSVDLGASGTDTQYF,1,0,1,1
TRBV29-1,TRBJ2-1,CSVEVAGGGYNEQFF,1,0,1,1
TRBV29-1,TRBJ1-3,CSVEDSVDSGNTIYF,1,0,1,1
TRBV29-1,TRBJ2-7,CSVEDWDRGPREQYF,1,0,1,1
TRBV29-1,TRBJ2-3,CSASATLTSTDTQYF,1,0,1,1
TRBV10-3,TRBJ2-2,CAINGAMGTGELFF,1,0,1,1
TRBV7-2,TRBJ2-7,CASSLLASSYEQYF,1,1,2,2
TRBV19,TRBJ2-5,CASSSQTSGETQYF,1,0,1,1
TRBV19,TRBJ1-5,CASSISWGVQPQHF,1,0,1,1
TRBV18,TRBJ1-1,CASSPGTGYTEAFF,2,0,1,2
TRBV18,TRBJ1-1,CASSPVLGYTEAFF,2,0,1,2
TRBV12-3/4,TRBJ2-5,CASSLARGQETQYF,1,0,1,1
TRBV6-2/3/5/6,TRBJ1-2,CASSLGQGVLGYTF,1,0,1,1
TRBV6-2/3/5/6,TRBJ1-5,CASSYMTGLEPQHF,2,1,2,3
TRBV12-3/4,TRBJ2-7,CASSPRGGRDEQYF,1,0,1,1
TRBV6-1,TRBJ1-1,CASSADGVNTEAFF,2,0,1,2
TRBV27,TRBJ2-3,CASSGTSPRDTQYF,2,0,1,2
TRBV11-1,TRBJ2-2,CASSLALAAGELFF,1,0,1,1
TRBV7-8,TRBJ1-4,CASSLGGTNEKLFF,1,0,1,1
TRBV7-9,TRBJ2-3,CASSPGGVTDTQYF,1,0,1,1
TRBV7-9,TRBJ2-1,CASSPIAGMGEQFF,1,0,1,1
TRBV4-2,TRBJ2-1,CASSHSGTYNEQFF,1,0,1,1
TRBV7-2,TRBJ1-5,CASSIVGGNQPQHF,1,0,1,1
TRBV5-1,TRBJ2-1,CASSWSDRYNEQFF,1,0,1,1
TRBV4-3,TRBJ1-5,CASSHYRDDQPQHF,1,0,1,1
TRBV5-1,TRBJ2-3,CASRRSSSTDTQYF,2,0,1,2
TRBV29-1,TRBJ1-5,CSVLAGGDNQPQHF,2,0,1,2
TRBV29-1,TRBJ2-1,CSVVAGQSYNEQFF,2,2,2,4
TRBV29-1,TRBJ2-7,CSVVKSSGSYEQYF,1,0,1,1
TRBV29-1,TRBJ2-7,CSVGKSQGDYEQYF,1,0,1,1
TRBV29-1,TRBJ2-5,CSVEDRTYQETQYF,1,0,1,1
TRBV29-1,TRBJ2-7,CSVEHGTGNYEQYF,1,0,1,1
TRBV29-1,TRBJ2-7,CSVTGRRSSYEQYF,1,0,1,1
TRBV10-3,TRBJ1-5,CAIRDRVAQPQHF,1,0,1,1
TRBV19,TRBJ2-7,CASSILGVPEQYF,1,0,1,1
TRBV7-2,TRBJ1-2,CASSLAGGYGYTF,1,0,1,1
TRBV18,TRBJ1-1,CASSPAAGAEAFF,2,1,2,3
TRBV28,TRBJ2-5,CASSFRDQETQYF,1,0,1,1
TRBV12-3/4,TRBJ2-2,CASSLSGAGELFF,1,0,1,1
TRBV27,TRBJ1-1,CASSWTVNTEAFF,1,0,1,1
TRBV6-2/3/5/6,TRBJ1-1,CASSYGPNTEAFF,1,2,2,3
TRBV6-2/3/5/6,TRBJ1-5,CASSYKENQPQHF,1,1,2,2
TRBV6-2/3/5/6,TRBJ1-2,CASSPDRSYGYTF,1,0,1,1
TRBV6-1,TRBJ2-7,CASSEMGGGEQYF,2,0,1,2
TRBV5-6,TRBJ2-1,CASSLPGTMGQFF,1,0,1,1
TRBV5-4,TRBJ1-1,CASSLSPNTEAFF,1,0,1,1
TRBV7-8,TRBJ1-1,CASSPDLDTEAFF,1,0,1,1
TRBV3-1,TRBJ1-4,CASSQMPNEKLFF,1,0,1,1
TRBV3-1,TRBJ2-7,CASSQWPPDEQYF,1,0,1,1
TRBV12-3/4,TRBJ1-2,CASSQGTANRYTF,1,0,1,1
TRBV3-1,TRBJ2-7,CASSQGRTYEQYF,2,1,2,3
TRBV9,TRBJ1-1,CASSVDGVTEAFF,1,0,1,1
TRBV7-2,TRBJ2-5,CASRPTGGETQYF,1,0,1,1
TRBV5-1,TRBJ1-4,CASSFTRDEKLFF,1,0,1,1
TRBV20-1,TRBJ1-6,CSASETSGSPLHF,1,0,1,1
TRBV29-1,TRBJ1-6,CSVAMREDSPLHF,1,0,1,1
TRBV29-1,TRBJ2-2,CSVDGPGRGELFF,1,0,1,1
TRBV29-1,TRBJ1-1,CSVEEGGNTEAFF,1,0,1,1
TRBV29-1,TRBJ1-1,CSVTGGIGTEAFF,1,0,1,1
TRBV29-1,TRBJ2-1,CSGGTSGWNEQFF,1,0,1,1
TRBV29-1,TRBJ2-2,CSTSTSGTGELFF,2,0,1,2
TRBV2,TRBJ2-5,CASDMRQETQYF,1,0,1,1
TRBV28,TRBJ2-7,CASSSGAYEQYF,1,0,1,1
TRBV6-2/3/5/6,TRBJ1-1,CASSHGTVEAFF,1,0,1,1
TRBV2,TRBJ2-7,CASSSDAYEQYF,1,0,1,1
TRBV7-9,TRBJ1-1,CASSFGNTEAFF,1,2,2,3
TRBV7-2,TRBJ2-5,CASSSVTWTQYF,2,0,1,2
TRBV28,TRBJ1-5,CASRSGNQPQHF,1,0,1,1
TRBV29-1,TRBJ2-5,CSVVRGEETQYF,1,0,1,1
TRBV12-5,TRBJ1-3,CASGTGNTIYF,1,0,1,1
TRBV12-3/4,TRBJ1-3,CASGQSGTIYF,1,0,1,1
TRBV20-1,TRBJ1-4,CSATRDEKLFF,1,0,1,1
TRBV29-1,TRBJ2-7,CSAVRGYEQYF,1,0,1,1
TRBV29-1,TRBJ1-3,CSGISGNTIYF,1,0,1,1
TRBV12-3/4,TRBJ2-3,CASRVDTQYF,1,0,1,1
TRBV29-1,TRBJ1-1,CSVQTGEAFF,1,0,1,1
TRBV2,TRBJ1-1,CASQYRGLNTEAFF,1,0,1,1
TRBV29-1,TRBJ2-5,CSVEETRLAYGETQYF,1,0,1,1
TRBV29-1,TRBJ1-2,CGAGVGADYGYTF,1,0,1,1
TRBV6-4,TRBJ2-1,CASSRLARKFYNEQFF,1,0,1,1
TRBV5-1,TRBJ2-5,CASGQETQYF,1,0,1,1
TRBV19,TRBJ2-6,CASSPRTGGTGANVLTF,1,1,2,2
TRBV6-2/3/5/6,TRBJ1-2,CASSPQGLGDYTF,1,0,1,1
TRBV7-9,TRBJ1-4,CASSPLDRGRPQNEKLFF,1,0,1,1
TRBV7-9,TRBJ2-3,CASSLGGTDTQYF,1,0,1,1
TRBV7-9,TRBJ1-2,CASSPRDNPISYGYTF,1,0,1,1
TRBV6-1,TRBJ1-2,CASSERLGLNYGYTF,1,0,1,1
TRBV12-3/4,TRBJ2-2,CASSQGIAGELFF,1,0,1,1
TRBV14,TRBJ1-1,CASSQVRGEAFF,1,0,1,1
TRBV29-1,TRBJ2-6,CSVSGLNQYSGANVLTF,1,0,1,1
TRBV5-1,TRBJ2-1,CASTSSPSGPYNEQFF,1,0,1,1
TRBV12-3/4,TRBJ2-3,CASSRQGAGTDTQYF,1,0,1,1
TRBV7-6,TRBJ2-7,CASSPKGKLREQYF,2,0,1,2
TRBV5-6,TRBJ1-5,CASSGTGGQPQHF,1,1,2,2
TRBV3-1,TRBJ1-1,CASSKARWDRWVFGTEAFF,2,1,2,3
TRBV10-3,TRBJ1-5,CAISGQFSLGAGNQPQHF,1,0,1,1
TRBV18,TRBJ2-1,CASSPDEAGDLSYNEQFF,1,0,1,1
TRBV7-9,TRBJ1-2,CASSLAKERTGAHYGYTF,1,0,1,1
TRBV3-1,TRBJ2-1,CASSQSLPRSAGGNEQFF,2,0,1,2
TRBV5-5,TRBJ2-2,CASSGGLAGGPDTGELFF,1,0,1,1
TRBV4-1,TRBJ1-2,CASNQNPGQGGIYYGYTF,1,0,1,1
TRBV29-1,TRBJ1-1,CSVVSVGRPSLLDTEAFF,1,0,1,1
TRBV5-6,TRBJ1-3,CASSFPRNISSGNTIYF,1,0,1,1
TRBV5-6,TRBJ1-3,CASSLDPISTAGNTIYF,1,0,1,1
TRBV7-6,TRBJ2-1,CASSLWEISGGHNEQFF,1,0,1,1
TRBV5-5,TRBJ2-2,CASSSIDRAVITGELFF,1,0,1,1
TRBV7-9,TRBJ2-2,CASSQWGAFGRPGELFF,1,0,1,1
TRBV5-1,TRBJ2-6,CASSSGQSFSGANVLTF,1,0,1,1
TRBV24-1,TRBJ1-1,CATSEIPRGSNTEAFF,1,0,1,1
TRBV15,TRBJ2-3,CATSRVSGNGGDTQYF,1,0,1,1
TRBV15,TRBJ1-5,CATSRDLEGAGQPQHF,1,0,1,1
TRBV2,TRBJ2-6,CASWGQDFSGANVLTF,1,0,1,1
TRBV6-2/3/5/6,TRBJ2-7,CASSYSRLAGDYEQYF,1,0,1,1
TRBV6-2/3/5/6,TRBJ2-1,CASSYSMRVSYNEQFF,1,0,1,1
TRBV6-2/3/5/6,TRBJ1-1,CASSYRAPLVDTEAFF,1,0,1,1
TRBV12-3/4,TRBJ2-5,CASSLAPGHLKETQYF,1,0,1,1
TRBV6-2/3/5/6,TRBJ2-1,CASSPRTGAPYNEQFF,1,0,1,1
TRBV6-4,TRBJ1-4,CASSDLMAGVDEKLFF,1,0,1,1
TRBV7-2,TRBJ1-4,CASSLLLSATNEKLFF,1,0,1,1
TRBV7-2,TRBJ1-5,CASSLVGRVSNQPQHF,1,0,1,1
TRBV7-2,TRBJ1-6,CASSLVDRVINSPLHF,1,0,1,1
TRBV7-2,TRBJ1-6,CASSSRTGADNSPLHF,1,0,1,1
TRBV12-3/4,TRBJ2-3,CASSSETSGQGNTQYF,1,0,1,1
TRBV7-2,TRBJ2-7,CASSLGGSGGTYEQYF,1,0,1,1
TRBV7-6,TRBJ2-3,CASSPRQGVSTDTQYF,1,0,1,1
TRBV5-5,TRBJ1-1,CASSPTTGTLNTEAFF,1,0,1,1
TRBV28,TRBJ2-2,CASSPRRTSGTGELFF,1,0,1,1
TRBV7-2,TRBJ2-2,CASSPGLAGVSGELFF,1,0,1,1
TRBV7-2,TRBJ2-4,CASSPPRGRGQNIQYF,1,0,1,1
TRBV7-2,TRBJ2-3,CASSRRGGRATDTQYF,1,0,1,1
TRBV3-1,TRBJ2-7,CASSQSPSGHQYEQYF,1,0,1,1
TRBV3-1,TRBJ2-4,CASSQASSSIENIQYF,1,2,2,3
TRBV4-2,TRBJ2-7,CASSQEVTGFSYEQYF,1,0,1,1
TRBV4-2,TRBJ2-7,CASSQERGLAGVEQYF,2,0,1,2
TRBV11-1,TRBJ2-2,CASSAPGLGYTGELFF,2,1,2,3
TRBV3-1,TRBJ2-3,CASSESTSGSTDTQYF,1,0,1,1
TRBV7-9,TRBJ1-4,CASSTRTLAINEKLFF,1,0,1,1
TRBV5-1,TRBJ2-1,CASSLDSGGSYNEQFF,1,0,1,1
TRBV4-3,TRBJ2-1,CASSQRVGMGGSEQFF,1,0,1,1
TRBV4-1,TRBJ1-1,CASSQLPGTTNTEAFF,1,0,1,1
TRBV4-1,TRBJ1-5,CASSQDPDYSNQPQHF,1,0,1,1
TRBV4-3,TRBJ1-2,CASSQEDRQYNYGYTF,2,23,2,25
TRBV20-1,TRBJ1-6,CSARSETGQGNSPLHF,1,0,1,1
TRBV19,TRBJ1-2,CASTSLGPRGYGYTF,1,0,1,1
TRBV18,TRBJ2-7,CASSPNRGGTYEQYF,1,0,1,1
TRBV12-3/4,TRBJ1-2,CASSLWTGAHYGYTF,1,0,1,1
TRBV6-2/3/5/6,TRBJ1-1,CASSYKAGRMTEAFF,1,2,2,3
TRBV6-2/3/5/6,TRBJ2-1,CASSPGTSSYNEQFF,1,0,1,1
TRBV12-3/4,TRBJ1-5,CASSPRRQGGEPQHF,1,0,1,1
TRBV2,TRBJ1-3,CASSVDRYSGNTIYF,1,1,2,2
TRBV6-1,TRBJ2-3,CASSDGASGFDTQYF,1,0,1,1
TRBV2,TRBJ2-1,CASSERLASYNEQFF,1,0,1,1
TRBV6-1,TRBJ2-5,CASSEAVGESETQYF,1,0,1,1
TRBV6-4,TRBJ1-1,CASSRGGQANTEAFF,1,0,1,1
TRBV5-4,TRBJ2-4,CASSFSLGPPGEEVF,1,0,1,1
TRBV7-2,TRBJ2-7,CASSFLAGVGYEQYF,1,0,1,1
TRBV7-2,TRBJ2-5,CASSLSTSGSETQYF,1,0,1,1
TRBV5-4,TRBJ1-6,CASSLEAGQNSPLHF,2,0,1,2
TRBV7-6,TRBJ2-7,CASSLVVPGGHEQYF,1,0,1,1
TRBV7-9,TRBJ2-1,CASSLVGQGSNEQFF,1,0,1,1
TRBV11-3,TRBJ2-1,CASSLGRPGWDEQFF,1,0,1,1
TRBV5-4,TRBJ2-4,CASSLGGRDKNIQYF,1,0,1,1
TRBV11-2,TRBJ2-3,CASSLELIYTDTQYF,1,0,1,1
TRBV7-2,TRBJ2-7,CASSLSSSRSYEQYF,1,0,1,1
TRBV7-2,TRBJ2-1,CASSSRGLADNEQFF,1,0,1,1
TRBV7-6,TRBJ2-5,CASSSTFGYEETQYF,2,6,2,8
TRBV28,TRBJ2-7,CASSLTSGGTYEQYF,1,0,1,1
TRBV7-6,TRBJ2-1,CASSLGASGTNEQFF,1,0,1,1
TRBV3-1,TRBJ1-2,CASSQDRAFGYGYTF,1,0,1,1
TRBV3-1,TRBJ1-2,CASSQDVRQTYGYTF,1,0,1,1
TRBV14,TRBJ2-7,CASSQDRTFLRKQYF,2,2,2,4
TRBV9,TRBJ2-5,CASSVGGVIQETQYF,1,0,1,1
TRBV9,TRBJ2-6,CASSVGRSGANVLTF,1,0,1,1
TRBV12-3/4,TRBJ2-1,CASSAQISSYNEQFF,2,1,2,3
TRBV6-2/3/5/6,TRBJ1-5,CASSATRKGNQPQHF,1,0,1,1
TRBV9,TRBJ2-1,CASSMTSGGSNEQFF,1,0,1,1
TRBV7-4,TRBJ1-2,CASSTQDPPIYGYTF,1,0,1,1
TRBV12-3/4,TRBJ2-7,CASRGTSGSSYEQYF,1,0,1,1
TRBV5-4,TRBJ1-4,CASRERTGGSEKLFF,1,0,1,1
TRBV28,TRBJ2-3,CASNTHGLNTDTQYF,1,0,1,1
TRBV5-1,TRBJ2-7,CASSFGQGSIYELYF,1,0,1,1
TRBV5-1,TRBJ1-3,CASSLGSGSGNTIYF,1,0,1,1
TRBV5-1,TRBJ1-1,CASSSVQGRDGEAFF,1,0,1,1
TRBV20-1,TRBJ1-2,CSASLGGRFNYGYTF,1,0,1,1
TRBV20-1,TRBJ1-2,CSARVDNSLEYGYTF,1,0,1,1
TRBV20-1,TRBJ2-7,CSARGTGSGSYEQYF,1,0,1,1
TRBV20-1,TRBJ2-4,CSAREYVGSKNIQYF,1,0,1,1
TRBV29-1,TRBJ2-1,CSVDAREDPGNEQFF,1,0,1,1
TRBV29-1,TRBJ1-2,CSVETRGQGIGGYTF,2,1,2,3
TRBV29-1,TRBJ1-1,CSVRGTGGRITEAFF,1,0,1,1
TRBV12-5,TRBJ1-5,CASGLGQGNQPQHF,1,0,1,1
TRBV19,TRBJ1-1,CASSSSGRGTEAFF,1,0,1,1
TRBV19,TRBJ2-7,CASSVGQGAVEQYF,1,0,1,1
TRBV19,TRBJ2-5,CASSMVGTGETQYF,1,0,1,1
TRBV19,TRBJ2-1,CASSIEGDYNEQFF,1,0,1,1
TRBV19,TRBJ1-1,CASSIKVQNTEAFF,1,0,1,1
TRBV18,TRBJ1-1,CASSPEGDSTEAFF,2,2,2,4
TRBV3-1,TRBJ2-1,CASQGPTHLGEQFF,1,0,1,1
TRBV5-4,TRBJ1-5,CASVVGSSNQPQHF,1,0,1,1
TRBV3-1,TRBJ2-1,CASGGLSSYNEQFF,1,0,1,1
TRBV12-3/4,TRBJ2-3,CASSFLAVSDTQYF,1,1,2,2
TRBV27,TRBJ1-1,CASSFLSGGTEAFL,1,0,1,1
TRBV6-2/3/5/6,TRBJ1-5,CASSSTGGNQPQHF,1,0,1,1
TRBV6-2/3/5/6,TRBJ2-1,CASSSEGEYNEQFF,1,0,1,1
TRBV12-3/4,TRBJ1-2,CASSSTGTGYGYTF,1,0,1,1
TRBV6-2/3/5/6,TRBJ2-1,CASSYSSLYNEQFF,1,0,1,1
TRBV12-3/4,TRBJ1-1,CASSPQGLNTEAFF,1,0,1,1
TRBV12-3/4,TRBJ2-3,CASSPRIDESSQYF,1,0,1,1
TRBV12-3/4,TRBJ2-2,CASSPRGYTGELFF,1,0,1,1
TRBV6-1,TRBJ1-5,CASSELASRQPQHF,1,0,1,1
TRBV2,TRBJ2-3,CASSEARTRATQYF,1,0,1,1
TRBV7-8,TRBJ2-3,CASSFRLVKDTQYF,1,1,2,2
TRBV3-1,TRBJ2-1,CASSFDPRGGEQFF,1,0,1,1
TRBV5-8,TRBJ2-3,CASSLRPGSDTQYF,1,0,1,1
TRBV5-5,TRBJ2-7,CASSLTSGSYEQYF,1,0,1,1
TRBV7-6,TRBJ2-3,CASSLRAGWDTQYF,1,0,1,1
TRBV7-3,TRBJ1-1,CASSLQGWNTEAFF,1,0,1,1
TRBV7-2,TRBJ1-4,CASSLAEYSEKLFF,1,0,1,1
TRBV7-6,TRBJ1-6,CASSLDPYNSPLHF,1,0,1,1
TRBV7-9,TRBJ1-4,CASSSDRSDEKLFF,1,0,1,1
TRBV3-1,TRBJ1-6,CASSPTQGYSPLHF,1,0,1,1
TRBV13,TRBJ1-2,CASSPNTGLSGYTF,1,0,1,1
TRBV3-1,TRBJ1-5,CASSPENSNQPQHF,1,0,1,1
TRBV3-1,TRBJ1-2,CASSQVSGAHGYTF,1,0,1,1
TRBV5-4,TRBJ1-2,CASSIWGTGQGSTF,1,2,2,3
TRBV6-2/3/5/6,TRBJ1-1,CASRLGHRNTEAFF,1,0,1,1
TRBV6-2/3/5/6,TRBJ2-7,CASRQGVYVREQYF,1,0,1,1
TRBV3-1,TRBJ2-5,CASNRIQGAATQYF,1,0,1,1
TRBV29-1,TRBJ2-1,CSVENRGSGWEQFF,2,0,1,2
TRBV29-1,TRBJ2-7,CSVERKGNPYEQYF,1,0,1,1
TRBV29-1,TRBJ2-5,CSVTSGADQETQYF,1,0,1,1
TRBV30,TRBJ1-2,CAWSVDGDYGYTF,1,0,1,1
TRBV30,TRBJ1-1,CAQEGIADTEAFF,1,0,1,1
TRBV7-2,TRBJ1-1,CAISGTTNTEAFF,1,0,1,1
TRBV19,TRBJ1-1,CASSIGRLTEAFF,1,6,2,7
TRBV19,TRBJ2-1,CASSTSEGNEQFF,1,0,1,1
TRBV19,TRBJ2-1,CASSQGLLNEQFF,1,0,1,1
TRBV5-4,TRBJ2-1,CASISFPLNEQFF,1,0,1,1
TRBV6-2/3/5/6,TRBJ2-1,CASIRAAYNEQFF,1,0,1,1
TRBV12-3/4,TRBJ2-7,CASSFRRAYEQYF,1,0,1,1
TRBV6-2/3/5/6,TRBJ1-5,CASSLVINQPQHF,1,0,1,1
TRBV9,TRBJ1-5,CASSANSNQPQHF,1,0,1,1
TRBV6-1,TRBJ2-3,CASSEGPTDTQYF,2,0,1,2
TRBV3-1,TRBJ1-2,CASSFQHNYGYTF,1,0,1,1
TRBV7-2,TRBJ2-7,CASSSSPSYEQYF,1,0,1,1
TRBV12-3/4,TRBJ1-5,CASSSRGRQPQHF,1,0,1,1
TRBV7-9,TRBJ2-7,CASSQGGSYEQYF,1,0,1,1
TRBV12-3/4,TRBJ2-1,CASSVHDRDEQFF,1,0,1,1
TRBV9,TRBJ2-5,CASSVNPTGTQYF,1,0,1,1
TRBV5-6,TRBJ2-7,CASSTGTSYEQYF,1,0,1,1
TRBV12-3/4,TRBJ1-1,CASRPDKHTEAFF,1,0,1,1
TRBV25-1,TRBJ2-1,CASRGSSYNEQFF,1,0,1,1
TRBV4-1,TRBJ2-1,CASSLPGFYEQFF,1,0,1,1
TRBV4-3,TRBJ1-2,CASSHLDRYGYTF,1,0,1,1
TRBV29-1,TRBJ1-1,CGARMGLNTEAFF,1,0,1,1
TRBV20-1,TRBJ2-1,CSAREIPSNEQFF,1,0,1,1
TRBV20-1,TRBJ1-5,CSASLRENQPQYF,1,0,1,1
TRBV20-1,TRBJ2-7,CSARSPAAYEQYF,1,0,1,1
TRBV20-1,TRBJ2-5,CSARGLVQETQYF,1,0,1,1
TRBV20-1,TRBJ1-5,CSAYADPPQPQHF,2,0,1,2
TRBV20-1,TRBJ2-1,CSATTRTTNEQFF,1,0,1,1
TRBV29-1,TRBJ1-1,CSVGATLGTEAFF,1,0,1,1
TRBV29-1,TRBJ2-3,CSVDSGFTDTQYF,1,1,2,2
TRBV29-1,TRBJ1-1,CSVERGVIPEAFF,1,0,1,1
TRBV29-1,TRBJ1-1,CSVELGGATEAFF,1,0,1,1
TRBV29-1,TRBJ1-6,CSVRTEGDSPLHF,1,0,1,1
TRBV20-1,TRBJ2-3,CSVERRGSDTQYF,1,0,1,1
TRBV19,TRBJ2-2,CASQTVTGELFF,1,0,1,1
TRBV19,TRBJ2-7,CASSGESYEQYF,1,0,1,1
TRBV12-3/4,TRBJ2-2,CASCRGQRGLFF,1,0,1,1
TRBV6-2/3/5/6,TRBJ2-7,CASSLTGGEQYS,1,0,1,1
TRBV12-3/4,TRBJ2-7,CASSLGFNEQYF,2,2,2,4
TRBV7-2,TRBJ2-1,CASSSPGVRQFF,1,0,1,1
TRBV12-3/4,TRBJ1-1,CASSPPQGKAFF,2,0,1,2
TRBV6-1,TRBJ2-1,CASSGTNNEQFF,1,0,1,1
TRBV6-1,TRBJ1-3,CASSETANTIYF,1,0,1,1
TRBV7-2,TRBJ1-2,CASSTGKGGYTF,1,0,1,1
TRBV5-5,TRBJ2-7,CASSLESYEQYF,1,0,1,1
TRBV3-1,TRBJ2-3,CASSPPERGKYF,1,0,1,1
TRBV6-2/3/5/6,TRBJ1-3,CASSRPYNTIYF,1,2,2,3
TRBV5-6,TRBJ2-7,CASSRHLLEQYF,1,0,1,1
TRBV3-1,TRBJ2-3,CASSQGDGRQYF,1,0,1,1
TRBV3-1,TRBJ2-5,CASSQDPSAPYF,1,1,2,2
TRBV3-1,TRBJ1-6,CASSQDNSPLHF,1,0,1,1
TRBV3-1,TRBJ2-5,CASSQIQETQYF,1,0,1,1
TRBV5-1,TRBJ1-1,CASSLVDTEAFF,1,0,1,1
TRBV20-1,TRBJ2-5,CSASVGQETQYF,1,0,1,1
TRBV19,TRBJ2-3,CAPGEADTQYF,1,0,1,1
TRBV12-3/4,TRBJ2-7,CASSFRGEQYF,1,0,1,1
TRBV2,TRBJ2-1,CASSPGLTGFF,1,0,1,1
TRBV16,TRBJ2-1,CASSPSNEQFF,1,0,1,1
TRBV12-3/4,TRBJ2-3,CASSHEDTQYF,1,0,1,1
TRBV4-1,TRBJ1-3,CASSQGNTIYF,1,0,1,1
TRBV29-1,TRBJ2-2,CSGSLHGELFF,1,0,1,1
TRBV6-2/3/5/6,TRBJ1-2,GASSYVSGYTF,1,0,1,1
TRBV7-3,TRBJ2-5,CATTYETQYF,1,0,1,1
TRBV30,TRBJ2-2,CAWSAGTSDWNGELFF,1,0,1,1
TRBV18,TRBJ1-1,CASSPQTGTEAFF,1,0,1,1
TRBV29-1,TRBJ2-3,CSVKGLSTDTQYF,1,0,1,1
TRBV20-1,TRBJ2-1,CSARDRGLAGALPARSYNEQFF,1,3,2,4
TRBV7-2,TRBJ2-1,CASSLIRGTGTSASYNEQFF,1,0,1,1
TRBV4-2,TRBJ2-6,CASSQPTGKGLEGANVLTF,1,0,1,1
TRBV5-1,TRBJ1-5,CASSLPRASEDFFNQPQHF,1,0,1,1
TRBV5-1,TRBJ2-6,CASSLRSKSPGSGANVLTF,1,0,1,1
TRBV12-5,TRBJ2-5,CASGLVPAGTGTQETQYF,1,0,1,1
TRBV12-3/4,TRBJ2-3,CASSFLGTSGASTDTQYF,1,0,1,1
TRBV12-3/4,TRBJ2-1,CASSLLPETSGRNNEQFF,1,0,1,1
TRBV27,TRBJ1-3,CASSLSGVRANSGNTIYF,1,0,1,1
TRBV6-2/3/5/6,TRBJ1-1,CASSYLPLTQGRKAEAFF,2,0,1,2
TRBV6-2/3/5/6,TRBJ2-6,CASSYGRQGASGANVLTF,1,0,1,1
TRBV6-2/3/5/6,TRBJ2-2,CASSYTFPSGRFTGELFF,1,0,1,1
TRBV6-1,TRBJ1-4,CASSEAANRRSVREKLFF,1,0,1,1
TRBV5-4,TRBJ2-1,CASSSPGLAGVISNEQFF,1,0,1,1
TRBV5-6,TRBJ2-7,CASSSRRLWGPNSYEQYF,1,0,1,1
TRBV9,TRBJ1-1,CASSVVIGSSLVNTEAFF,1,0,1,1
TRBV4-1,TRBJ2-1,CASSQESRDYTSYNEQFF,1,0,1,1
TRBV20-1,TRBJ2-1,CSAVKRLTLDNFYNEQFF,1,0,1,1
TRBV29-1,TRBJ1-2,CSVEVFSDRGEPNYGYTF,1,0,1,1
TRBV29-1,TRBJ2-1,CSVEDGPAGLVGVDEQFF,1,0,1,1
TRBV15,TRBJ2-1,CATSREPGLAGDNEQFF,1,0,1,1
TRBV19,TRBJ1-5,CASSTGQARRSNQPQHF,1,0,1,1
TRBV6-2/3/5/6,TRBJ1-5,CASSYKGKSGSNQPQHF,1,0,1,1
TRBV14,TRBJ1-1,CASSHYRGLRTNTEAFF,1,0,1,1
TRBV13,TRBJ2-2,CASSFGLADANTGELFF,1,0,1,1
TRBV7-2,TRBJ2-3,CASSLALIGGPTDTQYF,1,0,1,1
TRBV7-6,TRBJ2-2,CASSLDRSSGNTGELFF,1,0,1,1
TRBV7-9,TRBJ2-5,CASSPPIQGAVKETQYF,1,0,1,1
TRBV3-1,TRBJ2-7,CASSQEKLAALTYEQYF,1,0,1,1
TRBV7-9,TRBJ2-1,CASSTRLAGGNYNEQFF,1,0,1,1
TRBV10-2,TRBJ1-1,CASSGGRVSVTNTEAFF,1,0,1,1
TRBV5-1,TRBJ2-1,CASSLLREGPFSGEQFF,1,0,1,1
TRBV5-1,TRBJ1-1,CASSLSDGGLRDTEAFF,1,0,1,1
TRBV20-1,TRBJ2-1,CSAPGLAGTPSYNEQFF,1,0,1,1
TRBV15,TRBJ1-3,CATSYRAGRHRNTIYF,2,1,2,3
TRBV24-1,TRBJ2-3,CATSDPSGRAGDTQYF,1,0,1,1
TRBV15,TRBJ2-7,CATSRARTGSSYEQYF,1,0,1,1
TRBV19,TRBJ2-1,CASSMRAGVPYNEQFF,1,0,1,1
TRBV12-3/4,TRBJ2-7,CASSFYNGPNSYEQYF,1,0,1,1
TRBV6-2/3/5/6,TRBJ2-5,CASSFRLAGGHETQYF,1,0,1,1
TRBV28,TRBJ1-5,CASSLHRAEGNQPQHF,2,0,1,2
TRBV6-2/3/5/6,TRBJ2-7,CASSRPSGAGSYEQYF,1,0,1,1
TRBV6-1,TRBJ2-1,CASSESGSGLYNEQFF,1,0,1,1
TRBV2,TRBJ1-3,CASSEDHGASGNTIYF,2,3,2,5
TRBV2,TRBJ2-3,CASSETLWGDTDTQYF,1,0,1,1
TRBV5-4,TRBJ2-1,CASSFQREGRYNEQFF,1,0,1,1
TRBV5-6,TRBJ1-1,CASSLVGSRGAVEAFF,1,0,1,1
TRBV11-1,TRBJ2-1,CASSLTSGGNVNEQFF,1,0,1,1
TRBV13,TRBJ2-1,CASSLGGRGRNNEQFF,1,0,1,1
TRBV7-2,TRBJ2-5,CASSLGGLAGYETQYF,1,0,1,1
TRBV13,TRBJ2-1,CASSLGFSGGDNEQFF,1,0,1,1
TRBV7-8,TRBJ1-1,CASSSRVDRGNTEAFF,1,0,1,1
TRBV28,TRBJ2-3,CASSSGTSGTTDTQYF,2,1,2,3
TRBV7-2,TRBJ2-3,CASSWAPLRSTDTQYF,1,0,1,1
TRBV7-2,TRBJ2-4,CASSPWTTSPKNIQYF,1,0,1,1
TRBV4-2,TRBJ2-3,CASSPWDSGITDTQYF,3,1,2,4
TRBV6-2/3/5/6,TRBJ2-3,CASSPPRQGTSDTQYF,1,0,1,1
TRBV12-3/4,TRBJ2-4,CASSPGGGRAKNIQYF,1,0,1,1
TRBV12-3/4,TRBJ2-1,CASSALLAGGHNEQFF,1,4,2,5
TRBV13,TRBJ1-5,CASSARTVGSNQPQHF,1,0,1,1
TRBV7-9,TRBJ1-4,CASSKGQGSTNEKLFF,1,0,1,1
TRBV6-2/3/5/6,TRBJ1-5,CASKTVREARYQPQHF,1,0,1,1
TRBV5-1,TRBJ2-2,CASSLFIGGADGELFF,1,0,1,1
TRBV5-1,TRBJ2-7,CASSSLTTGLSYEQYF,1,0,1,1
TRBV5-1,TRBJ1-1,CASSYGQGGVGTEAFF,1,0,1,1
TRBV20-1,TRBJ2-5,CSASPVSGRHRETQYF,1,0,1,1
TRBV20-1,TRBJ2-5,CSASGVAGEAGETQYF,1,0,1,1
TRBV20-1,TRBJ2-3,CSARALTGGDTDTQYF,1,0,1,1
TRBV20-1,TRBJ2-7,CSARGLPGLPGYGQYF,1,0,1,1
TRBV20-1,TRBJ1-5,CSARGQGGPFDQPQHF,1,0,1,1
TRBV29-1,TRBJ2-4,CSVVPGTEKAKNIQYF,2,0,1,2
TRBV4-2,TRBJ2-3,SASSQGAGTGADTQYF,1,0,1,1
TRBV30,TRBJ2-4,CAWSQGQGPKNIQYF,1,0,1,1
TRBV10-3,TRBJ1-2,CAISEEGGPLYGYTF,1,1,2,2
TRBV10-3,TRBJ2-7,CAISNGQGGQTEQYF,1,0,1,1
TRBV10-3,TRBJ1-4,CAINEGPGDNEKLFF,1,0,1,1
TRBV24-1,TRBJ2-1,CATSDWGTFYNEQFF,1,2,2,3
TRBV15,TRBJ1-5,CATSRPTALLQPQHF,1,2,2,3
TRBV18,TRBJ1-6,CASSLDVIVGSPLHF,1,0,1,1
TRBV12-3/4,TRBJ1-2,CASRSRDSDIGGYTF,1,0,1,1
TRBV7-3,TRBJ2-5,CASTDSGLRGETQYF,1,0,1,1
TRBV27,TRBJ1-2,CASTSLDGFNYGYTF,2,1,2,3
TRBV12-3/4,TRBJ1-5,CASSLGIDSNQPQHF,1,0,1,1
TRBV28,TRBJ1-5,CASSLSAGGRQPQHF,1,0,1,1
TRBV6-2/3/5/6,TRBJ1-5,CASSLGVRSNQPQHF,1,0,1,1
TRBV7-9,TRBJ1-1,CASSWGDRPDTEAFF,1,0,1,1
TRBV12-3/4,TRBJ2-1,CASSWRLAGENEQFF,1,0,1,1
TRBV6-2/3/5/6,TRBJ2-1,CASSYGASSYNEQFF,1,0,1,1
TRBV6-2/3/5/6,TRBJ1-2,CASSYSLTESYGYTF,1,0,1,1
TRBV28,TRBJ2-7,CASSLTTGGPYEQYF,1,0,1,1
TRBV12-3/4,TRBJ2-5,CASSPDRGRDETQYF,1,0,1,1
TRBV6-1,TRBJ2-1,CASSDSGASYNEQFF,1,0,1,1
TRBV6-1,TRBJ1-5,CASSDNRDRGQPQHF,1,0,1,1
TRBV2,TRBJ2-3,CASSEGTPPTDTQYF,1,0,1,1
TRBV7-9,TRBJ2-7,CASSFPGTGVYEQYF,1,0,1,1
TRBV7-6,TRBJ2-1,CASSFKASPNNEQFF,1,0,1,1
TRBV7-9,TRBJ2-7,CASSFEDRGTYEQYF,1,0,1,1
TRBV5-4,TRBJ2-1,CASSLFLAGNNEQFF,1,0,1,1
TRBV5-5,TRBJ1-1,CASSLAQGTGGEAFF,2,0,1,2
TRBV7-2,TRBJ1-1,CASSLAGQGGTEAFF,1,0,1,1
TRBV5-6,TRBJ1-2,CASSLGPPTYYGYTF,1,0,1,1
TRBV5-4,TRBJ1-1,CASSLTREPNTEAFS,1,0,1,1
TRBV7-3,TRBJ2-5,CASSLWTGEQETQYF,1,0,1,1
TRBV7-9,TRBJ2-7,CASSLRQGSSYEQYF,1,0,1,1
TRBV7-9,TRBJ1-4,CASSLGTRGGEKLFF,1,0,1,1
TRBV5-4,TRBJ2-5,CASSLGLAGEETQYF,1,0,1,1
TRBV7-2,TRBJ1-2,CASSLGGGGGYGYTF,1,0,1,1
TRBV7-3,TRBJ1-1,CASSLIGGLNTEAFF,1,0,1,1
TRBV7-2,TRBJ2-1,CASSSSWAGFDEQFF,1,0,1,1
TRBV7-2,TRBJ2-7,CASSSDRGPSYEQYF,1,0,1,1
TRBV7-2,TRBJ2-1,CASSSGNRGLNEQFF,1,0,1,1
TRBV13,TRBJ1-1,CASSYGRGPNTEAFF,1,0,1,1
TRBV7-9,TRBJ1-1,CASSLGDTSGTEAFF,1,0,1,1
TRBV5-6,TRBJ2-1,CASSPWRIKADEQFF,1,0,1,1
TRBV12-3/4,TRBJ2-1,CASSPPRSSVNEQFF,1,0,1,1
TRBV7-9,TRBJ2-1,CASSPVSGIHNEQFF,1,0,1,1
TRBV7-6,TRBJ2-3,CASSPGTPNTDTQYF,1,0,1,1
TRBV5-6,TRBJ2-5,CASSPDGRYQETQYF,1,0,1,1
TRBV11-2,TRBJ1-1,CASSPTGAGNTEAFF,1,0,1,1
TRBV7-2,TRBJ2-7,CASSPVSRGVYEQYF,1,0,1,1
TRBV3-1,TRBJ2-3,CASSPGPRGGDTQYF,1,0,1,1
TRBV7-9,TRBJ2-4,CASSPEFLAKNIQYF,1,0,1,1
TRBV7-9,TRBJ2-7,CASSPTSGSSYEQYF,1,0,1,1
TRBV7-3,TRBJ1-1,CASSPNAGAETEAFF,1,0,1,1
TRBV6-2/3/5/6,TRBJ2-5,CASSPNGIRGETQYF,1,0,1,1
TRBV12-3/4,TRBJ2-3,CASSRLNVAANTQHF,1,0,1,1
TRBV4-2,TRBJ2-1,CASSQSLGGYDEQFF,2,0,1,2
TRBV3-1,TRBJ2-5,CASSQVPAIVETQYF,1,0,1,1
TRBV3-1,TRBJ1-4,CASSQGSGTNEKLFF,1,0,1,1
TRBV14,TRBJ2-7,CASSQGLAGRNEQYF,1,1,2,2
TRBV3-1,TRBJ2-7,CASSQEVGTSYEQYF,1,0,1,1
TRBV4-2,TRBJ2-3,CASSQEGRGTDTQYF,1,0,1,1
TRBV4-2,TRBJ2-3,CASSQERAEIDTQYF,1,0,1,1
TRBV9,TRBJ2-1,CASSVGSGSYNEQFF,1,0,1,1
TRBV9,TRBJ2-1,CASSVDGGRPNEQFF,2,3,2,5
TRBV3-1,TRBJ1-3,CASSAPTAAGDTIYF,1,0,1,1
TRBV7-3,TRBJ2-2,CASRAGTANTGELFF,1,0,1,1
TRBV2,TRBJ2-1,CASRADRLGNNEQFF,1,0,1,1
TRBV12-3/4,TRBJ2-7,CASNLVAGGPDEQYF,1,0,1,1
TRBV5-1,TRBJ1-2,CASSRTGIVRWGYTF,1,0,1,1
TRBV4-1,TRBJ1-4,CASSHTGESREKLFF,1,0,1,1
TRBV4-1,TRBJ1-2,CASSQPGQKNYGYTF,1,0,1,1
TRBV20-1,TRBJ1-5,CSAYTGIRGNQPQHF,1,0,1,1
TRBV20-1,TRBJ2-7,CSARDGRTSDYEQYF,1,0,1,1
TRBV20-1,TRBJ1-5,CSARGSLHSNQPQHF,1,0,1,1
TRBV20-1,TRBJ2-7,CSATGTSGFSYEQYF,1,0,1,1
TRBV29-1,TRBJ2-7,CSVRLRQGATYEQYF,1,0,1,1
TRBV29-1,TRBJ2-1,CSATGQTRGHNEQFF,1,0,1,1
TRBV12-5,TRBJ2-7,CASVPGYSSYEQYF,1,0,1,1
TRBV12-5,TRBJ2-1,CASGLDKTYNEQFF,1,0,1,1
TRBV30,TRBJ1-2,CAWSVGGQLYGYTF,1,0,1,1
TRBV15,TRBJ1-1,CATSRDLGTAEAFF,1,0,1,1
TRBV12-3/4,TRBJ2-7,CASFCGGGAGEQYF,1,0,1,1
TRBV18,TRBJ2-5,CASSPPQTGETQYF,1,0,1,1
TRBV7-8,TRBJ2-7,CASRVAVEDYEQYF,1,0,1,1
TRBV6-2/3/5/6,TRBJ2-7,CASIPQGRSYEQYF,1,0,1,1
TRBV2,TRBJ1-4,CASTRDWSEEKLFF,1,0,1,1
TRBV12-3/4,TRBJ1-2,CASSFQQGFYGYTF,1,0,1,1
TRBV27,TRBJ2-5,CASSLGGGRETQYF,1,0,1,1
TRBV6-2/3/5/6,TRBJ1-2,CASSLRAPYYGYTF,1,0,1,1
TRBV6-2/3/5/6,TRBJ2-7,CASSYYGGAYEQYF,1,0,1,1
TRBV6-2/3/5/6,TRBJ2-7,CASSYSGLGYEQYF,1,0,1,1
TRBV6-2/3/5/6,TRBJ1-2,CASSYPQGIGGYTF,1,0,1,1
TRBV6-2/3/5/6,TRBJ1-5,CASSYDSGIGPQHF,1,0,1,1
TRBV6-2/3/5/6,TRBJ1-4,CASSRTGLSEKLFF,1,0,1,1
TRBV6-1,TRBJ2-1,CASSEVLGVGEQFF,1,0,1,1
TRBV25-1,TRBJ1-2,CASSERQLFYGYTF,1,0,1,1
TRBV6-1,TRBJ1-1,CASSEGTTSTEAFF,1,0,1,1
TRBV9,TRBJ2-7,CASSFSGTSGEQYF,1,0,1,1
TRBV7-9,TRBJ2-7,CASSFGGGPREQYF,1,0,1,1
TRBV5-6,TRBJ2-5,CASSLSRAIETQYF,2,0,1,2
TRBV5-4,TRBJ2-1,CASSLVAGVNEQFF,1,0,1,1
TRBV7-9,TRBJ1-1,CASSLGTGNTEAFF,2,0,1,2
TRBV5-5,TRBJ2-2,CASSLGRAAGELFF,1,0,1,1
TRBV12-3/4,TRBJ1-4,CASSLGQGAKKLFF,1,0,1,1
TRBV7-6,TRBJ2-3,CASSLQGSTDTQYF,1,0,1,1
TRBV7-2,TRBJ1-2,CASSLVGRSNGYTF,1,0,1,1
TRBV7-2,TRBJ1-1,CASSLVGMNTEAFF,1,0,1,1
TRBV7-9,TRBJ2-1,CASSLGGRRNEQFF,2,0,1,2
TRBV6-2/3/5/6,TRBJ2-4,CASSLEDEKNIQYF,1,0,1,1
TRBV7-9,TRBJ1-6,CASSLNQYNSPLHF,2,0,1,2
TRBV7-6,TRBJ2-5,CASSSWGGKETQYF,1,0,1,1
TRBV5-6,TRBJ1-3,CASSPLVSGNTIYF,1,0,1,1
TRBV7-9,TRBJ2-7,CASSPPGQSYEQYF,1,0,1,1
TRBV6-2/3/5/6,TRBJ1-5,CASSPGEGRQPQHF,1,0,1,1
TRBV7-9,TRBJ1-4,CASSPRVTNEKLFF,1,0,1,1
TRBV7-2,TRBJ1-3,CASSPRDRRNTIYF,1,0,1,1
TRBV5-4,TRBJ1-2,CASSPRTALYGYTF,1,0,1,1
TRBV12-3/4,TRBJ1-2,CASSPLQGNYGYTF,1,0,1,1
TRBV3-1,TRBJ2-7,CASSRQGGLYEQYF,1,1,2,2
TRBV14,TRBJ2-7,CASSRAGGHYEQYF,1,0,1,1
TRBV5-4,TRBJ2-5,CASSRDTRKETQYF,1,0,1,1
TRBV4-2,TRBJ1-1,CASSQFGDDTEAFF,1,0,1,1
TRBV7-9,TRBJ1-1,CASSQAGGIAEAFF,1,0,1,1
TRBV3-1,TRBJ2-7,CASSQGTGPYEQYF,1,0,1,1
TRBV5-6,TRBJ2-7,CASSQRDKFYEQYF,1,0,1,1
TRBV9,TRBJ1-2,CASSVLGSNYGYTF,2,3,2,5
TRBV9,TRBJ1-2,CASSVGDSNYGYTF,1,0,1,1
TRBV9,TRBJ2-5,CASSVDLSTETQYF,1,0,1,1
TRBV7-9,TRBJ2-7,CASSSRAGSYEQYF,2,0,1,2
TRBV6-2/3/5/6,TRBJ1-6,CASRSTGERSPLHF,1,0,1,1
TRBV27,TRBJ1-1,CASRDKTVNTEAFF,1,0,1,1
TRBV5-1,TRBJ2-5,CASSLSRGSETQYF,1,0,1,1
TRBV5-1,TRBJ2-5,CASSPGQGWETQYF,1,0,1,1
TRBV5-1,TRBJ1-1,CASSQWQGDTEALF,1,0,1,1
TRBV5-1,TRBJ1-2,CASSQLTGNYGYTF,1,0,1,1
TRBV4-3,TRBJ2-3,CASSQDSHRDTQYF,1,0,1,1
TRBV5-1,TRBJ2-2,CASKIGTETGELFF,1,0,1,1
TRBV20-1,TRBJ2-7,CSAPDSRGIYEQYF,1,0,1,1
TRBV20-1,TRBJ2-2,CSAIAGGLDGELFF,1,0,1,1
TRBV20-1,TRBJ1-5,CSARVGTVNQPQHF,1,0,1,1
TRBV20-1,TRBJ2-1,CSAREGETYNEQFF,1,0,1,1
TRBV29-1,TRBJ1-1,CSVVPGVRVTEAFF,1,0,1,1
TRBV29-1,TRBJ2-1,CSVGDRLIYNEQFF,1,0,1,1
TRBV29-1,TRBJ2-1,CSVGVAGGGNEQFF,1,0,1,1
TRBV29-1,TRBJ1-2,CSVDSPRVWDGYTF,1,0,1,1
TRBV29-1,TRBJ2-6,CSVDLGSGANVLTF,1,0,1,1
TRBV29-1,TRBJ2-7,CSVEDPLGTYEQYF,1,0,1,1
TRBV29-1,TRBJ2-5,CSVEEGTFQETQYF,1,0,1,1
TRBV29-1,TRBJ1-1,CSVLRDRGHPEAFF,1,0,1,1
TRBV29-1,TRBJ1-5,CSAAGTGDNQPQHF,1,0,1,1
TRBV29-1,TRBJ1-2,CSATSSTVSYGYTF,1,0,1,1
TRBV7-7,TRBJ2-5,CAIFSGGEETQYF,1,0,1,1
TRBV12-3/4,TRBJ1-2,CATTRASRTSYTF,1,0,1,1
TRBV24-1,TRBJ2-5,CATSDPLRETQYF,1,0,1,1
TRBV19,TRBJ1-1,CASGGGSNTEAFF,1,0,1,1
TRBV19,TRBJ1-1,CASSPGLNTEAFF,1,0,1,1
TRBV2,TRBJ1-6,CASFRTADRNLHF,1,0,1,1
TRBV18,TRBJ1-2,CASSPRENYGYTF,1,0,1,1
TRBV18,TRBJ1-1,CASSPQTNTEAFF,1,0,1,1
TRBV12-3/4,TRBJ2-7,CASLRGSENEQYF,1,1,2,2
TRBV12-3/4,TRBJ1-2,CASTHGREYGYTF,1,0,1,1
TRBV27,TRBJ2-7,CASSFYNSYEQYF,1,0,1,1
TRBV12-3/4,TRBJ1-5,CASSLGSNQPQHF,1,0,1,1
TRBV12-3/4,TRBJ2-7,CASSLGGPYEQYF,1,0,1,1
TRBV12-3/4,TRBJ2-5,CASSSGQGETQYF,1,0,1,1
TRBV6-2/3/5/6,TRBJ2-1,CASSPERRNEQFF,1,0,1,1
TRBV6-1,TRBJ1-4,CASSPTENEKLFF,1,0,1,1
TRBV2,TRBJ2-1,CASSEVVGYEQFF,1,0,1,1
TRBV25-1,TRBJ1-1,CASSEGFYTDAFF,1,0,1,1
TRBV7-2,TRBJ2-3,CASSLGPPGTQYF,2,2,2,4
TRBV7-2,TRBJ1-1,CASSLTENTEAFF,1,0,1,1
TRBV7-8,TRBJ2-7,CASSLQNSYEQYF,1,0,1,1
TRBV5-4,TRBJ2-1,CASSSPTSNEQFF,1,0,1,1
TRBV5-6,TRBJ1-2,CASSYREGGGYTF,1,0,1,1
TRBV6-2/3/5/6,TRBJ2-1,CASSPYPPYEQFF,1,0,1,1
TRBV7-6,TRBJ2-7,CASSRTDNYEQYF,1,1,2,2
TRBV4-2,TRBJ1-2,CASSQNRGRGYTF,1,0,1,1
TRBV14,TRBJ1-1,CASSQSTRTEAFF,1,0,1,1
TRBV7-9,TRBJ2-7,CASSSESSYEQYF,1,0,1,1
TRBV7-9,TRBJ1-4,CASRDRGSEKLFF,1,0,1,1
TRBV7-2,TRBJ2-7,CASRLDRYYEQYF,1,0,1,1
TRBV28,TRBJ2-7,CASRGTGTYEQYF,1,0,1,1
TRBV5-1,TRBJ1-6,CASSLEPGSPLHF,1,0,1,1
TRBV5-1,TRBJ2-7,CASSYRAGDEQYF,1,0,1,1
TRBV5-1,TRBJ1-1,CASSPGPNTEAFF,1,0,1,1
TRBV20-1,TRBJ2-7,CSATSGYSYEQYF,1,0,1,1
TRBV20-1,TRBJ2-7,CSARDNPRYEQYF,1,0,1,1
TRBV20-1,TRBJ2-2,CSARPRDTGELFF,1,0,1,1
TRBV20-1,TRBJ2-7,CSANPGGSYEQYF,1,0,1,1
TRBV20-1,TRBJ2-1,CSAPGQGANEQFF,1,0,1,1
TRBV20-1,TRBJ2-7,CSALAVISYEQYF,1,0,1,1
TRBV29-1,TRBJ2-1,CSVGIDSYNEQFF,1,0,1,1
TRBV29-1,TRBJ1-1,CSVDAGWGTEAFF,1,0,1,1
TRBV29-1,TRBJ1-2,CSVEGTGPRGYTF,1,0,1,1
TRBV29-1,TRBJ2-1,CSVEETSGSMQFF,1,0,1,1
TRBV29-1,TRBJ2-5,CSVLAGLQETQYF,1,0,1,1
TRBV29-1,TRBJ2-7,CSVAVSSSYEQYF,1,0,1,1
TRBV29-1,TRBJ1-6,CSVGDRENSPLHF,1,0,1,1
TRBV29-1,TRBJ1-1,CSTHRGQNTEAFF,1,0,1,1
TRBV30,TRBJ2-3,CAYDRDTDTQYF,1,0,1,1
TRBV19,TRBJ2-3,CASQRSGGRQYF,1,0,1,1
TRBV19,TRBJ2-4,CASSLDKNIQYF,1,0,1,1
TRBV19,TRBJ2-2,CASSIGTGELFF,1,0,1,1
TRBV19,TRBJ1-5,CASSKAPGPQHF,1,0,1,1
TRBV7-9,TRBJ1-5,CASGYSNQPQHF,1,0,1,1
TRBV7-9,TRBJ1-4,CASDRVNEKLFF,1,0,1,1
TRBV27,TRBJ2-7,CASSSTGGEQYF,1,2,2,3
TRBV27,TRBJ2-1,CASSPRYNEQFF,1,0,1,1
TRBV12-3/4,TRBJ2-1,CASSRLVDEQFF,1,0,1,1
TRBV6-2/3/5/6,TRBJ2-5,CASSQGGETQYF,1,0,1,1
TRBV2,TRBJ2-7,CASSASRNEQYF,1,0,1,1
TRBV7-9,TRBJ1-5,CASSLGRRPQHF,1,0,1,1
TRBV11-2,TRBJ1-5,CASSLENQPQHF,1,0,1,1
TRBV7-6,TRBJ1-2,CASSLENRGYTF,1,0,1,1
TRBV6-1,TRBJ1-1,CASSDSVGEAFF,1,0,1,1
TRBV7-9,TRBJ2-1,CGSGEGRYEQFF,2,3,2,5
TRBV10-2,TRBJ2-1,CATSDPWDEQFF,1,0,1,1
TRBV4-3,TRBJ2-3,CASSQSRDTQYF,1,0,1,1
TRBV5-1,TRBJ2-3,CASSQYTDTQYF,1,0,1,1
TRBV20-1,TRBJ2-5,CSANGEGETQYF,1,0,1,1
TRBV20-1,TRBJ2-5,CSAELRQETQYF,1,0,1,1
TRBV29-1,TRBJ1-2,CSVDSPHYGYTF,1,0,1,1
TRBV29-1,TRBJ2-7,CSVEDRAYEQYF,1,0,1,1
TRBV29-1,TRBJ2-1,CSVEEPRGEQFF,2,0,1,2
TRBV29-1,TRBJ1-1,CSVTTGNTEAFF,1,0,1,1
TRBV29-1,TRBJ2-1,CSVGQVGDEQFF,1,0,1,1
TRBV19,TRBJ2-1,CATTTGGRRFF,1,0,1,1
TRBV27,TRBJ1-1,CASEITGQAFF,1,1,2,2
TRBV12-3/4,TRBJ1-2,CASSLAGGYTF,1,0,1,1
TRBV6-1,TRBJ1-6,CASSEGSPLHF,1,0,1,1
TRBV10-3,TRBJ1-5,CASNSKQPQHF,1,0,1,1
TRBV12-3/4,TRBJ1-6,CASKLSSPLHF,1,0,1,1
TRBV20-1,TRBJ1-1,CSAVGAGGAFF,1,0,1,1
TRBV20-1,TRBJ1-3,CSARAVDTIYF,1,0,1,1
TRBV20-1,TRBJ2-1,CSARALVEQFF,1,0,1,1
TRBV29-1,TRBJ2-7,CSVDQGGEQYF,1,0,1,1
TRBV29-1,TRBJ1-1,CSVDGNTEAFF,1,0,1,1
TRBV29-1,TRBJ2-7,CSVELGYEQYF,1,0,1,1
TRBV2,TRBJ2-7,CASSVHEQYF,1,0,1,1
TRBV5-4,TRBJ2-7,CASSKDPTGVYEQYF,1,0,1,1
TRBV12-5,TRBJ1-4,CASGLVRSLATNEKLFF,1,0,1,1
TRBV7-9,TRBJ2-5,CASSPPLGPGQETQYF,1,0,1,1
TRBV7-8,TRBJ1-3,CAGSWTGGAGNTIYF,1,0,1,1
TRBV7-3,TRBJ2-1,RASSHGGGFYNEQFL,1,0,1,1
TRBV7-6,TRBJ1-4,CASSLASGTGNEILFF,1,0,1,1
TRBV3-1,TRBJ1-3,CASSQDYRISGNSIYF,1,0,1,1
TRBV19,TRBJ1-5,CASSTVDPIGSNQPQHF,1,0,1,1
TRBV4-2,TRBJ2-1,CASSLRLAGSYNEQFF,1,0,1,1
TRBV18,TRBJ2-7,CASSPSGGVFYEQYF,1,1,2,2
TRBV2,TRBJ2-2,CASRRGGQNTGELFF,2,0,1,2
TRBV5-8,TRBJ2-1,CASSLFGLNEQFF,2,0,1,2
TRBV18,TRBJ1-5,CASSPGQNSNQTQHF,1,0,1,1
TRBV12-3/4,TRBJ1-5,CASSLLRGGGSQPQHF,1,0,1,1
TRBV12-5,TRBJ2-1,CASGNPGLDSNEQFF,1,65,2,66
TRBV7-2,TRBJ2-5,CASSPSLAGLLGTQYF,1,0,1,1
TRBV9,TRBJ2-5,CASSGPLSWERGETQYF,1,4,2,5
TRBV5-4,TRBJ2-3,CASSLTSTDTQYF,1,2,2,3
TRBV4-1,TRBJ1-1,CASSQDPTVMNTEAFF,1,0,1,1
TRBV20-1,TRBJ2-3,CSARDRGLSDTQYF,1,2,2,3
TRBV9,TRBJ2-2,CASSVGGSGELFF,1,4,2,5
TRBV7-2,TRBJ2-5,CASSFAPTWTGSITGTSAQETQYF,1,0,1,1
TRBV12-3/4,TRBJ2-2,CASSFKVQAGTAGGGMPGELFF,1,0,1,1
TRBV2,TRBJ2-1,CASSGPWGGTSGRIDYNEQFF,1,0,1,1
TRBV6-2/3/5/6,TRBJ2-4,CASTIRPGLAGDLAKNIQYF,1,0,1,1
TRBV6-2/3/5/6,TRBJ2-6,CASSYWDQAGGYSGANVLTF,1,0,1,1
TRBV3-1,TRBJ2-3,CASSQEWWTSGALPTDTQYF,1,0,1,1
TRBV12-5,TRBJ2-2,CASGLPDRVGFWNTGELFF,1,0,1,1
TRBV12-3/4,TRBJ2-5,CASSFQGTSGRWDQETQYF,2,0,1,2
TRBV10-3,TRBJ2-7,CASSDGTGGIAGIYEQYF,1,0,1,1
TRBV19,TRBJ2-6,CASSSPPGRYSGANVLTF,1,1,2,2
TRBV19,TRBJ1-5,CASSIDQSQIQKFQPQHF,1,0,1,1
TRBV12-3/4,TRBJ1-5,CASSLGHRFWNSNQPQHF,1,0,1,1
TRBV6-2/3/5/6,TRBJ2-1,CASSLGGAGGLSYNEQFF,1,0,1,1
TRBV7-3,TRBJ2-3,CASSLSGRATWAPDTQYF,1,0,1,1
TRBV11-2,TRBJ1-5,CASSLARGDRGGNQPQHF,1,0,1,1
TRBV2,TRBJ1-4,CASSLWEQNPLDNEKLFF,1,0,1,1
TRBV4-2,TRBJ1-2,CASSQDSRGDLREDGYTF,1,0,1,1
TRBV20-1,TRBJ1-2,CSATRPGTGGLGDYGYTF,1,0,1,1
TRBV29-1,TRBJ1-3,CSDAGWVITLCAGNTIYF,1,0,1,1
TRBV7-2,TRBJ2-3,CAGSLGVAGGLTDTQYF,1,0,1,1
TRBV15,TRBJ2-7,CATSRDLPGLGTYEQYF,1,0,1,1
TRBV7-9,TRBJ2-5,CASSFLGQLAVQETQYF,1,0,1,1
TRBV18,TRBJ2-3,CASSPRLAGGSTDTQYF,2,0,1,2
TRBV7-2,TRBJ2-3,CASGNLRDRVNTDTQYF,1,0,1,1
TRBV6-2/3/5/6,TRBJ1-1,CASSYSNRGLTNTEAFF,1,0,1,1
TRBV6-1,TRBJ2-2,CASSEARQVVGSGELFF,1,0,1,1
TRBV6-1,TRBJ1-5,CASSEARGSNSNQPQHF,1,0,1,1
TRBV12-3/4,TRBJ2-3,CASSNPGLAGRTDTQYF,1,0,1,1
TRBV7-2,TRBJ2-1,CASSLAVAGGPYNEQFF,1,0,1,1
TRBV11-2,TRBJ1-3,CASSLGVYGRSGNTIYF,1,0,1,1
TRBV7-9,TRBJ2-4,CASSLGGGQGADWIQYF,1,0,1,1
TRBV7-6,TRBJ2-7,CASSLTGRPAGVYEQYF,1,0,1,1
TRBV7-9,TRBJ2-5,CASSSTWDGGYQETQYF,1,0,1,1
TRBV5-4,TRBJ1-2,CASSRLDPTFRNYGYTF,1,0,1,1
TRBV3-1,TRBJ2-3,CASSQYDRSDKTDTQYF,1,0,1,1
TRBV3-1,TRBJ2-3,CASSQARGTGGTDTQYF,1,0,1,1
TRBV7-3,TRBJ2-1,CASSANRGTPQGNEQFF,2,5,2,7
TRBV5-4,TRBJ2-3,CASSAGLAGSTQNTQYF,1,0,1,1
TRBV7-9,TRBJ2-1,CASRRDPVFSSFEEQFF,1,0,1,1
TRBV28,TRBJ1-5,CASRNRDRGYSNQPQHF,1,0,1,1
TRBV5-1,TRBJ2-5,CASSLDPSGVVQETQYF,1,0,1,1
TRBV4-3,TRBJ2-7,CASSKGGRLAGTYEQYF,1,0,1,1
TRBV20-1,TRBJ2-6,CSASTGQGGGGANVLTF,1,0,1,1
TRBV30,TRBJ2-7,CAWSGLAGATFYEQYF,1,0,1,1
TRBV10-3,TRBJ2-3,CAISSLAGDTVDTQYF,1,0,1,1
TRBV24-1,TRBJ1-4,CATSDPRDRKNEKLFF,1,0,1,1
TRBV19,TRBJ2-1,CASSILSGSRGNEQFF,1,0,1,1
TRBV18,TRBJ2-5,CASSWRGLGVQETQYF,1,0,1,1
TRBV5-4,TRBJ2-1,CASIDKKTGTNNEQFF,1,1,2,2
TRBV12-3/4,TRBJ2-7,CASTQGSRQRSYEQYF,1,0,1,1
TRBV27,TRBJ1-5,CASSFRDRGPNQPQHF,1,0,1,1
TRBV12-3/4,TRBJ1-6,CASSLSVGSYNSPLHF,1,1,2,2
TRBV27,TRBJ2-7,CASSSPKLAGVSEQYF,1,0,1,1
TRBV6-2/3/5/6,TRBJ2-1,CASSYSGGKSYNEQFF,1,0,1,1
TRBV6-2/3/5/6,TRBJ1-4,CASSYPGFGGLEKLFF,1,0,1,1
TRBV12-3/4,TRBJ2-4,CASSPGLAVAKNIQYF,1,0,1,1
TRBV27,TRBJ1-5,CASSPGQGAVYQPQHF,1,0,1,1
TRBV5-5,TRBJ1-5,CASSPGGGYINQPQHF,1,0,1,1
TRBV6-2/3/5/6,TRBJ2-7,CASSHRDRSPAYEQYF,1,0,1,1
TRBV6-1,TRBJ1-5,CASSVGGGRINQPQHF,1,0,1,1
TRBV6-4,TRBJ2-5,CASSGSTSGSQETQYF,1,0,1,1
TRBV2,TRBJ2-1,CASSGTSGSSYNEQFF,1,0,1,1
TRBV25-1,TRBJ2-3,CASSEFGGVGTDTQYF,1,0,1,1
TRBV19,TRBJ2-1,CASSIYEGEGDNEQFF,1,0,1,1
TRBV12-3/4,TRBJ1-1,CASSTPDGTVNTEAFF,1,0,1,1
TRBV7-2,TRBJ2-4,CASSFRGRGAKNIQYF,1,0,1,1
TRBV5-6,TRBJ2-3,CASSFVSGRSTDTQYF,1,0,1,1
TRBV5-4,TRBJ2-1,CASSLAGRGGYNEQFF,1,0,1,1
TRBV6-4,TRBJ2-3,CASSLDLAGGPDTQYF,1,0,1,1
TRBV5-6,TRBJ2-1,CASSLMRQSGYNEQFF,1,0,1,1
TRBV7-2,TRBJ2-5,CASSLTSGRARETQYF,1,0,1,1
TRBV7-9,TRBJ1-5,CASSLQPRGSNQPQHF,1,0,1,1
TRBV11-1,TRBJ2-3,CASSLVFSSTADTQYF,1,0,1,1
TRBV7-2,TRBJ2-1,CASSLVADLSYNEQFF,1,0,1,1
TRBV7-9,TRBJ2-1,CASSLAGTGPYNEQFF,1,0,1,1
TRBV7-2,TRBJ2-1,CASSLDTSGLLDEQFF,1,0,1,1
TRBV11-1,TRBJ1-1,CASSLTPGQGGTEAFF,1,0,1,1
TRBV7-2,TRBJ2-5,CASSSQGGEEWETQYF,1,0,1,1
TRBV5-5,TRBJ2-2,CASSSGLAGVDGELFF,1,0,1,1
TRBV5-4,TRBJ2-1,CASSSRKTGILWEQFF,1,0,1,1
TRBV6-2/3/5/6,TRBJ2-6,CASSSDRGGITNVLTF,1,0,1,1
TRBV14,TRBJ2-2,CASSLTDSLNTGELFF,1,2,2,3
TRBV6-2/3/5/6,TRBJ2-5,CASSLTGGTGAETQYF,1,0,1,1
TRBV5-4,TRBJ2-1,CASSLGSVSSYNEQFF,1,1,2,2
TRBV7-2,TRBJ2-3,CASSLTGLAGSDTQYF,1,0,1,1
TRBV5-4,TRBJ2-1,CASSPLAGQPYNEQFF,1,0,1,1
TRBV3-1,TRBJ1-1,CASSPLAGWGNTEAFF,1,0,1,1
TRBV7-8,TRBJ2-1,CASSPPVWGDYNEQFF,1,0,1,1
TRBV12-3/4,TRBJ1-2,CASSPRSAPKSSGYTF,1,2,2,3
TRBV7-9,TRBJ2-1,CASSPPRPGSYNEQFF,2,0,1,2
TRBV5-4,TRBJ2-1,CASSHPEAGGYNEQFF,1,1,2,2
TRBV6-2/3/5/6,TRBJ2-3,CASSHWSGRAVDTQYF,1,0,1,1
TRBV3-1,TRBJ2-6,CASSQAGDSGANVLTF,1,0,1,1
TRBV7-2,TRBJ2-1,CASSQGLAFSYNEQFF,1,0,1,1
TRBV3-1,TRBJ2-2,CASSQGSGSVTGELFF,1,0,1,1
TRBV3-1,TRBJ1-5,CASSQTREGGGQPQHF,1,0,1,1
TRBV9,TRBJ2-1,CASSVGAGAEYNEQFF,1,0,1,1
TRBV9,TRBJ2-3,CASSAPGGGLTDTQYF,1,0,1,1
TRBV7-2,TRBJ2-5,CASSIQTSGSSQTQYF,1,0,1,1
TRBV3-1,TRBJ2-2,CASSRQDPRGSGELFF,1,0,1,1
TRBV2,TRBJ2-2,CASRDLRRGNTGELFF,1,0,1,1
TRBV6-2/3/5/6,TRBJ2-6,CASRADWTSGANVLTF,1,0,1,1
TRBV5-1,TRBJ2-2,CASYSGQSRNTGELFF,1,0,1,1
TRBV5-1,TRBJ2-2,CASGLEPKGTTGELFF,1,0,1,1
TRBV5-1,TRBJ2-7,CASSFGLTLDSYEQYF,1,0,1,1
TRBV5-1,TRBJ2-2,CASSLYPSGNTGELFF,1,0,1,1
TRBV5-1,TRBJ1-1,CASSLGGDGSSAEAFF,1,0,1,1
TRBV5-1,TRBJ2-7,CASSLVGGGSPYEQYF,1,0,1,1
TRBV5-1,TRBJ2-6,CASSSPTGSGANVLTF,1,0,1,1
TRBV5-1,TRBJ2-3,CASSSGLAGGVDTQYF,1,0,1,1
TRBV4-1,TRBJ1-1,CASSQVKGKMNTEAFF,1,0,1,1
TRBV4-3,TRBJ1-2,CASSQDSTGDNYGYTF,1,0,1,1
TRBV4-3,TRBJ2-5,CASSQDVSEPWETQYF,1,1,2,2
TRBV4-3,TRBJ2-7,CASSQDTLTAGDEQYF,2,0,1,2
TRBV5-1,TRBJ1-6,CASSTSGLGDNSPLHF,1,0,1,1
TRBV29-1,TRBJ2-5,CSAGGLARMYQETQYF,1,0,1,1
TRBV20-1,TRBJ1-6,CSAGGVTEKNNSPLHF,1,0,1,1
TRBV20-1,TRBJ2-1,CSAIAGSASSYNEQFF,1,0,1,1
TRBV20-1,TRBJ2-1,CSASGASGDPGNEQFF,1,0,1,1
TRBV20-1,TRBJ2-2,CSARDFGGAWDGELFF,1,0,1,1
TRBV20-1,TRBJ2-3,CSARDLVNFITDTQYF,1,0,1,1
TRBV20-1,TRBJ2-2,CSARDRLAGNTGELFF,1,0,1,1
TRBV20-1,TRBJ1-4,CSARDGTSPPFEKLFF,1,0,1,1
TRBV20-1,TRBJ2-5,CSARDLGTLRGETQYF,1,0,1,1
TRBV29-1,TRBJ2-1,CSVGSWGKSSYNEQFF,1,0,1,1
TRBV29-1,TRBJ2-3,CSVKSGRREDTDTQYF,1,0,1,1
TRBV29-1,TRBJ2-1,CSANGASGSLNNEQFF,1,0,1,1
TRBV7-3,TRBJ1-2,RASSLTTGCANYGYTF,1,0,1,1
TRBV12-5,TRBJ1-1,CASGLTRVTHTEAFF,1,0,1,1
TRBV30,TRBJ2-1,CAWIARAYPYNEQFF,1,0,1,1
TRBV10-3,TRBJ2-5,CAISVSGRAEETQYF,1,0,1,1
TRBV10-3,TRBJ2-2,CAIRLAGVNAGELFF,1,0,1,1
TRBV12-3/4,TRBJ2-1,CATATGTASYNEQFF,1,0,1,1
TRBV15,TRBJ2-5,CATSRGRGGQETQYF,1,0,1,1
TRBV15,TRBJ2-3,CATSRRTVSTDTQYF,1,0,1,1
TRBV12-3/4,TRBJ2-5,CASLEIGWGSETQYF,1,0,1,1
TRBV19,TRBJ1-1,CASSIRTAMNTEAFF,1,0,1,1
TRBV19,TRBJ1-3,CASSISPPTGNTIYF,1,0,1,1
TRBV19,TRBJ2-3,CASSMMRADTDTQYF,1,0,1,1
TRBV19,TRBJ2-1,CASSSPGTGLNEQFF,1,0,1,1
TRBV3-1,TRBJ1-3,CASSGTALSGNTIYF,1,0,1,1
TRBV19,TRBJ2-1,CASRTGLSSYNEQFF,1,0,1,1
TRBV18,TRBJ1-5,CASSPRQGGGQPQHF,1,0,1,1
TRBV18,TRBJ2-5,CASSPMGQGQETQYF,1,0,1,1
TRBV18,TRBJ2-1,CASSRDLSIDNEQFF,1,0,1,1
TRBV18,TRBJ1-4,CASSRSQGVDEKLFF,1,0,1,1
TRBV5-4,TRBJ2-3,CASREGGGNTDTQYF,1,0,1,1
TRBV6-1,TRBJ2-1,CASTEGGLAGGEQFF,1,0,1,1
TRBV6-2/3/5/6,TRBJ2-1,CASTKSAGGYNEQFF,1,0,1,1
TRBV28,TRBJ1-6,CASSFRHSKNSPLHF,1,0,1,1
TRBV28,TRBJ2-7,CASSLPGTGVNEQYF,1,0,1,1
TRBV12-3/4,TRBJ2-3,CASSLVYGRGDTQYF,1,0,1,1
TRBV12-3/4,TRBJ1-5,CASSLKGIGNQPQHF,1,0,1,1
TRBV6-2/3/5/6,TRBJ2-7,CASSLLGTGIYEQYF,1,0,1,1
TRBV12-3/4,TRBJ1-5,CASSLDGRPYQPQHF,1,0,1,1
TRBV7-9,TRBJ1-2,CASSLTQGVYDGYTF,2,0,1,2
TRBV6-2/3/5/6,TRBJ1-5,CASSYSDRSNQPQHF,1,0,1,1
TRBV6-2/3/5/6,TRBJ2-4,CASSYSRDRQNIQYF,1,0,1,1
TRBV12-3/4,TRBJ2-3,CASSLIAGLTDTQYF,1,0,1,1
TRBV25-1,TRBJ2-7,CASSRSGTGRVEQYF,1,0,1,1
TRBV2,TRBJ1-5,CASSRDRRTNQPQHF,1,0,1,1
TRBV6-4,TRBJ1-3,CASSDAGSTGNTIYF,1,0,1,1
TRBV25-1,TRBJ1-2,CASSESGIANYGYTF,1,0,1,1
TRBV6-1,TRBJ2-1,CASSEWYRAYNEQFF,1,0,1,1
TRBV6-1,TRBJ1-1,CASSEAIPGQTEAFF,1,0,1,1
TRBV6-1,TRBJ2-5,CASSEGAGGRETQYF,1,0,1,1
TRBV12-3/4,TRBJ1-5,CASSTRQGGNQPQHF,1,0,1,1
TRBV5-4,TRBJ2-1,CASSKRGLSYNEQFF,1,0,1,1
TRBV5-6,TRBJ2-5,CASSFAGRGQETQYF,1,0,1,1
TRBV5-6,TRBJ2-3,CASSLSEARTDTQYF,1,0,1,1
TRBV5-5,TRBJ2-3,CASSLWEIGADTQYF,1,0,1,1
TRBV5-4,TRBJ2-5,CASSLRGTLKETLYF,1,0,1,1
TRBV5-6,TRBJ2-5,CASSLASGIQETQYF,1,0,1,1
TRBV7-9,TRBJ2-1,CASSLGLFDYNEQFF,1,0,1,1
TRBV7-6,TRBJ2-3,CASSLISSGTDTQYF,1,0,1,1
TRBV7-9,TRBJ1-4,CASSLQGRLNEELFF,1,0,1,1
TRBV7-9,TRBJ2-7,CASSLVGRGNYEQYF,1,0,1,1
TRBV7-2,TRBJ2-1,CASSLAGGPRNEQFF,1,0,1,1
TRBV7-2,TRBJ2-7,CASSLADGTTYEQYF,1,0,1,1
TRBV7-8,TRBJ2-5,CASSLGGGQGETQYF,1,0,1,1
TRBV7-2,TRBJ2-7,CASSLGRLPSYEQYF,1,0,1,1
TRBV7-3,TRBJ2-7,CASSLRGGGVYEQYI,1,0,1,1
TRBV5-6,TRBJ2-5,CASSSRTDVKETQYF,1,0,1,1
TRBV5-6,TRBJ2-4,CASSSDYLAKNIQYF,1,0,1,1
TRBV5-4,TRBJ2-7,CASSSFPRTQLEQYF,2,3,2,5
TRBV7-2,TRBJ1-2,CASSWPGRTTYGYTF,1,0,1,1
TRBV7-3,TRBJ2-1,CASSWGLADHNEQFF,1,0,1,1
TRBV4-2,TRBJ2-7,CASSLMTSGSYEQYF,1,0,1,1
TRBV7-2,TRBJ2-7,CASSPLTVTPYEQYF,1,0,1,1
TRBV5-8,TRBJ2-6,CASSPRTAGANVLTF,1,0,1,1
TRBV6-2/3/5/6,TRBJ2-5,CASSPVSLRKETQYF,1,0,1,1
TRBV11-2,TRBJ2-3,CASSPGNKSTDTQYF,1,0,1,1
TRBV5-5,TRBJ1-3,CASSPDIFPGNTIYF,1,0,1,1
TRBV6-2/3/5/6,TRBJ2-5,CASSPNGQIQETQYF,1,0,1,1
TRBV6-2/3/5/6,TRBJ1-2,CASSPTSSANYGYTF,1,0,1,1
TRBV7-3,TRBJ2-7,CASSPTGQGSFEQYF,1,0,1,1
TRBV7-9,TRBJ1-6,CASSRAGTGVSPLHF,1,0,1,1
TRBV11-1,TRBJ2-1,CASSQDRASYNEQFF,2,0,1,2
TRBV3-1,TRBJ1-2,CASSQIDRADYGYTF,1,0,1,1
TRBV3-1,TRBJ1-4,CASSQPGQGGEKLFF,1,0,1,1
TRBV4-2,TRBJ2-1,CASSQGWEGPNEQFF,1,0,1,1
TRBV14,TRBJ1-5,CASSQGPYSNQPQHF,1,5,2,6
TRBV3-1,TRBJ2-3,CASSQGGPPTDTQYF,1,0,1,1
TRBV3-1,TRBJ2-4,CASSQGKRQTGSRYF,2,0,1,2
TRBV4-2,TRBJ1-1,CASSQDLGQSSGAFF,1,0,1,1
TRBV3-1,TRBJ2-7,CASSQDGIPSYEQYF,1,0,1,1
TRBV3-1,TRBJ2-5,CASSQEILARETQYF,1,0,1,1
TRBV4-2,TRBJ2-1,CASSQETGIYNEQFF,1,0,1,1
TRBV9,TRBJ1-6,CASSVSGTDNSPLHF,1,0,1,1
TRBV9,TRBJ2-1,CASSVGGGTNNEQFF,1,0,1,1
TRBV9,TRBJ2-5,CASSVGLGARKTQYF,1,0,1,1
TRBV5-4,TRBJ2-2,CASSAAGSTTGELFF,1,0,1,1
TRBV9,TRBJ2-1,CASSADVLAGAEQFF,1,0,1,1
TRBV6-2/3/5/6,TRBJ2-5,CASSGLAGAQETQYF,1,0,1,1
TRBV5-6,TRBJ1-6,CASSMTGGRNSPLHF,1,0,1,1
TRBV7-2,TRBJ2-7,CASSTLAGGSYEQYF,1,0,1,1
TRBV11-1,TRBJ2-3,CASSNGAASTDTQYF,1,0,1,1
TRBV12-3/4,TRBJ1-3,CASRSTGPDGNTIYF,1,0,1,1
TRBV6-2/3/5/6,TRBJ1-2,CASRLDETGVYGYTF,1,0,1,1
TRBV11-1,TRBJ2-3,CASRPRVWVTDTQYF,1,0,1,1
TRBV6-2/3/5/6,TRBJ1-1,CASRPWGQINTEAFF,1,0,1,1
TRBV6-2/3/5/6,TRBJ2-7,CASRGFSRKGYEQYF,1,0,1,1
TRBV12-3/4,TRBJ2-2,CASNHGLARTGELFF,1,0,1,1
TRBV4-1,TRBJ1-1,CASTHHWVRNTEAFF,2,0,1,2
TRBV10-2,TRBJ2-3,CASSRLAGFTDTQYF,1,0,1,1
TRBV5-1,TRBJ2-7,CASSLYPGGRSEQYF,1,0,1,1
TRBV5-1,TRBJ1-1,CASSLGQPMNTEAFF,1,0,1,1
TRBV5-1,TRBJ2-5,CASSLEGTYRETQYF,1,0,1,1
TRBV5-1,TRBJ2-7,CASSLRGGLSYEQYF,1,0,1,1
TRBV5-1,TRBJ1-5,CASSWGQGINQPQHF,1,0,1,1
TRBV5-1,TRBJ2-7,CASSYHGQGDSEQYF,1,0,1,1
TRBV5-1,TRBJ1-6,CASSPRGGADSPLHF,1,0,1,1
TRBV4-1,TRBJ1-5,CASSQWVYSNQPQHF,1,2,2,3
TRBV4-1,TRBJ1-2,CASSQGWGTSYGYTF,1,0,1,1
TRBV4-1,TRBJ2-7,CASSQDQTGVYEQYF,1,0,1,1
TRBV4-1,TRBJ1-2,CASSQMGLLTYGYTF,1,0,1,1
TRBV5-1,TRBJ2-3,CASSISGGRGDTQYF,1,0,1,1
TRBV5-1,TRBJ2-3,CASSTGTGSTDTQYF,1,0,1,1
TRBV5-1,TRBJ2-1,CASRALQGAYNEQFF,1,0,1,1
TRBV20-1,TRBJ2-1,CSAAPTSGRQVEQFF,1,0,1,1
TRBV20-1,TRBJ2-1,CSADRDAPLDNEQFF,1,0,1,1
TRBV20-1,TRBJ2-7,CSARLLAGGGYEQYF,1,1,2,2
TRBV20-1,TRBJ2-7,CSARSPLAGENEQYF,1,0,1,1
TRBV20-1,TRBJ1-6,CSARVGQGINSPLHF,1,0,1,1
TRBV20-1,TRBJ2-7,CSARDLLAGAYEQYF,1,0,1,1
TRBV20-1,TRBJ2-1,CSARDRGGYRDEQFF,2,0,1,2
TRBV20-1,TRBJ1-4,CSARDPNRAAEKLFF,1,0,1,1
TRBV20-1,TRBJ2-1,CSALETSGRSNEQFF,1,0,1,1
TRBV20-1,TRBJ2-4,CSAPDTRLAKNIQYF,1,0,1,1
TRBV20-1,TRBJ2-7,CSARLGVAGTYEQYF,1,0,1,1
TRBV20-1,TRBJ1-5,CSASIRDSSYQPQHF,1,0,1,1
TRBV29-1,TRBJ2-1,CSVGQSEPNNNEQFF,1,0,1,1
TRBV29-1,TRBJ2-5,CSVESANLRIETQYF,1,0,1,1
TRBV29-1,TRBJ2-1,CRRKFTRSSYNEQFF,1,0,1,1
TRBV12-3/4,TRBJ2-3,SASSQRTGGSDTQYF,1,0,1,1
TRBV29-1,TRBJ2-1,SSVEEGLAGVNEQFF,1,0,1,1
TRBV30,TRBJ2-1,CAWEWGVAYNEQFF,1,0,1,1
TRBV30,TRBJ1-1,CAWSVVAIGSEAFF,1,0,1,1
TRBV10-3,TRBJ2-1,CAIGMSILGHEQFF,1,0,1,1
TRBV7-8,TRBJ1-5,CAITVLPSNQPQHF,1,0,1,1
TRBV24-1,TRBJ1-1,CATSDFRQNTEAFF,1,0,1,1
TRBV24-1,TRBJ1-5,CATSDFGVDQPQHF,1,0,1,1
TRBV24-1,TRBJ2-7,CATSDSTDSSEQYF,2,2,2,4
TRBV15,TRBJ1-5,CATSRDLRNQPQRF,1,0,1,1
TRBV19,TRBJ1-5,CASSLQGRDQPQHF,1,0,1,1
TRBV19,TRBJ2-7,CASSGGQKGGEQYF,1,0,1,1
TRBV19,TRBJ1-2,CASSIGQGRYGYTF,1,0,1,1
TRBV19,TRBJ2-1,CASSIGAGLNEQFF,1,0,1,1
TRBV19,TRBJ1-1,CASSSGVGNTEAFF,1,0,1,1
TRBV19,TRBJ2-4,CASRGPMGKNIQYF,1,0,1,1
TRBV19,TRBJ2-3,CASRNRGLADTQYF,1,0,1,1
TRBV19,TRBJ2-2,CASNTNLRTGELFF,1,0,1,1
TRBV5-5,TRBJ2-3,CASNGLAGTDTQYF,1,0,1,1
TRBV18,TRBJ2-7,CASSRNSGSYEQYF,1,1,2,2
TRBV7-2,TRBJ2-2,CASSGLAVTGELFF,1,0,1,1
TRBV18,TRBJ2-1,CASSTSGRYNEQFF,1,0,1,1
TRBV7-9,TRBJ1-1,CASWDRVYGTEAFF,1,0,1,1
TRBV7-2,TRBJ2-5,CASIPTSGNRGGYF,2,0,1,2
TRBV7-2,TRBJ1-2,CASTPGPDNYGYTF,1,0,1,1
TRBV9,TRBJ1-3,CASTPTGLGNTIYF,1,0,1,1
TRBV6-2/3/5/6,TRBJ1-2,CASSFTGTGYGYTF,1,1,2,2
TRBV12-3/4,TRBJ1-4,CASSFFATNEKLFF,1,0,1,1
TRBV12-3/4,TRBJ1-2,CASSLATENYGYTF,1,0,1,1
TRBV28,TRBJ2-7,CASSLASGSYEQYF,1,0,1,1
TRBV6-2/3/5/6,TRBJ2-4,CASSLDLESDIQYF,1,0,1,1
TRBV12-3/4,TRBJ2-7,CASSLEQGAYEQYF,1,0,1,1
TRBV27,TRBJ1-4,CASSLRGYNEKLFF,1,0,1,1
TRBV28,TRBJ1-2,CASSSSDGAYGYTF,1,0,1,1
TRBV6-2/3/5/6,TRBJ1-1,CASSSASMNTEAFF,1,0,1,1
TRBV27,TRBJ2-1,CASSSGITYNEQFF,1,0,1,1
TRBV5-4,TRBJ2-1,CASSSISSYNEQFF,1,0,1,1
TRBV27,TRBJ2-7,CASSWAGGTYEQYF,1,0,1,1
TRBV6-2/3/5/6,TRBJ1-1,CASSYGQGDTEAFF,1,0,1,1
TRBV6-2/3/5/6,TRBJ1-5,CASSYGRSNQPQHF,1,0,1,1
TRBV6-2/3/5/6,TRBJ1-1,CASSLEVGSTEAFF,1,0,1,1
TRBV6-2/3/5/6,TRBJ1-1,CASSPDQLGTEAFF,1,0,1,1
TRBV2,TRBJ2-2,CASSVETPTGELFF,1,0,1,1
TRBV25-1,TRBJ2-5,CASSEWGVQETQYF,1,0,1,1
TRBV6-1,TRBJ2-7,CASSEWGAVNEQYF,1,0,1,1
TRBV6-1,TRBJ1-6,CASSEDIDNSPLHF,1,0,1,1
TRBV9,TRBJ1-2,CASSTGANNYGYTF,1,0,1,1
TRBV5-6,TRBJ2-1,CASSFSGRTGEQFF,2,0,1,2
TRBV5-4,TRBJ1-2,CASSFGQGGHGYTF,1,0,1,1
TRBV7-2,TRBJ2-5,CASSLQRQQETQYF,1,0,1,1
TRBV5-5,TRBJ2-7,CASSLVWQNYEQYF,1,0,1,1
TRBV5-6,TRBJ1-5,CASSLEGGNQPQHF,1,1,2,2
TRBV5-5,TRBJ1-5,CASSLEGSHQPQHF,1,0,1,1
TRBV7-8,TRBJ2-3,CASSLVGVGDTQYF,1,0,1,1
TRBV11-2,TRBJ2-1,CASSLAGGRDEQFF,1,0,1,1
TRBV7-2,TRBJ2-7,CASSLGGPAYEQYF,1,0,1,1
TRBV7-8,TRBJ1-5,CASSLTFSNQPQHF,1,0,1,1
TRBV7-9,TRBJ2-7,CASSSGTGSYEQYF,1,0,1,1
TRBV5-6,TRBJ2-1,CASSWGLAGNEQFF,1,0,1,1
TRBV7-2,TRBJ2-3,CASSWGLAEDTQYF,1,0,1,1
TRBV3-1,TRBJ1-3,CASSLLGVGDTIYF,1,0,1,1
TRBV13,TRBJ2-5,CASSPYWMGETQYF,1,0,1,1
TRBV7-3,TRBJ2-7,CASSPYLAPYEQYF,1,0,1,1
TRBV7-9,TRBJ2-7,CASSPLGISYEQYF,1,0,1,1
TRBV7-8,TRBJ2-2,CASSPRTSSGELFF,1,0,1,1
TRBV6-2/3/5/6,TRBJ2-1,CASSPSGRYNEQFF,1,0,1,1
TRBV5-6,TRBJ1-3,CASSRDIRGNTIYF,1,0,1,1
TRBV5-5,TRBJ1-5,CASSRTSGNQPQHF,1,0,1,1
TRBV12-3/4,TRBJ1-2,CASSHGLANYGYTF,1,0,1,1
TRBV5-5,TRBJ1-1,CASSQSYRGTEAFF,2,1,2,3
TRBV4-2,TRBJ1-5,CASSQLVGNQPQHF,1,0,1,1
TRBV3-1,TRBJ1-4,CASSQRQGFEKLFF,1,0,1,1
TRBV4-2,TRBJ1-1,CASSQGKVNTEAFF,1,0,1,1
TRBV7-9,TRBJ1-1,CASSVLGGHTEAFF,1,0,1,1
TRBV9,TRBJ2-7,CASSVDAGTYEQYF,1,0,1,1
TRBV5-4,TRBJ2-1,CASSALAQKGLEFF,1,0,1,1
TRBV5-4,TRBJ2-1,CASSGWGGPGEQFF,1,0,1,1
TRBV7-6,TRBJ1-1,CASSNGQAHTEAFF,1,0,1,1
TRBV3-1,TRBJ2-7,CASRLTGGGYEQYF,1,0,1,1
TRBV27,TRBJ1-5,CASRKQYGNQPQHF,1,0,1,1
TRBV12-3/4,TRBJ2-1,CASNLQGFHNEQFF,1,0,1,1
TRBV7-2,TRBJ2-1,CAVAGGPSYNEQFF,2,0,1,2
TRBV2,TRBJ1-2,CTSSGTGNLYGYTF,1,0,1,1
TRBV5-1,TRBJ1-6,CASHRDGENSPLHF,1,0,1,1
TRBV5-1,TRBJ1-2,CASSLATGGSGYTF,1,0,1,1
TRBV5-1,TRBJ1-6,CASSLGHVRSPLHF,1,0,1,1
TRBV5-1,TRBJ2-5,CASSLVGGVETQYF,1,0,1,1
TRBV5-1,TRBJ1-1,CASSSRGPNTEAFF,1,0,1,1
TRBV5-1,TRBJ1-2,CASSPGGQGIGYTF,1,0,1,1
TRBV4-1,TRBJ1-1,CASSQQTANTEAFF,1,1,2,2
TRBV4-1,TRBJ2-5,CASSQGSSQETQYF,1,0,1,1
TRBV4-1,TRBJ1-2,CASSQESKGYGYTF,1,0,1,1
TRBV4-3,TRBJ2-2,CASSQRVATGELFF,2,0,1,2
TRBV5-1,TRBJ1-4,CASRTGERDEKLFF,1,0,1,1
TRBV20-1,TRBJ2-7,CSAPGDRVKDEQYF,1,0,1,1
TRBV20-1,TRBJ2-7,CSAAGTSRSYEQYF,1,0,1,1
TRBV20-1,TRBJ2-5,CSARLQGRQEAQYF,1,0,1,1
TRBV20-1,TRBJ2-3,CSANRDSSTDTQYF,1,0,1,1
TRBV20-1,TRBJ2-7,CSAPRGGRSYEQYF,1,0,1,1
TRBV20-1,TRBJ1-1,CSAQREGPNTEAFF,1,0,1,1
TRBV20-1,TRBJ2-3,CSGNQARGTDTQYF,1,0,1,1
TRBV29-1,TRBJ1-1,CSVLGGGGGTEAFF,1,0,1,1
TRBV29-1,TRBJ2-3,CSVVIAGSTDTQYF,1,1,2,2
TRBV29-1,TRBJ2-1,CSVVRTSGNNEQFF,1,0,1,1
TRBV29-1,TRBJ1-2,CSVAGTGAGYGYTF,1,0,1,1
TRBV29-1,TRBJ2-7,CSVALPDFPHEQYF,1,0,1,1
TRBV29-1,TRBJ2-7,CSVAGTRQAYEQYF,1,0,1,1
TRBV29-1,TRBJ2-1,CSVAGDELGDEQFF,1,0,1,1
TRBV29-1,TRBJ1-3,CSVDSGTKANTIYF,1,0,1,1
TRBV29-1,TRBJ2-1,CSVESVAGGNEQFF,1,0,1,1
TRBV29-1,TRBJ2-1,CSALVAGRYNEQFF,1,0,1,1
TRBV29-1,TRBJ1-3,CSAETALGGNTIYF,1,0,1,1
TRBV30,TRBJ2-5,CAWDGQEGETQYF,1,0,1,1
TRBV30,TRBJ1-1,CAWSGGTGTEAFF,1,0,1,1
TRBV30,TRBJ1-5,CAWSLGAGQPQHF,1,0,1,1
TRBV30,TRBJ2-1,CAWSPGGYNEQFF,1,0,1,1
TRBV10-3,TRBJ1-2,CAISGTGGNGYTF,1,0,1,1
TRBV19,TRBJ2-7,CATRDRTTYEQYF,1,0,1,1
TRBV19,TRBJ1-2,CASSAGQHYGYAF,1,0,1,1
TRBV19,TRBJ2-7,CASSIWGSYEQYF,1,0,1,1
TRBV19,TRBJ2-1,CASSIVPGGEQFF,1,0,1,1
TRBV7-9,TRBJ2-7,CASRTSGTYEQYF,1,0,1,1
TRBV18,TRBJ2-7,CASSPDSSYEQYF,1,0,1,1
TRBV7-9,TRBJ1-1,CASSGGGITEAFF,1,0,1,1
TRBV18,TRBJ1-1,CASSLGQGAEAFF,1,0,1,1
TRBV18,TRBJ2-7,CASSPAGNYEQYF,1,1,2,2
TRBV18,TRBJ1-2,CASSPKQKHGYTF,1,0,1,1
TRBV18,TRBJ2-1,CASYSTTGNEQFF,1,0,1,1
TRBV6-2/3/5/6,TRBJ1-2,CASTWDREDGYTF,1,0,1,1
TRBV4-2,TRBJ2-3,CASTPSETGTQYF,1,1,2,2
TRBV7-2,TRBJ1-5,CASTMGQNQPQHF,1,0,1,1
TRBV12-3/4,TRBJ1-2,CASSFTVNYGYTF,1,1,2,2
TRBV27,TRBJ2-7,CASSFVATYEQYF,1,0,1,1
TRBV27,TRBJ2-7,CASSLSTRYEQYF,1,0,1,1
TRBV12-3/4,TRBJ2-5,CASSLAFVGTQYF,1,0,1,1
TRBV12-3/4,TRBJ2-5,CASSLALQETQYF,1,0,1,1
TRBV12-3/4,TRBJ2-5,CASSSPARETQYF,1,0,1,1
TRBV6-2/3/5/6,TRBJ2-5,CASSSGPQETQYF,1,0,1,1
TRBV6-2/3/5/6,TRBJ2-1,CASSWTSVNEQFF,1,1,2,2
TRBV6-2/3/5/6,TRBJ1-2,CASSYVRNYGYTF,1,0,1,1
TRBV27,TRBJ1-1,CASSPSGGTEAFF,1,0,1,1
TRBV6-2/3/5/6,TRBJ2-1,CASSPPVNNEQFF,1,0,1,1
TRBV6-1,TRBJ2-1,CASSAPVGNEQFF,1,0,1,1
TRBV14,TRBJ1-1,CASSATLNTEAFF,1,0,1,1
TRBV6-4,TRBJ1-1,CASSDYPDREAFF,1,0,1,1
TRBV11-2,TRBJ2-7,CASSFPTSYEQYF,1,0,1,1
TRBV7-6,TRBJ1-2,CASSLDPEGGYTF,2,0,1,2
TRBV7-6,TRBJ2-1,CASSLVLANEQFF,1,0,1,1
TRBV7-9,TRBJ1-2,CASSLVGVGGYTF,1,0,1,1
TRBV7-9,TRBJ1-1,CASSLARSTEAFF,1,0,1,1
TRBV7-8,TRBJ2-7,CASSLAEDYEQYF,1,0,1,1
TRBV7-2,TRBJ2-1,CASSSPLLPEQFF,1,0,1,1
TRBV7-9,TRBJ2-1,CASSSGGGSEQFF,1,0,1,1
TRBV5-5,TRBJ2-5,CASSWGGTETQYF,2,2,2,4
TRBV7-2,TRBJ2-1,CASSLRQHNEQFF,1,0,1,1
TRBV6-4,TRBJ2-3,CASSPPSADTQYF,1,0,1,1
TRBV9,TRBJ1-1,CASSPNQAIEAFF,1,0,1,1
TRBV11-1,TRBJ2-5,CASSQPGWETQYF,1,0,1,1
TRBV3-1,TRBJ1-2,CASSQGNYYGYTF,1,0,1,1
TRBV4-2,TRBJ1-1,CASSQERNTEAFF,1,0,1,1
TRBV7-9,TRBJ1-1,CASSVRTDLLAFF,1,0,1,1
TRBV9,TRBJ1-2,CASSAGSRVRYTF,1,0,1,1
TRBV7-3,TRBJ2-3,CASSGGLTDTQYF,1,0,1,1
TRBV5-8,TRBJ1-4,CASRRRFNEKLFF,1,0,1,1
TRBV6-4,TRBJ1-1,CASRISGGTEAFF,1,0,1,1
TRBV6-4,TRBJ2-7,CASRTTGEREQYF,1,0,1,1
TRBV5-4,TRBJ2-2,CASRGTNTGELFF,1,0,1,1
TRBV2,TRBJ2-1,CASKASGQDEQFF,1,0,1,1
TRBV6-2/3/5/6,TRBJ2-5,CASKASGMETQYF,1,0,1,1
TRBV5-1,TRBJ2-1,CASSLGNPTEQFF,1,0,1,1
TRBV4-3,TRBJ1-1,CASSRDRGREAFF,1,0,1,1
TRBV4-3,TRBJ2-2,CASSQHGTGELFF,1,0,1,1
TRBV4-3,TRBJ2-7,CASSQAVGYEQYF,1,0,1,1
TRBV4-3,TRBJ2-7,CASSQDLSGEQYF,1,0,1,1
TRBV4-1,TRBJ2-1,CASSQNKNNEQFF,1,0,1,1
TRBV4-1,TRBJ1-2,CASSKGLTGGYTF,1,0,1,1
TRBV5-1,TRBJ1-2,CASRPDRGGGYTF,1,0,1,1
TRBV4-1,TRBJ1-6,CASRDRGNSPLHF,1,0,1,1
TRBV20-1,TRBJ2-7,CSVAPDISYEQYF,1,0,1,1
TRBV20-1,TRBJ1-2,CSAWGEVNYGYTF,1,0,1,1
TRBV20-1,TRBJ1-5,CSAPAQRNQPQHF,1,0,1,1
TRBV20-1,TRBJ2-3,CSAPDWGPDTQYF,1,0,1,1
TRBV20-1,TRBJ1-3,CSARAAGGNTIYF,1,0,1,1
TRBV20-1,TRBJ2-1,CSARDYPYNEQFF,1,0,1,1
TRBV20-1,TRBJ2-1,CSAPGLAGNEQFF,1,0,1,1
TRBV29-1,TRBJ2-1,CSVVRLAGADQFF,1,0,1,1
TRBV29-1,TRBJ2-1,CSVEIKREYEQFF,1,0,1,1
TRBV29-1,TRBJ2-3,CSVVGTLSDTQYF,1,0,1,1
TRBV20-1,TRBJ2-7,CSATGTGEYEQYF,1,0,1,1
TRBV29-1,TRBJ2-1,CSISRGSANEQFF,1,0,1,1
TRBV2,TRBJ2-5,CAGSGGWETQYF,1,0,1,1
TRBV7-2,TRBJ2-7,CATGTNSYEQYF,1,0,1,1
TRBV12-3/4,TRBJ1-5,CASTGGNQPQHF,1,0,1,1
TRBV27,TRBJ2-7,CASSFGATEQYF,1,1,2,2
TRBV6-2/3/5/6,TRBJ1-1,CASSPLNTEAFF,1,0,1,1
TRBV6-1,TRBJ2-7,CASSAGSYEQYF,1,0,1,1
TRBV6-4,TRBJ2-5,CASSAESQTQYF,1,0,1,1
TRBV12-3/4,TRBJ1-1,CASSTGFTEAFF,1,0,1,1
TRBV4-1,TRBJ2-5,CASSRDQETQYF,2,0,1,2
TRBV6-2/3/5/6,TRBJ2-4,CASSRPKNIQYF,1,0,1,1
TRBV7-2,TRBJ2-1,CASSFPSGEQFF,1,0,1,1
TRBV7-9,TRBJ2-2,CASSLDTGELFF,1,0,1,1
TRBV7-9,TRBJ2-1,CASSLRGLREFF,1,0,1,1
TRBV7-6,TRBJ2-1,CASSLRGSEQFF,1,0,1,1
TRBV7-9,TRBJ2-1,CASSLESHEQFF,1,1,2,2
TRBV7-2,TRBJ2-1,CASSLGGPEQFF,2,6,2,8
TRBV3-1,TRBJ2-5,CASSQLQETQYF,1,0,1,1
TRBV7-9,TRBJ2-7,CASSGRSYEQYF,1,0,1,1
TRBV7-8,TRBJ1-1,CASSRGNTEAFF,1,2,2,3
TRBV6-2/3/5/6,TRBJ2-7,CASSRQGYEQYF,1,0,1,1
TRBV10-3,TRBJ2-7,CASKREGREQYF,1,0,1,1
TRBV4-1,TRBJ2-3,CASSQVWDTQYF,2,0,1,2
TRBV29-1,TRBJ1-2,CSVGRVGEGYTF,1,0,1,1
TRBV29-1,TRBJ2-7,CSVELQAYEQYF,1,0,1,1
TRBV29-1,TRBJ1-2,CSVEPNTPTITF,2,0,1,2
TRBV29-1,TRBJ1-3,CSVEMDRNTIYF,1,0,1,1
TRBV29-1,TRBJ1-2,CSVRDGAYGYTF,1,0,1,1
TRBV29-1,TRBJ2-2,CSVHRGTGELFF,1,0,1,1
TRBV29-1,TRBJ1-1,CSALLGNTEAFF,1,0,1,1
TRBV29-1,TRBJ1-4,CSAGATNEKLFF,1,0,1,1
TRBV29-1,TRBJ2-3,CSAERGKDTQYF,1,0,1,1
TRBV29-1,TRBJ2-1,ARERVSYNEQFF,1,0,1,1
TRBV30,TRBJ1-1,CAWFSGAEAFF,1,0,1,1
TRBV19,TRBJ1-1,CASSTGTEAFF,1,0,1,1
TRBV18,TRBJ2-7,CASSPGDEQYF,2,3,2,5
TRBV12-3/4,TRBJ2-1,CASSSGDEQFF,1,1,2,2
TRBV7-2,TRBJ2-7,CASSQSYEQYF,1,0,1,1
TRBV6-2/3/5/6,TRBJ1-1,CASSSEDEAFF,1,0,1,1
TRBV3-1,TRBJ1-2,CASSQSHGYTF,1,0,1,1
TRBV7-2,TRBJ2-3,CASSATDTQYF,2,0,1,2
TRBV12-3/4,TRBJ2-2,CASRLTGELFF,1,0,1,1
TRBV6-2/3/5/6,TRBJ1-2,CASRNIYGYTF,1,0,1,1
TRBV2,TRBJ2-7,CAGGDSYEQYF,1,0,1,1
TRBV4-1,TRBJ2-1,CASSRGSGQFF,1,0,1,1
TRBV20-1,TRBJ1-1,CSAREISEAFF,1,0,1,1
TRBV29-1,TRBJ2-5,CSVDRVETQYF,1,0,1,1
TRBV29-1,TRBJ1-2,CSARGDYGYTF,1,0,1,1
TRBV29-1,TRBJ1-4,CSGWANEKLFF,1,0,1,1
TRBV20-1,TRBJ2-3,CSARDGAQYF,1,0,1,1
TRBV7-9,TRBJ1-5,CASRPLPGPGNQPQHF,1,0,1,1
TRBV20-1,TRBJ1-6,CSARPLDRGNSPLHF,1,0,1,1
TRBV7-2,TRBJ1-1,CACSLTGRNTEAFF,1,0,1,1
TRBV30,TRBJ1-1,CAWSVSSKNTEAFF,2,0,1,2
TRBV19,TRBJ2-2,CASSLRTFTGELFF,1,1,2,2
TRBV4-2,TRBJ2-2,CASSQHQGGLAGGNTGELFF,1,0,1,1
TRBV9,TRBJ2-1,CASSTTRVQSSYNEQFF,1,0,1,1
TRBV4-3,TRBJ2-5,CASSQVLWGGGETQYF,1,0,1,1
TRBV2,TRBJ1-4,CASITQGNAFGKLFF,1,0,1,1
TRBV4-2,TRBJ1-5,CASSQEVGGNQPQHF,1,0,1,1
TRBV12-3/4,TRBJ2-7,CASSLVGSIGEQYF,1,0,1,1
TRBV18,TRBJ2-3,CASSKAGLDTQYF,1,0,1,1
TRBV5-4,TRBJ2-1,CASSLSGGASAEVF,1,0,1,1
TRBV11-2,TRBJ2-7,CASSLGLDGESYEQYF,1,0,1,1
TRBV3-1,TRBJ1-1,CASSDLGGFEAFF,1,0,1,1
TRBV2,TRBJ2-4,CATAPGLSWRAKNIQYF,1,0,1,1
TRBV5-6,TRBJ2-5,CASSLIGAGKQETQYF,1,0,1,1
TRBV7-9,TRBJ2-1,CASSSQAGGHSNEQFF,1,0,1,1
TRBV29-1,TRBJ2-6,CSVEEGRTQKLTPHMVGANVLTF,1,0,1,1
TRBV29-1,TRBJ2-5,CSVEDWGAGHTTGTTQETQYF,1,0,1,1
TRBV6-2/3/5/6,TRBJ1-4,CASSLSGTGQGPATNEKLFF,1,0,1,1
TRBV5-6,TRBJ2-1,CASSLESSGRAMASYNEQFF,1,0,1,1
TRBV19,TRBJ2-2,CASTPGLAGGRPNTGELFF,1,0,1,1
TRBV12-3/4,TRBJ2-3,CASTPVGASGGIFTDTQYF,1,0,1,1
TRBV27,TRBJ1-2,CASTPRRGPGEDRVRGYTF,1,0,1,1
TRBV6-2/3/5/6,TRBJ2-1,CASSFGSARAGSPQSEQFF,1,0,1,1
TRBV12-3/4,TRBJ1-5,CASSLGGELLSAGNQPQHF,1,0,1,1
TRBV6-2/3/5/6,TRBJ2-3,CASSYTNYRLAGVTDTQYF,1,0,1,1
TRBV7-2,TRBJ1-5,CASSLWGGGGPLLNQPQHF,1,0,1,1
TRBV4-2,TRBJ2-3,CASSQQTTSGGDSTDTQYF,1,0,1,1
TRBV3-1,TRBJ2-2,CASSQVGLAGLLNTGELFF,1,0,1,1
TRBV4-1,TRBJ2-7,CASSQGYGTGGTASYEQYF,1,0,1,1
TRBV29-1,TRBJ2-1,CSAGDLGTSGTRSYNEQFF,1,0,1,1
TRBV3-1,TRBJ2-1,RASSQDLSTSGGALNEQFF,1,0,1,1
TRBV12-5,TRBJ1-5,CASAVSGGYPRWDQPQHF,1,0,1,1
TRBV12-5,TRBJ2-1,CASGLKGLAGVGYNEQFF,1,0,1,1
TRBV19,TRBJ2-3,CASSPRIAGGIGTDTQYF,1,0,1,1
TRBV19,TRBJ2-1,CASSRNPTGASYYNEQFF,1,0,1,1
TRBV28,TRBJ2-4,CASSLFPGADLAKNIQYF,1,0,1,1
TRBV6-2/3/5/6,TRBJ1-1,CASSYSLNWGVRRTEAFF,1,0,1,1
TRBV6-2/3/5/6,TRBJ2-7,CASSYSTEWTEIDYEQYF,1,0,1,1
TRBV6-2/3/5/6,TRBJ2-1,CASSYTRGLAGRTDEQFF,1,0,1,1
TRBV6-2/3/5/6,TRBJ1-1,CASSLGTGVTVLNTEAFF,1,0,1,1
TRBV6-1,TRBJ2-5,CASSAGTSGSDPSETQYF,1,0,1,1
TRBV6-1,TRBJ2-1,CASSEWEELTSSYNEQFF,1,0,1,1
TRBV6-1,TRBJ1-5,CASSEAAGRTYSNQPQHF,1,0,1,1
TRBV7-2,TRBJ2-3,CASSLRTSGGAGADTQYF,1,0,1,1
TRBV7-8,TRBJ2-1,CASSLGVGGATLYNEQFF,1,0,1,1
TRBV6-2/3/5/6,TRBJ2-7,CASSSTPKTSGRYYEQYF,1,0,1,1
TRBV5-4,TRBJ2-1,CASSYPQSGLAGYNEQFF,1,0,1,1
TRBV5-8,TRBJ2-3,CASSPPGGSRGKTDTQYF,1,0,1,1
TRBV5-4,TRBJ1-4,CASSPGQGAELGNEKLFF,1,0,1,1
TRBV3-1,TRBJ2-7,CASSQSELAGGPAYEQYF,1,0,1,1
TRBV4-2,TRBJ2-6,CASSQLRTAGAGANVLTF,1,0,1,1
TRBV3-1,TRBJ2-6,CASSQAAGGFSGANVLTF,1,0,1,1
TRBV6-2/3/5/6,TRBJ2-2,CASSTTSGRAEGTGELFF,1,0,1,1
TRBV6-2/3/5/6,TRBJ2-3,CASRRPVAGTGDTGTQYF,1,0,1,1
TRBV4-1,TRBJ1-4,CASTKKGTLGITNEKLFF,1,0,1,1
TRBV10-2,TRBJ2-3,CASSEPPLAGGGSDTQYF,1,0,1,1
TRBV5-1,TRBJ2-1,CASSLVSPTGSSYNEQFF,1,0,1,1
TRBV5-1,TRBJ1-1,CASSLSAGTGRATTEAFL,1,0,1,1
TRBV24-1,TRBJ1-4,CATSDDLPGLEIEKLFF,1,0,1,1
TRBV19,TRBJ1-2,CASSMRLPREGVYGYTF,1,0,1,1
TRBV6-2/3/5/6,TRBJ2-1,CASSFHPTSTKRGEQFF,1,0,1,1
TRBV6-2/3/5/6,TRBJ2-5,CASSYSIGRVNQETQYF,1,0,1,1
TRBV6-2/3/5/6,TRBJ2-3,CASSYKGLAGGADTQYF,1,0,1,1
TRBV6-2/3/5/6,TRBJ1-5,CASSHGQGQGKGQPQHF,1,0,1,1
TRBV6-1,TRBJ2-7,CASSELFGLAGTYEQYF,1,0,1,1
TRBV6-2/3/5/6,TRBJ2-1,CASSTQRQGRSSNEQFF,1,0,1,1
TRBV7-6,TRBJ2-7,CASSLGTGSFGSYEQYF,1,0,1,1
TRBV7-8,TRBJ1-6,CASSLVGGGEYNSPLHF,1,1,2,2
TRBV7-2,TRBJ1-5,CASSLARGTGRDQPQHF,1,0,1,1
TRBV5-5,TRBJ2-5,CASSSGITVKVQETQYF,1,1,2,2
TRBV5-4,TRBJ2-1,CASSPGQGLAEINEQFF,1,0,1,1
TRBV3-1,TRBJ2-2,CASSPGLAGMNTGELFF,1,0,1,1
TRBV3-1,TRBJ2-5,CASSQVSLVWKQETQYF,1,0,1,1
TRBV3-1,TRBJ2-6,CASSQVPGTGGANVLTF,1,0,1,1
TRBV3-1,TRBJ2-5,CASSQALRLAGLETQYF,1,0,1,1
TRBV3-1,TRBJ2-7,CASSQGRLASGGPEQYF,1,0,1,1
TRBV3-1,TRBJ2-4,CASSQDSGMQSKNIQYF,1,0,1,1
TRBV3-1,TRBJ1-5,CASSQDVAGSSNQPQHF,1,0,1,1
TRBV4-2,TRBJ2-6,CASSQDAGHTGANVLTF,1,0,1,1
TRBV14,TRBJ2-1,CASSQDILAGGSNEQFF,1,0,1,1
TRBV4-2,TRBJ2-3,CASSQEGYTSLTDTQYF,1,0,1,1
TRBV14,TRBJ2-2,CASSQRTGTGGTGELFF,1,1,2,2
TRBV9,TRBJ2-1,CASSVGTQAGPYNEQFF,1,0,1,1
TRBV5-5,TRBJ1-6,CASSTVDRSSYNSPLHF,1,0,1,1
TRBV6-2/3/5/6,TRBJ1-5,CASSKRHGPGGNQPQHF,1,0,1,1
TRBV6-2/3/5/6,TRBJ1-2,CASRGLAGSPANYGYTF,1,0,1,1
TRBV5-6,TRBJ2-4,CASRINLAGRAKNIQYF,1,0,1,1
TRBV6-2/3/5/6,TRBJ1-2,CASKTRIRDRGDYGYTF,1,0,1,1
TRBV7-9,TRBJ2-1,CTSSSHRGLAGVNEQFF,1,0,1,1
TRBV5-1,TRBJ1-1,CASSLELVTGLGTEAFF,1,0,1,1
TRBV5-1,TRBJ1-2,CASSLEPQGDARYGYTF,1,0,1,1
TRBV5-1,TRBJ1-1,CASSLREQPIMNTEAFF,1,0,1,1
TRBV5-1,TRBJ2-1,CASSSPSQQLSYNEQFF,1,0,1,1
TRBV5-1,TRBJ2-3,CASSLRLAGAATDTQYF,1,0,1,1
TRBV4-1,TRBJ1-2,CASSHQPRIQGSKGYTF,1,0,1,1
TRBV4-1,TRBJ2-3,CASSQTTSGGAPDTQYF,1,0,1,1
TRBV4-3,TRBJ2-1,CASSQDLSSGRTHEQFY,1,0,1,1
TRBV4-3,TRBJ1-3,CASSQDPPGSSGNTIYF,1,0,1,1
TRBV4-3,TRBJ2-1,CASSQDITSGRKNEQFF,1,0,1,1
TRBV5-1,TRBJ2-5,CASNPAGGPGFQETQYF,1,1,2,2
TRBV20-1,TRBJ2-3,CSVTSGRTYRPRDTQYF,1,0,1,1
TRBV20-1,TRBJ1-3,CSARGMGQPSSGNTIYF,1,0,1,1
TRBV20-1,TRBJ2-1,CSARDLGAGGLRGEQFF,1,0,1,1
TRBV29-1,TRBJ2-3,CSVEDPTGTEFTDTQYF,1,0,1,1
TRBV29-1,TRBJ2-5,CSVLGLAGEPSQETQYF,1,0,1,1
TRBV7-3,TRBJ2-1,RASSFQGDLYYYNEQFF,1,0,1,1
TRBV12-5,TRBJ2-4,CASGLVLAGSKNIQYF,1,0,1,1
TRBV19,TRBJ2-1,CASQEEGLAGGDEQFF,1,0,1,1
TRBV30,TRBJ2-7,CAWSGLGSGRTYEQYF,1,0,1,1
TRBV30,TRBJ1-5,CAWSTRGRGSGQPQHF,1,0,1,1
TRBV10-3,TRBJ2-7,CAISESGRRGSYEQYF,1,0,1,1
TRBV15,TRBJ2-5,CATSRDFRDSRETQYF,1,0,1,1
TRBV19,TRBJ2-2,CASSFVWGSETGELFF,1,0,1,1
TRBV19,TRBJ1-1,CASSAGTVKVNTEAFF,1,0,1,1
TRBV19,TRBJ2-3,CASSIGLAGPLDTQYF,1,0,1,1
TRBV19,TRBJ2-1,CASSIVAGGGDNEQFF,1,0,1,1
TRBV19,TRBJ2-1,CASSTPGGGRGNEQFF,2,0,1,2
TRBV18,TRBJ1-1,CASSPVTGGPHTEAFF,1,0,1,1
TRBV6-2/3/5/6,TRBJ2-1,CASPGLAVNSYNEQFF,1,0,1,1
TRBV6-2/3/5/6,TRBJ2-1,CASTNRGYPNTNEQFF,1,0,1,1
TRBV12-3/4,TRBJ1-2,CASTNLGPTGNYGYTF,1,0,1,1
TRBV12-3/4,TRBJ2-3,CASSFLLAGGGDTQYF,1,1,2,2
TRBV12-3/4,TRBJ2-7,CASSLPVGQGHYEQYF,1,0,1,1
TRBV12-3/4,TRBJ2-5,CASSLWASSTQETQYF,1,0,1,1
TRBV28,TRBJ1-2,CASSLPGTGGFYGYTF,1,0,1,1
TRBV6-2/3/5/6,TRBJ1-1,CASSYSWTGGKNEAFF,1,0,1,1
TRBV6-2/3/5/6,TRBJ2-5,CASSYSPSGYQETQYF,1,0,1,1
TRBV6-2/3/5/6,TRBJ2-7,CASSYSASPLPYEQYF,1,0,1,1
TRBV6-2/3/5/6,TRBJ1-1,CASSYLLTGRGTEAFF,1,0,1,1
TRBV2,TRBJ1-5,CASSEEFPRGYQPQHF,1,1,2,2
TRBV6-1,TRBJ2-2,CASSKMQGANTGELFF,1,0,1,1
TRBV13,TRBJ2-4,CASSFAKQGAKNIQYF,1,0,1,1
TRBV5-4,TRBJ2-2,CASSFGAGANTGELFF,1,0,1,1
TRBV5-6,TRBJ2-1,CASSLAGGAAYNEQFF,1,0,1,1
TRBV7-3,TRBJ2-5,CASSLGLAGAQETQYF,1,0,1,1
TRBV7-9,TRBJ2-5,CASSLGTGGLFETQYF,1,0,1,1
TRBV5-5,TRBJ2-2,CASSLRQGMNTGELFF,1,0,1,1
TRBV7-9,TRBJ1-5,CASSLATGYSNQPQHF,1,0,1,1
TRBV7-8,TRBJ2-3,CASSLAIMAITDTQYF,1,0,1,1
TRBV7-9,TRBJ2-3,CASSLGTGLYADTQYF,1,0,1,1
TRBV9,TRBJ2-7,CASSLGLAGGTYEQYF,1,0,1,1
TRBV11-2,TRBJ2-2,CASSLDPGGDTGELFF,1,0,1,1
TRBV7-2,TRBJ2-1,CASSLEWDRAYNEQFF,1,0,1,1
TRBV7-6,TRBJ2-7,CASSLETGFNSYEQYF,1,0,1,1
TRBV7-9,TRBJ2-1,CASSSTGTSVSGEQFF,1,0,1,1
TRBV5-6,TRBJ2-1,CASSSPSGRTYNEQFF,1,2,2,3
TRBV5-6,TRBJ2-3,CASSSGTGASTDTQYF,1,0,1,1
TRBV11-3,TRBJ2-5,CASSSGRTTNQETQYF,1,0,1,1
TRBV7-6,TRBJ2-7,CASSSDGGVGSYEQYF,1,0,1,1
TRBV9,TRBJ2-1,CASSSFAGSSYNEQFF,1,0,1,1
TRBV7-2,TRBJ1-1,CASSSFRGPGDTEAFF,1,0,1,1
TRBV7-9,TRBJ1-6,CASSSPGSSYNSPLHF,1,0,1,1
TRBV6-2/3/5/6,TRBJ2-7,CASSSRGGLAAYEQYF,1,0,1,1
TRBV11-2,TRBJ2-7,CASSSLSGTRPYEQYF,1,0,1,1
TRBV5-5,TRBJ2-3,CASSWGDSHQGVTQYF,1,0,1,1
TRBV7-2,TRBJ2-3,CASSYLPSGRTDTQYF,1,0,1,1
TRBV5-6,TRBJ2-1,CASSLSASGDYNEQFF,1,0,1,1
TRBV4-2,TRBJ2-7,CASSLSLAGDTYEQYF,1,0,1,1
TRBV7-2,TRBJ2-3,CASSLPVAGDSDTQYF,1,0,1,1
TRBV5-1,TRBJ2-3,CASSPGLAGGSDTQYF,1,1,2,2
TRBV9,TRBJ1-3,CASSPHRGNRGNTIYF,1,0,1,1
TRBV3-1,TRBJ1-2,CASSPGQGEYLWSYTF,1,0,1,1
TRBV3-1,TRBJ2-5,CASSPEGGRAGETQYF,1,0,1,1
TRBV7-9,TRBJ2-3,CASSPTSGRSTDTQYF,1,0,1,1
TRBV6-2/3/5/6,TRBJ1-6,CASSPRQGGDNSPLHF,1,0,1,1
TRBV5-6,TRBJ2-1,CASSPRRGGLYNEQFF,1,0,1,1
TRBV5-6,TRBJ2-7,CASSRRSGTSFYEQYF,1,0,1,1
TRBV4-2,TRBJ1-2,CASSQVSGQGTYGYTF,1,0,1,1
TRBV3-1,TRBJ2-7,CASSQGVIPIAYEQYF,1,0,1,1
TRBV4-2,TRBJ2-4,CASSQDVAGGQDIQYF,1,0,1,1
TRBV4-2,TRBJ2-1,CASSQDRSSGYNEQFF,1,0,1,1
TRBV4-2,TRBJ1-4,CASSQDRGRGNEKLFF,1,0,1,1
TRBV7-9,TRBJ2-5,CASSVSGQGAGETQYF,1,0,1,1
TRBV9,TRBJ2-5,CASSVGGAGGQETQYF,1,0,1,1
TRBV7-2,TRBJ2-7,CASSARVGDVRHEQYF,1,0,1,1
TRBV7-6,TRBJ2-7,CASSASSGRPFYEQYF,1,0,1,1
TRBV9,TRBJ1-2,CASSISQGTRGAGYTF,1,1,2,2
TRBV7-2,TRBJ2-1,CASSKRTSAIYNEQFF,1,0,1,1
TRBV7-2,TRBJ2-7,CASSKEGVGLRDEQYF,1,0,1,1
TRBV12-3/4,TRBJ2-1,CASRRGGVSAYNEQFF,1,0,1,1
TRBV4-1,TRBJ1-5,CASSLGLGRSNQPQHF,1,0,1,1
TRBV10-2,TRBJ2-1,CASSESGQASYNEQFF,1,0,1,1
TRBV10-2,TRBJ2-3,CASSESRTSGIDTQYF,1,0,1,1
TRBV5-1,TRBJ2-1,CASSFIARGGYNEQFF,1,0,1,1
TRBV5-1,TRBJ1-6,CASSFGPNQGNSPLHF,1,0,1,1
TRBV5-1,TRBJ2-1,CASSLVPDLAWNEQFF,1,0,1,1
TRBV5-1,TRBJ2-3,CASSLESTGATDTQYF,1,0,1,1
TRBV5-1,TRBJ2-2,CASSWDPGRDTGELFF,1,0,1,1
TRBV4-1,TRBJ1-4,CASSLGQGAVMAKLFF,1,0,1,1
TRBV4-1,TRBJ2-5,CASSLGLAGRRETQYF,1,0,1,1
TRBV4-3,TRBJ2-7,CASSPTPGQGTFEQYF,1,0,1,1
TRBV4-1,TRBJ2-1,CASSHIAGITTNEQFF,1,0,1,1
TRBV4-1,TRBJ2-3,CASSQQQGSVTDTQYF,1,0,1,1
TRBV4-1,TRBJ2-7,CASSQGSGTGAYEQYF,1,0,1,1
TRBV4-1,TRBJ1-1,CASSQDPQTGGTEAFF,1,0,1,1
TRBV4-1,TRBJ2-1,CASSQDRGTSGNEQFF,1,1,2,2
TRBV4-1,TRBJ2-1,CASSQEMPPSYNEQFF,1,0,1,1
TRBV5-1,TRBJ1-6,CASSVSGQGGNSPLHF,1,0,1,1
TRBV20-1,TRBJ1-6,CSAPIIGSSYNSPLHF,1,0,1,1
TRBV20-1,TRBJ2-1,CSARYMGTSGYNEQFF,1,0,1,1
TRBV20-1,TRBJ2-5,CSARLPTSGSGETQYF,1,0,1,1
TRBV20-1,TRBJ2-6,CSARLGQISGANVLTF,1,0,1,1
TRBV20-1,TRBJ2-3,CSARPSTSGLTDTQYF,1,0,1,1
TRBV20-1,TRBJ2-4,CSARDRGSRAKNIQYF,1,0,1,1
TRBV20-1,TRBJ2-1,CSAINPGQGTYNEQFF,1,0,1,1
TRBV20-1,TRBJ2-5,CSARNPSGGRKETQYF,1,0,1,1
TRBV29-1,TRBJ2-3,CSVEGSTGTNPDTQYF,1,0,1,1
TRBV29-1,TRBJ1-2,CSVETRTGKANHGYTF,1,0,1,1
TRBV29-1,TRBJ2-3,CSAISGGGQGSDTQYF,1,0,1,1
TRBV29-1,TRBJ2-2,CSGGAGGPWNTGELFF,1,0,1,1
TRBV29-1,TRBJ1-2,CSDETRTGKANYGYTF,1,0,1,1
TRBV12-3/4,TRBJ1-5,CAGSGKDRERQPQHF,1,0,1,1
TRBV7-9,TRBJ2-5,CAIHSPRVGQVTQYF,1,0,1,1
TRBV10-3,TRBJ2-1,CAISRLAEAYNEQFF,1,0,1,1
TRBV10-3,TRBJ2-1,CAIRRPGLSYNEQFF,1,0,1,1
TRBV11-3,TRBJ2-2,CATLREDSNTGELFF,1,0,1,1
TRBV15,TRBJ2-3,CATGHGLAGTDTQYF,1,0,1,1
TRBV24-1,TRBJ2-3,CATSDEMDSTDTQYF,1,0,1,1
TRBV24-1,TRBJ2-1,CATSESGSPSGEQFF,1,0,1,1
TRBV15,TRBJ1-6,CATSRDYSGNSPLHF,1,0,1,1
TRBV15,TRBJ2-5,CATSRETGGPETQYF,1,0,1,1
TRBV19,TRBJ1-6,CASSFRRNERFALHF,1,0,1,1
TRBV19,TRBJ1-5,CASSSTTRSNQPQHF,1,0,1,1
TRBV19,TRBJ1-6,CASSPGGAYNSPLHF,1,0,1,1
TRBV19,TRBJ1-5,CASSMWDSYNQPQHF,1,0,1,1
TRBV19,TRBJ1-3,CASSMVWKGRNTIYF,1,0,1,1
TRBV19,TRBJ1-4,CASSIVGGTNEKLFF,1,0,1,1
TRBV19,TRBJ2-2,CASRPPRVDTGELFF,1,0,1,1
TRBV18,TRBJ2-1,CASSPTGNVYNEQFF,1,0,1,1
TRBV19,TRBJ1-2,CASRDSISAGYGYSF,1,0,1,1
TRBV7-9,TRBJ2-3,CASAKRGPSTDTQYF,1,0,1,1
TRBV12-3/4,TRBJ2-3,CASMPAGRRTDTQYF,1,0,1,1
TRBV9,TRBJ2-3,CASTLGEGWTDTQYF,1,0,1,1
TRBV5-6,TRBJ1-2,CASTPGQGLLYGYTF,1,0,1,1
TRBV7-9,TRBJ2-3,CASTRRGEDTDTQYF,1,0,1,1
TRBV12-3/4,TRBJ1-5,CASSFGGIGSQPQHF,1,0,1,1
TRBV12-3/4,TRBJ2-7,CASSFGGRPSYEQYF,1,0,1,1
TRBV6-2/3/5/6,TRBJ2-5,CASSFLLAGEETQYF,1,0,1,1
TRBV27,TRBJ2-1,CASSLLRGLQDEQFF,1,0,1,1
TRBV25-1,TRBJ2-1,CASSLGRGRVNEQFF,1,0,1,1
TRBV6-2/3/5/6,TRBJ2-3,CASSLNGRAADTQYF,1,0,1,1
TRBV28,TRBJ2-7,CASSLLAAAFYEQYF,1,2,2,3
TRBV28,TRBJ2-5,CASSLRTGGTETQYF,1,0,1,1
TRBV12-3/4,TRBJ1-2,CASSLAPDSNYGYTF,1,0,1,1
TRBV6-2/3/5/6,TRBJ1-2,CASSLDREGGYGYTF,1,0,1,1
TRBV6-2/3/5/6,TRBJ2-4,CASSLEAGGIGIQYF,1,0,1,1
TRBV28,TRBJ2-7,CASSSPGTGAYEQYF,1,0,1,1
TRBV12-3/4,TRBJ2-1,CASSSRQGHYNEQFF,1,0,1,1
TRBV7-6,TRBJ2-5,CASSYYGPDQETQYF,1,1,2,2
TRBV6-2/3/5/6,TRBJ2-5,CASSYLPGPPETQYF,1,1,2,2
TRBV6-2/3/5/6,TRBJ2-7,CASSYSMAGSYEQYF,1,0,1,1
TRBV6-2/3/5/6,TRBJ1-1,CASSYSMGLNTEAFF,1,0,1,1
TRBV6-2/3/5/6,TRBJ1-2,CASSYLRGTNYGYTF,1,0,1,1
TRBV6-2/3/5/6,TRBJ2-3,CASSYASGRTDTQYF,1,0,1,1
TRBV6-2/3/5/6,TRBJ1-5,CASSYGTGANQPQHF,1,0,1,1
TRBV9,TRBJ2-7,CASSPEGAGEDEQYF,1,0,1,1
TRBV7-2,TRBJ2-1,CASSRRDGSYNEQFF,1,0,1,1
TRBV6-2/3/5/6,TRBJ2-7,CASSHRDSYRREQYF,1,0,1,1
TRBV2,TRBJ1-6,CASSVWTVSRSPLHF,1,0,1,1
TRBV7-2,TRBJ2-5,CASSVRAVGGETQYF,1,0,1,1
TRBV6-1,TRBJ2-1,CASSATGQPYNEQFF,1,0,1,1
TRBV2,TRBJ2-1,CASSGAQNAYNEQFF,1,0,1,1
TRBV6-1,TRBJ2-7,CASSEWNTFSYEQYF,1,0,1,1
TRBV2,TRBJ1-3,CASSEAPLPGNTIYF,1,0,1,1
TRBV6-1,TRBJ1-5,CASSESRVPNQPQHF,1,0,1,1
TRBV6-2/3/5/6,TRBJ1-1,CASSMAEKMNTEAFF,1,0,1,1
TRBV7-9,TRBJ1-3,CASSNPAVSGNTIYF,2,0,1,2
TRBV7-2,TRBJ2-2,CASSFWTGGTGELFF,1,0,1,1
TRBV7-9,TRBJ2-2,CASSFRQGNTGELFF,1,0,1,1
TRBV7-6,TRBJ2-3,CASSFKAVRTDTQYF,1,0,1,1
TRBV7-2,TRBJ1-5,CASSFFGQGNQPQHF,1,0,1,1
TRBV7-9,TRBJ2-1,CASSFVSGRYNEQFF,1,0,1,1
TRBV7-9,TRBJ2-3,CASSFGSMSTDTQYF,1,0,1,1
TRBV7-2,TRBJ2-7,CASSFRGGAVYEQYF,1,2,2,3
TRBV5-4,TRBJ2-2,CASSLRGTNTGELFF,1,0,1,1
TRBV5-4,TRBJ1-6,CASSLGGSYNSPLHF,1,0,1,1
TRBV5-4,TRBJ2-3,CASSLGTSGRDTQYF,1,0,1,1
TRBV5-4,TRBJ2-2,CASSLDSGNTGELFF,1,0,1,1
TRBV7-2,TRBJ1-1,CASSLLALVDTEAFF,1,0,1,1
TRBV7-9,TRBJ2-4,CASSLQGGAKNIQYF,1,0,1,1
TRBV7-9,TRBJ2-2,CASSLVGLNTGELFF,1,0,1,1
TRBV7-9,TRBJ2-5,CASSLARGGQETQYF,1,0,1,1
TRBV7-2,TRBJ2-7,CASSLAGLDPYEQYF,1,0,1,1
TRBV7-2,TRBJ2-4,CASSLGAGTANIQYF,1,0,1,1
TRBV7-9,TRBJ2-1,CASSLGQGARNEQFF,1,0,1,1
TRBV7-6,TRBJ2-3,CASSLGGAQGDTQYF,1,0,1,1
TRBV7-2,TRBJ2-1,CASSLRQGLYNEQFF,1,0,1,1
TRBV7-2,TRBJ2-7,CASSSRTGVPYEQYF,1,1,2,2
TRBV3-1,TRBJ2-5,CASSYGLAGQETQYF,1,0,1,1
TRBV5-8,TRBJ2-7,CASSLLQTGSYEQYF,1,0,1,1
TRBV7-9,TRBJ2-3,CASSLTSGRYDTQYF,1,0,1,1
TRBV5-4,TRBJ2-1,CASSLSGSSYNEQFF,1,0,1,1
TRBV6-2/3/5/6,TRBJ1-1,CASSPLQDMNTEAFF,1,0,1,1
TRBV7-9,TRBJ2-1,CASSPRDRAYNEQFF,1,0,1,1
TRBV7-9,TRBJ2-2,CASSPVLGNTGELFF,1,0,1,1
TRBV12-3/4,TRBJ2-7,CASSPGTPFTLEQYF,1,0,1,1
TRBV13,TRBJ2-7,CASSPGTGGLLEQYF,1,0,1,1
TRBV5-4,TRBJ1-2,CASSPWQGVNYGYTF,1,0,1,1
TRBV7-9,TRBJ1-6,CASSPGQGAWSPLHF,1,0,1,1
TRBV14,TRBJ2-7,CASSPGPSGAYEQYF,1,0,1,1
TRBV12-3/4,TRBJ2-6,CASSRVTSGANVLTF,1,0,1,1
TRBV5-4,TRBJ1-2,CASSRGHPEGYGYTF,1,0,1,1
TRBV14,TRBJ1-4,CASSHLGTANEKLFF,1,0,1,1
TRBV3-1,TRBJ2-1,CASSQREFPNNEQFF,1,0,1,1
TRBV7-8,TRBJ1-2,CASSQLTGLEYGYTF,1,3,2,4
TRBV14,TRBJ2-5,CASSQVGGSGETQYF,1,0,1,1
TRBV14,TRBJ2-7,CASSQGEQWWYEQYF,1,0,1,1
TRBV3-1,TRBJ1-1,CASSQDWGAGTEAFF,1,0,1,1
TRBV14,TRBJ2-1,CASSQDGTSGIGQFF,1,0,1,1
TRBV4-2,TRBJ1-3,CASSQDRGTEHTIYF,1,0,1,1
TRBV3-1,TRBJ1-2,CASSQEGDRGYGYTF,1,0,1,1
TRBV3-1,TRBJ1-5,CASSQRSYSNQPQHF,1,0,1,1
TRBV7-2,TRBJ1-2,CASSVSGTANYGYTF,1,0,1,1
TRBV7-2,TRBJ2-1,CASSVVLGSYNEQFF,1,0,1,1
TRBV9,TRBJ2-1,CASSVWAGGRNEQFF,1,0,1,1
TRBV9,TRBJ2-1,CASSVGSSLWGEQFF,1,0,1,1
TRBV12-3/4,TRBJ1-1,CASSVKQGVGTEAFF,1,0,1,1
TRBV5-6,TRBJ1-5,CASSGYRDTHQPQHF,1,0,1,1
TRBV7-3,TRBJ1-6,CASSGVGQNNSPLHF,1,0,1,1
TRBV5-5,TRBJ2-7,CASSGRNSPTLEQYF,1,0,1,1
TRBV7-2,TRBJ2-3,CASSGLAGASNTQYF,1,0,1,1
TRBV7-2,TRBJ2-1,CASSDPGQNYNEQSF,1,0,1,1
TRBV2,TRBJ2-3,CASSEEQGGTNTQYF,1,0,1,1
TRBV7-9,TRBJ1-1,CASSILYGVSTEAFF,1,1,2,2
TRBV7-2,TRBJ1-5,CASSTPGRANQPQHF,1,0,1,1
TRBV7-2,TRBJ2-5,CASSTDRVPQETQYF,1,0,1,1
TRBV6-2/3/5/6,TRBJ2-1,CASSRTWGTTNEQFF,1,0,1,1
TRBV7-9,TRBJ2-1,CASSKGQLPGDEQFF,1,0,1,1
TRBV7-2,TRBJ2-7,CASSKRLVLPREQYF,1,0,1,1
TRBV2,TRBJ1-2,CASRSGRSVNYGYTF,1,0,1,1
TRBV12-3/4,TRBJ1-4,CASRSTGAANEKLFF,1,0,1,1
TRBV5-1,TRBJ2-1,CASSSRGASYNGQFF,1,0,1,1
TRBV4-1,TRBJ2-1,CASSKSDRDEDEQFF,1,0,1,1
TRBV5-1,TRBJ2-7,CASSFEGSRSYEQYF,1,0,1,1
TRBV5-1,TRBJ2-5,CASSLVLSDQETQYF,1,0,1,1
TRBV5-1,TRBJ2-1,CASSLVPNPDDEQFF,1,0,1,1
TRBV5-1,TRBJ2-5,CASSLGYGGQGTQYF,1,0,1,1
TRBV5-1,TRBJ2-7,CASSLTFGGTGEQYF,1,0,1,1
TRBV5-1,TRBJ1-1,CASSSRDTKNTEAFF,1,0,1,1
TRBV5-1,TRBJ2-3,CASSSTSGGTDTQYF,1,0,1,1
TRBV4-1,TRBJ2-5,CASSLRWQLKETQYF,1,0,1,1
TRBV5-1,TRBJ2-7,CASSPVGGIGYEQYF,1,0,1,1
TRBV4-1,TRBJ2-4,CASSRLIAGQNIQYF,1,1,2,2
TRBV4-3,TRBJ2-7,CASSHASGGAYEQYF,1,0,1,1
TRBV4-1,TRBJ1-1,CASSQVPDPNTEAFF,1,0,1,1
TRBV4-3,TRBJ1-2,CASSQDYRGFYGYTF,1,0,1,1
TRBV4-1,TRBJ1-5,CASSQDKSRNQPQHF,1,0,1,1
TRBV4-3,TRBJ2-1,CASSQDGRSYNEQFF,1,0,1,1
TRBV5-1,TRBJ2-7,CASSDSTANYYEQYF,1,0,1,1
TRBV4-1,TRBJ2-4,CASSELAGGADIQYF,1,0,1,1
TRBV5-1,TRBJ1-1,CASSIEGRWDTEAFF,1,0,1,1
TRBV20-1,TRBJ2-3,CSAPGTSGSTDTQYF,1,0,1,1
TRBV20-1,TRBJ1-2,CSAALPWTDDYGYTF,1,0,1,1
TRBV20-1,TRBJ2-5,CSADGTSGPQETQYF,1,0,1,1
TRBV20-1,TRBJ1-5,CSATPRRATSQPQHF,1,0,1,1
TRBV20-1,TRBJ1-5,CSASPPRGGNQPQHF,1,0,1,1
TRBV20-1,TRBJ2-1,CSASPGASSYNEQFF,1,0,1,1
TRBV20-1,TRBJ2-3,CSARVRQGAADTQYF,1,0,1,1
TRBV20-1,TRBJ2-7,CSARDPGLLSYEQYF,1,0,1,1
TRBV20-1,TRBJ2-7,CSARDGLAGGDEQYF,1,0,1,1
TRBV20-1,TRBJ2-3,CSAKGLGLGTDTQYF,1,0,1,1
TRBV20-1,TRBJ2-5,CSAPGPPPNQETQYF,1,0,1,1
TRBV20-1,TRBJ2-5,CSAPEGGGIQETQYF,1,0,1,1
TRBV20-1,TRBJ2-5,CSARLAGDPRETQYF,1,0,1,1
TRBV20-1,TRBJ2-3,CSADYLAVDTGTQYF,1,0,1,1
TRBV20-1,TRBJ1-2,CSATPGTGDNYGYTF,2,0,1,2
TRBV20-1,TRBJ2-2,CSASDRGKVTGELFF,1,0,1,1
TRBV20-1,TRBJ2-1,CSAVVGESSYNEQFF,1,0,1,1
TRBV29-1,TRBJ1-1,CSVSRLGVMGTEAFF,1,0,1,1
TRBV29-1,TRBJ2-5,CSVDLGGTGLKTQYF,1,0,1,1
TRBV29-1,TRBJ2-3,CSVDGQGGGTDTQYF,1,0,1,1
TRBV29-1,TRBJ2-3,CSVDGDVDFTDTQYF,1,0,1,1
TRBV29-1,TRBJ2-7,CSVEHRDGSYYEQYF,1,0,1,1
TRBV29-1,TRBJ2-5,CSVEDLFQGLETQYF,1,0,1,1
TRBV29-1,TRBJ2-4,CSVEDPLLAKNIQYF,1,0,1,1
TRBV29-1,TRBJ2-6,CSVEDTNSGANVLTF,1,0,1,1
TRBV29-1,TRBJ2-7,CSVEIPRGFVAEQYF,1,0,1,1
TRBV29-1,TRBJ1-5,CSVRDSSNSNQPQHF,1,0,1,1
TRBV29-1,TRBJ2-7,CSVLGLAGLTGEQYF,1,0,1,1
TRBV29-1,TRBJ2-5,CSVGPSGRAVETQYF,1,0,1,1
TRBV7-4,TRBJ2-7,RASSLGDPATYEQYF,1,0,1,1
TRBV12-5,TRBJ2-5,CASGHGGPTETQYF,2,1,2,3
TRBV12-5,TRBJ2-1,CASGSSGGLNEQFF,1,0,1,1
TRBV30,TRBJ2-2,CAWSVSANTGELFF,1,0,1,1
TRBV30,TRBJ1-1,CAWSGDIRNTEAFF,1,1,2,2
TRBV30,TRBJ1-2,CAWRMGGQGFGYTF,1,0,1,1
TRBV19,TRBJ2-3,CATGQGESTDTQYF,1,0,1,1
TRBV15,TRBJ1-5,CATSRERVGQPQHF,1,0,1,1
TRBV15,TRBJ1-5,CATSRDLRNQPQHF,1,0,1,1
TRBV2,TRBJ1-1,CATRNRAMNTEAFF,2,0,1,2
TRBV19,TRBJ1-5,CATNTGDSDQPQHF,1,0,1,1
TRBV19,TRBJ2-5,CASSLLLGQETQYF,1,0,1,1
TRBV19,TRBJ1-1,CASSIATDYTEAFF,1,0,1,1
TRBV19,TRBJ1-1,CASSRQVGNTEAFF,1,0,1,1
TRBV19,TRBJ2-2,CASRYPAPSGELFF,1,0,1,1
TRBV19,TRBJ1-1,CASSGARMNTEAFF,1,0,1,1
TRBV18,TRBJ2-1,CASSPLGVGNEQFF,1,0,1,1
TRBV18,TRBJ2-5,CASSPPFYLETQYF,1,0,1,1
TRBV18,TRBJ2-7,CASSPPGTSGEQYF,1,0,1,1
TRBV2,TRBJ2-5,CASRGAAGGETQYF,1,0,1,1
TRBV13,TRBJ2-7,CASRPAGVSYEQYF,1,0,1,1
TRBV27,TRBJ1-5,CASRRRDSNQPQHF,1,0,1,1
TRBV7-9,TRBJ2-7,CASGRGRETYEQYF,1,0,1,1
TRBV7-2,TRBJ1-1,CASEGGRMVTEAFF,1,0,1,1
TRBV7-2,TRBJ1-2,CASIRDRGNYGYTF,1,0,1,1
TRBV12-3/4,TRBJ2-5,CASMPSGNQETQYF,1,0,1,1
TRBV12-3/4,TRBJ2-1,CASTVAVTYNEQFF,1,0,1,1
TRBV12-3/4,TRBJ1-1,CASTPGLITAEAFF,1,0,1,1
TRBV5-4,TRBJ1-4,CASTQTGGNEKLFF,1,0,1,1
TRBV2,TRBJ2-5,CASTTLGFQETQYF,1,0,1,1
TRBV12-3/4,TRBJ1-2,CASSFGGQGRGYTF,1,0,1,1
TRBV27,TRBJ2-2,CASSFNPNTGELFF,1,0,1,1
TRBV6-2/3/5/6,TRBJ2-4,CASSFELAGSIQYF,1,0,1,1
TRBV6-2/3/5/6,TRBJ2-5,CASSLASGEETQYF,1,0,1,1
TRBV27,TRBJ2-5,CASSLGQRGETQYF,1,0,1,1
TRBV6-2/3/5/6,TRBJ2-5,CASSLLTGGETQYF,1,0,1,1
TRBV12-3/4,TRBJ1-5,CASSLGAENQPQHF,1,0,1,1
TRBV14,TRBJ1-1,CASSLGGGDTEAFF,1,1,2,2
TRBV12-3/4,TRBJ2-1,CASSLGGKYNEQFF,1,0,1,1
TRBV12-3/4,TRBJ1-2,CASSLDTGVVGYTF,1,0,1,1
TRBV12-3/4,TRBJ1-1,CASSLIQSNTEAFF,1,0,1,1
TRBV6-2/3/5/6,TRBJ2-5,CASSLIDGPKTQYF,1,0,1,1
TRBV12-3/4,TRBJ2-3,CASSSDRAGDTQYF,1,0,1,1
TRBV6-2/3/5/6,TRBJ2-3,CASSYLQGADTQYF,1,0,1,1
TRBV6-2/3/5/6,TRBJ2-5,CASSYLGPGETQYF,1,0,1,1
TRBV6-2/3/5/6,TRBJ2-2,CASSYSTSTGELFF,1,0,1,1
TRBV7-2,TRBJ2-3,CASSYGSVGDTQYF,1,1,2,2
TRBV27,TRBJ2-7,CASSPARGPYEQYF,1,0,1,1
TRBV12-3/4,TRBJ2-4,CASSRTDLKNIQYF,1,0,1,1
TRBV2,TRBJ2-3,CASSVSQGWDTQYF,1,0,1,1
TRBV6-1,TRBJ1-1,CASSVQGAYTEAFF,1,0,1,1
TRBV6-1,TRBJ2-7,CASSAGGGTYEQYF,1,0,1,1
TRBV6-1,TRBJ2-3,CASSAVDSTDTQYF,1,0,1,1
TRBV6-1,TRBJ1-2,CASSAGTFDYGYTF,1,0,1,1
TRBV6-4,TRBJ2-3,CASSDRGGPDTQYF,1,0,1,1
TRBV6-1,TRBJ2-7,CASSETSGFYEQYF,1,0,1,1
TRBV6-2/3/5/6,TRBJ2-3,CASSTQDATDTQYF,1,0,1,1
TRBV6-2/3/5/6,TRBJ1-2,CASSNLGVNYGYTF,1,0,1,1
TRBV5-4,TRBJ2-5,CASSFWTGRETQYF,1,0,1,1
TRBV7-8,TRBJ2-1,CASSFQGRGNEQFF,1,0,1,1
TRBV7-2,TRBJ1-2,CASSFGVSNYGYTF,1,0,1,1
TRBV5-6,TRBJ2-5,CASSFDRQKGTQYF,1,0,1,1
TRBV7-2,TRBJ1-2,CASSLRGTDAGYTF,1,0,1,1
TRBV7-6,TRBJ1-1,CASSLQGLGSEAFF,1,0,1,1
TRBV5-6,TRBJ1-6,CASSLASYNSPLHF,1,0,1,1
TRBV7-6,TRBJ2-1,CASSLAGKNNEQFF,1,0,1,1
TRBV5-4,TRBJ1-1,CASSLGAGNTEAFF,1,0,1,1
TRBV5-4,TRBJ1-1,CASSLGPVDTEAFF,1,0,1,1
TRBV7-9,TRBJ1-3,CASSLGRAADTIYF,1,0,1,1
TRBV5-4,TRBJ2-1,CASSLDGGYNEQFF,1,0,1,1
TRBV7-8,TRBJ1-2,CASSLDRNNYGYTF,1,0,1,1
TRBV7-9,TRBJ2-3,CASSLSTSTDTQYF,1,0,1,1
TRBV7-9,TRBJ2-2,CASSLVGDTGELFF,1,0,1,1
TRBV7-6,TRBJ2-5,CASSLVAGEETQYF,1,0,1,1
TRBV7-9,TRBJ2-7,CASSLAGGAWEQYF,1,0,1,1
TRBV7-6,TRBJ2-3,CASSLGARVDTQYF,1,0,1,1
TRBV7-6,TRBJ1-1,CASSLGDKNTEAFF,1,0,1,1
TRBV7-2,TRBJ1-1,CASSLGRMNTEAFF,1,0,1,1
TRBV7-2,TRBJ2-1,CASSLDFGGDRRFF,1,0,1,1
TRBV7-6,TRBJ1-1,CASSLEGTGAEAFF,1,0,1,1
TRBV7-2,TRBJ1-4,CASSLETGNEKLFF,1,0,1,1
TRBV7-2,TRBJ2-7,CASSLTSGRYEQYF,1,0,1,1
TRBV7-9,TRBJ2-3,CASSLRGGADTQYF,1,0,1,1
TRBV7-8,TRBJ1-1,CASSLNRQNTEAFF,1,0,1,1
TRBV7-9,TRBJ2-3,CASSSSAATDTQYF,1,0,1,1
TRBV7-6,TRBJ2-3,CASSSGALTDTQYF,1,0,1,1
TRBV7-9,TRBJ1-1,CASSSWRGNTEAFF,1,0,1,1
TRBV7-9,TRBJ1-6,CASSSGQGRSPLHF,1,0,1,1
TRBV7-3,TRBJ2-3,CASSSSGGTDTQYF,1,0,1,1
TRBV5-5,TRBJ2-5,CASSWASGEETQYF,1,0,1,1
TRBV5-6,TRBJ1-6,CASSWDGRNSPLHF,1,0,1,1
TRBV5-4,TRBJ1-1,CASSYDPGGAEAFF,1,0,1,1
TRBV4-2,TRBJ1-4,CASSLGRGDEKLFF,1,0,1,1
TRBV7-9,TRBJ2-5,CASSPARIFETQYF,1,0,1,1
TRBV7-6,TRBJ1-2,CASSPGTGGYGYTF,1,0,1,1
TRBV12-3/4,TRBJ1-4,CASSPGQGREKLSF,1,0,1,1
TRBV3-1,TRBJ2-7,CASSPDEGTYEQYF,1,0,1,1
TRBV13,TRBJ1-1,CASSPLQGNTEAFF,1,0,1,1
TRBV4-2,TRBJ1-1,CASSRDRMNTEAFF,1,0,1,1
TRBV5-4,TRBJ1-4,CASSQDSSEEKLFF,1,0,1,1
TRBV3-1,TRBJ2-7,CASSQVGGSYEQYF,1,0,1,1
TRBV4-2,TRBJ1-2,CASSQVDEGPGYTF,1,0,1,1
TRBV3-1,TRBJ2-7,CASSQDSQGYEQYF,1,0,1,1
TRBV4-2,TRBJ1-2,CASSQDGGGSGYTF,1,1,2,2
TRBV4-2,TRBJ1-1,CASSQDMGSSEAFF,1,1,2,2
TRBV4-2,TRBJ1-2,CASSQEGALHGYTF,1,0,1,1
TRBV5-6,TRBJ2-7,CASSVGLGGYEQYF,1,0,1,1
TRBV9,TRBJ1-1,CASSVTDRNTEAFF,1,0,1,1
TRBV9,TRBJ2-1,CASSVVMDPNEQFF,1,0,1,1
TRBV13,TRBJ2-5,CASSARLATETQYF,1,0,1,1
TRBV11-2,TRBJ1-6,CASSADRGISPLHF,1,0,1,1
TRBV5-4,TRBJ2-7,CASSGGLTGVEQYF,1,0,1,1
TRBV9,TRBJ1-4,CASSEGTGGEKLFF,1,0,1,1
TRBV7-9,TRBJ1-3,CASSIAVSGNTIYF,1,0,1,1
TRBV7-8,TRBJ1-2,CASSTGHRTYGYTF,1,0,1,1
TRBV5-6,TRBJ2-2,CASSRDVYTGELFF,1,0,1,1
TRBV7-2,TRBJ1-1,CASSNTDRNTEAFF,1,0,1,1
TRBV5-6,TRBJ1-2,CASSKEVANYGYTF,1,0,1,1
TRBV12-3/4,TRBJ1-1,CASRATGERAEAFF,1,0,1,1
TRBV6-1,TRBJ1-4,CASRNRRVNEKLFF,1,0,1,1
TRBV6-2/3/5/6,TRBJ1-6,CASRPGQSPSPLHF,1,0,1,1
TRBV7-2,TRBJ2-1,CASRQRGANNEQFF,1,0,1,1
TRBV12-3/4,TRBJ2-1,CASRKIGTPFEQFF,1,0,1,1
TRBV7-2,TRBJ2-5,CASNQQGGKETQYF,1,0,1,1
TRBV2,TRBJ2-1,CASKGGTSYNEQFF,1,0,1,1
TRBV20-1,TRBJ1-5,CSARLGGVRQPQHF,1,0,1,1
TRBV4-1,TRBJ1-3,CACSPDRGGNTIYF,1,0,1,1
TRBV5-1,TRBJ1-1,CASSLSTGFTEAFF,1,0,1,1
TRBV5-1,TRBJ2-5,CASSLPDRGETQYF,1,0,1,1
TRBV5-1,TRBJ2-3,CASSLVLRTDTQYF,1,0,1,1
TRBV5-1,TRBJ2-7,CASSLVAEPYEQYF,1,0,1,1
TRBV5-1,TRBJ1-1,CASSLGQGNTEAFF,1,0,1,1
TRBV5-1,TRBJ1-1,CASSLRQANTEAFF,1,0,1,1
TRBV4-3,TRBJ2-7,CASSSGTGTYEQYF,1,0,1,1
TRBV4-1,TRBJ2-3,CASSSVGTTDTQYF,1,0,1,1
TRBV5-1,TRBJ1-6,CASSWRGLDSPLHF,1,0,1,1
TRBV5-1,TRBJ1-1,CASSPRFPNTEAFF,1,0,1,1
TRBV5-1,TRBJ1-2,CASSPRDRSYGYTF,1,0,1,1
TRBV5-1,TRBJ1-1,CASSPGPPNTEAFF,1,0,1,1
TRBV5-1,TRBJ2-7,CASSPGGIKYEQYF,1,0,1,1
TRBV5-1,TRBJ1-6,CASSRAQENSPLHF,1,0,1,1
TRBV4-1,TRBJ1-2,CASSQGTRTGGHTF,1,1,2,2
TRBV4-1,TRBJ1-2,CASSQLGQQYGYTF,1,0,1,1
TRBV4-1,TRBJ1-6,CASSQTTGGEPLPF,1,0,1,1
TRBV20-1,TRBJ2-7,CSALTGTGVREQYF,1,0,1,1
TRBV20-1,TRBJ2-3,CSAPSQRGADTQYF,1,0,1,1
TRBV20-1,TRBJ2-5,CSAHPGGGAETQYF,1,0,1,1
TRBV20-1,TRBJ2-1,CSAINRLGYNEQFF,1,0,1,1
TRBV20-1,TRBJ1-3,CSAMSGYSLNTIYF,1,2,2,3
TRBV20-1,TRBJ2-7,CSAILGQGRHEQYF,1,0,1,1
TRBV20-1,TRBJ1-1,CSATRTGGSAEAFF,1,0,1,1
TRBV20-1,TRBJ2-3,CSASWIADTDTQYF,1,0,1,1
TRBV20-1,TRBJ2-1,CSASEGLADNEQFF,1,0,1,1
TRBV20-1,TRBJ1-5,CSARRVSADQPQHF,1,0,1,1
TRBV20-1,TRBJ1-1,CSARFISGGTEAFF,1,0,1,1
TRBV20-1,TRBJ2-5,CSARARDSQETQYF,1,0,1,1
TRBV20-1,TRBJ2-7,CSARDPSGSKEQYF,1,0,1,1
TRBV20-1,TRBJ2-5,CSARDPRGWETQYF,1,0,1,1
TRBV20-1,TRBJ2-1,CSAPRPQGGNEQFF,1,0,1,1
TRBV20-1,TRBJ2-1,CSAPIRDFLNEQFF,1,0,1,1
TRBV20-1,TRBJ2-3,CSAPANAGPDTQYF,1,0,1,1
TRBV20-1,TRBJ1-5,CSARRGAVNQPQHF,1,0,1,1
TRBV29-1,TRBJ2-1,CSSDSAGGYNEQFF,1,0,1,1
TRBV29-1,TRBJ1-2,CSVDAGIGPYGYTF,1,0,1,1
TRBV29-1,TRBJ2-2,CSVEGTGETGELFF,1,0,1,1
TRBV29-1,TRBJ2-5,CSVGSGGGRETQYF,1,0,1,1
TRBV29-1,TRBJ2-7,CSVKTSGGASEQYF,1,0,1,1
TRBV29-1,TRBJ2-1,CSARLAGDLNEQFF,1,0,1,1
TRBV2,TRBJ2-7,CVTTSGGSYEQYF,1,0,1,1
TRBV12-5,TRBJ2-5,CASGLGWQETQYF,1,0,1,1
TRBV12-5,TRBJ2-5,CASGTSRGETQYF,1,0,1,1
TRBV30,TRBJ1-2,CAWSPQGSYGYTF,1,0,1,1
TRBV30,TRBJ2-3,CAWSDASTDTQYF,1,0,1,1
TRBV5-4,TRBJ2-2,CALAWASPGELFF,1,0,1,1
TRBV27,TRBJ1-1,CAIFLSGGTEAFF,1,0,1,1
TRBV19,TRBJ1-3,CAITPRSGNTIYF,1,0,1,1
TRBV10-3,TRBJ2-2,CAIGQGNTGELFF,1,0,1,1
TRBV10-3,TRBJ2-7,CAIRGPGDYEQYF,1,0,1,1
TRBV10-3,TRBJ1-6,CATVKGFDSPLHF,1,0,1,1
TRBV24-1,TRBJ2-3,CATSASGADTQYF,1,0,1,1
TRBV15,TRBJ1-1,CATSRDANTEAFF,1,0,1,1
TRBV15,TRBJ1-5,CATSREGNQPQHF,2,0,1,2
TRBV27,TRBJ2-1,CATTRRGYNEQFF,1,0,1,1
TRBV19,TRBJ1-1,CASSFRDTYEAFF,1,0,1,1
TRBV19,TRBJ2-5,CASSSSGQETQYF,1,2,2,3
TRBV19,TRBJ1-2,CASSIRGDYGYTF,1,0,1,1
TRBV19,TRBJ1-1,CASSIWGNTEAFF,1,0,1,1
TRBV19,TRBJ1-5,CASSITGNQPQHF,1,0,1,1
TRBV2,TRBJ2-7,CASSQAISYEQYF,1,0,1,1
TRBV6-2/3/5/6,TRBJ1-4,CASFGRINEKLFF,1,0,1,1
TRBV18,TRBJ1-1,CASSTGMNTEAFF,1,0,1,1
TRBV18,TRBJ1-6,CASSPSGNSPLHF,1,0,1,1
TRBV18,TRBJ2-7,CASSPPVSHEQYF,1,0,1,1
TRBV6-4,TRBJ2-1,CASWDRSYNEQFF,1,0,1,1
TRBV19,TRBJ2-1,CASRDTPYNEQFF,1,0,1,1
TRBV2,TRBJ2-2,CASAGKNTGELFF,1,0,1,1
TRBV6-2/3/5/6,TRBJ1-1,CASSFGVNTEAFF,1,0,1,1
TRBV12-3/4,TRBJ2-5,CASSFPDQETQYF,1,0,1,1
TRBV12-3/4,TRBJ2-1,CASSFREWSEQFF,1,0,1,1
TRBV12-3/4,TRBJ2-7,CASSLQGKNEQYF,1,0,1,1
TRBV12-3/4,TRBJ2-1,CASSLSIANEQFF,1,0,1,1
TRBV12-3/4,TRBJ2-5,CASSLRGQETQYF,1,0,1,1
TRBV6-2/3/5/6,TRBJ1-6,CASSSTENSPLHF,1,1,2,2
TRBV6-2/3/5/6,TRBJ1-1,CASSSGFGTEAFF,1,0,1,1
TRBV12-3/4,TRBJ1-5,CASSWDRLQPQHF,1,0,1,1
TRBV6-2/3/5/6,TRBJ2-7,CASSWEEPYEQYF,1,0,1,1
TRBV6-2/3/5/6,TRBJ2-1,CASSYSGYNEQFF,1,0,1,1
TRBV6-2/3/5/6,TRBJ2-1,CASSYGSVREQFF,1,0,1,1
TRBV12-3/4,TRBJ2-5,CASSLSEQETQYF,1,0,1,1
TRBV5-6,TRBJ1-2,CASSPDRTYGYTF,1,0,1,1
TRBV12-3/4,TRBJ1-2,CASSPNDGYGYTF,1,0,1,1
TRBV7-6,TRBJ1-5,CASSQDPNQPQHF,1,0,1,1
TRBV6-1,TRBJ2-6,CASSVTGANVLTF,1,0,1,1
TRBV6-1,TRBJ1-1,CASSVTGRTEAFF,1,0,1,1
TRBV6-4,TRBJ2-2,CASSDRGTGELFF,1,0,1,1
TRBV6-1,TRBJ1-4,CASSEGRFGNLFF,1,0,1,1
TRBV7-2,TRBJ2-7,CASSFTASHEQYF,1,0,1,1
TRBV5-6,TRBJ2-1,CASSLVYLREQFF,1,0,1,1
TRBV5-6,TRBJ1-4,CASSLGSGEKLFF,1,1,2,2
TRBV5-6,TRBJ2-7,CASSLMSRGEQYF,1,0,1,1
TRBV7-2,TRBJ2-2,CASSLSGVGELFF,1,0,1,1
TRBV7-6,TRBJ2-7,CASSLGRAYEQYF,1,0,1,1
TRBV7-8,TRBJ2-7,CASSLGVGYEQYF,1,0,1,1
TRBV7-2,TRBJ1-2,CASSLEGGHGYTF,1,0,1,1
TRBV11-1,TRBJ2-7,CASSLIRGREQYF,1,1,2,2
TRBV7-9,TRBJ2-1,CASSLNRDNEQFF,1,0,1,1
TRBV6-2/3/5/6,TRBJ1-5,CASSSTGNQPQHF,1,0,1,1
TRBV7-9,TRBJ1-5,CASSSYLSQPQHF,1,0,1,1
TRBV6-2/3/5/6,TRBJ1-5,CASSSTEEEPQHF,1,0,1,1
TRBV7-9,TRBJ2-5,CASSSGVGETQYF,1,0,1,1
TRBV5-4,TRBJ1-5,CASSLGTRQPQHF,1,0,1,1
TRBV7-7,TRBJ2-3,CASSPFDADTQYF,1,0,1,1
TRBV11-2,TRBJ2-7,CASSPSPGYEQYF,1,0,1,1
TRBV3-1,TRBJ2-3,CASSPRESDTQYF,1,0,1,1
TRBV14,TRBJ1-1,CASSPTADTEAFF,1,0,1,1
TRBV4-2,TRBJ2-1,CASSQSGKDEQFF,1,0,1,1
TRBV3-1,TRBJ1-1,CASSQDRGVVAFF,1,0,1,1
TRBV7-2,TRBJ2-4,CASSQRTGDILYF,1,0,1,1
TRBV9,TRBJ2-1,CASSVGQINEQFF,1,0,1,1
TRBV5-6,TRBJ2-7,CASSGTPAYEQYF,1,0,1,1
TRBV7-9,TRBJ1-6,CASSEWTASPLHF,1,0,1,1
TRBV14,TRBJ2-5,CASSTLAGETQYF,1,0,1,1
TRBV7-6,TRBJ2-7,CASSKTNSYEQYF,1,0,1,1
TRBV6-1,TRBJ2-5,CASRVTGPETQYF,1,0,1,1
TRBV7-2,TRBJ2-1,CASRINPNNEQFF,1,0,1,1
TRBV7-9,TRBJ2-5,CASRLTDQETQYF,1,0,1,1
TRBV4-2,TRBJ2-7,CTSSQDQGVEQYF,1,0,1,1
TRBV7-4,TRBJ2-7,CAWGGQGNHEQYF,1,0,1,1
TRBV5-1,TRBJ1-5,CASIRPSNQPQHF,1,1,2,2
TRBV5-1,TRBJ1-2,CASSFGHNYGYTF,1,0,1,1
TRBV5-1,TRBJ2-1,CASSLYRDGEQFF,1,0,1,1
TRBV5-1,TRBJ1-1,CASSLAGDTEAFF,1,0,1,1
TRBV5-1,TRBJ2-7,CASSLDTPYEQYF,1,0,1,1
TRBV4-3,TRBJ2-3,CASSPSSTDTQYF,1,0,1,1
TRBV4-3,TRBJ1-1,CASSPTGQGEAFF,1,0,1,1
TRBV2,TRBJ2-3,CASSRDHTDTQYF,1,0,1,1
TRBV4-1,TRBJ1-1,CASSQVQWTEAFF,1,0,1,1
TRBV4-1,TRBJ2-5,CASSQDRGETQYF,1,0,1,1
TRBV4-3,TRBJ2-5,CASSQKSMGTQYF,1,0,1,1
TRBV5-1,TRBJ2-3,CASSTGTLDTQYF,1,0,1,1
TRBV20-1,TRBJ1-1,CSATAGGDTEAFF,1,0,1,1
TRBV20-1,TRBJ2-4,CSASLTGGNIQYF,1,4,2,5
TRBV20-1,TRBJ2-5,CSASGARLETQYF,1,0,1,1
TRBV20-1,TRBJ1-1,CSARGVGRTEAFF,1,0,1,1
TRBV20-1,TRBJ2-5,CSARGTGQETQYF,1,0,1,1
TRBV20-1,TRBJ2-7,CSARDGLFYEQYF,1,0,1,1
TRBV20-1,TRBJ2-7,CSAGQGSYDEQYF,1,0,1,1
TRBV29-1,TRBJ2-3,CSPWDQSTDTQYF,1,1,2,2
TRBV29-1,TRBJ1-1,CSVVGTRNTEAFF,1,0,1,1
TRBV29-1,TRBJ1-5,CSVGDNFDQPQHF,1,0,1,1
TRBV29-1,TRBJ2-5,CSVGRDTQETQYF,1,1,2,2
TRBV29-1,TRBJ2-7,CSVGQGLAYEQYF,1,1,2,2
TRBV29-1,TRBJ2-1,CSVERDLVDEQFF,1,0,1,1
TRBV29-1,TRBJ1-1,CSVTRTMNTEAFF,1,0,1,1
TRBV29-1,TRBJ1-4,CSVNKGQGGKLFF,1,0,1,1
TRBV29-1,TRBJ2-7,CSVGSGGDYEQYF,1,0,1,1
TRBV29-1,TRBJ2-7,CSAWDNNSYEQYF,1,0,1,1
TRBV29-1,TRBJ2-1,CSAGLAGEGEQFF,1,0,1,1
TRBV29-1,TRBJ1-5,CSGADGSNQPQHF,1,0,1,1
TRBV29-1,TRBJ2-1,CSTWGIQGNEQFF,1,0,1,1
TRBV15,TRBJ2-1,RATSRVTGNEQFF,1,0,1,1
TRBV9,TRBJ2-1,RASSAPWDNEQFF,1,0,1,1
TRBV12-5,TRBJ1-1,CASGQSKTEAFF,1,0,1,1
TRBV12-5,TRBJ1-5,CASGLLSQPQHF,1,0,1,1
TRBV30,TRBJ2-3,CAWTAGLHTQYF,1,0,1,1
TRBV2,TRBJ2-7,CAGGRKAYEQYF,1,1,2,2
TRBV24-1,TRBJ2-5,CAIPVKQETQYF,1,0,1,1
TRBV10-3,TRBJ2-1,CAISEGDNEQFF,1,0,1,1
TRBV10-3,TRBJ2-3,CAIRGNTDTQYF,1,0,1,1
TRBV19,TRBJ2-1,CASSIDPLEQFF,1,0,1,1
TRBV11-2,TRBJ2-7,CASEGRGNEQYF,1,0,1,1
TRBV12-3/4,TRBJ1-5,CASTYSNQPQHF,1,1,2,2
TRBV6-2/3/5/6,TRBJ1-2,CASTTEGADYTF,1,0,1,1
TRBV25-1,TRBJ2-1,CASTGIRNEQFF,1,0,1,1
TRBV12-3/4,TRBJ2-1,CASSLGGDEQSF,1,0,1,1
TRBV5-1,TRBJ2-7,CASSLQGYEQYF,1,1,2,2
TRBV6-2/3/5/6,TRBJ1-1,CASSSPNTEAFF,1,0,1,1
TRBV6-2/3/5/6,TRBJ2-3,CASSLRLDTQYF,1,0,1,1
TRBV6-2/3/5/6,TRBJ2-3,CASSQGLDTQYF,1,0,1,1
TRBV7-6,TRBJ2-1,CASSLQGNEQFF,1,0,1,1
TRBV5-6,TRBJ1-2,CASSLAGPPYTF,1,0,1,1
TRBV5-5,TRBJ1-1,CASSLELDYAFF,1,0,1,1
TRBV7-6,TRBJ2-7,CASSLSDREQYF,1,1,2,2
TRBV7-6,TRBJ1-1,CASSLVEGEAFF,1,0,1,1
TRBV7-9,TRBJ1-5,CASSLEGQPQHF,1,0,1,1
TRBV7-9,TRBJ2-5,CASSSSYQAQYF,1,0,1,1
TRBV7-9,TRBJ2-1,CASSLAYNEQFF,1,0,1,1
TRBV14,TRBJ1-1,CASSPSGVEAFF,1,0,1,1
TRBV5-4,TRBJ2-5,CASSPTTETQYF,1,0,1,1
TRBV7-9,TRBJ2-5,CASSPLGETQYF,1,0,1,1
TRBV27,TRBJ2-3,CASSHDTFTQYF,1,0,1,1
TRBV6-2/3/5/6,TRBJ2-1,CASSQNLFEQFF,1,0,1,1
TRBV5-6,TRBJ1-6,CASSGWNSPLHF,1,0,1,1
TRBV7-9,TRBJ2-7,CASREKGGEQYF,1,3,2,4
TRBV6-2/3/5/6,TRBJ2-7,CASRTTGYEQYF,1,0,1,1
TRBV5-1,TRBJ2-7,CASSLRGSEQYF,1,0,1,1
TRBV5-1,TRBJ2-7,CASSINSREQYF,1,0,1,1
TRBV20-1,TRBJ1-1,CSAPLDIPEAFL,1,0,1,1
TRBV20-1,TRBJ2-5,CSAPSTGETQYF,1,0,1,1
TRBV20-1,TRBJ2-5,CSAIGTEETQYF,1,0,1,1
TRBV20-1,TRBJ1-1,CSARAGNTEAFF,1,0,1,1
TRBV29-1,TRBJ2-7,CSVVTGGYEQYF,1,0,1,1
TRBV29-1,TRBJ2-7,CSVGGSTYEQYF,1,0,1,1
TRBV29-1,TRBJ2-1,CSVGTGDNEQFF,1,0,1,1
TRBV29-1,TRBJ1-2,CSVEDRDIGYTF,1,0,1,1
TRBV20-1,TRBJ1-1,CSAPRGATEAFF,1,0,1,1
TRBV7-2,TRBJ2-1,RASSVGGPEQFF,1,0,1,1
TRBV30,TRBJ2-7,CAWNRGMEQYF,1,0,1,1
TRBV10-3,TRBJ1-2,CAISTPAGYTF,1,0,1,1
TRBV12-3/4,TRBJ2-2,CASLTTGELFF,1,0,1,1
TRBV3-1,TRBJ2-2,CASLLSGELFF,1,0,1,1
TRBV27,TRBJ2-1,CASGYRDFGFF,1,0,1,1
TRBV16,TRBJ2-1,CASGPNNEQFF,1,0,1,1
TRBV6-4,TRBJ2-3,CASTRGDTQYF,1,0,1,1
TRBV11-2,TRBJ2-1,CASTQSLEQFF,1,0,1,1
TRBV12-3/4,TRBJ2-7,CASSLGYEQYF,1,0,1,1
TRBV12-3/4,TRBJ2-4,CASSLGDRGDF,1,0,1,1
TRBV6-2/3/5/6,TRBJ2-2,CASSYSGELFF,1,0,1,1
TRBV7-9,TRBJ2-7,CASSLGPEQYF,1,0,1,1
TRBV11-1,TRBJ2-7,CASSLTGGQYF,1,0,1,1
TRBV11-3,TRBJ2-1,CASSLRDSGIF,1,0,1,1
TRBV7-9,TRBJ2-7,CASSYSYEQYF,1,0,1,1
TRBV7-9,TRBJ2-1,CASSLRDEQFF,1,0,1,1
TRBV3-1,TRBJ2-7,CASSHLYEQYF,1,0,1,1
TRBV3-1,TRBJ1-4,CASSQRGLLFF,1,0,1,1
TRBV29-1,TRBJ1-3,CSGGQGNTIYF,1,0,1,1
TRBV6-2/3/5/6,TRBJ2-7,CASGRDEQYF,1,0,1,1
TRBV29-1,TRBJ1-1,CSVVNGEAFF,1,0,1,1
TRBV29-1,TRBJ2-7,CSVAGYEQYF,1,0,1,1
TRBV29-1,TRBJ2-2,CSAGTGELFF,1,0,1,1
TRBV12-3/4,TRBJ2-4,CASSPPGAGGFAKDIQYF,1,0,1,1
TRBV5-1,TRBJ2-2,CASSLLGQLAITGELFF,1,0,1,1
TRBV6-2/3/5/6,TRBJ1-6,CASSSSTGTGNSPLHF,1,0,1,1
TRBV9,TRBJ1-4,CASSGSGYSTNEKLFF,1,0,1,1
TRBV7-7,TRBJ2-5,CASSLGAGRQETQYF,1,0,1,1
TRBV10-2,TRBJ2-5,CASAGTSGRVETQYF,1,0,1,1
TRBV19,TRBJ2-5,CASSIGSSPETQYF,1,0,1,1
TRBV12-3/4,TRBJ1-6,CASSLWDTNSPLHF,1,0,1,1
TRBV25-1,TRBJ1-2,CASSVGSSSLRYTF,1,0,1,1
TRBV7-8,TRBJ2-7,CASRPRGRPYEQYF,1,0,1,1
TRBV4-1,TRBJ2-5,CASSQAGGWETQYF,1,0,1,1
TRBV18,TRBJ1-2,CASSPGRDNGYTF,1,0,1,1
TRBV19,TRBJ1-2,CASCWGAGYGYTF,1,0,1,1
TRBV4-3,TRBJ2-3,CASSRGRTDTQYF,1,0,1,1
TRBV6-2/3/5/6,TRBJ2-1,CASQRGVGPDGPNEQFF,1,0,1,1
TRBV3-1,TRBJ2-5,CASTSGGAGQETQYF,1,0,1,1
TRBV30,TRBJ1-5,CAWRLDRSNQPQHF,1,0,1,1
TRBV19,TRBJ2-3,CASSASGTGGTDTQYF,1,0,1,1
TRBV10-3,TRBJ2-3,CAISESAGGTQYF,1,0,1,1
TRBV7-6,TRBJ2-1,CASSSHNEQFF,1,0,1,1
TRBV6-2/3/5/6,TRBJ1-1,CASSLMAAFMNTEAFF,1,0,1,1
TRBV9,TRBJ1-1,CASSARPTGRSTEAFF,1,3,2,4
TRBV7-6,TRBJ2-3,CASSLEGTDTQYF,1,1,2,2
TRBV5-1,TRBJ2-1,CASSSPLGTSGGTLNRIEQFF,1,0,1,1
TRBV6-2/3/5/6,TRBJ2-3,CASTDLSGQGWGLSTDTQYF,1,0,1,1
TRBV7-9,TRBJ2-2,CASSLPPYSRGLANTGELFF,1,0,1,1
TRBV18,TRBJ2-7,CASSHRIPGLAGGTYEQYF,1,0,1,1
TRBV18,TRBJ2-5,CASSRTSVRGYSWEETQYF,1,0,1,1
TRBV12-3/4,TRBJ1-4,CASSFLTQRGQGTNEKLFF,1,0,1,1
TRBV12-3/4,TRBJ1-2,CASSLGLGPKALEIRVYTF,1,3,2,4
TRBV12-3/4,TRBJ2-3,CASSLGLAGPPPDTDTQYF,1,0,1,1
TRBV6-2/3/5/6,TRBJ2-7,CASSYSAPGLAGSPNEQYF,1,0,1,1
TRBV7-9,TRBJ2-7,CASSEPPGIGTSGPYEQYF,1,0,1,1
TRBV5-5,TRBJ2-1,CASSFGTPSRRALWNEQFF,1,0,1,1
TRBV5-4,TRBJ2-1,CASSLATGTNGTGYNEQFF,1,0,1,1
TRBV6-2/3/5/6,TRBJ2-1,CASSLAPGPGTGQLGEQFF,1,0,1,1
TRBV5-5,TRBJ1-5,CASSLGAGGALYSNQPQHF,1,0,1,1
TRBV7-9,TRBJ2-1,CASSPRLFGLAESYNEQFF,1,0,1,1
TRBV5-5,TRBJ2-5,CASSGAGTSGTALWETQYF,1,0,1,1
TRBV6-2/3/5/6,TRBJ2-1,CASSERGGILAVNRNEQFF,1,0,1,1
TRBV9,TRBJ2-1,CASSERGGILAGNRNEQFF,1,0,1,1
TRBV12-3/4,TRBJ2-5,CASRLYRLAGGGAQETQYF,1,0,1,1
TRBV5-1,TRBJ2-5,CASSLQKGLAGLKGETQYF,1,0,1,1
TRBV4-1,TRBJ1-1,CASSPGSLRGPYMNTEAFF,1,0,1,1
TRBV29-1,TRBJ2-1,CSVRRPGLAGAPTYNEQFF,1,0,1,1
TRBV10-3,TRBJ2-1,CAISGGLAGVRGGNEQFF,1,0,1,1
TRBV15,TRBJ2-2,CATSRELAGVGNTGELFF,1,0,1,1
TRBV19,TRBJ1-5,CASRAGPPGRLSNQPQHF,1,0,1,1
TRBV6-2/3/5/6,TRBJ1-2,CASSLGSITGGTNYGYTF,1,0,1,1
TRBV6-2/3/5/6,TRBJ2-3,CASSYSWAGGPVADAQYF,1,0,1,1
TRBV4-2,TRBJ2-6,CASSLGGEGDSGANVLTF,1,1,2,2
TRBV6-2/3/5/6,TRBJ1-5,CASSRLTGTALPNQPQHF,1,0,1,1
TRBV12-3/4,TRBJ1-4,CASSQRQGSHQANEKLFF,1,0,1,1
TRBV6-1,TRBJ1-5,CASSGRSRGIYSNQPQHF,1,0,1,1
TRBV5-6,TRBJ1-4,CASSFSTGPSHFDEKLFF,1,0,1,1
TRBV12-3/4,TRBJ2-1,CASSFRLAGGRSYNEQFF,1,0,1,1
TRBV7-6,TRBJ1-6,CASSLETGSSSYNSPLHF,1,0,1,1
TRBV11-3,TRBJ2-7,CASSLIQARTDRDYEQYF,1,0,1,1
TRBV4-2,TRBJ2-7,CASSLQTGTSGVLYEQYF,1,0,1,1
TRBV13,TRBJ2-1,CASSLARERKTSGNEQFF,1,0,1,1
TRBV7-2,TRBJ2-3,CASSPRGNLGVITDTQYF,1,0,1,1
TRBV11-2,TRBJ2-1,CASSPWTSGRKLYNEQFF,1,0,1,1
TRBV4-2,TRBJ2-1,CASSQASGTTLFYNEQFF,1,0,1,1
TRBV4-2,TRBJ1-2,CASSQDQNRGHSNYGYTF,1,0,1,1
TRBV9,TRBJ2-3,CASSVGEREGPVADTQYF,1,0,1,1
TRBV4-1,TRBJ2-7,CASSQRRLAGGSSYEQYF,1,0,1,1
TRBV4-1,TRBJ2-2,CASSQAVASGINTGELFF,1,0,1,1
TRBV4-1,TRBJ1-2,CASSQGVKGNRANYGYTF,1,0,1,1
TRBV4-3,TRBJ2-4,CASSQDLGQGLAKNIQYF,1,0,1,1
TRBV4-3,TRBJ1-3,CASSQDGTPAFSGNTIYF,1,0,1,1
TRBV4-3,TRBJ2-1,CASSQDSPSGALYNEQFF,1,0,1,1
TRBV4-3,TRBJ2-2,CASSQELSGRTNTGELFF,1,0,1,1
TRBV4-3,TRBJ2-1,CASSQEEAQGSSYNEQFF,1,0,1,1
TRBV20-1,TRBJ2-3,CSVEKGLAGFLSRDTQYF,1,0,1,1
TRBV20-1,TRBJ2-3,CSVEKGLAGFLNRDTQYF,1,0,1,1
TRBV20-1,TRBJ1-5,CSASAGTGGLFGNQPQHF,1,1,2,2
TRBV20-1,TRBJ2-1,CSARGGLAGLSSYNEQFF,1,0,1,1
TRBV20-1,TRBJ1-5,CSARDRVSGGAGNQPQHF,1,0,1,1
TRBV20-1,TRBJ1-1,CSARDIGAFLQMNTEAFF,1,0,1,1
TRBV12-5,TRBJ2-1,CASGFYRGLANYNEQFF,1,0,1,1
TRBV7-6,TRBJ2-1,CAGSPTLKEFSYNEQFF,1,0,1,1
TRBV15,TRBJ2-1,CATSPNSRGVGGNEQFF,1,0,1,1
TRBV15,TRBJ2-3,CATSRKRAGGPTDTQYF,1,0,1,1
TRBV19,TRBJ1-5,CASSIRADTLRNQPQHF,1,0,1,1
TRBV19,TRBJ1-1,CASSIVWAGGRNTEAFF,1,0,1,1
TRBV19,TRBJ1-5,CASSRGALREGNQPQHF,1,0,1,1
TRBV18,TRBJ1-2,CASSPRPLAAPNYGYTF,1,0,1,1
TRBV18,TRBJ2-3,CASSPTFASGGSDTQYF,1,0,1,1
TRBV12-3/4,TRBJ2-2,CASSLGWLAGNTGELFF,1,0,1,1
TRBV6-2/3/5/6,TRBJ2-3,CASSLSGLAGGLDTQYF,1,0,1,1
TRBV6-2/3/5/6,TRBJ2-3,CASSLLSVPVGADTQYF,1,0,1,1
TRBV12-3/4,TRBJ2-3,CASSLILAARLPGGQYF,1,0,1,1
TRBV27,TRBJ2-1,CASSSRLLASSYNEQFF,1,0,1,1
TRBV6-2/3/5/6,TRBJ1-3,CASSYSKRAGSGNTIYF,1,0,1,1
TRBV6-2/3/5/6,TRBJ2-4,CASSYSDLLAVKNIQYF,1,0,1,1
TRBV6-2/3/5/6,TRBJ1-1,CASSYVRAENPNTEAFF,1,0,1,1
TRBV6-4,TRBJ2-2,CASSASEWGAVTGELFF,1,0,1,1
TRBV12-3/4,TRBJ2-4,CASSGSRSGLAKNIQYF,1,0,1,1
TRBV2,TRBJ2-1,CASSDGDSGRAYNEQFF,1,0,1,1
TRBV6-1,TRBJ2-1,CASSEKLAGGRRNEQFF,1,0,1,1
TRBV9,TRBJ2-3,CASSFRTSGYGADTQYF,1,0,1,1
TRBV5-6,TRBJ2-7,CASSLASVGKPSYEQYF,1,0,1,1
TRBV5-6,TRBJ1-2,CASSLEYRDSVSYGYTF,1,0,1,1
TRBV7-9,TRBJ2-7,CASSLSGNYQGAYEQYF,1,0,1,1
TRBV7-2,TRBJ2-7,CASSLQFGLAGSYEQYF,1,0,1,1
TRBV11-3,TRBJ2-2,CASSLVYNAGNTGELFF,1,0,1,1
TRBV7-2,TRBJ2-3,CASSLARVSGQAQTQYF,1,0,1,1
TRBV7-6,TRBJ1-1,CASSLAGQGAGWTEAFF,1,0,1,1
TRBV7-6,TRBJ2-1,CASSLAIPDGAYNEQFF,1,0,1,1
TRBV11-3,TRBJ2-3,CASSLGVSGRSEDTQYF,1,0,1,1
TRBV7-9,TRBJ2-7,CASSLGWTGGSHYEQYF,1,0,1,1
TRBV7-8,TRBJ2-7,CASSLDLRDRAFYEQYF,1,0,1,1
TRBV7-6,TRBJ2-2,CASSLDRVKANTGELFF,1,0,1,1
TRBV7-9,TRBJ2-6,CASSLEVGFSGANVLTF,1,0,1,1
TRBV7-9,TRBJ1-5,CASSLTGGNRGNQPQHF,1,0,1,1
TRBV7-6,TRBJ2-7,CASSSRLAGDPSYEQYF,1,0,1,1
TRBV4-2,TRBJ2-6,CASSLGTGLSGANVLTF,1,0,1,1
TRBV7-9,TRBJ2-1,CASSLGPASGTNNEQFF,1,0,1,1
TRBV5-4,TRBJ2-1,CASSLNFNRGSYNEQFF,1,0,1,1
TRBV7-9,TRBJ2-7,CASSPSPSGGLPYEQYF,1,0,1,1
TRBV4-2,TRBJ1-5,CASSQAPLGGYDQPQHF,1,0,1,1
TRBV4-2,TRBJ1-5,CASSQSTREDSNQPQHF,1,0,1,1
TRBV3-1,TRBJ2-7,CASSQAQDGGPTYEQYF,1,0,1,1
TRBV3-1,TRBJ1-6,CASSQAIGGTYNSPLHF,1,0,1,1
TRBV4-2,TRBJ2-3,CASSQIGSGRATDTQYF,1,0,1,1
TRBV27,TRBJ1-5,CASSMTGGVGGNQPQHF,1,0,1,1
TRBV11-1,TRBJ2-1,CASRKGGDGSGYNEQFF,1,1,2,2
TRBV6-2/3/5/6,TRBJ2-7,CASRPPATAQGIYEQYF,1,0,1,1
TRBV5-1,TRBJ2-5,CASSLGFATRTKETQYF,1,0,1,1
TRBV5-1,TRBJ1-2,CASSLGGLRGRSYGYTF,1,0,1,1
TRBV5-1,TRBJ2-1,CASSSGAGSQKYNEQFF,1,0,1,1
TRBV5-1,TRBJ2-7,CASSSAEGSLSSYEQYF,1,0,1,1
TRBV5-1,TRBJ2-5,CASSSGLAGAPPETQYF,1,0,1,1
TRBV4-1,TRBJ2-4,CASSQPPGELGENIQYF,1,0,1,1
TRBV4-1,TRBJ2-4,CASSQGGASIAKNIQYF,1,0,1,1
TRBV4-3,TRBJ2-5,CASSQDLGGVNQETQYF,1,0,1,1
TRBV4-3,TRBJ2-1,CASSQDQVGLAGERQFF,1,0,1,1
TRBV4-1,TRBJ1-6,CASSQEVRSSYNSPLHF,1,0,1,1
TRBV4-3,TRBJ2-1,CASSQEIGRKDQGEQFF,1,0,1,1
TRBV20-1,TRBJ2-2,CSAEWGVQGARTGELFF,1,0,1,1
TRBV20-1,TRBJ2-1,CSARVQGLADSYNEQFF,1,0,1,1
TRBV20-1,TRBJ2-3,CSARDPTSGGGTDTQYF,1,0,1,1
TRBV29-1,TRBJ2-7,CSVETGSVTSGRPEQYF,1,0,1,1
TRBV29-1,TRBJ2-5,CSVEVAGARNPGETQYF,1,0,1,1
TRBV29-1,TRBJ2-6,CSVEGRAGDSGANVLTF,1,0,1,1
TRBV12-5,TRBJ1-1,CASGSAATGRGAEAFF,1,0,1,1
TRBV3-1,TRBJ1-1,CASRHVVGLGGTEAFF,1,0,1,1
TRBV30,TRBJ2-2,CAWVSGRTSNTGELFF,1,0,1,1
TRBV12-3/4,TRBJ2-2,CAGSLGTSANTGELFF,1,0,1,1
TRBV10-3,TRBJ2-7,CAISEISSGRDNEQYF,1,0,1,1
TRBV24-1,TRBJ2-1,CATSDYSRLIYNEQFF,1,0,1,1
TRBV15,TRBJ2-3,CATSRVQRVDDDTQYF,1,0,1,1
TRBV15,TRBJ2-3,CATSREEGQGRDTQYF,1,0,1,1
TRBV19,TRBJ1-2,CASSPGRRANNYGYTF,1,1,2,2
TRBV19,TRBJ1-5,CASSILRQGSNQPQHF,1,0,1,1
TRBV19,TRBJ1-2,CASSIEADKSNYGYTF,1,0,1,1
TRBV19,TRBJ2-5,CASSIYDGTGQETQYF,1,0,1,1
TRBV11-3,TRBJ2-1,CASSGRDGGSYNEQFF,1,0,1,1
TRBV18,TRBJ1-4,CASSPRLTATNEKLFF,1,0,1,1
TRBV18,TRBJ2-4,CASSPRLAGSLNIQYF,1,0,1,1
TRBV18,TRBJ1-1,CASSPKPFAGVTEAFF,1,1,2,2
TRBV27,TRBJ2-2,CASIPTSGGYTGELFF,1,0,1,1
TRBV12-3/4,TRBJ2-1,CASIREVELPRGEQFF,1,0,1,1
TRBV19,TRBJ1-5,CASTPSGPTGHQPQHF,1,1,2,2
TRBV2,TRBJ2-3,CASTGTSGELTDTQYF,1,0,1,1
TRBV6-2/3/5/6,TRBJ1-5,CASTGLRTVIDWPQHF,1,0,1,1
TRBV6-2/3/5/6,TRBJ2-6,CASTNRRGAGANVLTF,1,0,1,1
TRBV28,TRBJ1-5,CASSFGGQGNNQPQHF,1,0,1,1
TRBV6-2/3/5/6,TRBJ1-5,CASSLVDRGKGQPQHF,1,0,1,1
TRBV6-2/3/5/6,TRBJ2-4,CASSLGTGDVKNTQYF,1,0,1,1
TRBV6-2/3/5/6,TRBJ2-5,CASSLFLWGSQETQYF,1,0,1,1
TRBV12-3/4,TRBJ2-1,CASSLSTASEYNEQFF,1,0,1,1
TRBV12-3/4,TRBJ2-1,CASSSSGSSLGNEQFF,1,1,2,2
TRBV6-2/3/5/6,TRBJ2-1,CASSSLWDRTYNEQFF,1,0,1,1
TRBV12-3/4,TRBJ1-6,CASSSLQGLHNSPLHF,1,0,1,1
TRBV6-2/3/5/6,TRBJ2-3,CASSSLAGLGSDTQYF,1,0,1,1
TRBV6-2/3/5/6,TRBJ1-5,CASSYSLRREGQPQHF,1,0,1,1
TRBV6-2/3/5/6,TRBJ1-5,CASSYSSWAVNQPQHF,1,0,1,1
TRBV6-2/3/5/6,TRBJ2-4,CASSYEDTVAKNIQYF,1,0,1,1
TRBV2,TRBJ2-1,CASSYRAGNSYNEQFF,1,0,1,1
TRBV12-3/4,TRBJ2-6,CASSPLGAAGANVLTF,1,0,1,1
TRBV2,TRBJ1-5,CASSELSALTDQPQHF,1,1,2,2
TRBV2,TRBJ2-7,CASSEPGQGRSYEQYF,1,0,1,1
TRBV6-1,TRBJ2-5,CASSEGRIRGQETQYF,1,0,1,1
TRBV6-1,TRBJ2-5,CASSEIRTAPVETQYF,1,0,1,1
TRBV6-2/3/5/6,TRBJ1-1,CASSTDRVVAGTEAFF,1,0,1,1
TRBV7-6,TRBJ1-2,CASSFGTAGDLYGYTF,1,0,1,1
TRBV7-9,TRBJ2-4,CASSFQAGGPGDIQYF,1,0,1,1
TRBV5-5,TRBJ1-2,CASSLVGQGATYGYTF,1,1,2,2
TRBV7-9,TRBJ2-3,CASSLGGGRSTDTQYF,1,0,1,1
TRBV5-4,TRBJ2-3,CASSLRLAGPVDTQYF,1,0,1,1
TRBV11-2,TRBJ2-6,CASSLSVHSGANVLTF,1,0,1,1
TRBV7-2,TRBJ1-2,CASSLQSGGTNYGYTF,1,0,1,1
TRBV6-2/3/5/6,TRBJ2-5,CASSLVASGRKETQYF,1,0,1,1
TRBV7-3,TRBJ1-1,CASSLVGGGGYTEAFF,1,0,1,1
TRBV11-3,TRBJ2-3,CASSLAAGASTDTQYF,1,0,1,1
TRBV7-9,TRBJ2-1,CASSLAGQGAGNEQFF,1,0,1,1
TRBV7-2,TRBJ2-1,CASSLEADSSYNEQFF,1,0,1,1
TRBV11-3,TRBJ2-1,CASSLEWGQGRNEQFF,1,0,1,1
TRBV7-2,TRBJ2-3,CASSLTESSGMDTQYF,1,1,2,2
TRBV7-2,TRBJ2-1,CASSLSPSGRAREQFF,1,0,1,1
TRBV7-9,TRBJ2-1,CASSLNEGAPYNEQFF,1,0,1,1
TRBV7-6,TRBJ2-1,CASSSRLAGEYDEQFF,1,0,1,1
TRBV7-9,TRBJ2-1,CASSSRQTSSYNEQFF,1,0,1,1
TRBV11-3,TRBJ2-1,CASSSRGAGSYNEQFF,1,1,2,2
TRBV4-2,TRBJ2-5,CASSSGGWGPGETQYF,1,0,1,1
TRBV5-6,TRBJ2-7,CASSSDGGRAVHEQYF,1,0,1,1
TRBV7-2,TRBJ2-3,CASSSRTDGATSTQYF,1,0,1,1
TRBV4-2,TRBJ2-3,CASSSLAGGRADTQYF,1,0,1,1
TRBV3-1,TRBJ2-5,CASSLGTSGEKETQYF,1,0,1,1
TRBV3-1,TRBJ2-1,CASSLALADLYNEQFF,1,0,1,1
TRBV7-2,TRBJ2-2,CASSLSWSMNTGELFF,1,0,1,1
TRBV7-2,TRBJ2-1,CASSPQLGGDYNEQFF,1,0,1,1
TRBV14,TRBJ2-1,CASSPTGQKIYNEQFF,1,1,2,2
TRBV7-2,TRBJ2-5,CASSPSGGSLQETQYF,1,1,2,2
TRBV7-2,TRBJ2-6,CASSRDRHSGANVLTF,1,0,1,1
TRBV9,TRBJ1-1,CASSRGTGGMNTEAFF,1,0,1,1
TRBV4-2,TRBJ1-5,CASSHIGGGGNQPQHF,1,0,1,1
TRBV7-9,TRBJ1-5,CASSHWTGGSNQPQHF,1,0,1,1
TRBV11-2,TRBJ2-6,CASSQRDASGANVLTF,1,0,1,1
TRBV3-1,TRBJ2-7,CASSQVRGGQGSEQYF,1,0,1,1
TRBV14,TRBJ1-2,CASSQGQGGYGYGYTF,1,0,1,1
TRBV14,TRBJ2-7,CASSQGQGIKRYEQYF,1,0,1,1
TRBV4-2,TRBJ2-3,CASSQGDGVSTDTQYF,1,0,1,1
TRBV4-2,TRBJ1-5,CASSQDEGAGNQPQHF,1,0,1,1
TRBV9,TRBJ2-2,CASSVGTGANTGELFF,1,0,1,1
TRBV9,TRBJ2-7,CASSVAMGGSSYEQYF,1,0,1,1
TRBV6-4,TRBJ1-6,CASSVGPRGQDSPLHF,1,0,1,1
TRBV7-2,TRBJ2-5,CASSATGRIFEETQYF,1,0,1,1
TRBV7-2,TRBJ2-1,CASSARLAGGDNEQFF,1,0,1,1
TRBV5-4,TRBJ2-2,CASSGGPAGYTGELFF,1,0,1,1
TRBV7-9,TRBJ2-7,CASSGPTRTGSYEQYF,1,0,1,1
TRBV5-4,TRBJ2-1,CASSGRLAAPYNEQFF,1,0,1,1
TRBV7-2,TRBJ2-6,CASSKTWDYGANVLTF,1,0,1,1
TRBV7-2,TRBJ2-7,CASRYDFGTNVYEQYF,1,0,1,1
TRBV6-2/3/5/6,TRBJ1-1,CASRHLKQVSNTEAFF,1,0,1,1
TRBV12-3/4,TRBJ2-7,CASKVEIGTPTHEQYF,1,1,2,2
TRBV5-1,TRBJ2-1,CASSFRSSGIYNEQFF,1,0,1,1
TRBV5-1,TRBJ2-7,CASSLSSGRPTYEQYF,1,0,1,1
TRBV5-1,TRBJ2-3,CASSLPSLAATDTQYF,1,0,1,1
TRBV5-1,TRBJ2-1,CASSLGGAGRDNEQFF,1,0,1,1
TRBV5-1,TRBJ2-7,CASSLGTGTSAYEQYF,1,0,1,1
TRBV5-1,TRBJ2-5,CASSLEGSGSSGTQYF,1,0,1,1
TRBV4-3,TRBJ2-3,CASSSGLAGITDTQYF,1,0,1,1
TRBV4-3,TRBJ1-3,CASSLNHRSSGNTIYF,1,0,1,1
TRBV4-3,TRBJ2-3,CASSLFSGRAADTQYF,1,0,1,1
TRBV4-1,TRBJ2-7,CASSPTMGLNPTGQYF,1,0,1,1
TRBV4-3,TRBJ2-7,CASSQPNRGSRGEQYF,1,0,1,1
TRBV4-1,TRBJ2-6,CASSQVIGSGANVLTF,1,0,1,1
TRBV4-3,TRBJ2-7,CASSQGIPDSSYEQYF,1,0,1,1
TRBV4-3,TRBJ2-6,CASSQDGFSGANVLTF,1,1,2,2
TRBV4-3,TRBJ2-7,CASSQEGAGGVYEQYF,1,0,1,1
TRBV4-1,TRBJ2-3,CASSARTGGGTDTQYF,1,0,1,1
TRBV4-1,TRBJ1-2,CASSAGRARKVYGYTF,1,0,1,1
TRBV20-1,TRBJ2-1,CSARGRSGGRFGEQFF,1,0,1,1
TRBV20-1,TRBJ1-1,CSARFHSRALNTEAFF,1,0,1,1
TRBV20-1,TRBJ2-1,CSARVTSGEYNNEQFF,1,0,1,1
TRBV20-1,TRBJ2-3,CSARDMVAGRTDTQYF,1,0,1,1
TRBV20-1,TRBJ2-7,CSAREGLAGVRYEQYF,1,0,1,1
TRBV29-1,TRBJ2-3,CSVRTMGWDSTDTQYF,1,0,1,1
TRBV29-1,TRBJ2-7,CSVETGRTDSAYEQYF,1,0,1,1
TRBV29-1,TRBJ2-5,CSVEVGIAADLWTQYF,1,0,1,1
TRBV29-1,TRBJ2-7,CSVEGLLGADPCEQYF,1,0,1,1
TRBV29-1,TRBJ2-7,CSVEDPVLGSSYEQYF,1,0,1,1
TRBV29-1,TRBJ2-7,CSVEKSGQGVSYEQYF,1,0,1,1
TRBV29-1,TRBJ2-7,CSVTPGQEVALGEQYF,1,1,2,2
TRBV29-1,TRBJ2-1,CSATSIQTGIYNEQFF,1,0,1,1
TRBV12-3/4,TRBJ2-3,RASRPGTSGITDTQYF,1,0,1,1
TRBV30,TRBJ2-3,CAWSAGGRATDTQYF,1,0,1,1
TRBV30,TRBJ2-1,CAWSERTRTNNEQFF,1,0,1,1
TRBV30,TRBJ2-1,CAWNRGGGPNNEQFF,1,0,1,1
TRBV10-3,TRBJ2-5,CAIIVAGGPGETQYF,1,0,1,1
TRBV10-3,TRBJ2-7,CAISSGTGGIYEQYF,1,0,1,1
TRBV10-3,TRBJ1-1,CAISEPSLTGSEAFF,1,0,1,1
TRBV10-3,TRBJ2-7,CAIRPGTGGLLEQYF,1,0,1,1
TRBV10-3,TRBJ2-3,CATTSGQGEADTQYF,1,0,1,1
TRBV15,TRBJ2-1,CATSRLAGVGNEQFF,1,0,1,1
TRBV15,TRBJ2-1,CATSRPGLAGNEQFF,1,0,1,1
TRBV15,TRBJ2-3,CATSRDLLAPDTQYF,1,0,1,1
TRBV15,TRBJ1-5,CATSRDRDAYQPQHF,1,0,1,1
TRBV19,TRBJ2-5,CASTQLAGGQETQYF,1,0,1,1
TRBV19,TRBJ2-3,CASSLEGRSTDTQYF,1,0,1,1
TRBV19,TRBJ2-1,CASSPRQGAYNEQFF,1,0,1,1
TRBV19,TRBJ1-1,CASSPRTGTGTEAFF,1,1,2,2
TRBV19,TRBJ2-1,CASSITDSLGNEQFF,1,0,1,1
TRBV19,TRBJ2-7,CASSTESGGPYEQYF,1,0,1,1
TRBV18,TRBJ2-7,CASSSEQTGPGEQYF,1,0,1,1
TRBV18,TRBJ2-4,CASSLDWGAKNIQYF,1,0,1,1
TRBV18,TRBJ1-5,CASSPGTTSNQPQHF,1,0,1,1
TRBV18,TRBJ1-1,CASSPPSSGGGWAFF,1,0,1,1
TRBV18,TRBJ1-4,CASSRARDVNEKLFF,1,0,1,1
TRBV18,TRBJ1-2,CASSTDTGTGNGYTF,1,0,1,1
TRBV2,TRBJ2-7,CASCYRRGTSYEQYF,1,0,1,1
TRBV6-2/3/5/6,TRBJ2-5,CASLPGLAVKETQYF,1,0,1,1
TRBV12-3/4,TRBJ2-5,CASAPFGRIQETQYF,1,0,1,1
TRBV27,TRBJ1-6,CASDLWGLGYSPLHF,1,0,1,1
TRBV6-2/3/5/6,TRBJ1-2,CASIQGWGADYGYTF,1,0,1,1
TRBV12-3/4,TRBJ2-3,CASITSGLSTDTQYF,1,0,1,1
TRBV7-9,TRBJ2-1,CASTLSGGVYNEQFF,1,0,1,1
TRBV7-2,TRBJ2-1,CASTYWTSGYNEQFF,1,1,2,2
TRBV11-2,TRBJ2-1,CASTPGGGGVNEQFF,1,0,1,1
TRBV28,TRBJ2-7,CASSFNGEPSYEQYF,1,0,1,1
TRBV27,TRBJ1-1,CASSFHPSVEPLAFF,1,0,1,1
TRBV12-3/4,TRBJ2-7,CASSLGLAGAYEQYF,1,0,1,1
TRBV6-2/3/5/6,TRBJ2-2,CASSLSVSNTGELFF,1,0,1,1
TRBV6-2/3/5/6,TRBJ1-1,CASSLSWGGGTEAFF,1,2,2,3
TRBV12-3/4,TRBJ1-2,CASSLPGQGIYGYTF,1,0,1,1
TRBV27,TRBJ1-1,CASSLQGRSNTEAFF,1,0,1,1
TRBV6-2/3/5/6,TRBJ2-2,CASSSLDGSPWELFF,1,0,1,1
TRBV6-2/3/5/6,TRBJ2-7,CASSYSKDRPYEQYF,1,0,1,1
TRBV6-2/3/5/6,TRBJ1-6,CASSYLRAYNSPLHF,1,1,2,2
TRBV6-2/3/5/6,TRBJ2-1,CASSYPWSSGNEQFF,1,0,1,1
TRBV6-2/3/5/6,TRBJ2-5,CASSYRDRPQETQYL,1,0,1,1
TRBV6-2/3/5/6,TRBJ1-1,CASSYRDKMNTEAFF,1,0,1,1
TRBV12-3/4,TRBJ2-1,CASSLRDRVIDEQFF,1,0,1,1
TRBV12-3/4,TRBJ2-6,CASSLTRSGANVLTF,1,0,1,1
TRBV6-2/3/5/6,TRBJ2-1,CASSLTGSSYNEQFF,1,0,1,1
TRBV6-2/3/5/6,TRBJ2-5,CASSPGTGVGETQYY,1,0,1,1
TRBV6-2/3/5/6,TRBJ2-1,CASSPRTSGSNEQFF,1,0,1,1
TRBV10-2,TRBJ1-2,CASSPQSWVWDGYTF,1,0,1,1
TRBV6-2/3/5/6,TRBJ2-7,CASSRQQGGPYEQYF,1,0,1,1
TRBV6-2/3/5/6,TRBJ1-1,CASSRDRGGNTEAFF,1,0,1,1
TRBV6-1,TRBJ2-2,CASSQRDFFTGELFF,1,0,1,1
TRBV6-1,TRBJ1-1,CASSVRDRVNTEAFF,1,0,1,1
TRBV6-1,TRBJ1-4,CASSVDRGGGEKLFF,1,0,1,1
TRBV6-1,TRBJ1-1,CASSAPGQMNTEAFF,1,0,1,1
TRBV5-4,TRBJ2-7,CASSGAGVTAYEQYF,1,0,1,1
TRBV6-1,TRBJ1-2,CASSDKGWDNYGYTF,1,0,1,1
TRBV25-1,TRBJ1-1,CASSEGRGPNTEAFF,1,0,1,1
TRBV6-1,TRBJ2-5,CASSETSGGQETQYF,1,1,2,2
TRBV6-1,TRBJ2-7,CASSELSGRALEQYF,1,0,1,1
TRBV6-1,TRBJ2-3,CASSEYDRGTDTQYF,1,0,1,1
TRBV2,TRBJ1-6,CASSEQGGSNSPLHF,1,0,1,1
TRBV6-1,TRBJ1-2,CASSEMLIRGYGYTF,1,0,1,1
TRBV28,TRBJ2-5,CASSTPQTYQETQYF,1,0,1,1
TRBV6-4,TRBJ2-5,CASSRLAGARETQYF,1,0,1,1
TRBV6-1,TRBJ2-7,CASSKGQPISYEQYF,1,0,1,1
TRBV5-4,TRBJ1-1,CASSFNQGENAEAFF,1,0,1,1
TRBV7-2,TRBJ2-1,CASSFKRGNYNEQFF,1,0,1,1
TRBV5-6,TRBJ1-2,CASSLLRSDSYGYTF,1,0,1,1
TRBV5-6,TRBJ1-5,CASSLVQTGNQPQHF,1,0,1,1
TRBV5-4,TRBJ1-1,CASSLAGQVHTEAFF,1,0,1,1
TRBV5-4,TRBJ2-7,CASSLADRGHYEQYF,1,0,1,1
TRBV11-1,TRBJ2-2,CASSLGQGFTGELFF,1,0,1,1
TRBV5-6,TRBJ2-3,CASSLGTGGPDTQYF,1,0,1,1
TRBV5-4,TRBJ2-5,CASSLRREGQETQYF,1,0,1,1
TRBV7-6,TRBJ2-1,CASSLYNSRDYEQFF,1,0,1,1
TRBV7-9,TRBJ1-1,CASSLLGRYNTEAFF,1,0,1,1
TRBV7-9,TRBJ1-1,CASSLPGQGTTEAFF,1,0,1,1
TRBV7-2,TRBJ2-2,CASSLRTANTGELFF,1,0,1,1
TRBV7-2,TRBJ2-1,CASSLVNVAGVEQFF,1,0,1,1
TRBV7-6,TRBJ2-4,CASSLALGGRDIQYF,1,0,1,1
TRBV7-8,TRBJ1-2,CASSLAGQGMGGYTF,1,0,1,1
TRBV6-2/3/5/6,TRBJ1-1,CASSLGRGRYTEAFF,1,0,1,1
TRBV7-3,TRBJ2-3,CASSLGGQGPDTQYF,1,0,1,1
TRBV7-9,TRBJ2-7,CASSLGTGGTYEQYF,1,0,1,1
TRBV7-2,TRBJ2-7,CASSLGGTTIYEQYF,1,0,1,1
TRBV7-3,TRBJ2-1,CASSLMSGRDNEQFF,1,0,1,1
TRBV7-2,TRBJ2-1,CASSLTSGTYNEQFF,1,0,1,1
TRBV7-9,TRBJ2-3,CASSLNGGGADTQYF,1,0,1,1
TRBV7-9,TRBJ2-3,CASSSLSGHTDTQYF,1,0,1,1
TRBV7-2,TRBJ1-5,CASSWDRASLEPQHF,1,0,1,1
TRBV6-2/3/5/6,TRBJ1-5,CASSYQDPGFQPQHF,1,0,1,1
TRBV7-2,TRBJ2-7,CASSLRTGEHYEQYF,1,0,1,1
TRBV7-2,TRBJ2-7,CASSLAGGASYEQYF,1,0,1,1
TRBV7-2,TRBJ1-4,CASSLGQIGFEKLFF,1,0,1,1
TRBV5-6,TRBJ2-2,CASSLRQVTTGELFF,1,1,2,2
TRBV7-8,TRBJ2-1,CASSLMFRSYNEQFF,1,0,1,1
TRBV7-9,TRBJ2-5,CASSPRGGDRETQYF,1,0,1,1
TRBV3-1,TRBJ2-1,CASSPQEARDNEQSF,1,0,1,1
TRBV5-5,TRBJ1-2,CASSPVGTGNYGYTF,1,0,1,1
TRBV6-2/3/5/6,TRBJ1-2,CASSPGTGLNYGYTF,1,0,1,1
TRBV7-2,TRBJ2-1,CASSPGTGRYNEQFF,1,0,1,1
TRBV7-3,TRBJ2-3,CASSPSPARTDTQYF,1,0,1,1
TRBV7-2,TRBJ2-1,CASSPGTSGYNEQFF,1,1,2,2
TRBV7-8,TRBJ2-1,CASSPLAGSYNEQFF,1,0,1,1
TRBV6-2/3/5/6,TRBJ1-5,CASSPRRTGNQPQHF,1,0,1,1
TRBV7-2,TRBJ1-6,CASSPGTGRDSPLHF,1,0,1,1
TRBV7-9,TRBJ2-3,CASSPDGYRRDTQYF,1,0,1,1
TRBV12-3/4,TRBJ1-2,CASSPNRANPYGYTF,1,0,1,1
TRBV4-2,TRBJ1-2,CASSRAGQGSGGYTF,1,0,1,1
TRBV27,TRBJ2-5,CASSRDRGIGETQYF,1,0,1,1
TRBV3-1,TRBJ2-3,CASSQGGGRTDTQYF,1,0,1,1
TRBV11-2,TRBJ2-5,CASSQGLAGGETQYF,1,0,1,1
TRBV4-2,TRBJ2-7,CASSQEDLATYEQYF,1,0,1,1
TRBV3-1,TRBJ2-5,CASSQVLAGRETQYF,1,2,2,3
TRBV14,TRBJ2-1,CASSQASSGRGEQFF,1,0,1,1
TRBV4-2,TRBJ2-4,CASSQAVNPSHIQYF,1,0,1,1
TRBV14,TRBJ1-2,CASSQGARVTYGYTF,1,0,1,1
TRBV3-1,TRBJ1-4,CASSQDWATNEKLFF,1,0,1,1
TRBV3-1,TRBJ2-7,CASSQEPTLPSEQYF,1,0,1,1
TRBV3-1,TRBJ2-5,CASSQEVGTQETQYF,1,0,1,1
TRBV9,TRBJ2-2,CASSVAPTSSGELFF,1,0,1,1
TRBV9,TRBJ2-5,CASSVAGTGQETQYF,1,0,1,1
TRBV9,TRBJ2-1,CASSVDGGRADEQFF,1,0,1,1
TRBV27,TRBJ1-5,CASSKTKIRGQPQHF,1,0,1,1
TRBV12-3/4,TRBJ2-3,CASRSGTRSTDTQYF,1,0,1,1
TRBV6-4,TRBJ2-7,CASRVDRGASYEQYF,1,0,1,1
TRBV6-2/3/5/6,TRBJ2-1,CASRGTSGPGAEQFF,1,0,1,1
TRBV5-4,TRBJ2-3,CASREAGGPRDTQYF,1,0,1,1
TRBV6-1,TRBJ1-1,CASRSGGGSVREAFF,1,0,1,1
TRBV7-6,TRBJ2-3,CASRPVSGGADTQYF,1,0,1,1
TRBV11-2,TRBJ1-1,CASRRVPGGRTEAFF,1,1,2,2
TRBV7-2,TRBJ2-7,CASRELSGGANEQYF,1,0,1,1
TRBV6-1,TRBJ1-1,CASREGRGMNTEAFF,1,0,1,1
TRBV2,TRBJ2-4,CASREGGLAKNIQYF,1,0,1,1
TRBV13,TRBJ2-7,CASNYQTGSFGEQYF,1,0,1,1
TRBV5-1,TRBJ2-3,CATKLGGSLSDTQYF,1,0,1,1
TRBV5-1,TRBJ2-1,CASNPLRGSYNEQFF,1,0,1,1
TRBV4-1,TRBJ1-2,CASLAPGQINYGYTF,1,0,1,1
TRBV4-3,TRBJ2-1,CASTPLAGDAGEQFF,1,0,1,1
TRBV5-1,TRBJ2-6,CASSLVGLGANVLTF,1,0,1,1
TRBV5-1,TRBJ1-1,CASSLAGPSSTEAFF,1,0,1,1
TRBV5-1,TRBJ2-7,CASSLPGSSSYEQYF,1,0,1,1
TRBV5-1,TRBJ2-5,CASSSGQGQQETQYF,1,0,1,1
TRBV5-1,TRBJ2-5,CASSLEGRNQETQYF,1,0,1,1
TRBV4-1,TRBJ2-4,CASSLSGGTKNIQYF,1,0,1,1
TRBV5-1,TRBJ2-5,CASSPRPYSAETQYF,1,0,1,1
TRBV5-1,TRBJ1-6,CASSPTSGADSPLHF,1,0,1,1
TRBV5-1,TRBJ2-1,CASSPLGGVYNEQFF,1,0,1,1
TRBV4-3,TRBJ1-4,CASSHRGRSNEKLFF,1,0,1,1
TRBV4-1,TRBJ1-2,CASSHQDRENYGYTF,1,1,2,2
TRBV4-3,TRBJ1-2,CASSQDGTASGGYTF,1,0,1,1
TRBV4-1,TRBJ2-7,CASSQTQVPVLEQYF,1,0,1,1
TRBV5-1,TRBJ2-7,CASSQGTVYYYEQYF,1,0,1,1
TRBV4-1,TRBJ1-4,CASSQDTGGGEKLFF,1,0,1,1
TRBV4-1,TRBJ1-1,CASSQDRQYSTEAFF,1,1,2,2
TRBV4-1,TRBJ1-2,CASSVPGGSNYGYTF,1,0,1,1
TRBV5-1,TRBJ1-1,CASSEKKDTDTEAFF,1,0,1,1
TRBV5-1,TRBJ2-5,CASSKDRGRLETQYF,1,0,1,1
TRBV5-1,TRBJ2-1,CASNLQGALYNEQFF,1,0,1,1
TRBV20-1,TRBJ2-2,CSARAGGAGTGELFF,1,0,1,1
TRBV20-1,TRBJ2-7,CSARSGAGAGYEQYF,1,0,1,1
TRBV20-1,TRBJ2-3,CSARFGSGSPDTQYF,1,0,1,1
TRBV20-1,TRBJ1-3,CSARGSWDIQNAIYF,1,0,1,1
TRBV20-1,TRBJ1-4,CSARDWKETNEKLFF,1,0,1,1
TRBV20-1,TRBJ2-1,CSARDPAGHYNEQFF,1,0,1,1
TRBV20-1,TRBJ2-7,CSARDGGQESNEQYF,1,0,1,1
TRBV20-1,TRBJ2-1,CSARDGGLPYNEQFF,1,1,2,2
TRBV20-1,TRBJ1-4,CSARDMGTTNEKLFF,1,0,1,1
TRBV20-1,TRBJ2-7,CSARELGLPIGEQYF,1,0,1,1
TRBV20-1,TRBJ2-1,CSAREPERDSNEQFF,1,0,1,1
TRBV20-1,TRBJ2-1,CSAREWERFSYEQFF,1,0,1,1
TRBV20-1,TRBJ1-5,CSARRADGGNQPQHF,1,0,1,1
TRBV20-1,TRBJ1-5,CSAPGTGRFNQPQHF,1,0,1,1
TRBV20-1,TRBJ2-7,CSARTGGTFSYEQYF,1,0,1,1
TRBV20-1,TRBJ2-1,CSATRPSGGYNEQFF,1,0,1,1
TRBV29-1,TRBJ2-7,CSVSVFGTGGVEQYF,1,0,1,1
TRBV29-1,TRBJ2-1,CSVRSGRADINEQFF,1,0,1,1
TRBV29-1,TRBJ1-4,CSVAGNTATNEKLFF,1,0,1,1
TRBV29-1,TRBJ2-1,CSVDRGGSPTREQFF,1,0,1,1
TRBV29-1,TRBJ2-3,CSVESGRGRTDTQYF,1,0,1,1
TRBV29-1,TRBJ2-5,CSVELRGGLVETQYF,1,0,1,1
TRBV29-1,TRBJ1-1,CSVPEGATGTYEAFF,1,0,1,1
TRBV29-1,TRBJ1-2,CSAASTGTENYGYTF,1,0,1,1
TRBV29-1,TRBJ2-4,CSATAGGPANNIQYF,1,0,1,1
TRBV12-5,TRBJ2-5,CASGARQSGETQYL,1,0,1,1
TRBV30,TRBJ2-2,CAWSLPRDTGELFF,1,0,1,1
TRBV30,TRBJ1-6,CAWRGGSYNSPLHF,1,0,1,1
TRBV15,TRBJ1-4,CAAAPGTGDEKLFF,1,0,1,1
TRBV10-3,TRBJ1-2,CAIPKIDGTYGYTF,1,0,1,1
TRBV10-3,TRBJ1-1,CAISPGTPDVAAFF,1,0,1,1
TRBV10-3,TRBJ1-1,CAISESRGNTEAFF,1,0,1,1
TRBV10-3,TRBJ1-1,CAISEPVDSRGAFF,1,0,1,1
TRBV24-1,TRBJ2-7,CATSESAGTYEQYF,1,0,1,1
TRBV27,TRBJ1-1,CASSTGGAVTEAFF,1,0,1,1
TRBV2,TRBJ2-5,CASPSQGGVETQYF,1,0,1,1
TRBV19,TRBJ1-1,CASIQTGLNTEAFF,1,0,1,1
TRBV19,TRBJ1-3,CASSPPVSGNTIYF,1,0,1,1
TRBV19,TRBJ2-7,CASSVDGSSYEQYF,1,1,2,2
TRBV19,TRBJ1-3,CASSILGAGNTIYF,1,0,1,1
TRBV19,TRBJ1-4,CASSIHQGNEKLFF,1,0,1,1
TRBV19,TRBJ1-2,CASSIATVNYGYTF,1,0,1,1
TRBV19,TRBJ2-5,CASSIRGYQETQYF,1,0,1,1
TRBV19,TRBJ2-1,CASSTGLAFNEQFF,1,0,1,1
TRBV19,TRBJ1-1,CASSTGGANTEAFF,1,0,1,1
TRBV19,TRBJ2-1,CASSRTALNNEQFF,1,0,1,1
TRBV19,TRBJ1-2,CASSPTPGVYGYTF,1,0,1,1
TRBV19,TRBJ2-1,CASSRSSGYNEQFF,1,0,1,1
TRBV18,TRBJ1-1,CASSPEGDNPEAFF,1,1,2,2
TRBV18,TRBJ2-7,CASSPGSGAYEQYF,1,0,1,1
TRBV18,TRBJ1-1,CASSPKGLDTEAFF,1,0,1,1
TRBV5-6,TRBJ2-5,CASRDREYQETQYF,1,0,1,1
TRBV19,TRBJ1-5,CASATARSNQPQHF,1,0,1,1
TRBV12-3/4,TRBJ2-7,CASADSLNSYEQYF,1,0,1,1
TRBV7-2,TRBJ2-5,CASGLARRVETQYF,1,0,1,1
TRBV7-2,TRBJ1-2,CASISAGRNYGYTF,1,0,1,1
TRBV2,TRBJ1-6,CASTSRTLGSSLHF,1,0,1,1
TRBV12-3/4,TRBJ1-1,CASTADGSNTEAFF,1,0,1,1
TRBV2,TRBJ2-2,CASTTAVNTGELFF,1,0,1,1
TRBV7-9,TRBJ1-1,CASTSDSWDREAFF,1,0,1,1
TRBV6-2/3/5/6,TRBJ2-7,CASTPSGRSYEQYF,1,0,1,1
TRBV11-2,TRBJ2-1,CASTQLAGYNEQFF,1,0,1,1
TRBV7-2,TRBJ2-7,CASTAPSGNYEQYF,1,0,1,1
TRBV12-3/4,TRBJ1-1,CASTAGLGNTEAFF,1,0,1,1
TRBV12-3/4,TRBJ1-5,CASSFSVRYQPQHF,1,0,1,1
TRBV12-3/4,TRBJ1-1,CASSFREMNTEAFF,1,0,1,1
TRBV12-3/4,TRBJ1-1,CASSFGQLNTEAFF,1,0,1,1
TRBV6-2/3/5/6,TRBJ1-5,CASSLAGDNQPQHF,1,0,1,1
TRBV12-3/4,TRBJ2-1,CASSLGSGYNEQFF,1,0,1,1
TRBV6-2/3/5/6,TRBJ1-5,CASSLLGRNQPQHF,1,0,1,1
TRBV12-3/4,TRBJ1-1,CASSLQEIRSEAFF,1,0,1,1
TRBV12-3/4,TRBJ2-7,CASSLQGQAYEQYF,1,0,1,1
TRBV28,TRBJ2-2,CASSLVRTPGELFF,1,0,1,1
TRBV6-2/3/5/6,TRBJ2-7,CASSSQGSSYEQYF,1,0,1,1
TRBV12-3/4,TRBJ2-1,CASSSTDRGGEQFF,1,0,1,1
TRBV12-3/4,TRBJ2-1,CASSSTGRNNEQFF,1,0,1,1
TRBV11-2,TRBJ2-4,CASSSPRGKNIQYF,1,0,1,1
TRBV6-2/3/5/6,TRBJ1-4,CASSSQGRGEKLFF,1,0,1,1
TRBV6-2/3/5/6,TRBJ1-2,CASSWGLGYYGYTF,1,0,1,1
TRBV6-2/3/5/6,TRBJ1-5,CASSWDSGNQPQHF,1,1,2,2
TRBV12-3/4,TRBJ2-7,CASSWDSSSYEQYF,1,0,1,1
TRBV12-3/4,TRBJ1-1,CASSWTSANTEAFF,1,0,1,1
TRBV6-2/3/5/6,TRBJ1-6,CASSYGQGNSPLHF,1,0,1,1
TRBV6-2/3/5/6,TRBJ2-1,CASSYSRQGNEQFF,1,0,1,1
TRBV6-2/3/5/6,TRBJ2-7,CASSYSGGSYEQYF,1,0,1,1
TRBV6-2/3/5/6,TRBJ2-5,CASSYSERVETQYF,1,1,2,2
TRBV6-2/3/5/6,TRBJ2-7,CASSYSTGGNEQYF,1,2,2,3
TRBV6-2/3/5/6,TRBJ1-5,CASSYSTGGQPQHF,1,0,1,1
TRBV7-9,TRBJ1-1,CASSYPPGVIEAFF,1,0,1,1
TRBV6-2/3/5/6,TRBJ2-1,CASSYAGGLAEQFF,1,0,1,1
TRBV6-2/3/5/6,TRBJ2-5,CASSYGGQQETQYF,1,0,1,1
TRBV6-2/3/5/6,TRBJ1-1,CASSYMGVNTEAFF,1,0,1,1
TRBV6-2/3/5/6,TRBJ2-2,CASSYNAPTGELFF,1,0,1,1
TRBV6-2/3/5/6,TRBJ2-7,CASSLRYIHCEQYF,1,0,1,1
TRBV6-2/3/5/6,TRBJ1-5,CASSLRQGGRPQHF,1,0,1,1
TRBV28,TRBJ2-3,CASSLTLTSDTQYF,1,0,1,1
TRBV27,TRBJ2-7,CASSPRGVVYEQYF,1,0,1,1
TRBV6-2/3/5/6,TRBJ1-1,CASSPGRGRTEAFF,1,0,1,1
TRBV2,TRBJ2-2,CASSRTRNTGELFF,1,1,2,2
TRBV7-9,TRBJ2-1,CASSRGGGYNEQFF,1,0,1,1
TRBV12-3/4,TRBJ2-5,CASSHTRGVETQYF,1,0,1,1
TRBV12-3/4,TRBJ2-7,CASSQLGGSYEQYF,1,1,2,2
TRBV6-1,TRBJ1-5,CASSQDRTYQAQHF,1,0,1,1
TRBV12-3/4,TRBJ2-2,CASSVGGDTGELFF,1,0,1,1
TRBV6-4,TRBJ1-1,CASSAQFGTDEAFF,1,0,1,1
TRBV6-1,TRBJ2-4,CASSAGTVKNIQYF,1,0,1,1
TRBV2,TRBJ1-5,CASSGRINNQPQHF,1,0,1,1
TRBV2,TRBJ1-4,CASSGQGLREKLFF,1,0,1,1
TRBV6-1,TRBJ1-2,CASSGTPGWYGYTF,1,0,1,1
TRBV6-4,TRBJ1-1,CASSDSGDGDEAFF,1,0,1,1
TRBV6-1,TRBJ2-5,CASSELSVKETQYF,1,0,1,1
TRBV2,TRBJ1-1,CASSELQGATEAFF,1,1,2,2
TRBV25-1,TRBJ1-4,CASSEWGRGRKLFF,1,0,1,1
TRBV6-1,TRBJ1-1,CASSERQGISEAFF,1,0,1,1
TRBV6-1,TRBJ2-1,CASSEVEINNEQFF,1,0,1,1
TRBV6-1,TRBJ1-1,CASSEGAENTEAFF,1,0,1,1
TRBV6-2/3/5/6,TRBJ2-2,CASSMGLDTGELFF,1,0,1,1
TRBV5-4,TRBJ1-1,CASSFQGVGTGAFF,1,0,1,1
TRBV11-2,TRBJ2-7,CASSFGGLRNEQYF,1,0,1,1
TRBV11-2,TRBJ2-1,CASSFSGRGYEQFF,1,0,1,1
TRBV7-9,TRBJ2-3,CASSFFSGPDTQYF,1,0,1,1
TRBV7-2,TRBJ2-1,CASSFWGSAGEQFF,1,0,1,1
TRBV5-5,TRBJ1-5,CASSFGQGAQPQHF,1,0,1,1
TRBV5-6,TRBJ1-1,CASSLGGLNTEAFF,1,0,1,1
TRBV7-8,TRBJ2-1,CASSLTGDHNEQFF,1,0,1,1
TRBV7-9,TRBJ1-4,CASSLPAGPEKLFF,1,0,1,1
TRBV7-9,TRBJ2-6,CASSLPPGANVLTF,1,1,2,2
TRBV7-6,TRBJ1-1,CASSLRGPNTEAFF,1,0,1,1
TRBV7-8,TRBJ1-5,CASSLRQGGQPQHF,1,1,2,2
TRBV7-7,TRBJ2-5,CASSLQGQGETQYF,1,0,1,1
TRBV7-6,TRBJ1-1,CASSLAPPGTEAFF,1,0,1,1
TRBV7-2,TRBJ2-2,CASSLAPMTGELFF,1,0,1,1
TRBV6-2/3/5/6,TRBJ2-7,CASSLAGGPYEQYF,1,0,1,1
TRBV7-9,TRBJ1-2,CASSLAEGTYGYTF,1,0,1,1
TRBV7-2,TRBJ1-2,CASSLGGATPGYTF,1,0,1,1
TRBV7-8,TRBJ2-7,CASSLGTGDHEQYF,1,0,1,1
TRBV7-2,TRBJ1-4,CASSLGKGNEKLFF,1,0,1,1
TRBV7-9,TRBJ2-2,CASSLDYHTGELFF,1,0,1,1
TRBV11-1,TRBJ1-1,CASSLRGGLSEAFF,1,0,1,1
TRBV6-2/3/5/6,TRBJ1-1,CASSSHRRSSEAFF,1,0,1,1
TRBV6-2/3/5/6,TRBJ2-1,CASSSGTLYNEQFF,1,0,1,1
TRBV7-6,TRBJ1-2,CASSSRGANYGYTF,1,0,1,1
TRBV7-2,TRBJ1-5,CASSSDGSNQPQHF,1,0,1,1
TRBV7-6,TRBJ2-3,CASSSLRETDTQYF,1,0,1,1
TRBV7-9,TRBJ1-1,CASSSLGSDTEAFF,1,0,1,1
TRBV5-4,TRBJ2-1,CASSSMEGYNEQFF,1,0,1,1
TRBV9,TRBJ1-2,CASSPSWVNYGYTF,1,0,1,1
TRBV6-2/3/5/6,TRBJ2-3,CASSPSQGSDTQYF,1,0,1,1
TRBV7-9,TRBJ2-7,CASSPPRETYEQYF,1,0,1,1
TRBV12-3/4,TRBJ1-1,CASSPRTPGTEAFF,1,2,2,3
TRBV11-2,TRBJ2-5,CASSPQQYQETQYF,1,0,1,1
TRBV7-2,TRBJ2-7,CASSPGQYSYEQYF,1,0,1,1
TRBV9,TRBJ1-3,CASSPTTSGNTIYF,1,0,1,1
TRBV7-2,TRBJ2-7,CASSPTGGDYEQYF,1,0,1,1
TRBV7-2,TRBJ1-1,CASSPNPANTEAFF,1,0,1,1
TRBV7-9,TRBJ1-2,CASSPPWGDYGYTF,1,0,1,1
TRBV2,TRBJ1-2,CASSPGQPLYGYTF,1,0,1,1
TRBV7-2,TRBJ1-4,CASSPTGTFEKLFF,1,0,1,1
TRBV7-4,TRBJ2-7,CASSPRLAGDEQYF,1,0,1,1
TRBV7-6,TRBJ2-7,CASSPSTGANEQYF,1,0,1,1
TRBV4-2,TRBJ2-1,CASSRGELNNEQFF,1,0,1,1
TRBV7-9,TRBJ1-5,CASSRGGAGQPQHF,1,0,1,1
TRBV7-9,TRBJ1-6,CASSRDRGNSPLHF,1,0,1,1
TRBV14,TRBJ2-3,CASSHGGSTDTRYF,1,0,1,1
TRBV14,TRBJ2-3,CASSHGGSTDTQYF,1,0,1,1
TRBV12-3/4,TRBJ1-2,CASSHGRPNYGYTF,1,0,1,1
TRBV3-1,TRBJ2-1,CASSQEPRDNEQFF,1,0,1,1
TRBV7-9,TRBJ1-2,CASSQLGESYGYTF,1,0,1,1
TRBV3-1,TRBJ2-5,CASSQAGSQETQYF,1,0,1,1
TRBV3-1,TRBJ2-7,CASSQGTVTDEQYF,1,0,1,1
TRBV7-9,TRBJ2-2,CASSQSLSPGELFF,1,0,1,1
TRBV4-2,TRBJ2-1,CASSVGQGIHEQFF,1,0,1,1
TRBV7-9,TRBJ1-4,CASSVTGSGEKLFF,1,0,1,1
TRBV9,TRBJ2-5,CASSVAFLEETQYF,1,0,1,1
TRBV9,TRBJ2-7,CASSVEPGSYEQYF,1,0,1,1
TRBV9,TRBJ1-2,CASSALGSNYGYTF,1,0,1,1
TRBV7-9,TRBJ2-4,CASSGTGGKNIQYF,1,0,1,1
TRBV7-2,TRBJ2-7,CASSTRTGPYEQYF,1,0,1,1
TRBV5-5,TRBJ2-7,CASSTSPRRDEQYF,1,0,1,1
TRBV6-2/3/5/6,TRBJ2-3,CASSTGLGADTQYF,1,0,1,1
TRBV2,TRBJ2-5,CASRQDRGDETQYF,1,0,1,1
TRBV2,TRBJ2-1,CASRGDRGRNEQFF,1,0,1,1
TRBV12-3/4,TRBJ2-4,CASRTGGAKNIQYF,1,1,2,2
TRBV6-4,TRBJ1-2,CASRTGGLDYGYTF,1,0,1,1
TRBV6-2/3/5/6,TRBJ1-4,CASRRQGGSEKLFF,1,0,1,1
TRBV2,TRBJ2-6,CASRPGSGANVLTF,1,0,1,1
TRBV6-2/3/5/6,TRBJ1-5,CASRQDRTYQPQHF,1,0,1,1
TRBV7-7,TRBJ1-1,CASRKQGARTEAFF,1,0,1,1
TRBV27,TRBJ1-1,CASNQGVENTEAFF,1,0,1,1
TRBV12-3/4,TRBJ1-1,CASNTGQGQAEAFF,1,1,2,2
TRBV3-1,TRBJ2-2,CASKPRGNTGELFF,1,0,1,1
TRBV14,TRBJ2-7,CARQGRGDPYEQYF,1,0,1,1
TRBV7-6,TRBJ2-7,CANQRMAGGLEQYF,1,0,1,1
TRBV4-1,TRBJ1-1,CASTGLSLGTEAFF,1,0,1,1
TRBV5-1,TRBJ2-7,CASSLDVLSYEQYF,1,0,1,1
TRBV5-1,TRBJ1-5,CASSLDGGHQPQHF,1,0,1,1
TRBV5-1,TRBJ1-1,CASSLNGGHTEAFF,1,2,2,3
TRBV5-1,TRBJ1-1,CASSLQVSGTEAFF,1,0,1,1
TRBV5-1,TRBJ2-7,CASSSEGGGDEQYF,1,0,1,1
TRBV5-1,TRBJ1-1,CASSLGGRNTEAFF,1,0,1,1
TRBV5-1,TRBJ1-3,CASSPGGSGNTIYF,1,0,1,1
TRBV4-1,TRBJ1-5,CASSPGQDHQPQHF,1,0,1,1
TRBV5-1,TRBJ2-7,CASSPGQGGAHADF,1,0,1,1
TRBV5-1,TRBJ1-1,CASSRQGQNTEAFF,1,0,1,1
TRBV4-3,TRBJ2-7,CASSRRLGPYEQYF,1,0,1,1
TRBV4-1,TRBJ1-1,CASSRRVLGTEAFF,1,0,1,1
TRBV4-3,TRBJ2-7,CASSQGLAAYEQYF,1,1,2,2
TRBV4-3,TRBJ2-1,CASSQGQGGNEQFF,1,0,1,1
TRBV4-1,TRBJ1-1,CASSQTGANTEAFF,1,0,1,1
TRBV4-1,TRBJ1-1,CASSQTGGNTEAFF,1,0,1,1
TRBV4-1,TRBJ2-7,CASSQTRGDYEQYF,1,0,1,1
TRBV4-1,TRBJ2-1,CASSQPTSYNEQFF,1,0,1,1
TRBV4-3,TRBJ1-5,CASSQAGGAEPQHF,1,0,1,1
TRBV4-1,TRBJ2-7,CASSQGDRAYEQYF,1,0,1,1
TRBV4-3,TRBJ1-2,CASSQGQRPYGYTF,1,0,1,1
TRBV4-1,TRBJ2-1,CASSQDPGSNEQFF,1,0,1,1
TRBV4-1,TRBJ2-7,CASSQDPSSRGQYF,1,0,1,1
TRBV4-3,TRBJ2-7,CASSQDRGPYEQYF,1,0,1,1
TRBV4-3,TRBJ1-5,CASSQDRVRQPQHF,1,0,1,1
TRBV5-1,TRBJ2-7,CASSGTSGAYEQYF,1,0,1,1
TRBV5-1,TRBJ1-3,CASRQQGGGNTIYF,1,0,1,1
TRBV20-1,TRBJ2-7,CSAYRDGETYEQYF,1,0,1,1
TRBV20-1,TRBJ1-1,CSALLGSMNTEAFF,1,0,1,1
TRBV20-1,TRBJ2-1,CSAPLAGGLKSPFF,1,0,1,1
TRBV20-1,TRBJ1-1,CSAPGTKPNTEAFF,1,0,1,1
TRBV20-1,TRBJ2-1,CSADSGRGYNEQFF,1,0,1,1
TRBV20-1,TRBJ2-1,CSATGGGIYNEQFF,1,0,1,1
TRBV20-1,TRBJ1-2,CSASPQTGPYGYTF,1,0,1,1
TRBV20-1,TRBJ2-1,CSARGEGYRDEQFF,1,0,1,1
TRBV20-1,TRBJ2-5,CSARYSRQGETQYF,1,0,1,1
TRBV20-1,TRBJ2-1,CSARLGGSYNEQFF,1,0,1,1
TRBV20-1,TRBJ2-7,CSARVESRSYEQYF,1,0,1,1
TRBV20-1,TRBJ1-1,CSARVTGGGTEAFF,1,0,1,1
TRBV20-1,TRBJ2-1,CSARAGLVGGEQFF,1,0,1,1
TRBV20-1,TRBJ2-2,CSARDLAVSGELFF,1,0,1,1
TRBV20-1,TRBJ2-1,CSAREEGGHHEQFF,1,0,1,1
TRBV20-1,TRBJ2-7,CSAPTGTGGNEQYF,1,0,1,1
TRBV20-1,TRBJ1-2,CSAANRGLSYGYTF,1,1,2,2
TRBV20-1,TRBJ2-7,CSAGGAGLSYEQYF,1,0,1,1
TRBV20-1,TRBJ2-5,CSAMTPGRRETQYF,1,0,1,1
TRBV20-1,TRBJ2-7,CSALGLPSSYEQYF,1,0,1,1
TRBV29-1,TRBJ1-1,CSVRGAGLQTEAFF,1,0,1,1
TRBV29-1,TRBJ2-1,CSVGWGGESREQFF,1,0,1,1
TRBV29-1,TRBJ2-2,CSVDGGGNTGELFF,1,0,1,1
TRBV29-1,TRBJ2-1,CSVEGPDLYNEQFF,1,0,1,1
TRBV29-1,TRBJ2-1,CSVEGTGDNNEQFF,1,0,1,1
TRBV29-1,TRBJ1-2,CSVEQTGANYGYTF,1,0,1,1
TRBV29-1,TRBJ2-7,CSVAARGISYEQYF,1,0,1,1
TRBV29-1,TRBJ2-3,CSVAAGASTDTQYF,1,0,1,1
TRBV29-1,TRBJ1-4,CSAATGPLDEKLFF,1,0,1,1
TRBV29-1,TRBJ1-1,CSAMPGTGNTEAFF,1,0,1,1
TRBV29-1,TRBJ2-1,CSGGTGGRYNEQFF,1,0,1,1
TRBV30,TRBJ2-1,SAWSKAQLDNEQFF,1,0,1,1
TRBV30,TRBJ2-7,CVIGSGQSYEQYF,1,0,1,1
TRBV12-5,TRBJ1-1,CASGYRPNTEAFF,1,0,1,1
TRBV30,TRBJ1-1,CAWMDPVNTEAFF,1,0,1,1
TRBV30,TRBJ1-2,CAWSVIQGHSYTF,1,0,1,1
TRBV30,TRBJ2-7,CAWSVNGLGEQYF,1,0,1,1
TRBV30,TRBJ1-1,CAWSAQGQTEAFF,1,0,1,1
TRBV10-3,TRBJ2-3,CAITDGSTDTQYF,1,0,1,1
TRBV10-3,TRBJ2-3,CAISERGTDTQYF,1,0,1,1
TRBV10-3,TRBJ1-4,CAISLDRAEKLFF,1,0,1,1
TRBV9,TRBJ1-6,CATSQGADSPLHF,1,0,1,1
TRBV2,TRBJ2-7,CATPGTGGREQYF,1,0,1,1
TRBV7-2,TRBJ2-3,CATTGLSTDTQYF,1,0,1,1
TRBV24-1,TRBJ2-7,CATSGTGTDEQYF,1,1,2,2
TRBV24-1,TRBJ2-1,CATSKTSNNEQFF,1,1,2,2
TRBV15,TRBJ2-7,CATSRGLSYEQYF,1,0,1,1
TRBV15,TRBJ2-5,CATSRGEGGTQYF,1,0,1,1
TRBV19,TRBJ2-1,CASSPSGVREQFF,1,0,1,1
TRBV19,TRBJ2-7,CASSEQDSYEQYF,1,0,1,1
TRBV19,TRBJ1-1,CASSIQTKREAFF,1,0,1,1
TRBV19,TRBJ1-2,CASSIGQGRFYTF,1,0,1,1
TRBV19,TRBJ1-2,CASSNPVNYGYTF,1,0,1,1
TRBV19,TRBJ1-1,CASSHQRGTEAFF,1,0,1,1
TRBV12-3/4,TRBJ2-6,CASLTSGANVLTF,1,0,1,1
TRBV18,TRBJ2-5,CASSPGRGETQYF,1,0,1,1
TRBV18,TRBJ2-7,CASSLQGAGEQYF,1,0,1,1
TRBV18,TRBJ2-7,CASSPAESYEQYF,1,0,1,1
TRBV2,TRBJ1-2,CASAPGQIYGYTF,1,0,1,1
TRBV28,TRBJ2-3,CASISKTTGLQYF,1,0,1,1
TRBV7-9,TRBJ2-3,CASIPVNTDTQYF,1,0,1,1
TRBV2,TRBJ1-1,CASITDSYTEAFF,1,0,1,1
TRBV12-3/4,TRBJ2-3,CASMESSADTQYF,1,0,1,1
TRBV7-6,TRBJ2-1,CASTAWGANEQFF,1,0,1,1
TRBV27,TRBJ1-1,CASSFDRALVAFF,1,0,1,1
TRBV12-3/4,TRBJ1-2,CASSLGPNYGYTF,1,0,1,1
TRBV27,TRBJ2-3,CASSLSSTDTQYF,1,0,1,1
TRBV6-2/3/5/6,TRBJ2-7,CASSLSGAYEQYF,1,0,1,1
TRBV28,TRBJ2-5,CASSLSGFGTQYF,1,0,1,1
TRBV12-3/4,TRBJ1-1,CASSLAVGREAFF,1,0,1,1
TRBV6-2/3/5/6,TRBJ1-3,CASSLGTGNTIYF,1,0,1,1
TRBV6-2/3/5/6,TRBJ2-7,CASSLNVLGEQYL,1,0,1,1
TRBV27,TRBJ1-5,CASSLKGNQPQHF,1,0,1,1
TRBV2,TRBJ2-3,CASSSMSWDTQYF,1,0,1,1
TRBV5-5,TRBJ2-5,CASSWGAQETQYF,1,0,1,1
TRBV6-2/3/5/6,TRBJ2-1,CASSYQAYNEQFF,1,0,1,1
TRBV27,TRBJ2-5,CASSPFEQETQYF,1,0,1,1
TRBV6-1,TRBJ1-1,CASSAGKITEAFF,1,0,1,1
TRBV2,TRBJ1-1,CASSGLEGTEAFF,1,0,1,1
TRBV2,TRBJ2-4,CASSDGDRGIQYF,1,0,1,1
TRBV6-1,TRBJ2-2,CASSDGEFRELFF,1,0,1,1
TRBV25-1,TRBJ1-1,CASSEWGRVEAFF,1,0,1,1
TRBV2,TRBJ2-7,CASSEGGSYEQYF,1,0,1,1
TRBV6-2/3/5/6,TRBJ2-7,CASSSSVAYEQYF,1,0,1,1
TRBV25-1,TRBJ2-5,CASSRQGQETQYF,1,0,1,1
TRBV7-6,TRBJ2-7,CASSFRDTYEQYF,1,0,1,1
TRBV5-6,TRBJ2-3,CASSLLGTDTQYF,1,1,2,2
TRBV5-5,TRBJ1-2,CASSLADRDDYTF,1,0,1,1
TRBV13,TRBJ1-2,CASSLWGADGYTF,1,0,1,1
TRBV7-6,TRBJ2-7,CASSLVQGYEQYF,1,0,1,1
TRBV7-8,TRBJ2-3,CASSLVSTDTQYF,1,0,1,1
TRBV7-9,TRBJ1-1,CASSLDRGVGAFF,1,0,1,1
TRBV7-9,TRBJ1-1,CASSLDTGTKAFF,1,0,1,1
TRBV5-6,TRBJ1-6,CASSLDKFSPLHF,1,0,1,1
TRBV7-8,TRBJ2-7,CASSLNPGSEQYF,1,0,1,1
TRBV7-9,TRBJ1-2,CASSSSGGHGYTF,1,0,1,1
TRBV11-2,TRBJ2-1,CASSSGLFNEQFF,1,0,1,1
TRBV7-9,TRBJ1-1,CASSSGGDLEAFF,1,0,1,1
TRBV4-2,TRBJ2-7,CASSWRGTYEQYF,1,0,1,1
TRBV3-1,TRBJ2-5,CASSLINQETQYF,1,0,1,1
TRBV11-2,TRBJ1-1,CASSLGWGTEAFF,1,0,1,1
TRBV7-2,TRBJ2-7,CASSLGGYYEQYF,1,0,1,1
TRBV7-9,TRBJ1-1,CASSPYRDTEAFF,1,0,1,1
TRBV12-3/4,TRBJ1-5,CASSPPAGGPQHF,1,0,1,1
TRBV7-9,TRBJ1-2,CASSPRIGVGYTF,1,0,1,1
TRBV7-2,TRBJ2-5,CASSPGLQETQYF,1,0,1,1
TRBV5-6,TRBJ1-1,CASSPDQGAEAFF,1,0,1,1
TRBV7-6,TRBJ1-2,CASSRDRTYGYTF,1,0,1,1
TRBV4-2,TRBJ2-7,CASSQAHSYEQYF,1,0,1,1
TRBV7-9,TRBJ1-2,CASSQTANYGYTF,1,0,1,1
TRBV4-2,TRBJ2-7,CASSQAGSYEQYF,2,0,1,2
TRBV3-1,TRBJ2-1,CASSQDFGGEQFF,1,0,1,1
TRBV4-2,TRBJ2-7,CASSVTGADEQYF,1,0,1,1
TRBV5-6,TRBJ2-2,CASSVNREGELFF,1,0,1,1
TRBV9,TRBJ2-1,CASSVDRTYEQFF,1,0,1,1
TRBV11-2,TRBJ1-2,CASSAAGVYGYTF,1,0,1,1
TRBV11-1,TRBJ1-2,CASSGVDYYGYTF,1,0,1,1
TRBV11-2,TRBJ2-1,CASSGGETSGAFF,1,0,1,1
TRBV7-2,TRBJ2-5,CASSNDNQETQYF,1,0,1,1
TRBV5-6,TRBJ1-5,CASSKGANQPQHF,1,0,1,1
TRBV7-9,TRBJ1-1,CASRSGGNTEAFF,1,0,1,1
TRBV7-9,TRBJ1-5,CASRRISNQPQHF,1,0,1,1
TRBV5-6,TRBJ1-2,CASRAGTDYGYTF,1,0,1,1
TRBV27,TRBJ2-1,CASRTGASNEQFF,1,0,1,1
TRBV6-2/3/5/6,TRBJ2-7,CASRWTAPYEQYF,1,0,1,1
TRBV7-9,TRBJ1-1,CASRLVGDTEAFF,1,0,1,1
TRBV27,TRBJ2-7,CASRLAGTYEQYF,1,0,1,1
TRBV6-1,TRBJ2-1,CASRETGDNEQFF,1,0,1,1
TRBV7-2,TRBJ1-2,CASRMDSNYGYTF,1,0,1,1
TRBV29-1,TRBJ1-2,CSVGGGGGIVYTF,1,0,1,1
TRBV4-1,TRBJ1-4,CASSFLQGEKLFF,1,0,1,1
TRBV10-2,TRBJ2-1,CASSEKGYNEQFF,1,0,1,1
TRBV2,TRBJ1-2,CASSESKEYGYTF,1,0,1,1
TRBV4-1,TRBJ2-5,CASSLGHRETQYF,1,0,1,1
TRBV4-1,TRBJ1-2,CASSQPGHYGYTF,1,0,1,1
TRBV4-1,TRBJ2-7,CASSQGFIYEQYF,1,0,1,1
TRBV4-3,TRBJ2-1,CASSQDQTNEQFF,1,0,1,1
TRBV4-3,TRBJ2-3,CASSQDITDTQYF,1,0,1,1
TRBV5-1,TRBJ2-3,CASSMGLAGLTYF,1,0,1,1
TRBV4-3,TRBJ2-7,CASSMGQAYEQYF,1,0,1,1
TRBV5-1,TRBJ2-5,CASKLAGEETQYF,1,0,1,1
TRBV20-1,TRBJ2-1,CSAAGTDYNEQFF,1,0,1,1
TRBV20-1,TRBJ1-5,CSAIQGFNQPQHF,1,0,1,1
TRBV20-1,TRBJ2-5,CSARAGGRETQYF,1,0,1,1
TRBV20-1,TRBJ1-5,CSARDSRNQPQHF,1,0,1,1
TRBV20-1,TRBJ2-7,CSARMGGFYEQYF,1,0,1,1
TRBV20-1,TRBJ2-1,CSAVRGSYNEQFF,1,0,1,1
TRBV20-1,TRBJ1-5,CSASGEVLQPQHF,1,0,1,1
TRBV20-1,TRBJ2-3,CSGIAGGIDTQYF,1,1,2,2
TRBV29-1,TRBJ2-7,CSFALAGGREQYF,1,0,1,1
TRBV29-1,TRBJ2-1,CSLRILNYNEQFF,1,0,1,1
TRBV29-1,TRBJ1-1,CSVPGQGLTEAFF,1,0,1,1
TRBV29-1,TRBJ2-1,CSVRTGDFNEQFF,1,0,1,1
TRBV29-1,TRBJ1-1,CSVGGRAGTEAFF,1,0,1,1
TRBV29-1,TRBJ1-2,CSVGLRGRYGYTF,1,0,1,1
TRBV29-1,TRBJ2-3,CSVDPLGGDTQYF,1,0,1,1
TRBV29-1,TRBJ1-1,CSVSGDMNTEAFF,1,0,1,1
TRBV29-1,TRBJ1-2,CSVPSGDYYGYTF,1,0,1,1
TRBV29-1,TRBJ1-2,CSVHRGQNYGYTF,1,0,1,1
TRBV29-1,TRBJ1-1,CSVAGTVNTEAFF,1,0,1,1
TRBV29-1,TRBJ1-1,CSVVDRGQTEAFF,1,0,1,1
TRBV29-1,TRBJ2-7,CSVGGMGPYEQYF,1,0,1,1
TRBV29-1,TRBJ2-1,CSVSRGGGIEQFF,1,0,1,1
TRBV29-1,TRBJ2-2,CSGLAGGGGELLF,1,0,1,1
TRBV29-1,TRBJ1-1,CSGGDGRNTEAFF,1,0,1,1
TRBV29-1,TRBJ2-3,CSGRTGGADTQYF,1,0,1,1
TRBV4-3,TRBJ2-3,RASGSGSPDTQYF,1,0,1,1
TRBV30,TRBJ2-7,CAWSVRGGEQYF,1,0,1,1
TRBV15,TRBJ1-5,CATSRDENTQHF,1,0,1,1
TRBV7-9,TRBJ2-1,CASHGGPNEQFF,1,0,1,1
TRBV19,TRBJ1-5,CASRTDNQPQHF,1,0,1,1
TRBV2,TRBJ1-2,CASQDRGSGYTF,1,0,1,1
TRBV7-9,TRBJ1-1,CASGLKAGEAFF,1,0,1,1
TRBV2,TRBJ2-5,CASGREGETQYF,1,0,1,1
TRBV19,TRBJ2-1,CASIGGPNEQFF,1,0,1,1
TRBV12-3/4,TRBJ2-1,CASTGTGVQQFF,1,0,1,1
TRBV12-3/4,TRBJ2-2,CASSFGTGELFF,1,1,2,2
TRBV12-3/4,TRBJ2-7,CASSFQGFEQYF,1,0,1,1
TRBV5-6,TRBJ2-7,CASSLVGYEQYF,1,2,2,3
TRBV27,TRBJ2-7,CASSSTGSEQYF,1,0,1,1
TRBV6-2/3/5/6,TRBJ2-3,CASSSSLDTQYF,1,0,1,1
TRBV12-3/4,TRBJ1-2,CASSSGQVGYTF,1,0,1,1
TRBV6-2/3/5/6,TRBJ2-1,CASSYFQFEQFF,1,0,1,1
TRBV25-1,TRBJ2-5,CASSVHDGTQYF,1,0,1,1
TRBV12-3/4,TRBJ1-5,CASSGPDQPQHF,1,0,1,1
TRBV6-1,TRBJ2-7,CASSDMVYEQYF,1,0,1,1
TRBV2,TRBJ2-5,CASSEAPGTQYF,1,0,1,1
TRBV3-1,TRBJ2-2,CASSKLAGELFF,1,0,1,1
TRBV7-9,TRBJ2-1,CASSLAQGEPFF,1,0,1,1
TRBV7-6,TRBJ2-2,CASSLGGRELFF,1,2,2,3
TRBV5-4,TRBJ2-7,CASSLMGIEQYF,1,0,1,1
TRBV7-6,TRBJ2-1,CASSLNLNEQFF,1,0,1,1
TRBV7-2,TRBJ2-7,CASSLNRAEQYF,1,0,1,1
TRBV7-2,TRBJ1-6,CASSSRHSPLHF,1,0,1,1
TRBV11-1,TRBJ2-5,CASSSDSETQYF,1,0,1,1
TRBV7-8,TRBJ2-7,CASSYSTYEQYF,1,0,1,1
TRBV7-2,TRBJ1-1,CASSLGGPEASF,1,0,1,1
TRBV7-9,TRBJ2-7,CASSLGLYDQYF,1,0,1,1
TRBV7-9,TRBJ2-7,CASSLGSYEQYF,1,0,1,1
TRBV7-6,TRBJ1-1,CASSPLNTEASF,1,0,1,1
TRBV7-9,TRBJ2-1,CASSPLGNEQFF,1,0,1,1
TRBV14,TRBJ2-5,CASSQDWETQYF,1,0,1,1
TRBV7-6,TRBJ1-2,CASSGPVEGYTF,1,0,1,1
TRBV6-2/3/5/6,TRBJ2-1,CASRTLTNEQFF,1,0,1,1
TRBV2,TRBJ1-5,CASRSSNQPQHF,1,0,1,1
TRBV6-2/3/5/6,TRBJ1-2,CASRSWMDGYTF,1,0,1,1
TRBV7-6,TRBJ2-2,CAAGAGTGELFF,1,0,1,1
TRBV4-1,TRBJ2-7,CASSQGPSEQYF,1,0,1,1
TRBV10-2,TRBJ1-2,CASSEGGLGYTF,1,0,1,1
TRBV5-1,TRBJ2-7,CASSSGPSEQYF,1,0,1,1
TRBV4-1,TRBJ1-5,CASSLPAGPQHF,1,0,1,1
TRBV4-1,TRBJ2-2,CASSHSAGELFF,1,0,1,1
TRBV4-1,TRBJ2-1,CASSQVGDEQFF,1,0,1,1
TRBV4-1,TRBJ2-7,CASSGVLGEQYF,1,0,1,1
TRBV20-1,TRBJ2-5,CSATSGGETQYF,1,0,1,1
TRBV20-1,TRBJ2-3,CSARVRTGTQYF,1,0,1,1
TRBV20-1,TRBJ2-1,CSAGRHYNEQFF,1,0,1,1
TRBV20-1,TRBJ2-5,CSARLLAGTQYF,1,0,1,1
TRBV29-1,TRBJ1-1,CSVLTGGTEAFL,1,0,1,1
TRBV29-1,TRBJ1-2,CSVPTGTRGYTF,1,0,1,1
TRBV29-1,TRBJ1-1,CSVARGNTEAFF,1,0,1,1
TRBV29-1,TRBJ1-5,CSVGGSDQPQHF,1,0,1,1
TRBV29-1,TRBJ1-1,CSVGTANTEAFF,1,0,1,1
TRBV29-1,TRBJ2-7,CSVEDLQTEQYF,1,0,1,1
TRBV29-1,TRBJ2-7,CSVEDGGGLQYF,1,0,1,1
TRBV29-1,TRBJ1-3,CSVETGRNTIYF,1,0,1,1
TRBV29-1,TRBJ2-7,CSVETQYYEQYF,1,0,1,1
TRBV29-1,TRBJ2-1,CSVESGSAEQFF,1,0,1,1
TRBV29-1,TRBJ1-2,CSVEQGRYGYTF,1,0,1,1
TRBV29-1,TRBJ1-5,CSVRGLNQPQHF,1,0,1,1
TRBV29-1,TRBJ1-1,CSATPYSTEAFF,1,0,1,1
TRBV29-1,TRBJ2-1,CSGQQGWDEQFF,1,0,1,1
TRBV29-1,TRBJ1-1,CSTFDLNTEAFF,1,0,1,1
TRBV30,TRBJ1-1,CAWIKNTEAFF,1,0,1,1
TRBV30,TRBJ1-1,CAWSSEDEAFF,1,0,1,1
TRBV30,TRBJ1-1,CAWSVRQGAFF,1,0,1,1
TRBV30,TRBJ2-1,CAWSVGGPRFF,1,0,1,1
TRBV18,TRBJ2-6,CASSGANVLTF,1,2,2,3
TRBV12-3/4,TRBJ2-1,CASVRAGEQFF,1,0,1,1
TRBV7-9,TRBJ2-5,CASTLQETQYF,1,0,1,1
TRBV6-2/3/5/6,TRBJ1-1,CASTGRTEAFF,1,0,1,1
TRBV2,TRBJ1-1,CASSFHWEAFF,1,0,1,1
TRBV28,TRBJ1-4,CASSLSEKLFF,1,0,1,1
TRBV6-2/3/5/6,TRBJ2-3,CASSLGGTQYF,1,0,1,1
TRBV6-2/3/5/6,TRBJ2-5,CASSSAETQYF,1,0,1,1
TRBV7-2,TRBJ2-1,CASSVQDEQFF,1,0,1,1
TRBV6-4,TRBJ2-1,CASSAYSEQFF,1,0,1,1
TRBV2,TRBJ2-2,CASSDDGELFF,1,0,1,1
TRBV25-1,TRBJ2-3,CASSEFGTQYF,1,0,1,1
TRBV6-2/3/5/6,TRBJ2-5,CASSTKETQYF,1,0,1,1
TRBV11-1,TRBJ2-1,CASSFSNEQFF,1,0,1,1
TRBV3-1,TRBJ1-2,CASSQASTYTF,1,0,1,1
TRBV14,TRBJ1-3,CASSARNTIYF,1,0,1,1
TRBV7-9,TRBJ2-1,CASSTYNEQFF,1,0,1,1
TRBV4-1,TRBJ2-3,CASSHGDTQYF,1,0,1,1
TRBV20-1,TRBJ2-7,CSASGRRGEYF,1,0,1,1
TRBV20-1,TRBJ2-1,CSANERNEQFF,1,0,1,1
TRBV29-1,TRBJ2-3,CSVFSADTQYF,1,0,1,1
TRBV29-1,TRBJ1-1,CSVDSQARAFF,1,0,1,1
TRBV29-1,TRBJ1-2,CSVADNYGYTF,1,0,1,1
TRBV29-1,TRBJ1-3,CSALEGNTIYF,1,0,1,1
TRBV29-1,TRBJ2-2,CSAGVPGELFF,1,0,1,1
TRBV29-1,TRBJ2-5,CSTRGQETQYF,1,0,1,1
TRBV29-1,TRBJ1-1,SSATGGTEAFF,1,0,1,1
TRBV12-3/4,TRBJ1-1,CASSFAEAFF,1,0,1,1
TRBV27,TRBJ1-5,CASSWEPQHF,1,0,1,1
TRBV7-2,TRBJ2-2,CASSLGELFF,1,0,1,1
TRBV6-2/3/5/6,TRBJ2-4,CASSYGF,1,0,1,1
TRBV19,TRBJ1-4,CASSIRQRATNEKLFF,1,0,1,1
TRBV9,TRBJ2-4,CASSVTSGGWINVQYF,1,0,1,1
TRBV5-1,TRBJ2-7,CTSSSGDRVIWDEQYF,1,0,1,1
TRBV9,TRBJ2-3,CASSGRVGSTDTQYF,1,0,1,1
TRBV4-1,TRBJ1-2,CASSQVGQALYGYTF,1,0,1,1
TRBV30,TRBJ1-4,CAWSGGHANEKLFF,1,0,1,1
TRBV3-1,TRBJ1-2,CASSQDGRAYGYTF,1,0,1,1
TRBV13,TRBJ2-7,CASRGGISYEQYF,1,0,1,1
TRBV5-6,TRBJ2-1,CASSFSGAEQFF,1,0,1,1
TRBV7-6,TRBJ1-1,CASSLLGGGVDTEAFF,1,0,1,1
TRBV6-2/3/5/6,TRBJ2-7,CASSLNVLGEQYF,1,0,1,1
TRBV6-1,TRBJ1-5,CASSQDRTYQPQHF,1,0,1,1
TRBV20-1,TRBJ2-5,CSAIFSETQYF,1,1,2,2
TRBV20-1,TRBJ2-1,CSATPSGRGTYNEQFF,1,0,1,1
TRBV12-3/4,TRBJ1-2,CASSLMGYTF,1,0,1,1
TRBV15,TRBJ2-1,CATSRSFTGTSGGSSYNEQFF,1,0,1,1
TRBV18,TRBJ2-1,CASSPPKPLAGFLGREDEQFF,1,0,1,1
TRBV14,TRBJ2-1,CASCQGLAGSRWSSYNEQFF,1,0,1,1
TRBV6-2/3/5/6,TRBJ2-7,CASSFFSTNGLAGGRYEQYF,1,2,2,3
TRBV6-2/3/5/6,TRBJ2-5,CASSLRGTGYQRGPQETQYF,1,0,1,1
TRBV6-2/3/5/6,TRBJ2-1,CASSPVSGGPPYPIPNEQFF,1,0,1,1
TRBV5-1,TRBJ1-6,CASSQGTGDHLSSYNSSLHF,1,0,1,1
TRBV20-1,TRBJ1-4,CSAIRAATPLPNPTNEKLFF,1,0,1,1
TRBV6-2/3/5/6,TRBJ2-5,CASSLYGPRDRGYQETQYF,1,0,1,1
TRBV6-2/3/5/6,TRBJ2-1,CASSYPQAGGPHPLNEQFF,1,0,1,1
TRBV6-2/3/5/6,TRBJ2-3,CASSYPLSLADTSTDTQYF,1,0,1,1
TRBV12-3/4,TRBJ1-4,CASSALGGTGDVANERLFF,1,0,1,1
TRBV7-2,TRBJ2-1,CASSRKAIITQGARDEQFF,1,0,1,1
TRBV3-1,TRBJ2-6,CASSQFQREGPPGANVLTF,1,0,1,1
TRBV4-2,TRBJ1-6,CASSQVKGAPESLDSPLHF,1,0,1,1
TRBV4-2,TRBJ2-3,CASSQELSRLLNRADTQYF,1,0,1,1
TRBV5-6,TRBJ1-6,CASSDSGTGIDAYNSPLHF,1,0,1,1
TRBV9,TRBJ2-5,CASSERTSLAGGPRETQYF,1,0,1,1
TRBV6-4,TRBJ2-1,CASRTRGPVLAGNDNEQFF,1,0,1,1
TRBV5-1,TRBJ2-1,CASSGQGTTAGGGYNEQFF,1,0,1,1
TRBV20-1,TRBJ2-2,CSASGGTGITGAQTGELFF,1,0,1,1
TRBV29-1,TRBJ2-3,CSVEGSSSGGEWATDTQYF,1,0,1,1
TRBV12-3/4,TRBJ2-7,CVSSSIFLDRGGTYEQYF,1,0,1,1
TRBV30,TRBJ2-1,CAWSPTRTSGRTYNEQFF,1,0,1,1
TRBV5-6,TRBJ2-7,CAGSSPHDPTSRSYEQYF,1,0,1,1
TRBV19,TRBJ2-7,CASSPLVGGSRGRNEQYF,1,0,1,1
TRBV19,TRBJ1-1,CASSPLRDRDFMNTEAFF,1,0,1,1
TRBV6-2/3/5/6,TRBJ1-5,CASSFLPGGKGSNQPQHF,1,0,1,1
TRBV27,TRBJ2-3,CASSLLGRGGSKGYTQYF,1,0,1,1
TRBV6-2/3/5/6,TRBJ2-1,CASSYSIATVYSYNEQFF,1,0,1,1
TRBV12-3/4,TRBJ2-1,CASSPPRGLAGISDEQFF,1,0,1,1
TRBV27,TRBJ2-1,CASSPMGLAGVSYNEQFF,1,1,2,2
TRBV2,TRBJ2-1,CASSEVAGGPDGYNEQFF,1,0,1,1
TRBV6-2/3/5/6,TRBJ2-7,CASSIVLRLAGGTHEQYF,1,0,1,1
TRBV7-2,TRBJ2-3,CASSLAIRASGDTDTQYF,1,0,1,1
TRBV7-8,TRBJ2-5,CASSLAGTRLFGPETQYF,1,0,1,1
TRBV14,TRBJ2-4,CASSPSLQGSLAKSIQYF,1,0,1,1
TRBV11-2,TRBJ2-3,CASSRDEGLAGGTDTQYF,1,0,1,1
TRBV9,TRBJ2-2,CASSVDPSGGRNTGELFF,1,0,1,1
TRBV5-4,TRBJ1-6,CASSTRTGGSSYNSPLHF,1,0,1,1
TRBV6-2/3/5/6,TRBJ2-2,CASNPAPRQGGYTGELFF,1,0,1,1
TRBV10-2,TRBJ2-7,CASSGAGAGGFRRYEQYF,1,0,1,1
TRBV5-1,TRBJ2-6,CASSLISPQHSGANVLTF,1,0,1,1
TRBV5-1,TRBJ2-7,CASSSPPFPGLRTYEQYF,1,0,1,1
TRBV5-1,TRBJ2-1,CASSPGLAGGLGWNEQFF,1,0,1,1
TRBV5-1,TRBJ2-3,CASSPGLAGGRGTDTQYF,1,0,1,1
TRBV4-1,TRBJ1-2,CASSQRTLQGGADYGYTF,1,0,1,1
TRBV4-3,TRBJ2-5,CASSQEIGLAAIRETQYF,1,0,1,1
TRBV4-1,TRBJ2-6,CASSQETRMGSGANVLTF,1,0,1,1
TRBV5-1,TRBJ2-3,CASSGTSGTLTFTDTQYF,1,0,1,1
TRBV20-1,TRBJ2-3,CSASPVGRGGRGTDTQYF,1,0,1,1
TRBV20-1,TRBJ2-3,CSARDPAGLAGYTDTQYF,1,0,1,1
TRBV12-5,TRBJ2-5,CASGPPPGLAGQETQYF,1,0,1,1
TRBV30,TRBJ2-1,CAWTGLAGGRIYNEQFF,1,0,1,1
TRBV24-1,TRBJ2-4,CATSDLGGRGLLNIQYF,1,0,1,1
TRBV24-1,TRBJ2-1,CATSDQRTSGRNGEQFF,1,0,1,1
TRBV15,TRBJ2-1,CATSRRGSSGGANEQFF,1,0,1,1
TRBV15,TRBJ1-1,CATSRARTGRVNTEAFF,1,0,1,1
TRBV15,TRBJ1-5,CATSRDGRGPSNQPQHF,1,0,1,1
TRBV7-6,TRBJ2-1,CATLGQGERGPSMGQFF,1,0,1,1
TRBV19,TRBJ1-5,CASSIEPGQGPNQPQHF,1,0,1,1
TRBV19,TRBJ1-1,CASSTRQDLRMNTEAFF,1,0,1,1
TRBV18,TRBJ1-5,CASSPANPGQGSQPQHF,1,0,1,1
TRBV27,TRBJ2-1,CASSFGGDGFAYNEQFF,1,0,1,1
TRBV12-3/4,TRBJ2-1,CASSLLASQSSYNEQFF,1,0,1,1
TRBV12-3/4,TRBJ2-3,CASSLVAAPSGADTQYF,1,0,1,1
TRBV27,TRBJ1-2,CASSLNLPQGGYYGYTF,1,0,1,1
TRBV6-2/3/5/6,TRBJ1-6,CASSLNGPSSYNSPLHF,1,0,1,1
TRBV6-2/3/5/6,TRBJ1-4,CASSSPGVEGPNEKLFF,1,0,1,1
TRBV6-2/3/5/6,TRBJ2-1,CASSSALLRRGSNEQFF,1,0,1,1
TRBV6-2/3/5/6,TRBJ2-7,CASSYSPPGLADYEQYF,1,1,2,2
TRBV6-2/3/5/6,TRBJ1-2,CASSYSPSLVANYGYTF,1,0,1,1
TRBV6-2/3/5/6,TRBJ1-5,CASSYSPHRDINQPQHF,1,0,1,1
TRBV6-2/3/5/6,TRBJ1-3,CASSYYTGFESGNTIYF,1,0,1,1
TRBV12-3/4,TRBJ2-7,CASSRGTGGWGNYEQYF,1,0,1,1
TRBV6-4,TRBJ2-1,CASSDRTSGGVYNEQFF,1,0,1,1
TRBV2,TRBJ1-1,CASSDALYRGRGTEAFF,1,0,1,1
TRBV12-3/4,TRBJ2-1,CASSTRQGSPTYNEQFF,1,0,1,1
TRBV11-2,TRBJ2-4,CASSFGGGQTKKNIQYF,1,0,1,1
TRBV7-2,TRBJ2-7,CASSFSGIDRMSYEQYF,1,0,1,1
TRBV7-2,TRBJ1-5,CASSFNPTGYSNQPQHF,1,0,1,1
TRBV5-4,TRBJ1-5,CASSLYRTGVGDQPQHF,1,1,2,2
TRBV7-2,TRBJ2-1,CASSLVLRTSGRNEQFF,1,0,1,1
TRBV11-2,TRBJ2-3,CASSLVASGGASDTQYF,1,0,1,1
TRBV11-1,TRBJ2-1,CASSLARLVGGYNEQFF,1,0,1,1
TRBV7-9,TRBJ2-7,CASSLAESAGGVYEQYF,1,0,1,1
TRBV7-2,TRBJ2-7,CASSLGLAGNYSYEQYF,1,0,1,1
TRBV7-6,TRBJ1-5,CASSLGPGTGNHQPQHF,1,0,1,1
TRBV7-3,TRBJ2-1,CASSLTPKLAEYNEQFF,1,1,2,2
TRBV7-9,TRBJ2-5,CASSLTDRDRVAETQYF,1,1,2,2
TRBV7-8,TRBJ2-5,CASSLRTSGRVQETQYF,1,1,2,2
TRBV5-6,TRBJ2-1,CASSLPAMVVSYNEQFF,1,0,1,1
TRBV7-6,TRBJ2-1,CASSLNGRAGGYNEQFF,1,0,1,1
TRBV7-9,TRBJ2-3,CASSPWVALKGTDTQYF,1,0,1,1
TRBV7-3,TRBJ2-1,CASSPRGGRGPGNEQFF,1,0,1,1
TRBV7-2,TRBJ2-3,CASSPGTSGRMTDTQYF,1,0,1,1
TRBV9,TRBJ2-5,CASSPRAASGSEETQYF,1,0,1,1
TRBV11-2,TRBJ2-1,CASSPNSGTYLGNGQFF,1,0,1,1
TRBV7-9,TRBJ1-1,CASSPGSTGTTNTEAFF,1,0,1,1
TRBV4-2,TRBJ2-7,CASSQPDSVGAPYEQYF,1,0,1,1
TRBV3-1,TRBJ2-3,CASSQVAGGPPGNTQYF,1,0,1,1
TRBV4-2,TRBJ2-5,CASSQDLSGRAGETQYF,1,0,1,1
TRBV6-2/3/5/6,TRBJ2-7,CASSQDRGYQRSYEQYF,1,0,1,1
TRBV9,TRBJ1-3,CASSVVDRDYSGNTIYF,1,0,1,1
TRBV7-2,TRBJ1-2,CASSGRDSGAVNHGYTF,1,0,1,1
TRBV9,TRBJ2-2,CASSESGLATNTGELFF,1,0,1,1
TRBV6-2/3/5/6,TRBJ2-7,CASSKIKSDSRVYEQYF,1,0,1,1
TRBV13,TRBJ2-5,CASRDTGTGDPRETQYF,1,0,1,1
TRBV5-1,TRBJ2-3,CASSLLRQGFLTDTQYF,1,0,1,1
TRBV5-1,TRBJ2-1,CASSLGSPTRSYNEQFF,1,0,1,1
TRBV5-1,TRBJ1-4,CASSLGGLRTTNEKLFF,1,0,1,1
TRBV5-1,TRBJ2-5,CASSSLRTEHLKETQYF,1,0,1,1
TRBV4-3,TRBJ2-3,CASSLYLAGVGPDTQYF,1,0,1,1
TRBV4-1,TRBJ1-6,CASSPEGRMSFYSPLHF,1,0,1,1
TRBV4-1,TRBJ2-1,CASSHSQVRGPNNEQFF,1,0,1,1
TRBV4-3,TRBJ2-3,CASSQGGLSARGDTQYF,1,0,1,1
TRBV4-1,TRBJ2-4,CASSQVSSQIAKNIQYF,1,0,1,1
TRBV4-3,TRBJ1-3,CASSQVRARGSGNTIYF,1,0,1,1
TRBV4-1,TRBJ1-5,CASSQEGVRGGNQPQHF,1,0,1,1
TRBV4-3,TRBJ2-6,CASSQEGTYTGANVLTF,1,0,1,1
TRBV5-1,TRBJ2-1,CASSREGPGFTYNEQFF,1,0,1,1
TRBV20-1,TRBJ2-3,CSQPPAGGPGTTDTQYF,1,0,1,1
TRBV20-1,TRBJ2-7,CSAKRPPGTGGRYEQYF,1,0,1,1
TRBV29-1,TRBJ2-1,CSVSGTSPPLLYNEQFF,1,0,1,1
TRBV9,TRBJ2-5,RASSAGTSGGAGKTQHF,1,0,1,1
TRBV12-5,TRBJ1-1,CASGFIPPGNDTEAFF,1,0,1,1
TRBV12-5,TRBJ2-1,CASGLQGQGFYNEQFF,1,0,1,1
TRBV10-3,TRBJ2-3,CAVSGRDYQSTDTQYF,1,0,1,1
TRBV7-2,TRBJ2-5,CAGGPSLAGLLGTQYF,1,0,1,1
TRBV10-3,TRBJ2-7,CAISKFRDRDLYEQYF,1,0,1,1
TRBV10-3,TRBJ1-2,CAISRRQGFVNYGYTF,1,0,1,1
TRBV15,TRBJ2-5,CATSEITIGVEETQYF,1,0,1,1
TRBV15,TRBJ2-2,CATSTRGTANTGELFF,1,0,1,1
TRBV19,TRBJ2-5,CASSIVFRTAKETQYF,1,0,1,1
TRBV19,TRBJ2-3,CASSIDWEGNTDTQYF,1,0,1,1
TRBV19,TRBJ2-5,CASSRTSGGRQETQYF,1,0,1,1
TRBV18,TRBJ2-7,CASSPLRGEGYYEQYF,1,0,1,1
TRBV18,TRBJ1-2,CASSSISGTAIYGYTF,1,0,1,1
TRBV18,TRBJ1-1,CASSPARDRGLTEAFF,1,0,1,1
TRBV18,TRBJ1-4,CASSPNIGFPNEKLFF,1,0,1,1
TRBV6-2/3/5/6,TRBJ1-5,CASLREPLYSNQPQHF,1,0,1,1
TRBV25-1,TRBJ2-1,CASIHLRDKRTRGRGF,1,0,1,1
TRBV11-2,TRBJ2-5,CASTLGASGIQETQYF,1,0,1,1
TRBV12-3/4,TRBJ1-2,CASTPSRDRGPYGYTF,1,0,1,1
TRBV12-3/4,TRBJ2-5,CASTPRAGEGRETQYF,1,1,2,2
TRBV6-2/3/5/6,TRBJ2-5,CASTQGLNERQETQYF,1,0,1,1
TRBV7-2,TRBJ2-5,CASTQSRGRGRETQYF,1,0,1,1
TRBV2,TRBJ2-7,CASTEPGQASSYEQYF,1,0,1,1
TRBV7-9,TRBJ1-4,CASTTSLAATNEKLFF,1,0,1,1
TRBV2,TRBJ2-7,CASTKAGGRPSYEQYF,1,0,1,1
TRBV27,TRBJ2-1,CASSLRGQGSYNEQFF,1,0,1,1
TRBV6-2/3/5/6,TRBJ1-5,CASSLSRDRANQPQHF,1,0,1,1
TRBV12-3/4,TRBJ2-5,CASSLVLAGNQETQYF,1,0,1,1
TRBV12-3/4,TRBJ1-4,CASSLAPQGVGEKLFF,1,0,1,1
TRBV12-3/4,TRBJ2-4,CASSLARQGTKNIQYF,1,0,1,1
TRBV12-3/4,TRBJ2-1,CASSLARRSSYNEQFF,1,0,1,1
TRBV12-3/4,TRBJ2-7,CASSLGAGRTSYEQYF,1,0,1,1
TRBV6-2/3/5/6,TRBJ1-2,CASSLMGPRGLYGYTF,1,0,1,1
TRBV12-3/4,TRBJ2-1,CASSSSSGRSPNEQFF,1,0,1,1
TRBV6-2/3/5/6,TRBJ2-7,CASSSPVSGRIYEQYF,1,0,1,1
TRBV12-3/4,TRBJ1-1,CASSSGTGGGNTEAFF,1,0,1,1
TRBV6-2/3/5/6,TRBJ2-5,CASSSEPTGPQETQYF,1,0,1,1
TRBV6-2/3/5/6,TRBJ1-1,CASSYSSWGGNTEAFF,1,1,2,2
TRBV6-2/3/5/6,TRBJ2-3,CASSYSNYPGTDTQYF,1,0,1,1
TRBV27,TRBJ2-1,CASSYLAGAAHNEQFF,1,0,1,1
TRBV6-2/3/5/6,TRBJ1-2,CASSYRTGPTNYGYTF,1,0,1,1
TRBV6-2/3/5/6,TRBJ2-7,CASSYRVSLILGEQYF,1,0,1,1
TRBV12-3/4,TRBJ2-1,CASSLVSLRGSNEQFF,1,0,1,1
TRBV7-2,TRBJ1-2,CASSHYRSQRNYGYTF,1,5,2,6
TRBV6-2/3/5/6,TRBJ2-1,CASSQRTVLAYNEQFF,1,0,1,1
TRBV6-1,TRBJ2-1,CASSASIAGGNNEQFF,1,2,2,3
TRBV2,TRBJ2-5,CASSDPGTASQETQYF,1,0,1,1
TRBV6-4,TRBJ2-7,CASSDRPGTGGLEQYF,1,0,1,1
TRBV6-2/3/5/6,TRBJ2-2,CASSESQGSGTGELFF,1,0,1,1
TRBV25-1,TRBJ2-3,CASSEPGGISTDTQYF,1,0,1,1
TRBV2,TRBJ1-1,CASSERRAAGRPEAFF,1,0,1,1
TRBV6-1,TRBJ2-3,CASSEVGQGITDTQYF,1,0,1,1
TRBV6-1,TRBJ1-4,CASSEASGRRREKLFF,1,0,1,1
TRBV2,TRBJ2-6,CASSETPAVGANVLTF,1,0,1,1
TRBV6-1,TRBJ2-7,CASSERGGAFKDEQYF,1,0,1,1
TRBV28,TRBJ2-7,CASSMSRGPWAYEQYF,1,0,1,1
TRBV6-2/3/5/6,TRBJ2-5,CASSTRTSGRRETQYF,1,0,1,1
TRBV6-2/3/5/6,TRBJ2-7,CASSRGASGRSYEQYF,1,0,1,1
TRBV7-6,TRBJ1-2,CASSFGTTGGLYGYTF,1,0,1,1
TRBV7-2,TRBJ2-2,CASSFPGEGNTGELFF,1,0,1,1
TRBV5-6,TRBJ2-3,CASSLVPSGRSGTQYF,1,0,1,1
TRBV5-4,TRBJ2-1,CASSLEGGSWYNEQFF,1,0,1,1
TRBV7-9,TRBJ2-2,CASSLFLSSSAGELFF,1,0,1,1
TRBV7-9,TRBJ2-7,CASSLLTSGSVYEQYF,1,0,1,1
TRBV7-2,TRBJ1-2,CASSLSGDRGLWGYTF,1,0,1,1
TRBV7-9,TRBJ2-7,CASSLPDIYPSYEQYF,1,0,1,1
TRBV7-7,TRBJ2-3,CASSLHHTDRTDTQYF,1,0,1,1
TRBV7-2,TRBJ2-5,CASSLVMTTFQETQYF,1,0,1,1
TRBV7-9,TRBJ2-6,CASSLVLPSGANVLTF,1,0,1,1
TRBV7-2,TRBJ2-3,CASSLASGGSTDTQYF,1,0,1,1
TRBV7-2,TRBJ2-5,CASSLGTASKQETQYF,1,2,2,3
TRBV7-2,TRBJ2-1,CASSLIPPNLNNEQFF,1,1,2,2
TRBV7-3,TRBJ2-1,CASSLTGRVAYNEQFF,1,0,1,1
TRBV11-2,TRBJ2-5,CASSLNPAGTQETQYF,1,0,1,1
TRBV7-9,TRBJ2-2,CASSLNSVGNTGELFF,1,0,1,1
TRBV7-9,TRBJ2-1,CASSSSGLAGTNEQFF,1,0,1,1
TRBV5-4,TRBJ2-1,CASSSRRGATYNEQFF,1,0,1,1
TRBV4-2,TRBJ2-1,CASSSGGQGARNEQFF,1,0,1,1
TRBV13,TRBJ2-2,CASSSGQGRDTGELFF,1,0,1,1
TRBV13,TRBJ2-7,CASSSNDRGSPYEQYF,1,0,1,1
TRBV12-3/4,TRBJ1-5,CASSSGQRSSNQPQHF,1,1,2,2
TRBV5-6,TRBJ1-5,CASSSTFGTANQPQHF,1,0,1,1
TRBV11-2,TRBJ2-3,CASSLGTSPGTDTQYF,1,0,1,1
TRBV3-1,TRBJ2-5,CASSLGARTDGETQYF,1,0,1,1
TRBV7-9,TRBJ2-7,CASSPNTGEEYYEQYF,1,0,1,1
TRBV4-2,TRBJ2-2,CASSPLGTANTGELFF,1,0,1,1
TRBV7-9,TRBJ2-7,CASSPRLAGTAYEQYF,1,0,1,1
TRBV7-6,TRBJ2-1,CASSPQLAGEENEQFF,1,0,1,1
TRBV4-2,TRBJ2-1,CASSPTDGGGYNEQFF,1,0,1,1
TRBV7-2,TRBJ2-3,CASSPRTSGLADTQYF,1,0,1,1
TRBV7-2,TRBJ2-1,CASSPSRLAGANEQFF,1,0,1,1
TRBV7-9,TRBJ1-4,CASSRGPGQDNEKLFF,1,0,1,1
TRBV4-1,TRBJ2-5,CASSRSAVRGPETQYF,2,0,1,2
TRBV4-2,TRBJ2-4,CASSHRDPREGDIQYF,1,0,1,1
TRBV3-1,TRBJ2-1,CASSQVAGVLYNEQFF,1,0,1,1
TRBV4-2,TRBJ2-6,CASSQASGSGANVLTF,1,2,2,3
TRBV3-1,TRBJ2-1,CASSQDVLAGVNEQFF,1,0,1,1
TRBV7-6,TRBJ2-3,CASSQTSPSLTDTQYF,1,0,1,1
TRBV4-2,TRBJ2-1,CASSQPGQGTYNERFF,1,0,1,1
TRBV4-2,TRBJ1-6,CASSQVGRAGSSPPHF,1,0,1,1
TRBV4-2,TRBJ2-3,CASSQVAGGPTDTQYF,1,0,1,1
TRBV3-1,TRBJ1-4,CASSQDPTGPGEKLFF,1,0,1,1
TRBV4-2,TRBJ2-1,CASSQDRLAGHNEQFF,1,0,1,1
TRBV14,TRBJ2-2,CASSQDGDRNTGELFF,1,0,1,1
TRBV4-2,TRBJ2-7,CASSQDNPGGGYEQYF,1,0,1,1
TRBV4-2,TRBJ2-5,CASSQDGRGGEETQYF,1,0,1,1
TRBV4-2,TRBJ2-6,CASSQEPYSGANVLTF,1,0,1,1
TRBV3-1,TRBJ2-5,CASSQETGPFQETQYF,1,0,1,1
TRBV4-2,TRBJ2-7,CASSQNLGTGSYEQYF,1,0,1,1
TRBV3-1,TRBJ2-5,CASSVKAEGYQETQYF,1,0,1,1
TRBV6-2/3/5/6,TRBJ2-5,CASSVGGARRQETQHF,1,0,1,1
TRBV9,TRBJ2-5,CASSVEAGAYQETQYF,1,0,1,1
TRBV6-2/3/5/6,TRBJ1-5,CASSARGGTGRQPQHF,1,3,2,4
TRBV9,TRBJ2-3,CASSAIGGGAGDTQYF,1,0,1,1
TRBV9,TRBJ2-1,CASSGGLTRSYNEQFF,1,0,1,1
TRBV9,TRBJ2-2,CASSGTSGRGTGELFF,1,0,1,1
TRBV9,TRBJ2-1,CASSGGEGLAGDEQFF,1,0,1,1
TRBV25-1,TRBJ1-2,CASSGFAEGQERGYTF,1,0,1,1
TRBV3-1,TRBJ2-7,CASSIGGAASSYEQYF,1,0,1,1
TRBV7-9,TRBJ2-2,CASSNSGTGNTGELFF,1,0,1,1
TRBV6-2/3/5/6,TRBJ1-6,CASRLGVGTGNSPLHF,1,0,1,1
TRBV2,TRBJ1-6,CASRDTGMGWSSPLHF,1,0,1,1
TRBV2,TRBJ2-1,CASRDWTCGEYNEQFF,1,0,1,1
TRBV12-3/4,TRBJ2-7,CASRTTAGQGSYEQYF,1,0,1,1
TRBV7-2,TRBJ2-4,CASRTNQGFGKNIQYF,1,0,1,1
TRBV27,TRBJ2-5,CASRPPGTPWEETQYF,1,0,1,1
TRBV6-2/3/5/6,TRBJ1-2,CASRRLGDSLKGGYTF,1,0,1,1
TRBV4-3,TRBJ2-2,CASSRGGTRNTGELFF,1,0,1,1
TRBV5-1,TRBJ2-1,CASSFPRDKSYNEQFF,1,0,1,1
TRBV5-1,TRBJ1-1,CASSLVFVGSNTEAFF,1,0,1,1
TRBV5-1,TRBJ1-2,CASSLGHRDVDYGYTF,1,0,1,1
TRBV5-1,TRBJ2-1,CASSLGRLSSYNEQFF,1,0,1,1
TRBV5-1,TRBJ2-5,CASSLGLAGGQETQYF,1,0,1,1
TRBV5-1,TRBJ2-5,CASSLERGSPQETQYF,1,0,1,1
TRBV5-1,TRBJ1-3,CASSLEIHASGNTIYF,1,0,1,1
TRBV5-1,TRBJ2-2,CASSLESGRRTGELFF,1,0,1,1
TRBV5-1,TRBJ2-5,CASSLNGLGEQETQYF,1,0,1,1
TRBV5-1,TRBJ1-5,CASSSEGRGGNQPQHF,1,0,1,1
TRBV5-1,TRBJ2-6,CASSSSGDTGANVLTF,1,0,1,1
TRBV4-1,TRBJ1-5,CASSLRPGYSNQPQHF,1,0,1,1
TRBV5-1,TRBJ2-2,CASSPKNRVDTGELFF,1,0,1,1
TRBV4-1,TRBJ2-3,CASSRPGDSSLDTQYF,1,0,1,1
TRBV4-3,TRBJ2-1,CASSRYYRVGYNEQFF,1,0,1,1
TRBV5-1,TRBJ1-1,CASSHRPGPQNTEAFF,1,0,1,1
TRBV4-1,TRBJ1-2,CASSQDFGQGLGGYTF,1,0,1,1
TRBV4-1,TRBJ1-5,CASSQDPRYSNQPQHF,1,0,1,1
TRBV4-3,TRBJ2-1,CASSQDPGLAPKREFF,1,0,1,1
TRBV4-3,TRBJ2-1,CASSQDRGALGYEQFF,1,0,1,1
TRBV4-3,TRBJ2-1,CASSQDRRPIYNEQFF,1,0,1,1
TRBV4-1,TRBJ1-6,CASSQDRGSYNSPLHF,1,0,1,1
TRBV4-1,TRBJ2-5,CASSQDQGLAGSDQYF,1,0,1,1
TRBV4-3,TRBJ2-7,CASSQDGLAASYEQYF,1,0,1,1
TRBV4-1,TRBJ2-7,CASSQDTFPGVYEQYF,1,0,1,1
TRBV4-1,TRBJ1-6,CASSQEWTAYNSPLHF,1,0,1,1
TRBV4-1,TRBJ2-3,CASSQEWDRSTDTQYF,1,0,1,1
TRBV4-1,TRBJ2-7,CASSQTSGGRNYEQYF,1,1,2,2
TRBV5-1,TRBJ2-1,CASSAQLAGPLDEQFF,1,0,1,1
TRBV4-3,TRBJ2-1,CASSNRLAGGHNEQFF,1,0,1,1
TRBV20-1,TRBJ1-1,CSALAAITGRGTEAFF,1,0,1,1
TRBV20-1,TRBJ2-1,CSASTLAGHSYNEQFF,1,0,1,1
TRBV20-1,TRBJ2-1,CSARPRVSGVYNEQFF,1,0,1,1
TRBV20-1,TRBJ2-1,CSARVGGSVSYNEQFF,1,0,1,1
TRBV20-1,TRBJ2-7,CSARAGLVLADYEQYF,1,0,1,1
TRBV20-1,TRBJ2-7,CSARGLWTSESYEQYF,1,0,1,1
TRBV20-1,TRBJ2-7,CSARDSERGNPYEQYF,1,0,1,1
TRBV20-1,TRBJ1-5,CSARDYEQGISQPQHF,1,0,1,1
TRBV20-1,TRBJ1-2,CSARDRSGEANYGYTF,1,0,1,1
TRBV20-1,TRBJ2-7,CSARDALAGDSYEQYF,1,0,1,1
TRBV20-1,TRBJ2-4,CSARDELAGRENIQYF,1,0,1,1
TRBV20-1,TRBJ2-5,CSASHRTGVDQETQYF,1,0,1,1
TRBV29-1,TRBJ2-2,CSVADTGQGDGGELFF,1,0,1,1
TRBV29-1,TRBJ2-1,CSVDLGGASSYNEQFF,1,0,1,1
TRBV29-1,TRBJ2-3,CSVEGLQGSPTDTQYF,1,0,1,1
TRBV29-1,TRBJ2-7,CSVETLERESGYEQYF,1,0,1,1
TRBV12-5,TRBJ1-1,CASSRGGFMNTEAFF,1,0,1,1
TRBV6-2/3/5/6,TRBJ1-1,CASSYRTAGGSEAFF,1,0,1,1
TRBV30,TRBJ2-7,CAWQGGRDSSYEQYF,1,0,1,1
TRBV30,TRBJ2-2,CAWSVVEQESGELFF,1,0,1,1
TRBV30,TRBJ1-1,CAWSTAQLMNTEAFF,1,0,1,1
TRBV30,TRBJ1-4,CAWRAGVTTNEKLFF,1,0,1,1
TRBV18,TRBJ1-1,CAGSPPHRDDTEAFF,1,0,1,1
TRBV11-3,TRBJ2-1,CAGSLQGEANSEQFF,1,0,1,1
TRBV10-3,TRBJ2-3,CAIARQTGGTDTQYF,1,0,1,1
TRBV10-3,TRBJ1-2,CAISESPRGYYGYTF,1,0,1,1
TRBV10-3,TRBJ2-2,CAIRPAGGNTGELFF,1,0,1,1
TRBV24-1,TRBJ2-7,CATSTYLPAFYEQYF,1,0,1,1
TRBV15,TRBJ2-1,CATSTLAWYDNEQFF,1,0,1,1
TRBV10-3,TRBJ2-3,CATSFLSSGTDTQYF,1,0,1,1
TRBV19,TRBJ1-1,CASCSIGLKNTEAFF,1,0,1,1
TRBV19,TRBJ2-2,CASEQLAWGTGELFF,1,0,1,1
TRBV19,TRBJ2-3,CASSETSGGTDTQYF,1,0,1,1
TRBV19,TRBJ1-1,CASSIQKGRGTEAFF,1,0,1,1
TRBV19,TRBJ2-1,CASSIGSGSYNEQFF,1,0,1,1
TRBV19,TRBJ2-5,CASSIIGQNQETQYF,1,0,1,1
TRBV19,TRBJ1-5,CASSNYGLGTQPQHF,1,0,1,1
TRBV19,TRBJ2-7,CASRESLSAGYEQYF,1,0,1,1
TRBV6-2/3/5/6,TRBJ1-4,CASKQWFGTNEKLFF,1,0,1,1
TRBV18,TRBJ2-7,CASSLNGPSSYEQYF,1,0,1,1
TRBV2,TRBJ2-1,CASSLGGEAYNEQFF,1,0,1,1
TRBV2,TRBJ2-5,CASSSGQGAWETQYS,1,0,1,1
TRBV18,TRBJ1-6,CASSQGDSYNSPLHF,1,0,1,1
TRBV18,TRBJ2-5,CASSSPTGRSETQYF,1,0,1,1
TRBV18,TRBJ2-5,CASSPGIAGGEDQYF,1,0,1,1
TRBV18,TRBJ1-5,CASSPQANSNQPQHF,1,0,1,1
TRBV18,TRBJ2-1,CASSPTGPPYNEQFF,1,0,1,1
TRBV5-5,TRBJ2-1,CASLRGLAGNNEQFF,1,0,1,1
TRBV7-9,TRBJ2-1,CASRVSNRSYNEQFF,1,0,1,1
TRBV18,TRBJ2-1,CASAAPGGQYNGQFF,1,0,1,1
TRBV25-1,TRBJ1-5,CASIEKDSGNQPQHF,1,0,1,1
TRBV2,TRBJ1-1,CASMNYGRSNTEAFF,1,0,1,1
TRBV6-2/3/5/6,TRBJ2-7,CASTIRQGTSYEQYF,1,0,1,1
TRBV6-4,TRBJ2-3,CASTLAGGHTDTQYF,1,0,1,1
TRBV12-3/4,TRBJ2-5,CASTWTGVEKETQYF,1,0,1,1
TRBV6-2/3/5/6,TRBJ2-1,CASTPEQGLYNEQFF,1,0,1,1
TRBV12-3/4,TRBJ2-1,CASTPTRSSYNEQFF,1,0,1,1
TRBV6-2/3/5/6,TRBJ2-5,CASTGTGSTRETQYF,1,0,1,1
TRBV6-2/3/5/6,TRBJ2-3,CASSFWVAFTDTQYF,1,0,1,1
TRBV6-2/3/5/6,TRBJ2-7,CASSFRSGRRYEQYF,1,0,1,1
TRBV6-2/3/5/6,TRBJ2-5,CASSFGTGDQETQYF,1,0,1,1
TRBV12-3/4,TRBJ2-1,CASSLSGEGYNEQFF,1,0,1,1
TRBV12-3/4,TRBJ1-2,CASSLAGPPNYGYTF,1,0,1,1
TRBV6-1,TRBJ2-1,CASSLKRGGQNEQFF,1,0,1,1
TRBV6-2/3/5/6,TRBJ2-1,CASSLLRGGGHEQFS,1,0,1,1
TRBV12-3/4,TRBJ2-7,CASSLSPIHSYEQYF,1,0,1,1
TRBV6-2/3/5/6,TRBJ1-1,CASSLPGRLNTEAFF,1,0,1,1
TRBV6-2/3/5/6,TRBJ2-1,CASSLVRNSYNEQFF,1,0,1,1
TRBV6-2/3/5/6,TRBJ2-1,CASSLTNSGGREQFF,1,0,1,1
TRBV6-2/3/5/6,TRBJ1-2,CASSSRDRGLFGYTF,1,0,1,1
TRBV7-9,TRBJ2-3,CASSSTSGSGDTQYF,1,0,1,1
TRBV12-3/4,TRBJ1-5,CASSSRDYSNQPQHF,1,0,1,1
TRBV27,TRBJ1-1,CASSYSGTGNTEAFF,1,1,2,2
TRBV6-2/3/5/6,TRBJ2-5,CASSYSSTPQETQYF,1,0,1,1
TRBV6-2/3/5/6,TRBJ2-4,CASSYSSLAKNIQYF,1,0,1,1
TRBV6-2/3/5/6,TRBJ2-2,CASSYSRQGGWELFF,1,0,1,1
TRBV6-2/3/5/6,TRBJ2-5,CASSYSDRVWETQYF,1,0,1,1
TRBV6-2/3/5/6,TRBJ1-1,CASSYSKWGNTEAFF,1,0,1,1
TRBV6-2/3/5/6,TRBJ1-1,CASSYGVFMNTEAFF,1,0,1,1
TRBV6-2/3/5/6,TRBJ2-7,CASSYRASQTYEQYF,1,0,1,1
TRBV6-2/3/5/6,TRBJ2-7,CASSLRLAGEDEQYF,1,0,1,1
TRBV3-1,TRBJ1-5,CASSLQGESNQPQHF,1,0,1,1
TRBV12-3/4,TRBJ1-2,CASSPGRTDPRGYTF,1,1,2,2
TRBV6-2/3/5/6,TRBJ2-1,CASSPQKSSYNEQFF,1,0,1,1
TRBV7-2,TRBJ2-1,CASSPEGVSYNEQFF,1,0,1,1
TRBV12-3/4,TRBJ1-2,CASSPLPTFWGGYTF,1,0,1,1
TRBV7-2,TRBJ2-1,CASSPLAGIHNEQFF,1,0,1,1
TRBV27,TRBJ2-7,CASSPARDSGHEQYF,1,0,1,1
TRBV25-1,TRBJ2-1,CASSGRLGMGNEQFF,1,0,1,1
TRBV6-1,TRBJ1-2,CASSGELSGDYGYTS,1,0,1,1
TRBV6-1,TRBJ2-7,CASSDLGTRSYEQYF,1,0,1,1
TRBV6-4,TRBJ2-1,CASSDGTGGNNEQFF,1,0,1,1
TRBV6-4,TRBJ2-3,CASSDSAGSTDTQYF,1,0,1,1
TRBV2,TRBJ2-4,CASSEDLGAKNIQYF,1,0,1,1
TRBV25-1,TRBJ1-4,CASSEFTGRHEKLFF,1,0,1,1
TRBV2,TRBJ2-5,CASSEYRGGRETQYF,1,0,1,1
TRBV6-1,TRBJ2-7,CASSEAPLNSYEQYF,1,0,1,1
TRBV6-4,TRBJ1-2,CASSTRDTVNYGYTF,1,0,1,1
TRBV2,TRBJ2-2,CASSRGTANTGELFF,1,0,1,1
TRBV7-6,TRBJ2-3,CASSFSPGGTDTQYF,1,0,1,1
TRBV7-9,TRBJ2-1,CASSFQGMGPNEQFF,1,0,1,1
TRBV7-2,TRBJ2-3,CASSFGLAGTDTQYF,1,0,1,1
TRBV7-2,TRBJ1-2,CASSFVWGMTYGYTF,1,0,1,1
TRBV7-3,TRBJ2-3,CASSFAGGSTDTQYF,1,0,1,1
TRBV7-9,TRBJ1-5,CASSFEGQGHQPQHF,1,0,1,1
TRBV5-4,TRBJ2-7,CASSLLSPSSYEQYF,1,0,1,1
TRBV7-9,TRBJ1-5,CASSLGDRGNQPQHF,1,0,1,1
TRBV5-4,TRBJ1-5,CASSLEPGSNQPQHF,1,0,1,1
TRBV5-6,TRBJ2-5,CASSLIQGGEETQYF,1,0,1,1
TRBV5-4,TRBJ1-5,CASSLTGDGNQPQHF,1,0,1,1
TRBV13,TRBJ2-1,CASSLKAGGYNEQFF,1,1,2,2
TRBV7-6,TRBJ2-1,CASSLWGSSYNEQFF,1,0,1,1
TRBV11-3,TRBJ2-1,CASSLRGGPYNEQFF,1,1,2,2
TRBV7-9,TRBJ1-4,CASSLVGQNNEKLFF,1,0,1,1
TRBV13,TRBJ2-2,CASSLVAGLTGELFF,1,0,1,1
TRBV7-2,TRBJ1-5,CASSLVSRALQPQHF,1,0,1,1
TRBV7-9,TRBJ1-1,CASSLVGQWNTEAFF,1,0,1,1
TRBV7-8,TRBJ1-6,CASSLAQGARSPLHF,1,0,1,1
TRBV7-9,TRBJ1-1,CASSLATTVNTEAFF,1,0,1,1
TRBV7-9,TRBJ2-1,CASSLATSSYNEQFF,1,0,1,1
TRBV7-6,TRBJ1-1,CASSLAGTWGAEAFF,1,0,1,1
TRBV7-9,TRBJ1-2,CASSLGGTGDRGYTF,1,0,1,1
TRBV7-8,TRBJ2-7,CASSLGSGFSYEQYF,1,2,2,3
TRBV6-2/3/5/6,TRBJ2-1,CASSLGGGGHNEQFF,1,0,1,1
TRBV11-2,TRBJ1-5,CASSLGGQVNQPQHF,1,0,1,1
TRBV7-7,TRBJ2-2,CASSLGYGDSGELFF,1,0,1,1
TRBV7-2,TRBJ1-2,CASSLGPRTGGGYTF,1,0,1,1
TRBV11-1,TRBJ2-7,CASSLGDLLPGEQYF,1,0,1,1
TRBV7-9,TRBJ2-7,CASSLDPGRDYEQYF,1,0,1,1
TRBV7-6,TRBJ2-3,CASSLDPSYTDTQYF,1,0,1,1
TRBV7-2,TRBJ2-1,CASSLSPGTGDEQFF,1,0,1,1
TRBV7-2,TRBJ1-2,CASSLSSDTYNGYTF,1,0,1,1
TRBV7-2,TRBJ2-3,CASSLRGGGTDTQYF,1,0,1,1
TRBV7-9,TRBJ2-3,CASSSLDRGPDTQYF,1,0,1,1
TRBV7-9,TRBJ2-5,CASSSSGTGQETQYF,1,0,1,1
TRBV5-4,TRBJ2-3,CASSSWTGRTDTQYF,1,0,1,1
TRBV7-2,TRBJ2-7,CASSSPGRSSYEQYF,1,0,1,1
TRBV7-6,TRBJ2-5,CASSSRQGAVETQYF,1,0,1,1
TRBV7-9,TRBJ1-6,CASSSMGQGFSPLHF,1,0,1,1
TRBV7-2,TRBJ2-3,CASSSNSPSTDTQYF,1,1,2,2
TRBV7-9,TRBJ1-2,CASSSSGTGFGGYTF,1,0,1,1
TRBV5-4,TRBJ1-2,CASSWRGSSNYGYTF,1,0,1,1
TRBV28,TRBJ2-1,CASSLSGYSYNEQFF,1,0,1,1
TRBV11-2,TRBJ2-7,CASSLSGTISYEQYF,1,1,2,2
TRBV5-5,TRBJ2-1,CASSLRDSALVEQFF,1,0,1,1
TRBV5-6,TRBJ2-6,CASSLGLAGANVLTF,1,0,1,1
TRBV3-1,TRBJ1-3,CASSLSRDTGNTIYF,1,0,1,1
TRBV5-4,TRBJ2-1,CASSLAVSSYNEQFF,1,0,1,1
TRBV7-9,TRBJ2-7,CASSPTSGRAYEQYF,1,0,1,1
TRBV7-2,TRBJ2-3,CASSPSGGAADTQYF,1,0,1,1
TRBV7-2,TRBJ1-5,CASSPRGGRNQPQHF,1,0,1,1
TRBV11-2,TRBJ2-5,CASSPRDRGRETQYF,1,0,1,1
TRBV5-6,TRBJ2-7,CASSPAAGVSYEQYF,1,0,1,1
TRBV9,TRBJ1-3,CASSPGGFSGNTIYF,1,0,1,1
TRBV7-9,TRBJ1-1,CASSPGTDFNTEAFF,1,0,1,1
TRBV11-3,TRBJ2-1,CASSPDVSSYNEQFF,1,0,1,1
TRBV5-4,TRBJ2-1,CASSPDIGGANEQFF,1,0,1,1
TRBV7-6,TRBJ1-5,CASSPGVNSNQPQHF,1,0,1,1
TRBV7-9,TRBJ1-6,CASSPGTLAVSPLHF,1,0,1,1
TRBV5-4,TRBJ2-1,CASSPSVPGGNEQFF,1,0,1,1
TRBV5-5,TRBJ1-6,CASSPTLTPEKALHF,1,0,1,1
TRBV9,TRBJ2-7,CASSPRGQDPYEQYF,1,0,1,1
TRBV7-6,TRBJ2-1,CASSRISGSRNGQFF,1,0,1,1
TRBV7-9,TRBJ2-7,CASSRRGLAGAEQYF,1,0,1,1
TRBV4-2,TRBJ2-3,CASSHLGERLDTQYF,1,0,1,1
TRBV9,TRBJ1-3,CASSHSGGAGNTIYF,1,0,1,1
TRBV3-1,TRBJ1-2,CASSQIPKGRYGYTF,1,0,1,1
TRBV3-1,TRBJ2-1,CASSQVDRQGNEQFF,1,0,1,1
TRBV3-1,TRBJ1-1,CASSQGRGEGSEAFF,1,0,1,1
TRBV4-2,TRBJ2-5,CASSQDPGSRETQYF,1,0,1,1
TRBV3-1,TRBJ2-7,CASSQDASGSGEQYF,1,0,1,1
TRBV14,TRBJ2-7,CASSQDRGLPYEQYF,1,0,1,1
TRBV3-1,TRBJ2-7,CASSQEGGRGQEQYF,1,0,1,1
TRBV3-1,TRBJ2-7,CASSQIPPPSYEQYF,1,0,1,1
TRBV4-2,TRBJ1-1,CASSQTWTGGTEAFF,1,0,1,1
TRBV14,TRBJ2-5,CASSQNLGAGETQYF,1,0,1,1
TRBV9,TRBJ2-1,CASSVGGSSYNEQFF,1,0,1,1
TRBV9,TRBJ2-5,CASSVVSGGRETRYF,1,0,1,1
TRBV9,TRBJ1-5,CASSVAGTGNQPQHF,1,0,1,1
TRBV9,TRBJ2-1,CASSVEGGFYNEQFF,1,0,1,1
TRBV7-2,TRBJ1-3,CASSAQTGPGNTIYF,1,0,1,1
TRBV6-2/3/5/6,TRBJ2-1,CASSAGTSGHYERFF,1,0,1,1
TRBV5-4,TRBJ2-1,CASSATSGAYNEQFF,1,0,1,1
TRBV5-6,TRBJ1-5,CASSAQGGEYQPQHF,1,0,1,1
TRBV11-2,TRBJ2-5,CASSGDGTSEETQYF,1,1,2,2
TRBV6-2/3/5/6,TRBJ1-5,CASSGGQYSNQPQHF,1,0,1,1
TRBV9,TRBJ1-1,CASSDKTGGRTEAFF,1,0,1,1
TRBV3-1,TRBJ2-5,CASSEGGGNLETQYF,1,0,1,1
TRBV7-2,TRBJ2-7,CASSIRTSGSYEQYF,1,1,2,2
TRBV5-5,TRBJ1-5,CASSTSSRENQPQHF,1,0,1,1
TRBV5-6,TRBJ1-1,CASSTAGMRSTEAFF,1,0,1,1
TRBV6-2/3/5/6,TRBJ2-1,CASSRTLPSYNEQFF,1,0,1,1
TRBV5-4,TRBJ1-1,CASSRSRLGGRGAFF,1,0,1,1
TRBV12-3/4,TRBJ2-1,CASSNSGLTYNEQFF,1,0,1,1
TRBV27,TRBJ2-1,CASRPLTGSYNEQFF,1,0,1,1
TRBV12-3/4,TRBJ2-5,CASRMTSGGPETQYF,1,0,1,1
TRBV6-1,TRBJ2-1,CASRIQGLVYDEQFF,1,0,1,1
TRBV6-2/3/5/6,TRBJ1-2,CASRSDWVLNYGYTF,1,0,1,1
TRBV6-2/3/5/6,TRBJ2-7,CASRPLGQVPYEQYF,1,0,1,1
TRBV6-2/3/5/6,TRBJ2-6,CASRPTGYGANVLTF,1,0,1,1
TRBV6-2/3/5/6,TRBJ2-7,CASRAGTGEAYEQYF,1,0,1,1
TRBV12-3/4,TRBJ2-3,CASRESGRDADTQYF,1,0,1,1
TRBV7-2,TRBJ2-3,CASRTRGGGADTQYF,1,0,1,1
TRBV6-2/3/5/6,TRBJ2-1,CASRTQGQGGDEQFF,1,0,1,1
TRBV6-2/3/5/6,TRBJ1-3,CASRTREVSGNTIYF,1,1,2,2
TRBV27,TRBJ2-5,CASRSLAGGLETQYF,1,0,1,1
TRBV12-3/4,TRBJ2-2,CASRRGGVSTGELFF,1,0,1,1
TRBV7-9,TRBJ2-1,CASRNPGQGHYEQFF,1,0,1,1
TRBV12-3/4,TRBJ2-6,CASNPTGTGANVLTF,1,0,1,1
TRBV5-6,TRBJ2-1,CASNPGTQGGDEQFF,1,0,1,1
TRBV4-1,TRBJ1-1,CASVGREVRNTEAFF,1,0,1,1
TRBV4-3,TRBJ2-4,CASGQEDRVKNIQYF,1,0,1,1
TRBV5-1,TRBJ1-4,CASTLSWATNENLFF,1,0,1,1
TRBV5-1,TRBJ1-1,CASSFGGRLNTEAFF,1,0,1,1
TRBV5-1,TRBJ2-1,CASSFSGIQMYEQFF,1,0,1,1
TRBV5-1,TRBJ2-3,CASSFVGSSTDTQYF,1,0,1,1
TRBV5-1,TRBJ2-7,CASSFGQGSIYEQYF,1,0,1,1
TRBV5-1,TRBJ1-2,CASSLLGTVDYGYTF,1,0,1,1
TRBV5-1,TRBJ2-3,CASSLSEGGTDTQYF,1,0,1,1
TRBV5-1,TRBJ2-3,CASSLQDQSTDTQYF,1,0,1,1
TRBV5-1,TRBJ2-1,CASSLVSSSYNEQFF,1,0,1,1
TRBV5-1,TRBJ2-1,CASSLGQGAKREQFF,1,0,1,1
TRBV5-1,TRBJ1-2,CASSLGAGGNYGYTF,1,0,1,1
TRBV5-1,TRBJ2-3,CASSLDRDVTDTQYF,1,0,1,1
TRBV5-1,TRBJ2-3,CASSLEARGTDTQYF,1,0,1,1
TRBV5-1,TRBJ1-1,CASSLMSGEDTEAFF,1,0,1,1
TRBV5-1,TRBJ2-5,CASSLNGQGGETQYF,1,0,1,1
TRBV4-1,TRBJ2-1,CASSLTSGGYNEQFF,1,0,1,1
TRBV4-1,TRBJ1-2,CASSPPGGGYGGYTF,1,0,1,1
TRBV4-1,TRBJ2-7,CASSPVGSGVYEQYF,1,0,1,1
TRBV4-3,TRBJ2-7,CASSPGRTASYEQYF,1,0,1,1
TRBV4-3,TRBJ2-7,CASSPLGLAGNEQYF,1,0,1,1
TRBV5-1,TRBJ2-1,CASSRAPDSYNEQFF,1,0,1,1
TRBV4-1,TRBJ2-1,CASSHQRSAYNEQFF,1,0,1,1
TRBV4-1,TRBJ1-5,CASSQGQLGNQPQHF,1,1,2,2
TRBV4-1,TRBJ1-1,CASSQPGSSNTEAFF,1,0,1,1
TRBV4-1,TRBJ1-4,CASSQGGRGNEKLFF,1,0,1,1
TRBV4-3,TRBJ2-7,CASSQDLSYSYEQYF,1,0,1,1
TRBV4-1,TRBJ2-5,CASSQDPMRWETQYF,1,0,1,1
TRBV4-1,TRBJ2-7,CASSQEAVDTYEQYF,1,0,1,1
TRBV4-3,TRBJ2-1,CASSQEWGSYNEQFF,1,0,1,1
TRBV4-1,TRBJ1-6,CASSQMTSPSSPLHF,1,0,1,1
TRBV5-1,TRBJ2-6,CASSVQDSGANVLTF,1,0,1,1
TRBV4-3,TRBJ2-1,CASKEGEGSYNEQFF,1,0,1,1
TRBV20-1,TRBJ1-1,CSAPRGGEQGTEAFF,1,0,1,1
TRBV20-1,TRBJ2-7,CSAPAWRSSSYEQYF,1,0,1,1
TRBV20-1,TRBJ2-7,CSAQSPQGRRYEQYF,1,0,1,1
TRBV20-1,TRBJ1-2,CSARGPQAFHYGYTF,1,0,1,1
TRBV20-1,TRBJ2-3,CSARRGRFDTDTQYF,1,0,1,1
TRBV20-1,TRBJ2-4,CSARLGTGAGDIQYF,1,0,1,1
TRBV20-1,TRBJ1-6,CSARQQGTYNSPLHF,1,0,1,1
TRBV20-1,TRBJ1-6,CSARARWQWNSPLHF,1,0,1,1
TRBV20-1,TRBJ2-5,CSARDLRGREETQYF,1,0,1,1
TRBV20-1,TRBJ1-2,CSARDWDRGDYGYTF,1,0,1,1
TRBV20-1,TRBJ1-1,CSARDYAGRYTEAFF,1,0,1,1
TRBV20-1,TRBJ2-3,CSARDAGTSGDTQYF,1,0,1,1
TRBV20-1,TRBJ2-2,CSARETDREVGELFF,1,0,1,1
TRBV20-1,TRBJ2-1,CSASTSGGAWNEQFF,1,0,1,1
TRBV20-1,TRBJ2-7,CSALIGGEVGNEQYF,1,1,2,2
TRBV20-1,TRBJ2-4,CSGFSSGAGGNIQYF,1,0,1,1
TRBV20-1,TRBJ2-3,CSGGTSGSGTDTQYF,1,0,1,1
TRBV20-1,TRBJ1-6,CSDIRDKQGNSPLHF,1,0,1,1
TRBV29-1,TRBJ2-1,CSVVYKGTSNNEQFF,1,0,1,1
TRBV29-1,TRBJ2-1,CSVVLAGGPGNEQFF,1,0,1,1
TRBV29-1,TRBJ2-1,CSVVATSGWENEQFF,1,0,1,1
TRBV29-1,TRBJ2-7,CSVEDTGTGADEQYF,1,1,2,2
TRBV20-1,TRBJ2-1,CRARAWDRSINEQFF,1,0,1,1
TRBV7-9,TRBJ1-5,RASSSGQGMGQPQHF,1,0,1,1
TRBV12-5,TRBJ2-7,CASGFQSGRTEQYF,1,0,1,1
TRBV12-5,TRBJ2-5,CASGLRTGIETQYF,1,0,1,1
TRBV30,TRBJ1-1,CAWTRAGVWTEAFF,1,0,1,1
TRBV30,TRBJ1-4,CAWSAGTENEKLFF,1,1,2,2
TRBV30,TRBJ1-5,CAWSGTGGNQPQHF,1,0,1,1
TRBV30,TRBJ2-6,CAWSIDSGANVLTF,1,0,1,1
TRBV30,TRBJ1-5,CAWSEGVRRQPQHF,1,0,1,1
TRBV30,TRBJ2-1,CAWSKGLAGDEQFF,1,0,1,1
TRBV10-3,TRBJ1-2,CAISEPDGDYGYTF,1,0,1,1
TRBV10-3,TRBJ1-6,CAISPGQGSSPLHF,1,0,1,1
TRBV10-3,TRBJ2-1,CAIRGLAVYNEQFF,1,0,1,1
TRBV5-5,TRBJ2-7,CATGMSGRAYEQNF,1,0,1,1
TRBV10-3,TRBJ2-5,CATGISLGEKAQYF,1,0,1,1
TRBV30,TRBJ2-7,CATGLAGLSYEQYF,1,0,1,1
TRBV24-1,TRBJ1-2,CATTRPGRNYGYTF,1,0,1,1
TRBV15,TRBJ2-7,CATSPRDGAYEQYF,1,0,1,1
TRBV15,TRBJ2-5,CATSRDRGRETQYF,1,0,1,1
TRBV15,TRBJ1-6,CATSRDRASHTLHF,1,0,1,1
TRBV24-1,TRBJ1-5,CATNRTGGGQPQHF,1,0,1,1
TRBV19,TRBJ1-1,CASTPDRWNTEAFF,1,0,1,1
TRBV19,TRBJ2-3,CASSSTGFTDTQYF,1,0,1,1
TRBV19,TRBJ2-1,CASSALRVYNEQFF,1,0,1,1
TRBV19,TRBJ1-1,CASSIVTGNTEAFF,1,0,1,1
TRBV19,TRBJ1-4,CASSILLGDEKLFF,1,0,1,1
TRBV19,TRBJ2-1,CASSIGPSNNEQFF,1,0,1,1
TRBV19,TRBJ2-5,CASSIETSGRVQYF,1,0,1,1
TRBV19,TRBJ2-7,CASSTGMSTYEQYF,1,0,1,1
TRBV19,TRBJ2-7,CASSRQNKDYEQYF,1,0,1,1
TRBV19,TRBJ1-4,CASNPAVGGEKLFF,1,0,1,1
TRBV19,TRBJ1-4,CASKRNPTNEKLFF,1,0,1,1
TRBV7-2,TRBJ2-7,CASFDGTGVSEQYF,1,0,1,1
TRBV18,TRBJ1-4,CASSPSATNEKLFF,1,1,2,2
TRBV18,TRBJ2-7,CASSLRDRAGEQYF,1,0,1,1
TRBV18,TRBJ1-1,CASSPSTGNTEAFF,1,0,1,1
TRBV18,TRBJ2-7,CASSPRKDAYEQYF,1,0,1,1
TRBV18,TRBJ1-1,CASSPSGRGAGAFF,1,0,1,1
TRBV18,TRBJ1-4,CASSQSATNEKLFF,1,0,1,1
TRBV18,TRBJ2-5,CASSQGTDQETQYF,1,0,1,1
TRBV7-9,TRBJ2-4,CASRGEGAKNIQYF,1,0,1,1
TRBV19,TRBJ2-7,CASREDYGAYEQYF,1,2,2,3
TRBV6-2/3/5/6,TRBJ2-7,CASQPDRSTYEQYF,1,0,1,1
TRBV2,TRBJ2-5,CASAGQGGQETQYF,1,0,1,1
TRBV2,TRBJ2-7,CASGTSGGYYEQYF,1,0,1,1
TRBV28,TRBJ2-5,CASGASGYQETQYF,1,0,1,1
TRBV6-2/3/5/6,TRBJ2-5,CASELGGKQETQYF,1,0,1,1
TRBV5-6,TRBJ1-6,CASESRSEFPPLHF,1,0,1,1
TRBV2,TRBJ1-2,CASIQTDSDYGYTF,1,0,1,1
TRBV13,TRBJ1-4,CASTLGGRAEKLFF,1,0,1,1
TRBV16,TRBJ2-7,CASTRIGISYEQYF,1,0,1,1
TRBV7-9,TRBJ1-6,CASTEPPHNSPLHF,1,0,1,1
TRBV28,TRBJ2-3,CASSFLSGTDTQYF,1,0,1,1
TRBV12-3/4,TRBJ2-7,CASSFWDRSYEQYF,1,0,1,1
TRBV12-3/4,TRBJ2-1,CASSFQGAHNEQFF,1,0,1,1
TRBV12-3/4,TRBJ1-3,CASSFAGSGNTIYF,1,0,1,1
TRBV6-2/3/5/6,TRBJ2-1,CASSFGGVGNEQFF,1,0,1,1
TRBV12-3/4,TRBJ1-5,CASSFGLLNQPQHF,1,0,1,1
TRBV12-3/4,TRBJ1-6,CASSFTQGESPLHF,1,0,1,1
TRBV27,TRBJ1-1,CASSFRGGDTEAFF,1,0,1,1
TRBV12-3/4,TRBJ2-7,CASSLVGSSYEQYF,1,0,1,1
TRBV12-3/4,TRBJ2-2,CASSLVGRTGELFF,1,0,1,1
TRBV12-3/4,TRBJ2-7,CASSLVVSSYEQYF,1,0,1,1
TRBV12-3/4,TRBJ2-1,CASSLAGDENEQFF,1,1,2,2
TRBV12-3/4,TRBJ2-5,CASSLGGSQETQYF,1,0,1,1
TRBV12-3/4,TRBJ1-6,CASSLTGGNSPLHF,1,0,1,1
TRBV6-2/3/5/6,TRBJ2-5,CASSLNRGQETQYF,1,1,2,2
TRBV6-2/3/5/6,TRBJ1-1,CASSLKGDGTGAFF,1,0,1,1
TRBV28,TRBJ1-2,CASSSSPLNYGYTF,1,0,1,1
TRBV2,TRBJ1-6,CASSSGPTHSPLHF,1,0,1,1
TRBV12-3/4,TRBJ2-3,CASSSTARGDTQYF,1,0,1,1
TRBV6-2/3/5/6,TRBJ1-2,CASSYWRQGSGYTF,1,0,1,1
TRBV6-2/3/5/6,TRBJ1-1,CASSYSRPDGEAFF,1,0,1,1
TRBV6-2/3/5/6,TRBJ2-7,CASSYLSQSYEQYF,1,0,1,1
TRBV6-2/3/5/6,TRBJ1-4,CASSYAPNGGKLFF,1,0,1,1
TRBV6-2/3/5/6,TRBJ2-1,CASSYGTSGSKQFF,1,0,1,1
TRBV6-2/3/5/6,TRBJ1-3,CASSYGTGGDTIYF,1,0,1,1
TRBV6-2/3/5/6,TRBJ2-3,CASSYEREMDTQYF,1,2,2,3
TRBV6-2/3/5/6,TRBJ1-1,CASSLVYMNTEAFF,1,0,1,1
TRBV6-2/3/5/6,TRBJ2-1,CASSLSVEGNEQFF,1,0,1,1
TRBV6-2/3/5/6,TRBJ1-1,CASSLRGMNTEAFF,1,0,1,1
TRBV6-2/3/5/6,TRBJ1-2,CASSPLRESDGYTF,1,0,1,1
TRBV27,TRBJ1-5,CASSPLGGSQPQHF,1,0,1,1
TRBV12-3/4,TRBJ2-5,CASSPPGVRETQYF,1,0,1,1
TRBV12-3/4,TRBJ1-2,CASSPQGVNYGYTF,1,0,1,1
TRBV6-2/3/5/6,TRBJ1-5,CASSPAGGDQPQHF,1,0,1,1
TRBV6-2/3/5/6,TRBJ2-7,CASSPGTSGYEQYF,1,0,1,1
TRBV6-2/3/5/6,TRBJ1-1,CASSQSNMNTEAFF,1,0,1,1
TRBV12-3/4,TRBJ1-2,CASSVWDRDSGYTF,1,0,1,1
TRBV6-1,TRBJ2-5,CASSVGQLQETQYF,1,0,1,1
TRBV25-1,TRBJ2-7,CASSVGNRGYEQYF,1,0,1,1
TRBV6-1,TRBJ2-7,CASSAPGLSYEQYF,1,0,1,1
TRBV25-1,TRBJ2-1,CASSDSTKIYEQFF,1,0,1,1
TRBV6-1,TRBJ2-7,CASSEWSGEDEQYF,1,0,1,1
TRBV2,TRBJ1-2,CASSEARRTYGYTF,1,0,1,1
TRBV28,TRBJ2-3,CASSTTGTTDTQYF,1,0,1,1
TRBV7-2,TRBJ2-7,CASSFLRGTYEQYF,1,0,1,1
TRBV7-6,TRBJ1-1,CASSFPTGVSEAFF,1,0,1,1
TRBV7-3,TRBJ1-1,CASSFPGQNTEAFF,1,0,1,1
TRBV5-8,TRBJ2-5,CASSFRDDQETQYF,1,0,1,1
TRBV7-2,TRBJ2-4,CASSFIPGQDIQYF,1,0,1,1
TRBV7-2,TRBJ2-7,CASSFSGRPYEQYF,1,0,1,1
TRBV5-6,TRBJ2-2,CASSLSSLTGELFF,1,0,1,1
TRBV5-4,TRBJ2-5,CASSLVGSGETQYF,1,0,1,1
TRBV5-6,TRBJ2-7,CASSLVGTAYEQYF,1,0,1,1
TRBV5-6,TRBJ2-3,CASSLAATTDTQYF,1,0,1,1
TRBV7-9,TRBJ2-7,CASSLAGVGYEQYF,1,0,1,1
TRBV7-2,TRBJ1-3,CASSLDRAGNTIYF,1,1,2,2
TRBV5-6,TRBJ1-2,CASSLEARNYGYTF,1,0,1,1
TRBV5-6,TRBJ2-7,CASSLEGGLSKQYF,1,0,1,1
TRBV7-2,TRBJ1-5,CASSLVPGDQPQHF,1,0,1,1
TRBV11-2,TRBJ2-7,CASSLVRGAPEQYF,1,0,1,1
TRBV7-2,TRBJ2-7,CASSLVAFSYEQYF,1,0,1,1
TRBV11-3,TRBJ2-1,CASSLAVAGNEQFF,1,0,1,1
TRBV7-2,TRBJ1-2,CASSLAGVAYGYTF,1,0,1,1
TRBV7-9,TRBJ2-1,CASSLAISYNEQFF,1,0,1,1
TRBV7-8,TRBJ2-7,CASSLGYRVYEQYF,1,0,1,1
TRBV7-9,TRBJ1-1,CASSLDLVNTEAFF,1,0,1,1
TRBV7-9,TRBJ2-3,CASSLDRLTDTQYF,1,0,1,1
TRBV7-3,TRBJ2-1,CASSLTGANNEQFF,1,0,1,1
TRBV7-2,TRBJ1-1,CASSLRQGAFEAFF,1,0,1,1
TRBV7-2,TRBJ2-2,CASSLNRATGELFF,1,0,1,1
TRBV11-2,TRBJ2-3,CASSSWEAYDTQYF,1,0,1,1
TRBV7-2,TRBJ1-1,CASSSLDRVEGAFF,1,0,1,1
TRBV7-6,TRBJ2-5,CASSSTGLKETQYF,1,0,1,1
TRBV7-9,TRBJ1-4,CASSSTTRTGKLFF,1,0,1,1
TRBV28,TRBJ1-4,CASSSGQINEKLFF,1,0,1,1
TRBV7-2,TRBJ2-2,CASSSDQGAGELFF,1,0,1,1
TRBV5-6,TRBJ2-7,CASSSDRGSYEQYF,1,0,1,1
TRBV7-3,TRBJ1-5,CASSSTDSNQPQHF,1,0,1,1
TRBV7-9,TRBJ2-5,CASSSTGGGETQYF,1,0,1,1
TRBV7-9,TRBJ2-5,CASSSQVGQETQYF,1,0,1,1
TRBV7-6,TRBJ2-1,CASSSASGRNEQFF,1,1,2,2
TRBV7-6,TRBJ2-7,CASSSEQGIYEQYF,1,0,1,1
TRBV5-4,TRBJ1-6,CASSWDRDNSPLHF,1,0,1,1
TRBV5-4,TRBJ2-5,CASSWTGFQETQYF,1,0,1,1
TRBV7-2,TRBJ2-3,CASSLSGGTDTQYF,1,0,1,1
TRBV7-9,TRBJ2-1,CASSLVPGDNEQFF,1,0,1,1
TRBV12-3/4,TRBJ2-2,CASSLRGGTGELFF,1,0,1,1
TRBV12-3/4,TRBJ2-7,CASSLMPGNHEQYF,1,2,2,3
TRBV7-9,TRBJ1-1,CASSLTLANSEAFF,1,0,1,1
TRBV7-9,TRBJ2-1,CASSLTADYNEQFF,1,0,1,1
TRBV4-2,TRBJ2-7,CASSPTSGPYEQYF,1,0,1,1
TRBV5-5,TRBJ2-7,CASSPRGDSYEQYF,1,0,1,1
TRBV3-1,TRBJ2-7,CASSPRTGEYEQYF,1,0,1,1
TRBV7-2,TRBJ2-3,CASSPQNRADTQYF,1,0,1,1
TRBV7-6,TRBJ2-5,CASSPGGGPETQYF,1,0,1,1
TRBV4-2,TRBJ2-1,CASSPGGSYNEQFF,1,0,1,1
TRBV9,TRBJ2-1,CASSPGLEDNEQFF,1,0,1,1
TRBV4-2,TRBJ2-3,CASSPGLASDTQYF,1,0,1,1
TRBV7-2,TRBJ2-5,CASSPSGSLETQYF,1,0,1,1
TRBV9,TRBJ2-5,CASSPSDGLGTQYF,1,0,1,1
TRBV6-2/3/5/6,TRBJ2-5,CASSPDGAPATQYF,1,0,1,1
TRBV9,TRBJ2-1,CASSRRGGADEQFF,1,0,1,1
TRBV7-9,TRBJ2-7,CASSRGTVEYEQYF,1,0,1,1
TRBV3-1,TRBJ1-1,CASSHTTANTEAFF,1,0,1,1
TRBV3-1,TRBJ1-1,CASSQWEPNTEAFF,1,1,2,2
TRBV4-2,TRBJ2-7,CASSQGDGPYEQYF,1,0,1,1
TRBV11-1,TRBJ2-7,CASSQDRGAYEQYF,1,0,1,1
TRBV4-2,TRBJ1-1,CASSQVDAFTEAFF,1,0,1,1
TRBV3-1,TRBJ1-1,CASSQAAASRKAFF,1,0,1,1
TRBV4-2,TRBJ2-5,CASSQRGNQETQYF,1,1,2,2
TRBV9,TRBJ2-5,CASSVSAVQETQYF,1,2,2,3
TRBV9,TRBJ1-1,CASSVASEVGEAFF,1,0,1,1
TRBV9,TRBJ1-6,CASSVAGMASPLHF,1,0,1,1
TRBV9,TRBJ1-6,CASSVAGGSSPLHF,1,0,1,1
TRBV9,TRBJ2-5,CASSVDVGGETQYF,1,0,1,1
TRBV5-6,TRBJ1-5,CASSGREGRGSQHF,1,0,1,1
TRBV9,TRBJ2-1,CASSGTLSYNEQFF,1,0,1,1
TRBV7-6,TRBJ2-3,CASSGMNGGDTQYF,1,0,1,1
TRBV7-9,TRBJ2-1,CASSELAGVNEQFF,1,0,1,1
TRBV9,TRBJ2-7,CASSEGRESSEQYF,1,0,1,1
TRBV7-9,TRBJ2-4,CASSERTGRNIQYF,1,0,1,1
TRBV5-4,TRBJ1-2,CASSIWGTGQGSAF,1,0,1,1
TRBV7-9,TRBJ2-3,CASSTRGGTDTQYF,1,0,1,1
TRBV5-4,TRBJ2-7,CASSTGRALYEQYF,1,2,2,3
TRBV14,TRBJ1-1,CASSNYRARTEAFF,1,0,1,1
TRBV7-9,TRBJ1-2,CASSNQGTAAGYTF,1,0,1,1
TRBV2,TRBJ1-5,CASRGAGGKQPQHF,1,0,1,1
TRBV12-3/4,TRBJ2-3,CASRGTGRSDTQYF,1,1,2,2
TRBV6-2/3/5/6,TRBJ1-4,CASRLTGIIEKLFF,1,0,1,1
TRBV5-6,TRBJ2-2,CASRIGQMTGELFF,1,0,1,1
TRBV12-3/4,TRBJ1-2,CASNSLGQLYGYTF,1,0,1,1
TRBV12-3/4,TRBJ2-3,CASKDGGGVDTQYF,1,0,1,1
TRBV7-2,TRBJ1-2,CANSLGSATGGYTF,1,0,1,1
TRBV5-1,TRBJ2-1,CASSRDRGHNEQFF,1,0,1,1
TRBV5-1,TRBJ2-6,CASGPGDGANVLTF,1,0,1,1
TRBV5-1,TRBJ1-3,CASSPGTDGNTIYF,1,0,1,1
TRBV10-2,TRBJ1-1,CASSDTGRFTEAFF,1,0,1,1
TRBV5-1,TRBJ1-2,CASSFRPDGEGYTF,1,0,1,1
TRBV5-1,TRBJ2-7,CASSFTGLAGGEYF,1,0,1,1
TRBV5-1,TRBJ2-7,CASSLAAGVHEQYF,1,0,1,1
TRBV5-1,TRBJ2-1,CASSLGWGHNEQFF,1,0,1,1
TRBV5-1,TRBJ2-7,CASSLGQGAYEQYF,1,0,1,1
TRBV5-1,TRBJ2-2,CASSLGTNTGELFF,1,0,1,1
TRBV5-1,TRBJ2-3,CASSLEGITDTQYF,1,0,1,1
TRBV5-1,TRBJ1-1,CASSLGRAATEAFF,1,0,1,1
TRBV5-1,TRBJ2-7,CASSLSGSTYEQYF,1,0,1,1
TRBV4-1,TRBJ1-2,CASSPLDRDYGYTF,1,0,1,1
TRBV4-1,TRBJ2-4,CASSPAGSGDIQYF,1,0,1,1
TRBV10-2,TRBJ1-1,CASSRVKLDTEAFF,1,0,1,1
TRBV4-3,TRBJ1-4,CASSHGQVGEKLFF,1,0,1,1
TRBV5-1,TRBJ2-3,CASSQGHPTDTQYF,1,0,1,1
TRBV4-3,TRBJ1-2,CASSQVGINYGYTF,1,0,1,1
TRBV4-3,TRBJ2-1,CASSQGGDYNEQFF,1,1,2,2
TRBV4-1,TRBJ2-7,CASSQGDGGYEQYF,1,0,1,1
TRBV4-3,TRBJ2-7,CASSQDWGNYEQYF,1,0,1,1
TRBV4-1,TRBJ2-1,CASSQERGYNEQSF,1,0,1,1
TRBV4-1,TRBJ2-6,CASSGGSGANVLTF,1,0,1,1
TRBV4-1,TRBJ2-2,CASSRDSRTGELFF,1,0,1,1
TRBV4-1,TRBJ2-7,CASRRVVGTYEQYF,1,0,1,1
TRBV5-1,TRBJ1-1,CASRKGLGGTEAFF,1,0,1,1
TRBV20-1,TRBJ1-2,CSAPPGGVSDGYTF,1,0,1,1
TRBV20-1,TRBJ1-1,CSAQIKTGGVEAFF,1,0,1,1
TRBV20-1,TRBJ2-5,CSAGGGAGQETQYF,1,0,1,1
TRBV20-1,TRBJ2-7,CSAIALWGNYEQYF,1,0,1,1
TRBV20-1,TRBJ2-3,CSASQGTYTDTQYF,1,0,1,1
TRBV20-1,TRBJ2-1,CSARAGGAYNEQFF,1,0,1,1
TRBV20-1,TRBJ1-5,CSARTGGSDKPQHF,1,0,1,1
TRBV20-1,TRBJ2-3,CSARLAGYTDTQYF,1,0,1,1
TRBV20-1,TRBJ1-1,CSARYGDRDTEAFF,1,0,1,1
TRBV20-1,TRBJ2-5,CSARVSGEQETQYF,1,0,1,1
TRBV20-1,TRBJ1-4,CSARAPDRAEKLFF,1,0,1,1
TRBV20-1,TRBJ1-4,CSARDGTFNEKLFF,1,0,1,1
TRBV20-1,TRBJ2-7,CSAPAGDRVYEQYF,1,0,1,1
TRBV20-1,TRBJ2-1,CSARASGRRGEQFF,1,0,1,1
TRBV20-1,TRBJ1-1,CSPSMWAVNTEAFF,1,0,1,1
TRBV29-1,TRBJ1-4,CSVSTASKGEKLFF,1,0,1,1
TRBV29-1,TRBJ2-1,CSVVYGQGGYEQFF,1,3,2,4
TRBV29-1,TRBJ1-4,CSVAEGTTNEKLFF,1,0,1,1
TRBV29-1,TRBJ2-1,CSVAGGLVFGEQFF,1,0,1,1
TRBV29-1,TRBJ1-5,CSVAFGASNQPQHF,1,0,1,1
TRBV29-1,TRBJ1-1,CSVGGVGGATEAFF,1,0,1,1
TRBV29-1,TRBJ2-7,CSVGGAGTVYEQYF,1,0,1,1
TRBV29-1,TRBJ2-4,CSVEGGQGRDIQYF,1,0,1,1
TRBV29-1,TRBJ2-1,CSVEPRWGLNEQFF,1,0,1,1
TRBV29-1,TRBJ2-3,CSVEGAFNTDTQYF,1,0,1,1
TRBV29-1,TRBJ2-1,CSVEGTSGYNEQFF,1,0,1,1
TRBV29-1,TRBJ1-2,CSVEDGGLGYGYTF,1,0,1,1
TRBV29-1,TRBJ2-3,CSVERAGPKDTQYF,1,0,1,1
TRBV29-1,TRBJ2-5,CSVAIGERGETQYF,1,0,1,1
TRBV29-1,TRBJ2-5,CSVLSLQSPETQYF,1,0,1,1
TRBV29-1,TRBJ1-4,CSVTGGTTNEKLFF,1,0,1,1
TRBV29-1,TRBJ1-5,CSASTGGRNQPQHF,1,0,1,1
TRBV29-1,TRBJ2-3,CSAQSGGRTDTQYF,1,0,1,1
TRBV29-1,TRBJ2-5,CSIEERDGQETQYF,1,0,1,1
TRBV2,TRBJ2-7,CVGSGTTRHEQYF,1,0,1,1
TRBV3-1,TRBJ2-5,CASSQGYQETQYF,1,0,1,1
TRBV5-4,TRBJ2-5,CASTSSWEETQYF,1,0,1,1
TRBV30,TRBJ1-1,CAWSTRRNTEAFF,1,0,1,1
TRBV30,TRBJ1-5,CAWSKGTGQPQHF,1,0,1,1
TRBV30,TRBJ2-6,CAWSLGGANVLSF,1,0,1,1
TRBV30,TRBJ2-1,CAGIRGMGNEQFF,1,0,1,1
TRBV10-3,TRBJ2-7,CAISADTSYEQYF,1,0,1,1
TRBV19,TRBJ1-5,CATQGLSNQPQHF,1,0,1,1
TRBV24-1,TRBJ2-2,CATGLAGGGELFF,1,0,1,1
TRBV19,TRBJ1-1,CATDHREGTEAFF,1,0,1,1
TRBV24-1,TRBJ2-1,CATSDLTYNEQFF,1,0,1,1
TRBV15,TRBJ1-1,CATSRSQNTEAFF,1,0,1,1
TRBV19,TRBJ1-1,CASSMGLNTEAFF,1,0,1,1
TRBV19,TRBJ2-3,CASSMGGTDTQYF,1,0,1,1
TRBV19,TRBJ1-5,CASSILGPGPQHF,1,0,1,1
TRBV19,TRBJ1-5,CASRRSPGEPQHF,1,1,2,2
TRBV19,TRBJ1-1,CASRVDRETEAFF,1,0,1,1
TRBV19,TRBJ2-1,CASNLQGDNEQFF,1,0,1,1
TRBV19,TRBJ1-2,CASNLGQNYGYTF,1,0,1,1
TRBV6-2/3/5/6,TRBJ2-5,CASSGWGREDLYF,1,0,1,1
TRBV9,TRBJ1-5,CASSMTGLEPQHF,1,0,1,1
TRBV5-4,TRBJ2-5,CASAGAGRETQYF,1,0,1,1
TRBV2,TRBJ2-5,CASGQEGQETQYF,1,0,1,1
TRBV2,TRBJ2-7,CASGRGGPVEQYF,1,0,1,1
TRBV12-3/4,TRBJ2-3,CASMSPGRDTQYF,1,0,1,1
TRBV7-9,TRBJ1-4,CASMHSTDEKLFF,1,0,1,1
TRBV3-1,TRBJ2-5,CASTRGRLETQYF,1,0,1,1
TRBV12-3/4,TRBJ2-7,CASSFVGGYEQYF,1,0,1,1
TRBV6-1,TRBJ2-1,CASSFADLAEQFF,1,0,1,1
TRBV27,TRBJ2-7,CASSFRGSYEQYF,1,0,1,1
TRBV6-2/3/5/6,TRBJ1-1,CASSFRTNTEAFF,1,0,1,1
TRBV12-3/4,TRBJ1-1,CASSFGGNTEAFF,1,0,1,1
TRBV6-2/3/5/6,TRBJ1-5,CASSFGENQPQHF,1,1,2,2
TRBV27,TRBJ1-2,CASSLGTGQGYTF,1,0,1,1
TRBV6-2/3/5/6,TRBJ1-2,CASSLRQGYGYTF,1,0,1,1
TRBV12-3/4,TRBJ2-1,CASSLNRYNEQFF,1,0,1,1
TRBV12-3/4,TRBJ1-4,CASSLARDEKLFF,1,0,1,1
TRBV6-2/3/5/6,TRBJ1-1,CASSLTRSTEAFF,1,0,1,1
TRBV5-5,TRBJ2-5,CASSSGTQETQYF,1,0,1,1
TRBV12-3/4,TRBJ1-2,CASSSRGGDGYTF,1,0,1,1
TRBV6-2/3/5/6,TRBJ2-7,CASSYAAVYEQYF,1,0,1,1
TRBV6-2/3/5/6,TRBJ1-1,CASSYGLNTEAFF,1,0,1,1
TRBV7-8,TRBJ2-7,CASSPGHSYEQYF,1,0,1,1
TRBV11-1,TRBJ2-3,CASSQVRTDTQYF,1,0,1,1
TRBV12-3/4,TRBJ1-5,CASSQSSNQPQHF,1,0,1,1
TRBV6-1,TRBJ2-7,CASSGVGDYEQYF,1,0,1,1
TRBV6-1,TRBJ1-5,CASSGEYNQPQHF,1,0,1,1
TRBV6-1,TRBJ1-2,CASSERGQGTVLL,1,0,1,1
TRBV6-1,TRBJ2-7,CASSEASESEQYF,1,1,2,2
TRBV2,TRBJ1-1,CASSEGGYTEAFF,1,0,1,1
TRBV6-1,TRBJ1-1,CASSEKYGPEAFF,1,0,1,1
TRBV7-2,TRBJ1-2,CASSTGQGNGYTF,1,0,1,1
TRBV7-6,TRBJ1-5,CASSTGGVQPQHF,1,0,1,1
TRBV6-2/3/5/6,TRBJ2-5,CASSSLQGAFSNF,1,0,1,1
TRBV12-3/4,TRBJ2-5,CASSRAGRKTQYF,1,0,1,1
TRBV6-4,TRBJ1-1,CASSRLMNTEAFF,1,0,1,1
TRBV7-2,TRBJ2-7,CASSFNDGHEQYF,1,0,1,1
TRBV7-2,TRBJ1-1,CASSFDGNTEAFF,1,0,1,1
TRBV5-4,TRBJ1-1,CASSFDRGTAAFF,1,0,1,1
TRBV7-9,TRBJ1-1,CASSFTRNTEAFF,1,0,1,1
TRBV11-2,TRBJ2-1,CASSLSPYNEQFF,1,0,1,1
TRBV5-4,TRBJ2-5,CASSLAPQETQYF,1,0,1,1
TRBV7-7,TRBJ2-7,CASSLTSGYEQYF,1,0,1,1
TRBV7-9,TRBJ1-1,CASSLSGRTEAFF,1,1,2,2
TRBV7-9,TRBJ1-5,CASSLSIRQPQHF,1,0,1,1
TRBV7-2,TRBJ2-7,CASSLSTPYEQYF,1,0,1,1
TRBV7-9,TRBJ1-5,CASSLATDQPQHF,1,0,1,1
TRBV11-3,TRBJ2-1,CASSLGGYNEQFF,1,0,1,1
TRBV7-3,TRBJ1-1,CASSLGGGSEAFF,1,0,1,1
TRBV7-9,TRBJ2-7,CASSLTGDYEQYF,1,0,1,1
TRBV11-1,TRBJ1-1,CASSLTGNTEAFF,1,0,1,1
TRBV7-9,TRBJ2-7,CASSSGQLYEQYF,1,0,1,1
TRBV6-2/3/5/6,TRBJ2-1,CASSSTGGWEQFF,1,0,1,1
TRBV7-9,TRBJ2-2,CASSSRYTGELFF,1,0,1,1
TRBV7-9,TRBJ1-1,CASSSPFNTEAFF,1,0,1,1
TRBV3-1,TRBJ2-7,CASSSGAAYEQYF,1,0,1,1
TRBV7-6,TRBJ1-1,CASSWEEDTEAFF,1,0,1,1
TRBV27,TRBJ2-5,CASSYGGRETQYF,1,0,1,1
TRBV7-9,TRBJ1-1,CASSLGGNTEAFF,1,0,1,1
TRBV12-3/4,TRBJ1-2,CASSLRAPYGYTF,1,1,2,2
TRBV7-2,TRBJ1-1,CASSLQGGTEAFF,1,0,1,1
TRBV6-2/3/5/6,TRBJ1-2,CASSLGKDYGYTF,1,0,1,1
TRBV7-9,TRBJ1-5,CASSLNSNQPQHF,1,0,1,1
TRBV6-2/3/5/6,TRBJ2-1,CASSPRWYDEQFF,1,0,1,1
TRBV7-9,TRBJ2-1,CASSPRDGGEQFF,1,0,1,1
TRBV5-4,TRBJ1-1,CASSPGRKTEAFF,1,0,1,1
TRBV7-6,TRBJ2-7,CASSPGAAYEQYF,1,2,2,3
TRBV4-2,TRBJ1-2,CASSPGQDYGYTF,1,0,1,1
TRBV9,TRBJ1-2,CASSPTGGHGYTF,1,0,1,1
TRBV11-1,TRBJ2-5,CASSRRVQETQYF,1,0,1,1
TRBV7-2,TRBJ1-5,CASSRIGNQPQHF,1,0,1,1
TRBV3-1,TRBJ2-5,CASSQDIRETQYF,1,0,1,1
TRBV14,TRBJ1-3,CASSQIVRNTIYF,1,0,1,1
TRBV7-2,TRBJ1-2,CASSVAQGWGYTF,1,0,1,1
TRBV9,TRBJ2-7,CASSVVVGGEQYF,1,0,1,1
TRBV9,TRBJ1-1,CASSVGAGSEAFF,1,0,1,1
TRBV6-1,TRBJ2-2,CASSETSVRELFF,1,0,1,1
TRBV5-6,TRBJ1-1,CASSILRGTEAFF,1,0,1,1
TRBV7-9,TRBJ1-1,CASSRDIGTEAFF,1,1,2,2
TRBV9,TRBJ2-3,CASRSTPGDTQYF,1,0,1,1
TRBV6-2/3/5/6,TRBJ2-4,CASRLGNKNIQYI,1,0,1,1
TRBV2,TRBJ1-5,CASRGRGGQPQHF,1,0,1,1
TRBV12-3/4,TRBJ2-4,CASRGGGTAPNYF,1,0,1,1
TRBV7-9,TRBJ2-1,CASRPDGYNEQFF,1,0,1,1
TRBV12-3/4,TRBJ2-7,CASRAGTLYEQYF,1,0,1,1
TRBV12-3/4,TRBJ1-2,CASRDRVDYGYTF,1,0,1,1
TRBV7-9,TRBJ2-5,CASRERGRETQYF,1,0,1,1
TRBV4-2,TRBJ1-1,CASRIWGGTEAFF,1,0,1,1
TRBV12-3/4,TRBJ2-1,CASKANSRSVQFF,1,0,1,1
TRBV5-1,TRBJ2-3,CASTEQGTDTQYF,1,0,1,1
TRBV5-1,TRBJ1-2,CASSFGTTYGYTF,1,0,1,1
TRBV5-1,TRBJ1-2,CASSLLSQSGYTF,1,0,1,1
TRBV5-1,TRBJ2-1,CASSLSSYNEQFF,1,0,1,1
TRBV5-1,TRBJ2-7,CASSLNRGGEQYF,1,0,1,1
TRBV5-1,TRBJ1-1,CASSSGQGGEAFF,1,0,1,1
TRBV4-1,TRBJ2-5,CASSLTGRETQYF,1,0,1,1
TRBV5-1,TRBJ2-1,CASSLAAQNEQFF,1,0,1,1
TRBV5-1,TRBJ2-3,CASSPAGGDTQYF,1,0,1,1
TRBV4-3,TRBJ2-1,CASSPTGNNEQFF,1,0,1,1
TRBV4-1,TRBJ1-1,CASSRTLNTEAFF,1,1,2,2
TRBV4-1,TRBJ1-5,CASSQDRDQPQHF,1,0,1,1
TRBV4-1,TRBJ1-5,CASSQHRGEPQHF,1,0,1,1
TRBV4-1,TRBJ2-1,CASSQDGTWEQFF,1,0,1,1
TRBV4-1,TRBJ2-3,CASSQEGTSTQYF,1,0,1,1
TRBV5-1,TRBJ1-1,CASSVDRNTEAFF,1,0,1,1
TRBV5-1,TRBJ2-3,CASSGSGTDTQYF,1,0,1,1
TRBV5-1,TRBJ2-1,CASSIPDDNEQFF,1,0,1,1
TRBV5-1,TRBJ1-1,CASSITVLTEAFF,1,0,1,1
TRBV4-1,TRBJ1-1,CASSITVNTEAFF,1,0,1,1
TRBV4-3,TRBJ2-1,CASRQGLADEQFF,1,0,1,1
TRBV20-1,TRBJ2-5,CSVPDGYQETQYF,1,0,1,1
TRBV20-1,TRBJ1-1,CSARVVAGMGAFF,1,0,1,1
TRBV20-1,TRBJ2-7,CSARGDRDYEQYF,1,0,1,1
TRBV20-1,TRBJ1-5,CSARESTHQPQHF,1,0,1,1
TRBV20-1,TRBJ1-3,CSARKDGGNTIYF,1,0,1,1
TRBV20-1,TRBJ2-7,CSANLGGTYEQYF,1,0,1,1
TRBV20-1,TRBJ1-5,CSAKVRGNQPQHF,1,0,1,1
TRBV20-1,TRBJ1-1,CSAPNRVSTEAFF,1,0,1,1
TRBV20-1,TRBJ1-4,CSAIKRPSEKLFF,1,0,1,1
TRBV20-1,TRBJ1-5,CSAGQGSNQPQHF,1,0,1,1
TRBV29-1,TRBJ2-7,CSVSRGRGYEQYF,1,0,1,1
TRBV29-1,TRBJ1-4,CSVVRDVNEKLFF,1,0,1,1
TRBV29-1,TRBJ2-5,CSVVASEVETQYF,1,1,2,2
TRBV29-1,TRBJ2-5,CSVGGFGEETQYF,1,0,1,1
TRBV29-1,TRBJ2-1,CSVGTSGYNEQFF,1,0,1,1
TRBV29-1,TRBJ2-7,CSVDTGNTYEQYF,1,0,1,1
TRBV29-1,TRBJ1-1,CSVELGGNTEAFF,1,0,1,1
TRBV29-1,TRBJ1-6,CSVKEGEAAPLHF,1,0,1,1
TRBV29-1,TRBJ1-5,CSVGEGVGQPQHF,1,0,1,1
TRBV29-1,TRBJ2-7,CSVGGLAVYEQYF,1,0,1,1
TRBV29-1,TRBJ2-1,CSVGLAVYNEQFF,1,0,1,1
TRBV29-1,TRBJ2-7,CSVARGLAYEQYF,1,0,1,1
TRBV29-1,TRBJ1-2,CSAGGGGVNGYTF,1,0,1,1
TRBV29-1,TRBJ1-1,CSGDRPEGTEAFF,1,0,1,1
TRBV29-1,TRBJ2-5,CSGESRIQETQYF,1,0,1,1
TRBV29-1,TRBJ1-1,CSGTGVGNTEAFF,1,0,1,1
TRBV12-3/4,TRBJ2-7,YASSRLNSYEQYF,1,0,1,1
TRBV7-3,TRBJ1-2,RASSLSGHYGYTF,1,0,1,1
TRBV30,TRBJ2-1,CAWSVFDMVKSF,1,0,1,1
TRBV7-9,TRBJ2-7,CATRQGAYEQYF,1,0,1,1
TRBV24-1,TRBJ2-3,CATRGGTDTQYF,1,0,1,1
TRBV18,TRBJ1-2,CASSPTSEGYTF,1,0,1,1
TRBV18,TRBJ2-1,CASSPLKRAQFF,1,0,1,1
TRBV2,TRBJ2-5,CASLGLGETQYF,1,0,1,1
TRBV28,TRBJ1-2,CASRAGNYGYTF,1,0,1,1
TRBV12-3/4,TRBJ1-2,CASGGTTYGYTF,1,0,1,1
TRBV7-9,TRBJ2-1,CASGQGNSEQFF,1,0,1,1
TRBV2,TRBJ2-6,CASTSGANVLTF,1,0,1,1
TRBV6-2/3/5/6,TRBJ1-1,CASSFGGPEAFF,1,0,1,1
TRBV12-3/4,TRBJ1-1,CASSLVGTEAFF,1,0,1,1
TRBV6-2/3/5/6,TRBJ2-4,CASSLTGSELYF,1,0,1,1
TRBV12-3/4,TRBJ2-7,CASSLSSHEQYF,1,0,1,1
TRBV12-3/4,TRBJ2-4,CASSLDVNIQYF,1,0,1,1
TRBV6-2/3/5/6,TRBJ2-3,CASSYPSNTQYF,1,0,1,1
TRBV27,TRBJ2-7,CASSLDSYEQYF,1,0,1,1
TRBV6-2/3/5/6,TRBJ1-5,CASSPEDQPQHF,1,0,1,1
TRBV7-6,TRBJ2-1,CASSPSGNEQFF,1,1,2,2
TRBV6-2/3/5/6,TRBJ2-1,CASSPRGGTRFF,1,0,1,1
TRBV6-1,TRBJ2-1,CASSPEYNEQFF,1,0,1,1
TRBV6-2/3/5/6,TRBJ2-2,CASSRYTGELFF,1,0,1,1
TRBV25-1,TRBJ2-1,CASSVSYNEQFF,1,0,1,1
TRBV2,TRBJ2-7,CASSENSYEQYF,1,0,1,1
TRBV12-3/4,TRBJ2-4,CASSTPGGIQYF,1,1,2,2
TRBV5-6,TRBJ2-2,CASSLGTGELFF,1,1,2,2
TRBV5-6,TRBJ1-1,CASSLRITEAFF,1,0,1,1
TRBV7-9,TRBJ1-3,CASSSTWDTIYF,1,0,1,1
TRBV7-2,TRBJ1-6,CASSLRQGPLHF,1,0,1,1
TRBV12-3/4,TRBJ1-1,CASSPWSTEAFF,1,0,1,1
TRBV7-9,TRBJ2-1,CASSPPGWEQFF,1,0,1,1
TRBV12-3/4,TRBJ1-1,CASSPRLTEAFF,1,0,1,1
TRBV7-9,TRBJ1-5,CASSPDAQPQHF,1,0,1,1
TRBV7-9,TRBJ1-5,CASSPLDQPQHF,1,0,1,1
TRBV7-8,TRBJ2-7,CASSPRLDEQYF,1,0,1,1
TRBV6-2/3/5/6,TRBJ2-1,CASSRPYNEQFF,1,1,2,2
TRBV3-1,TRBJ1-5,CASSHSNQPQHF,1,0,1,1
TRBV3-1,TRBJ2-3,CASSQNRDTQYF,1,0,1,1
TRBV5-5,TRBJ1-2,CASSQGSYGYTF,1,0,1,1
TRBV3-1,TRBJ2-2,CASSQEPGELFF,1,0,1,1
TRBV3-1,TRBJ2-7,CASSQSRYEQYF,1,1,2,2
TRBV11-2,TRBJ2-5,CASSVGVETQYF,1,0,1,1
TRBV9,TRBJ1-1,CASSVRAGRAFF,1,0,1,1
TRBV5-6,TRBJ2-7,CASSAGPYEQYF,1,0,1,1
TRBV5-6,TRBJ1-1,CASSTMNTEAFF,1,0,1,1
TRBV6-2/3/5/6,TRBJ2-5,CASRFLQETQYF,1,0,1,1
TRBV25-1,TRBJ1-2,CASRGSLYGYTF,1,0,1,1
TRBV6-2/3/5/6,TRBJ2-5,CASRAGGETQYF,1,0,1,1
TRBV2,TRBJ2-1,CASRELAGEKFF,1,0,1,1
TRBV11-3,TRBJ2-3,CASREAADTQYF,1,0,1,1
TRBV2,TRBJ2-7,CASRTGAYEQYF,1,0,1,1
TRBV7-9,TRBJ2-7,CATSQGDHEQYF,1,0,1,1
TRBV12-3/4,TRBJ2-2,CALGGYTGELFF,1,0,1,1
TRBV4-1,TRBJ2-1,CASGQVRNEQFF,1,0,1,1
TRBV5-1,TRBJ2-7,CASSSELYEQYF,1,0,1,1
TRBV4-1,TRBJ1-6,CASSQTRSPLHF,1,0,1,1
TRBV5-1,TRBJ1-1,CASSAEGREAFL,1,0,1,1
TRBV4-1,TRBJ1-5,CARTRSNQPQHF,1,0,1,1
TRBV29-1,TRBJ2-1,CTGTSGSDEQFF,1,0,1,1
TRBV20-1,TRBJ2-3,CSASPTTDTQYF,1,0,1,1
TRBV20-1,TRBJ2-1,CSARRSYNEQFF,1,0,1,1
TRBV20-1,TRBJ1-2,CSADPGGRRYTF,1,0,1,1
TRBV29-1,TRBJ2-7,CSVVSQGDEQYF,1,0,1,1
TRBV29-1,TRBJ2-1,CSVGATDNEQFF,1,0,1,1
TRBV29-1,TRBJ2-5,CSVGQDRETQYF,1,0,1,1
TRBV29-1,TRBJ2-2,CSVGRDTGELFF,1,0,1,1
TRBV29-1,TRBJ1-2,CSVDPAGGGYTF,1,0,1,1
TRBV29-1,TRBJ2-1,CSVDIQGNEQFF,1,0,1,1
TRBV29-1,TRBJ2-4,CSVKGAKNIQYF,1,0,1,1
TRBV29-1,TRBJ2-1,CSAGTDYNEQFF,1,0,1,1
TRBV29-1,TRBJ2-7,CSAGQGPYEQYF,1,0,1,1
TRBV20-1,TRBJ2-1,CSGLDNDNEQFF,1,0,1,1
TRBV29-1,TRBJ2-5,CSGLAAEETQYF,1,0,1,1
TRBV29-1,TRBJ2-3,CSGGPAYSWQYF,1,0,1,1
TRBV30,TRBJ2-7,CAWGRSYEQYF,1,0,1,1
TRBV30,TRBJ1-3,CAWSNGNTIYF,1,0,1,1
TRBV30,TRBJ1-2,CAWSDGRDCAF,1,0,1,1
TRBV19,TRBJ2-7,CAAKGLHEQYF,1,0,1,1
TRBV12-3/4,TRBJ1-5,CAGSLSEPQHF,1,0,1,1
TRBV10-3,TRBJ1-2,CAISDSYGYTF,1,0,1,1
TRBV10-3,TRBJ1-1,CAISQDGEAFF,1,0,1,1
TRBV10-3,TRBJ2-1,CAIKLAGEQFF,1,0,1,1
TRBV19,TRBJ1-5,CASSQGQPQHF,1,0,1,1
TRBV19,TRBJ1-2,CASTSFYGYTF,1,0,1,1
TRBV30,TRBJ2-2,CASSGSGELFF,1,0,1,1
TRBV27,TRBJ1-1,CASSFGQEAFF,1,0,1,1
TRBV28,TRBJ2-1,CASSLDNEQFF,1,2,2,3
TRBV6-1,TRBJ2-1,CASSQGNEQFF,1,0,1,1
TRBV6-1,TRBJ2-3,CASSAPDTQYF,1,0,1,1
TRBV25-1,TRBJ2-7,CASSGSYEQYF,1,0,1,1
TRBV2,TRBJ2-1,CASSEAPGQFF,1,0,1,1
TRBV25-1,TRBJ2-3,CASSEQNTQYF,1,0,1,1
TRBV5-6,TRBJ2-1,CASSLYDEQFF,1,0,1,1
TRBV5-6,TRBJ2-5,CASSLTETQYF,1,0,1,1
TRBV6-2/3/5/6,TRBJ1-1,CASSLGGEAFF,1,0,1,1
TRBV7-9,TRBJ2-7,CASSPGIEQYF,1,0,1,1
TRBV3-1,TRBJ2-7,CASSHRTEQYF,1,0,1,1
TRBV7-9,TRBJ1-2,CASSASAGYTF,1,0,1,1
TRBV7-9,TRBJ2-7,CASRLTGEQYF,1,0,1,1
TRBV5-4,TRBJ1-2,CASRHIHGYTF,1,0,1,1
TRBV6-4,TRBJ2-1,CTSSAYNEQFF,1,0,1,1
TRBV4-1,TRBJ1-1,CASSPGSEAFF,1,0,1,1
TRBV29-1,TRBJ2-5,CSLGGPETQYF,1,0,1,1
TRBV20-1,TRBJ2-3,CSASGRDTQYF,1,0,1,1
TRBV20-1,TRBJ1-1,CSARENTEAFF,1,0,1,1
TRBV20-1,TRBJ2-5,CSATAQETQYF,1,0,1,1
TRBV29-1,TRBJ1-1,CSVVGQGWAFF,1,0,1,1
TRBV29-1,TRBJ1-1,CSVGWGTEAFF,1,0,1,1
TRBV29-1,TRBJ2-5,CSVDWGETQYF,1,0,1,1
TRBV29-1,TRBJ2-3,CSVEQTDTQYF,1,0,1,1
TRBV29-1,TRBJ1-2,CSAPGIYGYTF,1,0,1,1
TRBV29-1,TRBJ1-1,CSAASGTEAFF,1,0,1,1
TRBV7-9,TRBJ1-2,CASSPPGYTF,1,0,1,1
TRBV25-1,TRBJ1-2,CASSAPAVTF,1,0,1,1
TRBV20-1,TRBJ2-1,CSARRVEQFF,1,0,1,1
TRBV20-1,TRBJ2-7,CSAGTYEQYF,1,0,1,1
TRBV29-1,TRBJ2-2,CSVGNGELFF,1,0,1,1
TRBV29-1,TRBJ2-3,CSALRDTQYF,1,0,1,1
TRBV29-1,TRBJ1-1,CSANAFF,1,0,1,1
TRBV18,TRBJ2-6,CASSRKSLAGGIPTSGANVLTF,1,0,1,1
TRBV4-3,TRBJ2-2,CVSSQGTSRAYTGELFF,1,0,1,1
TRBV27,TRBJ2-1,CASSSPLASGSNEQFF,1,0,1,1
TRBV10-3,TRBJ2-7,CASSESRVGGEQYF,1,0,1,1
TRBV30,TRBJ2-1,CAWSGLDNEQFF,1,0,1,1
TRBV4-3,TRBJ2-1,CASSQEGGSSYNEQFF,0,49,1,49
TRBV7-9,TRBJ1-1,CASSFRTENTEAFF,0,13,1,13
TRBV7-9,TRBJ1-1,CASRTGSSEAFF,0,12,1,12
TRBV7-9,TRBJ1-5,CASSLSREQPQHF,0,8,1,8
TRBV6-4,TRBJ2-7,CASSLPPARGNYEQYF,0,1,1,1
TRBV20-1,TRBJ2-1,CSAISGGAGNEQFF,0,2,1,2
TRBV7-2,TRBJ2-7,CASGINSYEQYF,0,9,1,9
TRBV14,TRBJ1-5,CASSRNNQPQHF,0,8,1,8
TRBV2,TRBJ1-4,CASSEVWQRGEKLFF,0,4,1,4
TRBV13,TRBJ2-3,CASKAGQGGPRITDTQYF,0,5,1,5
TRBV5-6,TRBJ1-2,CASSLTGLGYTF,0,5,1,5
TRBV7-2,TRBJ2-3,CASSSSRGLAGATQYF,0,5,1,5
TRBV6-2/3/5/6,TRBJ1-5,CASSYRGDSNQPQHF,0,3,1,3
TRBV12-5,TRBJ2-1,CASGLAGTGEGDEQFF,0,1,1,1
TRBV7-2,TRBJ1-1,CASSLGGPEAFF,0,4,1,4
TRBV29-1,TRBJ2-1,CSAISGSAFRLHEQFF,0,5,1,5
TRBV14,TRBJ1-1,CASSQGGNTEAFF,0,3,1,3
TRBV10-3,TRBJ2-2,CAIGKTGGFTGELFF,0,1,1,1
TRBV7-2,TRBJ2-3,CASSPSGGRTDTQYF,0,2,1,2
TRBV7-9,TRBJ2-7,CASSLVVSGGHEQYF,0,5,1,5
TRBV3-1,TRBJ2-3,CASSQGLVRRVGTDTQYF,0,1,1,1
TRBV12-3/4,TRBJ1-5,CASSFGNQPQHF,0,1,1,1
TRBV2,TRBJ1-2,CASSEARNAVAPYGYTF,0,4,1,4
TRBV20-1,TRBJ2-3,CSAGPEAGADTQYF,0,1,1,1
TRBV5-1,TRBJ1-1,CASSIGMNTEAFF,0,1,1,1
TRBV29-1,TRBJ1-1,CSVTGNTEAFF,0,3,1,3
TRBV5-6,TRBJ2-7,CASSSTGGEGSYEQYF,0,4,1,4
TRBV29-1,TRBJ1-1,CSVDRGQLNTEAFF,0,3,1,3
TRBV29-1,TRBJ2-1,CSVDILNNEQFF,0,1,1,1
TRBV27,TRBJ1-6,CASSAGLTHSPLHF,0,4,1,4
TRBV5-6,TRBJ1-2,CASSLGPGPGWYGYTF,0,1,1,1
TRBV7-2,TRBJ2-7,CASIPRLVASGEQYF,0,1,1,1
TRBV12-3/4,TRBJ1-5,CASSFLESNQPQHF,0,1,1,1
TRBV7-2,TRBJ2-7,CAGSSGTEEQYF,0,5,1,5
TRBV12-3/4,TRBJ2-3,CASSLRSGAGTDTQYF,0,4,1,4
TRBV5-1,TRBJ1-4,CASSLRQGADEKLFF,0,1,1,1
TRBV6-1,TRBJ2-3,CASSENRGGQDTQYF,0,4,1,4
TRBV12-3/4,TRBJ1-5,CASSLVPGGQPQHF,0,1,1,1
TRBV20-1,TRBJ2-5,CSAGLVEQETQYF,0,1,1,1
TRBV11-2,TRBJ2-5,CASSPNNKETQYF,0,1,1,1
TRBV5-5,TRBJ2-2,CASSQDYLNTGELFF,0,1,1,1
TRBV7-2,TRBJ2-1,CASSLLAGGFSFVGNNEQFF,0,1,1,1
TRBV15,TRBJ1-1,CATKGTGAKDTEAFF,0,2,1,2
TRBV14,TRBJ2-7,CASSQSGRNRYEQYF,0,1,1,1
TRBV12-3/4,TRBJ2-3,CASSYDINSPSQYF,0,3,1,3
TRBV20-1,TRBJ2-7,CSAAGDREIYEQYF,0,1,1,1
TRBV12-3/4,TRBJ2-3,CASNPPAGGLTDTQYF,0,1,1,1
TRBV29-1,TRBJ2-1,CSVGGGGLGTYNEQFF,0,1,1,1
TRBV12-3/4,TRBJ2-7,CASTPGLKTPREQYF,0,1,1,1
TRBV5-6,TRBJ1-6,CASSFRQGSLSPLHF,0,2,1,2
TRBV11-2,TRBJ2-1,CASSLDGLSWDEQFF,0,1,1,1
TRBV12-3/4,TRBJ2-3,CASSLRRGKDTQYF,0,4,1,4
TRBV12-3/4,TRBJ2-7,CASSLGTSGTSKYF,0,2,1,2
TRBV11-1,TRBJ2-3,CASLGRRTDTQYF,0,1,1,1
TRBV12-3/4,TRBJ2-4,CASSLGFLDIQYF,0,1,1,1
TRBV20-1,TRBJ1-5,CSAGAGNQPQHF,0,3,1,3
TRBV5-1,TRBJ1-1,CASSLVDVNTEAFF,0,1,1,1
TRBV19,TRBJ1-4,CASSITGTNEKLFF,0,1,1,1
TRBV19,TRBJ2-6,CASSAQGHSGANVLTF,0,2,1,2
TRBV5-4,TRBJ1-6,CASSPDNRAYNSPLHF,0,1,1,1
TRBV3-1,TRBJ2-1,CASSQRAGTLYNEQFF,0,1,1,1
TRBV7-8,TRBJ2-1,CASRSGGMSSYNEQFF,0,1,1,1
TRBV19,TRBJ2-1,CASSPDRGAFDEQFF,0,1,1,1
TRBV3-1,TRBJ1-1,CASSQRTGPNTEAFF,0,1,1,1
TRBV5-1,TRBJ1-5,CASSLEGGAGQPQHF,0,1,1,1
TRBV5-1,TRBJ1-1,CASSLKGAENTEAFF,0,2,1,2
TRBV12-3/4,TRBJ2-7,CASSLGTYSYEQYF,0,1,1,1
TRBV6-1,TRBJ2-1,CASSEPLAGVLQFF,0,1,1,1
TRBV20-1,TRBJ2-5,CSATTAVNQETQYF,0,2,1,2
TRBV15,TRBJ1-2,CATSRGSGYGYTF,0,1,1,1
TRBV14,TRBJ2-1,CASSRREGNEQFF,0,3,1,3
TRBV29-1,TRBJ2-5,CSLEPGEGETQYF,0,1,1,1
TRBV6-2/3/5/6,TRBJ1-1,CASSEVATEAFF,0,4,1,4
TRBV19,TRBJ2-4,CASSNQGAGPNIQYF,0,1,1,1
TRBV12-3/4,TRBJ2-5,CASSFRTSGSGGTQYF,0,3,1,3
TRBV15,TRBJ1-5,CATSRVWTPGQPQHF,0,2,1,2
TRBV19,TRBJ1-3,CASSQGAGPGNTIYF,0,1,1,1
TRBV19,TRBJ1-5,CASSGGQGTIRPQHF,0,2,1,2
TRBV7-2,TRBJ2-3,CASSLAPGILDTQYF,0,1,1,1
TRBV5-6,TRBJ2-7,CASSRLAGGLYEQYF,0,2,1,2
TRBV16,TRBJ2-4,CASSQSIYRGNIQYF,0,1,1,1
TRBV5-1,TRBJ2-2,CASSSPLSGTGELFF,0,1,1,1
TRBV20-1,TRBJ2-1,CSAGVAGVAYNEQFF,0,2,1,2
TRBV19,TRBJ2-7,CASSTGQGAYEQYF,0,1,1,1
TRBV3-1,TRBJ2-1,CASSFTSGDNEQFF,0,2,1,2
TRBV7-9,TRBJ2-5,CASSPRVDRETQYF,0,1,1,1
TRBV6-2/3/5/6,TRBJ1-5,CASNNDGSNQPQHF,0,4,1,4
TRBV29-1,TRBJ2-7,CSVVFAGISYEQYF,0,1,1,1
TRBV12-5,TRBJ1-5,CASGLNDQPQHF,0,1,1,1
TRBV2,TRBJ2-7,CASSVNSGEQYF,0,1,1,1
TRBV6-2/3/5/6,TRBJ2-7,CASSNPSHEQYF,0,1,1,1
TRBV29-1,TRBJ2-7,CSVMRETYEQYF,0,1,1,1
TRBV3-1,TRBJ1-1,CASSQTAFF,0,2,1,2
TRBV18,TRBJ1-2,CASSPVRDIYGYTF,0,1,1,1
TRBV15,TRBJ2-6,CATSRDTGRGRTGANVLTF,0,1,1,1
TRBV4-2,TRBJ2-7,CASSQGPRWKGSYEQYF,0,2,1,2
TRBV6-2/3/5/6,TRBJ2-7,CASSPKGSSGSKFYEQYF,0,4,1,4
TRBV5-6,TRBJ2-5,CASSARGAPKSGETQYF,0,3,1,3
TRBV28,TRBJ2-3,CASSLGAALSTDTQYF,0,1,1,1
TRBV6-2/3/5/6,TRBJ1-4,CASSHHRMGVNEKLFF,0,1,1,1
TRBV3-1,TRBJ2-7,CASSQEAGRSSYEQYF,0,1,1,1
TRBV20-1,TRBJ1-4,CSARAGQGEKAEKLFF,0,1,1,1
TRBV5-6,TRBJ2-4,CASSNLEGGKNIQYF,0,1,1,1
TRBV7-8,TRBJ1-1,CASSLAQEGRTEAFF,0,4,1,4
TRBV7-9,TRBJ1-5,CASSLGSVPHQPQHF,0,1,1,1
TRBV20-1,TRBJ1-1,CSARSGAGDVTEAFF,0,2,1,2
TRBV15,TRBJ2-1,CATSREGSYNEQFF,0,1,1,1
TRBV19,TRBJ2-7,CASSNRDASYEQYF,0,1,1,1
TRBV2,TRBJ2-1,CARELQGTGNEQFF,0,1,1,1
TRBV4-1,TRBJ2-5,CASSQDPTSETQYF,0,4,1,4
TRBV19,TRBJ1-1,CASSMFQNTEAFF,0,1,1,1
TRBV5-6,TRBJ1-6,CASSSSSNSPLHF,0,3,1,3
TRBV11-3,TRBJ2-3,CASSSTSTDTQYF,0,1,1,1
TRBV20-1,TRBJ2-3,CSARRDSTDTQYF,0,1,1,1
TRBV20-1,TRBJ2-7,CSAQRGISYEQYF,0,1,1,1
TRBV12-3/4,TRBJ2-3,CASTLSTDTQYF,0,1,1,1
TRBV14,TRBJ2-7,CASSQGFYEQYF,0,1,1,1
TRBV12-3/4,TRBJ2-7,CASSSFYEQYF,0,1,1,1
TRBV14,TRBJ2-2,CASSLDRRTGELFF,0,1,1,1
TRBV7-6,TRBJ2-1,CASSSGFGIGSYNEQFF,0,1,1,1
TRBV29-1,TRBJ1-5,CSVVTGSAYSNQPQHF,0,1,1,1
TRBV12-3/4,TRBJ2-1,CASSFLLAGGLQLNEQFF,0,3,1,3
TRBV2,TRBJ2-5,CASSVRGTGEYQETQYF,0,3,1,3
TRBV20-1,TRBJ2-1,CSAPGLAGVLSHNEQFF,0,1,1,1
TRBV6-2/3/5/6,TRBJ2-2,CASSYMTGDDTGELFF,0,1,1,1
TRBV6-2/3/5/6,TRBJ2-1,CASSPLLAEVSDEQFF,0,1,1,1
TRBV19,TRBJ2-6,CASSMRASGANVLTF,0,1,1,1
TRBV5-8,TRBJ2-5,CASSLGTGGAETQYF,0,3,1,3
TRBV3-1,TRBJ2-7,CASSQESRPSYEQYF,0,1,1,1
TRBV5-1,TRBJ1-1,CASSPDRSTNTEAFF,0,1,1,1
TRBV7-3,TRBJ2-1,RASTKVVLDGDEQFF,0,1,1,1
TRBV19,TRBJ2-1,CASSIGAGVDEQFF,0,1,1,1
TRBV12-3/4,TRBJ2-1,CASSSGRGSNEQFF,0,1,1,1
TRBV6-2/3/5/6,TRBJ2-1,CASSYEAMRNEQFF,0,1,1,1
TRBV7-8,TRBJ2-1,CASSLDPWKHEQFF,0,1,1,1
TRBV27,TRBJ2-7,CASSPTSPTYEQYF,0,1,1,1
TRBV3-1,TRBJ2-7,CASSQRDRSYEQYF,0,2,1,2
TRBV3-1,TRBJ1-1,CASSQTGQATEAFF,0,1,1,1
TRBV9,TRBJ2-7,CASSEAMGFGEQYF,0,1,1,1
TRBV2,TRBJ2-5,CASRQNSGLETQYF,0,1,1,1
TRBV20-1,TRBJ2-1,CSASRAGANNEQFF,0,1,1,1
TRBV19,TRBJ2-7,CASSFSYANEQYF,0,1,1,1
TRBV12-3/4,TRBJ1-2,CASSLGQDYGYTF,0,1,1,1
TRBV6-1,TRBJ2-1,CASRQAGVNEQFF,0,1,1,1
TRBV20-1,TRBJ2-5,CSARTGGAETQYF,0,1,1,1
TRBV7-9,TRBJ2-1,CASSFGTSSQFF,0,2,1,2
TRBV11-2,TRBJ2-2,CASSLGFGELFF,0,1,1,1
TRBV5-6,TRBJ2-7,CASSSDPVQQYF,0,1,1,1
TRBV7-2,TRBJ1-4,CASSPGSEKLFF,0,1,1,1
TRBV9,TRBJ2-1,CASSETSDEQFF,0,1,1,1
TRBV5-1,TRBJ1-2,CASSLESYGYTF,0,1,1,1
TRBV18,TRBJ2-7,CASSPKGGTGLNEQYF,0,1,1,1
TRBV3-1,TRBJ2-6,CASSRTPTGANVLTF,0,2,1,2
TRBV5-4,TRBJ1-1,CASSFWQNTEAFF,0,1,1,1
TRBV19,TRBJ2-5,CASSTSSETQYF,0,1,1,1
TRBV20-1,TRBJ2-7,CSARDGTSSYERYF,0,1,1,1
TRBV20-1,TRBJ2-1,CSARDYPPLGTSGRNEQFF,0,1,1,1
TRBV13,TRBJ2-4,CASSHAQPKLAKNIQYF,0,1,1,1
TRBV19,TRBJ2-5,CASSILLAGGQETQYF,0,1,1,1
TRBV2,TRBJ2-2,CASTEPGQSAAGELFF,0,1,1,1
TRBV12-3/4,TRBJ2-3,CASSLWFSPDSDTQYF,0,1,1,1
TRBV6-2/3/5/6,TRBJ1-2,CASSPEGRTQTRGYTF,0,1,1,1
TRBV7-2,TRBJ2-1,CASSFRTGGGYNEQFF,0,1,1,1
TRBV5-4,TRBJ2-2,CASSRGQVIGDGELFF,0,1,1,1
TRBV5-4,TRBJ2-7,CASSRTSASYSYEQYF,0,1,1,1
TRBV20-1,TRBJ2-3,CSATRPGGRGTDTQYF,0,1,1,1
TRBV19,TRBJ1-1,CASRRPAAMNTEAFF,0,1,1,1
TRBV12-3/4,TRBJ1-5,CASSFGSTVNQPQHF,0,1,1,1
TRBV6-1,TRBJ2-1,CASSASGPRGNEQFF,0,1,1,1
TRBV6-1,TRBJ1-1,CASSGQSTGIGEAFF,0,1,1,1
TRBV12-3/4,TRBJ1-4,CASSPRQGTNEKLFF,0,1,1,1
TRBV2,TRBJ2-1,CASRTLAFSYNEQFF,0,1,1,1
TRBV5-1,TRBJ2-1,CASRGDGGLYNEQFF,0,1,1,1
TRBV20-1,TRBJ1-3,CSARVGLSSGNTIYF,0,1,1,1
TRBV20-1,TRBJ2-1,CSAPQGTPSYNEQFF,0,3,1,3
TRBV29-1,TRBJ2-3,CSVEDTGGAEDTQYF,0,2,1,2
TRBV29-1,TRBJ2-7,CSVEGEGRASYEQYF,0,1,1,1
TRBV27,TRBJ2-7,CASSVTGQSYEQYF,0,1,1,1
TRBV12-3/4,TRBJ1-6,CASSLEGPNSPLHF,0,1,1,1
TRBV28,TRBJ1-1,CASSSGTGLYEAFF,0,1,1,1
TRBV12-3/4,TRBJ2-5,CASSHSGREETQYF,0,1,1,1
TRBV7-9,TRBJ2-7,CASSLTSGFYEQYF,0,1,1,1
TRBV27,TRBJ1-5,CASRRTGGNQPQHF,0,1,1,1
TRBV7-2,TRBJ2-2,CASRHRGNTGELFF,0,1,1,1
TRBV4-1,TRBJ1-2,CASRTPGQQYGYTF,0,2,1,2
TRBV5-1,TRBJ2-3,CASSQDRAQDTQYF,0,1,1,1
TRBV5-1,TRBJ2-1,CASSFDRGEDEQFF,0,3,1,3
TRBV20-1,TRBJ2-1,CSASLAGGSNEQFF,0,2,1,2
TRBV20-1,TRBJ2-7,CSARDSIYPYEQYF,0,1,1,1
TRBV20-1,TRBJ1-5,CSARREDGNQPQHF,0,1,1,1
TRBV29-1,TRBJ2-7,CSAGSLQSSYEQYF,0,1,1,1
TRBV2,TRBJ2-7,CAGSGTTRHEQYF,0,2,1,2
TRBV6-2/3/5/6,TRBJ1-5,CASTLGGNQPQHF,0,1,1,1
TRBV6-2/3/5/6,TRBJ2-1,CASSYSIYNEQFF,0,1,1,1
TRBV6-2/3/5/6,TRBJ2-1,CASSYSGGNEQFF,0,1,1,1
TRBV7-9,TRBJ1-1,CASSLEVNTEAFF,0,2,1,2
TRBV3-1,TRBJ1-2,CASSQDPDRSYTF,0,1,1,1
TRBV5-6,TRBJ2-7,CASRGGTTYEQYF,0,1,1,1
TRBV5-1,TRBJ2-1,CASSQGQGDEQFF,0,1,1,1
TRBV4-3,TRBJ1-1,CASSQDGNTEAFF,0,1,1,1
TRBV29-1,TRBJ2-7,CSVEVPSSYEQYF,0,2,1,2
TRBV29-1,TRBJ2-5,CSAGRDTQETQYF,0,1,1,1
TRBV29-1,TRBJ2-1,CSGALAGGNEQFF,0,1,1,1
TRBV15,TRBJ2-7,CATSPNSYEQYF,0,1,1,1
TRBV29-1,TRBJ1-1,CSVSGGDTEAFF,0,1,1,1
TRBV29-1,TRBJ2-7,CSASGVSHEQYF,0,1,1,1
TRBV29-1,TRBJ2-5,CSGGRETQYF,0,1,1,1
TRBV5-5,TRBJ1-5,CASSLDSNQPQHF,0,1,1,1
TRBV12-3/4,TRBJ2-4,CASSLGTSGGLNIQYF,0,3,1,3
TRBV27,TRBJ1-1,CAGRKPGVLWTEAFF,0,1,1,1
TRBV3-1,TRBJ2-1,CASSQSGQGYYNEQFF,0,1,1,1
TRBV28,TRBJ1-3,CASRSSGNTIYF,0,2,1,2
TRBV11-2,TRBJ1-6,CASSFSGDNSPLHF,0,1,1,1
TRBV10-3,TRBJ2-1,CATENRGDRGYNEQFF,0,2,1,2
TRBV2,TRBJ2-2,CAGYQVTGELFF,0,3,1,3
TRBV4-1,TRBJ2-7,CASSQTGFSYEQYY,0,3,1,3
TRBV5-8,TRBJ1-4,CASRRRFNEKLVF,0,1,1,1
TRBV12-3/4,TRBJ2-3,CASSFGGQPSVSTDTQYF,0,1,1,1
TRBV3-1,TRBJ2-7,CASSQVVGSGTRGYEQYF,0,1,1,1
TRBV5-1,TRBJ2-2,CASSLGLAGEVNTGELFF,0,1,1,1
TRBV18,TRBJ1-2,CASSPVPGGSSFYGYTF,0,1,1,1
TRBV27,TRBJ1-5,CASSLSPGGYSNQPQHF,0,1,1,1
TRBV5-4,TRBJ2-1,CASSFGLGTSGPNEQFF,0,1,1,1
TRBV19,TRBJ2-5,CASSISRAPGQETQYF,0,1,1,1
TRBV18,TRBJ2-3,CASSPSDRGYPDTQYF,0,1,1,1
TRBV6-2/3/5/6,TRBJ2-1,CASSLGRRSENNEQFF,0,1,1,1
TRBV7-2,TRBJ2-3,CASSYPRATRTDTQYF,0,2,1,2
TRBV5-1,TRBJ2-1,CASSLERGGDYNEQFF,0,1,1,1
TRBV5-1,TRBJ2-6,CASSFSAVSGANVLTF,0,1,1,1
TRBV5-1,TRBJ1-6,CASSSYRRGYNSPLHF,0,1,1,1
TRBV5-1,TRBJ2-1,CASSPSSGGVYNEQFF,0,1,1,1
TRBV19,TRBJ2-5,CASSATSGDQETQYF,0,1,1,1
TRBV19,TRBJ2-3,CASSTGALSTDTQYF,0,1,1,1
TRBV19,TRBJ1-3,CASRAGGISGNTIYF,0,1,1,1
TRBV18,TRBJ1-6,CASSSQRTDNSPLHF,0,1,1,1
TRBV12-3/4,TRBJ1-1,CASSLGEIPFYEAFF,0,1,1,1
TRBV10-3,TRBJ2-1,CASSESQLTYNEQFF,0,2,1,2
TRBV6-4,TRBJ2-3,CASSKAGTSTDTQYF,0,1,1,1
TRBV12-3/4,TRBJ1-1,CASRLPTGWDTEAFF,0,1,1,1
TRBV20-1,TRBJ2-7,CSARDPDSGYGEQYF,0,1,1,1
TRBV24-1,TRBJ1-5,CATSDFGSNQPQHF,0,1,1,1
TRBV15,TRBJ1-4,CATSRRGDHEKLFF,0,1,1,1
TRBV19,TRBJ2-1,CASGNSGRWNEQFF,0,1,1,1
TRBV12-3/4,TRBJ1-1,CASTLGGAGTEAFF,0,1,1,1
TRBV12-3/4,TRBJ2-1,CASSFLGLAHEQFF,0,1,1,1
TRBV12-3/4,TRBJ2-2,CASSLKPTTGELFF,0,1,1,1
TRBV6-2/3/5/6,TRBJ2-7,CASSYGTSGYEQYF,0,2,1,2
TRBV6-2/3/5/6,TRBJ2-1,CASSPGGLNNEQFF,0,1,1,1
TRBV13,TRBJ2-1,CASSFKGPNGEQFF,0,1,1,1
TRBV14,TRBJ2-7,CASSLGQGSYEQYF,0,1,1,1
TRBV3-1,TRBJ2-7,CASSRDRARYEQYF,0,1,1,1
TRBV3-1,TRBJ1-2,CASSQEGQAYGYTF,0,1,1,1
TRBV14,TRBJ1-1,CASSQESTGLEAFF,0,1,1,1
TRBV9,TRBJ2-7,CASSVVGTPAEQYF,0,1,1,1
TRBV5-4,TRBJ1-2,CASSRTTLNYGYTF,0,1,1,1
TRBV7-2,TRBJ2-7,CASSNRDRVYEQYF,0,1,1,1
TRBV20-1,TRBJ2-7,CSASLLRQGYEQYF,0,1,1,1
TRBV20-1,TRBJ1-2,CSARGVKGRNGYTF,0,1,1,1
TRBV20-1,TRBJ1-1,CSARDLGGRAEAFF,0,1,1,1
TRBV29-1,TRBJ1-1,CSAGTLGQFTEAFF,0,1,1,1
TRBV29-1,TRBJ2-1,CSGLSRAFYNEQFF,0,1,1,1
TRBV11-2,TRBJ2-1,YASSLRHSGDEQFF,0,1,1,1
TRBV12-3/4,TRBJ1-5,CASSFWGNQPQHF,0,1,1,1
TRBV12-3/4,TRBJ2-6,CASSTAGANVLTF,0,1,1,1
TRBV14,TRBJ1-1,CASSQGVGTEAFF,0,1,1,1
TRBV11-3,TRBJ2-2,CASSGQNTGELFF,0,1,1,1
TRBV12-3/4,TRBJ1-1,CASNDRGWTEAFF,0,2,1,2
TRBV5-1,TRBJ1-3,CASSLGLGNTIYF,0,2,1,2
TRBV20-1,TRBJ2-7,CSAIQVTAYEQYF,0,1,1,1
TRBV12-3/4,TRBJ2-1,CASSLRANEQFL,0,1,1,1
TRBV7-2,TRBJ2-1,CASSSYSGSRFF,0,1,1,1
TRBV12-3/4,TRBJ2-5,CASSLLRETQYF,0,1,1,1
TRBV20-1,TRBJ1-5,CSARGMLQPQHF,0,1,1,1
TRBV20-1,TRBJ2-7,CSASAASYEQYF,0,1,1,1
TRBV29-1,TRBJ1-1,CSARTRNTEAFF,0,1,1,1
TRBV29-1,TRBJ2-2,CSAERGTGELFF,0,1,1,1
TRBV7-9,TRBJ2-3,CASSNTDTQYF,0,1,1,1
TRBV5-1,TRBJ2-2,CASSFSGELFF,0,1,1,1
TRBV5-1,TRBJ2-7,CASSRKLISFDRGGPAYEQYF,0,1,1,1
TRBV29-1,TRBJ2-1,CSVDGGWTSGRTLSSYNEQFF,0,1,1,1
TRBV6-2/3/5/6,TRBJ2-1,CASSSRRTSGVLSSYNEQFF,0,1,1,1
TRBV6-2/3/5/6,TRBJ2-1,CASSSPPSSSGSFDNEQFF,0,2,1,2
TRBV7-2,TRBJ2-2,CASSSRGGLAGANTGELFF,0,1,1,1
TRBV2,TRBJ2-3,CASLGRGLAGGRTDTQYF,0,1,1,1
TRBV13,TRBJ2-7,CASSPSRPASGDSYEQYF,0,2,1,2
TRBV6-2/3/5/6,TRBJ2-3,CASSFLVAGGPTDTQYF,0,1,1,1
TRBV12-3/4,TRBJ1-5,CASSSSEGPYSNQPQHF,0,1,1,1
TRBV7-2,TRBJ2-1,CASSSRGSGTLYNEQFF,0,1,1,1
TRBV2,TRBJ2-1,CASSEVTRASAYNEQFF,0,2,1,2
TRBV3-1,TRBJ2-5,CASSQGGLAGSGETQYF,0,1,1,1
TRBV20-1,TRBJ1-3,CSARDPVYRDSGNTIYF,0,1,1,1
TRBV12-5,TRBJ2-2,CASGLARQGINGELFF,0,1,1,1
TRBV19,TRBJ1-2,CASSISNKGQNYGYTF,0,1,1,1
TRBV19,TRBJ2-2,CASSNPYRGRAGELFF,0,1,1,1
TRBV27,TRBJ2-2,CASSLGAGRGSGELFF,0,1,1,1
TRBV6-2/3/5/6,TRBJ2-5,CASSYHGMTTQETQYF,0,1,1,1
TRBV5-1,TRBJ2-3,CASSLAVAGGTDTQYF,0,1,1,1
TRBV20-1,TRBJ1-4,CSASDPGAPVNEKLFF,0,1,1,1
TRBV20-1,TRBJ2-3,CSANPRLAAYTDTQYF,0,1,1,1
TRBV29-1,TRBJ2-1,CSVEDWPLRSYNEQFF,0,2,1,2
TRBV29-1,TRBJ2-2,CSVETPGLLNTGELFF,0,1,1,1
TRBV12-5,TRBJ2-1,CASGHDRSSYNEQFF,0,1,1,1
TRBV2,TRBJ2-2,CAGTPVGTGVRELFF,0,1,1,1
TRBV19,TRBJ1-1,CASIGTGVMNTEAFF,0,1,1,1
TRBV19,TRBJ2-7,CASSMGLGTSYEQYF,0,1,1,1
TRBV19,TRBJ1-1,CASRGEAFMNTEAFF,0,1,1,1
TRBV12-3/4,TRBJ2-1,CASSLGLAVVGEQFF,0,1,1,1
TRBV27,TRBJ1-2,CASSSLRNTRTGYTF,0,1,1,1
TRBV6-2/3/5/6,TRBJ2-7,CASSYSDRFAYEQYF,0,1,1,1
TRBV7-8,TRBJ2-2,CASSLASRGTGELFF,0,1,1,1
TRBV14,TRBJ2-5,CASSSLRGTQETQYF,0,1,1,1
TRBV3-1,TRBJ2-3,CASSQRRGQTDTQYF,0,1,1,1
TRBV3-1,TRBJ2-7,CASSQDLTGLYEQYF,0,1,1,1
TRBV14,TRBJ2-4,CASSQDRFLGDIQYF,0,1,1,1
TRBV11-1,TRBJ2-1,CASSADSIGATEQFF,0,1,1,1
TRBV7-9,TRBJ2-7,CASSDSGSHDYEQYF,0,1,1,1
TRBV2,TRBJ1-1,CARESTGGIGTEAFF,0,2,1,2
TRBV29-1,TRBJ2-6,CSVEPGGPGANVLTF,0,2,1,2
TRBV12-5,TRBJ2-7,CASTGTETSYEQYF,0,1,1,1
TRBV24-1,TRBJ2-1,CATSDSTWGDEQFF,0,1,1,1
TRBV19,TRBJ1-5,CASSIRDSNQPQHF,0,1,1,1
TRBV19,TRBJ1-5,CASSRGDPRSPQHF,0,1,1,1
TRBV7-2,TRBJ2-2,CASRPIPGPGELFF,0,1,1,1
TRBV12-3/4,TRBJ2-1,CASSFGTAYNEQFF,0,1,1,1
TRBV6-4,TRBJ2-3,CASSPGTPLDTQYF,0,1,1,1
TRBV2,TRBJ1-1,CASSQRRGGEAAFF,0,1,1,1
TRBV25-1,TRBJ1-1,CASSESRGNSEAFF,0,1,1,1
TRBV6-1,TRBJ2-5,CASSEDRDRETQYF,0,1,1,1
TRBV2,TRBJ1-2,CASSTYQTGGGYTF,0,1,1,1
TRBV5-4,TRBJ1-1,CASSFAPLDTEAFF,0,1,1,1
TRBV5-6,TRBJ1-5,CASSLRAGDQPQHF,0,1,1,1
TRBV7-2,TRBJ1-5,CASSLRHGNQPQHF,0,1,1,1
TRBV7-6,TRBJ2-7,CASSSQRDLYEQYF,0,1,1,1
TRBV13,TRBJ2-3,CASSSLPPTDTQYF,0,2,1,2
TRBV5-4,TRBJ1-4,CASSHGPPEEKLFF,0,1,1,1
TRBV5-5,TRBJ2-2,CASSDPSYTGELFF,0,1,1,1
TRBV5-1,TRBJ2-3,CASSFGQGTDTQYF,0,1,1,1
TRBV20-1,TRBJ1-5,CSASDRGSNQPQHF,0,1,1,1
TRBV29-1,TRBJ2-1,CSVVGTDSYNEQFF,0,1,1,1
TRBV29-1,TRBJ1-2,CSVDPQDRNYGYTF,0,1,1,1
TRBV29-1,TRBJ1-1,CSVEEGPTNTEAFF,0,1,1,1
TRBV30,TRBJ1-1,CAWSVAGNTEAFF,0,1,1,1
TRBV15,TRBJ2-7,CATSRAEGNEQYF,0,1,1,1
TRBV2,TRBJ1-1,CASLGQGNTGAFF,0,1,1,1
TRBV19,TRBJ2-2,CASSPRNTGELFF,0,1,1,1
TRBV12-3/4,TRBJ1-6,CASSRTGASPLHF,0,2,1,2
TRBV12-3/4,TRBJ1-1,CASSVQGGSEAFF,0,1,1,1
TRBV2,TRBJ1-1,CASSGRERAEAFF,0,2,1,2
TRBV7-8,TRBJ1-2,CASSLGPDYGYTF,0,1,1,1
TRBV5-5,TRBJ2-5,CASSYGNKETQYF,0,1,1,1
TRBV14,TRBJ1-1,CASSQHLNTEAFF,0,2,1,2
TRBV20-1,TRBJ1-3,CSVGTGVGNTIYF,0,1,1,1
TRBV13,TRBJ2-7,CASGRGSYEQYF,0,1,1,1
TRBV27,TRBJ1-1,CASSLTGTEAFF,0,1,1,1
TRBV12-3/4,TRBJ2-7,CASSSTQEEQYF,0,1,1,1
TRBV13,TRBJ2-7,CASSLGRYEQYF,0,1,1,1
TRBV7-9,TRBJ1-1,CASSWVITEAFF,0,1,1,1
TRBV3-1,TRBJ2-7,CASSRSRYEQYF,0,1,1,1
TRBV12-3/4,TRBJ2-3,CASRVSTDTQYF,0,1,1,1
TRBV30,TRBJ2-7,CAWSGIYEQYF,0,1,1,1
TRBV7-2,TRBJ2-5,CASSLRETQYF,0,1,1,1
TRBV3-1,TRBJ2-5,CASSQRETQYL,0,1,1,1
TRBV5-1,TRBJ2-1,CASSLGGEQFF,0,2,1,2
TRBV5-1,TRBJ2-3,CASSSRDTQYF,0,1,1,1
TRBV29-1,TRBJ1-3,CSARWDVAIYF,0,1,1,1
TRBV29-1,TRBJ2-5,CSTVLETQYF,0,1,1,1
TRBV5-4,TRBJ2-2,CASSSLSGALFF,0,1,1,1
TRBV3-1,TRBJ2-2,CASSPQGVGELFF,0,1,1,1
TRBV10-3,TRBJ1-1,CAISGNVGQMNTEAFF,0,1,1,1
TRBV12-3/4,TRBJ2-7,CASSLVVGGISYEQYF,0,2,1,2
TRBV5-1,TRBJ2-5,CASSGLAGNQGETQYF,0,1,1,1
TRBV3-1,TRBJ1-6,CAIHSGDGRSPLHF,0,1,1,1
TRBV25-1,TRBJ2-1,CASSENSGGRYNEQFF,0,1,1,1
TRBV6-2/3/5/6,TRBJ2-1,CASRLGQGGNHEQFF,0,1,1,1
TRBV6-2/3/5/6,TRBJ2-2,CASSYSSLGLAGEITGELFF,0,1,1,1
TRBV2,TRBJ2-1,CASSALTRTSGGPRNEQFF,0,2,1,2
TRBV6-2/3/5/6,TRBJ2-5,CASSSRLAGAGSRETQYF,0,2,1,2
TRBV6-2/3/5/6,TRBJ1-2,CASSYGRLGDRGRYGYTF,0,1,1,1
TRBV12-3/4,TRBJ2-1,CASSRAPRGASSYNEQFF,0,1,1,1
TRBV7-6,TRBJ2-1,CASSSLRTSGGSYNEQFF,0,1,1,1
TRBV14,TRBJ2-3,CASSQATSGRPHTDTQYF,0,1,1,1
TRBV5-4,TRBJ1-5,CASSVRERQGRSNQPQHF,0,1,1,1
TRBV5-6,TRBJ1-2,CASRNLLGHTRENYGYTF,0,2,1,2
TRBV10-2,TRBJ1-5,CASSESLSIVSSNQPQHF,0,1,1,1
TRBV29-1,TRBJ2-3,CSVEDGWTSGRAPDTQYF,0,1,1,1
TRBV29-1,TRBJ2-3,CSVESPYLAGSMVDTQYF,0,1,1,1
TRBV19,TRBJ2-1,CASSKSPGLAGTTKEFF,0,1,1,1
TRBV12-3/4,TRBJ2-3,CASTKWGLAGSTDTQYF,0,1,1,1
TRBV12-3/4,TRBJ1-4,CASSLGADYRANEKLFF,0,1,1,1
TRBV6-2/3/5/6,TRBJ2-7,CASSYLNVPGLADEQYF,0,1,1,1
TRBV7-2,TRBJ2-3,CASSLGGGGARADTQYF,0,1,1,1
TRBV7-9,TRBJ2-1,CASSSTKTAAKNNEQFF,0,1,1,1
TRBV6-2/3/5/6,TRBJ2-1,CASSPPGLGSSYNEQFF,0,1,1,1
TRBV14,TRBJ1-2,CASSRLDRATGGEGYTF,0,1,1,1
TRBV4-2,TRBJ2-5,CASSQGVGGSFAETQYF,0,1,1,1
TRBV5-1,TRBJ2-7,CASSPGLAGGLSYEQYF,0,2,1,2
TRBV4-1,TRBJ2-3,CASSQDWLAGATDTQYF,0,1,1,1
TRBV20-1,TRBJ2-1,CSARDFLAPSSYNEQFF,0,1,1,1
TRBV28,TRBJ2-1,CATLTAGTSYANEQFF,0,1,1,1
TRBV12-3/4,TRBJ2-1,CASTQAGGSSYNEQFF,0,1,1,1
TRBV12-3/4,TRBJ2-3,CASTPPGRRETDTQYF,0,1,1,1
TRBV12-3/4,TRBJ1-3,CASSLPGGSSGNTIYF,0,1,1,1
TRBV25-1,TRBJ2-2,CASSEWGLADTGELFF,0,1,1,1
TRBV6-1,TRBJ1-5,CASSEARLGNSQPQHF,0,1,1,1
TRBV6-1,TRBJ2-5,CASSESQGAGAETQYF,0,1,1,1
TRBV13,TRBJ2-5,CASSLTSGGSGETQYF,0,1,1,1
TRBV7-2,TRBJ2-3,CASSSRQGYYTDTQYF,0,1,1,1
TRBV7-9,TRBJ1-5,CASSPLDVVSNQPQHF,0,1,1,1
TRBV7-6,TRBJ2-3,CASSRQREGLRDTQYF,0,1,1,1
TRBV5-1,TRBJ1-3,CASSLDQGGSGNTIYF,0,1,1,1
TRBV20-1,TRBJ2-3,CSASPPGLGGTDTQYF,0,1,1,1
TRBV20-1,TRBJ2-3,CSASWGTGGSTDTQYF,0,1,1,1
TRBV10-3,TRBJ1-5,CAISTGGDSNQPQHF,0,1,1,1
TRBV19,TRBJ2-3,CASSIEDRSTDTQYF,0,1,1,1
TRBV19,TRBJ2-1,CASSRRGPPYNEQFF,0,1,1,1
TRBV19,TRBJ1-1,CASNIRAGVGTEAFF,0,2,1,2
TRBV2,TRBJ1-5,CASCALGASNQPQHF,0,1,1,1
TRBV6-2/3/5/6,TRBJ1-5,CASTLNPKSNQPQHF,0,1,1,1
TRBV7-6,TRBJ2-3,CASTSIGGATDTQYF,0,1,1,1
TRBV6-2/3/5/6,TRBJ2-1,CASSLTSGRKNEQFF,0,1,1,1
TRBV6-2/3/5/6,TRBJ1-2,CASSYSGGFNYGYTF,0,1,1,1
TRBV12-3/4,TRBJ1-5,CASSPRGIGYQPQHF,0,1,1,1
TRBV6-1,TRBJ2-3,CASSANFQGPQTQYF,0,1,1,1
TRBV6-4,TRBJ1-4,CASSDTTDRGEKLFF,0,2,1,2
TRBV2,TRBJ1-1,CASSEASGLNTEAFF,0,1,1,1
TRBV5-6,TRBJ2-1,CASSFWPGGWNEQFF,0,1,1,1
TRBV5-4,TRBJ1-4,CASSLAGTANEKLFF,0,1,1,1
TRBV7-3,TRBJ1-3,CASSLFWSSGNTIYF,0,1,1,1
TRBV7-2,TRBJ2-1,CASSLLAGRHNEQFF,0,1,1,1
TRBV7-9,TRBJ1-1,CASSLAQVMNTEAFF,0,1,1,1
TRBV7-3,TRBJ2-5,CASSLTTGRGETQYF,0,1,1,1
TRBV14,TRBJ1-1,CASSQDGSPYTEAFF,0,1,1,1
TRBV3-1,TRBJ2-3,CASSQENRRTDTQYF,0,1,1,1
TRBV9,TRBJ2-1,CASSVEGVSYNEQFF,0,1,1,1
TRBV12-3/4,TRBJ1-2,CASRPPGQGWYGYTF,0,1,1,1
TRBV12-3/4,TRBJ2-1,CASRPSGGRYNEQFF,0,1,1,1
TRBV28,TRBJ1-6,CASRNADRGYSPLHF,0,2,1,2
TRBV5-1,TRBJ2-3,CASSSGQIRTDTQYF,0,1,1,1
TRBV5-1,TRBJ2-3,CASSPRTGLEDTQYF,0,1,1,1
TRBV4-1,TRBJ1-1,CASSQDFPGFTEAFF,0,2,1,2
TRBV5-1,TRBJ2-7,CASSMGTSGSYEQYF,0,1,1,1
TRBV20-1,TRBJ2-7,CSAREGGRSSYEQYF,0,1,1,1
TRBV20-1,TRBJ2-3,CSAPVRASSTDTQYF,0,3,1,3
TRBV10-3,TRBJ2-1,CAISESRVRDEQFF,0,1,1,1
TRBV19,TRBJ1-2,CASTDGRGNYGYTF,0,1,1,1
TRBV19,TRBJ2-2,CASRQGAVGGELFF,0,1,1,1
TRBV18,TRBJ1-2,CASSSGQGDLGYTF,0,1,1,1
TRBV3-1,TRBJ2-2,CASGQAPGIGELFF,0,1,1,1
TRBV12-3/4,TRBJ2-3,CASSLHRGTDTQYF,0,1,1,1
TRBV3-1,TRBJ1-5,CASSPWGDDQPQHF,0,1,1,1
TRBV6-1,TRBJ2-7,CASSEIRASYEQYF,0,1,1,1
TRBV7-6,TRBJ2-7,CASSLVYRSYEQYF,0,1,1,1
TRBV11-2,TRBJ1-1,CASSLIFGGTEAFF,0,1,1,1
TRBV7-6,TRBJ2-7,CASSPRRENYEQYF,0,1,1,1
TRBV14,TRBJ2-7,CASSPGTPGYEQYF,0,1,1,1
TRBV3-1,TRBJ1-1,CASSRSPGATEAFF,0,1,1,1
TRBV3-1,TRBJ2-2,CASSQRGRTGELFF,0,1,1,1
TRBV4-2,TRBJ1-2,CASSQEVVFYGYTF,0,1,1,1
TRBV4-2,TRBJ2-5,CASSQKTGRETQYF,0,1,1,1
TRBV5-6,TRBJ2-7,CASRPTSGRNEQYF,0,1,1,1
TRBV3-1,TRBJ2-7,CASRGPLAGYEQYF,0,1,1,1
TRBV5-5,TRBJ1-1,CASRLWGGETEAFF,0,2,1,2
TRBV5-4,TRBJ1-2,CASRPGQQNYGYTF,0,1,1,1
TRBV5-1,TRBJ2-7,CASSLATSGNEQYF,0,1,1,1
TRBV5-1,TRBJ2-7,CASSLAGNPYEQYF,0,1,1,1
TRBV4-3,TRBJ1-1,CASSQGTDFTEAFF,0,1,1,1
TRBV5-1,TRBJ2-3,CASSVYRGTDTQYF,0,1,1,1
TRBV20-1,TRBJ2-1,CSANTRRSYNEQFF,0,1,1,1
TRBV20-1,TRBJ2-2,CSARSPRGTGELFF,0,1,1,1
TRBV29-1,TRBJ2-5,CSVAASGPRETQYF,0,1,1,1
TRBV29-1,TRBJ2-3,CSVENDQGTDTQYF,0,1,1,1
TRBV29-1,TRBJ1-1,CSVQLTGMNTEAFF,0,1,1,1
TRBV19,TRBJ2-1,CATAATTYNEQFF,0,1,1,1
TRBV19,TRBJ1-1,CASSGQANTEAFF,0,1,1,1
TRBV12-3/4,TRBJ2-7,CASQDGYSYEQYF,0,1,1,1
TRBV12-3/4,TRBJ2-5,CASGSRDQETQYF,0,1,1,1
TRBV7-9,TRBJ1-2,CASDPTAHYGYTF,0,1,1,1
TRBV27,TRBJ2-5,CASSSDSPGTQYF,0,1,1,1
TRBV12-3/4,TRBJ1-5,CASSPRTERPQHF,0,1,1,1
TRBV2,TRBJ2-7,CASSVRASYEQYF,0,1,1,1
TRBV6-4,TRBJ2-3,CASSDSSTDTQYF,0,2,1,2
TRBV5-4,TRBJ2-7,CASSLSSSYEQYF,0,1,1,1
TRBV13,TRBJ2-5,CASSLAVTETQYF,0,1,1,1
TRBV7-2,TRBJ1-2,CASSLTYTGGYTF,0,1,1,1
TRBV7-9,TRBJ2-3,CASSPRGPDTQYF,0,1,1,1
TRBV12-3/4,TRBJ1-2,CASSPQGSRGYTF,0,1,1,1
TRBV7-9,TRBJ1-5,CASSPSRNQPQHF,0,1,1,1
TRBV9,TRBJ1-2,CASSRQEHYGYTF,0,1,1,1
TRBV2,TRBJ1-1,CASSAKMNTEAFF,0,1,1,1
TRBV12-3/4,TRBJ1-2,CASRGTGLGGYTF,0,1,1,1
TRBV7-6,TRBJ2-5,CASRTRGQETQYF,0,2,1,2
TRBV5-1,TRBJ1-3,CASSGQTGNTIYF,0,1,1,1
TRBV5-1,TRBJ2-1,CASSLGNYNEQFF,0,1,1,1
TRBV20-1,TRBJ1-1,CSASRRRNTEAFF,0,1,1,1
TRBV20-1,TRBJ1-5,CSGREGGNQPQHF,0,1,1,1
TRBV29-1,TRBJ2-7,CSASGLAASEQYF,0,1,1,1
TRBV10-3,TRBJ1-2,CAIPDSNYGYTF,0,1,1,1
TRBV24-1,TRBJ2-2,CATSSATGELFF,0,1,1,1
TRBV18,TRBJ1-5,CASSPGNQPQHF,0,1,1,1
TRBV2,TRBJ1-2,CASGDRPYGYTF,0,1,1,1
TRBV13,TRBJ1-1,CASSFPGGEAFF,0,2,1,2
TRBV4-2,TRBJ2-1,CASSPDGTEQFF,0,1,1,1
TRBV6-2/3/5/6,TRBJ2-1,CASRGEFNEQFF,0,1,1,1
TRBV20-1,TRBJ2-5,CSASFSRGTQYF,0,1,1,1
TRBV29-1,TRBJ1-2,CSVEFRGRGYTF,0,1,1,1
TRBV29-1,TRBJ1-1,CSAEPQAAEAFF,0,1,1,1
TRBV12-3/4,TRBJ1-2,CASSLGAGYTF,0,1,1,1
TRBV5-6,TRBJ2-7,CASSLFREQYF,0,1,1,1
TRBV3-1,TRBJ1-1,CASSQDFRAFF,0,1,1,1
TRBV4-1,TRBJ2-1,CASSQAGEQFF,0,1,1,1
TRBV29-1,TRBJ1-4,CTIGAAEKLFF,0,1,1,1
TRBV20-1,TRBJ2-3,CSGLAVDTQYF,0,1,1,1
TRBV13,TRBJ2-1,CASSLGLAPNNEQFF,0,2,1,2
TRBV7-9,TRBJ2-6,CASSLEGRRSGANVLTF,0,2,1,2
TRBV18,TRBJ2-5,CASSPPSARRETQYF,0,1,1,1
TRBV3-1,TRBJ2-3,CASSQSGGAPTQYF,0,1,1,1
TRBV5-1,TRBJ1-4,CASSLGEKLFF,0,2,1,2
TRBV4-2,TRBJ2-3,CASSQEAGASTDTQYF,0,1,1,1
TRBV11-1,TRBJ2-7,CASSQRGSSYEQYF,0,1,1,1
TRBV19,TRBJ2-2,CASGISTGGTGELFF,0,1,1,1
TRBV5-6,TRBJ2-1,CASSLVSQGSNEQFF,0,1,1,1
TRBV4-1,TRBJ1-1,CASTQGFSVATEAFF,0,2,1,2
TRBV3-1,TRBJ2-5,CASSQSRGETQYF,0,1,1,1
TRBV7-9,TRBJ1-3,CASSNPDTIYF,0,1,1,1
TRBV19,TRBJ2-3,CASRRRAALRASGRTDTQYF,0,1,1,1
TRBV19,TRBJ2-1,CASSIARLAGGPSYNEQFF,0,1,1,1
TRBV12-3/4,TRBJ2-1,CASSSPLASGWGLINEQFF,0,1,1,1
TRBV20-1,TRBJ2-1,CSARDLRSGSETRYNEQFF,0,1,1,1
TRBV12-5,TRBJ1-3,CASGLVLGQGLFGNTIYF,0,1,1,1
TRBV19,TRBJ2-1,CASRGWMAGRSSYNEQFF,0,1,1,1
TRBV28,TRBJ2-6,CASSEQGAASSGANVLTF,0,1,1,1
TRBV12-3/4,TRBJ2-3,CASSSRRGLAGGSDTQYF,0,1,1,1
TRBV7-6,TRBJ1-3,CASSPTGGSGASGNTIYF,0,1,1,1
TRBV20-1,TRBJ1-5,CSALAGTGGENGNQPQHF,0,1,1,1
TRBV12-5,TRBJ2-7,CASGLPRSIRTTYEQYF,0,1,1,1
TRBV10-3,TRBJ2-7,CAIRNPPDRWDDYEQYF,0,1,1,1
TRBV3-1,TRBJ1-1,CASGRTGRFGGVSEAFF,0,1,1,1
TRBV19,TRBJ2-1,CASSSAAGTGVDNEQFF,0,1,1,1
TRBV12-3/4,TRBJ2-7,CASSFSWDAGPPTEQYF,0,2,1,2
TRBV12-3/4,TRBJ1-1,CASSSLGAGGFSTEAFF,0,1,1,1
TRBV6-2/3/5/6,TRBJ1-2,CASSYPSVWTPNYGYTF,0,1,1,1
TRBV12-3/4,TRBJ2-1,CASSGPSQREPPHEQFF,0,1,1,1
TRBV7-2,TRBJ1-1,CASSLVSDRGRTLGAFF,0,1,1,1
TRBV3-1,TRBJ2-5,CASSLSREGKNQETQYF,0,2,1,2
TRBV7-9,TRBJ2-3,CASSILTGGYSTDTQYF,0,1,1,1
TRBV20-1,TRBJ1-1,CSARGLLDSRMNTEAFF,0,1,1,1
TRBV12-5,TRBJ2-3,CASGPWTSGDTDTQYF,0,1,1,1
TRBV18,TRBJ1-1,CASSPLPGQGPPEAFF,0,1,1,1
TRBV18,TRBJ2-4,CASSPGTGVSKNIQYF,0,1,1,1
TRBV12-3/4,TRBJ2-1,CASSLFRGGSYNEQFF,0,1,1,1
TRBV12-3/4,TRBJ2-7,CASSLSRDRETYEQYF,0,1,1,1
TRBV12-3/4,TRBJ2-4,CASSLARQGAKNIQYF,0,1,1,1
TRBV12-3/4,TRBJ1-1,CASSLGTGGGNTEAFF,0,1,1,1
TRBV6-2/3/5/6,TRBJ2-5,CASSYYRGPTGETQYF,0,1,1,1
TRBV6-2/3/5/6,TRBJ1-2,CASSYFRQGTLRGYTF,0,2,1,2
TRBV6-2/3/5/6,TRBJ1-1,CASSYSSFQGGSEAFF,0,1,1,1
TRBV2,TRBJ2-2,CASSEGGAPEDGELFF,0,2,1,2
TRBV2,TRBJ2-1,CASSENDRVSYNEQFF,0,1,1,1
TRBV12-3/4,TRBJ2-1,CASSTRGLAGVNEQFF,0,1,1,1
TRBV2,TRBJ1-6,CASSNRGLSYNSPLHF,0,1,1,1
TRBV5-6,TRBJ2-7,CASSLDSASGTYEQYF,0,1,1,1
TRBV7-9,TRBJ1-4,CASSSTPNPLNEKLFF,0,1,1,1
TRBV7-3,TRBJ2-1,CASSLNSGNSYNEQFF,0,1,1,1
TRBV6-2/3/5/6,TRBJ1-5,CASSLLGTEPLEPQHF,0,1,1,1
TRBV5-4,TRBJ2-1,CASSPGGTSGYNEQFF,0,1,1,1
TRBV12-3/4,TRBJ2-5,CASSHKSSGAGETQYF,0,1,1,1
TRBV4-2,TRBJ2-1,CASSQSVRGGPDEQFF,0,2,1,2
TRBV14,TRBJ2-1,CASSQVGTTSYNEQFF,0,1,1,1
TRBV7-9,TRBJ2-7,CASSGSRDRQTYEQYF,0,2,1,2
TRBV7-3,TRBJ2-1,CASSTLELAGRDEQFF,0,1,1,1
TRBV12-3/4,TRBJ1-5,CASRAGFLYSNQPQHF,0,1,1,1
TRBV28,TRBJ2-1,CASRISLAGGINEQFF,0,1,1,1
TRBV5-1,TRBJ2-2,CASTWTDPFNTGELFF,0,1,1,1
TRBV5-1,TRBJ2-7,CASSLSGSLSIYEQYF,0,1,1,1
TRBV20-1,TRBJ2-2,CSALGTSGSYTGELFF,0,1,1,1
TRBV20-1,TRBJ2-3,CSGGLAGVAGTDTQYF,0,2,1,2
TRBV29-1,TRBJ1-1,CSVPLTGGEWNTEAFF,0,1,1,1
TRBV29-1,TRBJ2-7,CSVDGLVGGSIYEQYF,0,1,1,1
TRBV29-1,TRBJ1-2,CSVETRTGKANYGYTF,0,1,1,1
TRBV7-4,TRBJ2-3,RASSFRQGASGDTQYF,0,1,1,1
TRBV27,TRBJ1-1,CAISSGTGGWTEAFF,0,1,1,1
TRBV15,TRBJ2-5,CATSRGPGTQETQYF,0,1,1,1
TRBV19,TRBJ2-7,CASSQLPAGDYEQYF,0,1,1,1
TRBV19,TRBJ2-3,CASSISAESTDTQYF,0,1,1,1
TRBV18,TRBJ2-7,CASSPPGQSGNEQYF,0,1,1,1
TRBV18,TRBJ2-7,CASSQRPSGSYEQYF,0,1,1,1
TRBV5-4,TRBJ1-6,CASTLQGAYNSPLHF,0,1,1,1
TRBV2,TRBJ2-7,CASTPEGAGGYEQYF,0,1,1,1
TRBV2,TRBJ2-5,CASTGQPLRQETQYF,0,1,1,1
TRBV12-3/4,TRBJ2-1,CASSLLAGGGNEQFF,0,2,1,2
TRBV6-2/3/5/6,TRBJ2-3,CASSSTGESTDTQYF,0,1,1,1
TRBV7-2,TRBJ2-7,CASSWDAGGTYEQYF,0,1,1,1
TRBV6-2/3/5/6,TRBJ2-5,CASSYSGAYQETQYF,0,1,1,1
TRBV6-2/3/5/6,TRBJ2-3,CASSYSIQVTDTQYF,0,1,1,1
TRBV7-2,TRBJ1-6,CASSPTGVHGSPLHF,0,1,1,1
TRBV11-1,TRBJ2-6,CASSFRGLGANVLTF,0,1,1,1
TRBV7-2,TRBJ1-2,CASSFATTGSYGYTF,0,1,1,1
TRBV5-4,TRBJ1-1,CASSLVSNMNTEAFF,0,1,1,1
TRBV5-6,TRBJ1-2,CASSLGRQANYGYTF,0,1,1,1
TRBV5-4,TRBJ2-3,CASSLDGGSTDTQYF,0,1,1,1
TRBV7-2,TRBJ1-2,CASSLQGQNNYGYTF,0,1,1,1
TRBV7-9,TRBJ1-1,CASSLVGGRDTEAFF,0,1,1,1
TRBV7-3,TRBJ2-5,CASSLGGLDQETQYF,0,1,1,1
TRBV7-2,TRBJ1-1,CASSLEAGRNTEAFF,0,1,1,1
TRBV7-2,TRBJ1-2,CASSSTWPFGGGYTF,0,1,1,1
TRBV13,TRBJ1-1,CASSSSDRANTEAFF,0,1,1,1
TRBV7-9,TRBJ2-1,CASSSRQGVYNEQFF,0,1,1,1
TRBV7-9,TRBJ1-1,CASSSPPRGRTEAFF,0,1,1,1
TRBV7-2,TRBJ2-1,CASSLSGGGGHEQFF,0,1,1,1
TRBV14,TRBJ2-7,CASSPGVAGTPGQYF,0,1,1,1
TRBV7-9,TRBJ1-5,CASSPGTGINQPQHF,0,1,1,1
TRBV7-6,TRBJ2-7,CASSPTVTGSDEQYF,0,1,1,1
TRBV3-1,TRBJ2-3,CASSHGGGRADTQYF,0,1,1,1
TRBV7-2,TRBJ1-2,CASSHRDSPNYGYTF,0,3,1,3
TRBV6-4,TRBJ2-3,CASSHRLENTDTQYF,0,1,1,1
TRBV3-1,TRBJ2-7,CASSQDLTSFYEQYF,0,1,1,1
TRBV14,TRBJ2-5,CASSQDRRIRETQYF,0,1,1,1
TRBV7-2,TRBJ2-7,CASSVHGRGVDEQYF,0,1,1,1
TRBV9,TRBJ1-5,CASSVGRGGNQPQHF,0,1,1,1
TRBV7-9,TRBJ2-2,CASSTDRMNTGELFF,0,1,1,1
TRBV12-3/4,TRBJ2-3,CASRAGTGVPDTQYF,0,2,1,2
TRBV12-3/4,TRBJ2-1,CASRGTSGRFDEQFF,0,1,1,1
TRBV2,TRBJ2-1,CASRGQSKNYNEQFF,0,1,1,1
TRBV5-1,TRBJ1-6,CASGPLEGYNSPLHF,0,1,1,1
TRBV5-1,TRBJ2-1,CASSFRDSRENEQFF,0,1,1,1
TRBV5-1,TRBJ1-5,CASSLRGSSNQPQHF,0,1,1,1
TRBV5-1,TRBJ2-1,CASSLNPPLDNEQFF,0,1,1,1
TRBV4-3,TRBJ2-5,CASSLTVAGGETQYF,0,1,1,1
TRBV4-1,TRBJ2-7,CASSQIAGTAYEQYF,0,1,1,1
TRBV4-1,TRBJ2-1,CASSQTEGYWDEQFF,0,1,1,1
TRBV20-1,TRBJ2-1,CSASGRGASYNEQFF,0,1,1,1
TRBV19,TRBJ2-2,RASRPPRVDTGELFF,0,1,1,1
TRBV2,TRBJ2-5,CAGGLAGHQETQYF,0,1,1,1
TRBV24-1,TRBJ2-1,CATSERGTYNEQFF,0,1,1,1
TRBV6-4,TRBJ2-1,CASSGTVSYNEQFF,0,1,1,1
TRBV18,TRBJ1-1,CASSLIGRNTEAFF,0,1,1,1
TRBV18,TRBJ2-5,CASSPKQEGVTQYF,0,1,1,1
TRBV6-2/3/5/6,TRBJ2-7,CASDWQPSPYEQYF,0,1,1,1
TRBV5-5,TRBJ1-1,CASDQRDSWTEAFF,0,1,1,1
TRBV25-1,TRBJ2-1,CASTRSGAYNEQFF,0,1,1,1
TRBV12-3/4,TRBJ2-1,CASSFSRSYNEQFF,0,1,1,1
TRBV2,TRBJ2-7,CASSSTSGGYEQYF,0,1,1,1
TRBV6-2/3/5/6,TRBJ2-1,CASSYLLNGGGEFF,0,1,1,1
TRBV6-2/3/5/6,TRBJ2-4,CASSPRTAQNIQYF,0,1,1,1
TRBV12-3/4,TRBJ2-7,CASSPRDTAYEQYF,0,1,1,1
TRBV6-1,TRBJ1-2,CASSAMTANYGYTF,0,1,1,1
TRBV5-6,TRBJ2-7,CASSLASVSYEQYF,0,1,1,1
TRBV7-9,TRBJ1-1,CASSLGGAYTEAFF,0,1,1,1
TRBV7-2,TRBJ1-2,CASSLGGRIRGYTF,0,1,1,1
TRBV7-3,TRBJ2-1,CASSLGTSPHEQFF,0,2,1,2
TRBV11-3,TRBJ2-3,CASSLTRFSDTQYF,0,1,1,1
TRBV7-9,TRBJ2-2,CASSLNRHTGELFF,0,1,1,1
TRBV7-2,TRBJ2-7,CASSSRTSGVEQYF,0,1,1,1
TRBV5-6,TRBJ2-1,CASSWGQGYNEQFF,0,1,1,1
TRBV6-4,TRBJ2-5,CASSLGPVVETQYF,0,2,1,2
TRBV12-3/4,TRBJ1-1,CASSPGRPNTEAFF,0,2,1,2
TRBV5-6,TRBJ2-7,CASSPQGQGYEQYF,0,1,1,1
TRBV12-3/4,TRBJ1-5,CASSPTGDNQPQHF,0,1,1,1
TRBV3-1,TRBJ2-7,CASSQDYLAYEQYF,0,1,1,1
TRBV5-4,TRBJ2-1,CASSQRDLYNEQFF,0,1,1,1
TRBV9,TRBJ1-4,CASSETGDQEKLFF,0,1,1,1
TRBV6-4,TRBJ1-1,CASRPGPGWTEAFF,0,1,1,1
TRBV6-2/3/5/6,TRBJ2-7,CASRGTSGSLQQYS,0,1,1,1
TRBV5-1,TRBJ2-3,CASSTSGHTDTQYF,0,1,1,1
TRBV5-1,TRBJ1-1,CASSLAVLNTEAFF,0,1,1,1
TRBV5-1,TRBJ1-1,CASSLTELNTEAFF,0,1,1,1
TRBV5-1,TRBJ1-1,CASSPGGSVTEAFF,0,1,1,1
TRBV20-1,TRBJ2-7,CSARGDRGFYEQYF,0,1,1,1
TRBV20-1,TRBJ2-5,CSARDVRESETQYF,0,1,1,1
TRBV20-1,TRBJ1-4,CSAAGQPGDEKLFF,0,1,1,1
TRBV29-1,TRBJ2-2,CSVVGGENTGELFF,0,1,1,1
TRBV29-1,TRBJ2-1,CSVVQGESYNEQFF,0,1,1,1
TRBV29-1,TRBJ2-3,CSVGQGAPMDTQYF,0,1,1,1
TRBV29-1,TRBJ1-1,CSVETGARYTEAFF,0,1,1,1
TRBV29-1,TRBJ2-7,CSVILEGATYEQYF,0,1,1,1
TRBV29-1,TRBJ2-1,CSVRQGTLYNEQFF,0,2,1,2
TRBV29-1,TRBJ2-5,CSVPTGGMGETQYF,0,1,1,1
TRBV29-1,TRBJ2-7,CSVTTGGDYYEQYF,0,2,1,2
TRBV30,TRBJ1-5,CAWTTGSNQPQHF,0,1,1,1
TRBV10-3,TRBJ2-5,CAISESVGGERYF,0,1,1,1
TRBV19,TRBJ1-1,CATSKGGSTEAFF,0,1,1,1
TRBV19,TRBJ2-1,CASQEGPYNEQFF,0,1,1,1
TRBV19,TRBJ1-6,CASTEDGNSPLHF,0,1,1,1
TRBV19,TRBJ1-5,CASSREGLGPQHF,0,1,1,1
TRBV5-8,TRBJ1-4,CASSKGVREKLFF,0,1,1,1
TRBV28,TRBJ2-3,CASQGHDTDTQYF,0,1,1,1
TRBV3-1,TRBJ2-1,CASGLSSYNEQFF,0,1,1,1
TRBV3-1,TRBJ1-1,CASSLFLNTEAFF,0,1,1,1
TRBV11-3,TRBJ1-1,CASSRQGNTEAFF,0,2,1,2
TRBV25-1,TRBJ2-5,CASSEGGLETQYF,0,1,1,1
TRBV5-5,TRBJ2-5,CASSFGNKETQYF,0,1,1,1
TRBV5-6,TRBJ2-7,CASSLVSVDEQYF,0,1,1,1
TRBV7-9,TRBJ1-5,CASSLGGDQPQHF,0,1,1,1
TRBV5-5,TRBJ2-5,CASSWAGTETQYF,0,1,1,1
TRBV5-5,TRBJ1-2,CASSPGTAYGYTF,0,1,1,1
TRBV7-3,TRBJ2-7,CASSPGTGYEQYF,0,1,1,1
TRBV5-4,TRBJ1-2,CASSPGTVYGYTF,0,1,1,1
TRBV3-1,TRBJ1-3,CASSHLTGNTIYF,0,1,1,1
TRBV9,TRBJ2-7,CASSVGEPYEQYF,0,2,1,2
TRBV2,TRBJ1-1,CANSQNLVTEAFF,0,1,1,1
TRBV5-1,TRBJ2-7,CASSLATAYEQYF,0,1,1,1
TRBV4-1,TRBJ2-7,CASSPDKFYEQYF,0,1,1,1
TRBV29-1,TRBJ1-4,CSVPGRGNEKLFF,0,2,1,2
TRBV29-1,TRBJ1-6,CSVRGQYNSPLHF,0,1,1,1
TRBV29-1,TRBJ1-2,CSVRPYSRNGYTF,0,1,1,1
TRBV29-1,TRBJ2-3,CSVQDRSTDTQYF,0,1,1,1
TRBV29-1,TRBJ2-3,CSVDTQDTDTQYF,0,1,1,1
TRBV29-1,TRBJ2-3,CSVDAGNTDTQYF,0,1,1,1
TRBV29-1,TRBJ2-7,CSVEVGLGYEQYF,0,1,1,1
TRBV29-1,TRBJ2-3,CSVLPGRTDTQYF,0,1,1,1
TRBV29-1,TRBJ1-5,CSVGDREEQPQHF,0,1,1,1
TRBV15,TRBJ1-1,CATSTRTGKAFF,0,1,1,1
TRBV19,TRBJ1-1,CASHLGNTEAFF,0,1,1,1
TRBV12-3/4,TRBJ2-1,CASSPLRNEQFF,0,1,1,1
TRBV7-9,TRBJ1-6,CASSPRGSPLHF,0,1,1,1
TRBV7-2,TRBJ2-5,CASSLGGKTQYF,0,1,1,1
TRBV7-9,TRBJ2-1,CASSLEGGEQFF,0,1,1,1
TRBV7-9,TRBJ2-7,CASSTTAYEQYF,0,1,1,1
TRBV4-1,TRBJ1-2,CASSQQGNGYTF,0,2,1,2
TRBV20-1,TRBJ2-7,CSSGVDLYEQYF,0,1,1,1
TRBV20-1,TRBJ2-5,CSASMSQETQYF,0,1,1,1
TRBV20-1,TRBJ2-7,CSASPWEREQYF,0,1,1,1
TRBV29-1,TRBJ1-5,CSARKANQPQHF,0,1,1,1
TRBV29-1,TRBJ2-1,CSSSQGATEQFF,0,1,1,1
TRBV29-1,TRBJ2-1,CSSERSYNEQFF,0,1,1,1
TRBV29-1,TRBJ2-3,CSVGTTGDTQYF,0,1,1,1
TRBV7-9,TRBJ1-1,CASSLVGEAFF,0,1,1,1
TRBV29-1,TRBJ1-4,CTIGAAGKLFF,0,1,1,1
TRBV29-1,TRBJ2-1,CSVVGSDEQFF,0,1,1,1
TRBV29-1,TRBJ2-5,CSVGTEGTQYF,0,1,1,1
TRBV29-1,TRBJ2-4,CSAVAKNIQYF,0,1,1,1
TRBV20-1,TRBJ2-7,CSGWEGEQYF,0,1,1,1
TRBV11-1,TRBJ2-5,CASSYPGTAIIRDRETQYF,0,1,1,1
TRBV20-1,TRBJ1-1,CSASRDRGGSNTEAFF,0,1,1,1
TRBV4-3,TRBJ1-1,CASSQWTGMNTEAFF,0,1,1,1
TRBV4-3,TRBJ2-7,CASSQTGGRPNEQYF,0,1,1,1
TRBV5-6,TRBJ1-4,CASSPDSKREKLFF,0,1,1,1
TRBV6-2/3/5/6,TRBJ1-4,CASSYSVRAANEKLFF,0,2,1,2
TRBV3-1,TRBJ1-3,CASSQVETGNTIYF,0,1,1,1
TRBV7-9,TRBJ2-2,CASGSGSGARTGELFF,0,1,1,1
TRBV7-9,TRBJ2-1,CASSSTSGGFYNEQFF,0,2,1,2
TRBV15,TRBJ1-3,CATRLGNSGNTIYF,0,1,1,1
TRBV5-1,TRBJ2-4,CASSQDSGGTQYF,0,1,1,1
TRBV29-1,TRBJ2-7,CSVLPTGRNEQYF,0,1,1,1
TRBV9,TRBJ2-5,CASKGPLSWERGETQYF,0,1,1,1
TRBV12-3/4,TRBJ1-4,CASSLGLGQGEKLFF,0,1,1,1
TRBV5-8,TRBJ1-5,CAGSLMRQASNQPQHF,0,1,1,1
TRBV5-4,TRBJ2-3,CASSSPDRGRFGTDTQYF,0,1,1,1
TRBV4-2,TRBJ1-1,CASSQAGENTEAFF,0,2,1,2
TRBV20-1,TRBJ2-6,CSARPPLSRGHSTKSGANVLTF,0,1,1,1
TRBV20-1,TRBJ1-4,CSAEFGGDEKLIF,0,1,1,1
TRBV5-5,TRBJ2-7,CASRPWEGDYEQYF,0,1,1,1
TRBV19,TRBJ1-2,CASSPATVTNRVEERGYTF,0,1,1,1
TRBV7-6,TRBJ1-4,CASSRTGTGLAQGEKLFF,0,1,1,1
TRBV7-2,TRBJ2-4,CASSPPPRLAENIQYF,0,1,1,1
TRBV9,TRBJ1-6,CASSPTRGGEGSPLHF,0,1,1,1
TRBV19,TRBJ2-3,CASSIGLAPTDTQYF,0,1,1,1
TRBV6-1,TRBJ2-2,CASSAAGVTGELFF,0,1,1,1
TRBV3-1,TRBJ1-5,CASSQEWGREQPQHF,0,1,1,1
TRBV15,TRBJ2-4,CATSSATQTNIQYF,0,1,1,1
TRBV7-6,TRBJ2-3,CASSLSADSSTRYF,0,1,1,1
TRBV13,TRBJ1-4,CASSPGPNKEKLFS,0,1,1,1
TRBV13,TRBJ1-1,CASSFENTEAFF,0,1,1,1
TRBV4-2,TRBJ2-6,CASSRPRGSGVLSSGANVLTF,0,1,1,1
TRBV28,TRBJ2-5,CASTWDFGLGTQYF,0,1,1,1
TRBV5-1,TRBJ2-2,CASSETGDTGELFF,0,1,1,1
TRBV29-1,TRBJ1-1,CSVGKGNMNTEAFF,0,1,1,1
TRBV14,TRBJ1-2,CASSPGLDYGYTF,0,1,1,1
TRBV2,TRBJ2-3,CASSYKGALSGTEYTDTQYF,0,1,1,1
TRBV29-1,TRBJ2-1,CSVEGRGTSGITSSYNEQFF,0,1,1,1
TRBV10-3,TRBJ1-1,CAISESRGPYEGRSTEAFF,0,1,1,1
TRBV3-1,TRBJ2-1,CASSPLAGGPSMGRDEQFF,0,1,1,1
TRBV4-2,TRBJ2-2,CASSQVGDTGGRDTGELFF,0,2,1,2
TRBV3-1,TRBJ2-1,CASSQVSCTGARDYNEQFF,0,1,1,1
TRBV11-2,TRBJ2-2,CASSFGLAGDLNTGELFF,0,1,1,1
TRBV5-6,TRBJ1-5,CASSSALGISDRNQPQHF,0,1,1,1
TRBV20-1,TRBJ2-4,CSARDGGGGLIAKNIQYF,0,1,1,1
TRBV30,TRBJ2-3,CAWSNTGGKFGGDTQYF,0,1,1,1
TRBV10-3,TRBJ2-2,CAISAWTTSRNTGELFF,0,1,1,1
TRBV12-3/4,TRBJ2-7,CATSFGSGRVPGYEQYF,0,1,1,1
TRBV13,TRBJ2-7,CATGAGGIGVSDHEQYF,0,1,1,1
TRBV15,TRBJ1-3,CATSRGTGPSSGNTIYF,0,1,1,1
TRBV19,TRBJ1-2,CASSIFPDTRGLYGYTF,0,1,1,1
TRBV6-2/3/5/6,TRBJ1-1,CASSLGWKFGTNTEAFF,0,2,1,2
TRBV6-2/3/5/6,TRBJ1-6,CASSLIGAGVYNSPLHF,0,1,1,1
TRBV12-3/4,TRBJ2-1,CASSSKTSGSKGNEQFF,0,1,1,1
TRBV6-2/3/5/6,TRBJ2-3,CASSWAGGWGSTDTQYF,0,1,1,1
TRBV6-2/3/5/6,TRBJ1-2,CASSYVGTGGANYGYTF,0,1,1,1
TRBV7-2,TRBJ1-6,CASSFGLRGNYNSPLHF,0,1,1,1
TRBV7-9,TRBJ1-1,CASSLLPYLAGNTEAFF,0,1,1,1
TRBV7-9,TRBJ1-6,CASSLTFRLNDLSPLHF,0,1,1,1
TRBV7-2,TRBJ2-3,CASSLGLAGGMEDTQYF,0,1,1,1
TRBV11-3,TRBJ2-5,CASSRRTSGREQETQYF,0,1,1,1
TRBV2,TRBJ2-4,CASRRSGLELAKNIQYF,0,1,1,1
TRBV5-1,TRBJ2-1,CASSLELAGVSYNEQFF,0,1,1,1
TRBV20-1,TRBJ2-1,CSARENGLAGGYNEQFF,0,1,1,1
TRBV20-1,TRBJ1-3,CSATPDDIPSSGNTIYF,0,1,1,1
TRBV29-1,TRBJ2-3,CSVEDLGQQPRTDTQYF,0,1,1,1
TRBV12-5,TRBJ2-7,CASGPPSGQRPYEQYF,0,1,1,1
TRBV19,TRBJ2-5,CASSPFGGTGEETQYF,0,1,1,1
TRBV18,TRBJ2-3,CASSPPRGTDADTQYF,0,1,1,1
TRBV27,TRBJ2-7,CASRSPGTSLPYEQYF,0,1,1,1
TRBV6-2/3/5/6,TRBJ1-3,CASSFRKTLSENTICF,0,1,1,1
TRBV12-3/4,TRBJ1-6,CASSSRGTASNSPLHF,0,1,1,1
TRBV6-2/3/5/6,TRBJ1-2,CASSYSWTEINYGYTF,0,1,1,1
TRBV6-2/3/5/6,TRBJ2-1,CASSYVVQARGHEQFF,0,1,1,1
TRBV6-2/3/5/6,TRBJ2-1,CASSYNQGAFYNEQFF,0,1,1,1
TRBV27,TRBJ1-3,CASSPGGQITGNTIYF,0,1,1,1
TRBV5-4,TRBJ2-3,CASSFRGQGAIDTQYF,0,1,1,1
TRBV7-2,TRBJ2-1,CASSLASVAGNNEQFF,0,2,1,2
TRBV7-8,TRBJ1-5,CASSLEGQGSNQPQHF,0,1,1,1
TRBV7-9,TRBJ2-5,CASSSLADHYQETQYF,0,1,1,1
TRBV7-8,TRBJ2-7,CASSPRPDLGSYEQYF,0,1,1,1
TRBV3-1,TRBJ2-4,CASSPGPGEPKNIQYF,0,1,1,1
TRBV9,TRBJ2-7,CASSPYGTSGNYEQYF,0,1,1,1
TRBV7-2,TRBJ2-2,CASSVRLAENTGELFF,0,1,1,1
TRBV5-4,TRBJ1-2,CASSAPRTGAVYGYTF,0,1,1,1
TRBV11-2,TRBJ2-1,CASSATWTSGRTEQFF,0,1,1,1
TRBV13,TRBJ2-1,CASSGPEAGGRNEQFF,0,1,1,1
TRBV12-3/4,TRBJ2-5,CASRSFGTGDRETQYF,0,1,1,1
TRBV12-3/4,TRBJ1-3,CASRNRGRQERDTIYF,0,1,1,1
TRBV6-2/3/5/6,TRBJ2-1,CASRGVGGIYSNEQFF,0,1,1,1
TRBV5-1,TRBJ1-6,CASSLTGGTGGSPLHF,0,1,1,1
TRBV5-1,TRBJ1-3,CASSATGGSSGNTIYF,0,1,1,1
TRBV20-1,TRBJ2-5,CSARDLGSAQAETQYF,0,1,1,1
TRBV12-3/4,TRBJ2-5,CVSSPPGTGGETQYF,0,1,1,1
TRBV2,TRBJ1-4,CASLIGQGINEKLFF,0,1,1,1
TRBV30,TRBJ2-1,CAWSVRLAGVYEQFF,0,1,1,1
TRBV30,TRBJ1-5,CAWSKGADSNQPQHF,0,1,1,1
TRBV10-3,TRBJ2-7,CAISESNGGAYEQYF,0,1,1,1
TRBV24-1,TRBJ2-3,CATSDLRDSTDTQYF,0,1,1,1
TRBV15,TRBJ1-1,CATSRGGLMNTEAFF,0,1,1,1
TRBV18,TRBJ1-1,CASSPGRGENTEAFF,0,1,1,1
TRBV18,TRBJ1-6,CASSPDSSYNSPLHF,0,1,1,1
TRBV14,TRBJ2-3,CASQREGTSTDTQYF,0,1,1,1
TRBV6-2/3/5/6,TRBJ2-2,CASTRGGQHTGELFF,0,1,1,1
TRBV12-3/4,TRBJ1-6,CASSFGQGQNSPLHF,0,1,1,1
TRBV12-3/4,TRBJ2-3,CASSLGRGSTDTQYF,0,1,1,1
TRBV6-2/3/5/6,TRBJ2-1,CASSLGQANYNEQFF,0,1,1,1
TRBV27,TRBJ1-2,CASSSWTAPNYGYTF,0,2,1,2
TRBV12-3/4,TRBJ2-7,CASSSRGALPYEQYF,0,1,1,1
TRBV6-2/3/5/6,TRBJ2-3,CASSSASGGADTQYF,0,1,1,1
TRBV12-3/4,TRBJ2-3,CASSWSGGPTDTQYF,0,1,1,1
TRBV6-2/3/5/6,TRBJ1-5,CASSYSRQSNQPQHF,0,1,1,1
TRBV6-2/3/5/6,TRBJ1-1,CASSYRSDRLLEAFF,0,1,1,1
TRBV6-2/3/5/6,TRBJ2-1,CASSYGGSSYNEQFF,0,1,1,1
TRBV6-2/3/5/6,TRBJ2-3,CASSYGAGSADTQYF,0,1,1,1
TRBV6-2/3/5/6,TRBJ2-7,CASSYTYLAGHEQYF,0,1,1,1
TRBV12-3/4,TRBJ2-1,CASSLGQGSYNEQFF,0,1,1,1
TRBV27,TRBJ1-1,CASSPRDRMNTEAFF,0,1,1,1
TRBV6-2/3/5/6,TRBJ2-7,CASSPTSGGYYEQYF,0,1,1,1
TRBV6-1,TRBJ2-2,CASSVRADNTGELFF,0,1,1,1
TRBV2,TRBJ2-7,CASSGPAGERYEQYF,0,2,1,2
TRBV6-1,TRBJ2-3,CASSDLRGGLNTQYF,0,1,1,1
TRBV2,TRBJ2-7,CASSEGDTSSYEQYF,0,1,1,1
TRBV5-4,TRBJ1-4,CASSLVGATNEKLFF,0,1,1,1
TRBV7-2,TRBJ1-6,CASSLAGPPNSPLHF,0,2,1,2
TRBV13,TRBJ2-1,CASSLRQGATNEQFF,0,1,1,1
TRBV7-2,TRBJ2-7,CASSLAQSLFYEQYF,0,1,1,1
TRBV7-2,TRBJ1-5,CASSLGTGPNQPQHF,0,1,1,1
TRBV11-2,TRBJ2-1,CASSLGQGTYNEQFF,0,1,1,1
TRBV7-2,TRBJ1-3,CASSSGTGSGNTIYF,0,1,1,1
TRBV7-6,TRBJ1-6,CASSSNRGHNSPLHF,0,1,1,1
TRBV28,TRBJ2-2,CASSLGDRDTGELFF,0,1,1,1
TRBV4-2,TRBJ2-3,CASSLTQRNTDTQYF,0,1,1,1
TRBV7-2,TRBJ2-1,CASSPSLGNNDEQFF,0,1,1,1
TRBV3-1,TRBJ2-7,CASSPQTGGNYEQYF,0,1,1,1
TRBV6-2/3/5/6,TRBJ1-2,CASSPSGTTRDGYTF,0,1,1,1
TRBV11-1,TRBJ1-1,CASSHPTGGNTEAFF,0,1,1,1
TRBV3-1,TRBJ1-1,CASSQDHALDTEAFF,0,1,1,1
TRBV9,TRBJ1-6,CASSAGHSDNSPLHF,0,1,1,1
TRBV6-4,TRBJ2-3,CASSDGLLNRDTQYF,0,1,1,1
TRBV7-6,TRBJ2-7,CASSTTSGGNYEQYF,0,1,1,1
TRBV7-6,TRBJ2-7,CASSTTSGDNYEQYF,0,2,1,2
TRBV6-4,TRBJ2-6,CASSRGDSGANVLTF,0,1,1,1
TRBV5-6,TRBJ2-3,CASSNRTGWTDTQYF,0,1,1,1
TRBV12-3/4,TRBJ1-1,CASRGLWGFRTEAFF,0,1,1,1
TRBV7-2,TRBJ2-7,CASRRTGDGTYEQYF,0,1,1,1
TRBV7-9,TRBJ2-1,CASRPDGGGLHEQFF,0,2,1,2
TRBV7-2,TRBJ2-3,CASRPIGTSTDTQYF,0,1,1,1
TRBV2,TRBJ2-1,CASRTKTSENNEQFF,0,1,1,1
TRBV5-1,TRBJ1-6,CASSLAVTGESPLHF,0,1,1,1
TRBV5-1,TRBJ1-1,CASSLGQGHNTEAFF,0,1,1,1
TRBV5-1,TRBJ1-1,CASSLDEEGWTEAFF,0,1,1,1
TRBV4-1,TRBJ1-5,CASSRRRGANQPQHF,0,1,1,1
TRBV4-1,TRBJ2-7,CASSQGFLGGNEQYF,0,1,1,1
TRBV20-1,TRBJ1-4,CSATERGQANEKLFF,0,1,1,1
TRBV20-1,TRBJ2-7,CSASPGTGASYEQYF,0,1,1,1
TRBV20-1,TRBJ2-7,CSARVPGGSSYEQYF,0,1,1,1
TRBV20-1,TRBJ2-7,CSARGASGRTYEQYF,0,1,1,1
TRBV20-1,TRBJ1-6,CSARDLDRVGSPLHF,0,1,1,1
TRBV20-1,TRBJ1-1,CSARDLEGPRTEAFF,0,1,1,1
TRBV20-1,TRBJ1-6,CSAKTGGFYNSPLHF,0,1,1,1
TRBV20-1,TRBJ2-1,CSAKSSGGPFNEQFF,0,1,1,1
TRBV20-1,TRBJ2-2,CSARTSGLDTGELFF,0,2,1,2
TRBV20-1,TRBJ2-4,CSANHRQGNKNIQYF,0,1,1,1
TRBV29-1,TRBJ2-3,CSVGRGQNPTDTQYF,0,1,1,1
TRBV13,TRBJ2-7,RASSLGVAGVYEQYF,0,1,1,1
TRBV10-3,TRBJ2-5,CAISSGLAGGSQYF,0,1,1,1
TRBV7-6,TRBJ2-1,CATGTGGVYNEQFF,0,1,1,1
TRBV19,TRBJ2-5,CASTSSGWGETQYF,0,1,1,1
TRBV19,TRBJ1-5,CASTPGQFAQPQHF,0,2,1,2
TRBV19,TRBJ2-3,CASTKGALTDTQYF,0,1,1,1
TRBV18,TRBJ2-7,CASSRLAADYEQYF,0,1,1,1
TRBV18,TRBJ2-7,CASSLQGEIYEQYF,0,1,1,1
TRBV2,TRBJ2-1,CASIPGLDRGEQFF,0,1,1,1
TRBV2,TRBJ1-2,CASTRSISDYGYTF,0,1,1,1
TRBV6-2/3/5/6,TRBJ1-1,CASSFADMNTEAFF,0,1,1,1
TRBV12-3/4,TRBJ1-4,CASSLTGEREKLFF,0,1,1,1
TRBV12-3/4,TRBJ1-6,CASSLQAGDSPLHF,0,1,1,1
TRBV27,TRBJ2-7,CASSLAGGAYKQYF,0,1,1,1
TRBV12-3/4,TRBJ1-5,CASSLGTDNQPQHF,0,1,1,1
TRBV12-3/4,TRBJ1-1,CASSLNSLNTEAFF,0,2,1,2
TRBV6-2/3/5/6,TRBJ2-7,CASSSTGFSYEQYF,0,1,1,1
TRBV6-2/3/5/6,TRBJ2-1,CASSYSSYYNEQFF,0,1,1,1
TRBV5-4,TRBJ2-7,CASSPGTAPREQYF,0,1,1,1
TRBV4-2,TRBJ2-7,CASSHTGQSYEQYF,0,1,1,1
TRBV6-1,TRBJ2-1,CASSVGRGLNEQFF,0,1,1,1
TRBV25-1,TRBJ1-5,CASSAGGQGQPQHF,0,1,1,1
TRBV6-1,TRBJ2-2,CASSEKRNTGELFF,0,1,1,1
TRBV6-1,TRBJ2-5,CASSEQGNAETQYF,0,1,1,1
TRBV2,TRBJ2-7,CASSETGTAYEQYF,0,1,1,1
TRBV7-2,TRBJ2-5,CASSFKREVETQYF,0,1,1,1
TRBV5-6,TRBJ2-7,CASSLWGTSYEQYF,0,1,1,1
TRBV11-1,TRBJ2-3,CASSLGESTDTQYF,0,1,1,1
TRBV7-8,TRBJ1-5,CASSLSQGNQPQHF,0,1,1,1
TRBV7-2,TRBJ2-7,CASSLVEGAYEQYF,0,1,1,1
TRBV7-8,TRBJ2-1,CASSLASSYNEQFF,0,2,1,2
TRBV7-9,TRBJ2-7,CASSLAGSSYEQYF,0,2,1,2
TRBV7-9,TRBJ2-7,CASSLGTPFFEQYF,0,1,1,1
TRBV7-2,TRBJ2-7,CASSLDRGHYEQYF,0,1,1,1
TRBV5-4,TRBJ1-2,CASSSGQSLYGYTF,0,1,1,1
TRBV5-4,TRBJ2-7,CASSSGTGPYEQYF,0,2,1,2
TRBV11-2,TRBJ1-3,CASSSGAPPKAIYF,0,1,1,1
TRBV7-2,TRBJ2-3,CASSLGLPSDTQYF,0,1,1,1
TRBV7-8,TRBJ2-1,CASSLLLADNEQFF,0,1,1,1
TRBV5-4,TRBJ2-3,CASSPGAEADTQYF,0,1,1,1
TRBV12-3/4,TRBJ2-7,CASSPDRALYEQYF,0,1,1,1
TRBV2,TRBJ2-5,CASSPTRVIETQYF,0,1,1,1
TRBV7-9,TRBJ1-1,CASSPRQGATEAFF,0,1,1,1
TRBV7-6,TRBJ1-4,CASSRGQGGEKLFF,0,1,1,1
TRBV12-3/4,TRBJ1-1,CASSAQPGQGTVDF,0,1,1,1
TRBV6-1,TRBJ2-7,CASSDRWSSYEQYF,0,1,1,1
TRBV7-2,TRBJ2-7,CASSMGQPALEQYF,0,1,1,1
TRBV13,TRBJ2-7,CASSTSGKSYEQYF,0,1,1,1
TRBV13,TRBJ1-6,CASSTGRINSPLHF,0,1,1,1
TRBV7-6,TRBJ1-1,CASSKGAGATEAFF,0,1,1,1
TRBV2,TRBJ1-1,CASRLRGSNTEAFF,0,1,1,1
TRBV6-2/3/5/6,TRBJ2-1,CASRQALGDNEQFF,0,1,1,1
TRBV5-1,TRBJ1-1,CASSSDRLNTEAFF,0,1,1,1
TRBV4-3,TRBJ1-5,CASSQVAGNQPQHF,0,1,1,1
TRBV4-3,TRBJ2-2,CASSQDWATGELFF,0,1,1,1
TRBV5-1,TRBJ1-1,CASNLVGGDPEAFF,0,1,1,1
TRBV20-1,TRBJ2-1,CSARERGDYNEQFF,0,1,1,1
TRBV20-1,TRBJ1-6,CSARDLLVGSPLHF,0,1,1,1
TRBV20-1,TRBJ2-7,CSARDRGVFYEQYF,0,1,1,1
TRBV29-1,TRBJ2-3,CSVEAIVVADTQYF,0,1,1,1
TRBV29-1,TRBJ2-3,CSASTPTGSDTQYF,0,1,1,1
TRBV11-2,TRBJ2-1,RASTPNRAANEQFF,0,1,1,1
TRBV12-5,TRBJ1-1,CASPLGVNTEAFF,0,1,1,1
TRBV30,TRBJ1-1,CAWSATENTEAFF,0,1,1,1
TRBV19,TRBJ2-5,CATSSSRQETQYF,0,1,1,1
TRBV5-4,TRBJ1-3,CATSLDIGNTIYF,0,1,1,1
TRBV19,TRBJ1-5,CASRSSYGQPQHF,0,1,1,1
TRBV19,TRBJ1-2,CASSIDISYGYTF,0,1,1,1
TRBV18,TRBJ1-1,CASSPNRDTEAFF,0,1,1,1
TRBV7-2,TRBJ2-5,CASSGGFQETQYF,0,1,1,1
TRBV5-5,TRBJ1-2,CASTWEATSGYTF,0,2,1,2
TRBV12-3/4,TRBJ2-7,CASSFWGLYEQYF,0,1,1,1
TRBV6-2/3/5/6,TRBJ1-6,CASSFAAGSPLHF,0,1,1,1
TRBV12-3/4,TRBJ1-2,CASSSRTGIGYTF,0,1,1,1
TRBV27,TRBJ2-5,CASSSTLTGAPDF,0,1,1,1
TRBV7-2,TRBJ1-1,CASSSHVNTEAFF,0,1,1,1
TRBV6-2/3/5/6,TRBJ2-7,CASSYGGTYEQYF,0,1,1,1
TRBV5-4,TRBJ2-3,CASSPTSTDTQYF,0,1,1,1
TRBV27,TRBJ1-1,CASSGQGMSEAFF,0,1,1,1
TRBV2,TRBJ1-5,CASSNRGDQPQHF,0,1,1,1
TRBV7-2,TRBJ2-7,CASSFGTTYEQYF,0,1,1,1
TRBV5-5,TRBJ2-3,CASSLVGPYTQYF,0,1,1,1
TRBV7-2,TRBJ1-2,CASSLEAGASYTF,0,1,1,1
TRBV5-5,TRBJ2-5,CASSWAAEETQYF,0,3,1,3
TRBV12-3/4,TRBJ1-1,CASSWDRTPEAFF,0,1,1,1
TRBV5-4,TRBJ1-1,CASSPQGNTEAFF,0,1,1,1
TRBV7-9,TRBJ2-1,CASSPVGGGGQFF,0,1,1,1
TRBV6-2/3/5/6,TRBJ2-5,CASSPTSVETQYF,0,2,1,2
TRBV7-9,TRBJ2-7,CASSPTSVYEQYF,0,1,1,1
TRBV6-2/3/5/6,TRBJ2-1,CASSPLAENEQFF,0,1,1,1
TRBV3-1,TRBJ2-7,CASSQGTSYEQYF,0,1,1,1
TRBV12-3/4,TRBJ1-2,CASSQQGNYGYTF,0,1,1,1
TRBV3-1,TRBJ2-5,CASSQGRGAAQYF,0,1,1,1
TRBV14,TRBJ2-3,CASSQDLEDTQYF,0,1,1,1
TRBV3-1,TRBJ1-5,CASSQKDGQPQHF,0,1,1,1
TRBV7-9,TRBJ1-2,CASSIKEGGGYTF,0,1,1,1
TRBV6-4,TRBJ1-1,CASRDGINTEAFF,0,1,1,1
TRBV2,TRBJ1-1,CASRNGQGQLPFF,0,1,1,1
TRBV5-1,TRBJ1-5,CACSLGGNQPQHF,0,1,1,1
TRBV5-1,TRBJ2-1,CASSLEGFNEQFF,0,1,1,1
TRBV20-1,TRBJ2-7,CSARPAPGGEQYF,0,1,1,1
TRBV20-1,TRBJ2-7,CSARSGGGVEQYF,0,1,1,1
TRBV20-1,TRBJ1-5,CSARPPGNQPQHF,0,1,1,1
TRBV20-1,TRBJ2-7,CSALAGATYEQYF,0,1,1,1
TRBV20-1,TRBJ1-6,CSAEGSPNSPLHF,0,1,1,1
TRBV29-1,TRBJ2-7,CSVVQPSSYEQYF,0,1,1,1
TRBV29-1,TRBJ2-3,CSVVGEGLDTQYF,0,1,1,1
TRBV29-1,TRBJ2-1,CSVGGEGGNEQFF,0,1,1,1
TRBV29-1,TRBJ2-7,CSVERASGHEQYF,0,1,1,1
TRBV29-1,TRBJ2-2,CSVERGDTGELFF,0,1,1,1
TRBV29-1,TRBJ2-1,CSVPGLAGNEQFF,0,1,1,1
TRBV29-1,TRBJ2-3,CSAPGASTDAQYF,0,1,1,1
TRBV9,TRBJ2-2,SASSVGGSGELFF,0,1,1,1
TRBV30,TRBJ1-3,CASHRGENTIYF,0,1,1,1
TRBV30,TRBJ2-1,CACQKVYNEQFF,0,1,1,1
TRBV30,TRBJ1-5,CAWSVYKDSPHF,0,1,1,1
TRBV7-9,TRBJ2-7,CATSRGSYEQYF,0,1,1,1
TRBV19,TRBJ2-3,CASSPLGGTQYF,0,1,1,1
TRBV19,TRBJ1-4,CASSRGQEKLFF,0,1,1,1
TRBV7-2,TRBJ2-1,CASTYGPSEQFF,0,1,1,1
TRBV7-9,TRBJ1-1,CASTRMSSEAFF,0,1,1,1
TRBV7-2,TRBJ1-5,CASSVTTGPQHF,0,1,1,1
TRBV7-9,TRBJ1-2,CASSGGNYGYTF,0,2,1,2
TRBV2,TRBJ1-2,CASSGTASGYTF,0,1,1,1
TRBV5-6,TRBJ1-1,CASSLGGTEAFF,0,1,1,1
TRBV13,TRBJ2-1,CASSLGADEQFF,0,1,1,1
TRBV12-3/4,TRBJ2-7,CASSLHEYEQYF,0,1,1,1
TRBV12-3/4,TRBJ1-2,CASSLQGPGYTF,0,1,1,1
TRBV7-2,TRBJ2-7,CASSPSRREQYF,0,1,1,1
TRBV9,TRBJ2-3,CASSPSGDTQYF,0,1,1,1
TRBV6-2/3/5/6,TRBJ2-7,CASSHPISEQYF,0,1,1,1
TRBV14,TRBJ2-7,CASSQGRYEQYF,0,1,1,1
TRBV6-4,TRBJ2-7,CASNDRGYEQYF,0,1,1,1
TRBV19,TRBJ2-1,CAAGAKYNEQFF,0,1,1,1
TRBV20-1,TRBJ2-1,CSQPGVRDEQFF,0,1,1,1
TRBV20-1,TRBJ2-1,CSAFGEGHEQFF,0,1,1,1
TRBV20-1,TRBJ2-1,CSASGVDNEQFF,0,1,1,1
TRBV20-1,TRBJ2-7,CSALRQDYEQCF,0,1,1,1
TRBV29-1,TRBJ1-1,CSGSGQATEAFF,0,1,1,1
TRBV29-1,TRBJ1-2,CSVAIGSYGYTF,0,1,1,1
TRBV29-1,TRBJ1-2,CSVDRGNYGYTF,0,1,1,1
TRBV7-7,TRBJ1-2,RASSSSGPGYTF,0,1,1,1
TRBV19,TRBJ1-1,CAGSPGAEAFF,0,1,1,1
TRBV15,TRBJ2-1,CATSRVNEQFF,0,1,1,1
TRBV6-2/3/5/6,TRBJ2-7,CASSFGYEQYF,0,1,1,1
TRBV5-6,TRBJ2-5,CASSSTRTQYF,0,1,1,1
TRBV6-2/3/5/6,TRBJ1-1,CASSRGAEAFF,0,1,1,1
TRBV3-1,TRBJ2-3,CASSQGGNKYF,0,1,1,1
TRBV2,TRBJ2-1,CASREGDEQFF,0,1,1,1
TRBV19,TRBJ1-1,CASMRTEAFF,0,1,1,1
TRBV12-3/4,TRBJ1-2,CASGLNYYTF,0,1,1,1
TRBV4-3,TRBJ2-1,CAWGGRLQFF,0,2,1,2
TRBV29-1,TRBJ2-1,CSVRDNEQFF,0,1,1,1
TRBV2,TRBJ2-3,CASTDTQYF,0,1,1,1
TRBV29-1,TRBJ1-1,CSVLAFF,0,1,1,1
TRBV7-9,TRBJ2-3,CASSFLAAGGDTQYF,0,1,1,1
TRBV12-3/4,TRBJ1-5,CASSLFGPWPQHF,0,1,1,1
TRBV7-3,TRBJ2-3,CASSPGLAGGAQYF,0,1,1,1
TRBV19,TRBJ1-1,CASRRREGYPDTGAFF,0,1,1,1
TRBV6-2/3/5/6,TRBJ2-2,CASRTLDSGELFF,0,1,1,1
TRBV19,TRBJ2-1,CASSGRGVYSSGEAIRLYNEQFF,0,1,1,1
TRBV7-2,TRBJ1-2,CASSLAPRGTGLLFNYGYTF,0,1,1,1
TRBV7-9,TRBJ2-3,CASSLTIFRDRATSTDTQYF,0,1,1,1
TRBV11-2,TRBJ2-7,CASSLFYPQASGRSSYEQYF,0,1,1,1
TRBV12-5,TRBJ2-6,CASGLGSGTESSGANVLTF,0,2,1,2
TRBV5-1,TRBJ2-1,CATDGSGGPNQSPCNEQFF,0,1,1,1
TRBV20-1,TRBJ2-3,CSARLVSGSVVGPTDTQYF,0,1,1,1
TRBV28,TRBJ1-3,SASSSPGDRGFYSGNTIYF,0,1,1,1
TRBV12-5,TRBJ1-1,CASGLVRTAFRENTEAFF,0,1,1,1
TRBV10-3,TRBJ2-5,CAISESRLAGVYQETQYF,0,2,1,2
TRBV19,TRBJ2-2,CASSIARLAGGRTGELFF,0,1,1,1
TRBV19,TRBJ1-5,CASSSQGQTQYSNQPQHF,0,1,1,1
TRBV18,TRBJ2-1,CASSPRTATSGKGDEQFF,0,1,1,1
TRBV12-3/4,TRBJ2-1,CASSSETSGRATYNEQFF,0,1,1,1
TRBV6-2/3/5/6,TRBJ1-1,CASSLLTGTGSSNTEAFF,0,1,1,1
TRBV7-9,TRBJ1-2,CASSFSGAPGTENYGYTF,0,1,1,1
TRBV11-2,TRBJ1-4,CASSLYSLRYRGLEKLFF,0,1,1,1
TRBV7-9,TRBJ1-5,CASSLPWTGRGDNQPQHF,0,1,1,1
TRBV7-2,TRBJ2-3,CASSSWTSGVPRGDTQYF,0,1,1,1
TRBV11-2,TRBJ2-1,CASSPRPPGLAGRDEQFF,0,1,1,1
TRBV3-1,TRBJ1-4,CASSHRTGEVATNEKLFF,0,1,1,1
TRBV3-1,TRBJ1-1,CASSQVPRPGQLNTEAFF,0,1,1,1
TRBV3-1,TRBJ2-1,CASSQEGTSGLSIHEQFF,0,1,1,1
TRBV27,TRBJ2-1,CASSILGNSGPAYNEQFF,0,1,1,1
TRBV12-3/4,TRBJ1-4,CASRTRGQVYATNEKLFF,0,1,1,1
TRBV5-1,TRBJ2-3,CASSLGVRAGGFGDTQYF,0,1,1,1
TRBV4-1,TRBJ2-2,CASSLLGNGGRNTGELFF,0,1,1,1
TRBV4-1,TRBJ2-2,CASSQGGVLAGLSGELFF,0,1,1,1
TRBV20-1,TRBJ1-5,CSASVEMEMRNSNQPQHF,0,1,1,1
TRBV12-5,TRBJ1-1,CASGLKYRGLRVAEAFF,0,1,1,1
TRBV15,TRBJ1-2,CATSRDKIPLRYYGYTF,0,1,1,1
TRBV19,TRBJ2-1,CASSIGDRPNRYNEQFF,0,1,1,1
TRBV6-2/3/5/6,TRBJ2-7,CASSFEHYRGRNYEQYF,0,1,1,1
TRBV6-2/3/5/6,TRBJ2-7,CASSFSGSGRGSYEQYF,0,1,1,1
TRBV6-2/3/5/6,TRBJ1-1,CASSFHAGANWPTEASF,0,1,1,1
TRBV12-3/4,TRBJ2-2,CASSLGTSGRATGELFF,0,1,1,1
TRBV6-2/3/5/6,TRBJ2-3,CASSYPASGTSTDTQYF,0,1,1,1
TRBV2,TRBJ2-3,CASSVRLPRAGTDTQYF,0,1,1,1
TRBV7-6,TRBJ1-3,CASSFGFEGSSGNTIYF,0,1,1,1
TRBV13,TRBJ2-5,CASSLYSGNRGQETQYF,0,1,1,1
TRBV5-6,TRBJ2-6,CASSSGTGVGWANVLTF,0,2,1,2
TRBV3-1,TRBJ2-1,CASSLGLDSGPIGEQFF,0,2,1,2
TRBV7-9,TRBJ2-7,CASSLNGGPTSAYEQYF,0,1,1,1
TRBV7-2,TRBJ2-2,CASSPIAQGALGGELFF,0,1,1,1
TRBV12-3/4,TRBJ2-7,CASSRGLAGGHSYEQYF,0,1,1,1
TRBV3-1,TRBJ2-7,CASSAPKIRRAPYEQYF,0,1,1,1
TRBV4-1,TRBJ2-5,CASSHPGGQGGRETQYF,0,1,1,1
TRBV5-1,TRBJ1-6,CASSINREAVYNSPLHF,0,1,1,1
TRBV20-1,TRBJ2-4,CSAPARLGLGDKNIQYF,0,1,1,1
TRBV20-1,TRBJ1-4,CSAEGGGAPATNEKLFF,0,2,1,2
TRBV20-1,TRBJ2-7,CSARPFRAGASTYEQYF,0,1,1,1
TRBV20-1,TRBJ1-2,CSARDPRTGWYTDGYTF,0,1,1,1
TRBV29-1,TRBJ2-1,CSALTLPGLAGPNEQFF,0,1,1,1
TRBV10-3,TRBJ2-3,CAISAPPGQGTDTQYF,0,1,1,1
TRBV19,TRBJ2-1,CASKRNAARPYNEQFF,0,1,1,1
TRBV18,TRBJ1-4,CASSPYEGAMSEKLFF,0,1,1,1
TRBV18,TRBJ2-3,CASSPPLRVPTDTQYF,0,1,1,1
TRBV7-9,TRBJ2-1,CASILGGTGGRNEQFF,0,1,1,1
TRBV6-4,TRBJ1-1,CASTKLRIRQRTEAFF,0,1,1,1
TRBV12-3/4,TRBJ1-2,CASSFGTGGVRGGYTF,0,1,1,1
TRBV27,TRBJ2-1,CASSLFPAGYHNEQFF,0,1,1,1
TRBV27,TRBJ2-5,CASSLFWGQRGETQYF,0,1,1,1
TRBV12-3/4,TRBJ1-5,CASSLRSPSLGQPQHF,0,1,1,1
TRBV6-2/3/5/6,TRBJ1-4,CASSSTTGPGNEKLFF,0,1,1,1
TRBV6-2/3/5/6,TRBJ1-3,CASSSRVPSSGNTIYF,0,1,1,1
TRBV6-2/3/5/6,TRBJ1-2,CASSSGRPTFSHGYTF,0,1,1,1
TRBV6-2/3/5/6,TRBJ2-7,CASSYLSGGSSYEQYF,0,1,1,1
TRBV3-1,TRBJ2-3,CASSQPLAGDTDTQYF,0,1,1,1
TRBV6-1,TRBJ1-5,CASSGTVVFQYQPQHF,0,1,1,1
TRBV2,TRBJ1-2,CASSDSGSRLYYGYTF,0,1,1,1
TRBV6-4,TRBJ2-3,CASSDIAGGPTDTQYF,0,2,1,2
TRBV2,TRBJ2-5,CASSERSGGPLETQYF,0,2,1,2
TRBV6-1,TRBJ1-1,CASSETSGALNTEAFF,0,1,1,1
TRBV7-2,TRBJ2-3,CASSFLAGVGTDTQYF,0,1,1,1
TRBV13,TRBJ2-5,CASSFRQGAPSETQYF,0,1,1,1
TRBV5-4,TRBJ2-1,CASSLSTVRSYNEQFF,0,1,1,1
TRBV7-6,TRBJ1-4,CASSLASGTGEEKLFF,0,1,1,1
TRBV11-2,TRBJ1-4,CASSLKASTAKEKLFF,0,1,1,1
TRBV5-6,TRBJ2-3,CASSSRNEWGTDTQYF,0,1,1,1
TRBV7-9,TRBJ2-1,CASSWGLAGLYNEQFF,0,1,1,1
TRBV5-6,TRBJ2-3,CASSLRLDLLTDTQYF,0,1,1,1
TRBV11-1,TRBJ1-2,CASSPDPLTGGEGYTF,0,1,1,1
TRBV6-4,TRBJ2-5,CASSPAGGLGGETQYF,0,1,1,1
TRBV5-4,TRBJ2-7,CASSPKKTHDPYEQYF,0,2,1,2
TRBV3-1,TRBJ1-6,CASSREPGSTNSPLHF,0,1,1,1
TRBV7-9,TRBJ1-4,CASSRLAARANEKLFF,0,1,1,1
TRBV3-1,TRBJ1-4,CASSHQGTSTNEKLFF,0,1,1,1
TRBV4-2,TRBJ2-1,CASSQERTSGGDEQFF,0,1,1,1
TRBV3-1,TRBJ2-7,CASSQVFGATSYEQYF,0,1,1,1
TRBV3-1,TRBJ2-1,CASSQDGGLQYNEQFF,0,1,1,1
TRBV3-1,TRBJ2-1,CASSQDSALSYNEQFF,0,1,1,1
TRBV14,TRBJ1-5,CASSQDTGVSNQPQHF,0,1,1,1
TRBV4-2,TRBJ2-4,CASSQELAGGSNIQYF,0,1,1,1
TRBV14,TRBJ2-3,CASSQERELAGDTQYF,0,1,1,1
TRBV7-9,TRBJ2-7,CASSATRSPVGHGWYF,0,1,1,1
TRBV2,TRBJ2-5,CASNAPSSGGLETQYF,0,1,1,1
TRBV5-1,TRBJ2-3,CASSGTGAFPTDTQYF,0,1,1,1
TRBV5-1,TRBJ2-2,CASSLAIQGGTGELFF,0,1,1,1
TRBV5-1,TRBJ2-3,CASSLTSGGPGDTQYF,0,1,1,1
TRBV5-1,TRBJ2-6,CASSLTTSARANVLTF,0,1,1,1
TRBV4-3,TRBJ1-6,CASSQDRVVGNSPLHF,0,1,1,1
TRBV4-3,TRBJ2-3,CASSQEPRPSTDTQYF,0,1,1,1
TRBV4-1,TRBJ2-1,CASSQERGQSYNEQFF,0,1,1,1
TRBV20-1,TRBJ2-2,CSASRSGGPFTGELFF,0,1,1,1
TRBV20-1,TRBJ2-5,CSASPLQEGYQETQYF,0,1,1,1
TRBV20-1,TRBJ1-5,CSARPRIRYSNQPQHF,0,1,1,1
TRBV20-1,TRBJ2-2,CSARDLSDPNTGELFF,0,1,1,1
TRBV20-1,TRBJ2-3,CSAPPDGSPSTDTQYF,0,1,1,1
TRBV20-1,TRBJ2-1,CSAVTGTSGYYNEQFF,0,1,1,1
TRBV29-1,TRBJ1-2,CSVPNSWGTGIYGYTF,0,1,1,1
TRBV29-1,TRBJ2-1,CSVDLRTPSPFNEQFF,0,1,1,1
TRBV29-1,TRBJ1-1,SSVGGLRIAEGTEAFF,0,1,1,1
TRBV7-9,TRBJ2-3,CSSSFSGSKADTQYF,0,1,1,1
TRBV7-3,TRBJ2-5,CPSSHTIGQGETQYF,0,1,1,1
TRBV30,TRBJ2-3,CAWSVLGIGTDTQYF,0,1,1,1
TRBV10-3,TRBJ1-2,CAIRGTDLDNYGYTF,0,1,1,1
TRBV19,TRBJ1-2,CASTGGVDRVNGYTF,0,1,1,1
TRBV19,TRBJ1-2,CASSSDMDREYGYTF,0,1,1,1
TRBV19,TRBJ2-1,CASSDRKGKDNEQFF,0,1,1,1
TRBV19,TRBJ2-1,CASSIGLAGGFEQFF,0,1,1,1
TRBV19,TRBJ2-7,CASSMSAGGSYEQYF,0,1,1,1
TRBV19,TRBJ2-1,CASSMVAAKENEQFF,0,1,1,1
TRBV19,TRBJ2-1,CASSMGGVTYNEQFF,0,1,1,1
TRBV19,TRBJ2-7,CASSIRLGKLGEQYF,0,1,1,1
TRBV19,TRBJ2-7,CASSKTSGRNYEQYF,0,1,1,1
TRBV19,TRBJ1-4,CASSLGRDYNEKLFF,0,1,1,1
TRBV19,TRBJ1-5,CASSQPGYPHQPQHF,0,1,1,1
TRBV18,TRBJ1-5,CASSPDGRSNQPQHF,0,1,1,1
TRBV18,TRBJ1-1,CASSPPGGVNTEAFF,0,1,1,1
TRBV18,TRBJ1-5,CASSPSHRDNQPQHF,0,1,1,1
TRBV18,TRBJ1-1,CASSPLDSLWTEAFF,0,1,1,1
TRBV2,TRBJ1-1,CASCPTGGQDTEAFF,0,1,1,1
TRBV12-3/4,TRBJ1-3,CASGGKVASGNTIYL,0,1,1,1
TRBV12-3/4,TRBJ2-3,CASIPGGADTDTQYF,0,1,1,1
TRBV6-2/3/5/6,TRBJ2-1,CASTPNRASGGLPFF,0,2,1,2
TRBV12-3/4,TRBJ1-2,CASSFGRGNNYGYTF,0,1,1,1
TRBV12-3/4,TRBJ2-3,CASSFTSGVTDTQYF,0,1,1,1
TRBV6-2/3/5/6,TRBJ2-1,CASSFRRGDNNEQFF,0,1,1,1
TRBV12-3/4,TRBJ1-6,CASSLNSGGHSPLHF,0,1,1,1
TRBV12-3/4,TRBJ1-4,CASSLLGATNEKLFF,0,1,1,1
TRBV28,TRBJ2-3,CASSLLDRRTDTQYF,0,1,1,1
TRBV6-2/3/5/6,TRBJ1-1,CASSLLGGRRTEAFF,0,1,1,1
TRBV12-3/4,TRBJ1-4,CASSLAGAGGEKLFF,0,1,1,1
TRBV27,TRBJ1-5,CASSLSSYSNQPQHF,0,1,1,1
TRBV12-3/4,TRBJ2-1,CASSSRGRGTDEQFF,0,1,1,1
TRBV6-2/3/5/6,TRBJ2-5,CASSYSRAERETQYF,0,1,1,1
TRBV12-3/4,TRBJ2-6,CASSYGLSGANVLTF,0,1,1,1
TRBV7-9,TRBJ2-3,CASSLPGQTTDTQYF,0,1,1,1
TRBV12-3/4,TRBJ2-7,CASSPTGTGDYEQYF,0,1,1,1
TRBV27,TRBJ1-1,CASSPTGGLNTEAFF,0,1,1,1
TRBV6-2/3/5/6,TRBJ2-1,CASSPRQGTYNEQFF,0,1,1,1
TRBV6-1,TRBJ1-4,CASSRKGPTNEKLFF,0,1,1,1
TRBV6-4,TRBJ1-2,CASSVSPLDVYGYTF,0,1,1,1
TRBV6-1,TRBJ2-3,CASSGPGGATDTQYF,0,1,1,1
TRBV6-1,TRBJ2-7,CASSGDRGFSYEQYF,0,1,1,1
TRBV6-1,TRBJ2-5,CASSGRTSAGETQYF,0,1,1,1
TRBV2,TRBJ2-1,CASSDAGSSYNEQFF,0,1,1,1
TRBV6-4,TRBJ2-3,CASSDRNPSTDTQYF,0,1,1,1
TRBV25-1,TRBJ1-2,CASSEFGGLGYGYTF,0,1,1,1
TRBV6-1,TRBJ2-7,CASSEVGAAGYEQYF,0,1,1,1
TRBV6-1,TRBJ2-3,CASSEVLDGTDTQYF,0,1,1,1
TRBV7-2,TRBJ2-7,CASSFLGQGFYEQYF,0,1,1,1
TRBV7-2,TRBJ1-6,CASSFEAEFNSPLHF,0,1,1,1
TRBV7-2,TRBJ1-1,CASSFRRLGNTEAFF,0,1,1,1
TRBV7-9,TRBJ2-4,CASSLPPRFGNIQYF,0,1,1,1
TRBV5-6,TRBJ2-1,CASSLASGPYNEQFF,0,1,1,1
TRBV5-4,TRBJ1-1,CASSLGLPKFAEAFF,0,1,1,1
TRBV5-4,TRBJ2-1,CASSLGGRGYNEQFF,0,1,1,1
TRBV7-2,TRBJ2-7,CASSLGTSGVYEQYF,0,1,1,1
TRBV5-4,TRBJ1-5,CASSLDQAPNQPQHF,0,1,1,1
TRBV5-5,TRBJ1-3,CASSLNTPRGNTIYF,0,1,1,1
TRBV7-3,TRBJ2-3,CASSLAGVVGDTQYF,0,1,1,1
TRBV7-2,TRBJ1-1,CASSLAMNMNTEAFF,0,1,1,1
TRBV7-2,TRBJ2-7,CASSLDSRQIYEQYF,0,1,1,1
TRBV7-2,TRBJ2-5,CASSLDSGGAETQYF,0,1,1,1
TRBV11-2,TRBJ2-3,CASSLRGTEADTQYF,0,1,1,1
TRBV7-2,TRBJ2-7,CASSSLQGPPYEQYF,0,1,1,1
TRBV11-3,TRBJ2-2,CASSSTGPNTGELFF,0,1,1,1
TRBV7-3,TRBJ2-1,CASSLAGAEYNEQFF,0,1,1,1
TRBV3-1,TRBJ1-1,CASSPGGGASTEAFF,0,1,1,1
TRBV7-3,TRBJ2-3,CASSPGLAGTDTQYF,0,1,1,1
TRBV2,TRBJ1-4,CASSPRRGTNEKLFF,0,1,1,1
TRBV4-2,TRBJ2-1,CASSHGTRGYNEQFF,0,1,1,1
TRBV6-4,TRBJ1-2,CASSHRDRGADGYTF,0,1,1,1
TRBV3-1,TRBJ2-7,CASSQVKGTAYEQYF,0,1,1,1
TRBV3-1,TRBJ1-1,CASSQAGQGRTEAFF,0,2,1,2
TRBV7-2,TRBJ2-4,CASSQDGTQLNIQYF,0,1,1,1
TRBV14,TRBJ1-6,CASSQEGGQNSPLHF,0,1,1,1
TRBV14,TRBJ2-7,CASSQRAWGAYEQYF,0,1,1,1
TRBV3-1,TRBJ2-3,CASSQAGAGGDTQYF,0,1,1,1
TRBV9,TRBJ2-3,CASSVVERATDTQYF,0,1,1,1
TRBV7-9,TRBJ1-2,CASSGDTGINYGYTF,0,1,1,1
TRBV7-9,TRBJ2-1,CASSTGTSGHNEQFF,0,1,1,1
TRBV7-6,TRBJ1-2,CASRLEGQFLNGYTF,0,1,1,1
TRBV12-3/4,TRBJ2-3,CASRPAGVSTDTQYF,0,2,1,2
TRBV12-3/4,TRBJ2-1,CASRGGTGGRWEQFL,0,1,1,1
TRBV7-9,TRBJ2-5,CASRLPLPTQETQYF,0,1,1,1
TRBV2,TRBJ2-1,CAREHTGAGGNEQFF,0,1,1,1
TRBV28,TRBJ2-7,CAATAAGGLSYEQYF,0,1,1,1
TRBV5-1,TRBJ1-4,CASSFSRRTNEKLFF,0,1,1,1
TRBV5-1,TRBJ2-3,CASSFDRASTDTQYF,0,1,1,1
TRBV5-1,TRBJ1-6,CASSLVTGRDSPLHF,0,1,1,1
TRBV5-1,TRBJ2-1,CASSLAPGSYNEQFF,0,1,1,1
TRBV5-1,TRBJ1-5,CASSSGTGLSQPQHF,0,1,1,1
TRBV4-3,TRBJ2-2,CASSLRGANTGELFF,0,1,1,1
TRBV5-8,TRBJ2-1,CASSKRTSDQDEQFF,0,1,1,1
TRBV10-2,TRBJ1-5,CASRSDRGVGQPQHF,0,1,1,1
TRBV4-1,TRBJ2-7,CASRQVEGSSYEQYF,0,1,1,1
TRBV20-1,TRBJ1-2,CSALEGPGGNYGYTF,0,1,1,1
TRBV20-1,TRBJ2-1,CSAPNSGSGYNEQFF,0,1,1,1
TRBV20-1,TRBJ2-7,CSAENREMGIYEQYF,0,1,1,1
TRBV20-1,TRBJ2-3,CSASLAHSSTDTQYF,0,1,1,1
TRBV20-1,TRBJ2-7,CSARGGKTATYEQYF,0,1,1,1
TRBV20-1,TRBJ2-5,CSARGIRGQQETQYF,0,1,1,1
TRBV20-1,TRBJ2-3,CSARGSSGSSDTQYF,0,1,1,1
TRBV20-1,TRBJ2-2,CSARDLAGDTGELFF,0,2,1,2
TRBV20-1,TRBJ1-1,CSARDLDKQNTEASF,0,1,1,1
TRBV29-1,TRBJ2-3,CSVESQRRNTDTQYF,0,1,1,1
TRBV29-1,TRBJ2-1,CSVEPLGVSYNEQFF,0,1,1,1
TRBV29-1,TRBJ2-5,CSVEGTRDRGQTQYF,0,1,1,1
TRBV29-1,TRBJ1-4,CSVEGTGGVNEKLFF,0,1,1,1
TRBV29-1,TRBJ1-4,CSVEDGDRGPYELFF,0,1,1,1
TRBV29-1,TRBJ1-5,CSVNEGEGADQPQHF,0,1,1,1
TRBV12-5,TRBJ1-4,CASGLGEGQGRLFF,0,1,1,1
TRBV12-5,TRBJ1-1,CASGYTVKNTEAFF,0,1,1,1
TRBV30,TRBJ2-3,CAWIPQGKRGRQYF,0,1,1,1
TRBV7-2,TRBJ2-5,CAVGEGASHETQYF,0,1,1,1
TRBV10-3,TRBJ1-1,CAIRLMAANTEAFF,0,1,1,1
TRBV10-3,TRBJ1-2,CAISRNPRRGGYTF,0,1,1,1
TRBV15,TRBJ2-7,CATSSRTGLDEQYF,0,1,1,1
TRBV15,TRBJ2-7,CATSREGTGREQYF,0,1,1,1
TRBV27,TRBJ1-2,CASSGTNTFYGYTF,0,1,1,1
TRBV19,TRBJ2-2,CASSYNRDTGELFF,0,1,1,1
TRBV19,TRBJ2-7,CASSLAVRSYEQYF,0,1,1,1
TRBV19,TRBJ2-3,CASSVLGAQDTQYF,0,1,1,1
TRBV19,TRBJ1-2,CASSIQRTVGGYTF,0,1,1,1
TRBV19,TRBJ1-1,CASSTQGGTTEAFF,0,1,1,1
TRBV19,TRBJ2-7,CASSHSGRAHEQYF,0,1,1,1
TRBV6-2/3/5/6,TRBJ1-4,CASSFWTENEKLFF,0,1,1,1
TRBV18,TRBJ1-5,CASSPRSGNQPQHF,0,1,1,1
TRBV12-3/4,TRBJ1-6,CASRPNGANSPLHF,0,1,1,1
TRBV13,TRBJ2-7,CASHAGTDAYEQYF,0,1,1,1
TRBV6-1,TRBJ2-4,CASGAFVAKNIQYF,0,1,1,1
TRBV6-2/3/5/6,TRBJ1-6,CASGPGQSSSPLHF,0,1,1,1
TRBV6-4,TRBJ2-3,CASGLAGVSDTQYF,0,1,1,1
TRBV6-1,TRBJ1-1,CASGSTGKNTEAFF,0,1,1,1
TRBV27,TRBJ2-5,CASTPGDNRETQYF,0,1,1,1
TRBV12-3/4,TRBJ2-1,CASSFSASGYEQFF,0,1,1,1
TRBV12-3/4,TRBJ1-5,CASSFSGNGQPQHF,0,1,1,1
TRBV27,TRBJ2-7,CASSFGTDIGEQYF,0,1,1,1
TRBV27,TRBJ2-1,CASSLTQSATEQFF,0,1,1,1
TRBV27,TRBJ1-2,CASSLRHRGGGYTF,0,1,1,1
TRBV2,TRBJ1-5,CASSLDRGNQPQHF,0,1,1,1
TRBV27,TRBJ1-1,CASSSLQGNTEAFF,0,1,1,1
TRBV6-2/3/5/6,TRBJ2-2,CASSSVRTTGELFF,0,1,1,1
TRBV6-2/3/5/6,TRBJ2-3,CASSWTRITDTQYF,0,1,1,1
TRBV12-3/4,TRBJ1-5,CASSPLDSNQPQHF,0,1,1,1
TRBV6-2/3/5/6,TRBJ2-7,CASSPGQGGYEQYF,0,1,1,1
TRBV6-2/3/5/6,TRBJ1-2,CASSPDRANYGYTF,0,1,1,1
TRBV2,TRBJ2-5,CASSEDRDIETQYF,0,1,1,1
TRBV2,TRBJ2-1,CASSEPLAGVLQFS,0,1,1,1
TRBV6-1,TRBJ2-7,CASSEGAYNDEQYF,0,1,1,1
TRBV2,TRBJ2-2,CASSENPWSGELFF,0,1,1,1
TRBV19,TRBJ2-5,CASSTTRGGETQYF,0,1,1,1
TRBV6-2/3/5/6,TRBJ1-6,CASSRDRGSSPLHF,0,1,1,1
TRBV7-3,TRBJ2-3,CASSFTGFTDTQYF,0,1,1,1
TRBV7-2,TRBJ1-2,CASSFRGVDYGYTF,0,1,1,1
TRBV7-3,TRBJ1-6,CASSFRVKGSPLHF,0,1,1,1
TRBV5-5,TRBJ1-5,CASSLGVMGQPQHF,0,1,1,1
TRBV7-2,TRBJ1-1,CASSLTGMNTEAFF,0,1,1,1
TRBV7-2,TRBJ1-1,CASSLYSRGIEAFF,0,1,1,1
TRBV7-9,TRBJ2-3,CASSLGISQDTQYF,0,1,1,1
TRBV7-9,TRBJ1-2,CASSLEGLSGGYTF,0,1,1,1
TRBV7-8,TRBJ2-1,CASSLSRDYNEQFF,0,1,1,1
TRBV12-3/4,TRBJ2-5,CASSSGSHQETQYF,0,1,1,1
TRBV7-9,TRBJ2-3,CASSSSGIRDTQYF,0,1,1,1
TRBV5-4,TRBJ1-1,CASSWRGLGTEAFF,0,2,1,2
TRBV11-2,TRBJ1-1,CASSWGKMNTEAFF,0,1,1,1
TRBV7-9,TRBJ2-1,CASSLSGSGNEQFF,0,1,1,1
TRBV3-1,TRBJ1-4,CASSLGRGREKLFF,0,1,1,1
TRBV11-3,TRBJ2-3,CASSPRLGEDTQYF,0,1,1,1
TRBV11-1,TRBJ2-2,CASSPSGNTGELFF,0,1,1,1
TRBV13,TRBJ1-4,CASSPRRINEKLFF,0,1,1,1
TRBV9,TRBJ2-5,CASSPRFEGETQYF,0,1,1,1
TRBV12-3/4,TRBJ1-4,CASSPRTGGEKLFF,0,1,1,1
TRBV27,TRBJ1-5,CASSPGTVVQPQHF,0,1,1,1
TRBV11-2,TRBJ2-5,CASSPTGGQETQYF,0,1,1,1
TRBV5-6,TRBJ1-1,CASSPRSLGTEAFF,0,1,1,1
TRBV12-3/4,TRBJ2-7,CASSRAGNSYEQYF,0,1,1,1
TRBV9,TRBJ1-5,CASSRGQGDQPQHF,0,2,1,2
TRBV5-6,TRBJ2-1,CASSHGLDALEQFF,0,1,1,1
TRBV7-9,TRBJ1-3,CASSQNLVGNTIYF,0,1,1,1
TRBV3-1,TRBJ1-4,CASSQDQDNEKLFF,0,1,1,1
TRBV3-1,TRBJ2-1,CASSQDFSYNEQFF,0,1,1,1
TRBV3-1,TRBJ2-5,CASSQDRGRETQYF,0,1,1,1
TRBV7-6,TRBJ1-5,CASSATGDTQPQHF,0,1,1,1
TRBV7-9,TRBJ2-7,CASSETGPAYEQYF,0,1,1,1
TRBV6-1,TRBJ2-1,CASSEAGVDNEQFF,0,1,1,1
TRBV5-6,TRBJ2-1,CASSTIYSYNEQFF,0,1,1,1
TRBV7-9,TRBJ2-7,CASSTGSLTYEQYF,0,1,1,1
TRBV12-3/4,TRBJ2-7,CASRSGGQGYEQYF,0,1,1,1
TRBV5-6,TRBJ2-5,CASRSPGQGETQYF,0,1,1,1
TRBV6-2/3/5/6,TRBJ2-7,CASRPGGALIEQYF,0,1,1,1
TRBV6-2/3/5/6,TRBJ2-7,CASKSTSSLYEQYF,0,1,1,1
TRBV12-3/4,TRBJ1-5,CTSSFTQGAQPQHF,0,1,1,1
TRBV5-1,TRBJ2-7,CASSLTSGGYEQYF,0,1,1,1
TRBV5-1,TRBJ1-1,CASSLRGDGTEAFF,0,1,1,1
TRBV4-3,TRBJ2-1,CASSLMGTYNEQFF,0,1,1,1
TRBV4-1,TRBJ1-1,CASSRRSMNTEAFF,0,1,1,1
TRBV4-1,TRBJ1-2,CASSQAPGAGGYTF,0,1,1,1
TRBV4-1,TRBJ2-5,CASSQEQGRETQYF,0,1,1,1
TRBV5-1,TRBJ1-1,CASSRSDRNTEAFF,0,1,1,1
TRBV20-1,TRBJ2-1,CSASGQGGRSEQFF,0,1,1,1
TRBV20-1,TRBJ1-5,CSASRGRGNQPQHF,0,1,1,1
TRBV20-1,TRBJ2-5,CSARVSGSLETQYF,0,1,1,1
TRBV20-1,TRBJ1-5,CSARAPGRDQPQHF,0,1,1,1
TRBV20-1,TRBJ2-1,CSARDSAGDHEQFF,0,1,1,1
TRBV20-1,TRBJ2-5,CSARDPGGRETQYF,0,1,1,1
TRBV20-1,TRBJ2-5,CSANVLAGEETQYF,0,1,1,1
TRBV20-1,TRBJ1-1,CSARWGGVNTEAFF,0,1,1,1
TRBV29-1,TRBJ2-3,CSAVRPASTDTQYF,0,1,1,1
TRBV20-1,TRBJ1-3,CSAEPGSSGNTIYF,0,1,1,1
TRBV29-1,TRBJ2-6,CSVVFTGGANVLTF,0,1,1,1
TRBV29-1,TRBJ1-4,CSVGQGATNEKLFF,0,1,1,1
TRBV29-1,TRBJ1-2,CSVGTGTENYGYTF,0,1,1,1
TRBV29-1,TRBJ2-3,CSVDFGSTTDTQYF,0,1,1,1
TRBV29-1,TRBJ2-7,CSVDLRGRGNEQYF,0,1,1,1
TRBV29-1,TRBJ1-2,CSVDLGGHIYGYTF,0,1,1,1
TRBV29-1,TRBJ2-3,CSVEVTGGSDTQYF,0,1,1,1
TRBV29-1,TRBJ2-3,CSVEGLESTDTQYF,0,1,1,1
TRBV29-1,TRBJ1-2,CSVEVGQPTYGYTF,0,1,1,1
TRBV29-1,TRBJ2-5,CSVETSGSYETQYF,0,1,1,1
TRBV29-1,TRBJ1-5,CSVGGQSSNQPQHF,0,1,1,1
TRBV29-1,TRBJ2-2,CSATGGLNTGELFF,0,1,1,1
TRBV29-1,TRBJ2-7,CSARTGSSSYEQYF,0,1,1,1
TRBV20-1,TRBJ1-5,CSGQGEIGNQPQHF,0,1,1,1
TRBV20-1,TRBJ2-1,RSARSSRGVNEQFF,0,1,1,1
TRBV18,TRBJ1-1,SASSPEGDSTEAFF,0,1,1,1
TRBV5-4,TRBJ1-1,CAASSLGHLEAFF,0,1,1,1
TRBV24-1,TRBJ1-2,CATSDSTGYGYTF,0,1,1,1
TRBV15,TRBJ1-6,CATSPGTLSPLHF,0,1,1,1
TRBV12-3/4,TRBJ2-1,CATRGGSGRGQFF,0,1,1,1
TRBV19,TRBJ1-4,CASSFGQGEKLFF,0,1,1,1
TRBV19,TRBJ1-1,CASSIALLELPFF,0,1,1,1
TRBV19,TRBJ1-1,CASSTTPGQRAFF,0,1,1,1
TRBV18,TRBJ2-1,CASSSQGAGEQFF,0,1,1,1
TRBV18,TRBJ2-5,CASSPPGQETQYF,0,1,1,1
TRBV5-6,TRBJ1-1,CASISWDTTEAFF,0,1,1,1
TRBV12-3/4,TRBJ2-4,CASTLGRGNIQYF,0,1,1,1
TRBV7-9,TRBJ1-1,CASTPAGDTEAFF,0,1,1,1
TRBV12-3/4,TRBJ1-6,CASTRGFNSPLHF,0,1,1,1
TRBV5-6,TRBJ1-2,CASTRDRLYSYTF,0,1,1,1
TRBV2,TRBJ2-7,CASTESGLYEQYF,0,1,1,1
TRBV12-3/4,TRBJ2-1,CASSFSGPNEQFF,0,1,1,1
TRBV6-2/3/5/6,TRBJ1-2,CASSFKANYGYTF,0,1,1,1
TRBV6-2/3/5/6,TRBJ2-3,CASSFRDRDTQYF,0,1,1,1
TRBV12-3/4,TRBJ1-5,CASSFRGWQPQHF,0,1,1,1
TRBV27,TRBJ2-5,CASSLSIKSTQYF,0,1,1,1
TRBV12-3/4,TRBJ2-2,CASSLLGGGELFF,0,2,1,2
TRBV12-3/4,TRBJ1-2,CASSLASAAGYTF,0,1,1,1
TRBV12-3/4,TRBJ2-7,CASSLGLPYEQYF,0,1,1,1
TRBV12-3/4,TRBJ1-1,CASSWTEFTEAFF,0,1,1,1
TRBV5-6,TRBJ1-5,CASSRGANQPQHF,0,1,1,1
TRBV6-4,TRBJ1-6,CASSVRENSPLHF,0,1,1,1
TRBV6-1,TRBJ2-3,CASSVSGGYTQYF,0,1,1,1
TRBV6-1,TRBJ1-1,CASSAGPRVSAFF,0,1,1,1
TRBV2,TRBJ2-5,CASSEGGVETQYF,0,1,1,1
TRBV25-1,TRBJ1-2,CASSEEWVYGYTF,0,1,1,1
TRBV6-2/3/5/6,TRBJ1-5,CASSRTGYQPQHF,0,1,1,1
TRBV5-4,TRBJ2-2,CASSLAPAGELFF,0,2,1,2
TRBV5-5,TRBJ2-7,CASSLGLGYEQYF,0,1,1,1
TRBV7-2,TRBJ2-7,CASSLASGYEQYF,0,2,1,2
TRBV7-2,TRBJ1-1,CASSLAGRSEAFF,0,1,1,1
TRBV7-2,TRBJ1-5,CASSLGVEKPQHF,0,1,1,1
TRBV6-2/3/5/6,TRBJ1-1,CASSLDPGVEAFF,0,1,1,1
TRBV7-2,TRBJ1-1,CASSLDRGRSAFF,0,1,1,1
TRBV7-3,TRBJ2-5,CASSSGHPDFQYF,0,1,1,1
TRBV5-4,TRBJ2-7,CASSPRDTYEQYF,0,1,1,1
TRBV4-2,TRBJ2-7,CASSPERTYEQYF,0,1,1,1
TRBV14,TRBJ2-1,CASSPQGMGEQFF,0,1,1,1
TRBV7-9,TRBJ1-5,CASSRTTNQPQHF,0,1,1,1
TRBV3-1,TRBJ2-7,CASSHAQAYEQYF,0,1,1,1
TRBV7-9,TRBJ1-1,CASSQGLRTEAFF,0,1,1,1
TRBV3-1,TRBJ1-1,CASSQVPQTEAFF,0,1,1,1
TRBV3-1,TRBJ1-1,CASSQGANTEAFF,0,1,1,1
TRBV7-9,TRBJ2-7,CASSVGTIDEQYF,0,1,1,1
TRBV9,TRBJ1-5,CASSGADSQPQHF,0,1,1,1
TRBV5-6,TRBJ2-7,CASSGGISYEQYF,0,1,1,1
TRBV12-3/4,TRBJ2-7,CASSRQYSYEQYF,0,1,1,1
TRBV6-4,TRBJ1-2,CASRLTGSDGYTF,0,1,1,1
TRBV2,TRBJ1-4,CASRGSSNEKLFF,0,1,1,1
TRBV28,TRBJ2-5,CASRGQGQETQYF,0,1,1,1
TRBV6-4,TRBJ2-5,CASRDRSRETQYF,0,1,1,1
TRBV6-2/3/5/6,TRBJ2-2,CASRPGGAGELFF,0,1,1,1
TRBV6-1,TRBJ2-3,CASREGPTDTQYF,0,1,1,1
TRBV6-1,TRBJ1-1,CASRERGSTEAFF,0,1,1,1
TRBV6-2/3/5/6,TRBJ1-2,CASNRSGHYGYTF,0,1,1,1
TRBV7-9,TRBJ1-1,CASKGRLNTEAFF,0,1,1,1
TRBV7-9,TRBJ1-6,CASKRSYNSPLHF,0,1,1,1
TRBV12-3/4,TRBJ2-5,CASKTSSQETQYF,0,1,1,1
TRBV10-2,TRBJ2-5,CASTAILQETQYF,0,1,1,1
TRBV5-1,TRBJ2-3,CASSSTGADTQYF,0,1,1,1
TRBV4-3,TRBJ2-1,CASSQDNYNEQFF,0,1,1,1
TRBV5-1,TRBJ1-2,CASSAGTENGYTF,0,1,1,1
TRBV20-1,TRBJ2-5,CSASSGGGETQYF,0,1,1,1
TRBV20-1,TRBJ2-4,CSASLPVGDIQYF,0,1,1,1
TRBV20-1,TRBJ2-4,CSARGGAKNIQYF,0,1,1,1
TRBV20-1,TRBJ2-1,CSARDTGGNEQFF,0,2,1,2
TRBV20-1,TRBJ1-2,CSARDSLNDGYTF,0,1,1,1
TRBV20-1,TRBJ2-7,CSAPPTGSIEQYF,0,1,1,1
TRBV20-1,TRBJ2-7,CSAPIKKPHEQYF,0,1,1,1
TRBV29-1,TRBJ2-3,CSVDRGGTDTQYF,0,1,1,1
TRBV29-1,TRBJ2-1,CSVEEGTLNEQFF,0,1,1,1
TRBV29-1,TRBJ2-1,CSVEDRVLSEQFF,0,1,1,1
TRBV29-1,TRBJ2-5,CSVIGTVRETQYF,0,2,1,2
TRBV29-1,TRBJ2-1,CSVKTSGRFEQFF,0,1,1,1
TRBV29-1,TRBJ1-1,CSVVGGLGTEAFF,0,1,1,1
TRBV29-1,TRBJ2-7,CSVVGQGAYEQYF,0,1,1,1
TRBV29-1,TRBJ2-7,CSVRNPSSYEQYF,0,1,1,1
TRBV29-1,TRBJ2-5,CSVKTSPQEAQYF,0,1,1,1
TRBV29-1,TRBJ2-1,CSVRLGPLNEQFF,0,1,1,1
TRBV30,TRBJ2-7,CAWGHETYEQYF,0,1,1,1
TRBV30,TRBJ2-5,CAWSGGWETQYF,0,1,1,1
TRBV19,TRBJ2-1,CASSIRYNEQFF,0,1,1,1
TRBV19,TRBJ2-5,CASSTSEETQYF,0,1,1,1
TRBV2,TRBJ2-7,CASGRQAGEQYF,0,1,1,1
TRBV6-2/3/5/6,TRBJ2-1,CASTFSLGEQFF,0,1,1,1
TRBV18,TRBJ2-1,CASTSGLDEQFF,0,1,1,1
TRBV2,TRBJ2-5,CASTTGRETQYF,0,1,1,1
TRBV6-2/3/5/6,TRBJ1-1,CASSFTGVEAFF,0,1,1,1
TRBV12-3/4,TRBJ2-7,CASSLVGTEQYF,0,1,1,1
TRBV5-5,TRBJ2-3,CASSLDADTQYF,0,1,1,1
TRBV7-2,TRBJ2-7,CASSFRSYEQYF,0,1,1,1
TRBV5-4,TRBJ2-3,CASSLSTDTQYF,0,2,1,2
TRBV7-9,TRBJ1-2,CASSLALSGYTF,0,1,1,1
TRBV7-9,TRBJ1-1,CASSLAGYGAFF,0,1,1,1
TRBV11-2,TRBJ2-2,CASSLDRGELFF,0,1,1,1
TRBV18,TRBJ1-4,CASSRGNEKLFF,0,2,1,2
TRBV3-1,TRBJ2-2,CASSRLGGELFF,0,1,1,1
TRBV7-2,TRBJ2-7,CASSRGPYEQYF,0,1,1,1
TRBV3-1,TRBJ2-1,CASSQARSEQFF,0,1,1,1
TRBV12-3/4,TRBJ1-1,CASRTGATEAFF,0,1,1,1
TRBV6-2/3/5/6,TRBJ2-7,CASRRGVYEQYF,0,1,1,1
TRBV5-1,TRBJ2-3,CASSFSTDTLYF,0,1,1,1
TRBV5-1,TRBJ2-7,CASSSTGNEQYF,0,1,1,1
TRBV20-1,TRBJ2-7,CSAERTGHEQYF,0,1,1,1
TRBV20-1,TRBJ2-3,CSASLHTDTQYF,0,1,1,1
TRBV20-1,TRBJ1-2,CSASPTGYGYTF,0,1,1,1
TRBV20-1,TRBJ1-1,CSASGTGVEAFF,0,1,1,1
TRBV20-1,TRBJ2-1,CSASGSRSEQFF,0,1,1,1
TRBV20-1,TRBJ2-7,CSARTDPYEQYF,0,1,1,1
TRBV29-1,TRBJ2-7,CSVAGNSYEQYF,0,1,1,1
TRBV29-1,TRBJ2-5,CSVERGGETQYF,0,1,1,1
TRBV29-1,TRBJ1-1,CSVEFGNTEAFF,0,1,1,1
TRBV29-1,TRBJ2-7,CSVELGTYEQYF,0,1,1,1
TRBV29-1,TRBJ2-3,CSVEWDLDTQYF,0,1,1,1
TRBV29-1,TRBJ2-1,CSVETRRNEQFF,0,1,1,1
TRBV29-1,TRBJ1-4,CSAAGGGEKLFF,0,1,1,1
TRBV29-1,TRBJ2-2,CSGLSRAGELFF,0,1,1,1
TRBV29-1,TRBJ1-2,CSDTTGGYGYTF,0,1,1,1
TRBV14,TRBJ1-1,CAIRGAGGTFF,0,1,1,1
TRBV14,TRBJ2-1,CASSVRSEQFF,0,2,1,2
TRBV12-3/4,TRBJ2-3,CASSSSDTQYF,0,1,1,1
TRBV6-1,TRBJ1-5,CASSGNQPQHF,0,1,1,1
TRBV12-3/4,TRBJ2-7,CASSTYYEQYF,0,1,1,1
TRBV6-2/3/5/6,TRBJ2-3,CASSSTDTQYF,0,1,1,1
TRBV5-4,TRBJ2-1,CASSLAYEQFF,0,1,1,1
TRBV12-3/4,TRBJ1-3,CASSPSDTIYF,0,1,1,1
TRBV20-1,TRBJ2-7,CSARASYEQYF,0,1,1,1
TRBV20-1,TRBJ2-3,CSARSKDTQYF,0,1,1,1
TRBV20-1,TRBJ2-1,CSARAGGGQFF,0,1,1,1
TRBV29-1,TRBJ2-7,CSVEDVHEQYF,0,1,1,1
TRBV29-1,TRBJ1-1,CSGSLGNRPLF,0,1,1,1
TRBV9,TRBJ2-1,CASSPNEQFF,0,1,1,1
TRBV29-1,TRBJ2-1,CSVDTRGEFF,0,1,1,1
TRBV20-1,TRBJ2-2,CREDTGELFF,0,1,1,1
TRBV29-1,TRBJ1-5,CTKRPQHF,0,1,1,1
TRBV12-5,TRBJ2-7,CASGLVLNRGHPYEQYF,0,1,1,1
TRBV4-3,TRBJ2-2,CASSQDLRLANTGELFF,0,1,1,1
TRBV10-3,TRBJ1-5,CAISEFGDRNQPQHF,0,1,1,1
TRBV7-2,TRBJ2-1,CASSFGPTMGNEQFF,0,1,1,1
TRBV7-2,TRBJ2-2,CASSLDGGVTGELFF,0,1,1,1
TRBV6-1,TRBJ1-5,CTSSKNRGRDQPQHF,0,1,1,1
TRBV4-3,TRBJ1-4,CASSQDYRGEKLFF,0,1,1,1
TRBV2,TRBJ1-6,CASSGTISSPLHF,0,1,1,1
TRBV29-1,TRBJ2-4,CSIRDYRNIQYF,0,2,1,2
TRBV19,TRBJ1-6,CASSSPDDHF,0,1,1,1
TRBV7-9,TRBJ1-5,FASSYGTGGLNQPQHF,0,1,1,1
TRBV15,TRBJ1-5,CATSVGPINQPQHF,0,1,1,1
TRBV6-2/3/5/6,TRBJ2-3,CASSNSGTSDTQYF,0,1,1,1
TRBV9,TRBJ1-1,CASSVGGVRTEAFL,0,1,1,1
TRBV4-2,TRBJ1-5,CASSRGQGNQPQHF,0,1,1,1
TRBV14,TRBJ2-5,CASSRDNGETQYF,0,2,1,2
TRBV5-4,TRBJ2-7,CASSKGTSGSIYEQYF,0,1,1,1
TRBV5-8,TRBJ2-5,CASSLGGGVEETQYF,0,1,1,1
TRBV25-1,TRBJ1-5,CAGDGAGGNQPQHF,0,1,1,1
TRBV5-5,TRBJ2-5,CASSLGTLEAQYF,0,1,1,1
TRBV20-1,TRBJ1-6,CSAIELPGTGPNNSPLHF,0,1,1,1
TRBV5-6,TRBJ2-3,CASSADRGRSTDTQYF,0,1,1,1
TRBV2,TRBJ1-5,CASSEWLDSNQPQHF,0,1,1,1
TRBV20-1,TRBJ2-3,CSADGEAGTLADTQYF,0,1,1,1
TRBV5-1,TRBJ1-2,CASKWADRGIYGYTF,0,1,1,1
TRBV7-2,TRBJ2-3,CASSLDHFGLASDRGTDTQYI,0,1,1,1
TRBV19,TRBJ1-5,CASSISPPGQGLGGNQPQHF,0,1,1,1
TRBV27,TRBJ2-1,CASSLPTGVTGTTNSNEQFF,0,1,1,1
TRBV6-2/3/5/6,TRBJ2-2,CASSYADRPVTGINTGELFF,0,1,1,1
TRBV30,TRBJ2-1,CALHPSGGSAAQGYNERFF,0,1,1,1
TRBV19,TRBJ1-1,CASSISFWRQTSLNTEAFF,0,1,1,1
TRBV19,TRBJ2-2,CASSIGGGPFQANTGELFF,0,1,1,1
TRBV6-2/3/5/6,TRBJ2-4,CASFDRVQDLPLAKNIQYF,0,1,1,1
TRBV12-3/4,TRBJ1-2,CASIEGPWGRGHEENGYTF,0,1,1,1
TRBV6-2/3/5/6,TRBJ2-6,CASSLDGPWSNSGANVLTF,0,1,1,1
TRBV11-2,TRBJ2-1,CASSLERTGTSGRWGEQFF,0,1,1,1
TRBV5-6,TRBJ2-3,CASSPTKFWLAGGTDTQYF,0,1,1,1
TRBV14,TRBJ2-7,CASSHWSGQGARSLYEQYF,0,1,1,1
TRBV5-1,TRBJ2-3,CASSYKWDGRDVRADTQYF,0,1,1,1
TRBV5-1,TRBJ2-1,CASSIGLAGLVKNYNEQFF,0,1,1,1
TRBV29-1,TRBJ2-1,CSVETRTAKRFYVNNEQFF,0,1,1,1
TRBV12-5,TRBJ1-1,CASGLVRDRGALNTEAFF,0,1,1,1
TRBV18,TRBJ2-1,CASSPVPPGLAGYGEQFF,0,1,1,1
TRBV6-2/3/5/6,TRBJ2-1,CASTLSVAGLPVYNEQFF,0,1,1,1
TRBV6-2/3/5/6,TRBJ2-1,CASSLSQVAGGPNNEQFF,0,1,1,1
TRBV6-2/3/5/6,TRBJ2-1,CASSYSERGTSSYNEQFF,0,1,1,1
TRBV6-2/3/5/6,TRBJ2-3,CASSYSPWTGHRTDTQYF,0,1,1,1
TRBV13,TRBJ1-2,CASSPPSVQRQPSYGYTF,0,1,1,1
TRBV7-2,TRBJ1-2,CASSLGGQANSFWDGYTF,0,1,1,1
TRBV7-2,TRBJ2-3,CASSLASLAGWSTDTQYF,0,1,1,1
TRBV11-1,TRBJ2-1,CASSLGGRQGFIYNEQFF,0,1,1,1
TRBV5-6,TRBJ2-2,CASSSHLMGQGINGELFF,0,1,1,1
TRBV5-5,TRBJ2-3,CASSPGTSGSWESDTQYF,0,1,1,1
TRBV12-3/4,TRBJ2-5,CASSRTIRRDTLKETQYF,0,1,1,1
TRBV6-2/3/5/6,TRBJ2-1,CASSHRGGSLLSYNEQFF,0,1,1,1
TRBV3-1,TRBJ2-1,CASSQGLAGGQTYNEQFF,0,1,1,1
TRBV6-2/3/5/6,TRBJ1-6,CASSAPDKTNSYNSPLHF,0,1,1,1
TRBV5-1,TRBJ2-1,CASSLASAGDPLINEQFF,0,1,1,1
TRBV4-3,TRBJ2-5,CASSQGLSREGLIETQYF,0,1,1,1
TRBV20-1,TRBJ2-7,CSASWTSGSLFPPYEQYF,0,1,1,1
TRBV20-1,TRBJ1-5,CSARGLGQGVSSNQPQHF,0,1,1,1
TRBV29-1,TRBJ2-1,CSGIGTSGGRNSYNEQFF,0,1,1,1
TRBV13,TRBJ2-7,SASSPSRPASGDSYEQYF,0,1,1,1
TRBV30,TRBJ1-2,CAWSAPDNSRRGYGYTF,0,1,1,1
TRBV15,TRBJ2-1,CATSRDIAGGNYNEQFF,0,1,1,1
TRBV19,TRBJ1-5,CASSSPGRDRGNQPQHF,0,1,1,1
TRBV19,TRBJ2-1,CASSIRPLAGGFNEQFF,0,1,1,1
TRBV19,TRBJ2-4,CASSQLAGEEAKNTQYF,0,1,1,1
TRBV6-2/3/5/6,TRBJ1-2,CASTFLTGQGTNYGYTF,0,1,1,1
TRBV28,TRBJ2-1,CASSFIVGTVEDDEQFF,0,1,1,1
TRBV6-2/3/5/6,TRBJ1-1,CASSFTLGMGGYTEAFF,0,1,1,1
TRBV12-3/4,TRBJ2-7,CASSLAIYSGRGYEQYF,0,2,1,2
TRBV6-4,TRBJ2-1,CASSGSTSGSSYNEQFF,0,1,1,1
TRBV2,TRBJ2-1,CASSGGLAGGNYNEQFF,0,1,1,1
TRBV6-1,TRBJ2-4,CASSEKWAIPAKNIQYF,0,1,1,1
TRBV6-2/3/5/6,TRBJ2-7,CASSTGASGTGIYEQYF,0,1,1,1
TRBV7-6,TRBJ2-2,CASSLGGLAGRTGELFF,0,1,1,1
TRBV7-2,TRBJ1-1,CASSSFDGTVGDTEAFF,0,1,1,1
TRBV5-4,TRBJ2-1,CASSSGLAGGSYNEQFF,0,1,1,1
TRBV11-1,TRBJ2-5,CASSLMFPGFGMETQYF,0,1,1,1
TRBV11-1,TRBJ2-1,CASSLGRALALGNEQFF,0,1,1,1
TRBV12-3/4,TRBJ1-4,CASSPSGGGNVGGKLFF,0,1,1,1
TRBV7-3,TRBJ2-2,CASSPHSSGSRTGELFF,0,1,1,1
TRBV5-6,TRBJ2-7,CASSPELDRDIPYEQYF,0,1,1,1
TRBV7-2,TRBJ2-5,CASSRPGLARDAETQYF,0,1,1,1
TRBV3-1,TRBJ2-1,CASSHDPRSYSYNEQFF,0,1,1,1
TRBV5-6,TRBJ2-7,CASSQVLVWGSSYEQYF,0,1,1,1
TRBV3-1,TRBJ1-5,CASSQGAGGQGNQPQHF,0,1,1,1
TRBV14,TRBJ2-7,CASSQDRGTRDFSEQYF,0,1,1,1
TRBV4-2,TRBJ1-2,CASSQDRTFGNNYGYTF,0,1,1,1
TRBV9,TRBJ2-5,CASSVAGPSGTQETQYF,0,1,1,1
TRBV7-9,TRBJ1-4,CASSNPTAGVGDEKLFF,0,2,1,2
TRBV2,TRBJ1-4,CASRATGTGGVDEKLFF,0,1,1,1
TRBV12-3/4,TRBJ2-6,CDKWKTSGPLRANVLTF,0,1,1,1
TRBV5-1,TRBJ2-5,CASSLIFGGSPFETQYF,0,1,1,1
TRBV4-3,TRBJ1-4,CASSRTPVGGMDEKLFF,0,1,1,1
TRBV4-1,TRBJ2-1,CASSQPGATGDRNEQFF,0,1,1,1
TRBV29-1,TRBJ1-4,CSVKEFPGEATNEKLFF,0,1,1,1
TRBV12-5,TRBJ2-1,CASGLGSGGSYNEQFF,0,1,1,1
TRBV30,TRBJ2-5,CAWTDKQPMRGETQYF,0,1,1,1
TRBV10-3,TRBJ1-3,CAISESTGGWRNTIYF,0,1,1,1
TRBV24-1,TRBJ2-3,CATSVGGVGSTDTQYF,0,1,1,1
TRBV24-1,TRBJ2-2,CATSGGTVRSPGEPFF,0,1,1,1
TRBV15,TRBJ2-2,CATSSRRGSNTGELFF,0,1,1,1
TRBV15,TRBJ2-1,CATSRGTGATNNEQFF,0,1,1,1
TRBV19,TRBJ2-4,CASTMTSGVAKNIQYF,0,1,1,1
TRBV19,TRBJ1-4,CASTSGTWATNEKLFF,0,1,1,1
TRBV19,TRBJ2-6,CASSLEGTSGANVLTF,0,1,1,1
TRBV19,TRBJ2-2,CASSITSGRATGELFF,0,1,1,1
TRBV19,TRBJ2-7,CASSMDSGSVAYEQYF,0,1,1,1
TRBV19,TRBJ1-1,CASSTPGEGMNTEAFF,0,1,1,1
TRBV19,TRBJ2-1,CASSTAAGLGNNGQFF,0,1,1,1
TRBV19,TRBJ1-2,CASSSKTDYYNYGYTF,0,1,1,1
TRBV19,TRBJ1-5,CASSGWGGSFNQPQHF,0,1,1,1
TRBV19,TRBJ2-3,CASNDQGASGTDSQYF,0,1,1,1
TRBV18,TRBJ1-4,CASSPRRGTTNEKLFF,0,1,1,1
TRBV18,TRBJ2-1,CASSPPGGVIYNEQFF,0,1,1,1
TRBV7-9,TRBJ1-2,CASGPPGSEANYGYTF,0,1,1,1
TRBV6-2/3/5/6,TRBJ1-5,CASSLPLQGTNQPQHF,0,1,1,1
TRBV27,TRBJ2-1,CASSLFLAGGPREQFF,0,1,1,1
TRBV6-2/3/5/6,TRBJ2-1,CASSLWRGGSGDEQFF,0,1,1,1
TRBV12-3/4,TRBJ2-5,CASSLAGLAVQETQYF,0,1,1,1
TRBV28,TRBJ2-5,CASSLGRGGISETQYF,0,1,1,1
TRBV12-3/4,TRBJ2-3,CASSSWTATSADTQYF,0,1,1,1
TRBV27,TRBJ1-1,CASSSGGGWANTEAFF,0,1,1,1
TRBV12-3/4,TRBJ1-1,CASSSGTGVWDTEAFF,0,1,1,1
TRBV12-3/4,TRBJ1-5,CASSWGLGRGNQPQHF,0,1,1,1
TRBV6-2/3/5/6,TRBJ2-4,CASSYSQDLAKNIQYF,0,1,1,1
TRBV6-2/3/5/6,TRBJ1-6,CASSYSTGGYNSPLHF,0,1,1,1
TRBV6-2/3/5/6,TRBJ2-3,CASSYPIWYSTDTQYF,0,2,1,2
TRBV6-2/3/5/6,TRBJ1-5,CASSYTRTGPNQPQHF,0,1,1,1
TRBV12-3/4,TRBJ1-5,CASSLTGTYGNQPQHF,0,1,1,1
TRBV6-1,TRBJ2-1,CASSQRTSGKDNEQFF,0,1,1,1
TRBV2,TRBJ2-7,CASSQKDRAITYEQYF,0,1,1,1
TRBV6-4,TRBJ2-5,CASSAPGLAGQETQYF,0,1,1,1
TRBV6-1,TRBJ2-3,CASSAQDYSVLDTQYS,0,1,1,1
TRBV6-1,TRBJ1-5,CASSERGAGSNQPQHF,0,1,1,1
TRBV6-2/3/5/6,TRBJ2-4,CASSTQDLLAKNIQYF,0,1,1,1
TRBV6-2/3/5/6,TRBJ1-2,CASSTGPPDRSYGYTF,0,1,1,1
TRBV7-2,TRBJ2-3,CASSFLLAGGQDTQYF,0,1,1,1
TRBV7-8,TRBJ2-3,CASSLAEAASSDTQYF,0,1,1,1
TRBV13,TRBJ2-7,CASSLGAAGGPYEQYF,0,1,1,1
TRBV12-3/4,TRBJ2-3,CASSLEGSGNTDTQYF,0,1,1,1
TRBV7-2,TRBJ1-5,CASSLISGESNQPQHF,0,1,1,1
TRBV11-2,TRBJ2-3,CASSLNLGGGYDTQYF,0,1,1,1
TRBV5-4,TRBJ2-1,CASSLKREVSYNEQFF,0,1,1,1
TRBV6-2/3/5/6,TRBJ1-5,CASSSPLGGPHQPQHF,0,1,1,1
TRBV7-2,TRBJ2-1,CASSSSRLAGNNEQFF,0,1,1,1
TRBV5-6,TRBJ1-2,CASSWGQSQSNYGYTF,0,1,1,1
TRBV7-9,TRBJ2-1,CASSWTSGFGDNEQFF,0,1,1,1
TRBV28,TRBJ2-1,CASSLGLAGPYNEQFF,0,1,1,1
TRBV3-1,TRBJ2-2,CASSLTARGYAGELFF,0,1,1,1
TRBV3-1,TRBJ2-5,CASSLGPGLAWETQYF,0,1,1,1
TRBV5-6,TRBJ1-6,CASSPGTGGWFSPLHF,0,1,1,1
TRBV11-1,TRBJ2-1,CASSPSTGRGYNEQFF,0,1,1,1
TRBV7-9,TRBJ2-1,CASSPPDRLSYNEQFF,0,1,1,1
TRBV7-2,TRBJ2-5,CASSPRRMAGIPTQYF,0,1,1,1
TRBV27,TRBJ1-4,CASSQLPGGLNEKLFF,0,1,1,1
TRBV3-1,TRBJ2-1,CASSQGLAGPNNEQFF,0,1,1,1
TRBV3-1,TRBJ1-1,CASSQGTSMMNTEAFF,0,1,1,1
TRBV3-1,TRBJ2-7,CASSQDRGTVFYEQYF,0,1,1,1
TRBV3-1,TRBJ1-2,CASSQDARTDSYGYTF,0,1,1,1
TRBV4-2,TRBJ2-1,CASSQTRPSVGNEQFF,0,1,1,1
TRBV7-9,TRBJ2-3,CASSAPRRGGPDTQYF,0,1,1,1
TRBV5-5,TRBJ2-4,CASSAPTGGGKDIQYF,0,1,1,1
TRBV9,TRBJ1-3,CASSADGTGKGNTIYF,0,1,1,1
TRBV7-9,TRBJ2-7,CASSGIWDRSSYEQYF,0,1,1,1
TRBV5-6,TRBJ2-3,CASRWGGTSGTDTQYF,0,1,1,1
TRBV11-2,TRBJ2-3,CASRHPGRRGIDTQYF,0,1,1,1
TRBV6-4,TRBJ1-3,CANRTIQGGSGNTIYF,0,1,1,1
TRBV5-1,TRBJ2-5,CASSLVNRSLRETQYF,0,1,1,1
TRBV5-1,TRBJ2-7,CASSLVGRGSSYEQYF,0,1,1,1
TRBV5-1,TRBJ2-2,CASSLAGTGGTGELFF,0,1,1,1
TRBV5-1,TRBJ2-5,CASSLDGGAYQETQYF,0,1,1,1
TRBV5-1,TRBJ1-1,CASSSSGGAGNTEAFF,0,1,1,1
TRBV4-1,TRBJ2-7,CASSPSWAETSNEQYF,0,1,1,1
TRBV5-1,TRBJ1-1,CASSHSTGVGGTEAFF,0,1,1,1
TRBV4-3,TRBJ2-3,CASSQESGGGADTQYF,0,1,1,1
TRBV5-1,TRBJ2-1,CASSGKQGPPSNEQFF,0,1,1,1
TRBV5-1,TRBJ2-5,CASSTQQGGSSETQYF,0,1,1,1
TRBV20-1,TRBJ2-5,CSARYPGLAAQETQYF,0,1,1,1
TRBV20-1,TRBJ1-5,CSAQGGGLVSNQPQHF,0,1,1,1
TRBV20-1,TRBJ2-3,CSATQTSGRPTDTQYF,0,1,1,1
TRBV20-1,TRBJ1-3,CSATTRAVYSGNTIYF,0,1,1,1
TRBV20-1,TRBJ1-6,CSARGDRSSYNSPLHF,0,1,1,1
TRBV20-1,TRBJ2-5,CSARDQYTGGWETQYF,0,1,1,1
TRBV20-1,TRBJ2-4,CSARTQTDLDKNIQYF,0,1,1,1
TRBV29-1,TRBJ2-1,CSVEVPPGLFYNEQFF,0,1,1,1
TRBV29-1,TRBJ2-1,CSVEGQGAEQYNKQFF,0,1,1,1
TRBV29-1,TRBJ2-3,CSVEDRAAGVADTQYF,0,1,1,1
TRBV29-1,TRBJ2-1,CSAEGKTSGRLNEQFF,0,1,1,1
TRBV7-4,TRBJ2-1,RASSAASGGSYNEQFF,0,1,1,1
TRBV4-3,TRBJ2-7,RASSQGTSGSSYEQYF,0,1,1,1
TRBV12-3/4,TRBJ2-3,CVSRAGTGVPDTQYF,0,1,1,1
TRBV12-5,TRBJ1-5,CASGLTIGGAQPQHF,0,1,1,1
TRBV12-5,TRBJ1-1,CASGTRTGKNTEAFF,0,1,1,1
TRBV30,TRBJ1-1,CAWSPLGQQNTEAFF,0,1,1,1
TRBV6-2/3/5/6,TRBJ1-2,CARSYSWDLGYGYTF,0,1,1,1
TRBV10-3,TRBJ2-3,CAISGLNTVIDTQYF,0,1,1,1
TRBV10-3,TRBJ2-1,CAISDRGTGGNEQFF,0,1,1,1
TRBV10-3,TRBJ1-5,CAISEYRGGNQPQHF,0,1,1,1
TRBV10-3,TRBJ2-3,CAIRDLTPGTDTQYF,0,1,1,1
TRBV15,TRBJ1-2,CATSPGQGARYGYTF,0,1,1,1
TRBV15,TRBJ2-1,CATRSQGLAYNEQFF,0,2,1,2
TRBV5-4,TRBJ2-3,CATKISGGYTDTQYF,0,1,1,1
TRBV11-2,TRBJ2-3,CATSGGVAGTDTQYF,0,1,1,1
TRBV19,TRBJ2-1,CASSSQAGDYNEQFF,0,1,1,1
TRBV19,TRBJ1-1,CASSIAGSMNTEAFF,0,1,1,1
TRBV19,TRBJ1-2,CASSIKQGIDYGYTF,0,1,1,1
TRBV19,TRBJ2-1,CASSIDRGRPREQFF,0,1,1,1
TRBV19,TRBJ1-1,CASSPPAGENTEAFF,0,1,1,1
TRBV19,TRBJ2-5,CASSKRTGGQETQYF,0,1,1,1
TRBV19,TRBJ2-3,CASRTTSGSTDTQYF,0,1,1,1
TRBV19,TRBJ2-2,CASNEGVANTGELFF,0,1,1,1
TRBV18,TRBJ1-1,CASSPNGVMGTEAFF,0,1,1,1
TRBV18,TRBJ2-3,CASSPKRPSTDTQYF,0,1,1,1
TRBV18,TRBJ1-1,CASSPGRILNTEAFF,0,1,1,1
TRBV18,TRBJ1-1,CASSPPGGLNTEAFF,0,1,1,1
TRBV18,TRBJ2-7,CASSPRTGGGYEQYF,0,1,1,1
TRBV18,TRBJ2-7,CASSPIPLASGEQYF,0,1,1,1
TRBV18,TRBJ1-5,CASSPTTGKNQPQHF,0,1,1,1
TRBV18,TRBJ1-1,CASSQGQGSNTEAFF,0,1,1,1
TRBV18,TRBJ2-7,CASSNPGQGTYEQYF,0,1,1,1
TRBV3-1,TRBJ2-1,CASHGGPSSYNEQFF,0,1,1,1
TRBV6-2/3/5/6,TRBJ2-1,CASGQQGLTYNEQFF,0,1,1,1
TRBV6-2/3/5/6,TRBJ1-1,CASGGGLGMNTEAFF,0,1,1,1
TRBV6-2/3/5/6,TRBJ1-5,CASTRGVDGPEPQHF,0,1,1,1
TRBV5-4,TRBJ2-1,CASTFLGGRYNEQFF,0,1,1,1
TRBV12-3/4,TRBJ2-7,CASTNRDREFHEQYF,0,1,1,1
TRBV12-3/4,TRBJ2-4,CASSFETGEGGIQYF,0,1,1,1
TRBV28,TRBJ1-5,CASSLYRGGGQPQHF,0,1,1,1
TRBV12-3/4,TRBJ1-1,CASSLVAGKNTEAFF,0,1,1,1
TRBV27,TRBJ1-1,CASSLGAQGTPEAFF,0,1,1,1
TRBV6-2/3/5/6,TRBJ2-3,CASSLDFSSTDTQYF,0,1,1,1
TRBV6-2/3/5/6,TRBJ2-5,CASSSHRDSQETQYF,0,1,1,1
TRBV6-2/3/5/6,TRBJ2-1,CASSYQSGAYNEQFF,0,1,1,1
TRBV6-2/3/5/6,TRBJ1-1,CASSYIWQGPSEAFF,0,1,1,1
TRBV16,TRBJ2-7,CASSLTTGPLYEQYF,0,1,1,1
TRBV6-2/3/5/6,TRBJ2-6,CASSPVSSGANVLTF,0,1,1,1
TRBV12-3/4,TRBJ2-3,CASSPRGGRTDTQYF,0,1,1,1
TRBV28,TRBJ2-7,CASSPSGRGAPEQYF,0,1,1,1
TRBV6-2/3/5/6,TRBJ1-1,CASSPNRGPNTEAFF,0,1,1,1
TRBV7-8,TRBJ2-3,CASSRGLAEADTQYF,0,1,1,1
TRBV6-2/3/5/6,TRBJ1-4,CASSRGTGLNEKLFF,0,1,1,1
TRBV6-1,TRBJ1-1,CASSAPREMNTEAFF,0,1,1,1
TRBV28,TRBJ1-1,CASSAHKTGPPEAFF,0,1,1,1
TRBV27,TRBJ1-2,CASSGQGFLSYGYTF,0,1,1,1
TRBV25-1,TRBJ2-7,CASSDPWTGSYEQYF,0,1,1,1
TRBV6-4,TRBJ2-3,CASSDGTSDTDTQYF,0,1,1,1
TRBV25-1,TRBJ1-6,CASSEYPRGGSPLHF,0,1,1,1
TRBV6-1,TRBJ1-6,CASSEEGQRNSPLHF,0,1,1,1
TRBV28,TRBJ1-6,CASSTGQGSDSPLHF,0,1,1,1
TRBV27,TRBJ1-1,CASSTDRLMNTEAFF,0,1,1,1
TRBV12-3/4,TRBJ2-1,CASSRGLAEASEQFF,0,1,1,1
TRBV12-3/4,TRBJ2-1,CASSRGPGDCNEQFF,0,1,1,1
TRBV12-3/4,TRBJ1-5,CASSKNRGRDQPQHF,0,1,1,1
TRBV5-6,TRBJ2-1,CASSFPAGTMYEQFF,0,2,1,2
TRBV7-2,TRBJ2-1,CASSFKRGNYNGQFF,0,1,1,1
TRBV5-6,TRBJ2-6,CASSLWEFGANVLTF,0,1,1,1
TRBV7-2,TRBJ2-3,CASSLQTGAADTQYF,0,1,1,1
TRBV7-9,TRBJ1-1,CASSLVQGLGAEAFF,0,1,1,1
TRBV5-8,TRBJ2-7,CASSLAPAWSGEQYF,0,1,1,1
TRBV7-2,TRBJ1-5,CASSLGGAGGQPQHF,0,1,1,1
TRBV5-6,TRBJ1-5,CASSLGPGTNQPQHF,0,1,1,1
TRBV7-2,TRBJ2-1,CASSLDSRHLGEQFF,0,1,1,1
TRBV5-4,TRBJ2-7,CASSLKGSGGYEQYF,0,1,1,1
TRBV7-6,TRBJ1-2,CASSLFPGQSYGYTF,0,1,1,1
TRBV7-2,TRBJ2-7,CASSLLARGDYEQYF,0,1,1,1
TRBV7-2,TRBJ1-1,CASSLYLQRYTEAFF,0,1,1,1
TRBV7-9,TRBJ2-7,CASSLPSGKSYEQYF,0,1,1,1
TRBV7-6,TRBJ2-5,CASSLPRDRQETQYF,0,1,1,1
TRBV7-9,TRBJ2-5,CASSLVPEGQETQYF,0,2,1,2
TRBV7-2,TRBJ2-5,CASSLVGRDQETQYF,0,1,1,1
TRBV11-2,TRBJ2-1,CASSLVVAGGNEQFF,0,1,1,1
TRBV7-9,TRBJ1-1,CASSLAQGRNTEAFF,0,1,1,1
TRBV11-2,TRBJ1-3,CASSLAGDSGNTIYF,0,1,1,1
TRBV11-2,TRBJ2-3,CASSLAQTSTDTQCF,0,1,1,1
TRBV7-6,TRBJ2-5,CASSLAPGGQETQYF,0,1,1,1
TRBV6-2/3/5/6,TRBJ1-4,CASSLEAATNEKLFF,0,1,1,1
TRBV7-2,TRBJ1-2,CASSLEGRGHEGYTF,0,1,1,1
TRBV7-9,TRBJ1-1,CASSLEGAGSTEAFF,0,1,1,1
TRBV7-2,TRBJ1-3,CASSLETKQGNTIYF,0,1,1,1
TRBV11-3,TRBJ1-1,CASSLEGQMNTEAFF,0,1,1,1
TRBV7-2,TRBJ2-7,CASSLERQGSYEQYF,0,1,1,1
TRBV11-1,TRBJ2-6,CASSLKRAGANVLTF,0,1,1,1
TRBV7-3,TRBJ2-5,CASSSSDTPQETQYF,0,1,1,1
TRBV7-8,TRBJ2-3,CASSSLQGVTDTQYF,0,1,1,1
TRBV7-2,TRBJ2-3,CASSSLGGGTDTQYF,0,1,1,1
TRBV3-1,TRBJ2-2,CASSSRQMNTGELFF,0,1,1,1
TRBV7-6,TRBJ2-6,CASSSQGSGANVLTF,0,1,1,1
TRBV7-2,TRBJ1-5,CASSSDTYSNQPQHF,0,1,1,1
TRBV7-2,TRBJ2-1,CASSSRTGEYNEQFF,0,1,1,1
TRBV11-3,TRBJ2-1,CASSSRGGRNDEQFF,0,1,1,1
TRBV6-2/3/5/6,TRBJ2-1,CASSSVGLVYDEQFF,0,1,1,1
TRBV7-2,TRBJ1-4,CASSWGGDSGEKLFF,0,1,1,1
TRBV5-4,TRBJ2-7,CASSWTGTGGLEQYF,0,1,1,1
TRBV5-6,TRBJ1-1,CASSWTGSANTEAFF,0,2,1,2
TRBV7-3,TRBJ1-3,CASSYAGSGGNTIYF,0,1,1,1
TRBV5-5,TRBJ2-1,CASSPQGLASNEQFF,0,1,1,1
TRBV12-3/4,TRBJ2-4,CASSPTLGAKNIQYF,0,1,1,1
TRBV12-3/4,TRBJ1-5,CASSPTGRSNQPQHF,0,1,1,1
TRBV5-4,TRBJ2-7,CASSPPGTDFYEQYF,0,1,1,1
TRBV5-6,TRBJ2-1,CASSPWGVSYNEQFF,0,1,1,1
TRBV4-2,TRBJ2-2,CASSPDRDFTGELFF,0,1,1,1
TRBV4-2,TRBJ2-7,CASSPTRNDAYEQYF,0,1,1,1
TRBV12-3/4,TRBJ2-1,CASSQLAGAYNEQFF,0,1,1,1
TRBV14,TRBJ2-7,CASSQVDRGNYEQYF,0,1,1,1
TRBV2,TRBJ2-7,CASSQSTRGSYEQYF,0,2,1,2
TRBV4-2,TRBJ2-3,CASSQVDSMADTQYF,0,1,1,1
TRBV3-1,TRBJ2-3,CASSQVGLGTDTQYF,0,1,1,1
TRBV3-1,TRBJ2-5,CASSQDLLRQETQYF,0,1,1,1
TRBV14,TRBJ1-1,CASSQDIAANTEAFF,0,1,1,1
TRBV4-2,TRBJ1-1,CASSQRSWRRAEAFF,0,1,1,1
TRBV9,TRBJ2-1,CASSVAGGDYNEQFF,0,1,1,1
TRBV7-9,TRBJ2-1,CASSASGGEINEQFF,0,1,1,1
TRBV9,TRBJ2-1,CASSALAGSKNEQFF,0,1,1,1
TRBV9,TRBJ2-1,CASSATSGGANEQFF,0,1,1,1
TRBV9,TRBJ2-1,CASSTTLAGLNEQFF,0,1,1,1
TRBV7-2,TRBJ2-7,CASSSLGTVSYEQYF,0,1,1,1
TRBV3-1,TRBJ2-1,CASSRQGGSYNEQFF,0,1,1,1
TRBV6-2/3/5/6,TRBJ2-7,CASSNPGLHSYEQYF,0,1,1,1
TRBV7-2,TRBJ1-4,CASRAGSATNEKLFF,0,1,1,1
TRBV7-6,TRBJ1-1,CASRDTLKGDTEAFF,0,1,1,1
TRBV13,TRBJ2-3,CASRPMKGSTDTQYF,0,1,1,1
TRBV6-2/3/5/6,TRBJ2-4,CASRGTYLAKNIQYF,0,1,1,1
TRBV6-2/3/5/6,TRBJ2-7,CASKPLAGDTYEQYF,0,1,1,1
TRBV12-3/4,TRBJ2-1,CANSPSSGDYNEQFF,0,1,1,1
TRBV4-2,TRBJ2-1,CTSSHTSGGVNEQFF,0,1,1,1
TRBV5-1,TRBJ2-3,CASTLAGGLTDTQYF,0,1,1,1
TRBV5-1,TRBJ1-1,CASSYPGQGSTEAFF,0,1,1,1
TRBV10-2,TRBJ1-2,CASSDGGLFPYGYTF,0,1,1,1
TRBV5-1,TRBJ2-1,CASSLVLAGYNEQFF,0,2,1,2
TRBV13,TRBJ1-5,CASSLGGPGNQPQHF,0,1,1,1
TRBV5-1,TRBJ2-5,CASSWGVAEEETQYF,0,1,1,1
TRBV4-1,TRBJ1-3,CASSLPRGSGNTIYF,0,1,1,1
TRBV5-1,TRBJ1-1,CASSLVGGADTEAFF,0,1,1,1
TRBV4-1,TRBJ1-3,CASSPRVASGNTIYF,0,1,1,1
TRBV5-1,TRBJ1-4,CASSPDRSLNEKLFF,0,1,1,1
TRBV4-3,TRBJ1-1,CASSRRDREFPEAFF,0,1,1,1
TRBV4-1,TRBJ2-1,CASSQVGLAYNEQFF,0,1,1,1
TRBV4-3,TRBJ2-2,CASSQATIDTGELFF,0,1,1,1
TRBV4-1,TRBJ2-7,CASSQDNSGGYEQYF,0,1,1,1
TRBV20-1,TRBJ1-5,CSAAPLIHSNQPQHF,0,1,1,1
TRBV20-1,TRBJ1-2,CSARAPRTPGYGYTF,0,1,1,1
TRBV20-1,TRBJ1-5,CSARDWGQGSQPQHF,0,1,1,1
TRBV20-1,TRBJ2-7,CSARDLTDYLYEQYF,0,1,1,1
TRBV20-1,TRBJ2-2,CSARDIRDMGGELFF,0,1,1,1
TRBV20-1,TRBJ1-1,CSARDALGPRTEAFF,0,1,1,1
TRBV20-1,TRBJ1-4,CSARESDRGHVKLFF,0,1,1,1
TRBV20-1,TRBJ2-1,CSAHPTSGAYNEQFF,0,1,1,1
TRBV29-1,TRBJ2-3,CSSRGLAELTDTQYF,0,1,1,1
TRBV29-1,TRBJ2-7,CSVEGASGVTYEQYF,0,1,1,1
TRBV29-1,TRBJ1-4,CSVEDLGRGNEKLFF,0,1,1,1
TRBV29-1,TRBJ2-3,CSVEDDSRQQDTQYF,0,1,1,1
TRBV29-1,TRBJ2-1,CSVEDEGLAGNEQFF,0,1,1,1
TRBV29-1,TRBJ1-3,CSAKQDRFSGNTIYF,0,1,1,1
TRBV14,TRBJ2-3,CVSSRGLAIDTQYF,0,1,1,1
TRBV7-9,TRBJ2-1,CAPSQLAVYNEQFF,0,2,1,2
TRBV28,TRBJ1-4,CAGRAGGENEKLFF,0,1,1,1
TRBV27,TRBJ2-6,CATYAFFGANVLTF,0,1,1,1
TRBV15,TRBJ2-2,CATSRMGAARELFF,0,1,1,1
TRBV19,TRBJ1-5,CASCLSREFQPQHF,0,1,1,1
TRBV19,TRBJ1-5,CASAGQGEGQPQHF,0,1,1,1
TRBV19,TRBJ1-1,CASTVGQVNTEAFF,0,1,1,1
TRBV19,TRBJ2-1,CASSIGASGILWFF,0,1,1,1
TRBV19,TRBJ2-5,CASSTSPGPETQYF,0,1,1,1
TRBV19,TRBJ1-2,CASSTKQGIYGYTF,0,1,1,1
TRBV19,TRBJ2-1,CASSPPMDYNEQFF,0,2,1,2
TRBV19,TRBJ1-4,CASRKGQYNEKLFF,0,1,1,1
TRBV19,TRBJ2-3,CASKKRGSTDTQYF,0,1,1,1
TRBV18,TRBJ2-7,CASSLGGSYYEQYF,0,1,1,1
TRBV12-3/4,TRBJ2-5,CASSLRGRQETQYF,0,1,1,1
TRBV18,TRBJ1-1,CASSPPGVNTEAFF,0,1,1,1
TRBV18,TRBJ1-1,CASSPGLGGTEAFF,0,1,1,1
TRBV19,TRBJ2-7,CASCDRDRAYEQYF,0,1,1,1
TRBV12-3/4,TRBJ2-3,CASHTSPSTDTQYF,0,1,1,1
TRBV9,TRBJ1-5,CASGGGASNQPQHF,0,1,1,1
TRBV9,TRBJ2-3,CASTSRGETDTQYF,0,1,1,1
TRBV12-3/4,TRBJ1-1,CASTASAGTTEAFF,0,1,1,1
TRBV6-2/3/5/6,TRBJ1-5,CASSFTQGAQPQHF,0,1,1,1
TRBV12-3/4,TRBJ1-1,CASSFSGGNTEAFF,0,1,1,1
TRBV12-3/4,TRBJ1-2,CASSLSGGNQGYTF,0,1,1,1
TRBV12-3/4,TRBJ2-7,CASSLAPLSSEQYF,0,1,1,1
TRBV6-2/3/5/6,TRBJ2-5,CASSLNRAEETQYF,0,1,1,1
TRBV12-3/4,TRBJ1-6,CASSLGSYNSPLHF,0,1,1,1
TRBV6-2/3/5/6,TRBJ1-1,CASSLGGANTEAFF,0,1,1,1
TRBV12-3/4,TRBJ2-7,CASSLGGPIYEQYF,0,1,1,1
TRBV28,TRBJ1-1,CASSSKKPNTEAFF,0,1,1,1
TRBV6-2/3/5/6,TRBJ1-1,CASSYSKIKTEAFF,0,1,1,1
TRBV6-2/3/5/6,TRBJ1-1,CASSYPGGPTEAFF,0,1,1,1
TRBV6-2/3/5/6,TRBJ2-3,CASSYRRNADTQYF,0,1,1,1
TRBV6-2/3/5/6,TRBJ1-2,CASSYTRDNYGYTF,0,1,1,1
TRBV6-2/3/5/6,TRBJ2-1,CASSLLTDYNEQFF,0,1,1,1
TRBV12-3/4,TRBJ1-5,CASSPGGGVQPQHF,0,1,1,1
TRBV6-2/3/5/6,TRBJ2-1,CASSRSSSYNEQFF,0,1,1,1
TRBV6-1,TRBJ2-1,CASSHSGSKSEQFF,0,1,1,1
TRBV6-2/3/5/6,TRBJ2-5,CASSQNSRFGTQYF,0,1,1,1
TRBV6-1,TRBJ1-5,CASSVYRGNQPQHF,0,1,1,1
TRBV6-1,TRBJ2-1,CASSAGGRAGEQFF,0,1,1,1
TRBV2,TRBJ2-1,CASSAGLEVDEQFF,0,1,1,1
TRBV2,TRBJ1-6,CASSGQTYNSPLHF,0,1,1,1
TRBV6-1,TRBJ2-7,CASSGAGTSVKQYF,0,1,1,1
TRBV6-1,TRBJ1-1,CASSGRGGVGEAFF,0,1,1,1
TRBV6-1,TRBJ2-7,CASSELSGFHEQYF,0,1,1,1
TRBV6-1,TRBJ2-2,CASSESGDTGELFF,0,1,1,1
TRBV25-1,TRBJ2-7,CASSEYVTSYEQYF,0,1,1,1
TRBV25-1,TRBJ1-1,CASSEYAANTEAFF,0,1,1,1
TRBV6-2/3/5/6,TRBJ2-1,CASSIGLAGDGGFF,0,1,1,1
TRBV2,TRBJ2-1,CASSTRVLGYEQFF,0,1,1,1
TRBV2,TRBJ2-7,CASSTPGTTYEQYF,0,1,1,1
TRBV6-2/3/5/6,TRBJ1-1,CASSSILGAAEAFF,0,1,1,1
TRBV5-6,TRBJ2-3,CASSFWVSTDTQYF,0,1,1,1
TRBV7-9,TRBJ2-4,CASSFSGAKNIQYF,0,1,1,1
TRBV7-2,TRBJ2-7,CASSLFEVRDEQYF,0,1,1,1
TRBV5-4,TRBJ1-5,CASSLPGSNQPQHF,0,2,1,2
TRBV5-5,TRBJ2-1,CASSLVSSRSEQFF,0,1,1,1
TRBV5-4,TRBJ2-1,CASSLAEEGNEQFF,0,1,1,1
TRBV5-4,TRBJ1-1,CASSLAEDRGEAFF,0,1,1,1
TRBV5-6,TRBJ2-1,CASSLGIPGNEQFF,0,1,1,1
TRBV5-4,TRBJ2-1,CASSLDPKTNEQFF,0,1,1,1
TRBV7-2,TRBJ2-2,CASSLYRATGELFF,0,1,1,1
TRBV5-6,TRBJ1-1,CASSLYRGNTEAFF,0,1,1,1
TRBV7-2,TRBJ2-2,CASSLLGQTGELFF,0,1,1,1
TRBV5-4,TRBJ1-1,CASSLQQMNTEAFF,0,1,1,1
TRBV7-9,TRBJ1-1,CASSLVGGDTEAFF,0,1,1,1
TRBV7-9,TRBJ1-1,CASSLVGLNTEAFF,0,1,1,1
TRBV6-2/3/5/6,TRBJ2-5,CASSLVGRQETQYF,0,1,1,1
TRBV7-2,TRBJ1-3,CASSLGSVGNTIYF,0,1,1,1
TRBV7-8,TRBJ2-7,CASSLGVRIYEQYF,0,1,1,1
TRBV7-9,TRBJ2-5,CASSLGGFQETQYF,0,1,1,1
TRBV7-8,TRBJ1-1,CASSLDRGYTEAFF,0,2,1,2
TRBV7-9,TRBJ1-1,CASSLEGANTEAFF,0,1,1,1
TRBV7-2,TRBJ1-2,CASSLEGTPWSYTF,0,1,1,1
TRBV7-9,TRBJ1-2,CASSLTAGNYGYTF,0,1,1,1
TRBV7-2,TRBJ1-1,CASSLSQGGTEAFF,0,1,1,1
TRBV5-4,TRBJ2-5,CASSLRTSGETQYF,0,1,1,1
TRBV3-1,TRBJ2-7,CASSSRTVPYEQYF,0,1,1,1
TRBV5-6,TRBJ1-5,CASSSGQLNQPQHF,0,1,1,1
TRBV7-2,TRBJ1-1,CASSSRSVNTEAFF,0,1,1,1
TRBV7-2,TRBJ2-7,CASSSGLWSYEQYF,0,2,1,2
TRBV5-4,TRBJ2-7,CASSWRDLPYEQYF,0,1,1,1
TRBV6-2/3/5/6,TRBJ2-7,CASSYRQGRYEQYF,0,1,1,1
TRBV2,TRBJ1-1,CASSLSRQNTEAFF,0,1,1,1
TRBV12-3/4,TRBJ2-2,CASSLGLASGELFF,0,1,1,1
TRBV6-2/3/5/6,TRBJ2-3,CASSPLSYTDTQYF,0,1,1,1
TRBV6-2/3/5/6,TRBJ1-6,CASSPQDSTSPLHF,0,1,1,1
TRBV14,TRBJ1-2,CASSPGQRKGSYTF,0,1,1,1
TRBV7-2,TRBJ1-5,CASSPGTDDQPQHF,0,1,1,1
TRBV11-3,TRBJ2-7,CASSPRTGVNEQYF,0,1,1,1
TRBV7-9,TRBJ1-2,CASSPRTSNYGYTF,0,1,1,1
TRBV12-3/4,TRBJ2-3,CASSRGGALDTQYF,0,1,1,1
TRBV3-1,TRBJ1-4,CASSQGFANEKLFF,0,1,1,1
TRBV27,TRBJ1-1,CASSQGASNTEALF,0,1,1,1
TRBV3-1,TRBJ1-2,CASSQDPQLRGYTF,0,1,1,1
TRBV3-1,TRBJ1-2,CASSQDVGDSGYTF,0,1,1,1
TRBV4-2,TRBJ1-1,CASSQELSDTEAFF,0,1,1,1
TRBV12-3/4,TRBJ2-1,CASSQRLVRGEQFF,0,1,1,1
TRBV6-2/3/5/6,TRBJ2-1,CASSQRLGRGEQFF,0,1,1,1
TRBV3-1,TRBJ2-7,CASSARDRGYEQYF,0,1,1,1
TRBV7-9,TRBJ1-6,CASSAGTGVSPLHF,0,1,1,1
TRBV12-3/4,TRBJ2-3,CASSGDRDTDTQYF,0,1,1,1
TRBV5-6,TRBJ2-7,CASSTPQGVYEQYF,0,1,1,1
TRBV7-8,TRBJ2-5,CASSTPGRQETQYF,0,1,1,1
TRBV7-2,TRBJ1-3,CASRPAGTGNTIYF,0,1,1,1
TRBV7-2,TRBJ1-5,CASRIQGAHQPQHF,0,1,1,1
TRBV6-1,TRBJ1-4,CASRKTGDNEKLFF,0,1,1,1
TRBV3-1,TRBJ1-2,CASRPGQDGYGYTF,0,1,1,1
TRBV12-3/4,TRBJ2-7,CASRQGWEDYEQYF,0,1,1,1
TRBV2,TRBJ1-2,CASRGTGVLYGYTF,0,1,1,1
TRBV5-5,TRBJ1-1,CASNLEQVRTEAFF,0,1,1,1
TRBV2,TRBJ1-1,CASNPTRKNTEAFF,0,1,1,1
TRBV2,TRBJ2-7,CASNQQGTAYEQYF,0,1,1,1
TRBV12-3/4,TRBJ2-3,CASKGSLSTDTQYF,0,1,1,1
TRBV5-1,TRBJ2-1,CASRPGLADNEQFF,0,1,1,1
TRBV10-2,TRBJ2-5,CASSESKGQETQYF,0,1,1,1
TRBV5-1,TRBJ2-7,CASSFAVGVYEQYF,0,1,1,1
TRBV5-1,TRBJ2-7,CASSLRAGPYEQYF,0,1,1,1
TRBV5-1,TRBJ1-6,CASSLGQGGSPLHF,0,1,1,1
TRBV5-1,TRBJ1-1,CASSLDRGSAEAFF,0,1,1,1
TRBV5-1,TRBJ1-1,CASSSGRTNTEAFF,0,1,1,1
TRBV5-1,TRBJ1-4,CASSWTSTNEKLFF,0,1,1,1
TRBV4-1,TRBJ1-5,CASSLRSGNQPQHF,0,1,1,1
TRBV4-3,TRBJ2-1,CASSPTSGPNEQFF,0,1,1,1
TRBV4-3,TRBJ2-4,CASSPSLAKNIQYF,0,1,1,1
TRBV5-1,TRBJ2-2,CASSPSVNTGELFF,0,1,1,1
TRBV4-1,TRBJ1-5,CASSHPIKNQPQHF,0,1,1,1
TRBV4-1,TRBJ2-1,CASSQVTANNEQFF,0,1,1,1
TRBV4-1,TRBJ2-7,CASSQVDRSYEQYF,0,1,1,1
TRBV4-3,TRBJ2-3,CASSQGQGADTQYF,0,1,1,1
TRBV4-1,TRBJ1-2,CASSQDYDTPRWTF,0,1,1,1
TRBV4-1,TRBJ1-1,CASSQEFLNTEAFF,0,1,1,1
TRBV5-1,TRBJ2-3,CASSEGQRWDTQYF,0,1,1,1
TRBV5-1,TRBJ1-2,CASKYNRGDPGYTF,0,2,1,2
TRBV20-1,TRBJ2-1,CSVTLAGDYNEQFF,0,2,1,2
TRBV20-1,TRBJ2-1,CSVRLAGINNEQFF,0,1,1,1
TRBV20-1,TRBJ2-7,CSASGEGERNEQYF,0,1,1,1
TRBV20-1,TRBJ1-5,CSAQSQELNQPQHF,0,2,1,2
TRBV20-1,TRBJ2-7,CSAVSGGASYEQYF,0,1,1,1
TRBV20-1,TRBJ2-5,CSAITQAGDETQYF,0,1,1,1
TRBV20-1,TRBJ2-1,CSAISEKGNNEQFF,0,1,1,1
TRBV20-1,TRBJ1-6,CSARARGWNSPLHF,0,2,1,2
TRBV20-1,TRBJ2-7,CSARGNLAAYEQYF,0,1,1,1
TRBV20-1,TRBJ2-7,CSARDRERSYEQYF,0,1,1,1
TRBV20-1,TRBJ1-5,CSARSPDGNQPQHF,0,1,1,1
TRBV20-1,TRBJ2-5,CSARLQGRRETQYF,0,1,1,1
TRBV20-1,TRBJ1-2,CSARASLGYYGYTF,0,1,1,1
TRBV20-1,TRBJ2-7,CSARDPRLSYEQYF,0,1,1,1
TRBV20-1,TRBJ2-5,CSARDRGSQETQYF,0,1,1,1
TRBV20-1,TRBJ2-3,CSAKRQGNTDTQYF,0,1,1,1
TRBV20-1,TRBJ2-7,CSALKPGQKGEQYF,0,1,1,1
TRBV20-1,TRBJ2-3,CSAPLRGREDTQYF,0,1,1,1
TRBV20-1,TRBJ2-1,CSATGLFSYNEQFF,0,1,1,1
TRBV20-1,TRBJ2-1,CSAQTGELVNEQFF,0,1,1,1
TRBV20-1,TRBJ2-1,CSADQGDPRDEQFF,0,1,1,1
TRBV20-1,TRBJ2-4,CSAIRTTVQNIQYF,0,2,1,2
TRBV29-1,TRBJ2-2,CSYVETGGTGELFF,0,1,1,1
TRBV29-1,TRBJ2-7,CSVAGTASSYEQYF,0,1,1,1
TRBV29-1,TRBJ2-3,CSVDAGMGEDTQYF,0,1,1,1
TRBV29-1,TRBJ2-5,CSVDPGTSVRTQYF,0,1,1,1
TRBV29-1,TRBJ1-1,CSVDPGQGNTEAFF,0,1,1,1
TRBV29-1,TRBJ2-3,CSDGTSGNTDTQYF,0,1,1,1
TRBV7-3,TRBJ2-1,RASSFGTSGDPLFF,0,1,1,1
TRBV12-5,TRBJ2-3,CASGPTSTDTQYF,0,1,1,1
TRBV2,TRBJ1-6,CAFQDRWNSPLHF,0,1,1,1
TRBV30,TRBJ1-6,CAWVKTDNSPLHF,0,1,1,1
TRBV10-3,TRBJ2-3,CAYGTEATDTQYF,0,1,1,1
TRBV2,TRBJ2-3,CAALAGGTDTQYF,0,1,1,1
TRBV12-3/4,TRBJ2-4,CAAGLAGGGIQYF,0,1,1,1
TRBV10-3,TRBJ1-2,CAISEAGDDGYTF,0,1,1,1
TRBV10-3,TRBJ2-1,CAISEGVTNEQFF,0,1,1,1
TRBV24-1,TRBJ2-1,CATSVPGDNEQFF,0,1,1,1
TRBV19,TRBJ2-7,CASSAAGAYEQYF,0,1,1,1
TRBV19,TRBJ2-3,CASSGGAADTQYF,0,1,1,1
TRBV19,TRBJ2-3,CASSTTNTDTQYF,0,1,1,1
TRBV18,TRBJ1-4,CASSPDRDEKLFF,0,1,1,1
TRBV18,TRBJ1-2,CASSTGEDYGYTF,0,1,1,1
TRBV18,TRBJ2-7,CASSPPGDYEQYF,0,1,1,1
TRBV7-2,TRBJ2-5,CASAPWGQETQYF,0,1,1,1
TRBV25-1,TRBJ1-1,CASEPGAATEAFF,0,1,1,1
TRBV12-3/4,TRBJ2-7,CASTWGATYEQYF,0,1,1,1
TRBV7-9,TRBJ1-1,CASTRAVDTEAFF,0,1,1,1
TRBV6-2/3/5/6,TRBJ2-4,CASSFSQGNIQYF,0,1,1,1
TRBV12-3/4,TRBJ1-1,CASSFGRNTEAFS,0,1,1,1
TRBV6-2/3/5/6,TRBJ2-1,CASSFGGHNEQFF,0,1,1,1
TRBV12-3/4,TRBJ1-1,CASSLGANTEAFF,0,1,1,1
TRBV27,TRBJ2-7,CASSLSGTYEQYF,0,1,1,1
TRBV27,TRBJ1-1,CASSLSGRTSAFF,0,1,1,1
TRBV27,TRBJ2-5,CASSLWDSETQYF,0,1,1,1
TRBV12-3/4,TRBJ1-5,CASSLDFRWPQHF,0,1,1,1
TRBV27,TRBJ1-1,CASSLRGKAEAFF,0,1,1,1
TRBV12-3/4,TRBJ2-1,CASSLNRWNEQFF,0,1,1,1
TRBV27,TRBJ2-1,CASSLNWVDEQFF,0,1,1,1
TRBV12-3/4,TRBJ2-1,CASSSLAGDIRFF,0,1,1,1
TRBV6-2/3/5/6,TRBJ2-1,CASSYRRYNEQFF,0,1,1,1
TRBV6-2/3/5/6,TRBJ2-5,CASSYVETRTQYF,0,2,1,2
TRBV12-3/4,TRBJ1-5,CASSYRYNQPQHF,0,1,1,1
TRBV27,TRBJ1-1,CASSLSTDVVAFF,0,1,1,1
TRBV12-3/4,TRBJ2-7,CASSPTGGHEQYF,0,1,1,1
TRBV27,TRBJ2-5,CASSPYPAETQYF,0,1,1,1
TRBV12-3/4,TRBJ1-6,CASSHGLNSPLHF,0,1,1,1
TRBV6-1,TRBJ2-7,CASSAYRDYEQYF,0,1,1,1
TRBV5-6,TRBJ2-1,CASSFGFYNEQFF,0,1,1,1
TRBV7-9,TRBJ1-2,CASSFPDRVGYTF,0,1,1,1
TRBV5-4,TRBJ2-1,CASSLAGRNEQFF,0,1,1,1
TRBV7-9,TRBJ1-2,CASSLADSYGYTF,0,1,1,1
TRBV7-2,TRBJ2-5,CASSLGVQETQYF,0,2,1,2
TRBV7-2,TRBJ2-1,CASSLDVGVEQFF,0,1,1,1
TRBV7-9,TRBJ1-1,CASSLREGREAFF,0,1,1,1
TRBV5-8,TRBJ2-5,CASSSDYLETQYF,0,2,1,2
TRBV7-9,TRBJ2-1,CASSSSGHNEQFF,0,1,1,1
TRBV3-1,TRBJ1-1,CASSPSAYTEAFF,0,1,1,1
TRBV7-2,TRBJ2-4,CASSPTWTTVPYF,0,1,1,1
TRBV7-2,TRBJ2-1,CASSPGLAGEQFF,0,1,1,1
TRBV16,TRBJ2-7,CASSQRQTMEQYF,0,1,1,1
TRBV7-2,TRBJ2-7,CASSQKFPGEQYF,0,1,1,1
TRBV7-2,TRBJ2-1,CASSVDSYNEQFF,0,1,1,1
TRBV6-2/3/5/6,TRBJ2-7,CASSAGVGYEQYF,0,1,1,1
TRBV9,TRBJ1-5,CASSGEGNQPQHF,0,1,1,1
TRBV5-5,TRBJ1-5,CASSTWGSQPQHF,0,1,1,1
TRBV2,TRBJ1-2,CASSTTGAYGYTF,0,1,1,1
TRBV27,TRBJ2-7,CASSNRLGGEQYF,0,1,1,1
TRBV2,TRBJ1-1,CASRYRKNTEAFF,0,1,1,1
TRBV6-2/3/5/6,TRBJ2-1,CASRAITGNEQFF,0,1,1,1
TRBV7-9,TRBJ2-7,CASRAGASYEQYF,0,1,1,1
TRBV6-2/3/5/6,TRBJ1-1,CASRGQGRTEAFF,0,1,1,1
TRBV6-4,TRBJ2-2,CASRDQYTGELFF,0,1,1,1
TRBV12-3/4,TRBJ2-7,CASRSTGPYEQYF,0,1,1,1
TRBV12-3/4,TRBJ2-2,CASRTLDSGELCF,0,1,1,1
TRBV3-1,TRBJ2-1,CASNPGGRNEQSF,0,1,1,1
TRBV6-2/3/5/6,TRBJ2-2,CASKGQNTGELFF,0,1,1,1
TRBV27,TRBJ1-1,CASKTGGLAEAFF,0,1,1,1
TRBV5-8,TRBJ1-2,CARDSGVDYGYTF,0,1,1,1
TRBV4-3,TRBJ1-6,CASSPRGGSPLHF,0,1,1,1
TRBV5-1,TRBJ2-7,CASSFDPSYEQYF,0,1,1,1
TRBV5-1,TRBJ1-1,CASSLAGQGKAFF,0,1,1,1
TRBV5-1,TRBJ2-7,CASSLANPYEQYF,0,1,1,1
TRBV5-1,TRBJ1-6,CASSSQDNSPLHF,0,1,1,1
TRBV4-1,TRBJ1-2,CASSLPGSYGYTF,0,1,1,1
TRBV4-1,TRBJ2-7,CASSLRDTYEQYF,0,1,1,1
TRBV4-1,TRBJ2-1,CASSPGGSNEQFF,0,1,1,1
TRBV5-1,TRBJ2-7,CASSRGTGYEQYF,0,2,1,2
TRBV4-3,TRBJ1-1,CASSHLGGHEAFF,0,1,1,1
TRBV5-1,TRBJ2-7,CASSHGTVYEQYF,0,1,1,1
TRBV4-3,TRBJ2-7,CASSQASGDEQYF,0,1,1,1
TRBV4-3,TRBJ2-7,CASSQGQGYEQYF,0,1,1,1
TRBV5-1,TRBJ1-2,CASSVTGGNGYTF,0,1,1,1
TRBV5-1,TRBJ2-5,CASSDNPQETQYF,0,1,1,1
TRBV5-1,TRBJ2-6,CASRDDPTNVLTF,0,1,1,1
TRBV20-1,TRBJ2-3,CSVDRGSTDTQYF,0,1,1,1
TRBV20-1,TRBJ1-2,CSAWRDSPYGYTF,0,1,1,1
TRBV20-1,TRBJ2-5,CSAPPTGEETQYF,0,1,1,1
TRBV20-1,TRBJ1-2,CSAVGQTNYGYTF,0,1,1,1
TRBV20-1,TRBJ2-1,CSASSAVYNEQFF,0,1,1,1
TRBV20-1,TRBJ1-1,CSASRGERVEAFF,0,1,1,1
TRBV20-1,TRBJ1-6,CSASMGENSPLHF,0,1,1,1
TRBV20-1,TRBJ1-2,CSARDGSYYGYTS,0,1,1,1
TRBV20-1,TRBJ2-5,CSARARPEGTQYF,0,1,1,1
TRBV20-1,TRBJ2-2,CSANSGRTGELFF,0,1,1,1
TRBV20-1,TRBJ2-7,CSAKRGDLPGQYF,0,1,1,1
TRBV29-1,TRBJ1-1,CSVARGTNTEAFF,0,1,1,1
TRBV29-1,TRBJ1-1,CSVESSLNTEAFF,0,1,1,1
TRBV29-1,TRBJ1-1,CSVEIVRNTEAFF,0,1,1,1
TRBV29-1,TRBJ1-1,CSVTYLGNTEAFF,0,1,1,1
TRBV29-1,TRBJ1-2,CSVSVQSGEGYTF,0,1,1,1
TRBV29-1,TRBJ2-4,CSVLAIAKNIQYF,0,1,1,1
TRBV29-1,TRBJ2-1,CSVQGSSYNEQFF,0,1,1,1
TRBV29-1,TRBJ2-1,CSVGRTGRNEQFF,0,1,1,1
TRBV29-1,TRBJ2-1,CSVGLAGVGEQFF,0,1,1,1
TRBV29-1,TRBJ2-7,CSVERGAAYEQYF,0,1,1,1
TRBV29-1,TRBJ1-1,CSATTGGNTEAFF,0,1,1,1
TRBV29-1,TRBJ2-2,CSALAATTGELFF,0,1,1,1
TRBV29-1,TRBJ1-2,CSARQGGYDGYTF,0,1,1,1
TRBV29-1,TRBJ1-2,CSAKADRDHGYTF,0,1,1,1
TRBV29-1,TRBJ2-1,CSAGLADYNEQFF,0,1,1,1
TRBV29-1,TRBJ1-1,CSGISGQGGEAFF,0,1,1,1
TRBV29-1,TRBJ2-2,CSGRDRSYGELFF,0,1,1,1
TRBV29-1,TRBJ2-7,CSGGDGPLGEQYF,0,1,1,1
TRBV30,TRBJ2-1,CAWSAPGPEQFF,0,1,1,1
TRBV10-3,TRBJ2-3,CAILGDTDTQYF,0,1,1,1
TRBV24-1,TRBJ2-3,CATSGGTDTQYF,0,1,1,1
TRBV19,TRBJ2-3,CATGAEADTQYF,0,1,1,1
TRBV19,TRBJ1-1,CASSPPNTEAFF,0,1,1,1
TRBV19,TRBJ1-1,CASTLRGSEAFF,0,1,1,1
TRBV19,TRBJ1-1,CASSAFDTEAFF,0,1,1,1
TRBV19,TRBJ2-7,CASRDRASEQYF,0,1,1,1
TRBV7-9,TRBJ2-7,CASGEGFGEQYF,0,1,1,1
TRBV12-3/4,TRBJ2-3,CASSLTSDTQYF,0,1,1,1
TRBV12-3/4,TRBJ2-7,CASSSRADEQYF,0,2,1,2
TRBV12-3/4,TRBJ2-4,CASSSVQVIQYF,0,1,1,1
TRBV6-2/3/5/6,TRBJ2-1,CASSYNRFEQFF,0,1,1,1
TRBV3-1,TRBJ2-5,CASSPRRETQYF,0,1,1,1
TRBV2,TRBJ2-1,CASSAGGNEQFF,0,1,1,1
TRBV12-3/4,TRBJ1-6,CASSGKGAPLHF,0,1,1,1
TRBV27,TRBJ2-7,CASSTTGSEQYF,0,1,1,1
TRBV2,TRBJ2-5,CASSSGRETQYF,0,1,1,1
TRBV7-9,TRBJ2-1,CASSFRTDEQFF,0,1,1,1
TRBV6-2/3/5/6,TRBJ1-1,CASSLEVTEAFF,0,1,1,1
TRBV7-2,TRBJ2-7,CASSLGGPEQYF,0,1,1,1
TRBV7-9,TRBJ1-2,CASSLGGDRSNF,0,1,1,1
TRBV7-9,TRBJ2-5,CASSSTEETQYF,0,2,1,2
TRBV7-9,TRBJ2-7,CASSLTGREQYF,0,1,1,1
TRBV6-2/3/5/6,TRBJ2-1,CASSPPADEQFF,0,1,1,1
TRBV7-9,TRBJ2-1,CASSPPGDEQFF,0,1,1,1
TRBV4-2,TRBJ2-7,CASSQPPGGQYF,0,1,1,1
TRBV3-1,TRBJ2-3,CASSQDRALPHF,0,1,1,1
TRBV3-1,TRBJ2-7,CASSQEGAARCF,0,1,1,1
TRBV9,TRBJ2-7,CASSAGAYEQYF,0,1,1,1
TRBV3-1,TRBJ2-2,CASSANTGELFF,0,1,1,1
TRBV25-1,TRBJ2-5,CASRDPLKTQYF,0,1,1,1
TRBV6-2/3/5/6,TRBJ1-1,CASRVMNTEAFF,0,1,1,1
TRBV6-2/3/5/6,TRBJ2-7,CASRGSNYEQYF,0,1,1,1
TRBV5-1,TRBJ2-1,CASSLLLGEQFF,0,1,1,1
TRBV20-1,TRBJ2-3,CSAARGTDTQYF,0,1,1,1
TRBV20-1,TRBJ1-1,CSATGGRAEAFF,0,1,1,1
TRBV20-1,TRBJ2-3,CSASPVADTQYF,0,1,1,1
TRBV20-1,TRBJ1-3,CSASGEYHTIYF,0,1,1,1
TRBV20-1,TRBJ2-7,CSARVHSYEQYF,0,1,1,1
TRBV20-1,TRBJ1-2,CSARAATGSYTF,0,1,1,1
TRBV20-1,TRBJ2-1,CSARDSRNEQFF,0,1,1,1
TRBV20-1,TRBJ2-1,CSAREDGFEQFF,0,1,1,1
TRBV20-1,TRBJ2-7,CSASGTRSEQYF,0,1,1,1
TRBV20-1,TRBJ2-1,CSANFLFDEQFF,0,1,1,1
TRBV29-1,TRBJ2-5,CSVWGFQETQYF,0,1,1,1
TRBV29-1,TRBJ2-5,CSVETSRETQYF,0,1,1,1
TRBV29-1,TRBJ2-7,CSVEGRAYEQYF,0,1,1,1
TRBV29-1,TRBJ2-1,CSARDRGDEQFF,0,1,1,1
TRBV29-1,TRBJ2-1,CSGDLLGNEQFF,0,1,1,1
TRBV13,TRBJ1-2,CAVSGDYGYTF,0,1,1,1
TRBV10-3,TRBJ2-3,CAISETDTQYF,0,1,1,1
TRBV19,TRBJ1-1,CATRTGPEAFF,0,1,1,1
TRBV2,TRBJ2-1,CASEAPNEQFF,0,1,1,1
TRBV27,TRBJ2-3,CASSFSDTQYF,0,1,1,1
TRBV28,TRBJ2-3,CASSFTDTQYF,0,1,1,1
TRBV12-3/4,TRBJ1-2,CASSFRDGYTF,0,1,1,1
TRBV12-3/4,TRBJ1-5,CASSLVQPQHF,0,1,1,1
TRBV6-2/3/5/6,TRBJ2-7,CASSYNYEQYF,0,1,1,1
TRBV5-6,TRBJ2-7,CASSYENEQYF,0,1,1,1
TRBV7-9,TRBJ2-7,CASSRDYEQYF,0,1,1,1
TRBV7-8,TRBJ1-1,CASSQWSEAFF,0,1,1,1
TRBV3-1,TRBJ2-7,CASSGPLEQYF,0,1,1,1
TRBV12-3/4,TRBJ1-3,CASRVQGTIYF,0,1,1,1
TRBV7-9,TRBJ2-7,CASRIGALEYF,0,1,1,1
TRBV11-2,TRBJ1-4,CATERGRQLFF,0,1,1,1
TRBV20-1,TRBJ2-2,CTMHRYGELFF,0,1,1,1
TRBV29-1,TRBJ2-3,CSVSTGDTQYF,0,1,1,1
TRBV29-1,TRBJ2-7,CSATITYEQYF,0,1,1,1
TRBV29-1,TRBJ2-5,CSGGGGETQYF,0,1,1,1
TRBV20-1,TRBJ2-4,CSDSRGGIQYF,0,1,1,1
TRBV6-4,TRBJ2-1,CASRSNEQFF,0,1,1,1
TRBV29-1,TRBJ2-3,CSAGGDTQYF,0,1,1,1
TRBV20-1,TRBJ1-1,CSVSAFF,0,2,1,2
TRBV6-4,TRBJ2-7,CASSRTLVGSSYEQYF,0,1,1,1
TRBV7-9,TRBJ2-5,CASSLLLAGTETLYF,0,1,1,1
TRBV25-1,TRBJ1-1,CASSEAGVTEAFF,0,1,1,1
TRBV30,TRBJ2-1,CAWSVRGLSSYNEQFF,0,1,1,1
TRBV28,TRBJ2-1,CASRFRLGDRAEQFF,0,1,1,1
TRBV16,TRBJ1-2,CASSQSTGVYGFTF,0,1,1,1
TRBV30,TRBJ2-4,CAWSIDAKNIQYY,0,1,1,1
TRBV6-2/3/5/6,TRBJ2-4,CASCSGPRSIQYF,0,1,1,1
TRBV4-2,TRBJ2-2,CASSRDNTNTGGLFF,0,1,1,1
TRBV4-1,TRBJ2-3,CASSQPAISTDTQYF,0,1,1,1
TRBV11-3,TRBJ2-1,CASSLDLFDNEQFF,0,1,1,1
TRBV6-1,TRBJ1-2,CASSGPNYGYTF,0,1,1,1
TRBV19,TRBJ2-1,CASSPRGASGGAGEQFF,0,1,1,1
TRBV15,TRBJ2-7,CATSRGSPSVLQYF,0,1,1,1
TRBV5-6,TRBJ1-1,CASSYTDRETEAFF,0,1,1,1
TRBV20-1,TRBJ1-5,CSAIAPRAGGNQPQHF,0,1,1,1
TRBV2,TRBJ1-1,CASSFEGGNTEAFF,0,1,1,1
TRBV6-2/3/5/6,TRBJ1-2,CASSRWQGNYGYTF,0,1,1,1
TRBV6-2/3/5/6,TRBJ2-5,CASSYSIRGAQGETQYF,0,1,1,1
TRBV29-1,TRBJ2-2,CSIRDRGSTGELFF,0,1,1,1
TRBV7-2,TRBJ1-1,CASSFYPEPEAFF,0,1,1,1
TRBV12-3/4,TRBJ1-2,CASSLRGRPNYGYTF,0,1,1,1
TRBV12-3/4,TRBJ2-3,CASSLGGERDTQYF,0,1,1,1
TRBV4-3,TRBJ2-3,CASSQDLVGGLAGGLYGTDTQYF,0,1,1,1
TRBV7-2,TRBJ2-3,CASSFGFSLRGGPVMADTQYF,0,1,1,1
TRBV11-2,TRBJ2-1,CASSLGRMDREGSPYNEQFF,0,1,1,1
TRBV7-2,TRBJ2-3,CASSLGPGTSGGAGTDTQYF,0,1,1,1
TRBV4-1,TRBJ1-2,CASSQVGFLARSATNYGYTF,0,1,1,1
TRBV15,TRBJ2-2,CATSRGYLGTGKSTGELFF,0,1,1,1
TRBV18,TRBJ2-6,CASSPGGFDPWTGANVLTF,0,1,1,1
TRBV5-4,TRBJ2-5,CASTTLSTAGGHNQETQYF,0,1,1,1
TRBV5-6,TRBJ2-3,CASTKPKVDTGAETDTQYF,0,1,1,1
TRBV12-3/4,TRBJ2-3,CASSLTLAGGQIGTDTQYF,0,1,1,1
TRBV7-2,TRBJ2-5,CASSPRLAGPLLGSETQYF,0,1,1,1
TRBV6-1,TRBJ1-5,CASSDGTDRLRYSNQPQHF,0,1,1,1
TRBV6-2/3/5/6,TRBJ2-2,CASRRGWDSNIANTGELFF,0,1,1,1
TRBV4-3,TRBJ2-1,CASSQDMRQGVLSYNEQFF,0,1,1,1
TRBV4-3,TRBJ2-3,CASSQKSWNRLADTDTQYF,0,1,1,1
TRBV12-5,TRBJ1-2,CASGLFPLTAFPNYGYTF,0,1,1,1
TRBV12-5,TRBJ2-3,CASGLQGTRGYYTDTQYF,0,1,1,1
TRBV10-3,TRBJ2-5,CATTTGLADTNYQETQYF,0,1,1,1
TRBV2,TRBJ2-3,CASLFTPRQAITTDTQYF,0,1,1,1
TRBV2,TRBJ2-1,CASGRPPGLAGIYNEQFF,0,1,1,1
TRBV12-3/4,TRBJ2-2,CASTLGTSGTPPGGELFF,0,1,1,1
TRBV12-3/4,TRBJ1-2,CASTPVGFRDLGPYGYTF,0,1,1,1
TRBV6-2/3/5/6,TRBJ1-5,CASSFQFSVLRDNQPQHF,0,1,1,1
TRBV6-2/3/5/6,TRBJ2-5,CASSLLASGRAWQETQYF,0,1,1,1
TRBV12-3/4,TRBJ2-7,CASSLALAGTSGAYEQYF,0,1,1,1
TRBV12-3/4,TRBJ2-3,CASSSPVTGTSKTDTQYF,0,1,1,1
TRBV27,TRBJ2-2,CASSSTSGGPSNTGELFF,0,1,1,1
TRBV6-2/3/5/6,TRBJ1-3,CASSYIRSRESSGNTIYF,0,1,1,1
TRBV2,TRBJ2-1,CASSEAHPRTWQHNEQFF,0,1,1,1
TRBV6-1,TRBJ1-2,CASSEGFRIGVPNYGYTF,0,1,1,1
TRBV6-1,TRBJ1-5,CASSKSPQGRASNQPQHF,0,1,1,1
TRBV7-2,TRBJ1-1,CASSFRVTGVTSYTEAFF,0,1,1,1
TRBV5-6,TRBJ2-5,CASSLGDLGVAMQETQYF,0,1,1,1
TRBV7-2,TRBJ2-5,CASSLAGDGRGRVETQYF,0,1,1,1
TRBV7-2,TRBJ1-4,CASSLGDRALATNEKLFF,0,1,1,1
TRBV11-2,TRBJ2-1,CASSSGGASGVSYNEQFF,0,1,1,1
TRBV7-2,TRBJ2-4,CASSSGLAGQSDKNIQYF,0,1,1,1
TRBV2,TRBJ2-1,CASSYRALAVNLNNEQFF,0,1,1,1
TRBV3-1,TRBJ2-5,CASSLRTSGGVYQETQYF,0,1,1,1
TRBV4-2,TRBJ2-7,CASSLHPGLAGSGGEQYF,0,1,1,1
TRBV3-1,TRBJ2-1,CASSPRAVLRSSYNEQFF,0,1,1,1
TRBV14,TRBJ2-7,CASSRKEVRLAGDHEQYF,0,1,1,1
TRBV3-1,TRBJ2-6,CASSQPDRVLLGANVLTF,0,1,1,1
TRBV4-2,TRBJ2-2,CASSQGPGLADSTGELFF,0,1,1,1
TRBV3-1,TRBJ2-4,CASSQDTSSGGAGDIQYF,0,1,1,1
TRBV4-2,TRBJ1-1,CASSQDNRAGGLGGEAFF,0,1,1,1
TRBV9,TRBJ2-3,CASSVGEREGPVADTQYS,0,1,1,1
TRBV7-8,TRBJ2-1,CASSTREREPDPYNEQFF,0,1,1,1
TRBV6-2/3/5/6,TRBJ2-6,CASRLPGLAGSGANVLTF,0,1,1,1
TRBV6-4,TRBJ2-6,CASRGQVAPFSGANVLTF,0,1,1,1
TRBV20-1,TRBJ2-4,CSAGKGTSGDLAKNIQYF,0,1,1,1
TRBV20-1,TRBJ2-1,CSARVRNGGGRPYNEQFF,0,1,1,1
TRBV20-1,TRBJ2-1,CSARDALAGFSSYNEQFF,0,1,1,1
TRBV20-1,TRBJ2-7,CSARNLWTSGEGHYEQYF,0,1,1,1
TRBV20-1,TRBJ1-6,CSAGEANLKSSYNSPLHF,0,1,1,1
TRBV20-1,TRBJ2-3,CSAEHRTSGGTSTDTQYF,0,1,1,1
TRBV29-1,TRBJ2-1,CSVDKWDYSKRGVNEQFF,0,1,1,1
TRBV12-5,TRBJ2-1,CACGPRGGGEGTNEQFF,0,1,1,1
TRBV12-5,TRBJ2-3,CASALAHLAGGTDTQYF,0,1,1,1
TRBV12-5,TRBJ2-1,CASGLAAGAGEYNEQFF,0,1,1,1
TRBV30,TRBJ2-1,CAWSVRTSGRVYGEQFF,0,1,1,1
TRBV15,TRBJ2-2,CATSSRLAGVGTGELFF,0,1,1,1
TRBV15,TRBJ2-1,CATSRDVAGGVYNEQFF,0,1,1,1
TRBV15,TRBJ2-1,CATSRDTGSPSYNEQFF,0,1,1,1
TRBV19,TRBJ1-1,CASDKRAQGRRETEAFF,0,1,1,1
TRBV19,TRBJ1-1,CASSVPWGTPMNTEAFF,0,1,1,1
TRBV18,TRBJ2-1,CASSRSLGPEDYNEQFF,0,1,1,1
TRBV18,TRBJ1-1,CASSPIGNSWGYTEAFF,0,1,1,1
TRBV27,TRBJ2-6,CASCQGNYYSGANVLTF,0,1,1,1
TRBV12-3/4,TRBJ2-2,CASVGPEGGRNTGELFF,0,1,1,1
TRBV28,TRBJ2-7,CASSLWKLAGGPGEQYF,0,1,1,1
TRBV6-2/3/5/6,TRBJ2-7,CASSLGRLAGDSYEQYF,0,1,1,1
TRBV12-3/4,TRBJ1-5,CASSLGTGVRSNQPQHF,0,1,1,1
TRBV6-2/3/5/6,TRBJ2-1,CASSLTPFSGSNDEQFF,0,1,1,1
TRBV6-2/3/5/6,TRBJ2-1,CASSYSKERYFYNEQFF,0,1,1,1
TRBV6-2/3/5/6,TRBJ1-5,CASSPRQGRHGNQPQHF,0,1,1,1
TRBV12-3/4,TRBJ2-5,CASSQQVGGRYQETQYF,0,1,1,1
TRBV6-1,TRBJ1-2,CASSEASWDRGRYGYTF,0,1,1,1
TRBV2,TRBJ2-4,CASSEGGGGRAKNIQYF,0,1,1,1
TRBV2,TRBJ2-1,CASSTTTSGKTINEQFF,0,1,1,1
TRBV6-1,TRBJ1-2,CASSKTGGGPTNYGYTF,0,1,1,1
TRBV7-2,TRBJ2-3,CASSFLTGGGSSDTQYF,0,1,1,1
TRBV5-6,TRBJ1-5,CASSFRRAGALDQPQHF,0,1,1,1
TRBV6-2/3/5/6,TRBJ1-6,CASSFTRPGGSNSPLHF,0,1,1,1
TRBV5-6,TRBJ2-1,CASSLEAGRGLYNEQFF,0,1,1,1
TRBV7-3,TRBJ2-6,CASSLSEVISGANVLTF,0,1,1,1
TRBV7-2,TRBJ2-1,CASSLVGGPLNYNEQFF,0,1,1,1
TRBV11-2,TRBJ2-3,CASSLVPLAGRTDTQYF,0,1,1,1
TRBV7-2,TRBJ2-7,CASSLARLRTSPYEQYF,0,1,1,1
TRBV7-2,TRBJ2-5,CASSLAGTSGGQETQYF,0,1,1,1
TRBV5-4,TRBJ2-3,CASSLGPRDTNTDTQYF,0,1,1,1
TRBV11-3,TRBJ2-1,CASSLGGTTFGDDEQFF,0,1,1,1
TRBV7-8,TRBJ2-7,CASSLGVVAGGFYEQYF,0,1,1,1
TRBV7-9,TRBJ1-5,CASSLESSLGGNQPQHF,0,1,1,1
TRBV7-3,TRBJ1-1,CASSLIGGNEQVAEAFF,0,1,1,1
TRBV11-2,TRBJ2-5,CASSSPPAEAGDETQYF,0,1,1,1
TRBV3-1,TRBJ2-2,CASSLRRDRGNTGELFF,0,1,1,1
TRBV7-2,TRBJ2-7,CASSLFPRGGSPYEQYF,0,1,1,1
TRBV7-9,TRBJ2-7,CASSLSPVGDRFYEQYF,0,1,1,1
TRBV7-2,TRBJ2-2,CASSLWTLATNTGELFF,0,1,1,1
TRBV3-1,TRBJ2-5,CASSLRDRGLLQETQYF,0,1,1,1
TRBV6-2/3/5/6,TRBJ2-3,CASSPMRKVAGTDTQYF,0,1,1,1
TRBV2,TRBJ2-6,CASSPGGGRIGANVLTF,0,1,1,1
TRBV7-2,TRBJ2-3,CASSPAAAGSRTDTQYF,0,1,1,1
TRBV7-2,TRBJ2-4,CASSPWTSGTGKNIQYF,0,1,1,1
TRBV3-1,TRBJ2-7,CASSQPLSISGDYEQYF,0,1,1,1
TRBV3-1,TRBJ2-1,CASSQVGQVGSYNEQFF,0,1,1,1
TRBV3-1,TRBJ2-7,CASSQGRQDWGFYEQYF,0,1,1,1
TRBV7-8,TRBJ2-5,CASSEEKNRDFQETQYF,0,2,1,2
TRBV5-8,TRBJ2-5,CASRPRIQGAYRETQYF,0,1,1,1
TRBV6-4,TRBJ2-2,CASRGYAGVLNTGELFF,0,1,1,1
TRBV6-2/3/5/6,TRBJ2-7,CASRTTSGRRASYEQYF,0,1,1,1
TRBV12-3/4,TRBJ2-3,CASNKFRLAGERDTRYF,0,1,1,1
TRBV5-1,TRBJ1-1,CASSFGDRGSLNTEAFF,0,1,1,1
TRBV5-1,TRBJ2-1,CASSLEGLAGGVNEQFF,0,1,1,1
TRBV5-1,TRBJ1-4,CASSLERRNLANEKLFF,0,1,1,1
TRBV4-3,TRBJ2-1,CASSPQVAEAFFGEQFF,0,1,1,1
TRBV4-1,TRBJ1-4,CASSQVSFRVSNEKLFF,0,1,1,1
TRBV4-3,TRBJ2-1,CASSQEEELAGFNEQFF,0,1,1,1
TRBV5-1,TRBJ2-7,CASSNGLAGGLSYEQYF,0,1,1,1
TRBV20-1,TRBJ2-3,CSASTSGIPRGADTQYF,0,1,1,1
TRBV20-1,TRBJ2-3,CSASNRRDLASTDTQYF,0,1,1,1
TRBV20-1,TRBJ1-5,CSARDPSRSEANQPQHF,0,1,1,1
TRBV29-1,TRBJ2-1,CSVVGLAGVASYNEQFF,0,1,1,1
TRBV12-3/4,TRBJ2-7,SASSPSGVMGAYEQYF,0,1,1,1
TRBV30,TRBJ1-4,CAWSGPETGSNEKLFF,0,1,1,1
TRBV30,TRBJ2-1,CAWSGSGREFNNEQFF,0,1,1,1
TRBV19,TRBJ1-1,CARLRGIVGMNTEAFF,0,1,1,1
TRBV7-2,TRBJ2-4,CAGSPRAGIAKNIQYF,0,1,1,1
TRBV10-3,TRBJ1-5,CAISEWGTGDNQPQHF,0,1,1,1
TRBV11-3,TRBJ1-5,CAISSHRGCSNQPQHF,0,1,1,1
TRBV3-1,TRBJ2-2,CATTLSQAKSTGELFF,0,1,1,1
TRBV24-1,TRBJ2-1,CATSEPDRGANNEQFF,0,1,1,1
TRBV15,TRBJ2-6,CATSPTADSGANVLTF,0,2,1,2
TRBV15,TRBJ1-6,CATSTRDRFLNSPLHF,0,1,1,1
TRBV15,TRBJ2-1,CATSRDRLRMVNEQFF,0,1,1,1
TRBV25-1,TRBJ2-1,CATQLADRGPNNEQFF,0,1,1,1
TRBV19,TRBJ1-1,CASSAQGLPSGTEAFF,0,1,1,1
TRBV19,TRBJ2-2,CASSILTDPGTGELFF,0,1,1,1
TRBV19,TRBJ1-5,CASSIVKMTRDQPQHF,0,1,1,1
TRBV19,TRBJ2-1,CASSPLRSGGKNEQFF,0,1,1,1
TRBV19,TRBJ2-5,CASSPRLQPHQETQYF,0,1,1,1
TRBV19,TRBJ2-2,CASRSAGGSRTGELFF,0,1,1,1
TRBV18,TRBJ2-1,CASSPPTGGSYNEQFF,0,1,1,1
TRBV18,TRBJ1-5,CASSPLGVGSNQPQHF,0,1,1,1
TRBV7-2,TRBJ1-5,CASQKVGGDSNQPQHF,0,1,1,1
TRBV27,TRBJ2-7,CASAIQGRGPSYEQYF,0,1,1,1
TRBV7-2,TRBJ1-4,CASGRQGARANEKLFF,0,1,1,1
TRBV9,TRBJ2-2,CASGEERGPGGGELFF,0,1,1,1
TRBV12-3/4,TRBJ1-2,CASTSPSSEVNYGYTF,0,1,1,1
TRBV3-1,TRBJ2-7,CASTPGDSPGVDERYF,0,1,1,1
TRBV18,TRBJ1-1,CASTTGTGGMNTEAFF,0,1,1,1
TRBV6-2/3/5/6,TRBJ1-2,CASSFSPTGANYGYTF,0,1,1,1
TRBV6-2/3/5/6,TRBJ2-2,CASSLGSGGAAGELFF,0,1,1,1
TRBV6-2/3/5/6,TRBJ2-7,CASSLEWGGASYEQYF,0,1,1,1
TRBV27,TRBJ1-5,CASSLWATPGDQPQHF,0,1,1,1
TRBV6-2/3/5/6,TRBJ2-2,CASSLRPGGRSGELFF,0,1,1,1
TRBV6-1,TRBJ2-1,CASSLALPQGNNEQFF,0,1,1,1
TRBV12-3/4,TRBJ2-5,CASSLARGEGLETQYF,0,1,1,1
TRBV28,TRBJ2-7,CASSSTDRVILYEQYF,0,1,1,1
TRBV6-2/3/5/6,TRBJ1-6,CASSYLPGEQNSPLHF,0,1,1,1
TRBV6-2/3/5/6,TRBJ2-3,CASSYSLADLTDTQYF,0,1,1,1
TRBV6-2/3/5/6,TRBJ2-1,CASSYSILAGENEQFF,0,1,1,1
TRBV6-2/3/5/6,TRBJ2-3,CASSYSRTHGGDTQYF,0,1,1,1
TRBV6-2/3/5/6,TRBJ2-7,CASSYPGESGSYEQYF,0,1,1,1
TRBV6-4,TRBJ2-5,CASSRGGGTGQETQYF,0,1,1,1
TRBV12-3/4,TRBJ1-5,CASSAEAGGSNQPQHF,0,1,1,1
TRBV12-3/4,TRBJ1-2,CASSADRGRSNYGYTF,0,1,1,1
TRBV6-1,TRBJ2-1,CASSDLAGGPYNEQFF,0,1,1,1
TRBV2,TRBJ1-6,CASSDPAGVYNSPLHF,0,1,1,1
TRBV25-1,TRBJ2-1,CASSEFEGTGQREQFF,0,1,1,1
TRBV6-1,TRBJ2-1,CASSEGLAGAYNEQLS,0,1,1,1
TRBV25-1,TRBJ1-1,CASSEDRGRMNTEAFF,0,1,1,1
TRBV11-2,TRBJ2-7,CASSFSFQGNSYEQYF,0,1,1,1
TRBV7-8,TRBJ2-7,CASSFPGTGGAYEQYF,0,1,1,1
TRBV7-2,TRBJ2-5,CASSFSAGTLQETQYF,0,1,1,1
TRBV13,TRBJ2-1,CASSFVTSGSLHEQFF,0,1,1,1
TRBV5-8,TRBJ2-2,CASSFTGTGRTGELFF,0,1,1,1
TRBV7-8,TRBJ2-2,CASSFTAGGGTGELFF,0,1,1,1
TRBV7-8,TRBJ2-5,CASSFRTATPLGTQYF,0,1,1,1
TRBV5-4,TRBJ1-6,CASSLYRAGLNSPLHF,0,1,1,1
TRBV7-9,TRBJ2-3,CASSLVTSASTDTQYF,0,1,1,1
TRBV5-6,TRBJ1-2,CASSLARDRYTYGYTF,0,1,1,1
TRBV5-6,TRBJ2-7,CASSLGGALSSYEQYF,0,1,1,1
TRBV7-2,TRBJ2-1,CASSLRGPSGNNEQFF,0,1,1,1
TRBV7-9,TRBJ2-7,CASSLVGQGVSYEQYF,0,1,1,1
TRBV7-2,TRBJ2-1,CASSLDRLTFYNEQFF,0,1,1,1
TRBV7-9,TRBJ2-4,CASSLDRDAAKNIQYF,0,1,1,1
TRBV7-2,TRBJ2-1,CASSLRASGRVGEQFF,0,1,1,1
TRBV7-9,TRBJ1-4,CASSLRGTVTNEKLFF,0,1,1,1
TRBV7-9,TRBJ2-2,CASSLRGDRGTGELFF,0,1,1,1
TRBV11-2,TRBJ2-7,CASSSATSGVSYEQYF,0,1,1,1
TRBV5-4,TRBJ2-1,CASSSTSGDSYNEQFF,0,1,1,1
TRBV11-1,TRBJ2-5,CASSSPGPRTRETQYF,0,1,1,1
TRBV11-2,TRBJ2-6,CASSSRTLSGANVLTF,0,1,1,1
TRBV7-3,TRBJ1-1,CASSLRGGRVNTEAFF,0,1,1,1
TRBV7-9,TRBJ2-1,CASSPYTSGGYNEQFF,0,1,1,1
TRBV13,TRBJ2-5,CASSPRLAEPGETQYF,0,1,1,1
TRBV5-5,TRBJ2-2,CASSPDGSRGTGELFF,0,1,1,1
TRBV12-3/4,TRBJ2-7,CASSPRPSGRANEQYF,0,1,1,1
TRBV7-9,TRBJ2-7,CASSPKQGAAIFEQYF,0,1,1,1
TRBV7-8,TRBJ2-7,CASSPRGSGIQYEQYF,0,1,1,1
TRBV6-4,TRBJ1-6,CASSHGQGSYNSPLHF,0,1,1,1
TRBV3-1,TRBJ2-1,CASSQAGTGLYNEQFF,0,1,1,1
TRBV4-2,TRBJ2-3,CASSQRLAGGTDTQYF,0,2,1,2
TRBV3-1,TRBJ2-7,CASSQAVGLSSYEQYF,0,1,1,1
TRBV3-1,TRBJ1-5,CASSQDAGGLNQPQHF,0,1,1,1
TRBV4-2,TRBJ2-1,CASSQEGPGGANEQFF,0,1,1,1
TRBV9,TRBJ1-1,CASSAPWDGVNTEAFF,0,1,1,1
TRBV7-9,TRBJ2-2,CASSAQRPQGTGGLFF,0,1,1,1
TRBV6-1,TRBJ2-5,CASSEDIAGGEETQYF,0,1,1,1
TRBV6-2/3/5/6,TRBJ2-1,CASSTEGPRSYNEQFF,0,1,1,1
TRBV13,TRBJ2-5,CASSTRTSGKQETQYF,0,1,1,1
TRBV11-3,TRBJ2-7,CASSNQRNRDSHEQYF,0,1,1,1
TRBV7-2,TRBJ1-5,CASSNEGGWSNQPQHF,0,1,1,1
TRBV6-2/3/5/6,TRBJ2-2,CASRPTGTGDTGELFF,0,1,1,1
TRBV6-2/3/5/6,TRBJ2-7,CASRGLGASRHYEQYF,0,1,1,1
TRBV7-9,TRBJ1-2,CASRDGTASERRGYTF,0,1,1,1
TRBV6-4,TRBJ1-5,CASNSYIGFSNQPQHF,0,1,1,1
TRBV5-6,TRBJ1-1,CASSAGTGLMNTEAFF,0,1,1,1
TRBV27,TRBJ1-5,CGSRPSSWTANQPQHF,0,1,1,1
TRBV19,TRBJ1-5,CTSSIEGQGGNQPQHF,0,1,1,1
TRBV10-2,TRBJ2-1,CASSDPGGGKYNEQFF,0,1,1,1
TRBV5-1,TRBJ1-5,CASSLGTGGADQPQHF,0,1,1,1
TRBV5-1,TRBJ1-1,CASSLHNGGGNTEAFF,0,1,1,1
TRBV5-1,TRBJ2-2,CASSSFQGPNTGELFF,0,1,1,1
TRBV5-1,TRBJ2-7,CASSSYPGQGFGEQYF,0,1,1,1
TRBV5-1,TRBJ2-3,CASSLPGGPPTDTQYF,0,1,1,1
TRBV5-1,TRBJ1-1,CASSPGQGAMNTEAFF,0,1,1,1
TRBV4-1,TRBJ2-7,CASSQYPGQATYEQYF,0,1,1,1
TRBV4-1,TRBJ2-5,CASSQAGGGYQETQYF,0,1,1,1
TRBV4-1,TRBJ1-2,CASSQGSTEANYGYTF,0,1,1,1
TRBV4-1,TRBJ1-4,CASSQDQTGGVEKLFF,0,1,1,1
TRBV4-1,TRBJ1-1,CASSQEAITLNTEAFF,0,1,1,1
TRBV7-2,TRBJ2-1,CASSKDPSGRGHEQFF,0,1,1,1
TRBV5-1,TRBJ2-7,CASRPSAGQGIYEQYF,0,1,1,1
TRBV20-1,TRBJ2-5,CSAHASSGGVAETQYF,0,1,1,1
TRBV20-1,TRBJ2-1,CSATIGWTSGSDEQFF,0,1,1,1
TRBV20-1,TRBJ2-1,CSARPTEAGSVYEQFF,0,1,1,1
TRBV20-1,TRBJ2-3,CSARPGLAVSTDTQYF,0,1,1,1
TRBV20-1,TRBJ1-5,CSARGLGPRGNQPQHF,0,1,1,1
TRBV20-1,TRBJ2-5,CSARDPGTLFQETQYF,0,1,1,1
TRBV20-1,TRBJ1-4,CSARDARTSTREKLFF,0,1,1,1
TRBV20-1,TRBJ2-6,CSARDAYLSGANVLTF,0,1,1,1
TRBV20-1,TRBJ2-3,CSAVTADRVRPDTQYF,0,1,1,1
TRBV20-1,TRBJ2-7,CSASVGRGGLNYEQYF,0,1,1,1
TRBV29-1,TRBJ2-1,CSVERLAGNIYNEQFF,0,1,1,1
TRBV29-1,TRBJ2-3,CSVQNSGGSSTDTQYF,0,1,1,1
TRBV29-1,TRBJ2-6,CSVGQGASGGANVLTF,0,1,1,1
TRBV29-1,TRBJ2-3,CSAEGGTGFRTDTQYF,0,1,1,1
TRBV5-6,TRBJ1-2,RASSLGPGPGWYGYTF,0,1,1,1
TRBV12-5,TRBJ1-1,CASGLAEGSGTEAFF,0,1,1,1
TRBV15,TRBJ1-5,CASSRPTALLQPQHF,0,1,1,1
TRBV30,TRBJ2-3,CAWSLGAGEGNTQYF,0,1,1,1
TRBV30,TRBJ2-3,CAWTELAGGPDTQYF,0,1,1,1
TRBV30,TRBJ2-3,CAWSVGGAATDTQYF,0,1,1,1
TRBV30,TRBJ1-3,CAWSGQGLSGNTIYF,0,1,1,1
TRBV6-2/3/5/6,TRBJ1-1,CAGSYKAGRMTEAFF,0,1,1,1
TRBV10-3,TRBJ2-1,CAIRYGDKPYNEQFF,0,1,1,1
TRBV15,TRBJ2-2,CATSPGGEVTGELFF,0,1,1,1
TRBV24-1,TRBJ2-1,CATSDRQARGNEQFF,0,1,1,1
TRBV15,TRBJ2-5,CATSRSGTTRETQYF,0,1,1,1
TRBV19,TRBJ2-3,CASRNSDDYTDTQYF,0,1,1,1
TRBV19,TRBJ1-1,CASTDLRGKKTEAFF,0,1,1,1
TRBV19,TRBJ2-1,CASSIAGEGYNEQFF,0,1,1,1
TRBV19,TRBJ2-2,CASSRGQANTGELFF,0,1,1,1
TRBV7-6,TRBJ2-1,CASSLAVDSYNEQFF,0,1,1,1
TRBV19,TRBJ1-1,CASSPSGGRYGEAFF,0,1,1,1
TRBV19,TRBJ2-7,CASRCDGTEDYEQYF,0,1,1,1
TRBV18,TRBJ1-5,CASSPPGRGHQPQHF,0,1,1,1
TRBV18,TRBJ1-5,CASSPGQSSNQPQHF,0,1,1,1
TRBV5-4,TRBJ2-7,CASCSLPDSFYEQYF,0,1,1,1
TRBV9,TRBJ2-1,CASRPGLAGEGEQFF,0,1,1,1
TRBV2,TRBJ2-2,CASVLKRLSTGELFF,0,1,1,1
TRBV7-9,TRBJ2-7,CASGLAYRGVYEQYF,0,1,1,1
TRBV6-2/3/5/6,TRBJ1-2,CASGSGALFNYGYTF,0,1,1,1
TRBV7-2,TRBJ2-2,CASIRSGRNTGELFF,0,1,1,1
TRBV5-6,TRBJ2-1,CASMRAGGIYNEQFF,0,1,1,1
TRBV12-3/4,TRBJ1-1,CASSFGAPSNTEAFF,0,1,1,1
TRBV12-3/4,TRBJ2-5,CASSFGTSGLETQYF,0,1,1,1
TRBV12-3/4,TRBJ2-1,CASSLGQSSYNEQFF,0,1,1,1
TRBV12-3/4,TRBJ2-3,CASSLGRRRGDTQYF,0,1,1,1
TRBV6-2/3/5/6,TRBJ1-1,CASSLFGQENTEAFF,0,1,1,1
TRBV6-2/3/5/6,TRBJ2-3,CASSLQGGSTDTQYF,0,1,1,1
TRBV12-3/4,TRBJ1-1,CASSLVDRDYREAFF,0,1,1,1
TRBV12-3/4,TRBJ2-7,CASSLSSGGKYEQYF,0,1,1,1
TRBV12-3/4,TRBJ2-7,CASSSHTLAGYEQYF,0,1,1,1
TRBV28,TRBJ2-7,CASSSHDRVPYEQYF,0,1,1,1
TRBV12-3/4,TRBJ2-7,CASSSGTHGSYEQYF,0,1,1,1
TRBV6-2/3/5/6,TRBJ2-5,CASSWASGKPETQYF,0,1,1,1
TRBV6-2/3/5/6,TRBJ1-1,CASSYSAETNTEDFF,0,1,1,1
TRBV6-2/3/5/6,TRBJ2-1,CASSYSGSSYNEQFF,0,1,1,1
TRBV6-2/3/5/6,TRBJ2-7,CASSYSIGGSDEQYF,0,1,1,1
TRBV6-2/3/5/6,TRBJ1-4,CASSYSKAVSGKLFF,0,1,1,1
TRBV6-2/3/5/6,TRBJ2-5,CASSYSDRGEETQYF,0,1,1,1
TRBV6-2/3/5/6,TRBJ1-2,CASSYRPTDPYGYTF,0,1,1,1
TRBV6-2/3/5/6,TRBJ1-3,CASSYSRGTGNTIYF,0,1,1,1
TRBV6-2/3/5/6,TRBJ1-1,CASSYRGRMNTEAFF,0,1,1,1
TRBV6-2/3/5/6,TRBJ2-1,CASSLAGTPYNEQFF,0,1,1,1
TRBV6-2/3/5/6,TRBJ1-5,CASSLTGGKNQPQHF,0,1,1,1
TRBV7-9,TRBJ2-7,CASSLGQGSFYEQYF,0,1,1,1
TRBV6-2/3/5/6,TRBJ2-1,CASSPSGGRYNEQFF,0,1,1,1
TRBV6-4,TRBJ1-5,CASSPSLGGYQPQHF,0,1,1,1
TRBV28,TRBJ2-7,CASSPQGQGRREQYF,0,1,1,1
TRBV6-2/3/5/6,TRBJ2-5,CASSPSGALQETQYF,0,1,1,1
TRBV6-2/3/5/6,TRBJ2-3,CASSPWLTGTDTQYF,0,1,1,1
TRBV6-2/3/5/6,TRBJ2-4,CASSPRGGTQNIQYF,0,1,1,1
TRBV6-2/3/5/6,TRBJ2-5,CASSRTGGLQETQYF,0,1,1,1
TRBV27,TRBJ2-7,CASSQPDSRDYEQYY,0,1,1,1
TRBV2,TRBJ2-3,CASSARQGSTDTQYF,0,1,1,1
TRBV6-1,TRBJ2-1,CASSAGTSGYNEQFF,0,1,1,1
TRBV6-1,TRBJ1-5,CASSGAGERNQPQHF,0,1,1,1
TRBV6-4,TRBJ2-3,CASSGTRVGTDTQYF,0,1,1,1
TRBV6-1,TRBJ2-5,CASSGTQGDQETQYF,0,1,1,1
TRBV25-1,TRBJ1-2,CASSDWGQINYGYTF,0,1,1,1
TRBV12-3/4,TRBJ2-5,CASSDPGATQETQYF,0,1,1,1
TRBV25-1,TRBJ2-3,CASSDGGLSTDTQYF,0,1,1,1
TRBV2,TRBJ2-3,CASSDDTQAYDTQYF,0,1,1,1
TRBV6-1,TRBJ1-1,CASSEFQGAYTEAFF,0,1,1,1
TRBV2,TRBJ1-5,CASSELEISNQPQHF,0,1,1,1
TRBV2,TRBJ2-1,CASSEGSGAPNEQFF,0,1,1,1
TRBV6-1,TRBJ2-5,CASSENPFGTETQYF,0,1,1,1
TRBV12-3/4,TRBJ2-1,CASSSLWSSYNEQFF,0,1,1,1
TRBV7-2,TRBJ2-1,CASSFLAGVRNEQFF,0,1,1,1
TRBV7-9,TRBJ1-5,CASSFGTASNQPQHF,0,1,1,1
TRBV5-4,TRBJ2-3,CASSLPGQGADTQYF,0,1,1,1
TRBV5-4,TRBJ1-2,CASSLAAGYSYGYTF,0,1,1,1
TRBV5-5,TRBJ1-2,CASSLAGGQNYGYTF,0,1,1,1
TRBV5-6,TRBJ1-5,CASSLGATNNQPQHF,0,1,1,1
TRBV13,TRBJ2-3,CASSLTSGFTDTQYF,0,1,1,1
TRBV7-9,TRBJ2-3,CASSLSLATTDTQYF,0,1,1,1
TRBV7-6,TRBJ2-7,CASSLLVRDKYEQYF,0,1,1,1
TRBV5-6,TRBJ2-5,CASSLLTSGEETQYF,0,1,1,1
TRBV6-2/3/5/6,TRBJ2-2,CASSLWSSNTGELFF,0,1,1,1
TRBV7-9,TRBJ1-5,CASSLQGGGNQPQHF,0,1,1,1
TRBV7-2,TRBJ2-7,CASSLVSGGTYEQYF,0,1,1,1
TRBV7-9,TRBJ1-1,CASSLVVPGGTEAFF,0,1,1,1
TRBV7-2,TRBJ2-7,CASSLAGQVPHEQYF,0,1,1,1
TRBV7-9,TRBJ1-1,CASSLADSGNTEAFF,0,1,1,1
TRBV7-2,TRBJ2-1,CASSLAPSSHNEQFF,0,1,1,1
TRBV7-6,TRBJ2-1,CASSLAAQAANEQFF,0,1,1,1
TRBV7-2,TRBJ1-5,CASSLAARADQPQHF,0,1,1,1
TRBV11-3,TRBJ2-1,CASSLAGGPSNEQFF,0,1,1,1
TRBV7-9,TRBJ1-5,CASSLGPGVNQPQHF,0,1,1,1
TRBV7-9,TRBJ2-7,CASSLGRDSSYEQYF,0,1,1,1
TRBV7-9,TRBJ1-1,CASSLGEGMNTEAFF,0,1,1,1
TRBV7-2,TRBJ1-2,CASSLDGTGRRGYTF,0,1,1,1
TRBV7-2,TRBJ2-3,CASSLERGNPDTQYF,0,1,1,1
TRBV7-2,TRBJ2-5,CASSLEGAREETQYF,0,1,1,1
TRBV7-2,TRBJ2-5,CASSLMWGKQETQYF,0,1,1,1
TRBV7-3,TRBJ2-7,CASSLTGTVSYEQYF,0,1,1,1
TRBV7-9,TRBJ1-1,CASSLTGRMNTEAFF,0,1,1,1
TRBV7-2,TRBJ2-5,CASSLNPGVGETQYF,0,1,1,1
TRBV11-2,TRBJ1-6,CASSLNRGGNSPLHF,0,1,1,1
TRBV7-6,TRBJ1-5,CASSSTGIGNQPQHF,0,1,1,1
TRBV7-2,TRBJ2-7,CASSSSGSVSYEQYF,0,1,1,1
TRBV7-2,TRBJ2-1,CASSSSGSSYNEQFF,0,1,1,1
TRBV7-8,TRBJ2-7,CASSSRGHDYYEQYF,0,1,1,1
TRBV7-9,TRBJ1-3,CASSSGLRYGNTIYF,0,1,1,1
TRBV3-1,TRBJ2-7,CASSSSGTGAGEQYF,0,1,1,1
TRBV12-3/4,TRBJ2-1,CASSSVGLVYNEQFF,0,1,1,1
TRBV7-6,TRBJ2-4,CASSSGTGPQNIQYF,0,1,1,1
TRBV13,TRBJ2-5,CASSSTSGGQETQYF,0,1,1,1
TRBV6-2/3/5/6,TRBJ2-1,CASSWRGGMDNEQFF,0,1,1,1
TRBV14,TRBJ2-7,CASSLFGSGVYEQYF,0,1,1,1
TRBV7-3,TRBJ2-1,CASSLGTSGGNEQFF,0,1,1,1
TRBV13,TRBJ2-5,CASSLGRGERETQYF,0,1,1,1
TRBV27,TRBJ2-1,CASSLGRNPYNEQFF,0,1,1,1
TRBV7-2,TRBJ1-5,CASSLTRGRGQPQHF,0,1,1,1
TRBV7-2,TRBJ2-7,CASSLALGLGYEQYF,0,1,1,1
TRBV27,TRBJ2-1,CASSPAPGAYNEQFF,0,1,1,1
TRBV7-6,TRBJ2-5,CASSPPGGRVETQYF,0,1,1,1
TRBV7-8,TRBJ2-1,CASSPGRGAFYEQFF,0,1,1,1
TRBV6-2/3/5/6,TRBJ2-1,CASSPDWRGGNEQFF,0,1,1,1
TRBV9,TRBJ1-1,CASSPKDRVRTEAFF,0,1,1,1
TRBV3-1,TRBJ1-1,CASSPGGGQNTEAFF,0,1,1,1
TRBV5-6,TRBJ2-7,CASSPGQAYSYEQYF,0,1,1,1
TRBV7-9,TRBJ2-3,CASSPTGGGTDTQYF,0,1,1,1
TRBV7-9,TRBJ2-1,CASSPDRGLPYEQFF,0,1,1,1
TRBV7-6,TRBJ2-1,CASSHRSLPYNEQFF,0,1,1,1
TRBV5-4,TRBJ1-1,CASSQGAGVSTEAFS,0,1,1,1
TRBV11-3,TRBJ2-7,CASSQRPGPIYEQYF,0,1,1,1
TRBV14,TRBJ1-6,CASSQVPGNNSPLHF,0,1,1,1
TRBV14,TRBJ2-1,CASSQVTSGRGRRFF,0,1,1,1
TRBV3-1,TRBJ1-1,CASSQGGGGIGEAFF,0,1,1,1
TRBV3-1,TRBJ2-5,CASSQGWTSVETQYF,0,1,1,1
TRBV14,TRBJ2-7,CASSQDSALSYEQYF,0,1,1,1
TRBV3-1,TRBJ2-5,CASSQDLSGGETQYF,0,1,1,1
TRBV4-2,TRBJ2-5,CASSQDAPGGETQYF,0,1,1,1
TRBV3-1,TRBJ2-7,CASSQDLAGYDEQYF,0,1,1,1
TRBV3-1,TRBJ2-5,CASSQDQGGKETQYF,0,1,1,1
TRBV14,TRBJ2-1,CASSQDQLILNEQFF,0,1,1,1
TRBV4-2,TRBJ1-5,CASSQEYGGAQPQHF,0,1,1,1
TRBV9,TRBJ1-1,CASSVLGRSDTEAFF,0,1,1,1
TRBV9,TRBJ2-7,CASSVSRGYSYEQYF,0,1,1,1
TRBV9,TRBJ1-5,CASSVYPYSNQPQHF,0,1,1,1
TRBV9,TRBJ1-4,CASSATPSPDEKLFF,0,1,1,1
TRBV9,TRBJ2-3,CASSAGLAATDTQYF,0,1,1,1
TRBV7-2,TRBJ2-6,CASSATGSGANVLTF,0,1,1,1
TRBV7-2,TRBJ2-7,CASSGTGGRTYEQYF,0,1,1,1
TRBV7-2,TRBJ2-1,CASSEDGLGTAEQFF,0,1,1,1
TRBV7-6,TRBJ2-7,CASSTPGTPDYEQYF,0,1,1,1
TRBV3-1,TRBJ2-2,CASSNYGLPTGELFF,0,1,1,1
TRBV7-9,TRBJ1-1,CASRARADLNTEAFF,0,1,1,1
TRBV2,TRBJ1-4,CASRRGLQVSEKLFF,0,1,1,1
TRBV12-3/4,TRBJ2-7,CASRPGTSGSDEQYF,0,1,1,1
TRBV7-9,TRBJ2-2,CASRPTGMNTGELFF,0,1,1,1
TRBV6-2/3/5/6,TRBJ2-7,CASRHASVSSYEQYF,0,1,1,1
TRBV7-9,TRBJ2-1,CASRQGQGAYNEQFF,0,1,1,1
TRBV6-2/3/5/6,TRBJ2-3,CASRGTGDSTDTQYF,0,1,1,1
TRBV28,TRBJ1-5,CASRIGGQVTQPQHF,0,1,1,1
TRBV7-2,TRBJ2-1,CASRTRASSYNEQFF,0,1,1,1
TRBV5-1,TRBJ2-7,CASSLGSGESYEQYF,0,1,1,1
TRBV5-1,TRBJ2-3,CASSFLRQGTDTQYF,0,1,1,1
TRBV5-1,TRBJ2-1,CASSLVAGGYNEQFF,0,1,1,1
TRBV5-1,TRBJ2-7,CASSLTGDNTYEQYF,0,1,1,1
TRBV5-1,TRBJ2-2,CASSLRRDDHRELFF,0,1,1,1
TRBV5-1,TRBJ2-7,CASSLRQGAGYEQYF,0,1,1,1
TRBV5-1,TRBJ2-1,CASSSEGGGGNEQFF,0,1,1,1
TRBV5-1,TRBJ1-2,CASSSNPGQGGGYTF,0,1,1,1
TRBV4-3,TRBJ1-1,CASSPGGEVGAEAFF,0,1,1,1
TRBV4-1,TRBJ1-6,CASSHRTLGDSPLHF,0,1,1,1
TRBV4-1,TRBJ2-1,CASSQTSGGAYEQFF,0,1,1,1
TRBV4-1,TRBJ1-5,CASSQLGISNQPQHF,0,1,1,1
TRBV4-3,TRBJ2-7,CASSQRDGGGYEQYF,0,1,1,1
TRBV4-1,TRBJ1-6,CASSQAGLRLSSLHS,0,1,1,1
TRBV4-3,TRBJ2-7,CASSQGQGLAYEQYF,0,1,1,1
TRBV4-3,TRBJ1-1,CASSQDLDTSAEAFF,0,1,1,1
TRBV4-3,TRBJ2-1,CASSQDPLAGNEQFF,0,1,1,1
TRBV4-3,TRBJ1-2,CASSQDHGKGYGYTF,0,1,1,1
TRBV4-1,TRBJ1-5,CASSQEVTGDQPQHF,0,1,1,1
TRBV5-1,TRBJ1-1,CASRDDTYMNTEAFF,0,1,1,1
TRBV12-3/4,TRBJ2-2,CASNKLGFYTGELFF,0,1,1,1
TRBV20-1,TRBJ1-1,CSASHGQPTRSEAFF,0,1,1,1
TRBV29-1,TRBJ1-1,CSAPVPGQKNTEAFF,0,1,1,1
TRBV20-1,TRBJ2-7,CSAGGGLAVRGEQYF,0,1,1,1
TRBV20-1,TRBJ2-1,CSAGGLIHSYNEQFF,0,1,1,1
TRBV20-1,TRBJ2-3,CSARVPGQGQDTQYF,0,1,1,1
TRBV20-1,TRBJ1-5,CSARLARGAGQPQHF,0,1,1,1
TRBV20-1,TRBJ2-5,CSARPQRSPVETQYF,0,1,1,1
TRBV20-1,TRBJ2-7,CSARVYAGDTYEQYF,0,1,1,1
TRBV20-1,TRBJ2-2,CSARGSGRPGGELFF,0,1,1,1
TRBV20-1,TRBJ2-2,CSARDYGRDTGELFF,0,1,1,1
TRBV20-1,TRBJ2-1,CSARDLASGYGEQFF,0,1,1,1
TRBV20-1,TRBJ2-5,CSARDLKGRGETQYF,0,1,1,1
TRBV20-1,TRBJ2-1,CSARDVLAGRNEQFF,0,1,1,1
TRBV20-1,TRBJ2-7,CSARDGLAGGYEQYF,0,1,1,1
TRBV20-1,TRBJ2-5,CSARDKKQGTETQYF,0,1,1,1
TRBV20-1,TRBJ2-5,CSARESNSGGWTQYF,0,1,1,1
TRBV20-1,TRBJ2-1,CSARRVESSYNEQFF,0,1,1,1
TRBV20-1,TRBJ2-1,CSAPTRASGSNEQFF,0,1,1,1
TRBV20-1,TRBJ2-2,CSAQMDFTNTGELFF,0,1,1,1
TRBV20-1,TRBJ2-1,CSATLGGEAYNEQFF,0,1,1,1
TRBV20-1,TRBJ2-7,CSATIGGLGAYEQYF,0,1,1,1
TRBV20-1,TRBJ1-1,CSANRDRSASTEAFF,0,1,1,1
TRBV29-1,TRBJ2-5,CSVVPYRGKRETQYF,0,1,1,1
TRBV29-1,TRBJ1-1,CSVAYTGKRGTEAFF,0,1,1,1
TRBV29-1,TRBJ2-3,CSVGPRQGSTDTQYF,0,1,1,1
TRBV29-1,TRBJ2-3,CSVDTSGRATDTQYF,0,1,1,1
TRBV29-1,TRBJ1-1,CSVEEDSGASTEAFF,0,1,1,1
TRBV29-1,TRBJ1-2,CSVEGEQGGYNGYTF,0,1,1,1
TRBV29-1,TRBJ1-1,CSVEDLDSLNTEAFF,0,1,1,1
TRBV29-1,TRBJ2-1,CSVEEGTTTYNEQFF,0,1,1,1
TRBV29-1,TRBJ2-1,CSVESSSGSGEEQFF,0,1,1,1
TRBV29-1,TRBJ2-1,CSVSGTGGYHNEQFF,0,1,1,1
TRBV29-1,TRBJ2-3,CSVGRGPLGTDTQYF,0,1,1,1
TRBV29-1,TRBJ2-2,CSVEGEGTYTGELFF,0,1,1,1
TRBV29-1,TRBJ1-3,CSANLDRGRGNTIYF,0,1,1,1
TRBV12-5,TRBJ2-7,CASGLSQGAYEQYF,0,1,1,1
TRBV5-5,TRBJ1-1,CASGLWGAGTEAFF,0,1,1,1
TRBV15,TRBJ2-1,CASSQVGSYNEQFF,0,1,1,1
TRBV30,TRBJ1-3,CAWTKERDASTIYF,0,1,1,1
TRBV30,TRBJ1-2,CAWTGTGFGYGYTF,0,1,1,1
TRBV30,TRBJ1-4,CAWSGTAYNEKLFF,0,1,1,1
TRBV30,TRBJ1-5,CAWSGQSRNQPQYF,0,1,1,1
TRBV30,TRBJ1-1,CARNPGPLNTEAFF,0,1,1,1
TRBV10-3,TRBJ2-1,CAATSGGSYNEQFF,0,1,1,1
TRBV10-3,TRBJ2-3,CAGGTGKGPDTQYF,0,1,1,1
TRBV3-1,TRBJ1-1,CAGSQDQGYTEAFF,0,1,1,1
TRBV10-3,TRBJ2-1,CAISRGGPPNEQFF,0,1,1,1
TRBV10-3,TRBJ2-5,CAISSDRGGETLYS,0,1,1,1
TRBV10-3,TRBJ2-7,CAISDVESSYEQYF,0,1,1,1
TRBV10-3,TRBJ2-5,CAIRASGRDQTQYF,0,1,1,1
TRBV10-3,TRBJ1-1,CAINQDLGNTEAFF,0,1,1,1
TRBV12-3/4,TRBJ1-6,CATSLRLYNSPLHF,0,1,1,1
TRBV24-1,TRBJ2-2,CATSGDRDTGELFF,0,1,1,1
TRBV15,TRBJ2-3,CATSLARRTDTQYF,0,1,1,1
TRBV24-1,TRBJ2-5,CATRRQPGPETQYF,0,1,1,1
TRBV2,TRBJ2-1,CATLGGGMGNEQFF,0,1,1,1
TRBV5-5,TRBJ2-7,CASLRDLRSYEQYF,0,1,1,1
TRBV2,TRBJ2-1,CASRSGASGNEQFF,0,1,1,1
TRBV19,TRBJ2-7,CASSLRDGAYEQYF,0,1,1,1
TRBV19,TRBJ1-4,CASSDTGDREKLFF,0,1,1,1
TRBV19,TRBJ2-4,CASSSNRALNIQYF,0,1,1,1
TRBV19,TRBJ1-5,CASSKAPGNQPQHF,0,1,1,1
TRBV19,TRBJ2-7,CASSGLDSRRGQYF,0,1,1,1
TRBV7-2,TRBJ2-7,CASRDRSGSYEQYF,0,1,1,1
TRBV18,TRBJ2-7,CASSPAGAGDEQYF,0,1,1,1
TRBV18,TRBJ2-5,CASSLKKYQETQYF,0,1,1,1
TRBV18,TRBJ2-3,CASSPRENTDTQYF,0,1,1,1
TRBV18,TRBJ1-2,CASSPAGTVDGCTF,0,1,1,1
TRBV18,TRBJ1-1,CASSPADMNTEAFF,0,1,1,1
TRBV18,TRBJ2-1,CASSPTTRNNEQFF,0,1,1,1
TRBV18,TRBJ2-5,CASSPPVKKETQYF,0,1,1,1
TRBV18,TRBJ1-2,CASSPGEAARGYTF,0,1,1,1
TRBV6-2/3/5/6,TRBJ2-1,CASWDAGLYNEQFF,0,1,1,1
TRBV19,TRBJ1-2,CASRDRVVRAGYTF,0,1,1,1
TRBV7-2,TRBJ2-7,CASATGQGFYEQYF,0,1,1,1
TRBV27,TRBJ2-7,CASADRPGSYEQYF,0,1,1,1
TRBV2,TRBJ1-6,CASTTGTRNSPLHF,0,1,1,1
TRBV6-2/3/5/6,TRBJ1-6,CASTSEKHNSPLHF,0,1,1,1
TRBV7-6,TRBJ2-5,CASTPGGGLETQYF,0,1,1,1
TRBV27,TRBJ2-1,CASTAREGLNEQFF,0,1,1,1
TRBV12-3/4,TRBJ2-7,CASTMGGPSYEQYF,0,1,1,1
TRBV5-6,TRBJ2-7,CASTKGGTGGEQYF,0,1,1,1
TRBV12-3/4,TRBJ2-1,CASSFRSGRDEQFF,0,1,1,1
TRBV12-3/4,TRBJ2-7,CASSLGGVSYEQYF,0,1,1,1
TRBV27,TRBJ2-1,CASSLSSAYNEQFF,0,1,1,1
TRBV6-2/3/5/6,TRBJ1-2,CASSLGTDNYGYTF,0,1,1,1
TRBV12-3/4,TRBJ2-4,CASSLGGLVRIQYF,0,1,1,1
TRBV6-2/3/5/6,TRBJ1-2,CASSLDGTAYGYTF,0,1,1,1
TRBV6-2/3/5/6,TRBJ2-1,CASSLTAFFNEQFF,0,1,1,1
TRBV12-3/4,TRBJ1-5,CASSLRAGNQPQHF,0,1,1,1
TRBV6-2/3/5/6,TRBJ2-5,CASSLRTGGETQYF,0,1,1,1
TRBV7-9,TRBJ2-3,CASSSDRDPHTQYF,0,1,1,1
TRBV6-2/3/5/6,TRBJ2-5,CASSSLAGQETQYF,0,1,1,1
TRBV12-3/4,TRBJ2-1,CASSSQTGDNEQFF,0,1,1,1
TRBV6-2/3/5/6,TRBJ2-5,CASSYSEPGLTQYF,0,1,1,1
TRBV6-2/3/5/6,TRBJ2-5,CASSYSSRQETQYF,0,1,1,1
TRBV6-2/3/5/6,TRBJ2-2,CASSYSGVGGELFF,0,1,1,1
TRBV6-2/3/5/6,TRBJ2-7,CASSYREGIYEQYF,0,1,1,1
TRBV12-3/4,TRBJ2-5,CASSLGGAGETQYF,0,1,1,1
TRBV6-2/3/5/6,TRBJ1-2,CASSPPGTNYGYTF,0,1,1,1
TRBV7-3,TRBJ2-2,CASSRGAGTGKLFF,0,1,1,1
TRBV7-2,TRBJ2-7,CASSQGWQGDEQYF,0,1,1,1
TRBV14,TRBJ2-2,CASSQGTDTGELFF,0,1,1,1
TRBV2,TRBJ2-7,CASSVQSFDYEQYF,0,1,1,1
TRBV2,TRBJ2-3,CASSAGIGADTQYF,0,1,1,1
TRBV25-1,TRBJ1-5,CASSGSTGLEPQHF,0,1,1,1
TRBV6-1,TRBJ1-2,CASSDVVHVYGYTF,0,1,1,1
TRBV6-4,TRBJ1-2,CASSDLTGRAGYTF,0,2,1,2
TRBV2,TRBJ2-1,CASSDSTPYNEQFF,0,1,1,1
TRBV2,TRBJ2-7,CASSELAGVLEQYF,0,1,1,1
TRBV25-1,TRBJ2-7,CASSESPGSYEQYF,0,1,1,1
TRBV25-1,TRBJ1-5,CASSESGYNQPQHF,0,1,1,1
TRBV6-1,TRBJ2-1,CASSEPLAGVFQFF,0,1,1,1
TRBV6-1,TRBJ1-3,CASSEGFDLDTIYF,0,1,1,1
TRBV6-1,TRBJ2-1,CASSEDQSYNEQFF,0,1,1,1
TRBV6-1,TRBJ1-2,CASSENVEIYGYTF,0,1,1,1
TRBV6-2/3/5/6,TRBJ2-5,CASSILRGRETQNF,0,1,1,1
TRBV6-2/3/5/6,TRBJ2-5,CASSTGGIQETQYF,0,1,1,1
TRBV6-2/3/5/6,TRBJ1-1,CASSSSGAVTEAFF,0,1,1,1
TRBV5-4,TRBJ2-5,CASSFWGVGETQYF,0,1,1,1
TRBV5-6,TRBJ1-5,CASSFLATNQPQHF,0,1,1,1
TRBV5-4,TRBJ2-1,CASSFRAGYGEQFF,0,1,1,1
TRBV7-9,TRBJ2-1,CASSFLAGGREQFF,0,1,1,1
TRBV5-4,TRBJ1-1,CASSFGQPNTEAFF,0,1,1,1
TRBV11-3,TRBJ2-2,CASSFMGNTGELFF,0,1,1,1
TRBV6-2/3/5/6,TRBJ1-6,CASSFNRARATLHF,0,1,1,1
TRBV5-8,TRBJ2-3,CASSLDRGGDTQYF,0,1,1,1
TRBV5-8,TRBJ2-5,CASSLRDSEETQYF,0,1,1,1
TRBV7-9,TRBJ1-2,CASSLFGDNYGYTF,0,1,1,1
TRBV7-2,TRBJ2-7,CASSLSFRLGEQYF,0,1,1,1
TRBV7-9,TRBJ2-5,CASSLSTGGETQYF,0,1,1,1
TRBV7-9,TRBJ2-5,CASSLLASQETQYF,0,1,1,1
TRBV7-9,TRBJ2-5,CASSLPWDLETQYF,0,1,1,1
TRBV7-9,TRBJ2-1,CASSLVLGGSEQFF,0,1,1,1
TRBV7-9,TRBJ2-5,CASSLVRSQETQYF,0,1,1,1
TRBV7-9,TRBJ1-2,CASSLALTGDGYTF,0,1,1,1
TRBV11-2,TRBJ1-5,CASSLAGGYQPQHF,0,1,1,1
TRBV11-2,TRBJ2-7,CASSLGPRVYEQYF,0,1,1,1
TRBV11-1,TRBJ2-5,CASSLGSLQETQYF,0,1,1,1
TRBV7-9,TRBJ1-1,CASSLGWTVTEAFF,0,1,1,1
TRBV6-2/3/5/6,TRBJ2-7,CASSLGLAGREQYF,0,1,1,1
TRBV7-9,TRBJ1-2,CASSLDSANYGYTF,0,1,1,1
TRBV7-9,TRBJ1-1,CASSLERVSTEAFF,0,1,1,1
TRBV7-9,TRBJ1-2,CASSLTPFNYGYTF,0,1,1,1
TRBV13,TRBJ1-2,CASSLTGSNYGYTF,0,1,1,1
TRBV7-9,TRBJ2-4,CASSLSGSGNIQYF,0,1,1,1
TRBV7-2,TRBJ1-6,CASSLNGATSPLHF,0,1,1,1
TRBV7-9,TRBJ1-2,CASSSSGTAYGYTF,0,1,1,1
TRBV7-9,TRBJ2-5,CASSSGLEQETQYF,0,1,1,1
TRBV5-6,TRBJ1-1,CASSSALPNTEAFF,0,1,1,1
TRBV7-9,TRBJ2-1,CASSWTSSYNEQFF,0,1,1,1
TRBV6-2/3/5/6,TRBJ1-2,CASSYSDRANGYTF,0,1,1,1
TRBV13,TRBJ1-3,CASSLDGATNTIYF,0,1,1,1
TRBV7-9,TRBJ1-2,CASSLYTPEYGYTF,0,1,1,1
TRBV3-1,TRBJ2-5,CASSPPTSKETQYF,0,1,1,1
TRBV5-4,TRBJ2-7,CASSPVFSSHEQYF,0,1,1,1
TRBV7-3,TRBJ2-3,CASSPGLAPDTQYF,0,1,1,1
TRBV3-1,TRBJ1-4,CASSPGRSNEKLFF,0,1,1,1
TRBV7-2,TRBJ2-4,CASSPWDGKNIQYF,0,1,1,1
TRBV7-6,TRBJ2-2,CASSPLQEAGELFF,0,1,1,1
TRBV6-4,TRBJ2-7,CASSPPGLAGGPIF,0,1,1,1
TRBV7-3,TRBJ2-1,CASSPPGQGTEQFF,0,1,1,1
TRBV5-5,TRBJ2-5,CASSPRTGTETQYF,0,1,1,1
TRBV7-2,TRBJ2-7,CASSPRAAGYEQYF,0,1,1,1
TRBV14,TRBJ1-1,CASSPRGQNTEAFF,0,1,1,1
TRBV11-2,TRBJ2-1,CASSPVGSYNEQFF,0,1,1,1
TRBV7-2,TRBJ2-3,CASSPGYSTDTQYF,0,1,1,1
TRBV7-2,TRBJ2-5,CASSPGRTQETQYF,0,1,1,1
TRBV9,TRBJ1-3,CASSPGGDGNTIYF,0,1,1,1
TRBV3-1,TRBJ1-4,CASSPSHGNEKLFF,0,1,1,1
TRBV13,TRBJ2-3,CASSPWPGTDTQYF,0,1,1,1
TRBV3-1,TRBJ2-7,CASSPVRGSYEQYF,0,1,1,1
TRBV7-2,TRBJ2-5,CASSPQGKQETKYF,0,1,1,1
TRBV12-3/4,TRBJ1-2,CASSRRRDFYGYTF,0,1,1,1
TRBV13,TRBJ2-1,CASSRRTPYNEQFF,0,1,1,1
TRBV14,TRBJ2-5,CASSRAGTPETQYF,0,1,1,1
TRBV3-1,TRBJ1-1,CASSHNRMNTEAFF,0,1,1,1
TRBV7-9,TRBJ2-7,CASSQRQSSYEQYF,0,1,1,1
TRBV4-2,TRBJ2-1,CASSQDSGLAEQFF,0,1,1,1
TRBV6-4,TRBJ2-3,CASSQDTSQGGQYF,0,1,1,1
TRBV3-1,TRBJ1-2,CASSQDRANYGYTF,0,1,1,1
TRBV3-1,TRBJ2-5,CASSQDLGGGTQYF,0,1,1,1
TRBV14,TRBJ2-1,CASSQDDFYNEQFF,0,1,1,1
TRBV13,TRBJ1-4,CASSVAGRNEKLFF,0,1,1,1
TRBV11-2,TRBJ2-4,CASSAGSGGSIQYF,0,1,1,1
TRBV7-2,TRBJ2-7,CASSGNRGPYEQYF,0,1,1,1
TRBV7-9,TRBJ1-5,CASSGDSSNQPQHF,0,1,1,1
TRBV7-3,TRBJ2-7,CASSGSGGNYEQYF,0,1,1,1
TRBV13,TRBJ2-1,CASSDRWGNNEQFF,0,1,1,1
TRBV6-4,TRBJ1-1,CASSDGTGADEAFF,0,1,1,1
TRBV7-6,TRBJ2-7,CASSMARDTYEQYF,0,1,1,1
TRBV6-2/3/5/6,TRBJ1-6,CASSIGGNNSPLHF,0,1,1,1
TRBV5-4,TRBJ1-1,CASSTPRQGGQRFF,0,1,1,1
TRBV7-6,TRBJ2-1,CASSTPSRALPWFF,0,1,1,1
TRBV7-9,TRBJ2-5,CASSKDRGQETQYF,0,1,1,1
TRBV12-3/4,TRBJ2-4,CASRPSGGKNIQYF,0,1,1,1
TRBV2,TRBJ2-3,CASRPGLASDTQYF,0,1,1,1
TRBV12-3/4,TRBJ2-3,CASRGTGRSNTQYF,0,1,1,1
TRBV12-3/4,TRBJ2-5,CASRSTGSQETQYF,0,1,1,1
TRBV7-9,TRBJ1-1,CASRQLTGYTEAFF,0,1,1,1
TRBV6-2/3/5/6,TRBJ1-1,CASRASGMNTEAFF,0,1,1,1
TRBV6-2/3/5/6,TRBJ2-7,CASKWEQGPYEPYF,0,1,1,1
TRBV6-2/3/5/6,TRBJ1-1,CASKVLRDTLEAFF,0,1,1,1
TRBV19,TRBJ2-5,CARSPASEQETQYF,0,1,1,1
TRBV4-3,TRBJ2-5,CASPAKGPQETQYF,0,1,1,1
TRBV5-1,TRBJ1-5,CASSRDGNNQPQHF,0,1,1,1
TRBV5-1,TRBJ1-2,CASSLVMGNYGYTF,0,1,1,1
TRBV5-1,TRBJ2-5,CASSLVDHQETQYF,0,1,1,1
TRBV5-1,TRBJ1-1,CASSLGGMNTEAFF,0,1,1,1
TRBV5-1,TRBJ2-7,CASSLGGRDYEQYF,0,1,1,1
TRBV5-1,TRBJ2-5,CASSLDSLIGTQYF,0,1,1,1
TRBV5-1,TRBJ2-7,CASSLTGGFYEQYF,0,1,1,1
TRBV5-1,TRBJ2-7,CASSSPGPTGEQYF,0,1,1,1
TRBV4-3,TRBJ2-3,CASSPAQRFVTQYF,0,1,1,1
TRBV4-3,TRBJ1-1,CASSHATGGTEAFF,0,1,1,1
TRBV5-1,TRBJ2-7,CASSQGRSSYEQYF,0,1,1,1
TRBV5-1,TRBJ1-1,CASSQWQGDTEAFF,0,1,1,1
TRBV4-1,TRBJ1-2,CASSQLQLTYGYTF,0,1,1,1
TRBV4-3,TRBJ1-1,CASSQDSVDTEAFF,0,1,1,1
TRBV4-1,TRBJ1-5,CASSQEEGDQPQHF,0,1,1,1
TRBV4-1,TRBJ2-7,CASSQEPGEYEQYF,0,2,1,2
TRBV5-1,TRBJ2-7,CASSDTESSYEQYF,0,1,1,1
TRBV5-1,TRBJ2-4,CASSETLAKNIQFF,0,1,1,1
TRBV20-1,TRBJ1-5,CSAGGRVGNQPQHF,0,1,1,1
TRBV20-1,TRBJ1-2,CSAETGTSRYGYTF,0,1,1,1
TRBV20-1,TRBJ2-3,CSAIDGTAQDTQYF,0,1,1,1
TRBV20-1,TRBJ2-5,CSATRLGNQETQYF,0,1,1,1
TRBV20-1,TRBJ2-4,CSATGKGDENIQYF,0,1,1,1
TRBV20-1,TRBJ2-1,CSASGGDPYNEQFF,0,1,1,1
TRBV20-1,TRBJ2-7,CSASETGDAYEQYF,0,1,1,1
TRBV20-1,TRBJ1-4,CSARSGSENEKLFF,0,1,1,1
TRBV20-1,TRBJ2-1,CSARPPSGYNEQFF,0,1,1,1
TRBV20-1,TRBJ2-3,CSARDLSFTDTQYF,0,1,1,1
TRBV20-1,TRBJ2-7,CSAFRDLGSYEQYF,0,1,1,1
TRBV20-1,TRBJ2-4,CSALTGVPLNIQYF,0,1,1,1
TRBV20-1,TRBJ2-7,CSAPGQGADYEQYF,0,1,1,1
TRBV20-1,TRBJ1-6,CSAQQGATNSPLHF,0,1,1,1
TRBV20-1,TRBJ2-1,CSAREPAQYNEQFF,0,1,1,1
TRBV20-1,TRBJ2-7,CSAPNAGASYEQYF,0,1,1,1
TRBV20-1,TRBJ2-7,CSAPLRGGTYEQYF,0,1,1,1
TRBV20-1,TRBJ2-1,CSAERTSTNNEQFF,0,1,1,1
TRBV20-1,TRBJ2-7,CSGEAGGPSYEQYF,0,1,1,1
TRBV29-1,TRBJ1-1,CSVQRGGGYTEAFF,0,1,1,1
TRBV29-1,TRBJ2-1,CSVVTGTIYNEQFF,0,1,1,1
TRBV29-1,TRBJ2-5,CSVGIAGGKETQYF,0,1,1,1
TRBV29-1,TRBJ2-7,CSVEVTGGSDEQYF,0,1,1,1
TRBV29-1,TRBJ1-2,CSVEETPPNYGYTF,0,1,1,1
TRBV29-1,TRBJ2-3,CSVEEGLAPDTQYF,0,1,1,1
TRBV29-1,TRBJ1-2,CSVKLDRGPYGYTF,0,1,1,1
TRBV29-1,TRBJ1-1,CSVKGGGLDTEAFF,0,1,1,1
TRBV29-1,TRBJ2-1,CSVHDQSSYNEQFF,0,1,1,1
TRBV29-1,TRBJ1-2,CSVAGDERSYGYTF,0,1,1,1
TRBV29-1,TRBJ1-2,CSAEVGQPTYGYTF,0,1,1,1
TRBV29-1,TRBJ2-3,CSARTISSTDTQYF,0,1,1,1
TRBV29-1,TRBJ1-1,CSGATGGVPTEAFF,0,1,1,1
TRBV2,TRBJ1-5,CASQGRENQPQHF,0,1,1,1
TRBV30,TRBJ2-3,CAWGTSGTDTQYF,0,1,1,1
TRBV30,TRBJ2-3,CAWIHSGTDTQYF,0,1,1,1
TRBV30,TRBJ1-2,CAWSAGTDYGYTF,0,1,1,1
TRBV30,TRBJ2-3,CAWSRPGGDTQYF,0,1,1,1
TRBV30,TRBJ2-2,CAWSRQNTGELFF,0,1,1,1
TRBV30,TRBJ1-1,CALQGTLNTEAFF,0,1,1,1
TRBV24-1,TRBJ2-5,CAASDGYQETQYF,0,1,1,1
TRBV19,TRBJ2-3,CAGPGAHTDTQYF,0,1,1,1
TRBV24-1,TRBJ2-3,CATSEWGAATQYF,0,1,1,1
TRBV2,TRBJ1-3,CATQEDSGNTIYF,0,1,1,1
TRBV19,TRBJ1-1,CASFGTANTEAFF,0,1,1,1
TRBV19,TRBJ2-5,CASAPSAQETQYF,0,1,1,1
TRBV19,TRBJ2-7,CASGIGSSYEQYF,0,1,1,1
TRBV12-3/4,TRBJ1-1,CASGLRTYTEAVF,0,1,1,1
TRBV19,TRBJ2-1,CASTRSGNNEQFF,0,1,1,1
TRBV19,TRBJ2-7,CASTPGGIYEQYF,0,1,1,1
TRBV19,TRBJ2-1,CASSLAVYNEQFF,0,1,1,1
TRBV19,TRBJ2-1,CASSPPRYNEQFF,0,1,1,1
TRBV19,TRBJ1-5,CASSPAENQPQHF,0,2,1,2
TRBV19,TRBJ2-7,CASSANQGREQYF,0,1,1,1
TRBV19,TRBJ1-2,CASSIEPNYGYTF,0,1,1,1
TRBV19,TRBJ1-1,CASSRDRGTEAFF,0,1,1,1
TRBV19,TRBJ2-3,CASRPTSTDTQYF,0,1,1,1
TRBV18,TRBJ2-1,CASSLGTSGEQFF,0,1,1,1
TRBV18,TRBJ1-1,CASSPPQSKKAFF,0,1,1,1
TRBV13,TRBJ2-3,CASPLKDRDTQYF,0,1,1,1
TRBV6-4,TRBJ1-1,CASGRGLNTEAFF,0,1,1,1
TRBV2,TRBJ2-7,CASGRDRGYEQYF,0,1,1,1
TRBV6-2/3/5/6,TRBJ2-3,CASIQRSTDTQYF,0,1,1,1
TRBV6-2/3/5/6,TRBJ1-4,CASIGPSAEKLFF,0,1,1,1
TRBV9,TRBJ1-4,CASTGPTNEKLFF,0,1,1,1
TRBV6-2/3/5/6,TRBJ1-1,CASTSTGGTEAFF,0,1,1,1
TRBV7-2,TRBJ1-1,CASTRTGDTEAFF,0,1,1,1
TRBV6-2/3/5/6,TRBJ2-5,CASTGRAAETQYF,0,1,1,1
TRBV28,TRBJ1-5,CASTDSWNQPQHF,0,1,1,1
TRBV12-3/4,TRBJ2-7,CASSFQGSYEQYF,0,1,1,1
TRBV6-2/3/5/6,TRBJ2-3,CASSFLGTDTQYF,0,1,1,1
TRBV12-3/4,TRBJ2-2,CASSFPGAGELFF,0,1,1,1
TRBV7-9,TRBJ2-7,CASSFRGGNEQYF,0,1,1,1
TRBV27,TRBJ2-7,CASSLDNAYEQYF,0,1,1,1
TRBV6-2/3/5/6,TRBJ2-7,CASSLPTGDEQYF,0,1,1,1
TRBV12-3/4,TRBJ1-6,CASSLQGNSPLHF,0,1,1,1
TRBV12-3/4,TRBJ1-2,CASSLVEEYGYTF,0,1,1,1
TRBV28,TRBJ2-7,CASSLKLFGEQYF,0,1,1,1
TRBV12-3/4,TRBJ2-5,CASSSGTGGGQYF,0,1,1,1
TRBV6-2/3/5/6,TRBJ1-1,CASSYQRNTEAFF,0,1,1,1
TRBV6-2/3/5/6,TRBJ2-1,CASSYLTRNEQFF,0,1,1,1
TRBV6-2/3/5/6,TRBJ2-7,CASSYSQGGEQYF,0,1,1,1
TRBV6-2/3/5/6,TRBJ2-1,CASSYRENNEQFF,0,1,1,1
TRBV5-1,TRBJ1-5,CASSYGGNQPQHF,0,2,1,2
TRBV5-4,TRBJ2-7,CASSYRGRGEQYF,0,1,1,1
TRBV12-3/4,TRBJ1-6,CASSPQAGSRLHF,0,1,1,1
TRBV12-3/4,TRBJ2-4,CASSPQGVDIQYF,0,1,1,1
TRBV6-2/3/5/6,TRBJ1-1,CASSRDSYTEAFF,0,1,1,1
TRBV6-2/3/5/6,TRBJ1-6,CASSRIGASPLHF,0,1,1,1
TRBV6-1,TRBJ1-1,CASSATGGTEAFF,0,1,1,1
TRBV6-1,TRBJ2-5,CASSGARIETQYF,0,1,1,1
TRBV2,TRBJ1-1,CASSDLRDSEAFF,0,1,1,1
TRBV25-1,TRBJ2-7,CASSESATYDQYF,0,1,1,1
TRBV6-1,TRBJ1-5,CASSEGSNQPQHF,0,1,1,1
TRBV6-1,TRBJ2-7,CASSELHQAKQYF,0,1,1,1
TRBV7-2,TRBJ1-2,CASSFLSDYGYTF,0,1,1,1
TRBV7-6,TRBJ2-7,CASSFRETYEQYF,0,1,1,1
TRBV5-6,TRBJ2-7,CASSFQGTKEQYF,0,1,1,1
TRBV5-4,TRBJ2-7,CASSLWGTYEQYF,0,1,1,1
TRBV5-4,TRBJ2-3,CASSLLTRDTQYF,0,1,1,1
TRBV5-6,TRBJ1-1,CASSLVSNTEAFS,0,1,1,1
TRBV5-8,TRBJ1-2,CASSLGQGGGYTF,0,1,1,1
TRBV7-2,TRBJ1-2,CASSLDTSYGYTF,0,1,1,1
TRBV5-6,TRBJ1-2,CASSLIGDYGYAF,0,1,1,1
TRBV11-2,TRBJ2-2,CASSLLTTGELFF,0,1,1,1
TRBV7-9,TRBJ1-6,CASSLSSNSPLHF,0,1,1,1
TRBV5-8,TRBJ1-1,CASSLSGTAEAFF,0,1,1,1
TRBV7-7,TRBJ2-3,CASSLSGRDTQYF,0,1,1,1
TRBV13,TRBJ1-1,CASSLRGKTEAFF,0,2,1,2
TRBV7-2,TRBJ2-1,CASSLVAPGGQFF,0,1,1,1
TRBV13,TRBJ2-5,CASSLGPEETQYF,0,1,1,1
TRBV7-9,TRBJ1-1,CASSLDIGAEAFF,0,1,1,1
TRBV11-2,TRBJ2-7,CASSLDQGGEQYF,0,1,1,1
TRBV7-9,TRBJ1-1,CASSLDIGSEAFF,0,1,1,1
TRBV7-2,TRBJ2-1,CASSLTRGNEQFF,0,1,1,1
TRBV7-2,TRBJ1-1,CASSLTPNTEAFF,0,1,1,1
TRBV7-8,TRBJ2-7,CASSSVGAYEQYF,0,1,1,1
TRBV7-9,TRBJ1-2,CASSSRQNYGYTF,0,1,1,1
TRBV5-5,TRBJ2-5,CASSWGAEETQYF,0,2,1,2
TRBV7-2,TRBJ2-7,CASSLGQWYEQFF,0,1,1,1
TRBV7-9,TRBJ1-2,CASSLQRFDGYTF,0,1,1,1
TRBV4-2,TRBJ2-7,CASSLGQFNEQYF,0,1,1,1
TRBV11-2,TRBJ2-1,CASSLSGRHEQFF,0,1,1,1
TRBV6-2/3/5/6,TRBJ1-2,CASSPGQGRGYTF,0,1,1,1
TRBV9,TRBJ1-1,CASSPNGGTEAFF,0,1,1,1
TRBV6-2/3/5/6,TRBJ2-7,CASSPGTNYEQYF,0,1,1,1
TRBV2,TRBJ1-1,CASSRPVNTEAFF,0,1,1,1
TRBV4-2,TRBJ2-7,CASSRDSLYEQYF,0,1,1,1
TRBV5-4,TRBJ1-2,CASSRRDRYGYTF,0,1,1,1
TRBV14,TRBJ1-2,CASSRTLGSGYTF,0,1,1,1
TRBV11-3,TRBJ1-1,CASSRSGDTEAFF,0,1,1,1
TRBV5-6,TRBJ1-2,CASSRALFYGYTF,0,1,1,1
TRBV4-2,TRBJ1-1,CASSRGGIVEAFF,0,1,1,1
TRBV6-2/3/5/6,TRBJ1-3,CASSHQGGNTIYF,0,1,1,1
TRBV3-1,TRBJ1-1,CASSQQGRAEAFF,0,1,1,1
TRBV3-1,TRBJ1-1,CASSQSGGQAAFF,0,1,1,1
TRBV7-9,TRBJ1-2,CASSQRGGYGYTF,0,1,1,1
TRBV9,TRBJ2-7,CASSVGGSYEQYF,0,1,1,1
TRBV5-8,TRBJ2-1,CASSGPDYNEQFF,0,1,1,1
TRBV12-3/4,TRBJ1-2,CASRGISNYGYTF,0,1,1,1
TRBV6-2/3/5/6,TRBJ1-1,CASRRSGDTEAFF,0,1,1,1
TRBV7-8,TRBJ2-7,CASRHRGGYEQYF,0,1,1,1
TRBV12-3/4,TRBJ1-5,CASRRDSYQPQHF,0,1,1,1
TRBV12-3/4,TRBJ2-7,CASNGKNSYEQYF,0,1,1,1
TRBV5-1,TRBJ1-1,CASSLGINTEAFF,0,1,1,1
TRBV5-1,TRBJ2-5,CASSLGSGETQYF,0,2,1,2
TRBV5-1,TRBJ2-7,CASSLERGNEQYF,0,1,1,1
TRBV5-1,TRBJ1-1,CASSWGTGSEAFF,0,1,1,1
TRBV5-1,TRBJ1-2,CASSPDRVNGYTF,0,1,1,1
TRBV5-1,TRBJ1-1,CASSPAGDTEAFF,0,1,1,1
TRBV4-3,TRBJ1-6,CASSHGGQTPLHF,0,1,1,1
TRBV4-3,TRBJ2-7,CASSQPVWGEQYF,0,1,1,1
TRBV4-1,TRBJ2-1,CASSQGVDNEQFF,0,1,1,1
TRBV5-1,TRBJ1-5,CANRTVPDQPQHF,0,1,1,1
TRBV20-1,TRBJ2-1,CSPRDPRSNEQFF,0,1,1,1
TRBV20-1,TRBJ2-5,CSAAPGAGETQYF,0,1,1,1
TRBV20-1,TRBJ1-2,CSARDGSYYGYTF,0,1,1,1
TRBV20-1,TRBJ1-1,CSARALGANEAFF,0,1,1,1
TRBV20-1,TRBJ2-2,CSARAPGAGELFF,0,1,1,1
TRBV20-1,TRBJ1-1,CSARDHGETEAFF,0,1,1,1
TRBV20-1,TRBJ2-5,CSAEGRGLETQYF,0,1,1,1
TRBV20-1,TRBJ2-1,CSASITGVNEQFF,0,1,1,1
TRBV20-1,TRBJ1-1,CSAMGQGGTEAFF,0,1,1,1
TRBV20-1,TRBJ2-7,CSATTRTGVEQYF,0,1,1,1
TRBV20-1,TRBJ1-1,CSAEDGLNTEAFF,0,1,1,1
TRBV29-1,TRBJ2-1,CSVFPLRYNEQFF,0,1,1,1
TRBV29-1,TRBJ2-7,CSVPGPSFYEQYF,0,1,1,1
TRBV29-1,TRBJ1-2,CSVVVPGHYGYTF,0,1,1,1
TRBV29-1,TRBJ1-5,CSVAYRVDQPQHF,0,1,1,1
TRBV29-1,TRBJ2-7,CSVAGSGIDEQYF,0,1,1,1
TRBV29-1,TRBJ1-1,CSVDARRDTEAFF,0,1,1,1
TRBV29-1,TRBJ1-2,CSVEEGQNYGYTF,0,1,1,1
TRBV29-1,TRBJ1-2,CSVEFAGIYGYTF,0,1,1,1
TRBV29-1,TRBJ1-1,CSVERGTSTEAFF,0,1,1,1
TRBV29-1,TRBJ2-7,CSVEGGTGYEQYF,0,1,1,1
TRBV29-1,TRBJ2-1,CSVEMAAGNEQFF,0,1,1,1
TRBV29-1,TRBJ2-7,CSVETPLLGEQYF,0,1,1,1
TRBV29-1,TRBJ1-1,CSVPPQGNTEAFF,0,1,1,1
TRBV29-1,TRBJ2-7,CSVRGTAAYEQYF,0,1,1,1
TRBV29-1,TRBJ2-1,CSVEEGVYNEQFF,0,1,1,1
TRBV29-1,TRBJ2-5,CSVVTGSGETQYF,0,1,1,1
TRBV29-1,TRBJ2-7,CSVALAGALEQYF,0,1,1,1
TRBV29-1,TRBJ2-7,CSVESGRGYEQYF,0,1,1,1
TRBV29-1,TRBJ2-5,CSVRDRVTETQYF,0,1,1,1
TRBV29-1,TRBJ1-1,CSVDDQMNTEAFF,0,1,1,1
TRBV29-1,TRBJ2-7,CSASSQGAGEQYF,0,1,1,1
TRBV29-1,TRBJ1-1,CSAQQGGNTEAFF,0,1,1,1
TRBV29-1,TRBJ1-1,CSAAWTENTEAFF,0,1,1,1
TRBV29-1,TRBJ1-2,CSAEAALGDGYTF,0,1,1,1
TRBV29-1,TRBJ1-3,CSASGTDGNTIYF,0,1,1,1
TRBV29-1,TRBJ2-7,CSGRGTGMGEQYF,0,1,1,1
TRBV29-1,TRBJ2-1,CSGAPSGYNEQFF,0,1,1,1
TRBV29-1,TRBJ2-7,YSGGDGPLGEQYF,0,1,1,1
TRBV14,TRBJ1-2,GASSQSTTGGYTF,0,1,1,1
TRBV12-3/4,TRBJ1-1,SASSFRGTTEAFF,0,1,1,1
TRBV5-4,TRBJ2-3,CACRDFPDTQYF,0,1,1,1
TRBV30,TRBJ1-1,CAWRSWNTEAFF,0,1,1,1
TRBV10-3,TRBJ2-7,CAIRGDSYEQYF,0,1,1,1
TRBV10-3,TRBJ2-1,CATEPAGGHPFF,0,1,1,1
TRBV19,TRBJ1-5,CASSIGGQPQHF,0,1,1,1
TRBV18,TRBJ1-6,CASSPEKSPLHF,0,1,1,1
TRBV11-2,TRBJ1-1,CASPPDPTEAFF,0,1,1,1
TRBV12-3/4,TRBJ2-5,CASAEGAKTQYF,0,1,1,1
TRBV6-2/3/5/6,TRBJ1-1,CASDQGRTEAFF,0,1,1,1
TRBV6-1,TRBJ2-2,CASIGVRGELFF,0,1,1,1
TRBV6-2/3/5/6,TRBJ1-1,CASTEIRGEAFF,0,1,1,1
TRBV12-3/4,TRBJ2-1,CASSFFQNEQFF,0,1,1,1
TRBV6-2/3/5/6,TRBJ1-1,CASSFPGAEAFF,0,1,1,1
TRBV7-9,TRBJ1-1,CASSFGSIEAFF,0,1,1,1
TRBV6-2/3/5/6,TRBJ2-3,CASSLTGSTQYF,0,1,1,1
TRBV7-2,TRBJ2-1,CASSSPDSKQFF,0,1,1,1
TRBV27,TRBJ2-7,CASSLTGGEQYF,0,1,1,1
TRBV12-3/4,TRBJ2-1,CASSRSGDEQFF,0,1,1,1
TRBV2,TRBJ1-1,CASSGAWTEAFF,0,1,1,1
TRBV27,TRBJ1-4,CASSGPPGRLFF,0,1,1,1
TRBV2,TRBJ2-7,CASSESVGAQVF,0,1,1,1
TRBV6-2/3/5/6,TRBJ2-7,CASSTVPYEQYF,0,1,1,1
TRBV7-2,TRBJ1-2,CASSFGPEGYTF,0,1,1,1
TRBV5-6,TRBJ1-1,CASSFGGAEAFF,0,1,1,1
TRBV5-5,TRBJ2-1,CASSFDYNEQFF,0,1,1,1
TRBV7-9,TRBJ2-1,CASSFDINEQFF,0,1,1,1
TRBV5-6,TRBJ2-7,CASSLLGSEQYF,0,1,1,1
TRBV5-6,TRBJ2-1,CASSLDSMEQFF,0,1,1,1
TRBV7-6,TRBJ2-7,CASSLQAYEQYF,0,1,1,1
TRBV7-9,TRBJ1-6,CASSLAGSPLHF,0,1,1,1
TRBV13,TRBJ2-2,CASSLGAGELFF,0,1,1,1
TRBV7-9,TRBJ1-2,CASSLGARGYTF,0,1,1,1
TRBV11-2,TRBJ1-1,CASSYHQGEAFF,0,1,1,1
TRBV7-9,TRBJ1-6,CASSLVSSPLHF,0,1,1,1
TRBV14,TRBJ1-2,CASSRVQMGYTF,0,1,1,1
TRBV12-3/4,TRBJ2-1,CASSRTVGEQFF,0,1,1,1
TRBV14,TRBJ2-1,CASSQWDLRQFF,0,1,1,1
TRBV3-1,TRBJ1-6,CASSQASSPLHF,0,1,1,1
TRBV6-4,TRBJ1-1,CASSAPNTEAFF,0,1,1,1
TRBV9,TRBJ2-3,CASSATPDTQYF,0,1,1,1
TRBV11-2,TRBJ1-2,CASSGGGDGYTF,0,1,1,1
TRBV6-2/3/5/6,TRBJ2-2,CASRWRAGELFF,0,1,1,1
TRBV12-3/4,TRBJ1-1,CASRTGGGEAFF,0,1,1,1
TRBV7-2,TRBJ2-1,CASRRTSYEQFF,0,1,1,1
TRBV2,TRBJ1-5,CASKEPNQPQHF,0,1,1,1
TRBV5-1,TRBJ1-1,CASSPTGLEAFF,0,1,1,1
TRBV10-2,TRBJ2-5,CASSEVQETQYF,0,1,1,1
TRBV5-1,TRBJ1-1,CASSLPGGEAFF,0,1,1,1
TRBV4-1,TRBJ2-3,CASSQVTDTQYF,0,1,1,1
TRBV5-1,TRBJ1-2,CASSGDRVGYTF,0,1,1,1
TRBV5-1,TRBJ2-6,CASRGGANVLTF,0,1,1,1
TRBV20-1,TRBJ2-1,CSAIWGGNEQFF,0,1,1,1
TRBV20-1,TRBJ2-5,CSARGVRETQYF,0,1,1,1
TRBV20-1,TRBJ2-5,CSARGVQETQYF,0,1,1,1
TRBV20-1,TRBJ2-5,CSARRRGGGQYF,0,1,1,1
TRBV20-1,TRBJ1-1,CSARGKNTEAFF,0,1,1,1
TRBV29-1,TRBJ2-2,CSVVRGPGELFF,0,1,1,1
TRBV29-1,TRBJ1-1,CSVAWATGEAFF,0,1,1,1
TRBV29-1,TRBJ1-2,CSVGDRGSGYTF,0,1,1,1
TRBV29-1,TRBJ1-2,CSVTGTGFGYTF,0,1,1,1
TRBV29-1,TRBJ2-5,CSVTRNQETQYF,0,1,1,1
TRBV29-1,TRBJ2-5,CSVTGSRETQYF,0,1,1,1
TRBV29-1,TRBJ2-7,CSAAGQTYEQYF,0,1,1,1
TRBV29-1,TRBJ2-5,CSARDNQETQFF,0,1,1,1
TRBV29-1,TRBJ2-2,CSGQGNTGELFF,0,1,1,1
TRBV10-3,TRBJ2-5,CAAGLQETQYF,0,1,1,1
TRBV19,TRBJ1-5,CASTSNAPQHF,0,1,1,1
TRBV19,TRBJ2-5,CASSIEETQYF,0,1,1,1
TRBV19,TRBJ2-1,CASSKANEQFF,0,1,1,1
TRBV18,TRBJ2-7,CASSPPHEQYF,0,1,1,1
TRBV12-3/4,TRBJ1-2,CASSRSHGYTF,0,1,1,1
TRBV6-2/3/5/6,TRBJ2-7,CASSRGNEQYF,0,1,1,1
TRBV2,TRBJ1-1,CASSVVSVAFF,0,1,1,1
TRBV25-1,TRBJ1-2,CASSTGAGYTF,0,1,1,1
TRBV5-6,TRBJ2-5,CASSFQETQYS,0,1,1,1
TRBV7-9,TRBJ1-1,CASSLNTEAFF,0,1,1,1
TRBV3-1,TRBJ2-7,CASSPGYEQYF,0,1,1,1
TRBV7-3,TRBJ2-3,CASSQGGTQYF,0,1,1,1
TRBV5-6,TRBJ1-1,CASSVGTEAFF,0,1,1,1
TRBV7-9,TRBJ2-7,CASSAEEEQYF,0,1,1,1
TRBV4-2,TRBJ1-2,CASSGPRGYTF,0,1,1,1
TRBV11-2,TRBJ2-1,CASSITNEQFF,0,1,1,1
TRBV14,TRBJ2-1,CASRVGDEQFF,0,1,1,1
TRBV6-2/3/5/6,TRBJ1-1,CASRTGTEAFF,0,1,1,1
TRBV5-1,TRBJ1-1,CASSLEGEAFF,0,1,1,1
TRBV5-1,TRBJ2-2,CASSLYGELFF,0,1,1,1
TRBV20-1,TRBJ2-7,CSAPFGVLSYF,0,1,1,1
TRBV20-1,TRBJ2-1,CSGTSGNEQFF,0,1,1,1
TRBV29-1,TRBJ2-1,CSPKAGAEQFF,0,1,1,1
TRBV29-1,TRBJ2-7,CSVVGGYEQYF,0,1,1,1
TRBV29-1,TRBJ2-1,CSVERGFGQFF,0,1,1,1
TRBV20-1,TRBJ1-1,CSAAGGSEAFF,0,1,1,1
TRBV29-1,TRBJ2-5,CSGDLQETQYF,0,1,1,1
TRBV29-1,TRBJ1-2,CSEQGNYGYTF,0,1,1,1
TRBV30,TRBJ2-1,CAWSVSEQFF,0,1,1,1
TRBV2,TRBJ2-5,CASSLSTQYF,0,1,1,1
TRBV20-1,TRBJ2-1,CSAGINEQFF,0,1,1,1
TRBV20-1,TRBJ1-5,CSAGGAAQHF,0,1,1,1
TRBV19,TRBJ1-5,CAGGQPQHF,0,1,1,1
TRBV7-9,TRBJ2-1,CASTGPEFF,0,1,1,1
TRBV29-1,TRBJ2-5,CSVEETQYF,0,1,1,1
TRBV7-9,TRBJ2-4,CASSAGTSGRVRNIQYF,0,1,1,1
TRBV12-3/4,TRBJ2-5,CASSIKQPGLQETQYF,0,1,1,1
TRBV11-1,TRBJ1-4,CASSRGTVDYNEKLFF,0,1,1,1
TRBV4-2,TRBJ1-3,CASSRELSFTGNTIYF,0,1,1,1
TRBV4-2,TRBJ2-5,CASSQEEWTRQETQYF,0,1,1,1
TRBV7-8,TRBJ1-1,CASSLDGPTGAEAFF,0,1,1,1
TRBV12-3/4,TRBJ1-6,CASSLRDPSPLHF,0,1,1,1
TRBV9,TRBJ1-2,CASSPQGDYGYTF,0,1,1,1
TRBV9,TRBJ2-3,CASSFYGTSGSSADTQYF,0,1,1,1
TRBV4-1,TRBJ1-5,CASSAQQGSSNQPQHF,0,1,1,1
TRBV6-1,TRBJ1-1,CASSGTEFMNTEAFF,0,1,1,1
TRBV5-4,TRBJ1-3,CASSLGPSGNTIYF,0,1,1,1
TRBV18,TRBJ1-5,CASSPVGDSNQPQHF,0,1,1,1
TRBV14,TRBJ2-1,CASSPRTDPLPPNEQFF,0,1,1,1
TRBV12-3/4,TRBJ1-3,CASSRRVLSGNTIYF,0,1,1,1
TRBV14,TRBJ2-7,CASSRRGLLYEQYF,0,1,1,1
TRBV28,TRBJ1-1,CASSLRRNTEAFF,0,1,1,1
TRBV6-2/3/5/6,TRBJ2-7,CASSPPGLAGYHEQYF,0,1,1,1
TRBV6-4,TRBJ2-1,CASSDGLAGGVQFF,0,1,1,1
TRBV27,TRBJ2-1,CASLPRARVEGSNEQFF,0,1,1,1
TRBV12-5,TRBJ1-1,CASGLVRGLNTEAFF,0,1,1,1
TRBV7-2,TRBJ2-5,CASSLYGSGKKTQYF,0,1,1,1
TRBV6-2/3/5/6,TRBJ1-5,CASSSGDVNQPQHF,0,1,1,1
TRBV2,TRBJ2-3,CASSGSAIRVEYF,0,1,1,1
TRBV29-1,TRBJ1-2,CSADGGLDGYTF,0,1,1,1
TRBV4-2,TRBJ2-1,CASSQDPSGRASYNEQFF,0,1,1,1
TRBV30,TRBJ2-6,CARSATASDSPGANVLTF,0,1,1,1
TRBV7-3,TRBJ2-1,CASSLSGRRAYNEQFF,0,1,1,1
TRBV6-1,TRBJ2-1,CASTVAGNSYNEQFF,0,1,1,1
TRBV29-1,TRBJ1-3,CSVSRGPGNTIYF,0,1,1,1
TRBV27,TRBJ2-1,CASTNWARRPPTDGDHNHDNEQFF,0,2,1,2
TRBV7-2,TRBJ1-5,CASSQLLWPAGDRDSGGNQPQHF,0,1,1,1
TRBV12-3/4,TRBJ2-2,CASSGPTSGGGRPANAGELFF,0,1,1,1
TRBV5-6,TRBJ2-1,CASSLVGYVQGARDIYNEQFF,0,1,1,1
TRBV3-1,TRBJ1-6,CASSQFPRALKRSSYNSPLHF,0,1,1,1
TRBV3-1,TRBJ2-1,CASSQDPNLAGVRDSYNEQFF,0,1,1,1
TRBV5-1,TRBJ2-7,CASSDLLPAPNMFGKSYEQYF,0,1,1,1
TRBV30,TRBJ1-5,CAWVGFDDLRFPYHFLPQHF,0,1,1,1
TRBV28,TRBJ2-7,CASSSNLGPAGVVFGYEQYF,0,1,1,1
TRBV6-1,TRBJ2-1,CASSVVVASHPQEVHNEQFF,0,1,1,1
TRBV7-2,TRBJ2-1,CASSFDRGGSVWRGVNEQFF,0,1,1,1
TRBV7-2,TRBJ2-7,CASSYGLAGGQSLVFYEQYF,0,1,1,1
TRBV14,TRBJ1-5,CASSRDGICRTAPGRQPQHF,0,1,1,1
TRBV3-1,TRBJ1-1,CASSQVAGFVSKERDTEAFF,0,1,1,1
TRBV4-3,TRBJ2-1,CASSQESGSLAGTSDNEQFF,0,1,1,1
TRBV29-1,TRBJ2-6,CSVEDRSVRQGIGGANVLTF,0,1,1,1
TRBV7-4,TRBJ1-1,RASSLEIRATVISLNTEAFF,0,1,1,1
TRBV2,TRBJ2-2,CASAVRGTSGGPNTGELFF,0,1,1,1
TRBV12-3/4,TRBJ2-1,CASSLISGIGRNSYNEQFF,0,1,1,1
TRBV6-2/3/5/6,TRBJ1-3,CASSYSMGPGINRGNTIYF,0,1,1,1
TRBV2,TRBJ2-1,CASSEGILAGDPHEDEQFF,0,1,1,1
TRBV5-6,TRBJ1-1,CASSFYVYRVILGWTEAFF,0,1,1,1
TRBV13,TRBJ1-6,CASSLWLGQGSSYNSPLHF,0,1,1,1
TRBV5-8,TRBJ2-2,CASSLGRGAGLLDTGELFF,0,1,1,1
TRBV11-2,TRBJ2-1,CASSLDRGTFYLKGNEQFF,0,1,1,1
TRBV13,TRBJ2-4,CASSLRAAGVEIAKNIQYF,0,1,1,1
TRBV13,TRBJ2-4,CASSLRAAGAEIAKNIQYF,0,1,1,1
TRBV3-1,TRBJ1-3,CASSLPGQRIEVSGNTIYF,0,1,1,1
TRBV7-3,TRBJ2-1,CASSLGPGQGSRPYNEQFF,0,1,1,1
TRBV4-2,TRBJ2-7,CASSHPVKVPSGGASEQYF,0,1,1,1
TRBV14,TRBJ2-3,CASSQVMASPIWTADTQYF,0,1,1,1
TRBV4-2,TRBJ2-1,CASSQDPPSGRGSRNEQFF,0,1,1,1
TRBV3-1,TRBJ2-6,CASSQDVGRERFGANVLTF,0,1,1,1
TRBV7-2,TRBJ2-2,CASRLSTSGGVEDAGELFF,0,1,1,1
TRBV27,TRBJ2-1,CASRGNPGLAGSSYNEQFF,0,1,1,1
TRBV5-1,TRBJ2-1,CASSLGSSGGAGSYNEQFF,0,1,1,1
TRBV4-1,TRBJ1-1,CASSQEPPEGFFGNTEAFF,0,1,1,1
TRBV5-1,TRBJ2-6,CASREPGKLRSSGANVLTF,0,1,1,1
TRBV20-1,TRBJ2-3,CSAGVGLAGGVLGTDTQYF,0,1,1,1
TRBV12-5,TRBJ2-2,CASGPPSGGTLGTGELFF,0,1,1,1
TRBV30,TRBJ2-3,CAWSRGTSGRAITDTQYF,0,1,1,1
TRBV10-3,TRBJ1-2,CAISNLDPGTLEYYGYTF,0,1,1,1
TRBV15,TRBJ2-3,CATSSQFRGLAGGDTQYF,0,1,1,1
TRBV15,TRBJ2-1,CATSRDRTSGSMYNEQFF,0,1,1,1
TRBV19,TRBJ2-1,CASSSLAGGPRSYNEQFF,0,1,1,1
TRBV19,TRBJ1-6,CASSTSSGWVRFFSPLHF,0,1,1,1
TRBV18,TRBJ2-7,CASSPRSGSTGLSYEQYF,0,1,1,1
TRBV18,TRBJ2-1,CASSPTAIGGSSYNEQFF,0,1,1,1
TRBV6-2/3/5/6,TRBJ1-5,CASSLPGRVANSNQPQHF,0,1,1,1
TRBV12-3/4,TRBJ2-4,CASSSGTSGGWAKNIQYF,0,1,1,1
TRBV12-3/4,TRBJ2-1,CASSYETRSRRSYNEQFF,0,1,1,1
TRBV6-2/3/5/6,TRBJ1-6,CASSYRQGRPSYNSPLHF,0,1,1,1
TRBV12-3/4,TRBJ2-3,CASSPNSGGPPHTDTQYF,0,1,1,1
TRBV2,TRBJ2-6,CASSDRLAGSSGANVPTF,0,1,1,1
TRBV2,TRBJ2-3,CASSEVRQRGTSTDTQYF,0,1,1,1
TRBV6-2/3/5/6,TRBJ2-6,CASSTSSSQGSGANVLTF,0,1,1,1
TRBV7-8,TRBJ2-3,CASSFRGGASGKTDTQYF,0,1,1,1
TRBV5-6,TRBJ2-2,CASSLPLAGASNTGELFF,0,1,1,1
TRBV5-4,TRBJ2-1,CASSLVLNYRDYYNEQFF,0,1,1,1
TRBV13,TRBJ2-2,CASSLLSLAGRYTGELFF,0,1,1,1
TRBV7-8,TRBJ2-7,CASSLVRRGRGSSYEQYF,0,1,1,1
TRBV7-3,TRBJ2-3,CASSLARTTSGDTDTQYF,0,1,1,1
TRBV7-9,TRBJ1-1,CASSLGGQVALGNTEAFF,0,1,1,1
TRBV6-2/3/5/6,TRBJ1-1,CASSLEGPDRDMNTEAFF,0,1,1,1
TRBV9,TRBJ2-7,CASSSGLAGGGDYYEQYF,0,1,1,1
TRBV11-1,TRBJ2-5,CASSSRWGAGDYQETQYF,0,1,1,1
TRBV28,TRBJ2-7,CASSPNKGDPLIGYEQYF,0,1,1,1
TRBV7-9,TRBJ2-6,CASSPRGQGEAGANVLTF,0,1,1,1
TRBV5-5,TRBJ2-1,CASSPGPGLADFYNEQFF,0,1,1,1
TRBV9,TRBJ2-5,CASSPGLAGGPGQETQYF,0,1,1,1
TRBV7-2,TRBJ2-1,CASSHRTSGVVSYNEQFF,0,1,1,1
TRBV4-2,TRBJ1-5,CASSQDGDNVASNQPQHF,0,1,1,1
TRBV9,TRBJ2-7,CASSVFTLAGGSSYEQYF,0,1,1,1
TRBV4-2,TRBJ2-2,CASSTWTGLTLNTGELFF,0,1,1,1
TRBV12-3/4,TRBJ2-1,CASRPFGGPTSGFNEQFF,0,1,1,1
TRBV4-1,TRBJ2-2,CPSSQEPLAASNTGELFF,0,1,1,1
TRBV5-1,TRBJ1-2,CASSLGKNRENGLNGYTF,0,1,1,1
TRBV4-3,TRBJ2-3,CASSQLTSGRPVTDTQYF,0,1,1,1
TRBV4-1,TRBJ1-4,CASRQETSGVLSNEKLFF,0,1,1,1
TRBV20-1,TRBJ2-1,CSASGEGGRLYYSNEQFF,0,1,1,1
TRBV20-1,TRBJ1-2,CSARDQWDRDGENYGYTF,0,1,1,1
TRBV20-1,TRBJ2-7,CSARDPYTGTVSSYEQYF,0,1,1,1
TRBV20-1,TRBJ2-1,CSAREKLSFSGRASEQFF,0,1,1,1
TRBV20-1,TRBJ2-3,CSASGTSGRGWGTDTQYF,0,1,1,1
TRBV29-1,TRBJ2-1,CSTRRAGSSAPPYNEQFF,0,1,1,1
TRBV13,TRBJ1-1,CACSLGLRRVSGTEAFF,0,1,1,1
TRBV30,TRBJ1-6,CAWRYSWQDKPNSPLHF,0,1,1,1
TRBV10-3,TRBJ2-1,CAITKHVGDRLFGEQFF,0,1,1,1
TRBV10-3,TRBJ1-5,CAIRRGGRGASNQPQHF,0,1,1,1
TRBV15,TRBJ2-7,CATSTEIGGESSYEQYF,0,1,1,1
TRBV19,TRBJ1-5,CASWAGTGGFSNQPQHF,0,1,1,1
TRBV6-2/3/5/6,TRBJ2-1,CASSPPSSGVSLNEQFF,0,1,1,1
TRBV19,TRBJ1-1,CASSIFGGGPGATEAFF,0,1,1,1
TRBV19,TRBJ2-2,CASSMGPFPSNTGELFF,0,1,1,1
TRBV19,TRBJ2-2,CASRPMGGAGGTGELFF,0,1,1,1
TRBV18,TRBJ1-1,CASSPSPGQGANTEAFF,0,1,1,1
TRBV18,TRBJ2-7,CASSPRQETSSSYEQYF,0,1,1,1
TRBV18,TRBJ2-3,CASSPPRDLSSTDTQYF,0,1,1,1
TRBV18,TRBJ2-3,CASSPGPSGASTDTQYF,0,1,1,1
TRBV7-9,TRBJ1-1,CASIPGGPGPMNTEAFF,0,1,1,1
TRBV6-2/3/5/6,TRBJ2-6,CASTDRQGRSGANVLTF,0,1,1,1
TRBV28,TRBJ2-3,CASSFPPTITSTDTQYF,0,1,1,1
TRBV12-3/4,TRBJ1-3,CASSFNFQGILGNTIYF,0,1,1,1
TRBV28,TRBJ2-4,CASSLTGSPRAKNILYF,0,1,1,1
TRBV6-2/3/5/6,TRBJ1-6,CASSSAPGTAVYSPLHF,0,1,1,1
TRBV6-2/3/5/6,TRBJ1-2,CASSYFTTGTANYGYTF,0,1,1,1
TRBV6-2/3/5/6,TRBJ2-7,CASSYSLGGVNSYEQYF,0,1,1,1
TRBV6-2/3/5/6,TRBJ2-1,CASSYSWRLKSYNEQFF,0,1,1,1
TRBV6-2/3/5/6,TRBJ2-1,CASSYSNSRPGGNEQFF,0,1,1,1
TRBV6-2/3/5/6,TRBJ2-1,CASSYSKRLVSYNEQFF,0,1,1,1
TRBV6-2/3/5/6,TRBJ2-1,CASSYGLAGSRGNEQFF,0,1,1,1
TRBV12-3/4,TRBJ2-6,CASSLPGRNSGANVLTF,0,1,1,1
TRBV6-1,TRBJ1-5,CASSEPAGRITNQPQHF,0,1,1,1
TRBV25-1,TRBJ2-3,CASSELWRLNLPPTQYF,0,1,1,1
TRBV12-3/4,TRBJ2-5,CASSTQLRLAGAETQYF,0,1,1,1
TRBV7-2,TRBJ2-6,CASSFGQGTTGANVLTF,0,1,1,1
TRBV5-6,TRBJ2-1,CASSLSGTSGPYNEQFF,0,1,1,1
TRBV7-2,TRBJ1-5,CASSLDSAEISNQPQHF,0,1,1,1
TRBV5-5,TRBJ1-5,CASSLEVTFYSNQPQHF,0,1,1,1
TRBV7-2,TRBJ2-1,CASSLPPGTSGYNEQFF,0,1,1,1
TRBV7-8,TRBJ2-3,CASSLGGARAWADTQYF,0,1,1,1
TRBV11-2,TRBJ2-3,CASSLDRRGYRPDTQYF,0,1,1,1
TRBV7-2,TRBJ2-1,CASSLMVTSSPFYEQFF,0,1,1,1
TRBV12-3/4,TRBJ1-1,CASSLTFKGDRNTEAFF,0,1,1,1
TRBV7-2,TRBJ2-5,CASSLRPFGGGQEAQYF,0,1,1,1
TRBV7-8,TRBJ1-1,CASSSLRDRTMNTEAFF,0,1,1,1
TRBV7-6,TRBJ2-2,CASSSRPGTGVSGELFF,0,1,1,1
TRBV6-2/3/5/6,TRBJ2-7,CASSSARGTSGSYEQYF,0,1,1,1
TRBV7-3,TRBJ1-3,CASSSTGTGFSGNTIYS,0,1,1,1
TRBV7-9,TRBJ2-7,CASSPSGTGGRSEEQYF,0,1,1,1
TRBV13,TRBJ1-1,CASSPQGEGGRNTEAFF,0,1,1,1
TRBV25-1,TRBJ1-2,CASSPGVESAQKYGYTF,0,1,1,1
TRBV7-2,TRBJ2-3,CASSPWDSSLSTDTQYF,0,1,1,1
TRBV12-3/4,TRBJ2-7,CASSRAAGTRASYEQYF,0,1,1,1
TRBV3-1,TRBJ2-7,CASSQPGLAGVPVEQYF,0,1,1,1
TRBV3-1,TRBJ1-5,CASSQGPGQGAGQPQHF,0,1,1,1
TRBV3-1,TRBJ2-7,CASSQDFGGRQPLEQYF,0,1,1,1
TRBV3-1,TRBJ2-3,CASSQDLLAEYTDPQYF,0,1,1,1
TRBV4-2,TRBJ2-1,CASSQDPGLAGHNEQFF,0,1,1,1
TRBV3-1,TRBJ2-1,CASSQEFFGSIYNEQFF,0,1,1,1
TRBV7-9,TRBJ1-6,CASSQTGGESYNSPLHF,0,1,1,1
TRBV9,TRBJ2-4,CASSVSRLVGSYHIQYF,0,1,1,1
TRBV9,TRBJ2-1,CASSVPRAGVSYNEQFF,0,1,1,1
TRBV9,TRBJ2-5,CASSVGLAGGPVETQYF,0,1,1,1
TRBV3-1,TRBJ2-1,CASSTGTSGRIWNEQFF,0,1,1,1
TRBV5-6,TRBJ1-1,CASRLSPGAPSNTEAFF,0,1,1,1
TRBV4-2,TRBJ2-3,CASRPALAGGQRDTQYF,0,1,1,1
TRBV2,TRBJ1-1,CASKDFGPQGPSTEAFF,0,1,1,1
TRBV4-3,TRBJ2-7,CASGQETSGQATGEQYF,0,1,1,1
TRBV5-1,TRBJ2-1,CASSLVASGRGSNEQFF,0,1,1,1
TRBV5-1,TRBJ1-3,CASSLSVTGLSGNTIYF,0,1,1,1
TRBV5-1,TRBJ1-6,CASSSPEGSDYNSPLHF,0,1,1,1
TRBV5-1,TRBJ1-1,CASSYIVIGGPGTEAFF,0,1,1,1
TRBV4-3,TRBJ1-1,CASSLLFRGSVFTEAFF,0,1,1,1
TRBV5-1,TRBJ2-1,CASSPGGLASSYNEQFF,0,1,1,1
TRBV5-1,TRBJ2-7,CASSPGLAGASSYEQYF,0,1,1,1
TRBV5-1,TRBJ2-1,CASSPSGLAGGYNEQFF,0,1,1,1
TRBV4-1,TRBJ1-3,CASSPTEGRSSGNTIYF,0,1,1,1
TRBV4-1,TRBJ2-3,CASSQGNGRKSTDTQYF,0,1,1,1
TRBV4-1,TRBJ1-5,CASSQGPAQGGNQPQHF,0,1,1,1
TRBV4-3,TRBJ2-1,CASSQDDPGSSYNEQFF,0,1,1,1
TRBV4-1,TRBJ1-2,CASSQDLGTGGASGYTF,0,1,1,1
TRBV4-1,TRBJ2-3,CASSQKAVKGVGDTQYF,0,1,1,1
TRBV5-1,TRBJ2-1,CASSQKSDLASYNEQFF,0,1,1,1
TRBV4-1,TRBJ2-3,CASSDGTSGIGEDTQYF,0,1,1,1
TRBV20-1,TRBJ1-1,CSARVSETNLRNTEAFF,0,1,1,1
TRBV20-1,TRBJ2-4,CSARAPWTSGGSDIQYF,0,1,1,1
TRBV20-1,TRBJ1-4,CSARATGKRTANEKLFF,0,1,1,1
TRBV20-1,TRBJ1-5,CSARDYGQAKGFQPQHF,0,1,1,1
TRBV20-1,TRBJ1-6,CSARDLRTGVGNSPLHF,0,1,1,1
TRBV20-1,TRBJ2-1,CSARDISWGIKDNEQFF,0,1,1,1
TRBV29-1,TRBJ1-1,CSVRRPGTGERDTEAFF,0,1,1,1
TRBV29-1,TRBJ2-1,CSDTLAGGPMTYNEQFF,0,1,1,1
TRBV20-1,TRBJ2-1,CRARDPQLAVTSGEQFF,0,1,1,1
TRBV27,TRBJ1-5,RASSLRGAGMGNQPQHF,0,1,1,1
TRBV7-3,TRBJ2-2,RASSPPPDSPNTGELFF,0,1,1,1
TRBV30,TRBJ2-2,CAWSVLGAGGTGELFF,0,1,1,1
TRBV30,TRBJ2-5,CAWSVKTFSNQETQYF,0,1,1,1
TRBV30,TRBJ2-7,CAWSGRLGIVYHEQYF,0,1,1,1
TRBV10-3,TRBJ2-3,CAISETGTSGRDTQYF,0,1,1,1
TRBV7-2,TRBJ1-5,CAISLSRQGVGQPQRF,0,1,1,1
TRBV10-3,TRBJ1-5,CAIKDTIFDLHQPQHF,0,1,1,1
TRBV24-1,TRBJ2-5,CATSDSDPAAQETQYF,0,1,1,1
TRBV15,TRBJ2-3,CATSRRLAGHADTQYF,0,1,1,1
TRBV15,TRBJ1-1,CATSRRGQGSNTEAFF,0,1,1,1
TRBV15,TRBJ2-1,CATSRVGRDSYNEQFF,0,1,1,1
TRBV15,TRBJ1-5,CATSRDKGFSNQPQHF,0,1,1,1
TRBV19,TRBJ2-1,CASSLQTSRAHNEQFF,0,1,1,1
TRBV19,TRBJ2-1,CASSIPGVSGGNEQFF,0,1,1,1
TRBV19,TRBJ2-5,CASSIRLAGYQETQYF,0,1,1,1
TRBV19,TRBJ1-5,CASSIVGTGSNQPQHF,0,1,1,1
TRBV19,TRBJ2-5,CASSIDHILSQETQYF,0,1,1,1
TRBV18,TRBJ2-1,CASSPLTGALSNEQFF,0,1,1,1
TRBV18,TRBJ2-3,CASSPPPSGITDTQYF,0,1,1,1
TRBV18,TRBJ2-2,CASSPQSGGNTGELFF,0,1,1,1
TRBV7-2,TRBJ2-1,CASLFRGSGTGNEQFF,0,1,1,1
TRBV5-5,TRBJ2-5,CASRVAGPSYQETQYF,0,1,1,1
TRBV2,TRBJ2-2,CASITTGTGNTGELFF,0,1,1,1
TRBV12-3/4,TRBJ2-3,CASIDLNRFSTDTQYF,0,1,1,1
TRBV2,TRBJ1-5,CASTIMGARSNQPQHF,0,1,1,1
TRBV12-3/4,TRBJ2-5,CASTRRGREAQETQYF,0,1,1,1
TRBV2,TRBJ2-7,CASSFSLAGFSYEQYF,0,1,1,1
TRBV6-2/3/5/6,TRBJ2-1,CASSLSRTGLVFEQFF,0,1,1,1
TRBV12-3/4,TRBJ2-4,CASSLGQGLAKNIQYF,0,1,1,1
TRBV27,TRBJ2-3,CASSLSIAGGRDTQYF,0,1,1,1
TRBV27,TRBJ2-3,CASSLWSGTSTDTQYF,0,1,1,1
TRBV27,TRBJ1-6,CASSLPGQGRGSPLHF,0,1,1,1
TRBV12-3/4,TRBJ1-3,CASSLIRTVFGNTIYF,0,1,1,1
TRBV12-3/4,TRBJ1-2,CASSLSGRGGAHGYTF,0,1,1,1
TRBV12-3/4,TRBJ1-2,CASSSENRDRGYGYTF,0,1,1,1
TRBV11-1,TRBJ2-7,CASSSRSTSAAYEQYF,0,1,1,1
TRBV7-9,TRBJ2-7,CASSWGVGQTTYEQYF,0,1,1,1
TRBV27,TRBJ2-7,CASSWTGQPSRDEQYF,0,1,1,1
TRBV6-2/3/5/6,TRBJ1-2,CASSYRQGAVNYGYTF,0,1,1,1
TRBV6-2/3/5/6,TRBJ2-1,CASSYSSGLSYNEQFF,0,1,1,1
TRBV6-2/3/5/6,TRBJ1-4,CASSYSHASTDEKLFF,0,1,1,1
TRBV5-4,TRBJ2-3,CASSYPGTGTTDTQYF,0,1,1,1
TRBV6-2/3/5/6,TRBJ2-1,CASSYRHGQGANEQFF,0,1,1,1
TRBV6-2/3/5/6,TRBJ1-5,CASSYEGTRGDQPQHF,0,1,1,1
TRBV6-2/3/5/6,TRBJ2-2,CASSYTRDRFFGELFF,0,1,1,1
TRBV27,TRBJ2-1,CASSPNLAGEFNEQFF,0,1,1,1
TRBV12-3/4,TRBJ2-5,CASSPIAGGVQETQYF,0,1,1,1
TRBV7-2,TRBJ1-2,CASSHYRSLRNYGYTF,0,1,1,1
TRBV6-1,TRBJ2-4,CASSQPSDRGRNIQYF,0,1,1,1
TRBV2,TRBJ2-7,CASSGFGTANSYEQYF,0,1,1,1
TRBV25-1,TRBJ2-3,CASSGTSGMFTDTQYF,0,1,1,1
TRBV6-1,TRBJ2-5,CASSGPKTEPGETQYF,0,1,1,1
TRBV6-4,TRBJ2-1,CASSDSDLNNYNEQFF,0,1,1,1
TRBV12-3/4,TRBJ2-1,CASSDLTSGRAYEQFF,0,1,1,1
TRBV6-4,TRBJ2-4,CASSDRGRGAKNIQYF,0,1,1,1
TRBV6-1,TRBJ1-1,CASSEWSSSGPTEAFF,0,1,1,1
TRBV2,TRBJ2-1,CASSEVLAGPFSEQFF,0,1,1,1
TRBV2,TRBJ1-1,CASSEIGTGWATEAFF,0,1,1,1
TRBV12-3/4,TRBJ2-1,CASSIPTSGSLAEQFF,0,1,1,1
TRBV7-9,TRBJ2-3,CASSFPGQEGTDTQYF,0,1,1,1
TRBV5-4,TRBJ1-2,CASSFQVGQGGNGYTF,0,1,1,1
TRBV7-9,TRBJ2-5,CASSFGRQGNQETQYF,0,1,1,1
TRBV7-2,TRBJ2-2,CASSFTGGTGPGGLFF,0,1,1,1
TRBV9,TRBJ2-1,CASSFLAGDPTNEQFF,0,1,1,1
TRBV5-4,TRBJ2-5,CASSFPAGGPQETQYF,0,1,1,1
TRBV5-4,TRBJ2-1,CASSFPTGSSYNEQFF,0,1,1,1
TRBV7-9,TRBJ2-5,CASSFGSGGYGETQYF,0,1,1,1
TRBV5-5,TRBJ2-1,CASSLLAGGPSNEQFF,0,1,1,1
TRBV5-6,TRBJ1-4,CASSLWRTATNEKLFF,0,1,1,1
TRBV5-4,TRBJ2-5,CASSLPFSGDKETQYF,0,1,1,1
TRBV7-9,TRBJ2-1,CASSLRLAGGVNEQFF,0,1,1,1
TRBV5-5,TRBJ2-7,CASSLGLAGVGDEQYF,0,1,1,1
TRBV7-9,TRBJ1-1,CASSLGGRGPNTEAFF,0,1,1,1
TRBV7-2,TRBJ2-1,CASSLLPDNSYNEQFF,0,1,1,1
TRBV7-9,TRBJ2-1,CASSLSSGFSYNEQFF,0,1,1,1
TRBV7-6,TRBJ2-5,CASSLSPRQTQETQYF,0,1,1,1
TRBV7-9,TRBJ1-2,CASSLSGETPTYGYTF,0,1,1,1
TRBV6-2/3/5/6,TRBJ1-1,CASSLLWSPRNTEAFF,0,1,1,1
TRBV7-2,TRBJ2-1,CASSLVSLAGRNEQFF,0,1,1,1
TRBV7-9,TRBJ2-5,CASSLVDSPSQETQYF,0,1,1,1
TRBV7-9,TRBJ1-4,CASSLVSGVTNEKLFF,0,1,1,1
TRBV7-6,TRBJ2-7,CASSLVEGTTSYEQYF,0,1,1,1
TRBV7-2,TRBJ2-5,CASSLVASGRWETQYF,0,1,1,1
TRBV7-9,TRBJ1-2,CASSLAQGTGGYGYTF,0,1,1,1
TRBV5-6,TRBJ2-7,CASSLATGTGIYEQYF,0,1,1,1
TRBV7-9,TRBJ1-3,CASSLGQGSVTDTIYF,0,1,1,1
TRBV11-1,TRBJ2-1,CASSLDWASGQNEQFF,0,1,1,1
TRBV11-3,TRBJ2-2,CASSLIGGTNTGELFF,0,1,1,1
TRBV7-2,TRBJ2-3,CASSLTPGLGTDTQYF,0,1,1,1
TRBV7-2,TRBJ1-4,CASSSFPRGRYEKLFF,0,1,1,1
TRBV7-9,TRBJ2-7,CASSSWDRGNSYEQYF,0,1,1,1
TRBV11-2,TRBJ2-3,CASSSPRGGRGDTQYF,0,1,1,1
TRBV7-2,TRBJ2-3,CASSSQGGRATDTQYF,0,1,1,1
TRBV7-9,TRBJ1-1,CASSSRRPGVNTEAFF,0,1,1,1
TRBV7-9,TRBJ2-5,CASSSKAGTEKETQYF,0,1,1,1
TRBV7-9,TRBJ1-1,CASSSALGTGNTEAFF,0,1,1,1
TRBV7-9,TRBJ1-5,CASSSEEDSANQPQHS,0,1,1,1
TRBV11-3,TRBJ2-1,CASSSRTSGPYNEQFF,0,1,1,1
TRBV7-2,TRBJ2-3,CASSSNPSGGADTQYF,0,1,1,1
TRBV7-9,TRBJ1-1,CASSSTRRLEDTEAFF,0,1,1,1
TRBV7-6,TRBJ2-5,CASSSSSGTGEETQYF,0,1,1,1
TRBV6-2/3/5/6,TRBJ1-4,CASSWRGAATNEKLFF,0,1,1,1
TRBV14,TRBJ2-7,CASSLRPGGESYEQYF,0,1,1,1
TRBV27,TRBJ1-1,CASSLRGDRVGTEAFF,0,1,1,1
TRBV7-3,TRBJ2-1,CASSLSGTGSSIEQFF,0,1,1,1
TRBV4-2,TRBJ2-1,CASSLPSRGGYNEQFF,0,1,1,1
TRBV7-2,TRBJ2-2,CASSLRGGANTGELFF,0,1,1,1
TRBV7-3,TRBJ2-7,CASSLKGGQPIYEQYF,0,1,1,1
TRBV7-2,TRBJ2-5,CASSPLLAGEAETQYF,0,1,1,1
TRBV13,TRBJ2-3,CASSPPGTSGVDTQYF,0,1,1,1
TRBV5-4,TRBJ2-5,CASSPPGLASKETQYF,0,1,1,1
TRBV3-1,TRBJ2-3,CASSPGTSGVRDTQYF,0,1,1,1
TRBV7-9,TRBJ1-1,CASSPDRGRGDTEAFF,0,1,1,1
TRBV7-9,TRBJ2-7,CASSPNSGEEYYEQYF,0,1,1,1
TRBV7-2,TRBJ2-5,CASSPRGGLGGEAQYF,0,1,1,1
TRBV11-2,TRBJ2-1,CASSPQRGASYNEQFF,0,1,1,1
TRBV7-9,TRBJ1-3,CASSPQGGASGNTIYF,0,1,1,1
TRBV11-2,TRBJ2-1,CASSPVGLWEYNEQFF,0,1,1,1
TRBV7-2,TRBJ2-7,CASSPAPDRSAYEQYF,0,1,1,1
TRBV7-9,TRBJ1-1,CASSPGGVTSHTEAFF,0,1,1,1
TRBV7-8,TRBJ1-2,CASSPGTGNMVYGYTF,0,1,1,1
TRBV7-3,TRBJ2-3,CASSPSRRTSTDTQYF,0,1,1,1
TRBV4-2,TRBJ2-5,CASSPTSGAQRETQYF,0,1,1,1
TRBV7-2,TRBJ1-1,CASSPRDPTGRASAFF,0,1,1,1
TRBV11-3,TRBJ1-2,CASSPHPGGRNYGYTF,0,1,1,1
TRBV7-9,TRBJ2-1,CASSPQGGALYNEQFF,0,1,1,1
TRBV7-3,TRBJ2-3,CASSPVGLGGTDTQYF,0,1,1,1
TRBV5-8,TRBJ2-2,CASSRSGFLQGGELFF,0,1,1,1
TRBV7-9,TRBJ2-5,CASSRMSGSATRTQYF,0,1,1,1
TRBV14,TRBJ1-1,CASSRTSWGRNTEAFF,0,1,1,1
TRBV4-2,TRBJ2-3,CASSQVFGGGTDTQYF,0,1,1,1
TRBV14,TRBJ1-4,CASSQVALKGNEKPFF,0,1,1,1
TRBV14,TRBJ2-2,CASSQGGDWNTGELFF,0,1,1,1
TRBV4-2,TRBJ1-1,CASSQGAWSGNTEAFF,0,1,1,1
TRBV3-1,TRBJ2-3,CASSQDPQPGTDTQYF,0,1,1,1
TRBV3-1,TRBJ1-2,CASSQDPQLDAYGYTF,0,1,1,1
TRBV14,TRBJ1-1,CASSQDEGGLNTEAFF,0,1,1,1
TRBV4-2,TRBJ2-1,CASSQESSGPFGEQFF,0,1,1,1
TRBV3-1,TRBJ2-6,CASSQEGYSGANVLTF,0,1,1,1
TRBV4-2,TRBJ2-7,CASSQELAGTSYEQYF,0,1,1,1
TRBV4-2,TRBJ2-7,CASSQERQGGLWEQYF,0,1,1,1
TRBV9,TRBJ2-7,CASSVGGDRLSYEQYF,0,1,1,1
TRBV9,TRBJ1-2,CASSVAWTGVGYGYTF,0,1,1,1
TRBV7-2,TRBJ2-2,CASSARTSAYTGELFF,0,1,1,1
TRBV9,TRBJ2-1,CASSGRQGSSYNEQFF,0,1,1,1
TRBV4-2,TRBJ2-2,CASSGGREGNTGELFF,0,1,1,1
TRBV5-4,TRBJ2-5,CASSGDQGQRAETQYF,0,1,1,1
TRBV7-6,TRBJ2-1,CASSDRAGGAHNEQFF,0,1,1,1
TRBV7-9,TRBJ2-5,CASSEGTRGGGETQYF,0,1,1,1
TRBV5-8,TRBJ1-2,CASSEDGGLEFYGYTF,0,1,1,1
TRBV14,TRBJ2-3,CASSKTSGGRTDTQYF,0,1,1,1
TRBV12-3/4,TRBJ2-3,CASRLRSGAGTDTQYF,0,1,1,1
TRBV11-2,TRBJ2-3,CASRGLAGGALGAQYF,0,1,1,1
TRBV5-8,TRBJ1-1,CASRIPRSPRDTEAFF,0,1,1,1
TRBV7-9,TRBJ1-1,CASRSGQTGRGTEAFF,0,1,1,1
TRBV12-3/4,TRBJ2-2,CASRSRGGGITGELFF,0,1,1,1
TRBV3-1,TRBJ2-5,CASRWTGANFQETQYF,0,1,1,1
TRBV6-2/3/5/6,TRBJ1-1,CASRPGTVGLNTEAFF,0,1,1,1
TRBV6-2/3/5/6,TRBJ2-5,CASRPDRGSKPETQYF,0,1,1,1
TRBV28,TRBJ1-4,CASRRGGVLGEEKLFF,0,1,1,1
TRBV5-5,TRBJ2-2,CASNKRGYSNTGELFF,0,1,1,1
TRBV6-2/3/5/6,TRBJ1-5,CASKVGTVYSNQPQHF,0,1,1,1
TRBV13,TRBJ2-1,CTSSPTFGQGYNEQFF,0,1,1,1
TRBV4-1,TRBJ2-7,CACSQVPGTKNYEQYF,0,1,1,1
TRBV10-2,TRBJ2-5,CASGDVGLAAQETQYF,0,1,1,1
TRBV4-1,TRBJ2-1,CASSPGIAGGGNEQFF,0,1,1,1
TRBV5-1,TRBJ2-5,CASSFVSGGPQETQYF,0,1,1,1
TRBV5-1,TRBJ1-1,CASSLFAPALNTEAFF,0,1,1,1
TRBV5-1,TRBJ2-1,CASSLSRDRVVNEQFF,0,1,1,1
TRBV5-1,TRBJ2-5,CASSLALASGQETQYF,0,1,1,1
TRBV5-1,TRBJ2-7,CASSLAPAGSAYEQYF,0,1,1,1
TRBV5-1,TRBJ2-7,CASSLGRDRGNPEQYF,0,1,1,1
TRBV5-1,TRBJ2-7,CASSLESGVYLYEQYF,0,1,1,1
TRBV5-1,TRBJ1-2,CASSSPSGQGAYGYAF,0,1,1,1
TRBV5-1,TRBJ2-4,CASSWGLGGTKNIQYF,0,1,1,1
TRBV5-1,TRBJ2-5,CASSPGTGGGLETQYF,0,1,1,1
TRBV5-1,TRBJ2-3,CASSPRRGDLTDTQYF,0,1,1,1
TRBV4-1,TRBJ2-7,CASSQTRLAGSYEQYF,0,1,1,1
TRBV4-3,TRBJ2-1,CASSQSVAGGGNGQFF,0,1,1,1
TRBV4-3,TRBJ2-1,CASSQSVAGGGNEQFF,0,1,1,1
TRBV4-1,TRBJ1-3,CASSQYSGPGGNTIYF,0,1,1,1
TRBV4-1,TRBJ1-2,CASSQVFPETSYGYTF,0,1,1,1
TRBV4-3,TRBJ2-7,CASSQDPGGLLDEQYF,0,1,1,1
TRBV4-3,TRBJ2-1,CASSQEGAGGPNEQFF,0,1,1,1
TRBV20-1,TRBJ2-1,CSVQGTSGRRYNEQFF,0,1,1,1
TRBV20-1,TRBJ1-3,CSAILRTGNSGNTIYF,0,1,1,1
TRBV20-1,TRBJ2-3,CSARGLTSGSWDTQYF,0,1,1,1
TRBV20-1,TRBJ2-1,CSARSPGTSGGGEQFF,0,1,1,1
TRBV20-1,TRBJ1-5,CSARLYGQGDNQPQHF,0,1,1,1
TRBV20-1,TRBJ2-1,CSARGGPTRSYNEQFF,0,1,1,1
TRBV20-1,TRBJ1-5,CSARGRTLYSNQPQHF,0,1,1,1
TRBV20-1,TRBJ2-1,CSARDEGTSSPNEQFF,0,1,1,1
TRBV20-1,TRBJ2-7,CSARITGLDPSYEQYF,0,1,1,1
TRBV20-1,TRBJ2-5,CSARKKLAGGRETQYF,0,1,1,1
TRBV20-1,TRBJ1-4,CSTTGTPFATNEKLFF,0,1,1,1
TRBV29-1,TRBJ2-1,CSVRGKGPSSYNEQFF,0,1,1,1
TRBV29-1,TRBJ2-3,CSVVGPSGSSTDTQYF,0,1,1,1
TRBV29-1,TRBJ2-1,CSVEITLGSAGDEQFF,0,1,1,1
TRBV29-1,TRBJ2-1,CSVELRDPSSYNEQFF,0,1,1,1
TRBV29-1,TRBJ1-6,CSADPRAETYNSPLHF,0,1,1,1
TRBV29-1,TRBJ2-5,CSGAWWEEPPQETQYF,0,1,1,1
TRBV5-5,TRBJ2-2,YASSLDGGTNTGELFF,0,1,1,1
TRBV11-2,TRBJ2-6,RASSLGAHSGANVLTF,0,1,1,1
TRBV20-1,TRBJ1-3,RSARITFGFSGNTIYF,0,1,1,1
TRBV12-5,TRBJ2-1,CASGNPGLAFNKQFF,0,1,1,1
TRBV30,TRBJ1-2,CAWSPPGGPFYGYTF,0,1,1,1
TRBV10-3,TRBJ2-1,CAISEVADPPNEQFF,0,1,1,1
TRBV10-3,TRBJ2-1,CAISTSGKNRNEQFF,0,1,1,1
TRBV10-3,TRBJ2-2,CAIRKSGEATGELFF,0,1,1,1
TRBV12-3/4,TRBJ2-1,CATTGQGGGFYEQFF,0,1,1,1
TRBV15,TRBJ1-5,CATSTLLRDYQPQHF,0,1,1,1
TRBV12-3/4,TRBJ2-2,CASSLRQRNTGELFF,0,1,1,1
TRBV19,TRBJ1-1,CASSMSSGTNTEAFF,0,1,1,1
TRBV19,TRBJ2-7,CASSILPDLSYEQYF,0,1,1,1
TRBV19,TRBJ2-7,CASSIGASLGYEQYF,0,1,1,1
TRBV19,TRBJ2-3,CASSIEQGPGATQYF,0,1,1,1
TRBV19,TRBJ1-5,CASSTDAGWNQPQHF,0,1,1,1
TRBV19,TRBJ1-5,CASSTAISGNQPQHF,0,1,1,1
TRBV19,TRBJ1-5,CASSRGQEGNQPQHF,0,1,1,1
TRBV19,TRBJ1-2,CASSNSKPLNYGYTF,0,1,1,1
TRBV19,TRBJ1-5,CASSKGTGGDQPQHF,0,1,1,1
TRBV19,TRBJ2-1,CASSRLAGDFDAQFF,0,1,1,1
TRBV19,TRBJ1-3,CASRPQGTLENTIYF,0,1,1,1
TRBV6-2/3/5/6,TRBJ1-1,CASFLGLGAHTEAFF,0,1,1,1
TRBV18,TRBJ2-2,CASSPPRGNTGELFF,0,1,1,1
TRBV5-6,TRBJ2-2,CASSGLAENTGELFF,0,1,1,1
TRBV18,TRBJ2-5,CASSPEGGWGETQYF,0,1,1,1
TRBV18,TRBJ2-1,CASSPGQGSKNEQFF,0,1,1,1
TRBV18,TRBJ1-2,CASSPGGTGWHGYTF,0,1,1,1
TRBV18,TRBJ2-7,CASSPTGVRSYEQYF,0,1,1,1
TRBV18,TRBJ1-6,CASSRGHPPNSPLHF,0,1,1,1
TRBV27,TRBJ2-7,CASQPGRGFSYEQYY,0,1,1,1
TRBV6-2/3/5/6,TRBJ2-1,CASGGGTSGYLEQFF,0,1,1,1
TRBV6-2/3/5/6,TRBJ1-6,CASIRGDLVNSPLHF,0,1,1,1
TRBV12-3/4,TRBJ2-1,CASIGGSGGLNEQFF,0,1,1,1
TRBV5-6,TRBJ2-1,CASIHSGGHYNEQFF,0,1,1,1
TRBV6-2/3/5/6,TRBJ1-1,CASTSREVLDTEAFF,0,1,1,1
TRBV11-2,TRBJ2-5,CASTLDGGQGETQYF,0,1,1,1
TRBV6-2/3/5/6,TRBJ2-7,CASTRRLAGVNEQYF,0,1,1,1
TRBV12-3/4,TRBJ2-1,CASSFQESSYNEQFF,0,1,1,1
TRBV12-3/4,TRBJ2-1,CASSFALPYNNEQFF,0,1,1,1
TRBV6-2/3/5/6,TRBJ2-3,CASSFGQGGTDTQYF,0,1,1,1
TRBV12-3/4,TRBJ2-1,CASSFSTVSYNEQFF,0,1,1,1
TRBV27,TRBJ2-3,CASSFSGTGGSTQYF,0,1,1,1
TRBV6-2/3/5/6,TRBJ1-5,CASSFWTGPNQPQHF,0,1,1,1
TRBV12-3/4,TRBJ2-5,CASSFGREPLATQYF,0,1,1,1
TRBV27,TRBJ2-3,CASSLRAGDTDTQYF,0,1,1,1
TRBV6-2/3/5/6,TRBJ2-5,CASSLREVTRETQYF,0,1,1,1
TRBV6-2/3/5/6,TRBJ2-3,CASSLFSARPDTQYF,0,1,1,1
TRBV6-2/3/5/6,TRBJ2-7,CASSLSYTETYEQYF,0,1,1,1
TRBV12-3/4,TRBJ2-5,CASSLLLDRAQTQYF,0,1,1,1
TRBV12-3/4,TRBJ1-5,CASSLAPGGLQPQHF,0,1,1,1
TRBV12-3/4,TRBJ1-2,CASSLAGFGFYGYTF,0,1,1,1
TRBV6-2/3/5/6,TRBJ1-2,CASSLGTRMVYGYTF,0,1,1,1
TRBV12-3/4,TRBJ2-3,CASSLELAETDTQHF,0,1,1,1
TRBV12-3/4,TRBJ2-1,CASSLRGGYYNEQFF,0,1,1,1
TRBV12-3/4,TRBJ2-7,CASSSRDWHSYEQYF,0,1,1,1
TRBV28,TRBJ1-1,CASSSPGQGSSKAFF,0,1,1,1
TRBV6-2/3/5/6,TRBJ1-6,CASSSQRSEDSPLHF,0,1,1,1
TRBV6-2/3/5/6,TRBJ2-3,CASSSGTGFTDTQYF,0,1,1,1
TRBV6-2/3/5/6,TRBJ2-7,CASSSGTIYTYEQYF,0,1,1,1
TRBV6-2/3/5/6,TRBJ2-3,CASSWAGKSTDTQYF,0,1,1,1
TRBV6-2/3/5/6,TRBJ1-5,CASSWRQGDRQPQHF,0,1,1,1
TRBV6-2/3/5/6,TRBJ1-2,CASSYRGGANYGYTL,0,1,1,1
TRBV6-2/3/5/6,TRBJ1-1,CASSYSGQGNTEAFF,0,1,1,1
TRBV27,TRBJ1-6,CASSYSGTAGSPLHF,0,1,1,1
TRBV6-2/3/5/6,TRBJ2-7,CASSYGTGSGDEQYF,0,1,1,1
TRBV6-2/3/5/6,TRBJ1-5,CASSYGQGSNQPQHF,0,1,1,1
TRBV6-2/3/5/6,TRBJ1-6,CASSYDQGWNSPLHF,0,1,1,1
TRBV6-2/3/5/6,TRBJ1-5,CASSYTGQQNQPQHF,0,1,1,1
TRBV6-2/3/5/6,TRBJ1-4,CASSLEVQDHEKLFF,0,1,1,1
TRBV6-2/3/5/6,TRBJ2-3,CASSLQGARGDTQYF,0,1,1,1
TRBV27,TRBJ2-2,CASSLEGAGTGELFF,0,1,1,1
TRBV6-2/3/5/6,TRBJ1-2,CASSPRAGWLYGYTF,0,1,1,1
TRBV12-3/4,TRBJ2-2,CASSPIAGSTGELFF,0,1,1,1
TRBV2,TRBJ2-1,CASSPLAGGGNEQFF,0,1,1,1
TRBV6-2/3/5/6,TRBJ2-3,CASSPRTSGKNTQYF,0,1,1,1
TRBV27,TRBJ2-7,CASSHWVSTVYEQYF,0,1,1,1
TRBV2,TRBJ1-5,CASSQKGQGYQPQHF,0,1,1,1
TRBV6-1,TRBJ2-3,CASSARQGSTDTQYL,0,1,1,1
TRBV6-1,TRBJ2-5,CASSATSGAGETQYF,0,1,1,1
TRBV12-3/4,TRBJ2-1,CASSDTSGRDNEQFF,0,1,1,1
TRBV6-4,TRBJ2-3,CASSDSGQGSDTQYF,0,1,1,1
TRBV2,TRBJ2-1,CASSERDSAYNEQFF,0,1,1,1
TRBV25-1,TRBJ2-3,CASSELTTSTDTQYF,0,1,1,1
TRBV6-1,TRBJ2-7,CASSEPGTGSYEQYF,0,1,1,1
TRBV2,TRBJ2-5,CASSEVAGAGETQYF,0,1,1,1
TRBV2,TRBJ1-5,CASSEARQGLGPQHF,0,1,1,1
TRBV6-1,TRBJ2-3,CASSEAYRSTDTQYF,0,1,1,1
TRBV6-1,TRBJ1-2,CASSEARGFHYGYTF,0,1,1,1
TRBV2,TRBJ1-2,CASSEAGRSGYGYTF,0,1,1,1
TRBV6-1,TRBJ1-1,CASSEDWNLNTEAFF,0,1,1,1
TRBV2,TRBJ1-5,CASSEEGLPNQPQHF,0,1,1,1
TRBV2,TRBJ2-1,CASSEETGPYNEQFF,0,1,1,1
TRBV27,TRBJ2-1,CASSIETSGGGGQFF,0,1,1,1
TRBV6-2/3/5/6,TRBJ2-7,CASSTTDRRYYEQYF,0,1,1,1
TRBV7-8,TRBJ2-7,CASSFPWDRVNEQYF,0,1,1,1
TRBV7-2,TRBJ2-1,CASSFSGRVYNEQFF,0,1,1,1
TRBV11-1,TRBJ1-4,CASSFSDVADEKLFF,0,1,1,1
TRBV5-4,TRBJ2-7,CASSFRTGRSYEQYF,0,1,1,1
TRBV5-6,TRBJ2-7,CASSLLGPNPYEQYF,0,1,1,1
TRBV5-6,TRBJ2-5,CASSLLDRNQETQYF,0,1,1,1
TRBV5-6,TRBJ1-1,CASSLWVEPGTEAFF,0,1,1,1
TRBV5-6,TRBJ2-7,CASSLLQGWSGEQYF,0,1,1,1
TRBV7-3,TRBJ2-1,CASSLLAGSYNEQFF,0,1,1,1
TRBV5-6,TRBJ2-7,CASSLPPGASYEQYF,0,1,1,1
TRBV5-4,TRBJ2-3,CASSLRLADTDTQYF,0,1,1,1
TRBV5-6,TRBJ2-5,CASSLVAAVQETQYF,0,1,1,1
TRBV7-9,TRBJ2-3,CASSLASGITDTQYF,0,1,1,1
TRBV5-4,TRBJ1-2,CASSLAGRPDYGYTF,0,1,1,1
TRBV5-4,TRBJ2-1,CASSLGPTDYNEQFF,0,1,1,1
TRBV7-6,TRBJ2-2,CASSLGTGYTGELFF,0,1,1,1
TRBV7-3,TRBJ1-2,CASSLGGHANYGYTF,0,1,1,1
TRBV12-3/4,TRBJ1-1,CASSLTGGLNTEASF,0,1,1,1
TRBV5-6,TRBJ2-7,CASSLRQGVAYEQYF,0,1,1,1
TRBV7-2,TRBJ1-2,CASSLSRTVNYGYTF,0,1,1,1
TRBV7-2,TRBJ1-1,CASSLWGEGNTEAFF,0,1,1,1
TRBV11-2,TRBJ2-1,CASSLRGRALDEQYF,0,1,1,1
TRBV7-2,TRBJ2-6,CASSLVGAGANVLTF,0,1,1,1
TRBV11-2,TRBJ2-3,CASSLVGGGTSVMYF,0,1,1,1
TRBV7-2,TRBJ2-1,CASSLAASSYNEQFF,0,1,1,1
TRBV7-7,TRBJ2-1,CASSLAVGSYNEQFF,0,1,1,1
TRBV11-2,TRBJ2-5,CASSLATRGLETQYF,0,1,1,1
TRBV7-2,TRBJ1-1,CASSLALQGAAEAFF,0,1,1,1
TRBV7-4,TRBJ2-7,CASSLGLAVTYEQYF,0,1,1,1
TRBV7-2,TRBJ2-3,CASSLGDSSTDTQYF,0,1,1,1
TRBV7-9,TRBJ2-7,CASSLGDRGPYEQYF,0,1,1,1
TRBV7-9,TRBJ2-1,CASSLGEALYNEQFF,0,1,1,1
TRBV7-2,TRBJ2-7,CASSLGTGYGYEQYF,0,1,1,1
TRBV7-6,TRBJ1-5,CASSLGQGRRQPQHF,0,1,1,1
TRBV6-2/3/5/6,TRBJ2-7,CASSLGGGGTYEQYF,0,1,1,1
TRBV7-2,TRBJ2-5,CASSLDWGRQESQYF,0,1,1,1
TRBV11-2,TRBJ2-7,CASSLDLATSYELYF,0,1,1,1
TRBV7-9,TRBJ2-7,CASSLEGIWLPEQYF,0,1,1,1
TRBV7-9,TRBJ1-1,CASSLEGKKNTEAFF,0,1,1,1
TRBV5-6,TRBJ2-5,CASSLEEGVQETQYF,0,1,1,1
TRBV7-2,TRBJ2-7,CASSLSDGIPYEQYF,0,1,1,1
TRBV5-6,TRBJ2-1,CASSSSGRGYNEQFF,0,1,1,1
TRBV5-6,TRBJ2-1,CASSSLTASYNEQFF,0,1,1,1
TRBV7-2,TRBJ2-1,CASSSLAGAYNEQFF,0,1,1,1
TRBV7-2,TRBJ1-5,CASSSGGGSNQPQHF,0,1,1,1
TRBV7-9,TRBJ2-2,CASSSGTSYTGELFF,0,1,1,1
TRBV7-3,TRBJ1-5,CASSSDRTSNQPQHF,0,1,1,1
TRBV7-9,TRBJ2-1,CASSSEGGNYNEQFF,0,1,1,1
TRBV6-2/3/5/6,TRBJ1-6,CASSSGGAGNSPLHF,0,1,1,1
TRBV5-4,TRBJ1-1,CASSSSGGWGTEAFF,0,1,1,1
TRBV7-2,TRBJ2-3,CASSSGEGSVSTQYF,0,1,1,1
TRBV7-3,TRBJ2-1,CASSSGTSVYNEQFF,0,1,1,1
TRBV7-2,TRBJ2-1,CASSWGASRHNEQFF,0,1,1,1
TRBV7-6,TRBJ2-3,CASSYRDRSTDAQYF,0,1,1,1
TRBV7-8,TRBJ1-3,CASSYGQGDWNTIYF,0,1,1,1
TRBV3-1,TRBJ1-5,CASSLGAGVGQPQHF,0,1,1,1
TRBV3-1,TRBJ2-2,CASSLGQGATGELFF,0,1,1,1
TRBV6-4,TRBJ2-1,CASSLTGGGYNEQFF,0,1,1,1
TRBV5-4,TRBJ2-7,CASSLFASGTYEQYF,0,1,1,1
TRBV7-2,TRBJ1-4,CASSLDGATNEKLFF,0,1,1,1
TRBV7-9,TRBJ1-2,CASSPPSGGVYGYTF,0,1,1,1
TRBV14,TRBJ1-1,CASSPPGTENTEAFF,0,1,1,1
TRBV6-2/3/5/6,TRBJ1-2,CASSPDGAIDYGYTF,0,1,1,1
TRBV4-2,TRBJ1-1,CASSPEGQSNTEAFF,0,1,1,1
TRBV7-3,TRBJ2-1,CASSPFGQPYNEQFF,0,1,1,1
TRBV5-6,TRBJ1-1,CASSPLGARNTEAFF,0,1,1,1
TRBV11-3,TRBJ2-7,CASSPRTARVNEQYF,0,1,1,1
TRBV12-3/4,TRBJ2-6,CASSPAGTGANVLTF,0,1,1,1
TRBV7-9,TRBJ2-7,CASSPGTGRPSEQYF,0,1,1,1
TRBV5-6,TRBJ2-2,CASSPVARDVGELFF,0,1,1,1
TRBV14,TRBJ1-3,CASSPGVSPGNTIYF,0,1,1,1
TRBV6-2/3/5/6,TRBJ1-5,CASSPMRGGFWPQHF,0,1,1,1
TRBV7-2,TRBJ2-1,CASSPTGLAGGGQFF,0,1,1,1
TRBV7-9,TRBJ2-1,CASSPRQGAFSGQFF,0,1,1,1
TRBV7-9,TRBJ2-7,CASSPRQKTTYEQYF,0,1,1,1
TRBV4-2,TRBJ2-1,CASSPFFSLGNEQFF,0,1,1,1
TRBV14,TRBJ1-2,CASSPLGRGLYGYTF,0,1,1,1
TRBV7-9,TRBJ1-4,CASSPGGRTNEKLFF,0,1,1,1
TRBV4-2,TRBJ1-1,CASSPSGKRDTEAFF,0,1,1,1
TRBV7-6,TRBJ2-3,CASSPRRGGTDTQYF,0,1,1,1
TRBV28,TRBJ2-7,CASSRWEEGYHEQYF,0,1,1,1
TRBV7-2,TRBJ2-1,CASSRRASGHNEQFF,0,1,1,1
TRBV11-2,TRBJ2-1,CASSRRLAGYNEQFF,0,1,1,1
TRBV3-1,TRBJ2-3,CASSRGLTPSDTQYF,0,1,1,1
TRBV7-9,TRBJ2-2,CASSRTGRSTGELFF,0,1,1,1
TRBV13,TRBJ1-5,CASSHRGSGNQPQHF,0,1,1,1
TRBV9,TRBJ2-1,CASSHRDGSGNEQFF,0,1,1,1
TRBV4-2,TRBJ1-2,CASSQGGGSNYGYTF,0,1,1,1
TRBV14,TRBJ2-1,CASSQGTSEYNEQFF,0,1,1,1
TRBV6-4,TRBJ2-3,CASSQLQGTTDTQYF,0,1,1,1
TRBV7-9,TRBJ1-5,CASSQPGTGSQPQHF,0,1,1,1
TRBV3-1,TRBJ1-4,CASSQAFQGRMGLFF,0,1,1,1
TRBV14,TRBJ2-1,CASSQGPRSYNEQFF,0,1,1,1
TRBV3-1,TRBJ2-3,CASSQDLLVADTQYF,0,1,1,1
TRBV3-1,TRBJ1-5,CASSQDIGRDQPQHF,0,1,1,1
TRBV3-1,TRBJ2-3,CASSQDQARTDTQYF,0,1,1,1
TRBV3-1,TRBJ2-5,CASSQDGQGQETQYF,0,1,1,1
TRBV9,TRBJ1-5,CASSVGPGFGQPQHF,0,1,1,1
TRBV13,TRBJ2-3,CASSVGTSDWDTQYF,0,1,1,1
TRBV9,TRBJ1-3,CASSVGGDSGNTIYF,0,1,1,1
TRBV7-6,TRBJ1-3,CASSVDNFSGNTIYF,0,1,1,1
TRBV7-3,TRBJ2-1,CASSASSGRLNEQFF,0,1,1,1
TRBV9,TRBJ2-7,CASSARTSGRAEQYF,0,1,1,1
TRBV5-4,TRBJ2-3,CASSGTSGGTDTQYF,0,1,1,1
TRBV7-2,TRBJ2-5,CASSTLAGALETQYF,0,1,1,1
TRBV7-9,TRBJ2-2,CASSTDRGPTGELFF,0,1,1,1
TRBV7-9,TRBJ2-7,CASSTTLAGGYEQYF,0,1,1,1
TRBV5-4,TRBJ2-7,CASSKPSGESYEQYF,0,1,1,1
TRBV12-3/4,TRBJ2-2,CASRSRDLNTGELFF,0,1,1,1
TRBV11-1,TRBJ2-1,CASRPRGSSYNEQFF,0,1,1,1
TRBV2,TRBJ2-7,CASRQTGTRAYEQYF,0,1,1,1
TRBV7-9,TRBJ2-5,CASRGRDRGRETQYF,0,1,1,1
TRBV6-2/3/5/6,TRBJ1-1,CASRGQGAGNTEAFF,0,1,1,1
TRBV12-3/4,TRBJ2-2,CASRDTRGPAGELFF,0,1,1,1
TRBV12-3/4,TRBJ2-5,CASRLLGTEQETQYF,0,1,1,1
TRBV6-2/3/5/6,TRBJ2-5,CASRPDPWSQETQYF,0,1,1,1
TRBV6-2/3/5/6,TRBJ2-4,CASRPSLRTGNIQYF,0,1,1,1
TRBV2,TRBJ1-4,CASRGLRDRNEKLFF,0,1,1,1
TRBV6-2/3/5/6,TRBJ2-7,CASRGDPQLLYEQYF,0,1,1,1
TRBV6-2/3/5/6,TRBJ2-7,CASRIETGTLYEQYF,0,1,1,1
TRBV12-3/4,TRBJ1-1,CASNPRQGGNTEAFF,0,1,1,1
TRBV2,TRBJ2-4,CASKSGALAKNIQYL,0,1,1,1
TRBV30,TRBJ2-2,CARGMGLLSPGELFF,0,1,1,1
TRBV4-2,TRBJ2-3,CARSPQREGTDTQYF,0,1,1,1
TRBV5-1,TRBJ1-1,CVSSPDRSTNTEAFF,0,1,1,1
TRBV19,TRBJ2-1,CASSKKRTNYNEQFF,0,1,1,1
TRBV5-1,TRBJ2-1,CASPARDREDNEQFF,0,1,1,1
TRBV4-1,TRBJ2-1,CASRLAGASYNEQFF,0,1,1,1
TRBV5-1,TRBJ2-1,CASTSGTLPSNEQFF,0,1,1,1
TRBV5-1,TRBJ1-1,CASSFSVSQNTEAFF,0,1,1,1
TRBV5-1,TRBJ2-7,CASSFGRDPIYEQYF,0,1,1,1
TRBV5-1,TRBJ2-3,CASSLLGQFTDTQYF,0,1,1,1
TRBV5-1,TRBJ1-1,CASSLGAGSATEAFF,0,1,1,1
TRBV5-1,TRBJ2-1,CASSLDDPSYNEQFF,0,1,1,1
TRBV5-1,TRBJ2-3,CASSLEGNGADTQYF,0,1,1,1
TRBV5-1,TRBJ2-2,CASSLGGGNTGELFF,0,1,1,1
TRBV5-1,TRBJ2-1,CASSLTSGGASEQFF,0,1,1,1
TRBV5-1,TRBJ2-1,CASSSDRGTVNEQFF,0,1,1,1
TRBV4-3,TRBJ2-7,CASSLGTTFSNEQYF,0,1,1,1
TRBV5-1,TRBJ2-7,CASSLTGMDLDEQYF,0,1,1,1
TRBV4-1,TRBJ2-4,CASSLLQGAKNIQYF,0,1,1,1
TRBV4-1,TRBJ2-2,CASSLRQMNTGELFF,0,1,1,1
TRBV4-1,TRBJ1-2,CASSLGTGNNYGYTF,0,1,1,1
TRBV5-1,TRBJ2-7,CASSLTGSPSYEQYF,0,1,1,1
TRBV4-1,TRBJ2-7,CASSPGAGGPYEQYF,0,1,1,1
TRBV4-3,TRBJ1-2,CASSPLGQRAGGYTF,0,1,1,1
TRBV4-3,TRBJ2-2,CASSRAPENTGELFF,0,1,1,1
TRBV5-1,TRBJ2-5,CASSRNTRIQETQYF,0,1,1,1
TRBV4-1,TRBJ2-7,CASSHDRGLAYEQYF,0,1,1,1
TRBV4-1,TRBJ2-5,CASSHTGTRGETQYF,0,1,1,1
TRBV4-1,TRBJ1-1,CASSQTQDPNTEAFF,0,1,1,1
TRBV4-1,TRBJ2-1,CASSQVGGAWGEQFF,0,1,1,1
TRBV4-3,TRBJ2-1,CASSQGGLVGGEQFF,0,1,1,1
TRBV4-3,TRBJ1-1,CASSQDSGMNTEAFF,0,1,1,1
TRBV4-3,TRBJ2-4,CASSQDRGLGNIQYF,0,1,1,1
TRBV4-1,TRBJ1-5,CASSQDGESNQPQHF,0,1,1,1
TRBV4-1,TRBJ1-3,CASSQDMGPGNTIYF,0,1,1,1
TRBV4-3,TRBJ2-2,CASSQESGGAGELFF,0,1,1,1
TRBV4-3,TRBJ2-6,CASSQELRGGNVLTF,0,1,1,1
TRBV4-3,TRBJ2-7,CASSQEHRGSYEQYF,0,1,1,1
TRBV4-3,TRBJ2-7,CASSQEVRGSYEQYF,0,1,1,1
TRBV4-3,TRBJ2-7,CASSQEAGGLYEQYF,0,1,1,1
TRBV5-1,TRBJ2-1,CASSTGLAGVLEQFF,0,1,1,1
TRBV5-1,TRBJ1-6,CASRGSWTGHSPLHF,0,1,1,1
TRBV20-1,TRBJ2-5,CSAFLSGRPGETQYF,0,1,1,1
TRBV20-1,TRBJ1-4,CSAFGTATTNEKLFF,0,1,1,1
TRBV20-1,TRBJ1-4,CSAPTALATNEKLFF,0,1,1,1
TRBV20-1,TRBJ2-1,CSAAHRGGRYNEQFF,0,1,1,1
TRBV20-1,TRBJ2-2,CSAGSGRAFSRELFF,0,1,1,1
TRBV20-1,TRBJ1-6,CSAENTDSYNSPLHF,0,1,1,1
TRBV20-1,TRBJ2-1,CSAISGVLSYNEQFF,0,1,1,1
TRBV20-1,TRBJ1-4,CSATNPGGGKEKLFF,0,1,1,1
TRBV20-1,TRBJ2-1,CSARYDPGGRDEQFF,0,1,1,1
TRBV20-1,TRBJ2-1,CSARPSSGSLYEQFF,0,1,1,1
TRBV20-1,TRBJ1-5,CSARVGGPGYQPQHF,0,1,1,1
TRBV20-1,TRBJ2-1,CSARVGLASLHEQFF,0,1,1,1
TRBV20-1,TRBJ2-3,CSARVDSSYTDTQYF,0,1,1,1
TRBV20-1,TRBJ2-3,CSARVAWGGTDTQYF,0,1,1,1
TRBV20-1,TRBJ1-2,CSARGPQGVAYGYTF,0,1,1,1
TRBV20-1,TRBJ1-5,CSARGGRYSNQPQHF,0,1,1,1
TRBV20-1,TRBJ2-7,CSARGGQQRSYEQYF,0,1,1,1
TRBV20-1,TRBJ2-7,CSARGTSGGSYEQYF,0,1,1,1
TRBV20-1,TRBJ2-1,CSARDRDRAYNEQFF,0,1,1,1
TRBV20-1,TRBJ2-7,CSARDGDRSSYEQYF,0,1,1,1
TRBV20-1,TRBJ2-1,CSARDGTPSYNEQFF,0,1,1,1
TRBV20-1,TRBJ2-1,CSARNPGGPRDEQFF,0,1,1,1
TRBV20-1,TRBJ2-1,CSANPGGQDYNEQFF,0,1,1,1
TRBV20-1,TRBJ2-3,CSAKGHPVRRDTQYF,0,1,1,1
TRBV20-1,TRBJ2-1,CSAGRAGDQYNEQFF,0,1,1,1
TRBV29-1,TRBJ1-3,CSFQGPLDSGNTIYF,0,1,1,1
TRBV29-1,TRBJ2-3,CSVVVDRVWADTQYF,0,1,1,1
TRBV29-1,TRBJ2-1,CSVEEAGLARSEQFF,0,1,1,1
TRBV29-1,TRBJ1-1,CSVERGVRMNTEAFF,0,1,1,1
TRBV29-1,TRBJ2-3,CSVPRSSGNTDTQYF,0,1,1,1
TRBV29-1,TRBJ1-4,CSVGGTGSAPRKLFF,0,1,1,1
TRBV29-1,TRBJ2-5,CSAPPAGYLGETQYF,0,1,1,1
TRBV29-1,TRBJ2-3,CSAGGTGAPADTQYF,0,1,1,1
TRBV29-1,TRBJ2-5,CSATYFETGSETQYF,0,1,1,1
TRBV2,TRBJ2-1,YASVAVGTILDEQFF,0,1,1,1
TRBV6-2/3/5/6,TRBJ1-5,YASSQTAGSGQPQHF,0,1,1,1
TRBV14,TRBJ2-7,RASSHLPGQLYEQYF,0,1,1,1
TRBV14,TRBJ2-1,SARSSLAGLANEQFF,0,1,1,1
TRBV27,TRBJ1-6,SASSAGLTHSPLHF,0,1,1,1
TRBV7-2,TRBJ1-5,CVSSLVGSNQPQHF,0,1,1,1
TRBV7-8,TRBJ2-7,CVSSLTGSSYEQYF,0,1,1,1
TRBV12-5,TRBJ1-4,CASGRGPGGEKLFF,0,1,1,1
TRBV2,TRBJ2-5,CASYRTLDGETQYF,0,1,1,1
TRBV12-3/4,TRBJ1-4,CASTPGGTSEKLFF,0,1,1,1
TRBV7-2,TRBJ2-1,CASRDRLVWYEQFL,0,1,1,1
TRBV30,TRBJ1-4,CAWTTGRENEKLFF,0,1,1,1
TRBV30,TRBJ2-1,CAWSVLKRRNEQFF,0,1,1,1
TRBV30,TRBJ2-7,CAWNKWREWDEQYF,0,1,1,1
TRBV30,TRBJ1-2,CAWKVTGGAYGYTF,0,1,1,1
TRBV30,TRBJ2-6,CAWKVDSGANVLTF,0,1,1,1
TRBV10-3,TRBJ2-1,CAISSPHLYNEQFF,0,1,1,1
TRBV10-3,TRBJ2-5,CAISPQEYQETQYF,0,1,1,1
TRBV10-3,TRBJ2-3,CAIKREGRTDTQYF,0,1,1,1
TRBV28,TRBJ2-1,CATTLTGTDNEQFF,0,1,1,1
TRBV7-9,TRBJ1-5,CATDKGARDQPQHF,0,1,1,1
TRBV15,TRBJ2-7,CATTETGTLPPAYF,0,1,1,1
TRBV15,TRBJ1-1,CATSILRPGDEAFF,0,1,1,1
TRBV24-1,TRBJ2-1,CATRRGRLVNEQFF,0,1,1,1
TRBV19,TRBJ2-3,CASTGTSVADTQYF,0,1,1,1
TRBV19,TRBJ2-1,CASSSQSMSGEQFF,0,1,1,1
TRBV19,TRBJ1-1,CASSIQAMNTEAFF,0,1,1,1
TRBV19,TRBJ1-1,CASSKTGLNTEAFF,0,1,1,1
TRBV19,TRBJ2-1,CASSGPGTYNEQFF,0,1,1,1
TRBV19,TRBJ2-7,CASRRTGSSYEQYF,0,1,1,1
TRBV19,TRBJ2-7,CASRERRPPDEQYF,0,1,1,1
TRBV19,TRBJ2-4,CASKLLAGGNIQYF,0,1,1,1
TRBV6-2/3/5/6,TRBJ2-7,CASLERGLRDEQYF,0,1,1,1
TRBV18,TRBJ1-1,CASSPGLSVAEAFF,0,1,1,1
TRBV18,TRBJ2-7,CASSPYRGSYEQYF,0,1,1,1
TRBV18,TRBJ2-1,CASSPPGQYNEQFF,0,1,1,1
TRBV2,TRBJ1-5,CASRVTGIWQPQHF,0,1,1,1
TRBV12-3/4,TRBJ2-1,CASRTQKNYNEQFF,0,1,1,1
TRBV2,TRBJ1-2,CASQGQGSRYGYTF,0,1,1,1
TRBV11-2,TRBJ2-7,CASASTGGPYEQYF,0,1,1,1
TRBV11-2,TRBJ2-3,CASGPWLSTDTQYF,0,1,1,1
TRBV2,TRBJ2-7,CASGGQRFSYEQYF,0,1,1,1
TRBV6-2/3/5/6,TRBJ2-3,CASGISGARDTQYF,0,1,1,1
TRBV7-3,TRBJ1-3,CASIRQVSGNTIYF,0,1,1,1
TRBV7-8,TRBJ2-1,CASTRASGSHEQFF,0,1,1,1
TRBV27,TRBJ1-1,CASTLTGMNTEAFF,0,1,1,1
TRBV12-3/4,TRBJ1-2,CASTPDREGGGYTF,0,1,1,1
TRBV12-3/4,TRBJ1-6,CASTRTGEGSPLHF,0,1,1,1
TRBV12-3/4,TRBJ1-2,CASTHSGGAYGYTF,0,1,1,1
TRBV12-3/4,TRBJ2-2,CASTGTGPTGELFF,0,1,1,1
TRBV6-2/3/5/6,TRBJ2-3,CASTGARNTDTQYF,0,1,1,1
TRBV6-2/3/5/6,TRBJ2-7,CASSFRRKAYEQYF,0,1,1,1
TRBV6-2/3/5/6,TRBJ2-5,CASSFQFVRETQYF,0,1,1,1
TRBV12-3/4,TRBJ2-3,CASSFQLAADTQYF,0,1,1,1
TRBV12-3/4,TRBJ1-1,CASSFGQGVTEAFF,0,1,1,1
TRBV6-2/3/5/6,TRBJ2-3,CASSFDTSTDTQYF,0,1,1,1
TRBV28,TRBJ2-2,CASSLTGPTGELFF,0,1,1,1
TRBV6-2/3/5/6,TRBJ1-1,CASSLLGGSTEAFL,0,1,1,1
TRBV12-3/4,TRBJ1-2,CASSLVGQSYGYTF,0,1,1,1
TRBV12-3/4,TRBJ1-6,CASSLAEGNSPLHF,0,1,1,1
TRBV12-3/4,TRBJ1-1,CASSLARAVAEAFF,0,1,1,1
TRBV6-2/3/5/6,TRBJ1-6,CASSLRQGSSPLHF,0,1,1,1
TRBV12-3/4,TRBJ1-2,CASSLRGQGYGYTY,0,1,1,1
TRBV5-4,TRBJ1-2,CASSSVTGGHGYTF,0,1,1,1
TRBV6-2/3/5/6,TRBJ1-2,CASSSRIPNYGYTF,0,1,1,1
TRBV6-2/3/5/6,TRBJ2-1,CASSWGSQYNEQFF,0,1,1,1
TRBV6-2/3/5/6,TRBJ1-2,CASSYSAGYGGYTF,0,1,1,1
TRBV6-2/3/5/6,TRBJ1-5,CASSYSRPNQPQHF,0,1,1,1
TRBV6-2/3/5/6,TRBJ2-3,CASSYVTAGDTQYF,0,1,1,1
TRBV6-2/3/5/6,TRBJ1-2,CASSYVSGYYGYTF,0,1,1,1
TRBV6-2/3/5/6,TRBJ2-1,CASSYGLAGVLQFY,0,1,1,1
TRBV6-2/3/5/6,TRBJ1-1,CASSYGGADTEAFF,0,1,1,1
TRBV6-2/3/5/6,TRBJ2-7,CASSYGQSSYEQYF,0,1,1,1
TRBV27,TRBJ1-1,CASSPATGATEAFF,0,1,1,1
TRBV12-3/4,TRBJ1-5,CASSPGLLSQPQHF,0,1,1,1
TRBV6-2/3/5/6,TRBJ1-4,CASSPGQGHEKLFF,0,1,1,1
TRBV12-3/4,TRBJ2-4,CASSPLDPVNIQYF,0,1,1,1
TRBV6-4,TRBJ1-2,CASSRGTGDYGYTF,0,1,1,1
TRBV12-3/4,TRBJ2-3,CASSRDRTTDTQYF,0,1,1,1
TRBV6-2/3/5/6,TRBJ1-1,CASSRTGASTEAFF,0,1,1,1
TRBV6-1,TRBJ2-1,CASSQSGTNNEQFF,0,1,1,1
TRBV27,TRBJ2-7,CASSQFRGWVEQYF,0,1,1,1
TRBV12-3/4,TRBJ1-1,CASSVQGGYTEAFF,0,1,1,1
TRBV6-1,TRBJ2-7,CASSAVGQSYEQYF,0,1,1,1
TRBV2,TRBJ1-2,CASSGGAGVYGYTF,0,1,1,1
TRBV7-2,TRBJ2-7,CASSGRGLVYEQYF,0,1,1,1
TRBV6-4,TRBJ2-3,CASSDSPGTDTQYF,0,1,1,1
TRBV6-4,TRBJ2-3,CASSDPGPTDTQYF,0,1,1,1
TRBV3-1,TRBJ1-5,CASSDTGNFQPQHF,0,1,1,1
TRBV2,TRBJ1-2,CASSEWRTTFGYTF,0,1,1,1
TRBV25-1,TRBJ2-5,CASSELSGQETQYF,0,1,1,1
TRBV6-1,TRBJ1-1,CASSERGGVGEAFF,0,1,1,1
TRBV13,TRBJ1-5,CASSKGPINQPQHF,0,1,1,1
TRBV11-3,TRBJ1-1,CASSFGPQNTEAFF,0,1,1,1
TRBV7-9,TRBJ2-1,CASSFNSGFAEQFF,0,1,1,1
TRBV5-4,TRBJ1-1,CASSFSSGGTEAFF,0,1,1,1
TRBV5-6,TRBJ1-1,CASSFPDKNTEAFF,0,1,1,1
TRBV13,TRBJ2-5,CASSFGRRRETQYF,0,1,1,1
TRBV7-2,TRBJ2-1,CASSFGSVHNEQFF,0,1,1,1
TRBV7-2,TRBJ1-6,CASSFGADNSPLHF,0,1,1,1
TRBV5-4,TRBJ2-1,CASSLSGTRYEQFF,0,1,1,1
TRBV5-5,TRBJ1-1,CASSLHGGNTEAFF,0,1,1,1
TRBV5-4,TRBJ2-1,CASSLVSGRNEQFF,0,1,1,1
TRBV5-5,TRBJ2-5,CASSLVFDWETQYF,0,1,1,1
TRBV5-5,TRBJ2-5,CASSLASVQETQYF,0,1,1,1
TRBV6-2/3/5/6,TRBJ2-3,CASSLGGGRDTQYF,0,1,1,1
TRBV5-4,TRBJ1-2,CASSLGSLGYGYTF,0,1,1,1
TRBV5-6,TRBJ2-1,CASSLGGRGNEQFF,0,1,1,1
TRBV5-6,TRBJ1-6,CASSLDSALRDLHF,0,1,1,1
TRBV7-9,TRBJ2-1,CASSLYSPGYEQFF,0,1,1,1
TRBV11-2,TRBJ1-1,CASSLQGGNTEAFF,0,1,1,1
TRBV7-7,TRBJ2-1,CASSLQGVYNEQFF,0,1,1,1
TRBV7-8,TRBJ1-5,CASSLVGSNQPQHF,0,1,1,1
TRBV7-2,TRBJ1-1,CASSLVGRHTEAFF,0,1,1,1
TRBV7-6,TRBJ1-1,CASSLAAGNTEAFF,0,1,1,1
TRBV7-9,TRBJ2-7,CASSLAGSFEEQYF,0,1,1,1
TRBV7-8,TRBJ2-5,CASSLGRRAETQYF,0,1,1,1
TRBV7-2,TRBJ2-1,CASSLGTAYNEQFF,0,1,1,1
TRBV7-6,TRBJ2-5,CASSLGGGKETQYF,0,1,1,1
TRBV5-5,TRBJ2-5,CASSLGTGKETQYF,0,1,1,1
TRBV7-2,TRBJ2-5,CASSLGVRQETQYF,0,1,1,1
TRBV7-2,TRBJ1-2,CASSLGVGNYGYTF,0,1,1,1
TRBV7-6,TRBJ2-1,CASSLITSGIEQFF,0,1,1,1
TRBV5-5,TRBJ2-5,CASSSGTSQETQYF,0,1,1,1
TRBV5-6,TRBJ2-1,CASSSVPGRNEQFF,0,1,1,1
TRBV7-9,TRBJ1-1,CASSSGQGITEAFF,0,1,1,1
TRBV5-6,TRBJ2-7,CASSSLTGGHEQYF,0,1,1,1
TRBV11-2,TRBJ2-1,CASSWETLFKEQFF,0,1,1,1
TRBV12-3/4,TRBJ2-7,CASSLPNRLREQYF,0,1,1,1
TRBV7-2,TRBJ2-4,CASSLTGGRNIQYF,0,1,1,1
TRBV12-3/4,TRBJ1-5,CASSLDRLNQPQHF,0,1,1,1
TRBV7-9,TRBJ1-2,CASSLGSTSHGYTF,0,1,1,1
TRBV5-6,TRBJ1-3,CASSLGNSGNTIYF,0,1,1,1
TRBV7-3,TRBJ2-7,CASSLNAGPHEQYF,0,1,1,1
TRBV5-6,TRBJ2-7,CASSPLGDLHEQYF,0,1,1,1
TRBV13,TRBJ1-2,CASSPGTGSYGYTF,0,1,1,1
TRBV9,TRBJ2-1,CASSPSGVDNEQFF,0,1,1,1
TRBV13,TRBJ1-1,CASSPPPGNTEAFF,0,1,1,1
TRBV13,TRBJ1-2,CASSPPVRKNGYTF,0,1,1,1
TRBV3-1,TRBJ2-7,CASSPPGGGYEQYF,0,1,1,1
TRBV12-3/4,TRBJ2-1,CASSPRDYYNEQFF,0,1,1,1
TRBV7-2,TRBJ1-5,CASSPRGTHQPQHF,0,1,1,1
TRBV7-9,TRBJ1-2,CASSPPWGDYGYTL,0,1,1,1
TRBV28,TRBJ1-3,CASSPGQPGNTIYF,0,1,1,1
TRBV13,TRBJ2-3,CASSPGQGGDTQYF,0,1,1,1
TRBV5-6,TRBJ1-2,CASSPDRVAEGYTF,0,1,1,1
TRBV12-3/4,TRBJ1-1,CASSPDRGNTEAFF,0,1,1,1
TRBV7-8,TRBJ2-1,CASSPRQGAYEQFF,0,1,1,1
TRBV5-5,TRBJ1-3,CASSPVGRANTIYF,0,1,1,1
TRBV7-9,TRBJ2-7,CASSRSGDIYEQYF,0,1,1,1
TRBV5-4,TRBJ2-7,CASSRLGLDYEQYF,0,1,1,1
TRBV7-2,TRBJ1-2,CASSRDLGGSGYTF,0,1,1,1
TRBV7-9,TRBJ2-1,CASSRTGGDAGQFF,0,1,1,1
TRBV4-2,TRBJ1-5,CASSRYSSNQPQHF,0,1,1,1
TRBV14,TRBJ2-3,CASSRAGGPPAQYF,0,1,1,1
TRBV5-6,TRBJ2-1,CASSRGDSYNEQFF,0,1,1,1
TRBV13,TRBJ2-1,CASSHAGLGRPKFF,0,1,1,1
TRBV7-9,TRBJ2-1,CASSHYTRPDEQFF,0,1,1,1
TRBV7-9,TRBJ2-1,CASSHDRAYNEQFF,0,1,1,1
TRBV3-1,TRBJ2-2,CASSQGGNTGELFF,0,1,1,1
TRBV7-6,TRBJ2-7,CASSQDRESYEQYF,0,1,1,1
TRBV14,TRBJ1-1,CASSQWGMNTEAFF,0,1,1,1
TRBV12-3/4,TRBJ1-1,CASSQQGRNTEAFF,0,1,1,1
TRBV3-1,TRBJ2-1,CASSQVTVGGEQFF,0,1,1,1
TRBV4-2,TRBJ2-7,CASSQDGAISEQYF,0,1,1,1
TRBV7-6,TRBJ2-1,CASSQTRTYNEQLF,0,1,1,1
TRBV3-1,TRBJ1-2,CASSQRDRLYSYTF,0,1,1,1
TRBV9,TRBJ1-1,CASSVRGRNTEAFF,0,1,1,1
TRBV5-6,TRBJ2-5,CASSVTSGQETQYF,0,1,1,1
TRBV9,TRBJ2-3,CASSVAATGDTQYF,0,1,1,1
TRBV9,TRBJ2-7,CASSVGTAALGQYF,0,1,1,1
TRBV9,TRBJ2-7,CASSVDGQEDEQYF,0,1,1,1
TRBV9,TRBJ1-3,CASSVEPRRNTIYF,0,1,1,1
TRBV9,TRBJ2-7,CASSVTGTPYEQYF,0,1,1,1
TRBV7-3,TRBJ2-5,CASSAMGQSETQYF,0,1,1,1
TRBV7-9,TRBJ2-5,CASSGGRKQETQYF,0,1,1,1
TRBV7-6,TRBJ2-4,CASSGTGGSDIQYF,0,1,1,1
TRBV9,TRBJ2-3,CASSGKSDRDTQYF,0,1,1,1
TRBV13,TRBJ1-1,CASSGQGWGTEAFF,0,1,1,1
TRBV9,TRBJ2-2,CASSDPRATGELFF,0,1,1,1
TRBV13,TRBJ2-7,CASSEYRGQDEQYF,0,1,1,1
TRBV6-1,TRBJ1-4,CASSETVGDGKLFF,0,1,1,1
TRBV7-9,TRBJ2-1,CASSIPDEYNEQFF,0,1,1,1
TRBV7-6,TRBJ1-1,CASSIGQGNTEAFF,0,1,1,1
TRBV7-9,TRBJ2-7,CASSTSRTVYEQYF,0,1,1,1
TRBV9,TRBJ1-1,CASSTTGAESEAFF,0,1,1,1
TRBV7-9,TRBJ1-1,CASSTGQRNTEAFF,0,1,1,1
TRBV7-9,TRBJ1-1,CASSTDRVNTEAFF,0,1,1,1
TRBV7-9,TRBJ2-3,CASSTTSFPDTQYF,0,1,1,1
TRBV7-2,TRBJ1-4,CASSTGATNEKLFF,0,1,1,1
TRBV7-9,TRBJ2-7,CASSSRAGSYERYF,0,1,1,1
TRBV5-6,TRBJ2-1,CASSKTSGYNEQFF,0,1,1,1
TRBV2,TRBJ1-4,CASRGTGPNEKLFF,0,1,1,1
TRBV6-2/3/5/6,TRBJ2-1,CASRGTRESNEQFF,0,1,1,1
TRBV7-9,TRBJ1-1,CASRDAGTGKEAFF,0,1,1,1
TRBV2,TRBJ2-1,CASRMASSYNEQFF,0,1,1,1
TRBV6-2/3/5/6,TRBJ1-5,CASRRDRGGQPQHF,0,1,1,1
TRBV12-3/4,TRBJ2-7,CASRHLGQGHEQYF,0,1,1,1
TRBV27,TRBJ1-6,CASRQTGRGSPLHF,0,1,1,1
TRBV6-2/3/5/6,TRBJ1-5,CASRATGGYQPQHF,0,1,1,1
TRBV6-4,TRBJ1-2,CASRRSRSLSGYTF,0,1,1,1
TRBV6-2/3/5/6,TRBJ1-1,CASNAGQGQDEAFF,0,1,1,1
TRBV12-3/4,TRBJ2-5,CASKRSTDQETQYF,0,1,1,1
TRBV7-9,TRBJ1-1,CASKVQGADTEAFF,0,1,1,1
TRBV27,TRBJ2-3,CASKSVRAADTQYF,0,1,1,1
TRBV2,TRBJ2-1,CARSTAGMYNEQFF,0,1,1,1
TRBV5-6,TRBJ2-7,CDSSWGQGSYEQYF,0,1,1,1
TRBV20-1,TRBJ2-1,CSAKSPSGDNEQFL,0,1,1,1
TRBV4-1,TRBJ1-2,CASSLGVGPYGYTF,0,1,1,1
TRBV5-1,TRBJ2-7,CASAGQGGPYEQYF,0,1,1,1
TRBV4-3,TRBJ2-3,CASSLGQGPDTQYF,0,1,1,1
TRBV5-1,TRBJ2-7,CASSFGQGAYEQYF,0,1,1,1
TRBV5-1,TRBJ2-1,CASSLARGGDEQFF,0,1,1,1
TRBV5-1,TRBJ2-2,CASSLALNTGELFF,0,1,1,1
TRBV5-1,TRBJ2-7,CASSLAPAGYEQYF,0,1,1,1
TRBV5-1,TRBJ2-1,CASSLGGGNNEQFF,0,1,1,1
TRBV5-1,TRBJ2-7,CASSLDGELYEQYF,0,1,1,1
TRBV5-1,TRBJ1-2,CASSLDRTNYGYTF,0,1,1,1
TRBV5-1,TRBJ2-7,CASSLEANSYEQYF,0,1,1,1
TRBV5-1,TRBJ1-1,CASSLTAQGTEAFF,0,1,1,1
TRBV5-1,TRBJ1-1,CASSLDQGNTEAFF,0,1,1,1
TRBV4-1,TRBJ2-1,CASSPPGGWNEQFF,0,1,1,1
TRBV5-1,TRBJ2-7,CASSPGGQAYEQYF,0,1,1,1
TRBV5-1,TRBJ2-5,CASSRGQDQETQYF,0,1,1,1
TRBV4-3,TRBJ2-7,CASSRSSGTYEQYF,0,1,1,1
TRBV5-1,TRBJ2-7,CASSRTGETYEQYF,0,1,1,1
TRBV4-1,TRBJ2-7,CASSRLAESYEQYF,0,1,1,1
TRBV4-3,TRBJ2-1,CASSQGLARDEQFF,0,1,1,1
TRBV4-1,TRBJ2-5,CASSQVRGVETQYF,0,1,1,1
TRBV4-1,TRBJ1-2,CASSQAYRAYGYTF,0,1,1,1
TRBV4-1,TRBJ1-4,CASSQGGGREKLFF,0,1,1,1
TRBV4-3,TRBJ2-7,CASSQGTSGYEQYF,0,1,1,1
TRBV4-1,TRBJ1-1,CASSQDQGNTEAFF,0,1,1,1
TRBV4-3,TRBJ1-1,CASSQDGRSFEAFF,0,1,1,1
TRBV4-3,TRBJ2-3,CASSQDSRTDTQYF,0,1,1,1
TRBV4-3,TRBJ2-2,CASSQDRVTGGLFF,0,1,1,1
TRBV4-1,TRBJ1-1,CASSQDAGNTEAFF,0,1,1,1
TRBV5-1,TRBJ2-3,CASSVGTSTDTQYF,0,1,1,1
TRBV5-1,TRBJ2-1,CASSAGGAYNEQFF,0,1,1,1
TRBV4-1,TRBJ2-7,CASSEGQGGRKQYF,0,1,1,1
TRBV5-1,TRBJ1-6,CASSERGTNSPLHF,0,1,1,1
TRBV5-1,TRBJ2-7,CASSIGTGGYEQYF,0,1,1,1
TRBV5-1,TRBJ2-1,CASSTDSLYNEQFF,0,1,1,1
TRBV4-3,TRBJ2-7,CASSKGGLYGEQYF,0,1,1,1
TRBV5-1,TRBJ2-7,CASRDGAATYEQYF,0,1,1,1
TRBV5-1,TRBJ2-2,CASNDGQNTGELFF,0,1,1,1
TRBV4-3,TRBJ2-5,CTSRPGQGLETQYF,0,1,1,1
TRBV20-1,TRBJ2-3,CSAPRQGVRDTQYF,0,1,1,1
TRBV20-1,TRBJ2-3,CSAEGVPSTDTQYF,0,1,1,1
TRBV20-1,TRBJ1-1,CSATRDRVDGEAFF,0,1,1,1
TRBV20-1,TRBJ2-5,CSATTERLGETQYF,0,1,1,1
TRBV20-1,TRBJ1-5,CSASSRDRGQPQHF,0,1,1,1
TRBV20-1,TRBJ2-5,CSASDLRRQETQYF,0,1,1,1
TRBV20-1,TRBJ2-7,CSASLGQGGYEQYF,0,1,1,1
TRBV20-1,TRBJ2-3,CSASPTSGGDTQYF,0,1,1,1
TRBV20-1,TRBJ2-5,CSASPTGYQETQYF,0,1,1,1
TRBV20-1,TRBJ2-7,CSASAALITYEQYF,0,1,1,1
TRBV20-1,TRBJ2-6,CSARGSSGANVLTF,0,1,1,1
TRBV20-1,TRBJ2-7,CSARVSGLTYEQYF,0,1,1,1
TRBV20-1,TRBJ1-2,CSARVQGFGDGYTF,0,1,1,1
TRBV20-1,TRBJ2-7,CSARGAGESGEQYF,0,1,1,1
TRBV29-1,TRBJ1-1,CSAYRTGIYTEAFF,0,1,1,1
TRBV20-1,TRBJ2-3,CSAGLAGGQDTQYF,0,1,1,1
TRBV29-1,TRBJ2-5,CSAGIQRGQETQYF,0,1,1,1
TRBV20-1,TRBJ1-4,CSAGQPGGNEKLFF,0,1,1,1
TRBV20-1,TRBJ2-3,CSAESGRAPDTQYF,0,1,1,1
TRBV29-1,TRBJ2-2,CSVLSVVNTGELFF,0,1,1,1
TRBV29-1,TRBJ2-3,CSVWGDVSTDTQYF,0,1,1,1
TRBV29-1,TRBJ1-3,CSVREPSSGNTIYF,0,1,1,1
TRBV29-1,TRBJ1-5,CSVVVLGADQPQHF,0,1,1,1
TRBV29-1,TRBJ2-7,CSVAGGLHSYEQYF,0,1,1,1
TRBV29-1,TRBJ2-3,CSVALARFTDTQYF,0,1,1,1
TRBV29-1,TRBJ1-2,CSVGGPDRNYGYTF,0,1,1,1
TRBV29-1,TRBJ2-1,CSVGGLAVYNEQFF,0,1,1,1
TRBV29-1,TRBJ2-2,CSVGQGLITGELFF,0,1,1,1
TRBV29-1,TRBJ2-3,CSVDGQEGTDTQYF,0,1,1,1
TRBV29-1,TRBJ2-1,CSVEPSGNYNEQFF,0,1,1,1
TRBV29-1,TRBJ1-2,CSVEKMRSNYGYTF,0,1,1,1
TRBV29-1,TRBJ2-5,CSVGLAGEGETQYF,0,1,1,1
TRBV29-1,TRBJ1-4,CSVLGWTRGEKLFF,0,1,1,1
TRBV29-1,TRBJ2-5,CSVVAGGPGETQYL,0,1,1,1
TRBV20-1,TRBJ2-5,CSALSGRAGETQYF,0,1,1,1
TRBV29-1,TRBJ2-1,CSAEASGSGKKQFF,0,1,1,1
TRBV29-1,TRBJ2-2,CSARAAANTGELVF,0,1,1,1
TRBV29-1,TRBJ2-1,CSARLESSYNEQFF,0,1,1,1
TRBV29-1,TRBJ2-3,CSAGRPSGTDTQYF,0,1,1,1
TRBV29-1,TRBJ2-3,CSARTGPSTDTQYF,0,1,1,1
TRBV29-1,TRBJ2-2,CSGRAGISTGELFF,0,1,1,1
TRBV7-9,TRBJ2-7,YASSWGLAGREQYF,0,1,1,1
TRBV5-6,TRBJ2-3,YASSLGGSTDTQYF,0,1,1,1
TRBV2,TRBJ1-1,YASSLDGLNTEAFF,0,1,1,1
TRBV7-3,TRBJ2-7,RASSLSPGCGEQYF,0,1,1,1
TRBV12-5,TRBJ2-7,CASSDVGGREQYF,0,1,1,1
TRBV12-5,TRBJ2-5,CASGSGPWETQYF,0,1,1,1
TRBV12-5,TRBJ2-7,CASGGKSSYEQYF,0,1,1,1
TRBV30,TRBJ1-2,CAWSVGQGYGYTF,0,1,1,1
TRBV30,TRBJ2-1,CAWSGMGLGEQFF,0,1,1,1
TRBV30,TRBJ2-5,CAWSGAGVETQYF,0,1,1,1
TRBV30,TRBJ1-2,CAWSRDRPYGYTF,0,1,1,1
TRBV2,TRBJ2-2,CAALAGGTGELFF,0,1,1,1
TRBV10-3,TRBJ2-1,CAISAQGYNEQFF,0,1,1,1
TRBV24-1,TRBJ2-1,CATSDPKRAEQFF,0,1,1,1
TRBV24-1,TRBJ2-1,CATSEPGQYEQFF,0,1,1,1
TRBV7-9,TRBJ2-5,CATSLLTRETQYF,0,1,1,1
TRBV2,TRBJ2-4,CASQQGAQNIQYF,0,1,1,1
TRBV19,TRBJ1-1,CASIHGGGTEAFF,0,1,1,1
TRBV19,TRBJ1-5,CASTRTQNQPQHF,0,1,1,1
TRBV19,TRBJ1-1,CASSFTGNTEAFF,0,1,1,1
TRBV19,TRBJ2-1,CASSIGGIDEQFF,0,1,1,1
TRBV19,TRBJ1-1,CASSIGLNTEAFF,0,1,1,1
TRBV19,TRBJ2-5,CASSIINQETQYF,0,1,1,1
TRBV19,TRBJ1-4,CASSISTNEKLFF,0,1,1,1
TRBV19,TRBJ1-5,CASSIVVDQPQHF,0,1,1,1
TRBV19,TRBJ2-1,CASSIAQYNEQFF,0,1,1,1
TRBV19,TRBJ2-7,CASSTGQGEGQYF,0,1,1,1
TRBV19,TRBJ2-3,CASRTEAADTQYF,0,1,1,1
TRBV2,TRBJ1-2,CASSGGRDHGYTF,0,1,1,1
TRBV18,TRBJ2-1,CASSSRQLNEQFF,0,1,1,1
TRBV18,TRBJ2-1,CASSPGTPNEQFF,0,1,1,1
TRBV18,TRBJ2-7,CASSPVSDVGQYF,0,1,1,1
TRBV12-3/4,TRBJ1-1,CASYNHGDTEAFF,0,1,1,1
TRBV7-9,TRBJ2-5,CASLLGQGETQYF,0,1,1,1
TRBV12-3/4,TRBJ2-1,CASIDNREYEQFF,0,1,1,1
TRBV5-6,TRBJ2-5,CASILSPEETQYF,0,1,1,1
TRBV6-2/3/5/6,TRBJ1-5,CASTSRPDQPQHF,0,1,1,1
TRBV27,TRBJ2-1,CASTLMWGDEQFF,0,1,1,1
TRBV12-3/4,TRBJ1-3,CASTPDFRYTIYF,0,1,1,1
TRBV2,TRBJ2-5,CASTGGSGETQYF,0,1,1,1
TRBV12-3/4,TRBJ1-5,CASSFGDYQPQHF,0,1,1,1
TRBV6-2/3/5/6,TRBJ2-7,CASSFGESYEQYF,0,1,1,1
TRBV27,TRBJ1-5,CASSLATNQPQHF,0,1,1,1
TRBV6-2/3/5/6,TRBJ1-5,CASSLGQNQPQHF,0,1,1,1
TRBV27,TRBJ2-5,CASSLDIQETQYF,0,1,1,1
TRBV12-3/4,TRBJ1-2,CASSLEGRYGYTF,0,1,1,1
TRBV12-3/4,TRBJ1-1,CASSLKGVTEAFF,0,1,1,1
TRBV6-2/3/5/6,TRBJ2-1,CASSSRGRNEQFF,0,1,1,1
TRBV6-2/3/5/6,TRBJ1-1,CASSYSGLTEAFF,0,1,1,1
TRBV6-2/3/5/6,TRBJ2-7,CASSYRASHEQYF,0,1,1,1
TRBV12-3/4,TRBJ1-2,CASSLDGSSGYTF,0,1,1,1
TRBV6-2/3/5/6,TRBJ1-5,CASSLTENQPQHF,0,1,1,1
TRBV6-2/3/5/6,TRBJ1-1,CASSPIGGYEAFF,0,1,1,1
TRBV7-9,TRBJ2-5,CASSPTDRETQYF,0,1,1,1
TRBV12-3/4,TRBJ1-6,CASSRTGASPLHL,0,1,1,1
TRBV12-3/4,TRBJ2-5,CASSRPQAGTQYF,0,1,1,1
TRBV6-4,TRBJ1-1,CASSHQRNTEAFF,0,1,1,1
TRBV6-4,TRBJ1-2,CASSQEDRYGYTF,0,1,1,1
TRBV6-1,TRBJ2-3,CASSAQGLGTQYF,0,1,1,1
TRBV2,TRBJ1-1,CASSAQGITEAFF,0,1,1,1
TRBV6-1,TRBJ2-5,CASSAGGRETRYF,0,1,1,1
TRBV12-3/4,TRBJ1-5,CASSGDRNQPQHF,0,1,1,1
TRBV7-6,TRBJ1-1,CASSDTPNTEAFF,0,1,1,1
TRBV12-3/4,TRBJ2-7,CASSEGSSYEQYF,0,1,1,1
TRBV6-4,TRBJ1-2,CASSETPNYGYTF,0,1,1,1
TRBV6-1,TRBJ1-1,CASSEQWDTEAFF,0,1,1,1
TRBV2,TRBJ1-1,CASSEVAETEAFF,0,1,1,1
TRBV2,TRBJ2-7,CASSEAQAGYPTF,0,1,1,1
TRBV6-1,TRBJ1-2,CASSEGRRSGYTF,0,1,1,1
TRBV2,TRBJ2-1,CASSEEAYNEQFF,0,1,1,1
TRBV5-4,TRBJ2-3,CASSTAVGDTQYF,0,1,1,1
TRBV7-9,TRBJ2-5,CASSLPGGETQYF,0,1,1,1
TRBV5-4,TRBJ1-1,CASSLAAPSEAFF,0,1,1,1
TRBV5-4,TRBJ2-3,CASSLAGTDTQYF,0,1,1,1
TRBV5-6,TRBJ1-2,CASSLAGPGGYTF,0,1,1,1
TRBV7-6,TRBJ2-3,CASSLGTGDTQYF,0,1,1,1
TRBV5-4,TRBJ2-7,CASSLGPKGLGNF,0,1,1,1
TRBV11-1,TRBJ2-1,CASSLESGYEQFF,0,1,1,1
TRBV11-2,TRBJ1-5,CASSLSRNQPQHF,0,1,1,1
TRBV6-2/3/5/6,TRBJ1-1,CASSLLSSTGAFF,0,1,1,1
TRBV11-1,TRBJ2-5,CASSLPGQETQYF,0,1,1,1
TRBV13,TRBJ2-7,CASSLGLSYEQYF,0,1,1,1
TRBV7-2,TRBJ2-1,CASSLGLYSEQFF,0,1,1,1
TRBV7-2,TRBJ2-7,CASSLGGFGEQYF,0,1,1,1
TRBV7-2,TRBJ2-7,CASSLGTVYEQYF,0,1,1,1
TRBV11-1,TRBJ2-1,CASSLGLAREQFF,0,1,1,1
TRBV7-9,TRBJ1-2,CASSLGQDGGYTF,0,1,1,1
TRBV7-6,TRBJ2-5,CASSLDPQETQYF,0,1,1,1
TRBV7-2,TRBJ1-1,CASSLEISTEAFF,0,1,1,1
TRBV7-3,TRBJ1-1,CASSLIGNTEAFF,0,1,1,1
TRBV7-2,TRBJ1-1,CASSLKEGTEAFF,0,1,1,1
TRBV11-3,TRBJ2-7,CASSSSGAYEQYF,0,1,1,1
TRBV7-2,TRBJ1-5,CASSSAGHQPQHF,0,1,1,1
TRBV4-2,TRBJ2-3,CASSSKMGSTQYF,0,1,1,1
TRBV7-6,TRBJ1-3,CASSSAAGNTIYF,0,1,1,1
TRBV5-4,TRBJ2-1,CASSSAGGREQFF,0,1,1,1
TRBV7-2,TRBJ1-4,CASSWDRDEKLFF,0,1,1,1
TRBV6-2/3/5/6,TRBJ1-1,CASSLMENTEAFF,0,1,1,1
TRBV12-3/4,TRBJ2-5,CASSLRGGETQYF,0,1,1,1
TRBV5-6,TRBJ2-3,CASSLGGSDTQYF,0,1,1,1
TRBV7-3,TRBJ2-7,CASSPWPGSEQYF,0,1,1,1
TRBV11-3,TRBJ2-5,CASSPAPRETQYF,0,1,1,1
TRBV12-3/4,TRBJ2-7,CASSPDRGREQYF,0,1,1,1
TRBV14,TRBJ2-1,CASSPNSYNEQFF,0,1,1,1
TRBV12-3/4,TRBJ1-1,CASSPTQGSEAFF,0,1,1,1
TRBV12-3/4,TRBJ2-7,CASSRDRVNEQYF,0,1,1,1
TRBV7-6,TRBJ1-1,CASSRTPNTEAFF,0,1,1,1
TRBV7-9,TRBJ2-3,CASSRVNTDTQYF,0,1,1,1
TRBV12-3/4,TRBJ2-5,CASSRDSQETQYF,0,1,1,1
TRBV3-1,TRBJ2-5,CASSHPRLETQYF,0,1,1,1
TRBV7-2,TRBJ2-5,CASSHTLEETQYF,0,1,1,1
TRBV4-2,TRBJ1-5,CASSHFIGQPQHF,0,1,1,1
TRBV3-1,TRBJ2-5,CASSQSGQATQYF,0,1,1,1
TRBV14,TRBJ2-5,CASSQVRGETQYF,0,1,1,1
TRBV14,TRBJ2-2,CASSQVDSRELFF,0,1,1,1
TRBV4-2,TRBJ2-1,CASSQVEGNEQFF,0,1,1,1
TRBV4-2,TRBJ2-3,CASSQGRTDTQYF,0,1,1,1
TRBV3-1,TRBJ1-5,CASSQDLDQPQHF,0,1,1,1
TRBV7-6,TRBJ2-7,CASSQDRTYEQYF,0,1,1,1
TRBV3-1,TRBJ1-1,CASSQTGGTEAFF,0,1,1,1
TRBV6-2/3/5/6,TRBJ2-1,CASSVDVGYEQFF,0,1,1,1
TRBV9,TRBJ2-1,CASSVVGGNEQFF,0,1,1,1
TRBV9,TRBJ1-1,CASSVGGYTEAFF,0,1,1,1
TRBV9,TRBJ1-2,CASSARQDGGYTF,0,1,1,1
TRBV7-9,TRBJ2-1,CASSAGTSDEQFF,0,1,1,1
TRBV6-2/3/5/6,TRBJ2-1,CASSADRGFEQFF,0,1,1,1
TRBV7-9,TRBJ2-1,CASSTSGWGEQFF,0,1,1,1
TRBV7-9,TRBJ1-4,CASSRDRGEKLFF,0,1,1,1
TRBV7-2,TRBJ2-7,CASSKTGAYEQYF,0,1,1,1
TRBV6-2/3/5/6,TRBJ1-1,CASRVTGVTEAFF,0,1,1,1
TRBV7-9,TRBJ1-6,CASRAGSGSPLHF,0,1,1,1
TRBV6-2/3/5/6,TRBJ2-4,CASRGTGTDIQYF,0,1,1,1
TRBV2,TRBJ1-1,CASRGQGDTEAFF,0,1,1,1
TRBV12-3/4,TRBJ1-2,CASRMTGSYGYTF,0,1,1,1
TRBV27,TRBJ2-7,CASRTGAPYEQYF,0,1,1,1
TRBV2,TRBJ1-2,CASRTGGDYGYTF,0,1,1,1
TRBV2,TRBJ2-3,CASRRRITDTQYF,0,1,1,1
TRBV12-3/4,TRBJ2-7,CASRPGLTYEQYF,0,1,1,1
TRBV6-2/3/5/6,TRBJ2-2,CASRPNSPGELFF,0,1,1,1
TRBV12-3/4,TRBJ2-7,CASRRDRGYEQYF,0,1,1,1
TRBV12-3/4,TRBJ1-6,CASRGPRISPLHF,0,1,1,1
TRBV6-2/3/5/6,TRBJ2-2,CASRNPGLGELFF,0,1,1,1
TRBV12-3/4,TRBJ2-2,CASRNPGPGELFF,0,1,1,1
TRBV25-1,TRBJ2-1,CASNLKLGGEQFF,0,1,1,1
TRBV2,TRBJ2-7,CASKVGRYYEQYF,0,1,1,1
TRBV18,TRBJ2-5,CTSSPVRQETQYF,0,1,1,1
TRBV4-3,TRBJ1-2,CASSPDRDYGYTF,0,1,1,1
TRBV5-1,TRBJ2-7,CASSVSGEIEQYF,0,1,1,1
TRBV5-1,TRBJ1-1,CASSFRQNTEAFF,0,1,1,1
TRBV5-1,TRBJ2-5,CASSLAPGETQYF,0,1,1,1
TRBV5-1,TRBJ2-7,CASSLEGRYEQYF,0,1,1,1
TRBV11-3,TRBJ2-5,CASSSGIQETQYF,0,1,1,1
TRBV5-4,TRBJ2-1,CASSSGPINEQFF,0,1,1,1
TRBV5-1,TRBJ2-7,CASSLGLSDEQYF,0,1,1,1
TRBV5-1,TRBJ1-1,CASSLGQHTEAFF,0,1,1,1
TRBV5-1,TRBJ1-2,CASSPLGDYGYTF,0,1,1,1
TRBV5-1,TRBJ2-5,CASSRQGEETQYF,0,1,1,1
TRBV5-1,TRBJ1-2,CASSRDRGFYDTF,0,1,1,1
TRBV4-1,TRBJ2-1,CASSHLVENEQFF,0,1,1,1
TRBV4-1,TRBJ2-5,CASSQLTEETQYF,0,1,1,1
TRBV4-1,TRBJ1-2,CASSNQSGRGYTF,0,1,1,1
TRBV4-3,TRBJ1-1,CASRRDLNTEAFF,0,1,1,1
TRBV29-1,TRBJ2-4,CIITMSGSNIQYF,0,1,1,1
TRBV20-1,TRBJ2-5,CSACRDNKETQYF,0,1,1,1
TRBV20-1,TRBJ2-5,CSAPPPTTETQYF,0,1,1,1
TRBV20-1,TRBJ2-5,CSAREGPQETQYF,0,1,1,1
TRBV20-1,TRBJ1-3,CSAQTPRRNTIYF,0,1,1,1
TRBV29-1,TRBJ1-3,CSAQDRAGNTIYF,0,1,1,1
TRBV20-1,TRBJ1-1,CSAVTGDNTEAFF,0,1,1,1
TRBV20-1,TRBJ1-4,CSATTAVNENLFF,0,1,1,1
TRBV20-1,TRBJ2-3,CSASQRGPDTQYF,0,1,1,1
TRBV20-1,TRBJ1-5,CSARGRGGQPQHF,0,1,1,1
TRBV20-1,TRBJ1-5,CSARGRGNQPQHF,0,1,1,1
TRBV20-1,TRBJ1-5,CSARSRANQPQHF,0,1,1,1
TRBV20-1,TRBJ1-1,CSARDLREGGAFF,0,1,1,1
TRBV20-1,TRBJ2-7,CSARDPRIGEQYF,0,1,1,1
TRBV20-1,TRBJ2-5,CSARDRGGETQYF,0,1,1,1
TRBV20-1,TRBJ1-1,CSAKGQGGTEAFF,0,1,1,1
TRBV20-1,TRBJ1-3,CSADGTGGNTIYF,0,1,1,1
TRBV20-1,TRBJ2-2,CSAMDSNTGELFF,0,1,1,1
TRBV29-1,TRBJ2-5,CSVASATQETQYF,0,1,1,1
TRBV29-1,TRBJ1-1,CSVADRWDTEAFF,0,1,1,1
TRBV29-1,TRBJ1-1,CSVEAQAGTEAFF,0,1,1,1
TRBV29-1,TRBJ2-1,CSVEGLRYNEQFF,0,1,1,1
TRBV29-1,TRBJ1-2,CSVESGGGFGYTF,0,1,1,1
TRBV29-1,TRBJ2-5,CSVETGGEETQYF,0,2,1,2
TRBV29-1,TRBJ2-7,CSVKTPTTLEQYF,0,1,1,1
TRBV29-1,TRBJ2-5,CSVSGTGKETQYF,0,1,1,1
TRBV29-1,TRBJ2-7,CSVAPRDNYEQYF,0,1,1,1
TRBV29-1,TRBJ1-5,CSVARGPDQPQHF,0,1,1,1
TRBV29-1,TRBJ2-1,CSVIAGGSNEQFF,0,1,1,1
TRBV29-1,TRBJ1-2,CSVAGRHRSGYTF,0,1,1,1
TRBV29-1,TRBJ1-3,CSVTRGPGNTMYF,0,1,1,1
TRBV29-1,TRBJ1-5,CSVRQGFDQPQHF,0,1,1,1
TRBV29-1,TRBJ1-5,CSVNGGAGQPQHF,0,1,1,1
TRBV29-1,TRBJ1-1,CSALNRGGTEAFF,0,1,1,1
TRBV29-1,TRBJ2-7,CSAQSGFGYEQYF,0,1,1,1
TRBV29-1,TRBJ2-7,CSAGTGTGYEQYF,0,1,1,1
TRBV29-1,TRBJ2-7,CSAKPGQGAEQYF,0,1,1,1
TRBV29-1,TRBJ1-1,CSGGGSMNTEAFF,0,1,1,1
TRBV29-1,TRBJ1-1,CSSSTGGNTEAFF,0,1,1,1
TRBV19,TRBJ1-1,RASSTAGNTEAFF,0,1,1,1
TRBV28,TRBJ1-2,RASSLTGAPGYTF,0,1,1,1
TRBV7-4,TRBJ2-5,RASSPRKQETQYF,0,1,1,1
TRBV4-3,TRBJ2-1,RASSQDFYNEQFF,0,1,1,1
TRBV30,TRBJ1-1,CAWGGAKFEAFF,0,1,1,1
TRBV30,TRBJ2-1,CARGTRFDEQSF,0,1,1,1
TRBV7-9,TRBJ2-7,CAADGGDYEQYF,0,1,1,1
TRBV4-2,TRBJ2-1,CATQTGGNEQFF,0,1,1,1
TRBV2,TRBJ1-2,CATNRANYGYTF,0,1,1,1
TRBV19,TRBJ1-5,CASSFKDQPQHF,0,1,1,1
TRBV19,TRBJ1-2,CASSLPGQGYTF,0,1,1,1
TRBV19,TRBJ2-1,CASSSSRLGQFF,0,1,1,1
TRBV19,TRBJ2-5,CASSLAGETQYF,0,1,1,1
TRBV19,TRBJ2-7,CASSSGKYEQYF,0,1,1,1
TRBV19,TRBJ1-2,CASSIMDYGYTF,0,1,1,1
TRBV2,TRBJ2-7,CASEYRVHEQYF,0,1,1,1
TRBV7-9,TRBJ2-1,CASTRGSYEQFF,0,1,1,1
TRBV12-3/4,TRBJ2-1,CASTFSKNARFF,0,1,1,1
TRBV6-2/3/5/6,TRBJ2-7,CASSFRGYEQYF,0,1,1,1
TRBV12-3/4,TRBJ2-1,CASSFWTAEQFF,0,1,1,1
TRBV6-2/3/5/6,TRBJ2-5,CASSLNGETQYF,0,1,1,1
TRBV27,TRBJ2-3,CASSLRGDTQYF,0,1,1,1
TRBV12-3/4,TRBJ1-2,CASSLAPAGYTF,0,1,1,1
TRBV27,TRBJ2-1,CASSSDYNEQFF,0,1,1,1
TRBV27,TRBJ2-1,CASSSWGNEQFF,0,1,1,1
TRBV6-2/3/5/6,TRBJ2-1,CASSYVGTEQFF,0,1,1,1
TRBV27,TRBJ2-2,CASSLLGGELFF,0,1,1,1
TRBV2,TRBJ2-1,CASSPTGDEQFF,0,1,1,1
TRBV25-1,TRBJ1-2,CASSEYGEGYTF,0,1,1,1
TRBV6-1,TRBJ2-1,CASSEGYRGQFF,0,1,1,1
TRBV6-1,TRBJ1-5,CASSENGQPQHF,0,1,1,1
TRBV5-4,TRBJ1-1,CASSLHSGEAFF,0,1,1,1
TRBV5-6,TRBJ2-7,CASSLQTYEQYF,0,1,1,1
TRBV5-5,TRBJ2-7,CASSLVQGEQYF,0,1,1,1
TRBV5-6,TRBJ1-5,CASSLGDQPQHF,0,1,1,1
TRBV7-9,TRBJ1-5,CASSLEDQPQHF,0,1,1,1
TRBV7-9,TRBJ1-1,CASSLRGTEAFF,0,1,1,1
TRBV13,TRBJ2-5,CASSLGRETQYF,0,1,1,1
TRBV7-2,TRBJ1-2,CASSLDTYGYTF,0,1,1,1
TRBV7-9,TRBJ2-1,CASSLTSDEQFF,0,1,1,1
TRBV13,TRBJ2-4,CASSLNRDIQYL,0,1,1,1
TRBV7-2,TRBJ2-3,CASSSLAGAQYL,0,1,1,1
TRBV7-9,TRBJ1-6,CASSYAEGPLHF,0,1,1,1
TRBV7-2,TRBJ1-1,CASSLGGPEALF,0,1,1,1
TRBV12-3/4,TRBJ1-5,CASSLSPQPQHF,0,1,1,1
TRBV7-9,TRBJ1-5,CASSPSNQPQHF,0,1,1,1
TRBV7-9,TRBJ2-5,CASSPSGETQYF,0,1,1,1
TRBV12-3/4,TRBJ1-5,CASSPRNQPQHF,0,1,1,1
TRBV7-9,TRBJ2-5,CASSPGDGTQYF,0,1,1,1
TRBV7-2,TRBJ2-1,CASSPGRVQQFF,0,1,1,1
TRBV6-2/3/5/6,TRBJ2-5,CASSPDRETQYF,0,1,1,1
TRBV6-2/3/5/6,TRBJ2-7,CASSHTEYEQYF,0,1,1,1
TRBV3-1,TRBJ2-7,CASSQTTYEQYF,0,1,1,1
TRBV3-1,TRBJ2-3,CASSQVTHTQYF,0,1,1,1
TRBV7-9,TRBJ2-7,CASSQNRYEQYF,0,1,1,1
TRBV7-6,TRBJ1-2,CASSADLYGYTF,0,1,1,1
TRBV11-2,TRBJ2-1,CASSERGIKQFF,0,1,1,1
TRBV14,TRBJ2-7,CASSIGPGEQYF,0,1,1,1
TRBV5-4,TRBJ2-1,CASSSGPREQFF,0,1,1,1
TRBV9,TRBJ2-1,CASSNRGDEQFF,0,1,1,1
TRBV7-9,TRBJ2-5,CASRGYQETQYF,0,1,1,1
TRBV12-3/4,TRBJ2-7,CASRYVGYEQYF,0,1,1,1
TRBV5-6,TRBJ1-6,CASRRELSPLHF,0,1,1,1
TRBV12-3/4,TRBJ1-1,CASRVMNTEAFS,0,1,1,1
TRBV2,TRBJ2-7,CASNGASYEQYF,0,1,1,1
TRBV6-2/3/5/6,TRBJ1-4,CASKTANEKLFF,0,1,1,1
TRBV12-3/4,TRBJ2-5,CACSSAEETQYF,0,1,1,1
TRBV5-1,TRBJ1-6,CASGDSNSPLHF,0,1,1,1
TRBV5-1,TRBJ2-7,CASSRTGDEQYF,0,1,1,1
TRBV4-1,TRBJ1-1,CASSQGFTEAFF,0,1,1,1
TRBV5-1,TRBJ2-1,CASSTGPTSQFF,0,1,1,1
TRBV20-1,TRBJ2-1,CTSGLSYNEQFF,0,1,1,1
TRBV29-1,TRBJ2-7,CSVGTSFDEQYF,0,1,1,1
TRBV20-1,TRBJ2-7,CSAISRSAEQYF,0,1,1,1
TRBV20-1,TRBJ2-7,CSASGSGYEQYF,0,1,1,1
TRBV20-1,TRBJ2-1,CSARVPGDEQFF,0,1,1,1
TRBV20-1,TRBJ1-1,CSARGPNTEAFF,0,1,1,1
TRBV20-1,TRBJ2-5,CSARNGQETQYF,0,1,1,1
TRBV20-1,TRBJ1-1,CSAKVLNTEAFF,0,1,1,1
TRBV20-1,TRBJ1-3,CSGQGPGNTIYF,0,1,1,1
TRBV29-1,TRBJ2-1,CSVVQGPGEQFF,0,1,1,1
TRBV29-1,TRBJ2-2,CSVARSTGELFF,0,1,1,1
TRBV29-1,TRBJ1-3,CSVAGDGNTIYF,0,1,1,1
TRBV29-1,TRBJ2-5,CSVGDPGETQYF,0,1,1,1
TRBV29-1,TRBJ2-1,CSVGTGIHEQFF,0,1,1,1
TRBV29-1,TRBJ2-1,CSVGRARYEQFF,0,1,1,1
TRBV29-1,TRBJ1-1,CSVDLGGTEAFF,0,1,1,1
TRBV29-1,TRBJ2-7,CSVRVTSYEQYF,0,1,1,1
TRBV29-1,TRBJ2-1,CSVKQGYDEQFF,0,1,1,1
TRBV29-1,TRBJ1-1,CSVQQTGSEAFF,0,1,1,1
TRBV29-1,TRBJ1-1,CSGKRQGAEAFF,0,1,1,1
TRBV18,TRBJ1-1,CACSTTGKAFF,0,1,1,1
TRBV30,TRBJ1-3,CAWMIGNTIYF,0,1,1,1
TRBV30,TRBJ2-2,CAWSVAGELFF,0,1,1,1
TRBV2,TRBJ2-1,CASGTDNEQFF,0,1,1,1
TRBV25-1,TRBJ2-1,CASGSGGRQFF,0,1,1,1
TRBV2,TRBJ1-1,CASTGNGEAFF,0,1,1,1
TRBV28,TRBJ2-1,CASSLVDEQFF,0,1,1,1
TRBV12-3/4,TRBJ2-6,CASSSGAVLTF,0,1,1,1
TRBV6-2/3/5/6,TRBJ2-1,CASSYLDEQFF,0,1,1,1
TRBV12-3/4,TRBJ2-1,CASSVALEQFF,0,1,1,1
TRBV7-9,TRBJ1-6,CASSLGSPLHF,0,1,1,1
TRBV7-9,TRBJ2-7,CASSLSSEQYF,0,1,1,1
TRBV7-2,TRBJ1-2,CASSSRYGYTF,0,1,1,1
TRBV3-1,TRBJ1-2,CASSLTGGYTF,0,1,1,1
TRBV6-2/3/5/6,TRBJ2-1,CASSPVGEQFS,0,1,1,1
TRBV11-2,TRBJ2-1,CASSPGIELFF,0,1,1,1
TRBV3-1,TRBJ2-7,CASSRTWEQYF,0,1,1,1
TRBV12-3/4,TRBJ1-2,CASSRRGGYTF,0,1,1,1
TRBV3-1,TRBJ2-1,CASSQGATEIF,0,1,1,1
TRBV4-2,TRBJ2-1,CASSQDRWQFF,0,1,1,1
TRBV7-4,TRBJ2-7,CASSTRYERYF,0,1,1,1
TRBV25-1,TRBJ1-1,CASSRGTEAFF,0,1,1,1
TRBV10-3,TRBJ2-7,CASRWVDEQYF,0,1,1,1
TRBV2,TRBJ2-5,CASRLWETQYF,0,1,1,1
TRBV30,TRBJ1-2,CAVVGIYGYTF,0,1,1,1
TRBV10-2,TRBJ2-4,CASWTGEVQYF,0,1,1,1
TRBV5-1,TRBJ2-5,CASSLLETQYF,0,1,1,1
TRBV5-1,TRBJ2-1,CASSLHNEQFF,0,1,1,1
TRBV5-1,TRBJ2-7,CASSLGHEQYF,0,1,1,1
TRBV20-1,TRBJ2-1,CSPSVGNEQFF,0,1,1,1
TRBV20-1,TRBJ1-1,CSASSNTEAFF,0,1,1,1
TRBV20-1,TRBJ2-1,CSANLPVEQFF,0,1,1,1
TRBV20-1,TRBJ2-2,CSAKRAGELFF,0,1,1,1
TRBV29-1,TRBJ2-3,CSVYSTDTQYF,0,1,1,1
TRBV29-1,TRBJ2-7,CSVKSADEQYF,0,1,1,1
TRBV29-1,TRBJ2-1,CSVEMGLEQFF,0,1,1,1
TRBV29-1,TRBJ2-1,CSVRTSCEQFF,0,1,1,1
TRBV29-1,TRBJ2-1,CSVAGVHEQFF,0,1,1,1
TRBV20-1,TRBJ1-2,CSAGVVYGYTF,0,1,1,1
TRBV29-1,TRBJ2-5,CSKTDQESQYF,0,1,1,1
TRBV29-1,TRBJ2-1,CRVGGGNEQFF,0,1,1,1
TRBV27,TRBJ2-3,CASGRGTQYF,0,1,1,1
TRBV20-1,TRBJ2-1,CSADRHEQFF,0,1,1,1
TRBV20-1,TRBJ2-5,CSASRETQYF,0,1,1,1
TRBV29-1,TRBJ1-1,CSVVIGEAFF,0,1,1,1
TRBV29-1,TRBJ2-7,CSGWEGEQYL,0,1,1,1
TRBV19,TRBJ2-7,CASRQGQYF,0,1,1,1
TRBV7-9,TRBJ2-1,CASTGPGFF,0,1,1,1
TRBV3-1,TRBJ1-1,CASSQTAFI,0,1,1,1
TRBV20-1,TRBJ1-2,CMTGYTF,0,1,1,1
TRBV9,TRBJ1-4,CASANPPGRGPTNEKLFF,0,1,1,1
TRBV30,TRBJ1-6,CAWSGQFAYNSPLHF,0,1,1,1
TRBV4-2,TRBJ2-4,CASSQVFARGNFQYF,0,1,1,1
TRBV6-2/3/5/6,TRBJ1-1,CASSSTGSRTEAFF,0,1,1,1
TRBV27,TRBJ2-7,CASSIGGASYEQYF,0,1,1,1
TRBV6-1,TRBJ1-6,CASSVRGSPLHI,0,1,1,1
TRBV25-1,TRBJ2-7,CASSGQPYEQYF,0,1,1,1
TRBV29-1,TRBJ2-3,CSVEGGSTSGRTDTQYF,0,1,1,1
TRBV19,TRBJ1-5,CASSRPLQGGNQPQHF,0,1,1,1
TRBV5-1,TRBJ2-1,CASRVSLDWAQERFF,0,1,1,1
TRBV3-1,TRBJ1-1,CASSQKWTGATEAFF,0,1,1,1
TRBV3-1,TRBJ2-7,CASSSVRGGYEQYF,0,1,1,1
TRBV5-1,TRBJ2-7,CASSIGTSGNEQYF,0,1,1,1
TRBV20-1,TRBJ2-4,CSASDVAKNIQYL,0,1,1,1
TRBV18,TRBJ1-1,CASSPRVSISEDTEAFL,0,1,1,1
TRBV7-9,TRBJ2-7,CASSLSGTASSYEQYF,0,1,1,1
TRBV15,TRBJ2-4,CATSRDRRDTGLAGVNLAKNIQYF,0,1,1,1
TRBV11-2,TRBJ2-1,CASSFRLPGGLAGEGSYNEQFF,0,1,1,1
TRBV9,TRBJ2-1,CASSGGPKQWAITSGDYNEQFF,0,1,1,1
TRBV18,TRBJ2-1,CASSPPKPLAGFLEREDEQFF,0,1,1,1
TRBV28,TRBJ2-3,CASSFSSRPSGRQGSTDTQYF,0,1,1,1
TRBV6-2/3/5/6,TRBJ2-3,CASSWVWAREPEAVSTDTQYF,0,1,1,1
TRBV13,TRBJ2-1,CASSLGFPGLSGSGKYNEQFF,0,1,1,1
TRBV14,TRBJ1-1,CASSHSLKVLRQGRTNTEAFF,0,1,1,1
TRBV7-9,TRBJ2-3,CASSHGIGTTIAALLVDTQYF,0,1,1,1
TRBV30,TRBJ1-1,CAWSVLGMRRQGAPNTEAFF,0,1,1,1
TRBV15,TRBJ2-2,CATSREPVSGRAFNTGELFF,0,1,1,1
TRBV12-3/4,TRBJ2-2,CASCYSSLGLAGEITGELFF,0,1,1,1
TRBV7-8,TRBJ2-5,CASSSRTGASGGRPRETQYS,0,1,1,1
TRBV5-6,TRBJ2-1,CASSLELAGGPGLIGNEQFF,0,1,1,1
TRBV7-3,TRBJ2-2,CASSLTLGIAGATNTGELFF,0,1,1,1
TRBV7-2,TRBJ2-1,CASSSKYLGIRHEDNNEQFF,0,1,1,1
TRBV14,TRBJ2-6,CASSPRVPVHRASGANVLTF,0,1,1,1
TRBV5-1,TRBJ2-1,CASSWSSGLAGSRAENEQFF,0,1,1,1
TRBV19,TRBJ2-2,CATLAGGLPNFANTGELFF,0,1,1,1
TRBV15,TRBJ1-4,CATSRDYPAGTPEIGKLFF,0,1,1,1
TRBV6-2/3/5/6,TRBJ2-5,CASSYSPGTSGRSQETQYF,0,1,1,1
TRBV6-2/3/5/6,TRBJ2-1,CASSYDSRTGFIRYNEQFF,0,1,1,1
TRBV6-2/3/5/6,TRBJ2-5,CASSYTAGTSAQYQETQYF,0,1,1,1
TRBV12-3/4,TRBJ2-7,CASSPGSLTGGRFSYEQYF,0,1,1,1
TRBV7-2,TRBJ1-4,CASSLEATGGLATNEKLFF,0,1,1,1
TRBV7-2,TRBJ2-7,CASSWPGTSGTMSSYEQYF,0,1,1,1
TRBV7-9,TRBJ2-1,CASSLFSTRTGDRYNEQFF,0,1,1,1
TRBV7-9,TRBJ2-3,CASSPTSGGLQGYTDTQYF,0,1,1,1
TRBV4-2,TRBJ1-2,CASSQSPTWKGGLFYGYTF,0,1,1,1
TRBV14,TRBJ2-1,CASSQWGTGTPSSYNEQFF,0,1,1,1
TRBV4-2,TRBJ2-7,CASSQRPAGTSGRVDEQYF,0,1,1,1
TRBV7-9,TRBJ2-6,CASRAQLRTREFWANVLTF,0,1,1,1
TRBV5-1,TRBJ2-1,CASSSRPSGSAVRGNEQFF,0,1,1,1
TRBV4-1,TRBJ2-3,CASSQAVGRQRLNMGGQYF,0,1,1,1
TRBV4-3,TRBJ2-1,CASSQDAGPIYSSYNEQFF,0,1,1,1
TRBV4-3,TRBJ2-1,CASSQEPLGAGTSYNEQFF,0,1,1,1
TRBV4-1,TRBJ2-6,CASSQEIFQGASGANVLTF,0,1,1,1
TRBV20-1,TRBJ2-3,CSAPRVAGGPSFVPDTQYF,0,1,1,1
TRBV29-1,TRBJ2-1,CSVEDLDRRLFGSYNEQFF,0,1,1,1
TRBV12-5,TRBJ2-5,CASGLTPVTRGPVGTQYF,0,1,1,1
TRBV24-1,TRBJ2-2,CATSDNPQGPWNTGELFF,0,1,1,1
TRBV15,TRBJ2-1,CATSRVDGGRNPYNEQFF,0,1,1,1
TRBV19,TRBJ2-3,CASSYATGTGLLGDTQYF,0,1,1,1
TRBV12-3/4,TRBJ1-5,CASPRPGEGSMSNQPQHF,0,1,1,1
TRBV6-2/3/5/6,TRBJ2-1,CASTHDRVDLATRDEQFF,0,1,1,1
TRBV12-3/4,TRBJ2-2,CASSLPPGQGDHTGELFF,0,1,1,1
TRBV12-3/4,TRBJ2-6,CASSLGQVFSDEANVLTF,0,1,1,1
TRBV12-3/4,TRBJ2-1,CASSLGSGDSRSYNEQFF,0,1,1,1
TRBV12-3/4,TRBJ2-1,CASSSVIYSGSINNEQFF,0,1,1,1
TRBV6-2/3/5/6,TRBJ1-2,CASSYSRDHRGLSYGYTF,0,1,1,1
TRBV6-2/3/5/6,TRBJ2-3,CASSYGLLADGSTDTQYF,0,1,1,1
TRBV12-3/4,TRBJ1-3,CASSRLLQGKYSGNTIYF,0,1,1,1
TRBV25-1,TRBJ2-2,CASSAPSLARANTGELFF,0,1,1,1
TRBV6-4,TRBJ2-1,CASSDLPPGEGSYNEQFF,0,1,1,1
TRBV12-3/4,TRBJ2-4,CASSTQSGTSGAKNIQYF,0,1,1,1
TRBV7-2,TRBJ1-5,CASSFGQGGSYSNQPQHF,0,1,1,1
TRBV5-6,TRBJ2-1,CASSLGVTGTGDNNEQFF,0,1,1,1
TRBV7-7,TRBJ2-7,CASSLSHRSGIFSYEQYF,0,1,1,1
TRBV6-2/3/5/6,TRBJ2-6,CASSLSERDYSGANVPTF,0,1,1,1
TRBV7-6,TRBJ2-1,CASSLRPASGSSYNEQFF,0,1,1,1
TRBV7-6,TRBJ1-2,CASSLAVQRDSPWYGYTF,0,1,1,1
TRBV11-2,TRBJ2-1,CASSLGYRGRRPDNEQFF,0,1,1,1
TRBV7-9,TRBJ1-5,CASSLGEVRLRDNQPQHF,0,1,1,1
TRBV7-2,TRBJ2-1,CASSLTSGGSSSYNEQFF,0,1,1,1
TRBV7-9,TRBJ2-7,CASSSSTQRYSSSYEQYF,0,1,1,1
TRBV5-4,TRBJ1-1,CASSSPDAGGGGLTEAFF,0,1,1,1
TRBV5-6,TRBJ1-2,CASSSTRWGGQSSPGYTF,0,1,1,1
TRBV7-8,TRBJ2-1,CASSSTIAGGPSNNEQFF,0,1,1,1
TRBV7-2,TRBJ2-6,CASSLGGGSRSGANVLTF,0,1,1,1
TRBV7-9,TRBJ2-3,CASSLRRATSGTPHTQYF,0,1,1,1
TRBV5-6,TRBJ2-4,CASSPKIGTNIAKNIQYF,0,1,1,1
TRBV7-9,TRBJ2-5,CASSPPTSGRASEETQYF,0,1,1,1
TRBV3-1,TRBJ2-1,CASSRWTSRGTQGNEQFS,0,1,1,1
TRBV3-1,TRBJ2-1,CASSHETGRTVSYNEQFL,0,1,1,1
TRBV3-1,TRBJ2-1,CASSQDTRAGGGLDEQFF,0,1,1,1
TRBV9,TRBJ2-3,CASSVEGLAADSTDTQYF,0,1,1,1
TRBV7-9,TRBJ2-7,CASSVKLGTAGRLYEQYF,0,1,1,1
TRBV2,TRBJ2-4,CASRDRTGGISAKNIQYF,0,1,1,1
TRBV7-2,TRBJ2-3,CASRPISLAGRNTDTQYF,0,1,1,1
TRBV6-2/3/5/6,TRBJ2-7,CASRRPGQGKSLGYEQYF,0,1,1,1
TRBV5-1,TRBJ2-6,CASSFGRPDRTGANVLTF,0,1,1,1
TRBV5-1,TRBJ1-3,CASSFGTPEYTSGNTIYF,0,1,1,1
TRBV5-1,TRBJ2-6,CASSLPRQVPPGANVLTF,0,1,1,1
TRBV5-1,TRBJ1-4,CASSLRSLRDSANEKLFF,0,1,1,1
TRBV4-3,TRBJ1-2,CASSLGRNFRTANYGYTF,0,1,1,1
TRBV4-1,TRBJ2-2,CASSPFETGLVNTGELFF,0,1,1,1
TRBV4-1,TRBJ1-5,CASSQGGRQGYGNQPQHF,0,1,1,1
TRBV4-1,TRBJ2-5,CASSQDFTRAHYQETQYF,0,1,1,1
TRBV4-3,TRBJ2-3,CASSQDPTSGRAGDTQYF,0,1,1,1
TRBV4-3,TRBJ2-7,CASSQDRVLAGGSAKQYF,0,1,1,1
TRBV4-3,TRBJ2-3,CASSQDLLAGELGDTQYF,0,1,1,1
TRBV20-1,TRBJ2-2,CSAASLRASELNTGELFF,0,1,1,1
TRBV20-1,TRBJ1-2,CSAILLSGDLPSGYGYTF,0,1,1,1
TRBV29-1,TRBJ2-3,CSVALVLVATEITDTQYF,0,1,1,1
TRBV7-2,TRBJ1-6,CAGSLVGGGEYNSPLHF,0,1,1,1
TRBV12-3/4,TRBJ2-7,CAIPLPTGTGNTYEQYS,0,1,1,1
TRBV15,TRBJ2-5,CATSREQGGGAVETQYF,0,1,1,1
TRBV15,TRBJ2-2,CATSRDGRTRTTGELFF,0,1,1,1
TRBV24-1,TRBJ2-1,CATKDRQGVSSCNEQFF,0,1,1,1
TRBV19,TRBJ2-6,CASSIGWITSGANVLTF,0,1,1,1
TRBV19,TRBJ2-1,CASSMRVGASSYNEQFF,0,1,1,1
TRBV19,TRBJ1-4,CASSIGPEGATNEKLFF,0,1,1,1
TRBV18,TRBJ1-1,CASSLQGSGAMNTEAFF,0,1,1,1
TRBV18,TRBJ1-1,CASSPSGQGLWETEAFF,0,1,1,1
TRBV2,TRBJ2-7,CASLSTGGLAGGYEQYF,0,1,1,1
TRBV5-4,TRBJ2-1,CASGPRIGTGSRDEQFF,0,1,1,1
TRBV6-2/3/5/6,TRBJ2-6,CASTDRRGRSGANVLTF,0,1,1,1
TRBV12-3/4,TRBJ2-5,CASSFLVRGSVQETQYF,0,1,1,1
TRBV6-2/3/5/6,TRBJ2-1,CASSLFQRGATRYEQFF,0,1,1,1
TRBV12-3/4,TRBJ2-7,CASSLVGPGQGVHEQYF,0,1,1,1
TRBV12-3/4,TRBJ2-1,CASSLEFLAGGNNERFF,0,1,1,1
TRBV12-3/4,TRBJ2-1,CASSLEFLAGGNNEQFF,0,1,1,1
TRBV6-2/3/5/6,TRBJ2-2,CASSSPSGSGNTGELFF,0,1,1,1
TRBV6-2/3/5/6,TRBJ1-6,CASSSPAGGSYNSPLHF,0,1,1,1
TRBV12-3/4,TRBJ2-2,CASSSGLAGTNTGELFF,0,1,1,1
TRBV6-2/3/5/6,TRBJ2-5,CASSYSNSPGQQETQYF,0,1,1,1
TRBV7-2,TRBJ2-6,CASSPGAGNSGANVLTF,0,1,1,1
TRBV6-2/3/5/6,TRBJ1-2,CASSPSFAGGLHYGYTF,0,1,1,1
TRBV12-3/4,TRBJ2-1,CASSPRLAGGLYNEQFF,0,1,1,1
TRBV13,TRBJ2-1,CASSRTSGGSSYNEQFF,0,1,1,1
TRBV6-4,TRBJ2-2,CASSARTSGGYTGELFF,0,1,1,1
TRBV6-1,TRBJ2-1,CASSDLLPKVHDKWQFF,0,1,1,1
TRBV28,TRBJ1-5,CASSEGGAGRPNQPQHF,0,1,1,1
TRBV25-1,TRBJ2-3,CASSEPRDRAGTDTQYF,0,1,1,1
TRBV2,TRBJ1-1,CASSEVRSRTGHTEAFF,0,1,1,1
TRBV2,TRBJ2-2,CASSEVGGQSLTGELFF,0,1,1,1
TRBV5-6,TRBJ1-1,CASSLRIWARLNTEAFF,0,1,1,1
TRBV5-4,TRBJ2-1,CASSLDSGRFPYNEQFF,0,1,1,1
TRBV5-5,TRBJ2-7,CASSLEPSGRNSYEQYF,0,1,1,1
TRBV7-6,TRBJ2-1,CASSLTSGRAAYNEQFF,0,1,1,1
TRBV7-2,TRBJ2-5,CASSLSTGPGVQETQYF,0,1,1,1
TRBV7-2,TRBJ2-6,CASSLYTRDSGANVLTF,0,1,1,1
TRBV5-4,TRBJ2-2,CASSLLAGGPPSGELFF,0,1,1,1
TRBV7-2,TRBJ2-6,CASSLLAGGIGANVLTF,0,1,1,1
TRBV7-2,TRBJ1-5,CASSLVAGQLEGQPQHF,0,1,1,1
TRBV7-2,TRBJ2-1,CASSLVPTSGRRREQFF,0,1,1,1
TRBV7-6,TRBJ2-6,CASSLVGSLAGANVLTF,0,1,1,1
TRBV7-9,TRBJ2-1,CASSLVSSRNPPYEQFF,0,1,1,1
TRBV7-6,TRBJ2-7,CASSLASGLAGVYEQYF,0,1,1,1
TRBV7-9,TRBJ2-5,CASSLASLAGGGETQHF,0,1,1,1
TRBV11-2,TRBJ2-7,CASSLAAGVWSNYEQYF,0,1,1,1
TRBV7-9,TRBJ2-1,CASSLDPYAGDYNEQFF,0,1,1,1
TRBV7-2,TRBJ2-2,CASSLDGLAGGSGELFF,0,1,1,1
TRBV7-3,TRBJ2-1,CASSLMPSGASYNEQFF,0,1,1,1
TRBV7-2,TRBJ2-2,CASSLRGLSGGTGELLF,0,1,1,1
TRBV7-2,TRBJ2-3,CASSSLPEGPSTDTQYF,0,1,1,1
TRBV5-6,TRBJ1-5,CASSSRTGGIGNQPQHF,0,1,1,1
TRBV7-9,TRBJ2-1,CASSSGERGGLRNEQFF,0,1,1,1
TRBV5-6,TRBJ2-6,CASSSTGRVSGANVLTF,0,1,1,1
TRBV7-9,TRBJ2-7,CASSSIETDRGDYEQYF,0,1,1,1
TRBV7-2,TRBJ2-2,CASSLYRTGGLIGELFF,0,1,1,1
TRBV6-2/3/5/6,TRBJ2-3,CASSPGSGQAYADTQYF,0,1,1,1
TRBV11-2,TRBJ2-1,CASSPMGGGGFYNEQFF,0,1,1,1
TRBV11-2,TRBJ2-1,CASSPLGGSGSLREQFF,0,1,1,1
TRBV6-2/3/5/6,TRBJ2-7,CASSPTQGRLPTYEQYF,0,1,1,1
TRBV5-5,TRBJ2-3,CASSPSRTSGSTDTQYF,0,1,1,1
TRBV3-1,TRBJ2-3,CASSHGLAGGQTDTQYF,0,1,1,1
TRBV4-2,TRBJ2-6,CASSQALQGTGANVLTF,0,1,1,1
TRBV4-2,TRBJ2-5,CASSQGTRGSNQETQYF,0,1,1,1
TRBV4-2,TRBJ2-5,CASSQGLAGGPDKTQYF,0,1,1,1
TRBV4-2,TRBJ2-5,CASSQGDSLLYQETQYF,0,1,1,1
TRBV4-2,TRBJ1-2,CASSQDPVGTSGYGYTF,0,1,1,1
TRBV3-1,TRBJ2-1,CASSQEGGGSSYNEQFF,0,1,1,1
TRBV14,TRBJ2-7,CASSQTYTGGFAYEQYF,0,1,1,1
TRBV9,TRBJ2-1,CASSVAAEGGPGNEQFF,0,1,1,1
TRBV7-8,TRBJ2-1,CASSAFLAGGPHNEQFF,0,1,1,1
TRBV9,TRBJ1-1,CASSADPNRAMNTEAFF,0,1,1,1
TRBV5-5,TRBJ2-3,CASSENRLAGGTDTQYF,0,1,1,1
TRBV5-4,TRBJ2-1,CASRPSGAPSSYNEQFF,0,1,1,1
TRBV27,TRBJ1-4,CASRARQMPAANEKLFF,0,1,1,1
TRBV2,TRBJ2-1,CASRGGTRGSTYNEQFF,0,1,1,1
TRBV19,TRBJ1-5,CASSMGGAGGSNQPQHF,0,1,1,1
TRBV5-1,TRBJ2-7,CASSFDVSARRYYEQYF,0,1,1,1
TRBV5-1,TRBJ2-7,CASSLVAGGSFSYEQYF,0,1,1,1
TRBV5-1,TRBJ2-6,CASSLAGPNSGANVLTF,0,1,1,1
TRBV5-1,TRBJ2-7,CASSLDLAGGGFYEQYF,0,1,1,1
TRBV5-1,TRBJ2-3,CASSLRPMGGLFDTQYF,0,1,1,1
TRBV7-9,TRBJ2-7,CASSLAGGQGGSYEQYF,0,1,1,1
TRBV4-1,TRBJ2-3,CASSLRGTGGVTDTQYF,0,1,1,1
TRBV4-1,TRBJ1-4,CASSPRTGGITNEKLFF,0,1,1,1
TRBV4-1,TRBJ2-5,CASSRLPTGASVETQYF,0,1,1,1
TRBV4-1,TRBJ2-2,CASSHPSGGPNTGELFF,0,1,1,1
TRBV4-3,TRBJ2-3,CASSQAGTSGSTDTQYF,0,1,1,1
TRBV4-1,TRBJ1-5,CASSQVVGQGVDQPQHF,0,1,1,1
TRBV4-1,TRBJ1-3,CASSQAALVGSGNTIYF,0,1,1,1
TRBV4-3,TRBJ1-3,CASSQGVGTNSGNTIYF,0,1,1,1
TRBV4-1,TRBJ2-3,CASSQDPIAAGTDTQYF,0,1,1,1
TRBV4-3,TRBJ2-3,CASSQDRGQGVADTQYF,0,1,1,1
TRBV4-3,TRBJ2-1,CASSQDGGLANYNEQFF,0,1,1,1
TRBV4-3,TRBJ2-6,CASSQDGKGSGANVLTF,0,1,1,1
TRBV4-3,TRBJ2-1,CASSQESPLAGGDEQFF,0,1,1,1
TRBV4-3,TRBJ2-1,CASSQEVAGGIYNEQFF,0,1,1,1
TRBV4-3,TRBJ2-7,CASSQERTSGGPYEQYF,0,1,1,1
TRBV4-1,TRBJ1-1,CASSDPRNRGLNTEAFF,0,1,1,1
TRBV4-1,TRBJ2-1,CASRAKSALGPYDGQFF,0,1,1,1
TRBV20-1,TRBJ2-3,CSARPDGGAGGPDTQYF,0,1,1,1
TRBV20-1,TRBJ2-1,CSARVVWREASYNEQFF,0,1,1,1
TRBV20-1,TRBJ2-1,CSARDLLVASTYNEQFF,0,1,1,1
TRBV20-1,TRBJ2-1,CSARDLSGSLSYNEQFF,0,1,1,1
TRBV20-1,TRBJ1-4,CSARDLLEGALNEKLFF,0,1,1,1
TRBV20-1,TRBJ2-3,CSARDPQGRGSTDTQYF,0,1,1,1
TRBV20-1,TRBJ1-5,CSARDPSRSGANQPQHF,0,1,1,1
TRBV29-1,TRBJ2-2,CSVKLAGSLGGTGELFF,0,1,1,1
TRBV14,TRBJ2-7,WASSQTYTGGFAYEQYF,0,1,1,1
TRBV12-5,TRBJ2-4,CASGLVLGVAKNIQYF,0,1,1,1
TRBV12-5,TRBJ1-5,CASGLGDTYSNQPQHF,0,1,1,1
TRBV30,TRBJ2-5,CAWSPPGQGLRETQYF,0,1,1,1
TRBV30,TRBJ2-1,CAWRHPLQGASNEQFF,0,1,1,1
TRBV2,TRBJ2-1,CAIEPGQGGVDNEQFF,0,1,1,1
TRBV10-3,TRBJ2-3,CAITLGTGLASDTQYF,0,1,1,1
TRBV10-3,TRBJ2-5,CAISESWAKSQETQYF,0,1,1,1
TRBV10-3,TRBJ2-3,CAIRTGERDGTDTQYF,0,1,1,1
TRBV10-3,TRBJ2-7,CATYRGRDAQAYEQYF,0,1,1,1
TRBV15,TRBJ1-4,CATTPTGERTNEKLFF,0,1,1,1
TRBV15,TRBJ2-7,CATSPLREGVTYEQYF,0,1,1,1
TRBV15,TRBJ2-1,CATSTFSGGALDEQFF,0,1,1,1
TRBV15,TRBJ1-2,CATSRDQGPHAYGYTF,0,1,1,1
TRBV15,TRBJ2-5,CATSREDGVFNRDQYF,0,1,1,1
TRBV24-1,TRBJ2-2,CATRGEGQVHTGELFF,0,1,1,1
TRBV15,TRBJ2-2,CATGQGDFANTGKLFF,0,1,1,1
TRBV18,TRBJ1-1,CASRTGETGGASEAFF,0,1,1,1
TRBV19,TRBJ1-5,CASSYPRGQSNQPQHF,0,1,1,1
TRBV19,TRBJ1-5,CASSLYRGDSNQPQHF,0,1,1,1
TRBV19,TRBJ2-1,CASSIPGASGGNEQFF,0,1,1,1
TRBV19,TRBJ2-2,CASSIRGRTNTGELFF,0,1,1,1
TRBV19,TRBJ2-3,CASSIGGDRRTDTQYF,0,1,1,1
TRBV19,TRBJ2-1,CASSTGSLGLYNEQFF,0,1,1,1
TRBV18,TRBJ2-1,CASSPVRSGSYNEQFF,0,1,1,1
TRBV18,TRBJ2-3,CASSPFSQGNTDTQYF,0,1,1,1
TRBV18,TRBJ2-1,CASSPKRGEVFNEQFF,0,1,1,1
TRBV19,TRBJ1-5,CASPGQDHDSNQPQHF,0,1,1,1
TRBV4-2,TRBJ2-3,CASGQTSGKGTDTQYF,0,1,1,1
TRBV12-3/4,TRBJ2-7,CASGYRRGAGSYEQYF,0,1,1,1
TRBV7-9,TRBJ2-7,CASEAVTGQDAYEQYF,0,1,1,1
TRBV6-2/3/5/6,TRBJ1-5,CASTGRQGGSNQPQHF,0,1,1,1
TRBV2,TRBJ2-1,CASTRSLAEQYNEQFF,0,1,1,1
TRBV6-2/3/5/6,TRBJ2-7,CASTRGEGGGTYEQYF,0,1,1,1
TRBV2,TRBJ2-1,CASTRTSGPSYNEQFF,0,1,1,1
TRBV6-2/3/5/6,TRBJ2-5,CASSFYLSSFKETQYF,0,1,1,1
TRBV12-3/4,TRBJ2-5,CASSFYLSPFKETQYF,0,1,1,1
TRBV12-3/4,TRBJ2-7,CASSFGGTSGRDEQYF,0,1,1,1
TRBV6-2/3/5/6,TRBJ2-5,CASSFLAGTIGETQYF,0,1,1,1
TRBV12-3/4,TRBJ2-7,CASSFGDRAARNEQYF,0,1,1,1
TRBV28,TRBJ2-1,CASSLGVRAQGDEQFF,0,1,1,1
TRBV27,TRBJ1-6,CASSLSGQGVTSPLHF,0,1,1,1
TRBV27,TRBJ2-5,CASSLSWVTTRETQYF,0,1,1,1
TRBV28,TRBJ2-7,CASSLPTGGINDEQYF,0,1,1,1
TRBV12-3/4,TRBJ2-6,CASSLRWGDGANVLTF,0,1,1,1
TRBV12-3/4,TRBJ2-1,CASSLQSGTALNEQFF,0,1,1,1
TRBV6-2/3/5/6,TRBJ1-6,CASSLGTGGRNSPLHF,0,1,1,1
TRBV7-3,TRBJ2-1,CASSLIVTSGNNEQFF,0,1,1,1
TRBV6-2/3/5/6,TRBJ2-1,CASSSLWVRTYNEQFF,0,1,1,1
TRBV6-2/3/5/6,TRBJ2-1,CASSYFRDGLYNEQFF,0,1,1,1
TRBV6-2/3/5/6,TRBJ1-4,CASSYSNRATNEKLFF,0,1,1,1
TRBV6-2/3/5/6,TRBJ1-3,CASSYSRASSGNTIYF,0,1,1,1
TRBV6-2/3/5/6,TRBJ2-1,CASSYSGGRRYNEQFF,0,1,1,1
TRBV6-2/3/5/6,TRBJ1-1,CASSYSKGAENTEAFF,0,1,1,1
TRBV6-2/3/5/6,TRBJ1-2,CASSYSRGQGGDGYTF,0,1,1,1
TRBV6-2/3/5/6,TRBJ2-5,CASSYLTSGGPETQYF,0,1,1,1
TRBV6-2/3/5/6,TRBJ2-1,CASSYPTGPSGNEQFF,0,1,1,1
TRBV6-2/3/5/6,TRBJ2-7,CASSYPSGSGRVEQYF,0,1,1,1
TRBV6-2/3/5/6,TRBJ2-2,CASSYPLRGDTGELFF,0,1,1,1
TRBV6-2/3/5/6,TRBJ1-1,CASSYRRGTGDTEAFF,0,1,1,1
TRBV6-2/3/5/6,TRBJ1-5,CASSYVWDSSNQPQHF,0,1,1,1
TRBV6-2/3/5/6,TRBJ2-1,CASSYAPVSSYNEQFF,0,1,1,1
TRBV6-2/3/5/6,TRBJ1-2,CASSYGGSLSNYGYTF,0,1,1,1
TRBV7-9,TRBJ2-3,CASSPRTSGGQDTQYF,0,1,1,1
TRBV7-2,TRBJ2-3,CASSPHVAGGLNTQYF,0,1,1,1
TRBV12-3/4,TRBJ2-2,CASSPAPAGTTGELFF,0,1,1,1
TRBV12-3/4,TRBJ2-7,CASSRPTSGRPLEQYF,0,1,1,1
TRBV28,TRBJ1-1,CASSRDRGRMNTEAFF,0,1,1,1
TRBV7-2,TRBJ2-1,CASSRTSGRSYNEQFF,0,1,1,1
TRBV6-2/3/5/6,TRBJ2-2,CASSQTGLVGTGELFF,0,1,1,1
TRBV6-1,TRBJ2-7,CASSQTRGQGSSEQYF,0,1,1,1
TRBV6-4,TRBJ2-1,CASSDSGTSSYNEQFF,0,1,1,1
TRBV6-4,TRBJ1-3,CASSDLGQPRGNTIYF,0,1,1,1
TRBV6-4,TRBJ1-6,CASSDPFHRYNSPLHF,0,1,1,1
TRBV6-4,TRBJ2-7,CASSDRTRFQSYEQYF,0,1,1,1
TRBV2,TRBJ1-5,CASSERIGGGNQPQHF,0,1,1,1
TRBV2,TRBJ2-5,CASSEVGGRFPETQYF,0,1,1,1
TRBV6-1,TRBJ2-1,CASSEGFGRLQDEQFF,0,1,1,1
TRBV6-1,TRBJ1-2,CASSKQGNPDYYGYTF,0,1,1,1
TRBV6-2/3/5/6,TRBJ2-1,CASSFSALSSYNEQFF,0,1,1,1
TRBV13,TRBJ2-1,CASSFYRGSRYNEQFF,0,1,1,1
TRBV5-6,TRBJ2-7,CASSFGGRDRAYEQYF,0,1,1,1
TRBV7-8,TRBJ2-5,CASSFSSGGASETQYF,0,1,1,1
TRBV7-9,TRBJ2-2,CASSFWGLANTGELFF,0,1,1,1
TRBV7-9,TRBJ2-5,CASSFGTSGIQETQYF,0,1,1,1
TRBV13,TRBJ2-7,CASSFTSGGPSYEQYF,0,1,1,1
TRBV5-4,TRBJ1-5,CASSLYGTGGNQPQHF,0,1,1,1
TRBV5-4,TRBJ2-7,CASSLPSGGASYEQYF,0,1,1,1
TRBV7-2,TRBJ2-1,CASSLHPGPWGDEQFF,0,1,1,1
TRBV7-9,TRBJ2-7,CASSLGLAGNAYEQYF,0,1,1,1
TRBV5-5,TRBJ2-7,CASSLGQGRISYERYF,0,1,1,1
TRBV5-4,TRBJ2-1,CASSLDPSGRTNEQFF,0,1,1,1
TRBV5-6,TRBJ2-2,CASSLDGRAGGGELFF,0,1,1,1
TRBV5-6,TRBJ1-1,CASSLELTGLDFEAFF,0,1,1,1
TRBV7-2,TRBJ1-5,CASSLTAVRGNQPQHF,0,1,1,1
TRBV7-9,TRBJ2-1,CASSLFRGASYNEQFF,0,1,1,1
TRBV7-2,TRBJ2-6,CASSLSGAFGANVLTF,0,1,1,1
TRBV5-6,TRBJ2-1,CASSLLTSGDYNGQFF,0,1,1,1
TRBV12-3/4,TRBJ1-5,CASSLLRGGGSRPQHV,0,1,1,1
TRBV7-9,TRBJ1-1,CASSLPRDSLGTEAFF,0,1,1,1
TRBV11-2,TRBJ2-7,CASSLVAWTDSYEQYF,0,1,1,1
TRBV11-2,TRBJ2-7,CASSLVAGGPVGEQYF,0,1,1,1
TRBV7-2,TRBJ2-7,CASSLAGLAGRWEQYF,0,1,1,1
TRBV7-2,TRBJ2-7,CASSLARTGALGERYF,0,1,1,1
TRBV5-5,TRBJ2-2,CASSLGVRGVTGELFF,0,1,1,1
TRBV13,TRBJ1-3,CASSLGPNPSGNTIYF,0,1,1,1
TRBV7-6,TRBJ2-5,CASSLGGGGAGETQYF,0,1,1,1
TRBV7-6,TRBJ2-1,CASSLGGASGMHEQFF,0,1,1,1
TRBV7-2,TRBJ2-2,CASSLGVRQDTGELFF,0,1,1,1
TRBV11-2,TRBJ1-2,CASSLEGDRANYGYTF,0,1,1,1
TRBV7-6,TRBJ2-2,CASSLEDPGRTGELFF,0,1,1,1
TRBV7-2,TRBJ2-1,CASSLIPPNLNNEQFV,0,1,1,1
TRBV7-2,TRBJ2-5,CASSLRLLAGEETQYL,0,1,1,1
TRBV5-8,TRBJ1-2,CASSSPWGLTNYGYTF,0,1,1,1
TRBV11-3,TRBJ2-1,CASSSRTSGSYDEQFF,0,1,1,1
TRBV5-6,TRBJ2-2,CASSSSWVLNTGELFF,0,1,1,1
TRBV7-9,TRBJ2-3,CASSSSPGLATDTQYF,0,1,1,1
TRBV7-9,TRBJ2-6,CASSSRPNSGANVLTF,0,1,1,1
TRBV7-2,TRBJ1-5,CASSSGLEGSNQPQHF,0,1,1,1
TRBV7-9,TRBJ2-7,CASSSGGGLAAYEQYF,0,1,1,1
TRBV5-6,TRBJ1-2,CASSWTRQAERYGYTF,0,1,1,1
TRBV7-9,TRBJ1-6,CASSYAQFSYNSPLHF,0,1,1,1
TRBV9,TRBJ1-6,CASSLRQGSVNSPLHF,0,1,1,1
TRBV5-4,TRBJ2-2,CASSLGGHDRTGELFF,0,1,1,1
TRBV5-4,TRBJ2-3,CASSLGLAGRTDTQYS,0,1,1,1
TRBV7-2,TRBJ2-5,CASSLGTSGSQETQYF,0,1,1,1
TRBV14,TRBJ2-3,CASSPFESSSTDTQYF,0,1,1,1
TRBV7-9,TRBJ2-1,CASSPSRGAWSNEQFF,0,1,1,1
TRBV3-1,TRBJ2-6,CASSPGWFSGANVLTF,0,1,1,1
TRBV6-2/3/5/6,TRBJ2-1,CASSPNLAGGPSEQFF,0,1,1,1
TRBV4-2,TRBJ1-3,CASSPLGFFTGNTIYF,0,1,1,1
TRBV4-2,TRBJ2-1,CASSPWTRWEEAEQFF,0,1,1,1
TRBV5-6,TRBJ2-7,CASSPRGHSEFYEQYF,0,1,1,1
TRBV11-2,TRBJ2-5,CASSPRDRFNQETQYF,0,1,1,1
TRBV6-2/3/5/6,TRBJ1-1,CASSPGQGLLNTEAFF,0,1,1,1
TRBV12-3/4,TRBJ2-7,CASSPRQGAFSYEQYF,0,1,1,1
TRBV7-3,TRBJ2-5,CASSPSRGGYTETQYF,0,1,1,1
TRBV3-1,TRBJ2-7,CASSPGTSGNLYEQYF,0,1,1,1
TRBV7-9,TRBJ2-3,CASSPGTGVSTDTQYF,0,1,1,1
TRBV5-6,TRBJ2-7,CASSPDPSGRKYEQYF,0,1,1,1
TRBV13,TRBJ2-7,CASSPLTNSPPYEQYF,0,1,1,1
TRBV7-9,TRBJ2-3,CASSPAVTSSTDTQYF,0,1,1,1
TRBV7-9,TRBJ2-3,CASSPTGSLLADTQYF,0,1,1,1
TRBV3-1,TRBJ2-5,CASSRTGDGIKETQYF,0,1,1,1
TRBV6-2/3/5/6,TRBJ2-6,CASSRKQGSGANVLTF,0,1,1,1
TRBV2,TRBJ1-5,CASSHWDRGFVQPQHF,0,1,1,1
TRBV7-9,TRBJ1-4,CASSHRGQGAREKLFF,0,1,1,1
TRBV4-2,TRBJ1-2,CASSHHNFRDTYGYTF,0,1,1,1
TRBV6-2/3/5/6,TRBJ1-6,CASSHGQSSYNSPLHF,0,1,1,1
TRBV6-2/3/5/6,TRBJ1-4,CASSQLPGGLNEKLVF,0,1,1,1
TRBV3-1,TRBJ1-4,CASSQPSDATNEKLFF,0,1,1,1
TRBV14,TRBJ2-3,CASSQVGPRSTDTQYF,0,1,1,1
TRBV14,TRBJ1-2,CASSQAGWGARDGYTF,0,1,1,1
TRBV4-2,TRBJ1-2,CASSQGQETLDYGYTF,0,1,1,1
TRBV14,TRBJ1-1,CASSQGGLGWTTEAFF,0,1,1,1
TRBV3-1,TRBJ1-2,CASSQGGGQTNYGYTF,0,1,1,1
TRBV3-1,TRBJ2-1,CASSQGSGGANNEQFF,0,1,1,1
TRBV3-1,TRBJ2-1,CASSQDLSSAYNEQFF,0,1,1,1
TRBV4-2,TRBJ2-1,CASSQDQTGTINEQFF,0,1,1,1
TRBV3-1,TRBJ2-5,CASSQDVLAGQETQYF,0,1,1,1
TRBV3-1,TRBJ2-7,CASSQDIPQASYEQYF,0,1,1,1
TRBV4-2,TRBJ1-2,CASSQEITGVVYGYTF,0,1,1,1
TRBV9,TRBJ2-3,CASSVRAGDGTDTQYF,0,1,1,1
TRBV9,TRBJ1-4,CASSVAGGDGEVKLFF,0,1,1,1
TRBV9,TRBJ2-4,CASSVGVEVAKNIQYF,0,1,1,1
TRBV13,TRBJ2-7,CASSVGAGGPSYEQYF,0,1,1,1
TRBV9,TRBJ1-2,CASSVEVVGRGYGYTF,0,1,1,1
TRBV9,TRBJ2-5,CASSVSTSGGQETQYF,0,1,1,1
TRBV7-9,TRBJ2-7,CASSASGTGDSYEQYF,0,1,1,1
TRBV6-2/3/5/6,TRBJ2-1,CASSALAGELDGEQFF,0,1,1,1
TRBV5-6,TRBJ1-5,CASSGTGDGDNQPQHF,0,1,1,1
TRBV7-2,TRBJ1-3,CASSGGGGGSGNTIYF,0,1,1,1
TRBV13,TRBJ2-1,CASSDGGTSGSREQFF,0,1,1,1
TRBV7-2,TRBJ2-5,CASSDRGSLWGETQYF,0,1,1,1
TRBV6-4,TRBJ1-1,CASSEVQTGKNTEAFF,0,1,1,1
TRBV27,TRBJ2-3,CASSISGTVPTDTQYF,0,1,1,1
TRBV7-9,TRBJ2-1,CASSTSGGTSYNEQFF,0,1,1,1
TRBV7-2,TRBJ2-6,CASSTMTSGGANVLTF,0,1,1,1
TRBV5-4,TRBJ2-1,CASSSLTSGRLNEQFF,0,1,1,1
TRBV5-4,TRBJ1-2,CASSKKQEWAMAGYTF,0,1,1,1
TRBV7-9,TRBJ1-6,CASRPPWTEINSPLHF,0,1,1,1
TRBV6-1,TRBJ2-1,CASRDTGGRPYNEQFF,0,1,1,1
TRBV6-2/3/5/6,TRBJ2-2,CASRRTGGVDTGELFF,0,1,1,1
TRBV12-3/4,TRBJ2-6,CASRFYRVEGANVLTF,0,1,1,1
TRBV7-9,TRBJ2-1,CASRLGRTSGYNEQFF,0,1,1,1
TRBV6-2/3/5/6,TRBJ2-7,CASRLEGLGSSYEQYF,0,1,1,1
TRBV6-4,TRBJ1-1,CASRAPRVRLSTEAFF,0,1,1,1
TRBV11-1,TRBJ2-1,CASNTGQASSYNEQFF,0,1,1,1
TRBV7-2,TRBJ2-1,CASKERGGFAYNEQFF,0,1,1,1
TRBV6-2/3/5/6,TRBJ2-3,CTSSTGTGFLTDTQYF,0,1,1,1
TRBV4-3,TRBJ2-1,CASTSGQGSSYNEQFF,0,1,1,1
TRBV12-3/4,TRBJ2-5,CASSLAVGSGQETQYF,0,1,1,1
TRBV2,TRBJ2-3,CASSVETGWETDTQYF,0,1,1,1
TRBV5-1,TRBJ2-7,CASSFGLAGGYYEQYF,0,1,1,1
TRBV5-1,TRBJ2-3,CASSFTRGTGTDTQYF,0,1,1,1
TRBV5-1,TRBJ1-6,CASSLSNRDGNSPLHF,0,1,1,1
TRBV5-1,TRBJ2-2,CASSLGLAANTGELFF,0,1,1,1
TRBV5-1,TRBJ2-1,CASSSTGTGVGNEQFF,0,1,1,1
TRBV5-1,TRBJ2-1,CASSWRQGSSYNEQFF,0,1,1,1
TRBV4-3,TRBJ2-3,CASSLRAGRTLDTQYF,0,1,1,1
TRBV4-1,TRBJ1-5,CASSLGHRAFNQPQHF,0,1,1,1
TRBV4-3,TRBJ2-1,CASSPGTSGPYNEQFF,0,1,1,1
TRBV5-1,TRBJ1-4,CASSPLSPATNEKLFF,0,1,1,1
TRBV5-1,TRBJ2-1,CASSPAGLARGNEQFF,0,1,1,1
TRBV4-3,TRBJ1-1,CASSPDPTGPDPEAFF,0,1,1,1
TRBV4-3,TRBJ2-3,CASSPLEGGWTDTQYF,0,1,1,1
TRBV4-3,TRBJ2-3,CASSRSDTSSTDTQYF,0,1,1,1
TRBV4-1,TRBJ1-3,CASSRPPTGPGNTIYF,0,1,1,1
TRBV4-1,TRBJ2-5,CASSRDSGLGRETQYF,0,1,1,1
TRBV4-1,TRBJ1-1,CASSHLGTGRNTEAFF,0,1,1,1
TRBV4-3,TRBJ1-2,CASSHDFETENYGYTF,0,1,1,1
TRBV4-1,TRBJ1-3,CASSHSFVPSGNTIYF,0,1,1,1
TRBV4-1,TRBJ2-6,CASSQVRSSGANVLTF,0,1,1,1
TRBV4-1,TRBJ2-6,CASSQVDRAGANVLTF,0,1,1,1
TRBV4-3,TRBJ2-7,CASSQDWNGWSGEQYF,0,1,1,1
TRBV4-3,TRBJ2-6,CASSQDPASGANVLTF,0,1,1,1
TRBV4-3,TRBJ2-2,CASSQDVSGNTGELFF,0,1,1,1
TRBV4-3,TRBJ2-7,CASSQDATGPFYEQYF,0,1,1,1
TRBV4-3,TRBJ2-7,CASSQDSGLASDEQYF,0,1,1,1
TRBV4-3,TRBJ2-1,CASSQEFQYHSNEQFF,0,1,1,1
TRBV4-1,TRBJ1-2,CASSQEGGGPNYGYTF,0,1,1,1
TRBV4-3,TRBJ2-3,CASSQESGRRLDTQYF,0,1,1,1
TRBV5-1,TRBJ1-1,CASSTAARRGVNEAFF,0,1,1,1
TRBV5-1,TRBJ2-5,CASSRTGTGGQETQYF,0,1,1,1
TRBV5-1,TRBJ2-1,CASRRGLAGSSDEQFF,0,1,1,1
TRBV20-1,TRBJ1-6,CSASPRDGSYNSPLHF,0,1,1,1
TRBV20-1,TRBJ2-7,CSARVSRPLPSYEQYF,0,1,1,1
TRBV20-1,TRBJ2-7,CSARGLTSGDDYEQYF,0,1,1,1
TRBV20-1,TRBJ1-6,CSARGDGHPQIPPLHF,0,1,1,1
TRBV20-1,TRBJ2-3,CSARDSSGGSGDTQYF,0,1,1,1
TRBV20-1,TRBJ2-7,CSARDRTGIPPYEQYF,0,1,1,1
TRBV20-1,TRBJ2-3,CSARDEARVNTDTQYF,0,1,1,1
TRBV20-1,TRBJ2-7,CSARDHLAGDYYEQYF,0,1,1,1
TRBV20-1,TRBJ1-6,CSARDQDRVKNSPLHF,0,1,1,1
TRBV20-1,TRBJ2-6,CSALGAWDSGANVLTF,0,1,1,1
TRBV29-1,TRBJ2-1,CSVELAGAQPRREQFI,0,1,1,1
TRBV29-1,TRBJ2-1,CSVEGLAGRSYNEQFF,0,1,1,1
TRBV29-1,TRBJ2-1,CSVEGGGRTSYNEQFF,0,1,1,1
TRBV29-1,TRBJ1-2,CSVEDLGTGGLHGYTF,0,1,1,1
TRBV29-1,TRBJ2-3,CSVEDFSGPSTDTQYF,0,1,1,1
TRBV29-1,TRBJ2-1,CSVETWGGGSYNEQFF,0,1,1,1
TRBV29-1,TRBJ2-1,CSVGTSGGGRMSEQFF,0,1,1,1
TRBV29-1,TRBJ2-1,CSVVGARTGRSDEQFF,0,1,1,1
TRBV29-1,TRBJ2-1,CSVGTWEPELLNEQFF,0,1,1,1
TRBV29-1,TRBJ2-1,CSAVPLQRSSYNEQFF,0,1,1,1
TRBV29-1,TRBJ1-3,CSAAGTGGANGNTIYF,0,1,1,1
TRBV12-3/4,TRBJ1-2,RASSLSGRGGAHGYTF,0,1,1,1
TRBV4-2,TRBJ2-1,RASSQDKAGGPNEQFF,0,1,1,1
TRBV4-2,TRBJ2-2,RASSQETSVNTGELFF,0,1,1,1
TRBV30,TRBJ2-1,CVLRRAGSPHNEQFF,0,1,1,1
TRBV6-2/3/5/6,TRBJ2-1,CVSSYVGLAADEQFF,0,1,1,1
TRBV7-6,TRBJ2-1,CASSGLIVEDNEQFF,0,2,1,2
TRBV30,TRBJ2-1,CAWHPSGRARNEQFF,0,1,1,1
TRBV30,TRBJ1-6,CAWSVLGQGALPLHF,0,1,1,1
TRBV15,TRBJ1-4,CAVPLGDATNEKLFF,0,1,1,1
TRBV30,TRBJ2-5,CAGHLSGRAGETQYF,0,1,1,1
TRBV10-3,TRBJ2-7,CAISDLAGSVYEQYF,0,1,1,1
TRBV10-3,TRBJ1-3,CAISESRRAGNTIYF,0,1,1,1
TRBV10-3,TRBJ1-1,CAISETDRRNTEAFF,0,1,1,1
TRBV19,TRBJ2-2,CATCGTTFNTGELFF,0,1,1,1
TRBV10-3,TRBJ1-5,CATQGGGDSNQPQHF,0,1,1,1
TRBV15,TRBJ1-5,CATSQNRVNNQPQHF,0,1,1,1
TRBV24-1,TRBJ2-1,CATSGGQASYNEQFF,0,1,1,1
TRBV24-1,TRBJ2-1,CATSDTGGSYNEQFF,0,1,1,1
TRBV15,TRBJ2-2,CATSSRLANTGELFF,0,1,1,1
TRBV15,TRBJ2-5,CATSRGTGTGETQYF,0,1,1,1
TRBV15,TRBJ2-2,CATSRPTGNTGELFF,0,1,1,1
TRBV15,TRBJ2-5,CATSRVGSDQETQYF,0,1,1,1
TRBV15,TRBJ1-1,CATSRVPPRDTEAFF,0,1,1,1
TRBV15,TRBJ2-1,CATSRVTGGYNEQFF,0,1,1,1
TRBV15,TRBJ1-1,CATSRGKGLNTGAFF,0,1,1,1
TRBV15,TRBJ1-2,CATSRDSRTDVGYTF,0,1,1,1
TRBV15,TRBJ2-1,CATSRDGGEVSEQFF,0,1,1,1
TRBV15,TRBJ2-7,CATSRDKTGDYEQYF,0,1,1,1
TRBV19,TRBJ1-5,CASLQSGTGNQPQHF,0,1,1,1
TRBV7-9,TRBJ2-5,CASAPRATAIETQYF,0,1,1,1
TRBV19,TRBJ1-5,CASTYSGHSNQPQHF,0,1,1,1
TRBV19,TRBJ2-7,CASTKGSASSYEQYF,0,1,1,1
TRBV19,TRBJ2-1,CASSSGSYPNDEQFF,0,1,1,1
TRBV19,TRBJ1-1,CASSHAGTVNTEAFF,0,1,1,1
TRBV19,TRBJ1-1,CASSDRDRVTQGAFF,0,1,1,1
TRBV19,TRBJ2-5,CASSIDGKGEETQYF,0,1,1,1
TRBV19,TRBJ2-1,CASSIETGGLVEQFF,0,1,1,1
TRBV19,TRBJ1-1,CASSIMGVEDTEAFF,0,1,1,1
TRBV19,TRBJ1-2,CASSIKGRDRGRYTF,0,1,1,1
TRBV19,TRBJ2-7,CASSTGTSGQYEQYF,0,1,1,1
TRBV19,TRBJ1-1,CASSSLRQGRAEAFF,0,1,1,1
TRBV19,TRBJ2-2,CASRRTDDFTGELFF,0,1,1,1
TRBV12-3/4,TRBJ1-6,CASSARQGYNSPLHF,0,1,1,1
TRBV6-2/3/5/6,TRBJ2-5,CASSWGAVRQETQYF,0,1,1,1
TRBV18,TRBJ2-3,CASSPATGGTDTQYF,0,1,1,1
TRBV18,TRBJ2-1,CASSPDRGSYNEQFF,0,1,1,1
TRBV18,TRBJ2-7,CASSPSGYGSYEQYF,0,1,1,1
TRBV11-2,TRBJ2-7,CASCLSPLRGQEQYF,0,1,1,1
TRBV19,TRBJ1-2,CASHKGRTGDYGYTF,0,1,1,1
TRBV7-9,TRBJ2-1,CASGLRASVYNEQFF,0,1,1,1
TRBV2,TRBJ2-3,CASGLAVTSTDTQYF,0,1,1,1
TRBV12-3/4,TRBJ1-3,CASISRGVLGNTIYF,0,1,1,1
TRBV7-8,TRBJ1-6,CASTYLQIYNSPLHF,0,1,1,1
TRBV6-2/3/5/6,TRBJ2-1,CASTLRLAGTNEQFF,0,1,1,1
TRBV9,TRBJ2-1,CASTTGTSSYNEQFF,0,1,1,1
TRBV12-3/4,TRBJ2-5,CASTKGMGSRETQYF,0,1,1,1
TRBV9,TRBJ2-3,CASTVGGGATDTQYF,0,1,1,1
TRBV12-3/4,TRBJ2-1,CASSFYGGGDNEQFF,0,1,1,1
TRBV12-3/4,TRBJ1-2,CASSFPGTPGQGYTF,0,1,1,1
TRBV12-3/4,TRBJ2-2,CASSFVPREFGELFF,0,1,1,1
TRBV12-3/4,TRBJ1-1,CASSFVDTGRPEAFF,0,1,1,1
TRBV6-2/3/5/6,TRBJ1-2,CASSFAGGEGYGYTF,0,1,1,1
TRBV6-2/3/5/6,TRBJ2-3,CASSFGTVSTDTQYF,0,1,1,1
TRBV12-3/4,TRBJ1-2,CASSFEGTGVNGYTF,0,1,1,1
TRBV12-3/4,TRBJ2-5,CASSFNLRGRQTQYF,0,1,1,1
TRBV12-3/4,TRBJ2-1,CASSFKGDSQVEQFF,0,1,1,1
TRBV6-2/3/5/6,TRBJ1-1,CASSFQGIMNTEAFF,0,1,1,1
TRBV6-2/3/5/6,TRBJ2-1,CASSLSLLAWNEQFF,0,1,1,1
TRBV12-3/4,TRBJ2-2,CASSLRRVNTGELFF,0,1,1,1
TRBV27,TRBJ2-6,CASSLEFSGANVLTF,0,1,1,1
TRBV6-2/3/5/6,TRBJ2-1,CASSLSGGQLHEQFF,0,1,1,1
TRBV27,TRBJ1-2,CASSLVAGGGYGYTF,0,1,1,1
TRBV12-3/4,TRBJ2-7,CASSLADFEGGEQYF,0,1,1,1
TRBV27,TRBJ2-1,CASSLAGAGYNEQFF,0,1,1,1
TRBV6-2/3/5/6,TRBJ2-5,CASSLGLAGAETQYF,0,1,1,1
TRBV12-3/4,TRBJ1-5,CASSLGAGDDQPQHF,0,1,1,1
TRBV12-3/4,TRBJ2-1,CASSLGGGPYNEQFF,0,1,1,1
TRBV13,TRBJ1-5,CASSLGGRTNQPQHF,0,1,1,1
TRBV6-2/3/5/6,TRBJ1-1,CASSLITGRAAEAFF,0,1,1,1
TRBV6-2/3/5/6,TRBJ2-3,CASSSGRGDTDTQYF,0,1,1,1
TRBV12-3/4,TRBJ2-1,CASSWVASGYNEQFF,0,1,1,1
TRBV6-2/3/5/6,TRBJ2-1,CASSYSWVGYNEQFF,0,1,1,1
TRBV12-3/4,TRBJ2-6,CASSYQGTGANVLTF,0,1,1,1
TRBV6-2/3/5/6,TRBJ2-3,CASSYAGEETDTQYF,0,1,1,1
TRBV6-2/3/5/6,TRBJ1-5,CASSYSNRELQPQHF,0,1,1,1
TRBV6-2/3/5/6,TRBJ1-1,CASSYSSGGVDEAFF,0,1,1,1
TRBV6-2/3/5/6,TRBJ1-5,CASSYSRGSNQPQHF,0,1,1,1
TRBV6-2/3/5/6,TRBJ1-1,CASSYPGQGNTEAFF,0,1,1,1
TRBV6-2/3/5/6,TRBJ2-7,CASSYRRQVGYEQYF,0,1,1,1
TRBV6-2/3/5/6,TRBJ2-7,CASSYRTGERNEQYF,0,1,1,1
TRBV28,TRBJ2-1,CASSYGRNSYNEQFF,0,1,1,1
TRBV6-2/3/5/6,TRBJ2-7,CASSYTNEPRDEQYF,0,1,1,1
TRBV6-2/3/5/6,TRBJ2-7,CASSYSAGTFYEQYF,0,1,1,1
TRBV6-2/3/5/6,TRBJ2-1,CASSYSGSGHNEQFF,0,1,1,1
TRBV5-4,TRBJ2-6,CASSLGGSGANVLTF,0,1,1,1
TRBV2,TRBJ1-2,CASSLTTRVTRGYTF,0,1,1,1
TRBV2,TRBJ2-1,CASSLASGSYNEQFF,0,1,1,1
TRBV12-3/4,TRBJ2-1,CASSPPTGSYNEQFF,0,1,1,1
TRBV28,TRBJ2-1,CASSPSRGRGNEQFF,0,1,1,1
TRBV7-9,TRBJ1-5,CASSPGTGSNQPQHF,0,1,1,1
TRBV6-2/3/5/6,TRBJ2-1,CASSRRDPPRNEQFF,0,1,1,1
TRBV12-3/4,TRBJ2-3,CASSRRTAGTDTQYF,0,1,1,1
TRBV27,TRBJ1-5,CASSHLGTWNQPQHF,0,1,1,1
TRBV6-1,TRBJ1-1,CASSQMTGVNTEAFF,0,1,1,1
TRBV6-1,TRBJ2-1,CASSAGTSVYNEQFF,0,1,1,1
TRBV28,TRBJ2-7,CASSGRGGDTVEQYF,0,1,1,1
TRBV6-1,TRBJ2-7,CASSGETPYSYEQYF,0,1,1,1
TRBV2,TRBJ2-7,CASSGTDRPPYEQYF,0,1,1,1
TRBV6-4,TRBJ1-6,CASSDSWRGGSPLHF,0,1,1,1
TRBV6-4,TRBJ2-1,CASSDSAGEYNEQFF,0,1,1,1
TRBV6-1,TRBJ2-5,CASSELLLRGETQYF,0,1,1,1
TRBV25-1,TRBJ1-1,CASSESGPRGTEAFF,0,1,1,1
TRBV6-1,TRBJ2-5,CASSEPGAGWETQYF,0,1,1,1
TRBV2,TRBJ2-1,CASSEDLSSYNEQFF,0,1,1,1
TRBV5-5,TRBJ1-6,CASSFSAQNNSPLHF,0,1,1,1
TRBV7-9,TRBJ2-2,CASSFLLGEGGELFF,0,1,1,1
TRBV3-1,TRBJ1-2,CASSFPGQGPFGYTF,0,1,1,1
TRBV6-2/3/5/6,TRBJ2-3,CASSFHSGSEDTQCF,0,1,1,1
TRBV5-4,TRBJ2-7,CASSFGRAGGYEQYF,0,1,1,1
TRBV5-5,TRBJ2-7,CASSFRQGGISEQYF,0,1,1,1
TRBV7-9,TRBJ2-1,CASSFGRGASDEQFF,0,1,1,1
TRBV7-9,TRBJ2-5,CASSFGQGYQETQYF,0,1,1,1
TRBV7-8,TRBJ2-5,CASSFGRGDQETQYF,0,1,1,1
TRBV7-2,TRBJ2-1,CASSFGLAGRGEQFF,0,1,1,1
TRBV7-9,TRBJ2-1,CASSFDRAYYNEQFF,0,1,1,1
TRBV5-6,TRBJ2-7,CASSFETWGPYEQYF,0,1,1,1
TRBV7-3,TRBJ2-2,CASSFRRDHTGELFF,0,1,1,1
TRBV7-2,TRBJ2-5,CASSLLDLYKETQYF,0,1,1,1
TRBV5-8,TRBJ2-5,CASSLSGVSRETQYF,0,1,1,1
TRBV7-7,TRBJ2-3,CASSLAGGPTDTQYF,0,1,1,1
TRBV7-9,TRBJ2-1,CASSLGQQGTHEQFF,0,1,1,1
TRBV5-4,TRBJ2-7,CASSLGGLGDDEQYF,0,1,1,1
TRBV7-9,TRBJ2-4,CASSLGDRGSSIQYF,0,1,1,1
TRBV7-2,TRBJ1-6,CASSLGRSSNSPLHF,0,1,1,1
TRBV5-4,TRBJ2-1,CASSLDRGGYNEQFF,0,1,1,1
TRBV11-1,TRBJ2-3,CASSLELAGADTQYF,0,1,1,1
TRBV5-6,TRBJ2-1,CASSLTEGAHNEQFF,0,1,1,1
TRBV5-6,TRBJ1-1,CASSLRVGVNTEAFF,0,1,1,1
TRBV7-9,TRBJ2-2,CASSLKNRHTGELFF,0,1,1,1
TRBV7-2,TRBJ2-1,CASSLSESSYNEQFF,0,1,1,1
TRBV7-2,TRBJ2-4,CASSLSGGPPNIQYF,0,1,1,1
TRBV7-2,TRBJ2-1,CASSLRLAGGNEQFF,0,1,1,1
TRBV7-2,TRBJ2-7,CASSLVWRNPDEQYF,0,1,1,1
TRBV7-8,TRBJ1-1,CASSLVRGGSPEAFF,0,1,1,1
TRBV7-9,TRBJ1-6,CASSLVGGWNSPLHF,0,1,1,1
TRBV11-2,TRBJ1-2,CASSLVGDRADGYTF,0,1,1,1
TRBV7-9,TRBJ1-2,CASSLVAGDKSGYTF,0,1,1,1
TRBV7-9,TRBJ2-7,CASSLVGSLTGEQYF,0,1,1,1
TRBV11-2,TRBJ1-1,CASSLVDIPNTEAFF,0,1,1,1
TRBV11-1,TRBJ2-3,CASSLAYAYTDTQYF,0,1,1,1
TRBV7-9,TRBJ1-2,CASSLAQTGGYGYTF,0,1,1,1
TRBV7-2,TRBJ2-7,CASSLATSDSYEQYF,0,1,1,1
TRBV7-2,TRBJ1-5,CASSLARTPYQPQHF,0,1,1,1
TRBV7-9,TRBJ2-3,CASSLAGTNSDTQYF,0,1,1,1
TRBV7-6,TRBJ2-3,CASSLATGRTDTQYF,0,1,1,1
TRBV13,TRBJ1-6,CASSLGSVARSPLHF,0,1,1,1
TRBV7-9,TRBJ1-1,CASSLGPIGGAEAFF,0,1,1,1
TRBV13,TRBJ2-7,CASSLGPGLQDEQYF,0,1,1,1
TRBV7-9,TRBJ2-7,CASSLGSFGASEQYF,0,1,1,1
TRBV7-9,TRBJ2-7,CASSLGLAGGREQYF,0,1,1,1
TRBV7-9,TRBJ2-1,CASSLGGRPYNEQFF,0,1,1,1
TRBV7-2,TRBJ2-7,CASSLDYGTAYEQYF,0,1,1,1
TRBV7-3,TRBJ2-2,CASSLEGISTGELFF,0,1,1,1
TRBV7-9,TRBJ2-2,CASSLEGISTGELFS,0,1,1,1
TRBV7-3,TRBJ2-1,CASSLEGSSYNEQFF,0,1,1,1
TRBV7-2,TRBJ2-7,CASSLICGPSYEQYF,0,1,1,1
TRBV7-3,TRBJ2-7,CASSLTAGREHEQYF,0,1,1,1
TRBV11-2,TRBJ2-1,CASSLREDSYNEQFF,0,1,1,1
TRBV7-9,TRBJ2-5,CASSLKLAGQETQYF,0,1,1,1
TRBV7-8,TRBJ1-5,CASSSPAGANQPQHF,0,1,1,1
TRBV7-9,TRBJ2-1,CASSSGENSYNEQFF,0,1,1,1
TRBV11-1,TRBJ2-7,CASSYPGQGYYEQYF,0,1,1,1
TRBV7-8,TRBJ1-1,CASSYQGDMNTEAFF,0,1,1,1
TRBV7-8,TRBJ2-7,CASSLNRDKTNEQYF,0,1,1,1
TRBV6-2/3/5/6,TRBJ1-5,CASSLGTGASQPQHF,0,1,1,1
TRBV11-1,TRBJ2-1,CASSLGLSSYNEQFF,0,1,1,1
TRBV5-6,TRBJ2-3,CASSLDFPHSDTQYF,0,1,1,1
TRBV7-9,TRBJ2-1,CASSLTSGYYNEQFF,0,1,1,1
TRBV6-2/3/5/6,TRBJ2-4,CASSLTGLAKNIQYF,0,1,1,1
TRBV7-9,TRBJ2-5,CASSLQSGGSETQYF,0,1,1,1
TRBV6-2/3/5/6,TRBJ1-1,CASSLARIMNTEAFF,0,1,1,1
TRBV14,TRBJ2-6,CASSPSWALSNVLTF,0,1,1,1
TRBV3-1,TRBJ2-1,CASSPSASGVDEQFF,0,1,1,1
TRBV12-3/4,TRBJ2-1,CASSPHSGTYNEQFF,0,1,1,1
TRBV5-5,TRBJ2-1,CASSPATGGYNEQFF,0,1,1,1
TRBV6-2/3/5/6,TRBJ2-7,CASSPTGGASYEQYF,0,1,1,1
TRBV7-9,TRBJ2-3,CASSPWDPPADTQYF,0,1,1,1
TRBV14,TRBJ1-5,CASSPWTGSNQPQHF,0,1,1,1
TRBV7-9,TRBJ1-6,CASSPLGSYNSPLHF,0,1,1,1
TRBV3-1,TRBJ2-3,CASSPRDRGGDTQYF,0,1,1,1
TRBV7-9,TRBJ2-1,CASSPAVGPYNEQFF,0,1,1,1
TRBV6-2/3/5/6,TRBJ2-7,CASSPGLAGPYEQYF,0,1,1,1
TRBV14,TRBJ2-5,CASSPGLAGVETQYF,0,1,1,1
TRBV7-3,TRBJ2-1,CASSPGLAGGLEQFF,0,1,1,1
TRBV11-3,TRBJ2-3,CASSPGRTETDTQYF,0,1,1,1
TRBV7-9,TRBJ1-3,CASSPTTPSGNTIYF,0,1,1,1
TRBV9,TRBJ2-1,CASSPSTGSYSEQFF,0,1,1,1
TRBV7-8,TRBJ1-5,CASSPRFAQAKNQHF,0,1,1,1
TRBV7-6,TRBJ2-1,CASSPLAGVQNEQFF,0,1,1,1
TRBV14,TRBJ2-7,CASSPRTGGEDEQYF,0,1,1,1
TRBV7-9,TRBJ2-6,CASSPGQSGANVLTF,0,1,1,1
TRBV13,TRBJ2-1,CASSPGGGRRDEQFF,0,1,1,1
TRBV5-6,TRBJ2-1,CASSPGLLNYNEQFF,0,1,1,1
TRBV3-1,TRBJ2-7,CASSPGQGVDYEQYF,0,1,1,1
TRBV11-3,TRBJ1-1,CASSPGGDSNTEAFF,0,1,1,1
TRBV5-6,TRBJ1-2,CASSPDRFFNYGYTF,0,1,1,1
TRBV3-1,TRBJ2-3,CASSPVGVNTDTQYF,0,1,1,1
TRBV7-9,TRBJ2-6,CASSPGSFGANVLTF,0,1,1,1
TRBV14,TRBJ1-2,CASSRYTGGNYGYTF,0,1,1,1
TRBV7-2,TRBJ2-7,CASSRRGQGAYEQYF,0,1,1,1
TRBV6-2/3/5/6,TRBJ2-2,CASSRGTSVAGELFF,0,1,1,1
TRBV5-8,TRBJ2-3,CASSRYGAHTDTQYF,0,1,1,1
TRBV11-2,TRBJ2-1,CASSRQGGPYNEQFF,0,1,1,1
TRBV7-9,TRBJ2-7,CASSRPGQGFYEQYF,0,1,1,1
TRBV3-1,TRBJ2-1,CASSHLAGIYNEQFF,0,1,1,1
TRBV6-2/3/5/6,TRBJ2-2,CASSHRTRSPGELFF,0,1,1,1
TRBV4-2,TRBJ2-1,CASSQSGGFYNEQFF,0,1,1,1
TRBV4-2,TRBJ2-1,CASSQGLASSNEQFF,0,1,1,1
TRBV4-2,TRBJ2-1,CASSQETSAGAQQFF,0,1,1,1
TRBV3-1,TRBJ1-3,CASSQTDGGLNTIYF,0,1,1,1
TRBV3-1,TRBJ2-1,CASSQREFPNNEQLF,0,1,1,1
TRBV5-6,TRBJ2-5,CASSQVGQGVGAQYF,0,1,1,1
TRBV7-3,TRBJ2-5,CASSQVRGGKETQYF,0,1,1,1
TRBV3-1,TRBJ2-7,CASSQARANSYEQYF,0,1,1,1
TRBV3-1,TRBJ2-5,CASSQAGRAWETQYF,0,1,1,1
TRBV3-1,TRBJ2-1,CASSQGAGPHNEQFF,0,1,1,1
TRBV3-1,TRBJ2-7,CASSQGRDSYYEQYF,0,1,1,1
TRBV6-2/3/5/6,TRBJ2-7,CASSQGWGDSYEQYF,0,1,1,1
TRBV4-2,TRBJ1-1,CASSQGLDGNTEAFF,0,1,1,1
TRBV3-1,TRBJ1-5,CASSQDLGGNQPQHF,0,1,1,1
TRBV14,TRBJ2-5,CASSQDWTVQETQYF,0,1,1,1
TRBV3-1,TRBJ1-5,CASSQDARVDQPQHF,0,1,1,1
TRBV3-1,TRBJ2-1,CASSQDMGEGDEQFF,0,1,1,1
TRBV4-2,TRBJ1-1,CASSQEGEENTQAFF,0,1,1,1
TRBV3-1,TRBJ1-4,CASSQKQVANEKLFF,0,1,1,1
TRBV5-4,TRBJ1-3,CASSVTGTGGNTIYF,0,1,1,1
TRBV7-2,TRBJ2-1,CASSVLSGLYNEQFF,0,1,1,1
TRBV7-2,TRBJ2-1,CASSVRLAGGNEQFF,0,1,1,1
TRBV9,TRBJ2-1,CASSVVAGAYNEQFF,0,1,1,1
TRBV9,TRBJ1-4,CASSVGGRNNEKLFF,0,1,1,1
TRBV9,TRBJ1-2,CASSVDPGTNYGYTF,0,1,1,1
TRBV9,TRBJ1-5,CASSVEGGGNQPQHF,0,1,1,1
TRBV11-2,TRBJ1-1,CASSVTQGAFTEAFF,0,1,1,1
TRBV7-6,TRBJ2-1,CASSALAGEWNEQFF,0,1,1,1
TRBV6-2/3/5/6,TRBJ2-7,CASSAGLADSYEQYF,0,1,1,1
TRBV7-2,TRBJ2-5,CASSAGQPWQETQYF,0,1,1,1
TRBV7-2,TRBJ1-2,CASSAGQGANYGYTF,0,1,1,1
TRBV12-3/4,TRBJ1-1,CASSADPQGNTEAFF,0,1,1,1
TRBV11-1,TRBJ2-7,CASSAEGSSGYEQYF,0,1,1,1
TRBV7-9,TRBJ2-7,CASSGSSGGPPEQYF,0,1,1,1
TRBV7-2,TRBJ2-1,CASSGQRGGVNGQFF,0,1,1,1
TRBV7-2,TRBJ2-4,CASSGTSGRENIQYF,0,1,1,1
TRBV12-3/4,TRBJ2-3,CASSDRANRADTQYF,0,1,1,1
TRBV7-6,TRBJ1-4,CASSMNRRLSEKLFF,0,1,1,1
TRBV6-2/3/5/6,TRBJ2-1,CASSIAGGRYNEQFF,0,1,1,1
TRBV12-3/4,TRBJ2-7,CASSRPGTGYDEQYF,0,1,1,1
TRBV9,TRBJ2-7,CASSRRTGTEYEQYF,0,1,1,1
TRBV7-2,TRBJ2-5,CASSNQKTGEETQYF,0,1,1,1
TRBV12-3/4,TRBJ2-5,CASSNDRDPQETQYF,0,1,1,1
TRBV7-3,TRBJ2-1,CASRVSGSSYNEQFF,0,1,1,1
TRBV7-2,TRBJ2-7,CASRAGQNIGYEQYF,0,1,1,1
TRBV2,TRBJ2-3,CASRDLAGGTDTQYF,0,1,1,1
TRBV6-4,TRBJ2-5,CASRTTGVNLETQYF,0,1,1,1
TRBV7-3,TRBJ2-1,CASRLSGSSYNEQFF,0,1,1,1
TRBV7-2,TRBJ1-1,CASRSSPGQGIEAFF,0,1,1,1
TRBV2,TRBJ2-3,CASRLGLALRDTQYF,0,1,1,1
TRBV5-6,TRBJ2-2,CASRPGTGGTGELFF,0,1,1,1
TRBV7-9,TRBJ1-3,CASRPDTSSGNTIYF,0,1,1,1
TRBV7-9,TRBJ1-3,CASRAQGYSGNTIYF,0,1,1,1
TRBV2,TRBJ1-6,CASRGSGHNNSPLHF,0,1,1,1
TRBV12-3/4,TRBJ2-1,CASRTGTSGANEQFF,0,1,1,1
TRBV7-2,TRBJ2-2,CASNYNQGGTGELFF,0,1,1,1
TRBV6-2/3/5/6,TRBJ1-5,CASNPGGGGNQPQHF,0,1,1,1
TRBV2,TRBJ1-5,CASKGTTGSNQPQHF,0,1,1,1
TRBV6-2/3/5/6,TRBJ2-7,CASKITVDGSYEQYF,0,1,1,1
TRBV7-3,TRBJ2-1,CTSRQSGSIYNEQFF,0,1,1,1
TRBV4-3,TRBJ2-1,CASSRGTSGPNEQFF,0,1,1,1
TRBV5-1,TRBJ2-1,CASEAVAGSYNEQFF,0,1,1,1
TRBV5-1,TRBJ1-1,CASTGGTSRNTEAFF,0,1,1,1
TRBV4-1,TRBJ2-1,CASTPGTGDYNEQFF,0,1,1,1
TRBV5-1,TRBJ2-1,CASSPGESSYNEQFF,0,1,1,1
TRBV12-3/4,TRBJ2-2,CASSPTGGFAGELFF,0,1,1,1
TRBV10-2,TRBJ1-2,CASSEFRTDVYGYTF,0,1,1,1
TRBV5-1,TRBJ2-7,CASSFSGLLPYEQYF,0,1,1,1
TRBV5-1,TRBJ2-1,CASSFTGTGPVLQFF,0,1,1,1
TRBV5-1,TRBJ2-3,CASSLWSGSTDTQYL,0,1,1,1
TRBV5-1,TRBJ2-5,CASSLASGKQETQYF,0,1,1,1
TRBV5-1,TRBJ1-5,CASSLGTVGNQPQHF,0,1,1,1
TRBV5-1,TRBJ2-3,CASSLDTGRADTQYF,0,1,1,1
TRBV5-1,TRBJ1-1,CASSLDRERNTEAFF,0,1,1,1
TRBV5-1,TRBJ1-1,CASSLEGTLNTEAFF,0,1,1,1
TRBV5-1,TRBJ2-5,CASSLIAGAQETQYF,0,1,1,1
TRBV5-1,TRBJ1-2,CASSLSAGANYGYTF,0,1,1,1
TRBV5-1,TRBJ2-3,CASSLQGAGTDTQYF,0,1,1,1
TRBV5-1,TRBJ1-2,CASSWATGYDYGYTF,0,1,1,1
TRBV5-1,TRBJ2-1,CASSWTSGSGREQFF,0,1,1,1
TRBV5-1,TRBJ1-5,CASSWTTGDHQPQHF,0,1,1,1
TRBV5-1,TRBJ2-3,CASSWTGVFTDTQYF,0,1,1,1
TRBV4-1,TRBJ1-1,CASSYPGQGSAEAFF,0,1,1,1
TRBV4-1,TRBJ1-1,CASSPRTFLDTEAFF,0,1,1,1
TRBV5-1,TRBJ2-1,CASSPQEGSYNEQFF,0,1,1,1
TRBV4-1,TRBJ1-5,CASSPGQHSNQPQHF,0,1,1,1
TRBV5-1,TRBJ2-1,CASSPGGVGYNEQFF,0,1,1,1
TRBV4-3,TRBJ2-1,CASSPMGLADNEQFF,0,1,1,1
TRBV5-1,TRBJ2-5,CASSRYPTEQETQYF,0,1,1,1
TRBV4-3,TRBJ2-7,CASSHIGTSGNEQYF,0,1,1,1
TRBV4-1,TRBJ2-7,CASSHDLQDSNEQHF,0,1,1,1
TRBV4-1,TRBJ2-7,CASSHNSGGPYEQYF,0,1,1,1
TRBV4-3,TRBJ1-1,CASSQYNGGNTEAFF,0,1,1,1
TRBV4-3,TRBJ2-1,CASSQVGTSGNEQFF,0,1,1,1
TRBV4-1,TRBJ2-1,CASSQVQHSANEQFF,0,1,1,1
TRBV4-1,TRBJ2-1,CASSQAQTSGSEQFF,0,1,1,1
TRBV4-3,TRBJ2-1,CASSQGTASYNEQFF,0,1,1,1
TRBV4-1,TRBJ1-2,CASSQGRIQDYGYTF,0,1,1,1
TRBV4-1,TRBJ1-5,CASSQGPGGNQPQHF,0,1,1,1
TRBV4-3,TRBJ1-2,CASSQGVGRPYGYTF,0,1,1,1
TRBV4-3,TRBJ2-5,CASSQDLAPPQTQYF,0,1,1,1
TRBV4-1,TRBJ2-5,CASSQDVGVSETQYF,0,1,1,1
TRBV4-3,TRBJ1-2,CASSQDGTGDYGYTF,0,1,1,1
TRBV4-3,TRBJ1-2,CASSQDRTGAFGYTF,0,1,1,1
TRBV4-3,TRBJ1-1,CASSQDKQMNTEAFF,0,1,1,1
TRBV4-3,TRBJ2-3,CASSQDRLSTDTQYF,0,1,1,1
TRBV4-1,TRBJ2-2,CASSQESGGTGELFF,0,1,1,1
TRBV5-1,TRBJ2-1,CASSVVAGLDNEQFF,0,1,1,1
TRBV4-1,TRBJ2-3,CASSTRRGVPDTQYF,0,1,1,1
TRBV4-1,TRBJ1-3,CASRVEGSSGNTIYF,0,1,1,1
TRBV5-1,TRBJ2-3,CASRAGPTMTDTQYF,0,1,1,1
TRBV4-1,TRBJ2-5,CASRELAGGRETQYF,0,1,1,1
TRBV5-1,TRBJ2-5,CASRPGQSTGETQYF,0,1,1,1
TRBV4-1,TRBJ2-6,CASRQYNSGANVLTF,0,1,1,1
TRBV20-1,TRBJ2-1,CSVVWWGGAYNEQFF,0,1,1,1
TRBV20-1,TRBJ2-3,CSAFREAFLTDTQYF,0,1,1,1
TRBV20-1,TRBJ2-1,CSAAPLAGVYNEQFF,0,1,1,1
TRBV20-1,TRBJ2-1,CSAGVAGVAYNEQFL,0,1,1,1
TRBV20-1,TRBJ1-5,CSAEGGAVGNQPQHF,0,1,1,1
TRBV20-1,TRBJ2-1,CSATPGESAYSEQFF,0,1,1,1
TRBV20-1,TRBJ1-5,CSATPGQGSNQPQHF,0,1,1,1
TRBV20-1,TRBJ1-1,CSASAPGHQNTEAFF,0,1,1,1
TRBV20-1,TRBJ2-2,CSARVVGDDTGELFF,0,1,1,1
TRBV20-1,TRBJ1-4,CSARASDRFNEKLVF,0,1,1,1
TRBV20-1,TRBJ2-5,CSARGKLAGGRTQYF,0,1,1,1
TRBV20-1,TRBJ2-3,CSARLAGRRKDTQYF,0,1,1,1
TRBV20-1,TRBJ2-1,CSARDLLAVYNEQFF,0,1,1,1
TRBV20-1,TRBJ2-5,CSARDLASGQETQYF,0,1,1,1
TRBV20-1,TRBJ1-5,CSARDRMWGNQPQHF,0,1,1,1
TRBV20-1,TRBJ2-7,CSARDGREDSYEQYF,0,1,1,1
TRBV20-1,TRBJ2-3,CSAREGGTSTDTQYF,0,1,1,1
TRBV20-1,TRBJ1-2,CSAKNRDRAINGYTF,0,1,1,1
TRBV20-1,TRBJ2-7,CSALQRAFLNYEQYF,0,1,1,1
TRBV20-1,TRBJ2-3,CSAQGLAGSTDTQYF,0,1,1,1
TRBV20-1,TRBJ2-1,CSAGLAGGLYNEQFF,0,1,1,1
TRBV20-1,TRBJ2-1,CSAIPPLGRGDEQFF,0,1,1,1
TRBV20-1,TRBJ2-3,CSATHGQGARDTQYF,0,1,1,1
TRBV20-1,TRBJ2-1,CSAIPGTSGGNEQFF,0,1,1,1
TRBV20-1,TRBJ2-7,CSAKDPRTGPYEQYF,0,1,1,1
TRBV29-1,TRBJ2-5,CSLRRRGITGETQYF,0,1,1,1
TRBV29-1,TRBJ2-7,CSVAPRENSPYEQYF,0,1,1,1
TRBV29-1,TRBJ2-3,CSVGISGGGPDTQYF,0,1,1,1
TRBV29-1,TRBJ2-7,CSVEVPSGTTYEQYF,0,1,1,1
TRBV29-1,TRBJ2-7,CSVEVASGSSYEQYF,0,1,1,1
TRBV29-1,TRBJ1-4,CSVEAGGAFNEKLFF,0,1,1,1
TRBV29-1,TRBJ2-7,CSVEGSLASPYEQYF,0,1,1,1
TRBV29-1,TRBJ2-3,CSVEGGAGGTDTQYF,0,1,1,1
TRBV29-1,TRBJ2-2,CSVEDLDRVTGELFF,0,1,1,1
TRBV29-1,TRBJ2-1,CSVGGGYTMGDEQFF,0,1,1,1
TRBV29-1,TRBJ1-5,CSVLDRGASNQPQHF,0,1,1,1
TRBV29-1,TRBJ2-1,CSVRTSGRARDEQFF,0,1,1,1
TRBV29-1,TRBJ1-2,CSAGTGLGTNYGYTF,0,1,1,1
TRBV29-1,TRBJ2-7,CSGSGGAGLFDEQYF,0,1,1,1
TRBV7-2,TRBJ1-2,WASSPSTRGAGRYTF,0,1,1,1
TRBV4-3,TRBJ1-2,YASSQDLGGSYGYTF,0,1,1,1
TRBV20-1,TRBJ2-5,YSAFPSAGPRETQYF,0,1,1,1
TRBV9,TRBJ2-3,RASSVGLIRTDTQYF,0,1,1,1
TRBV11-1,TRBJ2-1,RASSIGAEDYNEQFF,0,1,1,1
TRBV12-5,TRBJ2-5,CASAPGLEKRTQYF,0,1,1,1
TRBV12-5,TRBJ2-3,CASGFPGPRDTQYF,0,1,1,1
TRBV30,TRBJ1-4,CAWAATVQLEKLFF,0,1,1,1
TRBV30,TRBJ2-2,CAWSYRGRGGELFF,0,1,1,1
TRBV30,TRBJ2-1,CAWSRLAGNNEQFF,0,1,1,1
TRBV30,TRBJ1-1,CAWSVLGGNTEAFF,0,1,1,1
TRBV30,TRBJ2-7,CAWSVQGGVYEQYF,0,1,1,1
TRBV30,TRBJ2-1,CAWSVVSSEVTQFF,0,1,1,1
TRBV30,TRBJ2-2,CAWSGIRYTGELFF,0,1,1,1
TRBV10-3,TRBJ1-2,CAISVGTPNYGYTF,0,1,1,1
TRBV10-3,TRBJ1-1,CAISASNKATEAFF,0,1,1,1
TRBV10-3,TRBJ2-7,CAISDRDRSYEQYF,0,1,1,1
TRBV10-3,TRBJ1-2,CAISEELTDYGYTF,0,1,1,1
TRBV10-3,TRBJ1-2,CAISETGARYGYTF,0,1,1,1
TRBV10-3,TRBJ1-1,CAISFRDHGTEAFF,0,1,1,1
TRBV10-3,TRBJ2-1,CAIRGLESYNEQFF,0,1,1,1
TRBV10-3,TRBJ2-5,CAIRPDRGGETQYF,0,1,1,1
TRBV10-3,TRBJ2-3,CAIRGTALGDTQYF,0,1,1,1
TRBV15,TRBJ2-1,CATLPSGSSGEQFF,0,1,1,1
TRBV10-3,TRBJ2-1,CATRDRGGVDEQFF,0,1,1,1
TRBV10-3,TRBJ2-5,CATAHRGLGETQYF,0,1,1,1
TRBV24-1,TRBJ2-1,CATSEAGGTDEQFF,0,1,1,1
TRBV15,TRBJ2-7,CATSRLAGAYEQYF,0,1,1,1
TRBV24-1,TRBJ2-3,CATSNAGQADTQYF,0,1,1,1
TRBV24-1,TRBJ2-5,CATSSRDPRETQYF,0,1,1,1
TRBV15,TRBJ1-1,CATSRDRGRDEAFF,0,1,1,1
TRBV12-3/4,TRBJ1-1,CATRHTRLNTEAFF,0,1,1,1
TRBV15,TRBJ2-1,CATKPGLEYNEQFF,0,1,1,1
TRBV2,TRBJ2-7,CATKERAISYEQYF,0,1,1,1
TRBV2,TRBJ2-7,CASQPRALTYEQYF,0,1,1,1
TRBV19,TRBJ1-1,CASSPFGPNTEAFF,0,1,1,1
TRBV19,TRBJ1-4,CASSPRTAFEELFF,0,1,1,1
TRBV19,TRBJ2-4,CASSVGVEVNIQYF,0,1,1,1
TRBV19,TRBJ2-1,CASSIRGQGGEQFF,0,1,1,1
TRBV19,TRBJ1-5,CASSTSDGFRPQHF,0,1,1,1
TRBV19,TRBJ2-5,CASSTWDSQETQYF,0,1,1,1
TRBV19,TRBJ1-5,CASSPGQGIQPQHF,0,1,1,1
TRBV19,TRBJ1-2,CASSPSWTNYGYTF,0,1,1,1
TRBV19,TRBJ2-7,CASSGYRGSYEQYF,0,1,1,1
TRBV19,TRBJ1-1,CASSTLPGGTEAFF,0,1,1,1
TRBV19,TRBJ2-1,CASRPIFRANVQFF,0,1,1,1
TRBV19,TRBJ2-4,CASKDIGDKNIQYF,0,1,1,1
TRBV13,TRBJ2-7,CASSPLGSLHEQYF,0,1,1,1
TRBV18,TRBJ2-3,CASSPVKNTDTQYF,0,1,1,1
TRBV18,TRBJ2-7,CASSPKTGPYEQYF,0,1,1,1
TRBV18,TRBJ1-1,CASSPGAAGAEAFF,0,1,1,1
TRBV18,TRBJ2-4,CASSPPHQGNIQYF,0,1,1,1
TRBV2,TRBJ2-2,CASWTTRNTGELFF,0,1,1,1
TRBV7-2,TRBJ2-3,CASLPGLASDTQYF,0,1,1,1
TRBV6-2/3/5/6,TRBJ1-5,CASVRDIVNQPQHF,0,1,1,1
TRBV27,TRBJ2-4,CASAPGQGGNIQYF,0,1,1,1
TRBV6-1,TRBJ2-3,CASGEGQGGDTQYF,0,1,1,1
TRBV5-4,TRBJ2-3,CASGRTGGTDTQYF,0,1,1,1
TRBV2,TRBJ1-5,CASGDGVSNQPQHF,0,1,1,1
TRBV12-3/4,TRBJ1-1,CASGPVGENTEAFF,0,1,1,1
TRBV12-3/4,TRBJ2-1,CASIPGGLNNEQFF,0,1,1,1
TRBV6-2/3/5/6,TRBJ2-2,CASIRAANTGELFF,0,1,1,1
TRBV6-2/3/5/6,TRBJ1-2,CASIRTGGNYGYTF,0,1,1,1
TRBV2,TRBJ1-1,CASIGRGLSTEAFF,0,1,1,1
TRBV6-2/3/5/6,TRBJ2-2,CASTRDGNTGELFF,0,1,1,1
TRBV12-3/4,TRBJ1-2,CASTISERGYGYTF,0,1,1,1
TRBV6-2/3/5/6,TRBJ2-1,CASTPRGVQNEQFF,0,1,1,1
TRBV12-3/4,TRBJ2-7,CASTRLAGYYEQYF,0,1,1,1
TRBV28,TRBJ1-5,CASTAPRGFGPQHF,0,1,1,1
TRBV28,TRBJ2-5,CASTGTARGETQYF,0,1,1,1
TRBV6-2/3/5/6,TRBJ2-7,CASSFSHKTYEQYF,0,1,1,1
TRBV12-3/4,TRBJ1-1,CASSFVSGGTEAFF,0,1,1,1
TRBV6-2/3/5/6,TRBJ2-3,CASSFGQYTDTQYF,0,1,1,1
TRBV6-2/3/5/6,TRBJ2-7,CASSFDAPAHEQYF,0,1,1,1
TRBV6-2/3/5/6,TRBJ2-1,CASSFFAGGNEQFF,0,1,1,1
TRBV6-2/3/5/6,TRBJ1-6,CASSFGGENSPLHF,0,1,1,1
TRBV6-2/3/5/6,TRBJ2-7,CASSLSPGPYEQYF,0,1,1,1
TRBV6-2/3/5/6,TRBJ2-5,CASSLRRIQETQYF,0,1,1,1
TRBV6-2/3/5/6,TRBJ2-4,CASSLQIAKNIQYF,0,1,1,1
TRBV12-3/4,TRBJ1-4,CASSLVTTNEKLFF,0,1,1,1
TRBV6-2/3/5/6,TRBJ2-1,CASSLVGLDNEQFF,0,1,1,1
TRBV12-3/4,TRBJ1-1,CASSLGQGDTEAFF,0,1,1,1
TRBV6-2/3/5/6,TRBJ2-1,CASSLGSGSNEQFF,0,1,1,1
TRBV6-2/3/5/6,TRBJ1-1,CASSLDSPNTEAFF,0,1,1,1
TRBV6-2/3/5/6,TRBJ2-7,CASSLTPRMNEQYF,0,1,1,1
TRBV12-3/4,TRBJ2-4,CASSLSRTGNIQYF,0,1,1,1
TRBV6-2/3/5/6,TRBJ1-6,CASSLRLYNSPLHF,0,1,1,1
TRBV12-3/4,TRBJ2-7,CASSLNGGAYEQYF,0,1,1,1
TRBV12-3/4,TRBJ2-7,CASSSGTGAYEQYF,0,1,1,1
TRBV6-2/3/5/6,TRBJ1-2,CASSSSAEGYGYTF,0,1,1,1
TRBV12-3/4,TRBJ2-1,CASSSYRGYNEQFF,0,1,1,1
TRBV6-2/3/5/6,TRBJ2-7,CASSSSSFGYEQYF,0,1,1,1
TRBV27,TRBJ2-5,CASSSTGLQETQYF,0,1,1,1
TRBV12-3/4,TRBJ2-1,CASSSQTGNNEQLF,0,1,1,1
TRBV6-2/3/5/6,TRBJ2-3,CASSWTGDTDTQYF,0,1,1,1
TRBV12-3/4,TRBJ1-1,CASSYRTGGAEAFF,0,1,1,1
TRBV6-2/3/5/6,TRBJ1-6,CASSYSFGDSPLHF,0,1,1,1
TRBV6-2/3/5/6,TRBJ1-4,CASSYSGPHEKLFF,0,1,1,1
TRBV6-2/3/5/6,TRBJ2-1,CASSYSGAGNEQFF,0,1,1,1
TRBV6-2/3/5/6,TRBJ2-7,CASSYSGGRDEQYF,0,1,1,1
TRBV6-2/3/5/6,TRBJ1-6,CASSYRQGNSPLHF,0,1,1,1
TRBV6-2/3/5/6,TRBJ2-7,CASSYRDSAYEQYF,0,1,1,1
TRBV6-2/3/5/6,TRBJ1-1,CASSYAGGSPEAFF,0,1,1,1
TRBV6-2/3/5/6,TRBJ2-5,CASSYGLLQETQYF,0,1,1,1
TRBV6-2/3/5/6,TRBJ1-5,CASSYKADNQPQHF,0,1,1,1
TRBV7-2,TRBJ2-2,CASSLRGNTGELFF,0,1,1,1
TRBV12-3/4,TRBJ2-7,CASSPTGTGYEQYF,0,1,1,1
TRBV27,TRBJ1-5,CASSPSQGNQPQHF,0,1,1,1
TRBV7-9,TRBJ2-5,CASSPGTTEKTQYF,0,1,1,1
TRBV6-2/3/5/6,TRBJ2-1,CASSPGTTYNEQFF,0,1,1,1
TRBV6-2/3/5/6,TRBJ1-6,CASSPSRNNSPLHF,0,1,1,1
TRBV12-3/4,TRBJ2-1,CASSPGFEYNEQFF,0,1,1,1
TRBV12-3/4,TRBJ1-5,CASSPMGGNQPQHF,0,1,1,1
TRBV6-2/3/5/6,TRBJ2-7,CASSRRSYSYEQYF,0,1,1,1
TRBV12-3/4,TRBJ2-3,CASSRPTSAGTQYF,0,1,1,1
TRBV12-3/4,TRBJ1-5,CASSRGQGRQPQHF,0,1,1,1
TRBV6-2/3/5/6,TRBJ2-2,CASSRTRNTGELVF,0,1,1,1
TRBV6-2/3/5/6,TRBJ1-5,CASSHDRTYQPQHF,0,1,1,1
TRBV6-2/3/5/6,TRBJ1-2,CASSHTGLGYGYTF,0,1,1,1
TRBV6-2/3/5/6,TRBJ1-1,CASSHHSGNTEAFF,0,1,1,1
TRBV12-3/4,TRBJ1-5,CASSAHREAQPQHF,0,1,1,1
TRBV6-1,TRBJ2-7,CASSAGAHSYEQYF,0,1,1,1
TRBV6-1,TRBJ1-2,CASSAMTANYGYAF,0,1,1,1
TRBV6-1,TRBJ2-3,CASSGGTETDTQYF,0,1,1,1
TRBV25-1,TRBJ1-2,CASSDGRGQNGYTF,0,1,1,1
TRBV2,TRBJ1-5,CASSDKTANQPQHF,0,1,1,1
TRBV10-3,TRBJ1-1,CASSEWTGSTEAFF,0,1,1,1
TRBV6-1,TRBJ2-3,CASSERGGTDTQYF,0,1,1,1
TRBV6-1,TRBJ1-3,CASSEWISGNAIYF,0,1,1,1
TRBV25-1,TRBJ1-2,CASSEIGQPVGYTF,0,1,1,1
TRBV6-1,TRBJ1-5,CASSESRVNQPQHF,0,1,1,1
TRBV6-2/3/5/6,TRBJ1-1,CASSTDRGLSEAFF,0,1,1,1
TRBV6-2/3/5/6,TRBJ1-1,CASSNRGADTEAFF,0,1,1,1
TRBV11-2,TRBJ1-2,CASSFLGGYYGYTF,0,1,1,1
TRBV11-2,TRBJ1-5,CASSFHGSNQPQHF,0,1,1,1
TRBV7-9,TRBJ2-5,CASSFQSSFATQYF,0,1,1,1
TRBV4-2,TRBJ2-7,CASSFVGSGYEQYF,0,1,1,1
TRBV7-2,TRBJ2-7,CASSFGGSSYEQYF,0,1,1,1
TRBV7-2,TRBJ2-7,CASSFGDYPYEQYF,0,1,1,1
TRBV5-5,TRBJ2-7,CASSFGTGLDEQYF,0,1,1,1
TRBV7-9,TRBJ1-1,CASSFGREATEAFF,0,1,1,1
TRBV7-2,TRBJ1-3,CASSLSNSGNTIYF,0,1,1,1
TRBV5-4,TRBJ2-7,CASSLVGVTYEQYF,0,1,1,1
TRBV5-6,TRBJ2-7,CASSLVGGPYEQYF,0,1,1,1
TRBV5-6,TRBJ1-1,CASSLGWGNTEAFF,0,1,1,1
TRBV5-5,TRBJ2-1,CASSLGLDYNEQFF,0,1,1,1
TRBV5-6,TRBJ2-7,CASSLEGNPYEQYF,0,1,1,1
TRBV7-9,TRBJ2-1,CASSLSTPGMGLFF,0,1,1,1
TRBV5-4,TRBJ2-7,CASSLSRGPYEQYF,0,1,1,1
TRBV12-3/4,TRBJ1-1,CASSLRQGNTEAFF,0,1,1,1
TRBV7-9,TRBJ2-7,CASSLVAGDYEQYF,0,1,1,1
TRBV7-9,TRBJ2-2,CASSLVVGPGELFF,0,1,1,1
TRBV7-9,TRBJ1-1,CASSLATVGTEAFF,0,1,1,1
TRBV7-9,TRBJ1-2,CASSLGQVPYGYTF,0,1,1,1
TRBV11-2,TRBJ1-5,CASSLGFGDQPQHF,0,1,1,1
TRBV7-2,TRBJ2-1,CASSLGYGLDNMTF,0,1,1,1
TRBV7-2,TRBJ2-5,CASSLGPGSETQYF,0,1,1,1
TRBV7-9,TRBJ1-1,CASSLGVVNTEAFF,0,1,1,1
TRBV7-9,TRBJ1-6,CASSLGGLNSPLHF,0,1,1,1
TRBV7-6,TRBJ1-1,CASSLDFRGSEAFF,0,1,1,1
TRBV11-3,TRBJ1-1,CASSLDRMNSEAFF,0,1,1,1
TRBV5-4,TRBJ2-7,CASSLINRRYEQYF,0,1,1,1
TRBV7-9,TRBJ2-1,CASSLSLSYNEQFF,0,1,1,1
TRBV12-3/4,TRBJ2-5,CASSLSGSWETQYF,0,1,1,1
TRBV7-6,TRBJ2-1,CASSLNGLADEQFF,0,1,1,1
TRBV7-2,TRBJ2-7,CASSLKRFNYEQYF,0,1,1,1
TRBV7-2,TRBJ2-3,CASSSRGDTDTQYF,0,1,1,1
TRBV7-2,TRBJ2-5,CASSSTLGARTQYF,0,1,1,1
TRBV2,TRBJ2-7,CASSSGGSFYEQYF,0,1,1,1
TRBV5-4,TRBJ1-1,CASSSGGWDTEAFF,0,1,1,1
TRBV5-4,TRBJ1-1,CASSSTGGEVEAFF,0,1,1,1
TRBV7-9,TRBJ1-1,CASSSSQMLRQAFF,0,1,1,1
TRBV7-2,TRBJ2-3,CASSSRGSSDTQYF,0,1,1,1
TRBV6-2/3/5/6,TRBJ1-2,CASSWGQEAYGYTF,0,1,1,1
TRBV7-2,TRBJ2-7,CASSWDRGGYEQYF,0,1,1,1
TRBV5-5,TRBJ1-4,CASSWESGHEKLFF,0,1,1,1
TRBV11-1,TRBJ1-1,CASSYGQNRAEAFF,0,1,1,1
TRBV14,TRBJ1-6,CASSLDEQTGPLHF,0,1,1,1
TRBV6-2/3/5/6,TRBJ1-6,CASSLRQGNSPLHF,0,1,1,1
TRBV7-2,TRBJ2-3,CASSLGGSTDTQYF,0,1,1,1
TRBV6-2/3/5/6,TRBJ2-2,CASSLAGDTGELFF,0,1,1,1
TRBV5-5,TRBJ1-1,CASSLGIMNTEAFF,0,1,1,1
TRBV3-1,TRBJ1-2,CASSLDSQGYGYTF,0,1,1,1
TRBV13,TRBJ2-4,CASSPRTGGNIQYF,0,1,1,1
TRBV9,TRBJ2-7,CASSPANRGREQYF,0,1,1,1
TRBV9,TRBJ2-7,CASSPRLALYEQYF,0,1,1,1
TRBV13,TRBJ2-1,CASSPRLKANEQFF,0,1,1,1
TRBV7-2,TRBJ2-7,CASSPQVQIYEQYF,0,1,1,1
TRBV7-9,TRBJ2-2,CASSPGTYTGELFF,0,1,1,1
TRBV7-6,TRBJ1-2,CASSPIDGVYGYTF,0,1,1,1
TRBV7-9,TRBJ1-1,CASSPRVVNTEAFF,0,1,1,1
TRBV7-9,TRBJ2-7,CASSPRGTGDEQYF,0,1,1,1
TRBV7-2,TRBJ1-2,CASSPKGEGYGYTF,0,1,1,1
TRBV9,TRBJ2-7,CASSPRDVTYEQYF,0,1,1,1
TRBV4-2,TRBJ2-5,CASSPGGGEETQYF,0,1,1,1
TRBV7-9,TRBJ2-3,CASSPGMATDTQYF,0,1,1,1
TRBV5-6,TRBJ2-5,CASSPGLELETQYF,0,1,1,1
TRBV7-2,TRBJ2-1,CASSPTTGSDEQFF,0,1,1,1
TRBV5-6,TRBJ2-2,CASSPTANTGELFF,0,1,1,1
TRBV7-3,TRBJ1-2,CASSPTGDGYGYTF,0,1,1,1
TRBV7-9,TRBJ1-1,CASSPTRENTEAFF,0,1,1,1
TRBV9,TRBJ2-2,CASSPRTNTGELFF,0,1,1,1
TRBV9,TRBJ2-7,CASSPRLAVYEQYF,0,1,1,1
TRBV4-2,TRBJ1-3,CASSPGWNGNTIYF,0,1,1,1
TRBV12-3/4,TRBJ2-1,CASSPGSSYNEQFF,0,1,1,1
TRBV7-2,TRBJ2-5,CASSRGRKEETQYF,0,1,1,1
TRBV7-9,TRBJ2-1,CASSRTSGNNEQFF,0,1,1,1
TRBV5-6,TRBJ1-1,CASSHPRGNTEAFF,0,1,1,1
TRBV14,TRBJ2-2,CASSQLTGSGELFF,0,1,1,1
TRBV14,TRBJ1-1,CASSQGYGHTEAFF,0,1,1,1
TRBV4-2,TRBJ1-1,CASSQVGGPTEAFF,0,1,1,1
TRBV4-2,TRBJ2-7,CASSQAAVAYEQYF,0,1,1,1
TRBV14,TRBJ2-1,CASSQGYGFNEQFF,0,1,1,1
TRBV3-1,TRBJ1-2,CASSQDLRNYGYTF,0,1,1,1
TRBV27,TRBJ1-5,CASSQEPWIQPQHF,0,1,1,1
TRBV14,TRBJ2-7,CASSQNGQGGEQYF,0,1,1,1
TRBV7-9,TRBJ1-1,CASSVTGSNTEAFF,0,1,1,1
TRBV9,TRBJ1-5,CASSVDSGNQPQHF,0,1,1,1
TRBV9,TRBJ1-6,CASSVEQRNSPLHF,0,1,1,1
TRBV9,TRBJ2-2,CASSVRAGTGELFF,0,1,1,1
TRBV5-6,TRBJ2-3,CASSAPGAADTQYF,0,1,1,1
TRBV9,TRBJ2-5,CASSAGDRQETQYF,0,1,1,1
TRBV5-6,TRBJ2-5,CASSGLAGEETQYF,0,1,1,1
TRBV7-2,TRBJ2-7,CASSGQGATYEQYF,0,1,1,1
TRBV7-9,TRBJ1-5,CASSGGHSNQPQHF,0,1,1,1
TRBV5-4,TRBJ1-1,CASSGGTYNTEAFF,0,1,1,1
TRBV5-5,TRBJ2-7,CASSERLSSYEQYF,0,1,1,1
TRBV7-2,TRBJ2-5,CASSTHPGGETQYF,0,1,1,1
TRBV7-9,TRBJ1-5,CASSTVNSNQPQHF,0,1,1,1
TRBV12-3/4,TRBJ1-2,CASRLSTLNYGYTF,0,1,1,1
TRBV6-2/3/5/6,TRBJ1-5,CASRSTGPNQPQHF,0,1,1,1
TRBV2,TRBJ1-1,CASRWDRENTEAFF,0,1,1,1
TRBV12-3/4,TRBJ2-7,CASRPVASGEQQYF,0,1,1,1
TRBV6-2/3/5/6,TRBJ1-5,CASRRPGENQPQHF,0,1,1,1
TRBV2,TRBJ2-5,CASRVRGLGETQYF,0,1,1,1
TRBV12-3/4,TRBJ1-2,CASRAPGTKRGYTF,0,1,1,1
TRBV6-2/3/5/6,TRBJ2-5,CASRGAGQGETQYF,0,1,1,1
TRBV12-3/4,TRBJ2-2,CASRGTGHTGELFF,0,1,1,1
TRBV5-4,TRBJ2-7,CASREAGVHYEQYF,0,1,1,1
TRBV27,TRBJ2-3,CASRTGYGTDTQYF,0,1,1,1
TRBV6-4,TRBJ2-5,CASRSTTTRETQYF,0,1,1,1
TRBV7-9,TRBJ2-2,CASRLRGNTGELFF,0,1,1,1
TRBV7-9,TRBJ2-1,CASRPGPLGGEQFF,0,1,1,1
TRBV27,TRBJ1-6,CASRPSSYNSPLHF,0,1,1,1
TRBV7-2,TRBJ2-7,CASRPDPNTYEQYF,0,1,1,1
TRBV3-1,TRBJ2-2,CASRGTGDTGELFF,0,1,1,1
TRBV2,TRBJ2-5,CASRGQGRGETQYF,0,1,1,1
TRBV6-2/3/5/6,TRBJ2-3,CASNPPGTADTQYF,0,1,1,1
TRBV6-2/3/5/6,TRBJ1-4,CASNPGPPNEKLFF,0,1,1,1
TRBV3-1,TRBJ2-5,CASNPTYSQETQYF,0,1,1,1
TRBV7-9,TRBJ1-2,CASNPFGGNYGYTF,0,1,1,1
TRBV6-2/3/5/6,TRBJ1-3,CASNQAGSGNTIYF,0,1,1,1
TRBV5-4,TRBJ2-2,CASNTRTGTGELFF,0,1,1,1
TRBV6-2/3/5/6,TRBJ2-7,CASKAGTGSDEQYF,0,1,1,1
TRBV12-5,TRBJ1-5,CARGSRDIDQPQHF,0,1,1,1
TRBV10-3,TRBJ2-4,CAKNQGNKKNIQYF,0,1,1,1
TRBV12-3/4,TRBJ1-5,CTSSLADFYQPQHF,0,1,1,1
TRBV29-1,TRBJ1-1,CCAPRTGRNTEAFF,0,1,1,1
TRBV29-1,TRBJ2-3,CCASTPTGSDTQYF,0,1,1,1
TRBV5-1,TRBJ2-7,CASATWDRGSEQYF,0,1,1,1
TRBV5-1,TRBJ1-3,CASQRDSSGNTIYF,0,1,1,1
TRBV5-1,TRBJ2-1,CASGLGQDLDEQFF,0,1,1,1
TRBV4-3,TRBJ2-3,CASSPSDSTDTQYF,0,1,1,1
TRBV4-1,TRBJ1-6,CASSQQGGYSPLHF,0,1,1,1
TRBV5-1,TRBJ2-1,CASSLVWTSTEQFF,0,1,1,1
TRBV5-1,TRBJ2-7,CASSLGLQIGEQYF,0,1,1,1
TRBV5-1,TRBJ1-6,CASSLGTGNSPLHF,0,1,1,1
TRBV5-1,TRBJ2-5,CASSLGQGQETQYF,0,1,1,1
TRBV5-1,TRBJ2-7,CASSLGGQGLEQYF,0,1,1,1
TRBV5-1,TRBJ2-7,CASSLERGYYEQYF,0,1,1,1
TRBV7-9,TRBJ1-1,CASSLVLGNTEAFF,0,1,1,1
TRBV7-2,TRBJ1-2,CASSLRTGGYGYTF,0,1,1,1
TRBV5-1,TRBJ2-4,CASSSGIAKNIQYF,0,1,1,1
TRBV4-1,TRBJ1-1,CASSSPTGGTEAFF,0,1,1,1
TRBV5-1,TRBJ2-5,CASSYDLGPETQYF,0,1,1,1
TRBV5-1,TRBJ2-5,CASSYLDSRETQYF,0,1,1,1
TRBV5-1,TRBJ1-1,CASSLLDRNTEAFF,0,1,1,1
TRBV4-1,TRBJ1-5,CASSPWTEGQPQHF,0,1,1,1
TRBV4-3,TRBJ2-1,CASSPTRTYNEQFF,0,1,1,1
TRBV5-1,TRBJ1-2,CASSPGTPDYGYTF,0,1,1,1
TRBV5-1,TRBJ1-1,CASSRRTADTEAFF,0,1,1,1
TRBV4-1,TRBJ2-1,CASSHPGLGVEQFF,0,1,1,1
TRBV4-3,TRBJ2-2,CASSQVSGDGELFF,0,1,1,1
TRBV4-3,TRBJ1-5,CASSQGQMDQPQHF,0,1,1,1
TRBV4-3,TRBJ2-7,CASSQDYSSYEQYF,0,1,1,1
TRBV4-1,TRBJ2-5,CASSQDPTSETQYL,0,1,1,1
TRBV4-3,TRBJ2-2,CASSQDRVTGELFF,0,1,1,1
TRBV4-3,TRBJ2-7,CASSQEWSSYEQYF,0,1,1,1
TRBV5-1,TRBJ2-1,CASSDGRGGGQKFF,0,1,1,1
TRBV5-1,TRBJ2-3,CASSTFPGTDTQYF,0,1,1,1
TRBV5-1,TRBJ2-7,CASSREGAFYEQYF,0,1,1,1
TRBV5-1,TRBJ2-1,CASKTGDSYNEQFF,0,1,1,1
TRBV20-1,TRBJ1-4,CSPARLQPNEKLFF,0,1,1,1
TRBV20-1,TRBJ2-3,CSVRDSGEKDTQYF,0,1,1,1
TRBV20-1,TRBJ2-5,CSASDTRAWETQYF,0,1,1,1
TRBV20-1,TRBJ2-3,CSAPGLIPGDTQYF,0,1,1,1
TRBV20-1,TRBJ2-3,CSAMTSRGTDTQYF,0,1,1,1
TRBV20-1,TRBJ2-5,CSASYAGTRETQYF,0,1,1,1
TRBV20-1,TRBJ2-7,CSARSDRISYEQYF,0,1,1,1
TRBV20-1,TRBJ2-1,CSARGVSSYNEQFF,0,1,1,1
TRBV20-1,TRBJ1-6,CSARLGETSSPLHF,0,1,1,1
TRBV20-1,TRBJ1-1,CSARVLGPRTEAFF,0,1,1,1
TRBV20-1,TRBJ1-5,CSALGQESNQPQHF,0,1,1,1
TRBV20-1,TRBJ1-1,CSAPRTGRNTEAFF,0,1,1,1
TRBV20-1,TRBJ2-5,CSARPGGQQETQYF,0,1,1,1
TRBV20-1,TRBJ2-1,CSAQSGGDYNEQFF,0,1,1,1
TRBV20-1,TRBJ1-6,CSASRGRGSAPLHF,0,1,1,1
TRBV20-1,TRBJ1-3,CSAPGQGSGNTIYF,0,1,1,1
TRBV20-1,TRBJ1-5,CSAASGQGHQPQHF,0,1,1,1
TRBV20-1,TRBJ2-3,CSAPGAVGTDTQYF,0,1,1,1
TRBV20-1,TRBJ2-3,CSARTSGTTDTQYF,0,1,1,1
TRBV29-1,TRBJ2-7,CSVLGLAGAYEQYF,0,1,1,1
TRBV29-1,TRBJ2-7,CSVVDASGVYEQYF,0,1,1,1
TRBV29-1,TRBJ2-5,CSVAGGPGGETQYF,0,1,1,1
TRBV29-1,TRBJ2-5,CSVGSGGAVETQYF,0,1,1,1
TRBV29-1,TRBJ2-3,CSVGRDRGPDTQYF,0,1,1,1
TRBV29-1,TRBJ1-1,CSVGAGGLNTEAFF,0,1,1,1
TRBV29-1,TRBJ1-1,CSVGRGQLNTEAFF,0,1,1,1
TRBV29-1,TRBJ2-2,CSVEAGQGTGELFF,0,1,1,1
TRBV29-1,TRBJ2-5,CSVEDREDQETQYF,0,1,1,1
TRBV29-1,TRBJ1-5,CSVRVRQDNQPQHF,0,1,1,1
TRBV29-1,TRBJ2-7,CSVYTGLNSYEQYF,0,1,1,1
TRBV29-1,TRBJ2-7,CSVIDRGKSYEQYF,0,1,1,1
TRBV29-1,TRBJ2-1,CSVLGGGTHNEQFF,0,1,1,1
TRBV29-1,TRBJ1-1,CSAEVQRGDTEAFF,0,1,1,1
TRBV29-1,TRBJ1-1,CSAWDRGMNTEAFF,0,1,1,1
TRBV29-1,TRBJ1-1,CSGGMTGANTEAFF,0,1,1,1
TRBV29-1,TRBJ2-3,CSDDGRFSTDTQYF,0,1,1,1
TRBV3-1,TRBJ1-5,WASSPGQRNQPQHF,0,1,1,1
TRBV20-1,TRBJ2-3,YSATRLAGADTQYF,0,1,1,1
TRBV24-1,TRBJ2-1,CASSSGGLNEQFF,0,1,1,1
TRBV30,TRBJ2-5,CASLGTGQETQYF,0,1,1,1
TRBV30,TRBJ1-2,CAWTVDGSYGYTF,0,1,1,1
TRBV30,TRBJ1-5,CAWSHRDNQPQHF,0,1,1,1
TRBV30,TRBJ2-7,CAWSVRGSGEQYF,0,1,1,1
TRBV30,TRBJ1-1,CAWSVSRNTEAFF,0,1,1,1
TRBV30,TRBJ1-3,CAWSGDSGNTIYF,0,1,1,1
TRBV30,TRBJ1-5,CAWSGGFNQPQHF,0,1,1,1
TRBV30,TRBJ2-1,CAWSGLADNEQFF,0,1,1,1
TRBV30,TRBJ1-1,CAWSTWGNTEAFF,0,1,1,1
TRBV11-2,TRBJ2-5,CAGSFNSQETQYF,0,1,1,1
TRBV2,TRBJ1-3,CAIGTAAGNTIYF,0,1,1,1
TRBV10-3,TRBJ1-2,CAISERVDYGYTF,0,1,1,1
TRBV10-3,TRBJ2-7,CAISEKREYEQYF,0,1,1,1
TRBV7-9,TRBJ2-7,CATTSGSTYEQYF,0,1,1,1
TRBV19,TRBJ2-1,CASSLRGGNEQFF,0,1,1,1
TRBV19,TRBJ1-5,CASSIGPHQPQHF,0,1,1,1
TRBV19,TRBJ1-1,CASSIGLSTEAFF,0,1,1,1
TRBV19,TRBJ2-1,CASSIDKGDEQFF,0,1,1,1
TRBV18,TRBJ1-3,CASSSGGGNTIYF,0,1,1,1
TRBV12-3/4,TRBJ1-2,CASSRSGDGGYTF,0,1,1,1
TRBV18,TRBJ1-2,CASSPAGIHGYTF,0,1,1,1
TRBV7-6,TRBJ2-1,CASCDSSYNEQFF,0,1,1,1
TRBV6-4,TRBJ2-1,CASVTGFDNEQFF,0,1,1,1
TRBV4-2,TRBJ2-7,CASGSGSGYEQYF,0,1,1,1
TRBV6-2/3/5/6,TRBJ2-7,CASDISGGYEQYF,0,1,1,1
TRBV2,TRBJ2-3,CASEPTYTDTQYF,0,1,1,1
TRBV7-9,TRBJ2-7,CASEAGASYEQYF,0,1,1,1
TRBV7-9,TRBJ2-5,CASILADLETQYF,0,1,1,1
TRBV6-2/3/5/6,TRBJ2-7,CASTSGQHHEQYF,0,1,1,1
TRBV11-2,TRBJ2-7,CASTALAGVEQYF,0,1,1,1
TRBV7-9,TRBJ2-5,CASTKIGAETQYF,0,1,1,1
TRBV6-2/3/5/6,TRBJ2-2,CASTGPYTGELFF,0,1,1,1
TRBV6-2/3/5/6,TRBJ1-1,CASSFRMNTEAFF,0,1,1,1
TRBV12-3/4,TRBJ1-2,CASSFRQSYGYTF,0,1,1,1
TRBV6-2/3/5/6,TRBJ1-1,CASSFGAGTEAFF,0,1,1,1
TRBV12-3/4,TRBJ1-2,CASSLVGSYGYTF,0,1,1,1
TRBV6-2/3/5/6,TRBJ1-1,CASSLTLSTEAFF,0,1,1,1
TRBV6-2/3/5/6,TRBJ1-2,CASSLQHSDGYTF,0,1,1,1
TRBV6-2/3/5/6,TRBJ1-1,CASSSGRDTEAFF,0,1,1,1
TRBV6-2/3/5/6,TRBJ2-5,CASSYNRGETQYF,0,1,1,1
TRBV6-2/3/5/6,TRBJ1-1,CASSYSKIWVAFF,0,1,1,1
TRBV12-3/4,TRBJ2-5,CASSPGGPGAQYF,0,1,1,1
TRBV12-3/4,TRBJ2-5,CASSPGTEETQYF,0,1,1,1
TRBV12-3/4,TRBJ2-3,CASSPLQKGTQYF,0,1,1,1
TRBV6-2/3/5/6,TRBJ2-7,CASSPGLSYEQYF,0,1,1,1
TRBV12-3/4,TRBJ2-7,CASSRTSFYEQYF,0,1,1,1
TRBV2,TRBJ1-1,CASSVRGNTEAFF,0,1,1,1
TRBV2,TRBJ1-1,CASSDEGNTEAFF,0,1,1,1
TRBV6-1,TRBJ1-1,CASSEHQDTEAFF,0,1,1,1
TRBV12-3/4,TRBJ1-1,CASSTRTVLGAFF,0,1,1,1
TRBV7-6,TRBJ2-1,CASSRTNSNEQFF,0,1,1,1
TRBV5-6,TRBJ1-1,CASSLVSNTEAFF,0,1,1,1
TRBV5-6,TRBJ2-1,CASSLVGSNEQFF,0,1,1,1
TRBV5-4,TRBJ2-1,CASSLAFRNEQFF,0,1,1,1
TRBV5-6,TRBJ2-1,CASSLGGYGEQFF,0,1,1,1
TRBV5-6,TRBJ1-4,CASSLGSGEKLFS,0,1,1,1
TRBV5-4,TRBJ1-1,CASSLSPNTEACF,0,1,1,1
TRBV7-2,TRBJ2-7,CASSLRGSYEQYF,0,1,1,1
TRBV7-6,TRBJ2-2,CASSLSATGELFF,0,1,1,1
TRBV7-9,TRBJ2-5,CASSLPQTETQYF,0,1,1,1
TRBV13,TRBJ2-7,CASSLAGGGEQYF,0,1,1,1
TRBV7-9,TRBJ2-7,CASSLASVYEQYF,0,1,1,1
TRBV7-2,TRBJ2-4,CASSLATLNIQYF,0,1,1,1
TRBV7-2,TRBJ1-2,CASSLAGNYGYTF,0,1,1,1
TRBV7-9,TRBJ1-1,CASSLARQAEAFF,0,1,1,1
TRBV13,TRBJ2-1,CASSLGRGSEQFF,0,1,1,1
TRBV7-9,TRBJ2-1,CASSLGRGNEQFF,0,1,1,1
TRBV5-6,TRBJ1-1,CASSLGRYTEAFF,0,1,1,1
TRBV11-2,TRBJ1-5,CASSLDPGGARHF,0,1,1,1
TRBV7-2,TRBJ1-2,CASSLEGGHSYTF,0,1,1,1
TRBV7-2,TRBJ2-7,CASSLETGYEQYF,0,1,1,1
TRBV7-3,TRBJ2-5,CASSLTSLETQYF,0,1,1,1
TRBV7-9,TRBJ1-2,CASSLNTLEGYTF,0,1,1,1
TRBV7-2,TRBJ2-1,CASSLKRYNEQFF,0,1,1,1
TRBV7-9,TRBJ1-1,CASSSGQTSEAFF,0,1,1,1
TRBV7-3,TRBJ1-1,CASSSAPWQEAFF,0,1,1,1
TRBV7-9,TRBJ2-1,CASSSDSYNEQFF,0,1,1,1
TRBV7-9,TRBJ2-7,CASSSTTPYEQYF,0,1,1,1
TRBV7-2,TRBJ2-7,CASSSGTSYEQYF,0,1,1,1
TRBV7-7,TRBJ2-5,CASSSMNPGTQYF,0,1,1,1
TRBV5-5,TRBJ2-5,CASSSQGGETQYF,0,1,1,1
TRBV5-5,TRBJ1-4,CASSWAGDEKLFF,0,1,1,1
TRBV4-2,TRBJ2-7,CASSLGTTYEQYF,0,1,1,1
TRBV13,TRBJ2-7,CASSLSRRYEQYF,0,1,1,1
TRBV6-2/3/5/6,TRBJ2-2,CASSLARTGELFL,0,1,1,1
TRBV3-1,TRBJ2-1,CASSLDLGVAEFF,0,1,1,1
TRBV7-2,TRBJ1-5,CASSLDMQTPQHF,0,1,1,1
TRBV7-9,TRBJ1-2,CASSLTYWNGYTF,0,1,1,1
TRBV4-2,TRBJ1-1,CASSPDQNTEAFF,0,1,1,1
TRBV9,TRBJ1-1,CASSPGGGTEAFF,0,1,1,1
TRBV13,TRBJ2-5,CASSPGGEETQYF,0,1,1,1
TRBV7-9,TRBJ2-7,CASSPNGGGEQYF,0,1,1,1
TRBV7-2,TRBJ2-7,CASSPREGFEQYF,0,1,1,1
TRBV9,TRBJ2-7,CASSPGPSGEQYF,0,1,1,1
TRBV7-9,TRBJ1-1,CASSPPGWTEAFF,0,1,1,1
TRBV14,TRBJ1-1,CASSPTRNTEAFF,0,1,1,1
TRBV9,TRBJ2-7,CASSPRSSYEQYF,0,1,1,1
TRBV7-9,TRBJ1-2,CASSRPGQRGYTF,0,1,1,1
TRBV16,TRBJ2-7,CASSRGTEVGQYF,0,1,1,1
TRBV6-2/3/5/6,TRBJ2-5,CASSRKNTETQYF,0,1,1,1
TRBV7-9,TRBJ2-3,CASSRTRTDTQYF,0,1,1,1
TRBV4-2,TRBJ2-1,CASSRDGYNEQFF,0,1,1,1
TRBV13,TRBJ1-4,CASSHDRGEKLFF,0,1,1,1
TRBV14,TRBJ1-4,CASSQGVGEKLFF,0,1,1,1
TRBV4-2,TRBJ2-3,CASSQGRSDTQYF,0,1,1,1
TRBV4-2,TRBJ2-7,CASSQGGPYEQYF,0,1,1,1
TRBV9,TRBJ2-7,CASSVSKGHEQYF,0,1,1,1
TRBV9,TRBJ2-5,CASSVGLAETQYF,0,1,1,1
TRBV9,TRBJ1-1,CASSVEGQVEAFF,0,1,1,1
TRBV11-3,TRBJ2-1,CASSAQGYNEQFF,0,1,1,1
TRBV11-3,TRBJ2-2,CASSAGPTGELFF,0,1,1,1
TRBV7-9,TRBJ2-1,CASSAGLALTQFF,0,1,1,1
TRBV5-6,TRBJ2-7,CASSGALRVEQYF,0,1,1,1
TRBV7-3,TRBJ1-1,CASSIGQGTEAFF,0,1,1,1
TRBV7-3,TRBJ1-1,CASSIDRGSEAFF,0,1,1,1
TRBV12-3/4,TRBJ2-2,CASSTLLGGELFF,0,1,1,1
TRBV7-9,TRBJ1-1,CASSRGKGTEAFF,0,1,1,1
TRBV6-2/3/5/6,TRBJ2-5,CASSRTEEETQYF,0,1,1,1
TRBV7-9,TRBJ2-7,CASSKDRDYEQYF,0,1,1,1
TRBV27,TRBJ2-7,CASRLAGDHEQYF,0,1,1,1
TRBV5-4,TRBJ2-2,CASRVQNTGELFF,0,1,1,1
TRBV6-2/3/5/6,TRBJ2-7,CASRGTMSHEQYF,0,1,1,1
TRBV7-2,TRBJ2-5,CASRDRAGETQYF,0,1,1,1
TRBV7-2,TRBJ2-5,CASRDRAGETQNF,0,1,1,1
TRBV2,TRBJ1-5,CASREGLNQPQHF,0,1,1,1
TRBV6-2/3/5/6,TRBJ1-1,CASRIFGDTEAFL,0,1,1,1
TRBV6-4,TRBJ2-2,CASRTSETGELFF,0,1,1,1
TRBV7-3,TRBJ2-7,CASRSNSAYEQYF,0,1,1,1
TRBV6-2/3/5/6,TRBJ1-6,CASRYRENSPLHF,0,1,1,1
TRBV7-9,TRBJ2-3,CASRPTVTDTQYF,0,1,1,1
TRBV6-2/3/5/6,TRBJ2-7,CASRRTISYEQYF,0,1,1,1
TRBV12-3/4,TRBJ2-7,CASRQGANYEQYF,0,1,1,1
TRBV12-3/4,TRBJ1-1,CASRGGAYTEAFF,0,1,1,1
TRBV11-1,TRBJ1-2,CASRDRGLYGYTF,0,1,1,1
TRBV12-3/4,TRBJ2-3,CASNGLAGETQYF,0,1,1,1
TRBV6-2/3/5/6,TRBJ2-5,CASKAQLQETQYF,0,1,1,1
TRBV12-3/4,TRBJ2-1,CASKQTSGGGPFF,0,1,1,1
TRBV2,TRBJ2-1,CAREKDREDEQFF,0,1,1,1
TRBV7-6,TRBJ1-4,CTSSLFGSEKLFF,0,1,1,1
TRBV5-1,TRBJ2-1,CASSSRQGNEQFF,0,1,1,1
TRBV5-1,TRBJ2-7,CASQGGGNLEQYF,0,1,1,1
TRBV4-3,TRBJ2-1,CASGRGWRYEQFF,0,1,1,1
TRBV5-1,TRBJ2-2,CASGTANTGELFF,0,1,1,1
TRBV5-1,TRBJ2-7,CASSFGIAYEQYF,0,1,1,1
TRBV5-1,TRBJ2-2,CASSFRGTGELFF,0,1,1,1
TRBV5-1,TRBJ1-2,CASSLRQGQGYTF,0,1,1,1
TRBV5-1,TRBJ2-7,CASSLGQTYEQYF,0,1,1,1
TRBV5-1,TRBJ1-1,CASSLGGGTEAFF,0,1,1,1
TRBV5-1,TRBJ1-2,CASSLDHSRGYTF,0,1,1,1
TRBV5-1,TRBJ2-2,CASSLEVAGELFF,0,1,1,1
TRBV5-1,TRBJ2-7,CASSLTGFDELYF,0,1,1,1
TRBV5-1,TRBJ2-1,CASSSHRDNEQFF,0,1,1,1
TRBV5-1,TRBJ2-1,CASSLDLFNEQFF,0,1,1,1
TRBV4-3,TRBJ2-7,CASSPGHQYEQYF,0,1,1,1
TRBV12-3/4,TRBJ1-5,CASSPQGAQPQHF,0,1,1,1
TRBV5-1,TRBJ1-2,CASSPDRPRSYTF,0,1,1,1
TRBV4-3,TRBJ2-7,CASSRQGSYEQYF,0,1,1,1
TRBV4-1,TRBJ2-1,CASSRGTDNEQFF,0,1,1,1
TRBV4-3,TRBJ2-7,CASSQYQGDEQYF,0,1,1,1
TRBV4-3,TRBJ2-7,CASSQVLQGEQYF,0,1,1,1
TRBV4-3,TRBJ1-1,CASSQDLGGEAFF,0,1,1,1
TRBV4-3,TRBJ2-5,CASSQDREETQYF,0,1,1,1
TRBV4-1,TRBJ2-7,CASSQILSYEQYF,0,1,1,1
TRBV5-1,TRBJ1-5,CASSRGDDQPQHF,0,1,1,1
TRBV5-1,TRBJ2-7,CASRRDDSYEQYF,0,1,1,1
TRBV20-1,TRBJ1-5,CSVSRGSRQPQHF,0,1,1,1
TRBV20-1,TRBJ2-3,CSAPRGAEDTQYF,0,1,1,1
TRBV20-1,TRBJ2-7,CSARTGVSYEQYF,0,1,1,1
TRBV20-1,TRBJ2-3,CSARGLTSDTQYF,0,1,1,1
TRBV20-1,TRBJ2-5,CSAGGTTQETQYF,0,1,1,1
TRBV20-1,TRBJ1-4,CSAEGQSNEKLFF,0,1,1,1
TRBV20-1,TRBJ2-5,CSASSALTETQYF,0,1,1,1
TRBV20-1,TRBJ2-7,CSASSGLEFGQYF,0,1,1,1
TRBV20-1,TRBJ1-5,CSASYRGGQPQHF,0,1,1,1
TRBV20-1,TRBJ1-1,CSASFSQGSEAFF,0,1,1,1
TRBV20-1,TRBJ2-7,CSASRTSGREQYF,0,1,1,1
TRBV20-1,TRBJ2-5,CSARLQPQETQYF,0,1,1,1
TRBV20-1,TRBJ1-5,CSARAYSNQPQHF,0,1,1,1
TRBV20-1,TRBJ2-7,CSARAGPGYEQYF,0,1,1,1
TRBV20-1,TRBJ2-5,CSARGASGGAAYF,0,1,1,1
TRBV20-1,TRBJ2-7,CSARGEQDYEQYF,0,1,1,1
TRBV20-1,TRBJ2-3,CSARDRPVDTQYF,0,1,1,1
TRBV20-1,TRBJ2-7,CSAREPGGNEQYF,0,1,1,1
TRBV20-1,TRBJ1-2,CSARELPGLGYTF,0,1,1,1
TRBV20-1,TRBJ2-5,CSARDQGEETQYF,0,1,1,1
TRBV20-1,TRBJ2-5,CSARDRDRETQYF,0,1,1,1
TRBV20-1,TRBJ2-3,CSATSGSTDTQYF,0,1,1,1
TRBV20-1,TRBJ2-7,CSKTSGRGREQYF,0,1,1,1
TRBV29-1,TRBJ2-5,CSLTVIGRETQYF,0,1,1,1
TRBV29-1,TRBJ2-5,CSLAGTRAETQYF,0,1,1,1
TRBV29-1,TRBJ2-7,CSVSGTNLYEQYF,0,1,1,1
TRBV29-1,TRBJ2-2,CSVVAGGTGELFF,0,1,1,1
TRBV29-1,TRBJ1-1,CSVAGTGGTEAFF,0,1,1,1
TRBV29-1,TRBJ1-1,CSVGGGQNTEALF,0,1,1,1
TRBV29-1,TRBJ2-2,CSVGTTNTGELFF,0,1,1,1
TRBV29-1,TRBJ2-2,CSVGQMDTGELFF,0,1,1,1
TRBV29-1,TRBJ1-3,CSVGGGERNTIYF,0,1,1,1
TRBV29-1,TRBJ1-1,CSVDTAQNTEAFF,0,1,1,1
TRBV29-1,TRBJ2-7,CSVDTGGIGEQYF,0,1,1,1
TRBV29-1,TRBJ1-2,CSVDRVRDYGYTF,0,1,1,1
TRBV29-1,TRBJ1-2,CSVERFSSNGYTF,0,1,1,1
TRBV29-1,TRBJ1-2,CSVEPFGGHGYTF,0,1,1,1
TRBV29-1,TRBJ2-5,CSVEVRSKETQYF,0,1,1,1
TRBV29-1,TRBJ2-5,CSVEEQQPWTQYF,0,1,1,1
TRBV29-1,TRBJ2-5,CSVTSGGQETQYF,0,1,1,1
TRBV29-1,TRBJ2-7,CSVRASGSYEQYF,0,1,1,1
TRBV29-1,TRBJ2-1,CSVSGQGGDEQFF,0,1,1,1
TRBV29-1,TRBJ2-1,CSVPKLSSNEQFF,0,1,1,1
TRBV29-1,TRBJ2-5,CSVALRLAETQYF,0,1,1,1
TRBV29-1,TRBJ1-1,CSVETGGWTEAFF,0,1,1,1
TRBV29-1,TRBJ2-5,CSVGTSDQETQYF,0,1,1,1
TRBV29-1,TRBJ1-3,CSVEDTAGNTIYF,0,1,1,1
TRBV29-1,TRBJ1-5,CSADTGYGQPQHF,0,1,1,1
TRBV29-1,TRBJ1-1,CSAPSPGNTEAFF,0,1,1,1
TRBV29-1,TRBJ1-1,CSAPDDRNTEAFF,0,1,1,1
TRBV29-1,TRBJ2-6,CSARTGGANVLTF,0,1,1,1
TRBV29-1,TRBJ2-7,CSAEGGSSYEQYF,0,1,1,1
TRBV29-1,TRBJ2-3,CSGCQVGADTQYF,0,1,1,1
TRBV29-1,TRBJ1-1,CSGGDRMNTEAFF,0,1,1,1
TRBV29-1,TRBJ2-1,CSGSGGLYNEQFF,0,1,1,1
TRBV20-1,TRBJ2-7,CSITSGRWGEQYF,0,1,1,1
TRBV20-1,TRBJ1-4,CNASNRVGEKLFF,0,1,1,1
TRBV29-1,TRBJ1-1,RSVGTRGDTEAFF,0,1,1,1
TRBV30,TRBJ1-1,CAGGTIWGGAFF,0,1,1,1
TRBV30,TRBJ1-1,CAGNPGRTEAFF,0,1,1,1
TRBV7-9,TRBJ1-2,CAITYGVYGYTF,0,1,1,1
TRBV15,TRBJ1-5,CATSTEGQPQHF,0,1,1,1
TRBV15,TRBJ1-2,CATSRDGYGYTF,0,1,1,1
TRBV19,TRBJ1-2,CASSLGGDGYTF,0,1,1,1
TRBV19,TRBJ2-5,CASSGGRETQYF,0,1,1,1
TRBV19,TRBJ1-1,CASSIGGTEAFF,0,1,1,1
TRBV19,TRBJ2-7,CASSYNSYEQYF,0,1,1,1
TRBV27,TRBJ2-1,CASSGAYNEQFF,0,1,1,1
TRBV19,TRBJ2-7,CASSRQGSEQYF,0,1,1,1
TRBV6-1,TRBJ2-4,CASCGLGNIQYF,0,1,1,1
TRBV7-9,TRBJ2-3,CASQGSTDTQYF,0,1,1,1
TRBV6-2/3/5/6,TRBJ2-2,CASGTRTGELFF,0,1,1,1
TRBV7-2,TRBJ2-7,CASGLGGPEQYF,0,1,1,1
TRBV6-2/3/5/6,TRBJ1-6,CASGPGNSPLHF,0,1,1,1
TRBV6-2/3/5/6,TRBJ1-5,CASGSQGLAQHF,0,1,1,1
TRBV12-3/4,TRBJ2-3,CASGSSTDTQYF,0,1,1,1
TRBV12-3/4,TRBJ2-7,CASTFRGDEQYF,0,1,1,1
TRBV27,TRBJ2-1,CASTQDRDEQFF,0,1,1,1
TRBV2,TRBJ2-1,CASTSVGDEQFF,0,1,1,1
TRBV27,TRBJ2-1,CASSFRHNEQFF,0,1,1,1
TRBV6-2/3/5/6,TRBJ1-1,CASSFAGIEAFF,0,1,1,1
TRBV28,TRBJ1-5,CASSFRDQPQHS,0,1,1,1
TRBV12-3/4,TRBJ1-5,CASSLLYQPQHF,0,1,1,1
TRBV12-3/4,TRBJ1-1,CASSLPNTEAFF,0,1,1,1
TRBV12-3/4,TRBJ2-5,CASSLAPMGQYF,0,1,1,1
TRBV12-3/4,TRBJ2-7,CASSLGFNGQYF,0,1,1,1
TRBV6-2/3/5/6,TRBJ2-7,CASSSRGYEQYF,0,1,1,1
TRBV27,TRBJ2-7,CASSSLAHEQYF,0,1,1,1
TRBV9,TRBJ2-5,CASSSLQETQYF,0,1,1,1
TRBV6-2/3/5/6,TRBJ1-2,CASSSRTEINTF,0,1,1,1
TRBV6-2/3/5/6,TRBJ2-1,CASSSNIWEQFF,0,1,1,1
TRBV6-2/3/5/6,TRBJ1-1,CASSYRNTEAFF,0,1,1,1
TRBV6-2/3/5/6,TRBJ1-5,CASSYVGQPQHF,0,1,1,1
TRBV6-2/3/5/6,TRBJ2-7,CASSYTGYEQYF,0,1,1,1
TRBV6-2/3/5/6,TRBJ2-1,CASSYNKNEQFF,0,1,1,1
TRBV12-3/4,TRBJ2-5,CASSPPGETQYF,0,1,1,1
TRBV6-2/3/5/6,TRBJ2-1,CASSPQLGEQFF,0,1,1,1
TRBV2,TRBJ2-1,CASSGLNNEQFF,0,1,1,1
TRBV12-3/4,TRBJ1-2,CASSGTRYGYTF,0,1,1,1
TRBV6-1,TRBJ2-7,CASSELAYEQYF,0,1,1,1
TRBV11-1,TRBJ2-7,CASSRGVHEQYF,0,1,1,1
TRBV7-9,TRBJ2-1,CASSFQGYEQFF,0,1,1,1
TRBV7-2,TRBJ2-7,CASSFRLNEQYF,0,1,1,1
TRBV5-6,TRBJ2-7,CASSLSANKQYF,0,1,1,1
TRBV7-9,TRBJ1-2,CASSLGDWGYTF,0,1,1,1
TRBV5-6,TRBJ1-2,CASSLEGLGYTF,0,1,1,1
TRBV5-4,TRBJ2-2,CASSLKTGELFF,0,1,1,1
TRBV7-2,TRBJ1-2,CASSLAGGGYTF,0,1,1,1
TRBV7-2,TRBJ1-2,CASSLGPNGYTF,0,1,1,1
TRBV5-4,TRBJ2-2,CASSSGGGELFF,0,1,1,1
TRBV5-4,TRBJ2-1,CASSSSGNEQFF,0,1,1,1
TRBV5-5,TRBJ2-3,CASSSDLDTQYF,0,1,1,1
TRBV5-6,TRBJ1-2,CASSSDSGGYTF,0,1,1,1
TRBV7-3,TRBJ2-1,CASSSPNNEQFF,0,1,1,1
TRBV6-2/3/5/6,TRBJ1-1,CASSWGGTEAFF,0,1,1,1
TRBV7-2,TRBJ2-1,CASSYQGHEQFF,0,1,1,1
TRBV7-2,TRBJ2-1,CASSLLTDEQFF,0,1,1,1
TRBV3-1,TRBJ1-1,CASSLRTGEAFF,0,1,1,1
TRBV7-2,TRBJ1-2,CASSPQFPGYTF,0,1,1,1
TRBV3-1,TRBJ1-2,CASSPRTGGYTF,0,1,1,1
TRBV6-2/3/5/6,TRBJ2-1,CASSPTLNEQFF,0,1,1,1
TRBV4-2,TRBJ2-7,CASSHNGVEQYF,0,1,1,1
TRBV7-2,TRBJ2-3,CASSHPQDTQYF,0,1,1,1
TRBV11-1,TRBJ2-7,CASSHRVYEQYF,0,1,1,1
TRBV7-9,TRBJ1-3,CASSQSGNTIYF,0,1,1,1
TRBV12-3/4,TRBJ1-2,CASSQTGHGYTF,0,1,1,1
TRBV5-5,TRBJ1-1,CASSQRGAEAFF,0,1,1,1
TRBV14,TRBJ1-2,CASSQGTYGYTF,0,1,1,1
TRBV9,TRBJ2-2,CASSVGGGELFF,0,1,1,1
TRBV7-9,TRBJ2-5,CASSVRELGIYF,0,1,1,1
TRBV11-2,TRBJ2-7,CASSEGQSEQYF,0,1,1,1
TRBV7-9,TRBJ2-3,CASSIGTDTQYF,0,1,1,1
TRBV2,TRBJ2-5,CASSRGGETQYF,0,1,1,1
TRBV13,TRBJ2-1,CASSRTGVEQFF,0,1,1,1
TRBV12-3/4,TRBJ2-4,CASSRITGLQYF,0,1,1,1
TRBV12-3/4,TRBJ2-7,CASRRTGHEQYF,0,1,1,1
TRBV27,TRBJ2-7,CASRSSRGQQYF,0,1,1,1
TRBV3-1,TRBJ1-2,CASRQGAGGYTF,0,1,1,1
TRBV2,TRBJ1-5,CASRQGSQPQHF,0,1,1,1
TRBV6-2/3/5/6,TRBJ1-2,CASRAGDYGYTF,0,1,1,1
TRBV7-9,TRBJ2-7,CASRINSYEQYF,0,1,1,1
TRBV7-6,TRBJ1-4,CASRKVGEKLFF,0,1,1,1
TRBV5-6,TRBJ2-3,CASNLGTDTQYF,0,1,1,1
TRBV2,TRBJ2-3,CASKQITDTQYF,0,1,1,1
TRBV2,TRBJ1-3,CASKGDGNTIYF,0,1,1,1
TRBV5-1,TRBJ1-6,CASSLGTSPLHF,0,1,1,1
TRBV4-1,TRBJ2-3,CASSQVWATQYF,0,1,1,1
TRBV4-1,TRBJ1-5,CASSQGQQPQHF,0,1,1,1
TRBV5-1,TRBJ1-2,CDSGSRGYGYTF,0,1,1,1
TRBV20-1,TRBJ1-6,CSARLGNSPLHF,0,1,1,1
TRBV20-1,TRBJ2-5,CSATATGETQYF,0,1,1,1
TRBV20-1,TRBJ2-7,CSASLISYEQYF,0,1,1,1
TRBV20-1,TRBJ2-1,CSASRRRNEQFF,0,1,1,1
TRBV20-1,TRBJ1-2,CSARLTNYGYTF,0,1,1,1
TRBV20-1,TRBJ1-1,CSARDDGTKAFF,0,1,1,1
TRBV20-1,TRBJ1-2,CSAREAGTGYTF,0,1,1,1
TRBV20-1,TRBJ2-3,CSALGVADTQYF,0,1,1,1
TRBV20-1,TRBJ2-1,CSARREELEQFF,0,1,1,1
TRBV29-1,TRBJ2-7,CSVVVRTYEQYF,0,1,1,1
TRBV29-1,TRBJ2-1,CSVDHPYNEQFF,0,1,1,1
TRBV29-1,TRBJ2-5,CSVDGRLETQYF,0,1,1,1
TRBV29-1,TRBJ2-4,CSVDADGNIQYF,0,1,1,1
TRBV29-1,TRBJ2-3,CSVEPGTDTQYF,0,1,1,1
TRBV29-1,TRBJ2-1,CSVEAGRDEQFF,0,1,1,1
TRBV29-1,TRBJ1-2,CSVEGTENGYTF,0,1,1,1
TRBV29-1,TRBJ2-1,CSVEDRGNEQFF,0,1,1,1
TRBV29-1,TRBJ1-2,CSVETDNYGYTF,0,1,1,1
TRBV29-1,TRBJ2-7,CSVRLGVGEQYF,0,1,1,1
TRBV29-1,TRBJ2-7,CSVEQETYEQYF,0,1,1,1
TRBV29-1,TRBJ2-2,CSADRGPGELFF,0,1,1,1
TRBV7-4,TRBJ1-2,RASSGTGGGYTF,0,1,1,1
TRBV27,TRBJ2-1,CVSTQGMEQFF,0,1,1,1
TRBV12-5,TRBJ2-7,CASGFSYEQYF,0,1,1,1
TRBV12-5,TRBJ1-2,CARAGIYGYTF,0,1,1,1
TRBV10-3,TRBJ1-2,CAITGGVGYTF,0,1,1,1
TRBV19,TRBJ2-1,CATGLHNEQFF,0,1,1,1
TRBV14,TRBJ2-7,CATGQTCEQHF,0,1,1,1
TRBV19,TRBJ2-1,CASSRFGEQFF,0,1,1,1
TRBV19,TRBJ2-7,CASRENYEQYF,0,1,1,1
TRBV7-3,TRBJ2-7,CASRGRYEQYF,0,1,1,1
TRBV25-1,TRBJ2-1,CASQLNNEQFF,0,1,1,1
TRBV2,TRBJ2-5,CASMLWETQYF,0,1,1,1
TRBV11-2,TRBJ2-3,CASISSGTQYF,0,1,1,1
TRBV6-2/3/5/6,TRBJ2-7,CASSFNYEQYF,0,1,1,1
TRBV12-3/4,TRBJ2-3,CASSLADTQYF,0,1,1,1
TRBV6-2/3/5/6,TRBJ2-7,CASSYLTEQYF,0,1,1,1
TRBV27,TRBJ2-7,CASSLSYEQYF,0,1,1,1
TRBV6-1,TRBJ1-1,CASSGRAEAFF,0,1,1,1
TRBV6-1,TRBJ2-1,CASSKGNEQFF,0,1,1,1
TRBV7-2,TRBJ2-7,CASSFQYEQYF,0,1,1,1
TRBV7-8,TRBJ2-7,CASSFSHEQYF,0,1,1,1
TRBV5-6,TRBJ2-5,CASSLDETQYF,0,1,1,1
TRBV7-9,TRBJ2-5,CASSLGRDQYF,0,1,1,1
TRBV7-9,TRBJ1-2,CASSLDISYTF,0,1,1,1
TRBV3-1,TRBJ2-7,CASSRSYEQYF,0,1,1,1
TRBV7-9,TRBJ2-1,CASSQYNEQFF,0,1,1,1
TRBV5-4,TRBJ1-1,CASSGGTEAFF,0,1,1,1
TRBV7-9,TRBJ2-5,CASSNPETQYF,0,1,1,1
TRBV10-3,TRBJ2-7,CAKNRGHEQYF,0,1,1,1
TRBV5-1,TRBJ2-1,CASGEYNEQFF,0,1,1,1
TRBV4-1,TRBJ2-7,CASSQGYEQYF,0,1,1,1
TRBV20-1,TRBJ1-1,CGTRVNTEAFF,0,1,1,1
TRBV20-1,TRBJ2-1,CSVEIRNEQFF,0,1,1,1
TRBV20-1,TRBJ1-1,CSAPSSMGAFF,0,1,1,1
TRBV20-1,TRBJ2-3,CSASSADTQYF,0,1,1,1
TRBV20-1,TRBJ1-1,CSARGGIEAFF,0,1,1,1
TRBV20-1,TRBJ1-1,CSARVGPEAFF,0,1,1,1
TRBV29-1,TRBJ2-3,CSVYSTDTRYF,0,1,1,1
TRBV29-1,TRBJ1-2,CSVLTEYGYTF,0,1,1,1
TRBV29-1,TRBJ2-1,CSVVEYNEQFF,0,1,1,1
TRBV29-1,TRBJ2-7,CSVGGKREQYF,0,1,1,1
TRBV29-1,TRBJ2-1,CSVEDSHEQFF,0,1,1,1
TRBV29-1,TRBJ1-1,CSVVRDREAFF,0,1,1,1
TRBV29-1,TRBJ2-4,CSAAGQGVQYF,0,1,1,1
TRBV7-9,TRBJ2-1,CASEGQRQLF,0,1,1,1
TRBV2,TRBJ1-1,CASIRRVAFF,0,1,1,1
TRBV11-2,TRBJ2-1,CASSLGEQFF,0,1,1,1
TRBV2,TRBJ2-7,CGSGENEQYF,0,1,1,1
TRBV20-1,TRBJ2-7,CSASSYEQHF,0,1,1,1
TRBV20-1,TRBJ2-4,CSARDNIQYF,0,1,1,1
TRBV29-1,TRBJ1-1,CSGQGAEAFF,0,1,1,1
TRBV29-1,TRBJ2-2,CSVRLGELFF,0,1,1,1
TRBV29-1,TRBJ2-2,CSVVSGELFF,0,1,1,1
TRBV29-1,TRBJ2-7,CSVAGTEQYF,0,1,1,1
TRBV28,TRBJ1-1,CAGDTEAFF,0,1,1,1
TRBV20-1,TRBJ2-7,CSAPSEQYF,0,1,1,1
TRBV29-1,TRBJ1-1,CSIPPAFF,0,1,1,1
TRBV29-1,TRBJ1-1,CSVEAFF,0,1,1,1
TRBV18,TRBJ1-4,CASSPPRGVSATNEKLFF,0,1,1,1
TRBV6-2/3/5/6,TRBJ1-6,CASSYSRGSSSPLHF,0,1,1,1
TRBV13,TRBJ1-6,CASSLGRLRSPLHF,0,1,1,1
TRBV11-1,TRBJ1-1,CASSWSRRTEAFF,0,1,1,1
