v_hit,j_hit,cdr3,S3-10ng_S8,S3-10ng_S20,freq,count_sum
TRBV3-1,TRBJ2-7,CASSQDLGSYEQYF,49,48,2,97
TRBV7-2,TRBJ1-1,CASSLSSSWNTEAFF,27,29,2,56
TRBV29-1,TRBJ1-2,CSPGAILTGQYGYTF,17,14,2,31
TRBV2,TRBJ2-3,CASSDGTTDTQYF,11,8,2,19
TRBV7-9,TRBJ1-1,CASSLGGMTEAFF,13,11,2,24
TRBV7-9,TRBJ2-2,CASSTNPNTGELFF,11,10,2,21
TRBV6-2/3/5/6,TRBJ2-1,CASSLTSGRYNEQFF,1,0,1,1
TRBV6-2/3/5/6,TRBJ2-5,CASSWSGLQETQYF,2,0,1,2
TRBV11-2,TRBJ2-1,CASRLGLAGGEGPFF,9,9,2,18
TRBV19,TRBJ2-7,CASSGTDTYEQYF,1,0,1,1
TRBV7-9,TRBJ2-3,CASSFFADTQYF,2,0,1,2
TRBV20-1,TRBJ1-5,CSARDLGIRQPQHF,3,3,2,6
TRBV12-3/4,TRBJ2-1,CASHKYAVERGGQGLGEQFF,2,0,1,2
TRBV7-2,TRBJ1-4,CASRGPGNEKLFF,2,0,1,2
TRBV5-4,TRBJ2-1,CASRSDSYNEQFF,5,5,2,10
TRBV5-1,TRBJ2-1,CASSLGGEAFF,2,0,1,2
TRBV28,TRBJ1-4,CASRKSVATNEKLFF,2,0,1,2
TRBV12-5,TRBJ2-3,CASGLTPAILTDTQYF,1,0,1,1
TRBV6-4,TRBJ1-1,CASSDRENTEAFF,4,6,2,10
TRBV12-3/4,TRBJ2-4,CASSLQEAKNIQYF,3,0,1,3
TRBV5-4,TRBJ1-4,CASSPDPTNEKLFF,1,0,1,1
TRBV12-3/4,TRBJ2-1,CASSLGGQGAYNEQFF,1,0,1,1
TRBV5-1,TRBJ2-7,CASSSRQGYEQYF,1,0,1,1
TRBV29-1,TRBJ2-2,CSVEGTEGPTGGLFF,2,0,1,2
TRBV2,TRBJ2-2,CASTSTGGLTGELFF,1,0,1,1
TRBV5-1,TRBJ1-1,CASNRQGALENTEAFF,2,0,1,2
TRBV19,TRBJ1-5,CASKEGAGGNQPQHF,2,0,1,2
TRBV29-1,TRBJ2-5,CSVEADQRVQETQYF,3,1,2,4
TRBV28,TRBJ2-2,CASSFPWGDYAGELFF,1,0,1,1
TRBV7-9,TRBJ1-1,CASSLGHNTEAFF,2,0,1,2
TRBV5-5,TRBJ2-1,CASSLGNYNEQFF,1,0,1,1
TRBV5-4,TRBJ2-7,CASSVTGDNEQYF,3,2,2,5
TRBV29-1,TRBJ1-2,CSVEEGNYGYTF,1,0,1,1
TRBV7-2,TRBJ2-5,CASSSVSIGETQYF,4,0,1,4
TRBV5-1,TRBJ1-1,CASSLVPGSFMNTEAFF,1,0,1,1
TRBV20-1,TRBJ2-6,CSARVGGSGANVLTF,1,0,1,1
TRBV12-3/4,TRBJ1-3,CASTPTVSGNTIYF,1,0,1,1
TRBV12-3/4,TRBJ1-2,CASSRDRGDNGYTF,1,0,1,1
TRBV30,TRBJ2-7,CAWSVGRNYEQYF,1,0,1,1
TRBV5-1,TRBJ2-3,CASSWTQGDTQYF,1,0,1,1
TRBV20-1,TRBJ2-3,CSASGGADTQYF,1,0,1,1
TRBV29-1,TRBJ2-1,CSVEGYNEQFF,1,0,1,1
TRBV7-9,TRBJ1-5,CASSSDRDRRNQPQHF,1,0,1,1
TRBV5-1,TRBJ2-3,CASSPGPGGRPDTQYF,1,0,1,1
TRBV20-1,TRBJ2-7,CSATPPDGPSSYEQYF,1,0,1,1
TRBV5-6,TRBJ2-7,CASSRLAVYEQYF,1,0,1,1
TRBV28,TRBJ2-5,CASNLGQMRAQYF,1,0,1,1
TRBV2,TRBJ1-1,CASSDSLGQAFF,2,0,1,2
TRBV28,TRBJ1-1,CASRGMREAFF,2,0,1,2
TRBV5-4,TRBJ1-4,CASSLIGSGHTNEKLFF,2,0,1,2
TRBV6-2/3/5/6,TRBJ2-1,CASSYPVGTTYNEQFF,1,0,1,1
TRBV6-2/3/5/6,TRBJ1-5,CASTGGLSSNQPQHF,1,0,1,1
TRBV6-2/3/5/6,TRBJ2-1,CASSPGTGGYDEQFF,3,3,2,6
TRBV6-1,TRBJ1-5,CASSEAPGGSQPQHF,1,0,1,1
TRBV14,TRBJ2-1,CASSQRPQRGDEQFF,1,0,1,1
TRBV2,TRBJ1-3,CASSAGTGAGNTIYF,2,0,1,2
TRBV18,TRBJ2-7,CASSPGQELYEQYF,1,0,1,1
TRBV12-3/4,TRBJ2-7,CASSLEGYSYEQYF,1,0,1,1
TRBV6-2/3/5/6,TRBJ2-5,CASSSTGLAETQYF,3,3,2,6
TRBV9,TRBJ1-6,CASSVDSGSAPLHF,1,0,1,1
TRBV7-3,TRBJ1-5,CASSLSPDQPQHF,1,0,1,1
TRBV20-1,TRBJ2-3,CSARERGDTQYF,1,0,1,1
TRBV5-1,TRBJ2-7,CASSLELAASSYEQYF,1,0,1,1
TRBV4-2,TRBJ2-2,CASSRLDVNTGELFF,1,0,1,1
TRBV6-2/3/5/6,TRBJ2-7,CASSPPGSGGSGEQYF,1,0,1,1
TRBV14,TRBJ2-1,CASSQVVGNEQFF,1,0,1,1
TRBV5-1,TRBJ2-5,CASSLAPLGNQETQYF,1,0,1,1
TRBV12-3/4,TRBJ1-2,CASSSQGWASYGYTF,2,0,1,2
TRBV2,TRBJ2-2,CASSRDRASTGELFF,1,0,1,1
TRBV9,TRBJ2-1,CASSPTGTLNNEQFF,1,0,1,1
TRBV5-1,TRBJ2-7,CASSLALFGTYEQYF,1,0,1,1
TRBV20-1,TRBJ2-1,CSASPMTDSYNEQFF,1,0,1,1
TRBV19,TRBJ1-5,CASRSGGSNQPQHF,2,0,1,2
TRBV12-3/4,TRBJ2-7,CASSLSGTDYEQYF,1,0,1,1
TRBV12-3/4,TRBJ1-6,CASSSTGDQSPLHF,2,0,1,2
TRBV13,TRBJ1-1,CASSDNPGQVEAFF,2,0,1,2
TRBV4-1,TRBJ1-2,CASSHTGTDYGYTF,4,4,2,8
TRBV20-1,TRBJ2-5,CSASYAGVRETQYF,2,0,1,2
TRBV7-3,TRBJ1-2,CASSLGQDYGYTF,1,0,1,1
TRBV2,TRBJ1-1,CAKTQGQGGEAFF,3,0,1,3
TRBV5-1,TRBJ2-1,CASSLGSHNEQFF,1,0,1,1
TRBV28,TRBJ2-7,CASSPTYYEQYF,2,0,1,2
TRBV29-1,TRBJ2-7,CSVTSGTYEQYF,1,0,1,1
TRBV29-1,TRBJ1-3,CSVMMGNTIYF,1,0,1,1
TRBV18,TRBJ2-7,CASSPRRLYEQYF,1,0,1,1
TRBV30,TRBJ2-2,CAWNRGLANTGELFF,2,0,1,2
TRBV9,TRBJ2-1,CASSPSGGAIDEQFF,1,0,1,1
TRBV2,TRBJ2-3,CASSEGLPGPDTQYS,1,0,1,1
TRBV18,TRBJ2-3,CASSPMGPTGTQYF,1,0,1,1
TRBV20-1,TRBJ2-5,CSAPGQAGGPGWSTQETQYF,1,0,1,1
TRBV12-3/4,TRBJ1-3,CASSGTGRSSGNTIYF,2,0,1,2
TRBV15,TRBJ1-1,CATSRDYGGQTEAFF,2,0,1,2
TRBV18,TRBJ2-3,CASSAYGTGGDTQYF,1,0,1,1
TRBV27,TRBJ2-5,CASSGGQGLWETQYF,1,0,1,1
TRBV7-8,TRBJ1-6,CASSLSGTGHSPLHF,1,0,1,1
TRBV27,TRBJ2-7,CASRGRGHVAYEQYF,2,0,1,2
TRBV5-1,TRBJ2-1,CASSRETSGYNEQFF,2,0,1,2
TRBV20-1,TRBJ2-1,CSASRVSGGLGEQFF,1,0,1,1
TRBV12-3/4,TRBJ2-3,CASSRTGTSDTQYF,1,0,1,1
TRBV9,TRBJ2-5,CASSVDGRLETQYF,1,0,1,1
TRBV5-1,TRBJ2-7,CASSPDSLSYEQYF,2,1,2,3
TRBV29-1,TRBJ1-4,CSHNYLTGNEKLFF,1,0,1,1
TRBV29-1,TRBJ2-7,CSVKTGSSYEQYF,3,0,1,3
TRBV19,TRBJ1-5,CASQGSNQPQHF,1,0,1,1
TRBV29-1,TRBJ1-1,CSVVGGLLGAFF,2,0,1,2
TRBV7-9,TRBJ2-5,CASSWDRSGGAPEETQYF,1,0,1,1
TRBV18,TRBJ1-1,CASSPLPGTVNTEAFF,1,0,1,1
TRBV12-3/4,TRBJ2-3,CASSLGTGGATDTQYF,1,0,1,1
TRBV13,TRBJ2-3,CASSPTFGQSTDTQYF,2,0,1,2
TRBV12-3/4,TRBJ1-5,CASSTHGTGANQPQHF,3,0,1,3
TRBV5-1,TRBJ1-1,CASSRETGDIATEAFF,1,0,1,1
TRBV24-1,TRBJ1-5,CATSAEGGGLQPQHF,1,0,1,1
TRBV12-3/4,TRBJ2-2,CASSVGLAGFGELFF,2,0,1,2
TRBV6-4,TRBJ2-2,CASSGLAGDTGELFF,1,0,1,1
TRBV3-1,TRBJ1-5,CASSQGLQSAQPQHF,1,0,1,1
TRBV4-1,TRBJ1-1,CASSQVSSQVAEAFF,1,0,1,1
TRBV20-1,TRBJ2-5,CSARDTGVGQETQYF,1,0,1,1
TRBV15,TRBJ1-5,CATRGSGGNQPQHF,1,0,1,1
TRBV19,TRBJ2-5,CASSKGQGIETQYF,1,0,1,1
TRBV28,TRBJ1-2,CASSWTGRRYGYTF,1,0,1,1
TRBV28,TRBJ2-5,CASSQTRPQETQYF,1,0,1,1
TRBV5-1,TRBJ2-7,CASSYTPGAYEQYF,1,0,1,1
TRBV5-1,TRBJ2-2,CASSLRDGTGELFF,1,0,1,1
TRBV5-1,TRBJ1-4,CASSPDGVNEKLFF,1,0,1,1
TRBV20-1,TRBJ2-2,CSARDPGTAGELFF,1,0,1,1
TRBV29-1,TRBJ1-5,CSVAGGSSNQPQHF,1,0,1,1
TRBV2,TRBJ1-4,CASSVQGTEKLFF,1,0,1,1
TRBV11-2,TRBJ1-2,CASSLDRGSGYTF,2,0,1,2
TRBV5-4,TRBJ1-2,CASSSYRGDGYTF,1,0,1,1
TRBV7-9,TRBJ1-2,CASSRDGSYGYTF,2,3,2,5
TRBV3-1,TRBJ2-3,CASSQGVTDTQYF,2,0,1,2
TRBV20-1,TRBJ2-7,CSLEEPSSYEQYF,2,0,1,2
TRBV29-1,TRBJ1-1,CSVESNKNTEAFF,1,0,1,1
TRBV2,TRBJ1-3,CASGFNEHTIYF,2,0,1,2
TRBV7-9,TRBJ1-4,CASSSPDEKLFF,1,0,1,1
TRBV30,TRBJ2-2,CAWSGTGELFF,2,0,1,2
TRBV6-1,TRBJ1-6,CASSVNSPLHF,1,0,1,1
TRBV5-1,TRBJ2-1,CASSSGRGRSSYNEQFF,1,0,1,1
TRBV7-9,TRBJ2-1,CASSGSSGDGFNEQFF,3,0,1,3
TRBV5-1,TRBJ1-5,CASSQLRDSGSQPQHF,1,0,1,1
TRBV19,TRBJ1-1,CASSPLSRALNTEAFF,2,0,1,2
TRBV19,TRBJ2-1,CASSIVGLAAYNEQFF,1,0,1,1
TRBV18,TRBJ1-5,CASSPNPGPESSPQHF,1,0,1,1
TRBV12-3/4,TRBJ2-7,CASSYGTFIQSEQYF,1,0,1,1
TRBV5-1,TRBJ2-1,CAGSLGQRGGNEQFF,1,0,1,1
TRBV19,TRBJ2-3,CASSTGLAGGYTDTQYF,1,0,1,1
TRBV3-1,TRBJ2-3,CASSGRLGRGNIDTQYF,3,0,1,3
TRBV19,TRBJ1-2,CASSGSPGTGFDGYTF,1,0,1,1
TRBV6-2/3/5/6,TRBJ1-2,CASITPGQVPLYGYTF,1,0,1,1
TRBV6-1,TRBJ1-5,CASSEFGASRNQPQHF,1,0,1,1
TRBV7-2,TRBJ1-1,CASSLDFVGLVTEAFF,2,0,1,2
TRBV20-1,TRBJ1-3,CSARDGGTGSGNTIYF,1,0,1,1
TRBV20-1,TRBJ1-5,CSARDGGGVGNQPQHF,1,0,1,1
TRBV29-1,TRBJ1-1,CSAPLGGLAVGTEAFF,2,0,1,2
TRBV12-3/4,TRBJ2-1,CASSLGRGVVGEQFF,1,1,2,2
TRBV3-1,TRBJ2-1,CASSQGLAVYNEQFF,1,0,1,1
TRBV7-9,TRBJ2-1,CASSLGQGARNEQFF,1,0,1,1
TRBV7-2,TRBJ2-3,CASSPSGGSPDTQYF,2,1,2,3
TRBV13,TRBJ2-1,CASSHTESSYNEQFF,1,0,1,1
TRBV14,TRBJ2-7,CASSQTVTSGGEQYF,1,0,1,1
TRBV20-1,TRBJ1-2,CSARDGSGGNYGYTF,1,0,1,1
TRBV30,TRBJ2-7,CAWSVPGQPYEQYF,2,2,2,4
TRBV19,TRBJ2-7,CASSIGQGKNEQYF,1,0,1,1
TRBV28,TRBJ2-1,CASSFRGVGNEQFF,1,0,1,1
TRBV6-2/3/5/6,TRBJ1-5,CASSLGQGHQPQHF,2,0,1,2
TRBV6-2/3/5/6,TRBJ1-1,CASSYDRERNRAFF,1,0,1,1
TRBV7-8,TRBJ1-6,CASSPGTGNSPLHF,1,0,1,1
TRBV3-1,TRBJ2-7,CASSQRQDSYEQYF,1,0,1,1
TRBV6-1,TRBJ1-6,CASRETVYNSPLHF,1,0,1,1
TRBV12-3/4,TRBJ2-5,CASKSRRESVTQYF,1,0,1,1
TRBV5-1,TRBJ1-1,CASLTGRGNTEAFF,1,0,1,1
TRBV5-1,TRBJ2-7,CASTPTSITYEQYF,1,0,1,1
TRBV20-1,TRBJ2-2,CSASPGQTYGELFF,2,0,1,2
TRBV20-1,TRBJ1-1,CSARDNDRVAEAFF,1,0,1,1
TRBV12-3/4,TRBJ2-3,CASSLGSTDTQYF,2,0,1,2
TRBV3-1,TRBJ1-2,CASSQRGNYGYTF,2,0,1,2
TRBV5-1,TRBJ1-2,CASSPGQNYGYTF,1,0,1,1
TRBV29-1,TRBJ2-3,CSGGALSTDTQYF,1,0,1,1
TRBV20-1,TRBJ1-5,CSARDRDQPQHF,1,0,1,1
TRBV20-1,TRBJ2-7,CSAPFTYEQYF,1,0,1,1
TRBV4-1,TRBJ1-5,CASSPQDRGSWSNQPQHF,1,0,1,1
TRBV7-2,TRBJ2-1,CASSHVASGVINEQFF,1,0,1,1
TRBV9,TRBJ2-3,CASSVADTQYF,3,4,2,7
TRBV29-1,TRBJ1-2,CSVVDLRDSRNYGYTF,1,0,1,1
TRBV18,TRBJ2-7,CASSPGTGMYERYF,2,0,1,2
TRBV4-2,TRBJ2-7,CASSQDRAGQTTNYEQYF,1,0,1,1
TRBV6-2/3/5/6,TRBJ2-2,CASSFLPGTPNTGELFF,1,0,1,1
TRBV6-2/3/5/6,TRBJ1-1,CASSPRGTGLMNTEAFF,1,0,1,1
TRBV5-6,TRBJ1-5,CASSPGRRFLSNQPQHF,1,0,1,1
TRBV20-1,TRBJ1-5,CSARDLGTAGVNQPQHF,2,0,1,2
TRBV15,TRBJ2-1,CATSQTGKVSYNEQFF,1,0,1,1
TRBV12-3/4,TRBJ2-2,CASSIGGAVHTGELFF,1,0,1,1
TRBV24-1,TRBJ2-7,CATSDLGTGGYEQYF,2,1,2,3
TRBV19,TRBJ2-1,CASSIGLVRTNEQFF,1,0,1,1
TRBV7-2,TRBJ2-7,CASSLGKGGNYEQYY,2,0,1,2
TRBV27,TRBJ2-1,CASSLISGGINEQFF,1,0,1,1
TRBV4-1,TRBJ1-3,CATSSGLHSGNTIYF,1,0,1,1
TRBV5-1,TRBJ2-5,CASSLQRGPQETQYF,1,0,1,1
TRBV20-1,TRBJ1-3,CSAEDGQLSGNTIYF,1,0,1,1
TRBV12-5,TRBJ2-1,CASALQGSFDEQFF,1,0,1,1
TRBV30,TRBJ1-1,CAWSVGIMNTEAFF,1,0,1,1
TRBV10-3,TRBJ2-3,CAISPGGSTDTQYF,1,0,1,1
TRBV12-3/4,TRBJ2-7,CASSFDRGPYEQYF,1,1,2,2
TRBV2,TRBJ2-4,CASSGVLAKNIQYF,1,0,1,1
TRBV7-9,TRBJ2-7,CASSLATGGDEQYF,1,0,1,1
TRBV7-6,TRBJ2-2,CASSLLGTAGELFF,1,1,2,2
TRBV7-2,TRBJ1-1,CASSSGTGSYEAFF,1,0,1,1
TRBV5-6,TRBJ2-5,CASSLRPQGETQYF,1,0,1,1
TRBV7-8,TRBJ2-5,CASSATGGQETQYF,1,0,1,1
TRBV5-8,TRBJ1-1,CASSDRTANTEAFF,1,0,1,1
TRBV29-1,TRBJ1-6,CSVAVTGDNSPLHF,1,0,1,1
TRBV29-1,TRBJ2-1,CSVEDGLALNEQFF,1,0,1,1
TRBV30,TRBJ1-5,CAWSGQSNQPQHF,1,0,1,1
TRBV28,TRBJ2-7,CASSTGYSYEQYF,2,0,1,2
TRBV12-3/4,TRBJ1-1,CASASLGNTEAFF,1,0,1,1
TRBV7-3,TRBJ1-2,CASGRDGSYGYTF,1,0,1,1
TRBV2,TRBJ1-1,CASTGQGFTEAFF,1,0,1,1
TRBV2,TRBJ1-1,CASSLDSNTEAFF,1,0,1,1
TRBV5-6,TRBJ2-5,CASSTVSQETQYF,1,0,1,1
TRBV12-3/4,TRBJ2-5,CASSTTSKETQYF,1,0,1,1
TRBV6-2/3/5/6,TRBJ1-1,CASSSARAEKAFF,1,0,1,1
TRBV7-2,TRBJ2-7,CASSLVQNYEQHF,1,0,1,1
TRBV5-1,TRBJ1-2,CASSLDSGGGYTF,1,0,1,1
TRBV4-1,TRBJ1-1,CASSLGIGTTAFF,1,0,1,1
TRBV29-1,TRBJ2-6,CSVSGQGPNVLTF,1,0,1,1
TRBV12-3/4,TRBJ1-1,CASSLGGVEAFF,1,0,1,1
TRBV27,TRBJ1-1,CASSPQGQEAFF,2,0,1,2
TRBV5-5,TRBJ1-4,CASSRGYEKLFF,1,0,1,1
TRBV4-2,TRBJ1-2,CASSQDAYGYTF,1,2,2,3
TRBV12-3/4,TRBJ2-3,CASRGLARTQYF,1,0,1,1
TRBV2,TRBJ2-7,CASGEFEQGYF,2,0,1,2
TRBV13,TRBJ1-6,CASSSNSPLHF,1,0,1,1
TRBV7-2,TRBJ1-1,CASSSSYEAFF,2,0,1,2
TRBV12-3/4,TRBJ2-3,CASSLEGDFTDTQYF,2,0,1,2
TRBV2,TRBJ2-5,CASSDGGQAGETQYF,1,0,1,1
TRBV7-2,TRBJ1-3,CASSLQGASGNTIYF,2,0,1,2
TRBV13,TRBJ1-1,CGSSSGRNTEAFF,1,0,1,1
TRBV7-9,TRBJ2-3,CAMPSAPGGTDTQYF,1,0,1,1
TRBV7-2,TRBJ2-2,CASSPRQGFTGELFF,1,0,1,1
TRBV12-3/4,TRBJ1-1,CASSPGGQGRTEAFF,1,0,1,1
TRBV15,TRBJ1-1,CATSTGGPNTEAFF,1,0,1,1
TRBV19,TRBJ2-1,CASGGTTFYNEQFF,1,0,1,1
TRBV20-1,TRBJ1-2,CSARPPGRSYGYTF,1,0,1,1
TRBV18,TRBJ2-5,CASSPSGPASQYF,2,0,1,2
TRBV5-1,TRBJ1-4,CASSIGPPGTNEKLFF,1,0,1,1
TRBV29-1,TRBJ1-4,CSVAGTGGSTNEKLYF,2,0,1,2
TRBV5-6,TRBJ2-5,CASSFLPGGEETQYF,2,0,1,2
TRBV7-3,TRBJ2-1,CASSLDRNNKQFF,1,0,1,1
TRBV7-2,TRBJ2-7,CASSLRGAYEQYF,1,0,1,1
TRBV5-1,TRBJ2-7,CASSLPGQYEQYF,1,0,1,1
TRBV4-1,TRBJ2-2,CASSQWWGPGDSYTGELFF,2,0,1,2
TRBV7-9,TRBJ2-1,CASRPPPRLARSNEQFF,1,0,1,1
TRBV29-1,TRBJ2-1,CSVEVLPGQGAYDEQFF,1,0,1,1
TRBV24-1,TRBJ1-6,CATSDLQGAGNSPLHF,1,0,1,1
TRBV24-1,TRBJ2-2,CATSDDGMTYTGELFF,1,0,1,1
TRBV18,TRBJ2-5,CASSPPGLASQETQYF,2,0,1,2
TRBV11-3,TRBJ2-3,CASTSGSGGPGDTLYF,1,0,1,1
TRBV28,TRBJ1-5,CASTKMAGQRNQPQHF,1,0,1,1
TRBV27,TRBJ2-5,CASSLVWGLPQETQYF,1,0,1,1
TRBV7-6,TRBJ2-1,CASSPRGLSSYNEQFF,1,0,1,1
TRBV7-9,TRBJ2-1,CASSPHRTSGGDEQFF,1,0,1,1
TRBV27,TRBJ2-3,CASSTSSGGSTDTQYF,1,0,1,1
TRBV20-1,TRBJ1-1,CSARDGSGFMNTEAFF,1,0,1,1
TRBV18,TRBJ2-5,CASSPSGVGMETQYF,1,0,1,1
TRBV18,TRBJ2-7,CASSPPMGQGYEQYF,2,0,1,2
TRBV19,TRBJ2-3,CASQGTGRRRDTQYF,2,0,1,2
TRBV6-4,TRBJ2-3,CASGGLFISTDTQYF,1,0,1,1
TRBV12-3/4,TRBJ2-1,CASSPTGVSYNEQFF,2,0,1,2
TRBV5-6,TRBJ2-3,CASSPGTENTDTQYF,1,0,1,1
TRBV5-6,TRBJ1-1,CASSFQSVMSTEAFF,1,0,1,1
TRBV5-6,TRBJ1-2,CASSLWDREVYGYTF,1,0,1,1
TRBV5-6,TRBJ2-3,CASSLGGGSTDTQYF,3,0,1,3
TRBV7-9,TRBJ2-2,CASSLAGQASGELFF,1,0,1,1
TRBV7-2,TRBJ2-7,CASSPTPVASYEQYF,1,0,1,1
TRBV14,TRBJ2-7,CASSQGGSIPYEQYF,1,0,1,1
TRBV4-2,TRBJ2-1,CASSQDKGGYNEQFF,1,0,1,1
TRBV14,TRBJ2-3,CASSQTGASTDTQYF,1,0,1,1
TRBV9,TRBJ2-3,CASSVGALGPDTQYF,1,0,1,1
TRBV5-6,TRBJ2-2,CASSETGTLFGELFF,1,0,1,1
TRBV12-3/4,TRBJ1-4,CASRPKAGGPEKLFF,1,0,1,1
TRBV6-2/3/5/6,TRBJ2-5,CASRREIRYQETQYF,1,0,1,1
TRBV4-1,TRBJ1-5,CASSSSQGSNQPQHF,1,0,1,1
TRBV20-1,TRBJ1-1,CSARDLIGGKTEAFF,1,1,2,2
TRBV29-1,TRBJ2-3,CSVGPTLGRTDTQYF,1,0,1,1
TRBV12-5,TRBJ2-2,CASGLGRNTGELFF,1,0,1,1
TRBV19,TRBJ2-2,CASTLDRAGGELFF,1,0,1,1
TRBV19,TRBJ1-5,CASSTRQSRVPPHF,1,0,1,1
TRBV19,TRBJ2-2,CASAQGANTGELFF,2,0,1,2
TRBV6-2/3/5/6,TRBJ2-1,CASSFMSGVYEQFF,1,0,1,1
TRBV6-2/3/5/6,TRBJ2-7,CASSFRRSSYEQYF,1,0,1,1
TRBV28,TRBJ1-2,CASSLGTGLYGYTF,1,0,1,1
TRBV12-3/4,TRBJ1-5,CASSLGTGNQPQHF,1,0,1,1
TRBV5-5,TRBJ1-3,CASSLNQAGNTIYF,1,0,1,1
TRBV11-3,TRBJ2-3,CASSLERPLGRQYF,2,0,1,2
TRBV3-1,TRBJ1-1,CASSPRDGNTEAFF,1,0,1,1
TRBV3-1,TRBJ2-5,CASSQVYGGVTQYF,1,0,1,1
TRBV12-3/4,TRBJ2-3,CASKERGRLDTQYF,1,0,1,1
TRBV5-1,TRBJ1-1,CASSLGSGNTEAFF,1,0,1,1
TRBV4-1,TRBJ2-1,CASSLGGEYNEQFF,1,0,1,1
TRBV5-1,TRBJ1-2,CASSVQGANYGYTF,1,0,1,1
TRBV20-1,TRBJ2-1,CSASTGDNFNEQFF,2,0,1,2
TRBV29-1,TRBJ2-2,CSVYRDQDTGELFF,1,0,1,1
TRBV30,TRBJ1-6,CAWMGQGTSPLHF,1,0,1,1
TRBV19,TRBJ1-5,CASSRVSNQPQHF,1,0,1,1
TRBV19,TRBJ2-5,CASSNSDQETQYF,1,0,1,1
TRBV2,TRBJ2-5,CASIGREQETQYF,1,0,1,1
TRBV7-6,TRBJ1-2,CASSLGRGYGYTF,1,0,1,1
TRBV7-2,TRBJ1-1,CASSLTGGTEAFF,1,2,2,3
TRBV3-1,TRBJ1-1,CASSLRLEGLTFF,1,0,1,1
TRBV13,TRBJ1-2,CASSSRSTGINAF,1,0,1,1
TRBV7-9,TRBJ2-1,CASSYQAGGEQFF,1,0,1,1
TRBV7-2,TRBJ1-2,CASSTVINYGYTF,1,0,1,1
TRBV7-9,TRBJ1-3,CASRGMAGNTIYF,1,0,1,1
TRBV20-1,TRBJ1-4,CSTNTGGNEKLFF,1,0,1,1
TRBV29-1,TRBJ1-1,CSAEARGGTEAFF,1,0,1,1
TRBV29-1,TRBJ2-5,CSAAPGQLETQYF,1,0,1,1
TRBV30,TRBJ1-1,CAWTGPNTEAFF,1,0,1,1
TRBV19,TRBJ2-1,CASSTFPREQFF,1,0,1,1
TRBV19,TRBJ2-3,CASRISGDTQYF,2,0,1,2
TRBV12-3/4,TRBJ1-2,CASSPRPRPYTF,1,0,1,1
TRBV7-2,TRBJ2-1,CASSSYNNEQFF,2,1,2,3
TRBV7-2,TRBJ1-2,CASSWDSDGYTF,1,0,1,1
TRBV5-4,TRBJ2-1,CASSGIYDEQFF,1,0,1,1
TRBV20-1,TRBJ1-1,CSARQGDPEAFF,1,0,1,1
TRBV20-1,TRBJ1-5,CSAQGINQPQHF,1,0,1,1
TRBV12-3/4,TRBJ2-2,CASLLAGELFF,1,0,1,1
TRBV12-3/4,TRBJ1-1,CASSLVEKAFF,1,0,1,1
TRBV6-2/3/5/6,TRBJ2-7,CASSPSYEQYF,1,0,1,1
TRBV27,TRBJ2-3,CASSLYASGRGDTDTQYF,1,0,1,1
TRBV15,TRBJ2-1,CATSNFVRGGNDEQFF,1,0,1,1
TRBV29-1,TRBJ2-5,CSVEDGWTGGGETQYF,1,0,1,1
TRBV7-9,TRBJ1-5,CASSLAGDSNQPQHF,1,0,1,1
TRBV2,TRBJ2-2,CASSARTVTGELFF,1,0,1,1
TRBV6-2/3/5/6,TRBJ1-1,CASNPGGLNTEAFF,1,0,1,1
TRBV3-1,TRBJ1-5,CASSPDGYQPQHS,1,0,1,1
TRBV29-1,TRBJ2-1,CSVEITRQEQFF,2,1,2,3
TRBV7-9,TRBJ2-2,CASTPGYPLNTGELFF,2,0,1,2
TRBV19,TRBJ2-3,CASSIEDTTDTQYS,2,0,1,2
TRBV4-3,TRBJ1-5,CASSQESRGKPQHF,1,0,1,1
TRBV20-1,TRBJ1-1,CSARGVPMNTEAFF,1,0,1,1
TRBV7-2,TRBJ2-1,CASSLDHNEQFF,2,0,1,2
TRBV5-1,TRBJ1-2,CASSPSGRPPLANYGYTF,1,0,1,1
TRBV11-2,TRBJ1-2,CASSKTGDKGYGYTF,1,0,1,1
TRBV7-8,TRBJ2-7,CASSSPTVQRRYF,3,0,1,3
TRBV29-1,TRBJ2-7,CSVEAGQWHEQYF,1,0,1,1
TRBV5-1,TRBJ2-1,CASWGAYNEQFF,2,4,2,6
TRBV5-6,TRBJ2-7,CAGSYSYEQYF,1,0,1,1
TRBV28,TRBJ1-5,CASSFKGQGAGVSNQPQHF,2,0,1,2
TRBV2,TRBJ1-5,CASSVSRTGGSFSNQPQHF,1,1,2,2
TRBV10-3,TRBJ2-4,CAISPRAGTSEGKNIQYF,1,0,1,1
TRBV18,TRBJ2-2,CASSPLPAGADNTGELFF,1,0,1,1
TRBV5-1,TRBJ2-7,CASSSPTSGGPTYEQYF,1,0,1,1
TRBV20-1,TRBJ2-3,CSASQADLFFSTDTQYL,1,0,1,1
TRBV20-1,TRBJ1-5,CSAHISAGGYSNQPQHF,1,0,1,1
TRBV19,TRBJ1-1,CASSNRDSGFTTEAFF,1,0,1,1
TRBV18,TRBJ1-4,CASSPMAGQGNEKLFF,1,0,1,1
TRBV2,TRBJ1-2,CASHPRGSIVNYGYTF,1,0,1,1
TRBV6-2/3/5/6,TRBJ2-6,CASSYGERSGANVLTF,1,0,1,1
TRBV3-1,TRBJ2-2,CASSRRDRLNTGELFF,1,0,1,1
TRBV7-2,TRBJ2-1,CASSLGGTRSYNEQFF,1,1,2,2
TRBV7-9,TRBJ2-7,CASSLALTGDKYEQYF,1,0,1,1
TRBV5-4,TRBJ2-2,CASSLGRGGRTGELFF,2,0,1,2
TRBV13,TRBJ2-1,CASSPPGDPVRNEQFF,2,0,1,2
TRBV14,TRBJ2-3,CASSELGAGGLDTQYF,1,0,1,1
TRBV5-1,TRBJ2-3,CASSFGSGASTDTQYF,1,0,1,1
TRBV4-1,TRBJ2-1,CASSLRTVGSYNEQFF,1,0,1,1
TRBV4-1,TRBJ2-7,CASSQVTGQGNDEQYF,1,0,1,1
TRBV18,TRBJ1-1,CASSETGTSRTEAFF,1,0,1,1
TRBV18,TRBJ1-1,CASSPNGILNTEAFF,1,0,1,1
TRBV19,TRBJ2-2,CASRQGARSTGELFF,1,0,1,1
TRBV12-3/4,TRBJ1-5,CASSFRDRNGPPQHF,1,0,1,1
TRBV6-2/3/5/6,TRBJ1-3,CASSLGSGSGNTIYF,1,0,1,1
TRBV27,TRBJ2-3,CASSYSGQSTDTQYF,1,0,1,1
TRBV28,TRBJ2-7,CASSPQIGQGYEQYF,1,0,1,1
TRBV25-1,TRBJ1-3,CASSGELSSGNTIYF,1,1,2,2
TRBV5-6,TRBJ2-3,CASSLSTGVIDTQYF,1,0,1,1
TRBV9,TRBJ2-7,CASSLGQGSSYEQYF,1,0,1,1
TRBV3-1,TRBJ2-3,CASSPLSGGTDTQYF,1,0,1,1
TRBV3-1,TRBJ1-2,CASSPPGAPNYGYTF,1,0,1,1
TRBV5-4,TRBJ2-3,CASSRTSGSTDTQYF,1,0,1,1
TRBV7-6,TRBJ2-5,CASSQDYSRGETQYF,1,0,1,1
TRBV6-1,TRBJ1-4,CASRMRESTNEKLFF,1,0,1,1
TRBV12-3/4,TRBJ1-1,CASRPYWADGTEAFF,1,0,1,1
TRBV10-2,TRBJ2-1,CASMLEAGGRNEQFF,1,0,1,1
TRBV5-1,TRBJ2-3,CASSSEEGGGDTQYF,1,0,1,1
TRBV5-1,TRBJ1-5,CASSLDGGRNQPQHF,1,0,1,1
TRBV4-1,TRBJ2-3,CASSQDEGVRDTQYF,1,0,1,1
TRBV5-1,TRBJ1-5,CASSAGGHSNQPQHF,1,1,2,2
TRBV20-1,TRBJ2-1,CSAGDVEGAINEQFF,1,0,1,1
TRBV20-1,TRBJ2-5,CSASDLLGGWETQYF,1,0,1,1
TRBV20-1,TRBJ2-3,CSAPGQPLGKDTQYF,1,0,1,1
TRBV29-1,TRBJ2-3,CSVAHRSAGTDTQYF,1,0,1,1
TRBV29-1,TRBJ2-7,CSVEDPGTGTYEQYF,1,0,1,1
TRBV19,TRBJ1-1,CASKTGRLNTEAFF,1,0,1,1
TRBV18,TRBJ1-1,CASSVGQMNTEAFF,1,0,1,1
TRBV6-2/3/5/6,TRBJ2-1,CASIEGRGYNEQFF,1,0,1,1
TRBV28,TRBJ1-4,CASISGQAVEKLFF,1,0,1,1
TRBV6-2/3/5/6,TRBJ1-5,CASSFVAERQPQHF,1,0,1,1
TRBV6-2/3/5/6,TRBJ1-2,CASSYSATGNGYTF,1,0,1,1
TRBV28,TRBJ1-2,CASSPLAGGYGYTF,2,0,1,2
TRBV7-9,TRBJ1-2,CASSQGASNYGYTF,1,0,1,1
TRBV6-1,TRBJ2-3,CASSVASGWDTQYF,1,0,1,1
TRBV7-2,TRBJ2-4,CASSLSDSKNIQYF,1,0,1,1
TRBV5-4,TRBJ2-5,CASSLAGVQETQYF,1,0,1,1
TRBV11-2,TRBJ1-5,CASSSGQFNQPQHF,1,0,1,1
TRBV12-3/4,TRBJ1-2,CASSPGHANYGYTF,1,0,1,1
TRBV5-4,TRBJ2-7,CASSPWAGAYEQYF,1,0,1,1
TRBV7-2,TRBJ2-7,CASSPGQGGYEQYF,1,0,1,1
TRBV3-1,TRBJ2-1,CASSRSGGSNEQFF,1,0,1,1
TRBV5-4,TRBJ1-2,CASSQRDRFYGYTF,1,0,1,1
TRBV14,TRBJ2-7,CASSQEATLGEQYF,1,0,1,1
TRBV9,TRBJ1-6,CASSVGPHNSPLHF,2,0,1,2
TRBV5-1,TRBJ1-2,CASSLEGANYGYTF,1,0,1,1
TRBV20-1,TRBJ2-4,CSAPPRLAKNIQYF,1,0,1,1
TRBV20-1,TRBJ2-7,CSASGQGTAYEQYF,1,0,1,1
TRBV29-1,TRBJ2-1,CSDVRGGVNNEQFF,1,0,1,1
TRBV2,TRBJ2-2,RAIAGGENTGELFF,1,0,1,1
TRBV30,TRBJ2-1,CAWGRKAEIEQFF,1,0,1,1
TRBV30,TRBJ1-1,CAWNERLNTEAFF,1,0,1,1
TRBV19,TRBJ2-7,CASSIRSSYEQYF,1,0,1,1
TRBV19,TRBJ1-5,CASLGGGNQPQHF,1,0,1,1
TRBV27,TRBJ1-2,CASGGQGIIGYTF,1,1,2,2
TRBV27,TRBJ2-7,CASGTGPSYEQYF,1,0,1,1
TRBV12-3/4,TRBJ1-2,CASSLSSSYGYTF,1,0,1,1
TRBV6-2/3/5/6,TRBJ1-1,CASSQGGNTEAFF,1,0,1,1
TRBV6-1,TRBJ1-4,CASSVQGPEKLFF,1,0,1,1
TRBV7-2,TRBJ2-7,CASSLGTVYEQYF,1,0,1,1
TRBV7-2,TRBJ2-3,CASSSALRDNENF,1,0,1,1
TRBV7-6,TRBJ2-7,CASSRGSSYEQYF,1,0,1,1
TRBV6-2/3/5/6,TRBJ1-1,CASSRDSYTEAFF,1,0,1,1
TRBV7-2,TRBJ2-7,CASSRDRDYEQYF,1,0,1,1
TRBV7-9,TRBJ1-1,CASSQTVNTEAFF,1,0,1,1
TRBV7-2,TRBJ2-5,CASSQNPRQTQYF,1,0,1,1
TRBV7-9,TRBJ1-1,CASSQRGNTEAFF,1,0,1,1
TRBV3-1,TRBJ2-5,CASSQGGAQLQYF,1,0,1,1
TRBV5-1,TRBJ2-3,CASSPGAEETQYF,1,0,1,1
TRBV10-1,TRBJ1-1,CASSVTANTEAFF,2,0,1,2
TRBV20-1,TRBJ2-3,CSALTGGTDTQYF,1,0,1,1
TRBV20-1,TRBJ1-4,CSAIYSGSEKLFF,1,1,2,2
TRBV20-1,TRBJ2-7,CSARDENSYEQYF,1,0,1,1
TRBV29-1,TRBJ2-7,CSVLDQGVGEQYF,1,0,1,1
TRBV29-1,TRBJ2-1,CSVEVQGYSEQFF,1,0,1,1
TRBV19,TRBJ1-5,CATGQGNQPQHF,1,0,1,1
TRBV18,TRBJ2-1,CASSATHAEQFF,1,0,1,1
TRBV28,TRBJ1-2,CASSSQGGGYTF,1,0,1,1
TRBV7-2,TRBJ2-3,CASSPLQDTQYF,1,0,1,1
TRBV3-1,TRBJ2-1,CASSQDPREQFF,1,0,1,1
TRBV6-2/3/5/6,TRBJ1-6,CASSGSRSPLHF,1,0,1,1
TRBV20-1,TRBJ1-2,CSASADNYGYTF,1,0,1,1
TRBV29-1,TRBJ2-3,CSVTPGTDTQYF,1,0,1,1
TRBV29-1,TRBJ2-5,CSVTLIGETQYF,1,0,1,1
TRBV29-1,TRBJ2-7,CSTRESSYEQYF,2,0,1,2
TRBV30,TRBJ2-3,CAWSVGDKQYF,1,0,1,1
TRBV24-1,TRBJ2-1,CATGVYNEQFF,1,0,1,1
TRBV6-2/3/5/6,TRBJ1-2,CASSRGFDYTF,1,0,1,1
TRBV10-1,TRBJ1-1,CASSRGTEAFF,1,0,1,1
TRBV10-2,TRBJ2-7,CASLGYEQYF,1,1,2,2
TRBV12-3/4,TRBJ1-5,CASTFSGARNQPQHF,1,0,1,1
TRBV30,TRBJ2-7,CAWSVLQGAYEQYF,1,0,1,1
TRBV5-1,TRBJ2-5,CASSPGYQETQYF,1,0,1,1
TRBV6-2/3/5/6,TRBJ1-5,CASSYSWFPSNSNQPQHF,1,0,1,1
TRBV3-1,TRBJ1-2,CASSQDLGTPGSYGYTF,1,0,1,1
TRBV7-2,TRBJ2-1,CASTLTGSSYNEHFF,1,0,1,1
TRBV5-4,TRBJ2-7,CASSFRGAASYEQYF,1,0,1,1
TRBV9,TRBJ1-5,CASGSPNQPQHF,1,0,1,1
TRBV7-9,TRBJ2-7,CASSFGLYEQYF,2,0,1,2
TRBV7-2,TRBJ2-3,CASSLEGGQYF,1,0,1,1
TRBV7-9,TRBJ2-5,CASSRNHQEGRRANQETQYF,2,0,1,2
TRBV29-1,TRBJ2-2,CSVINLPRRLLRGNTGELFF,1,0,1,1
TRBV7-2,TRBJ2-1,CASSPKRGGDPSSYNEQFF,1,0,1,1
TRBV7-2,TRBJ2-3,CASSRMSSGGTTYTDTQYF,1,0,1,1
TRBV3-1,TRBJ1-5,CASSQRPMVGLNSNQPQHF,2,0,1,2
TRBV12-3/4,TRBJ2-2,CASRLNARGLETLRGELFF,1,0,1,1
TRBV6-2/3/5/6,TRBJ1-4,CASSFGGNRARAGEKLFF,1,0,1,1
TRBV6-1,TRBJ2-3,CASSVLAGGSRRTDTQYF,1,0,1,1
TRBV3-1,TRBJ1-5,CASSLGGSHRGRGQPQHF,1,0,1,1
TRBV7-2,TRBJ2-2,CASSQSLAGGSYVGELFF,1,0,1,1
TRBV3-1,TRBJ1-2,CASSQDGLTGGGDYGYTF,1,0,1,1
TRBV5-1,TRBJ1-5,CASSPGQGSSIVDQPQHF,1,0,1,1
TRBV20-1,TRBJ2-5,CSARVVRPPGGAQETQYF,1,0,1,1
TRBV28,TRBJ1-1,CASSLSGNNYRASETFF,1,0,1,1
TRBV6-2/3/5/6,TRBJ2-5,CASSYWASGGARETQYF,1,1,2,2
TRBV2,TRBJ2-1,CASSPIRGVSSYNEQFF,1,0,1,1
TRBV5-6,TRBJ1-5,CASSLRTGGESNQPQHF,1,0,1,1
TRBV12-3/4,TRBJ2-7,CASSPWTSGGTHYEQYF,1,1,2,2
TRBV4-2,TRBJ2-7,CASSRGLAGGSSYEQYF,1,0,1,1
TRBV5-1,TRBJ2-2,CASSLTSGGPNTGELFF,1,0,1,1
TRBV19,TRBJ1-3,CASTRLTPNSGNTIYF,1,0,1,1
TRBV19,TRBJ1-5,CASSIQGRGIFQPQHF,1,0,1,1
TRBV6-2/3/5/6,TRBJ2-2,CASSSPSGGGPGELFF,1,1,2,2
TRBV6-2/3/5/6,TRBJ1-4,CASSRRTGPTNEKLFF,1,0,1,1
TRBV6-4,TRBJ1-2,CASSDSSGGARYGYTF,1,0,1,1
TRBV5-8,TRBJ2-3,CASSFWGSGGTDTQYF,1,0,1,1
TRBV7-3,TRBJ2-5,CASSFVHSGDQETQYF,1,0,1,1
TRBV7-2,TRBJ1-4,CASSLSLLTTNEKLFF,1,0,1,1
TRBV12-3/4,TRBJ1-5,CASSWLQGNSNQPQHF,1,0,1,1
TRBV3-1,TRBJ2-4,CASSPSGDRGGNIQYF,2,0,1,2
TRBV3-1,TRBJ1-6,CASSRQGNSYNSPLHF,1,0,1,1
TRBV3-1,TRBJ2-7,CASSQEMTSGYYEQYF,1,0,1,1
TRBV4-2,TRBJ1-5,CASSQESQYSNQPQHF,1,0,1,1
TRBV11-2,TRBJ1-2,CASSMTGTGGANGYTF,2,0,1,2
TRBV7-2,TRBJ2-3,CASSTRGSVGSHTQYF,1,0,1,1
TRBV2,TRBJ1-5,CTSSEFGASRNQPQHF,1,0,1,1
TRBV10-1,TRBJ2-1,CASSDFWGGSHNEQFF,2,0,1,2
TRBV5-1,TRBJ2-3,CASSLERQGFLGTQYF,1,0,1,1
TRBV5-1,TRBJ2-3,CASSRTSGGVTDTQYF,1,0,1,1
TRBV20-1,TRBJ1-2,CSARDQRTGVGYGYTF,1,0,1,1
TRBV29-1,TRBJ1-1,CSVEDLRGAQAAEAFF,1,0,1,1
TRBV7-2,TRBJ2-1,RASSLLRTRSYNEQFF,1,0,1,1
TRBV30,TRBJ2-4,CAWLDRSETKNIQYF,2,2,2,4
TRBV15,TRBJ1-5,CATSLDRALNKPQHF,1,0,1,1
TRBV19,TRBJ2-7,CASSMDASGEYEQYF,1,0,1,1
TRBV19,TRBJ2-7,CASSDRTGAVYEQYF,1,0,1,1
TRBV19,TRBJ1-4,CASRAPGRGNEKLFF,1,0,1,1
TRBV18,TRBJ1-2,CASSPLSTDGGGYTF,1,0,1,1
TRBV18,TRBJ1-5,CASSPPGQPNQAQHF,1,0,1,1
TRBV12-3/4,TRBJ2-2,CASSFFSGGSGELFF,1,0,1,1
TRBV12-3/4,TRBJ2-2,CASSFGPANTGELFF,1,0,1,1
TRBV12-3/4,TRBJ2-6,CASSFRGSGANVLTF,1,3,2,4
TRBV6-2/3/5/6,TRBJ2-1,CASSLGRGIYNEQFF,1,0,1,1
TRBV27,TRBJ1-4,CASSLGTGGNEKLFF,1,0,1,1
TRBV6-2/3/5/6,TRBJ1-1,CASSYEFVTGSEAFF,1,0,1,1
TRBV5-4,TRBJ2-5,CASSPSGRKQETQYF,1,0,1,1
TRBV6-2/3/5/6,TRBJ2-3,CASSPDRGGIDTQYF,1,0,1,1
TRBV6-1,TRBJ1-3,CASSAQTGPGNTIYF,1,0,1,1
TRBV6-4,TRBJ1-5,CASSTYRGGNQPQHF,1,0,1,1
TRBV7-9,TRBJ2-2,CASSLEGVYTGELFF,1,0,1,1
TRBV7-2,TRBJ2-3,CASSLLEFSTDTQYF,1,0,1,1
TRBV7-2,TRBJ2-7,CASSLVYRGRDEQYF,1,0,1,1
TRBV7-6,TRBJ2-1,CASSLAGTNTNEQFF,1,0,1,1
TRBV7-9,TRBJ2-1,CASSLDGSTYNEQFF,1,0,1,1
TRBV7-9,TRBJ2-5,CASSLDTGLRETQYF,1,0,1,1
TRBV5-4,TRBJ2-3,CASSWDRGGKDTQYF,1,0,1,1
TRBV7-2,TRBJ1-2,CASSLPSTGGKGYTF,1,0,1,1
TRBV5-4,TRBJ2-1,CASSPGQGKSNEQFF,1,0,1,1
TRBV3-1,TRBJ1-2,CASSPSSGINYGYTF,1,0,1,1
TRBV14,TRBJ2-3,CASSQQLAATDTQYF,1,0,1,1
TRBV4-2,TRBJ1-1,CASSQDWDMDTEAFF,1,0,1,1
TRBV12-3/4,TRBJ2-1,CASRRAGTYYNEQFF,1,0,1,1
TRBV28,TRBJ2-2,CASRIRELDTGELFF,1,0,1,1
TRBV12-3/4,TRBJ2-1,CANRPGGGAYNEQFF,1,0,1,1
TRBV10-2,TRBJ1-1,CASSDPQGGTTEAFF,1,0,1,1
TRBV5-1,TRBJ2-4,CASSTGGISKNIQYF,1,0,1,1
TRBV5-1,TRBJ1-6,CASSFESGVNSPLHF,1,0,1,1
TRBV5-1,TRBJ2-7,CASSLVPGSAYEQYF,1,0,1,1
TRBV5-1,TRBJ2-1,CASSLGDGPYNEQFF,1,1,2,2
TRBV5-1,TRBJ2-7,CASSSARTSGYEQYF,1,0,1,1
TRBV5-1,TRBJ1-6,CASSLGGGAYSPLHF,1,0,1,1
TRBV4-3,TRBJ2-1,CASSTDQRGSNEQFF,1,0,1,1
TRBV5-1,TRBJ2-2,CASRGGAQNTGELFF,1,0,1,1
TRBV10-2,TRBJ2-2,CASKGVGMNTGELFF,1,0,1,1
TRBV20-1,TRBJ2-3,CSAITGTGFTDTQYF,1,0,1,1
TRBV29-1,TRBJ2-3,CSLAGPLPSTDTQYF,1,0,1,1
TRBV30,TRBJ1-4,CAWSADRGTEKLFF,2,0,1,2
TRBV10-3,TRBJ2-2,CAISEAENTGELFF,1,0,1,1
TRBV10-3,TRBJ2-7,CAMASTSGTYEQYF,1,0,1,1
TRBV19,TRBJ1-1,CASSIFSGRDEAFF,1,0,1,1
TRBV18,TRBJ2-5,CASSKSGGQETQYF,1,0,1,1
TRBV2,TRBJ2-2,CASIGRRDPGELFF,1,0,1,1
TRBV28,TRBJ2-3,CASSFRGGPDTQYF,1,0,1,1
TRBV27,TRBJ2-1,CASSWQGPSNEQFF,1,0,1,1
TRBV12-3/4,TRBJ2-7,CASSYGTGHFEQYF,1,0,1,1
TRBV6-1,TRBJ2-7,CASSVGLGGYEQYF,1,0,1,1
TRBV2,TRBJ1-6,CASSELGVGSPLHF,1,0,1,1
TRBV7-9,TRBJ1-2,CASSLGVGSDGYTF,1,0,1,1
TRBV27,TRBJ1-5,CASSLTGGNQPQHF,1,0,1,1
TRBV16,TRBJ1-3,CASSPSRIGNTIYF,1,0,1,1
TRBV14,TRBJ2-7,CASSPHARGHEQYF,1,0,1,1
TRBV12-3/4,TRBJ1-6,CASSPNGPNSPLHF,1,0,1,1
TRBV3-1,TRBJ2-3,CASSRQGYTDTQYF,1,0,1,1
TRBV11-2,TRBJ1-5,CASSRDRGGEPQHF,1,0,1,1
TRBV4-2,TRBJ2-4,CASSQAAGTNIQCF,1,0,1,1
TRBV3-1,TRBJ2-1,CASSQGRDYNEQFF,2,0,1,2
TRBV5-4,TRBJ1-6,CASSQGQGDSPLHF,1,0,1,1
TRBV3-1,TRBJ2-5,CASSQSGTVDSQYF,1,0,1,1
TRBV6-2/3/5/6,TRBJ2-3,CASSAHEASDTQYF,1,0,1,1
TRBV7-9,TRBJ2-7,CASSEQGIPYEQYF,1,0,1,1
TRBV5-1,TRBJ1-6,CASSFDRKDSPLHF,1,0,1,1
TRBV2,TRBJ1-3,CASSGQGSGNTIYF,1,0,1,1
TRBV10-2,TRBJ1-1,CASSEPAGVTEAFF,1,0,1,1
TRBV5-1,TRBJ1-1,CASSLADTPTEAFF,1,0,1,1
TRBV5-1,TRBJ2-7,CASSLGSGANEQYF,1,0,1,1
TRBV5-1,TRBJ2-5,CASSDGGAQETQYF,1,0,1,1
TRBV20-1,TRBJ1-3,CSAVGTPSGNTIYF,1,0,1,1
TRBV20-1,TRBJ2-3,CSASRQGALDTQYF,1,0,1,1
TRBV20-1,TRBJ1-6,CSAPQQESNSPLHF,1,0,1,1
TRBV29-1,TRBJ2-1,CSVTGRGWFNEQFF,1,0,1,1
TRBV29-1,TRBJ2-7,CSVVRGTGSLEQYF,1,0,1,1
TRBV29-1,TRBJ2-5,CSAETSGGGETQYF,1,0,1,1
TRBV29-1,TRBJ1-1,CSDWGKTMNTEAFF,1,0,1,1
TRBV30,TRBJ1-2,CAWNDRVDYGYTF,1,0,1,1
TRBV19,TRBJ1-2,CASSDRRDRGYTF,1,0,1,1
TRBV19,TRBJ2-2,CASSIASAGELFF,1,0,1,1
TRBV18,TRBJ2-7,CASSDGQVYVQYF,1,0,1,1
TRBV12-3/4,TRBJ2-7,CASSFTSSDEQYF,2,3,2,5
TRBV12-3/4,TRBJ2-1,CASSLLRGDEQFF,1,0,1,1
TRBV5-5,TRBJ2-7,CASSQTGVWEQYF,1,0,1,1
TRBV7-6,TRBJ1-1,CASSLVEKAEAFF,2,0,1,2
TRBV7-9,TRBJ2-1,CASSSKDTRLQFF,1,0,1,1
TRBV3-1,TRBJ1-1,CASSSGRGTEAFF,1,0,1,1
TRBV14,TRBJ2-7,CASSPIASYEQYF,1,0,1,1
TRBV6-2/3/5/6,TRBJ2-2,CASSPGPSGVPFF,1,0,1,1
TRBV2,TRBJ1-5,CASSRGLGQPQHF,1,0,1,1
TRBV7-9,TRBJ1-1,CASSQTGASEAFF,1,0,1,1
TRBV7-9,TRBJ1-5,CASSQDSYQPQHF,1,0,1,1
TRBV6-2/3/5/6,TRBJ1-1,CASRGQGGTEAFF,2,0,1,2
TRBV5-1,TRBJ2-7,CASTPSGLREQYF,1,0,1,1
TRBV5-1,TRBJ2-7,CASSFGGYYEQYF,1,0,1,1
TRBV4-1,TRBJ2-7,CASSQGQGNEQYF,1,0,1,1
TRBV29-1,TRBJ1-5,CSVQGELNQPQHF,1,0,1,1
TRBV29-1,TRBJ1-6,CSVGTGDNSPLHF,1,0,1,1
TRBV29-1,TRBJ1-2,CSVEGRTNYGYTF,1,0,1,1
TRBV29-1,TRBJ1-1,CSALDGWNTEAFF,1,0,1,1
TRBV29-1,TRBJ1-1,CSGGHTGGSEAFF,1,0,1,1
TRBV30,TRBJ1-1,CAWGQLNTEAFF,1,0,1,1
TRBV19,TRBJ1-1,CASRLGATEAFF,2,0,1,2
TRBV6-2/3/5/6,TRBJ1-1,CASSPRNTEAFF,1,0,1,1
TRBV6-1,TRBJ2-1,CASSVGATEQFF,1,0,1,1
TRBV7-2,TRBJ1-1,CASSLEYTEAFF,1,0,1,1
TRBV7-2,TRBJ1-2,CASSSGAYGYTF,2,0,1,2
TRBV3-1,TRBJ2-1,CASSQDRHEQFF,1,0,1,1
TRBV5-1,TRBJ2-1,CASSLDYNEQFF,1,0,1,1
TRBV20-1,TRBJ1-1,CSFSRVNTEAFF,1,0,1,1
TRBV20-1,TRBJ1-5,CSVGGVNQPQHF,1,0,1,1
TRBV20-1,TRBJ2-1,CSAPVGYNEQFF,2,0,1,2
TRBV29-1,TRBJ1-5,CSVGQGNQPQHF,1,0,1,1
TRBV29-1,TRBJ1-1,CSVAYRDREAFF,1,0,1,1
TRBV29-1,TRBJ1-1,CSVPGQGTEAFF,1,0,1,1
TRBV29-1,TRBJ1-1,CSGGAWRTEAFF,1,0,1,1
TRBV7-9,TRBJ2-5,CASSFGQGNYF,1,0,1,1
TRBV7-9,TRBJ2-2,CASSRPGELFF,1,0,1,1
TRBV20-1,TRBJ2-1,CSAKGDNEQFF,1,0,1,1
TRBV20-1,TRBJ2-5,CSAEDQETQYF,1,0,1,1
TRBV29-1,TRBJ1-1,CSVVQDTEAFF,1,0,1,1
TRBV29-1,TRBJ1-2,CSVDAQIGYTF,1,0,1,1
TRBV29-1,TRBJ2-7,CSVDRVGEQYF,1,0,1,1
TRBV7-6,TRBJ2-1,CASSSIELVAGGSYNEQFF,1,0,1,1
TRBV7-2,TRBJ1-5,CASSPVGGWGSNRPQHF,1,0,1,1
TRBV7-9,TRBJ1-5,CASSLEGGVGQPQHF,1,0,1,1
TRBV7-9,TRBJ1-1,CASSLFSGADTEAFF,2,0,1,2
TRBV4-2,TRBJ2-1,CASSRLAGLYNEQFF,1,0,1,1
TRBV7-2,TRBJ1-5,CASSWDGNQPQHF,2,0,1,2
TRBV28,TRBJ2-7,CASRSLLYEQYF,1,0,1,1
TRBV12-3/4,TRBJ2-3,CARGLVSGGPPISTDTQYF,1,0,1,1
TRBV11-2,TRBJ2-3,CASSLAGSGGSSTDSQYF,2,0,1,2
TRBV11-2,TRBJ2-7,CASSFRQGRHSYEQYF,1,0,1,1
TRBV30,TRBJ1-5,CAWSDGGSHNQPQHF,1,0,1,1
TRBV5-6,TRBJ2-7,CASSSRAGGAYEQYF,1,0,1,1
TRBV7-9,TRBJ2-1,CASSLAAGQNEQLF,1,0,1,1
TRBV20-1,TRBJ1-1,CSASGGGNAPEAFF,2,0,1,2
TRBV18,TRBJ2-2,CANSPLGSGLNFLQNTGELFF,1,0,1,1
TRBV6-2/3/5/6,TRBJ2-7,CASSYSPSGGLDNSYEQYF,1,0,1,1
TRBV3-1,TRBJ2-7,CASSQKRIWEVPYSYEQYF,1,0,1,1
TRBV10-3,TRBJ2-3,CAISESKLLAGAPDTQYF,1,0,1,1
TRBV6-2/3/5/6,TRBJ2-1,CASSYSVQEGVAYNEQFF,1,0,1,1
TRBV6-1,TRBJ2-7,CASSEAWTWAGGLGEQYF,1,0,1,1
TRBV5-1,TRBJ2-1,CASSLDGASGGAVNEQFF,1,0,1,1
TRBV3-1,TRBJ2-7,CATSSGALRGIIYEQYF,1,0,1,1
TRBV19,TRBJ1-1,CASSPRKGDRRNTEAFF,1,0,1,1
TRBV6-1,TRBJ2-1,CASSEAWVAYPYNEQFF,1,0,1,1
TRBV6-2/3/5/6,TRBJ1-4,CASSTTREGAWNEKLFF,2,0,1,2
TRBV7-2,TRBJ2-1,CASSLPRRISSYNEQFF,1,0,1,1
TRBV5-4,TRBJ2-1,CASSLGGLGPDPHEQFF,1,0,1,1
TRBV28,TRBJ1-4,CASSSTLVPLGDEKLFF,1,0,1,1
TRBV6-2/3/5/6,TRBJ1-2,CASSSSLLGPPNYGYTF,1,0,1,1
TRBV4-2,TRBJ1-5,CASSPGQGRYSNQPQHF,1,0,1,1
TRBV5-5,TRBJ2-5,CASSPPARDRFQETQYF,1,0,1,1
TRBV3-1,TRBJ1-1,CASSRTGGGGFGTEAFF,1,0,1,1
TRBV5-1,TRBJ2-3,CASSFLRTQTSTDTQYF,1,0,1,1
TRBV5-1,TRBJ1-1,CASSYPTNGAQSGEAFF,1,0,1,1
TRBV4-1,TRBJ1-3,CASSRQGLTLSGNTIYF,2,0,1,2
TRBV4-3,TRBJ2-3,CASSQDIVGMSTDTQYF,2,0,1,2
TRBV20-1,TRBJ1-1,CSASKPPGEGTNTEAFF,1,0,1,1
TRBV24-1,TRBJ2-2,CATSDFRSGGTGELFF,1,0,1,1
TRBV6-2/3/5/6,TRBJ2-7,CASSSRRLAGGSEQYF,1,0,1,1
TRBV5-4,TRBJ2-3,CASSGASAVNTDTQYF,1,0,1,1
TRBV12-3/4,TRBJ2-3,CASSTGGLVIADTQYF,1,0,1,1
TRBV5-4,TRBJ2-5,CASSLAPAGGRETQYF,1,0,1,1
TRBV5-5,TRBJ2-1,CASSLRWDVGRGEQFF,1,0,1,1
TRBV13,TRBJ2-1,CASSSGLAGGYNEQFF,1,0,1,1
TRBV6-2/3/5/6,TRBJ2-2,CASSLVPDTNTGELFF,1,0,1,1
TRBV7-9,TRBJ2-2,CASSPLQGLDTGELFF,1,0,1,1
TRBV5-4,TRBJ2-5,CASSHGTFAREETQYF,1,0,1,1
TRBV3-1,TRBJ1-1,CASSQSWTALNTEAFF,1,0,1,1
TRBV11-3,TRBJ1-1,CASSQSWGSMNTEAFF,1,0,1,1
TRBV9,TRBJ2-3,CASSVGASATADTQYF,1,0,1,1
TRBV11-2,TRBJ1-5,CASSAGQIPSNQPQHF,1,0,1,1
TRBV5-1,TRBJ2-3,CASSVSGTSSKDTQYF,1,0,1,1
TRBV5-1,TRBJ2-1,CASSITSGGSYNEQFF,1,0,1,1
TRBV20-1,TRBJ2-1,CSARDLKDKGRNEQFF,1,0,1,1
TRBV10-3,TRBJ1-3,CAIDAGPSSGNTIYF,1,0,1,1
TRBV10-3,TRBJ2-5,CAISEFGASQETQYF,1,0,1,1
TRBV2,TRBJ1-2,CATIPRDSTNYGYTF,1,0,1,1
TRBV19,TRBJ2-1,CASSTAPTRMDEQFF,1,0,1,1
TRBV19,TRBJ2-6,CASRLGAGGANVLTF,1,0,1,1
TRBV18,TRBJ2-2,CASSLWDSLIGELFF,1,0,1,1
TRBV25-1,TRBJ2-2,CASTWALGRTGELFF,1,0,1,1
TRBV27,TRBJ1-2,CASSFWDRGVSGYTF,1,0,1,1
TRBV6-2/3/5/6,TRBJ1-6,CASSLGTGEVSPLHF,2,0,1,2
TRBV12-3/4,TRBJ1-5,CASSLGQGPNQPQHF,1,0,1,1
TRBV12-3/4,TRBJ2-3,CASSLWGGPADTQYF,1,0,1,1
TRBV12-3/4,TRBJ2-7,CASSSPGDRGREQYF,1,0,1,1
TRBV12-3/4,TRBJ2-1,CASSSGQSLYNEQFF,1,0,1,1
TRBV6-2/3/5/6,TRBJ1-1,CASSYSRLPNTEAFF,1,0,1,1
TRBV6-2/3/5/6,TRBJ1-1,CASSYRHLPNTEAFF,1,0,1,1
TRBV6-2/3/5/6,TRBJ1-1,CASSYQDRGNTEAFF,1,0,1,1
TRBV2,TRBJ2-3,CASSVQGPSPDTQYF,1,0,1,1
TRBV6-1,TRBJ1-3,CASSVQGAPGNTIYF,1,0,1,1
TRBV12-3/4,TRBJ1-2,CASSARRQGRHGYTF,1,0,1,1
TRBV28,TRBJ2-3,CASSGSGLHTDTQYF,1,0,1,1
TRBV6-1,TRBJ2-7,CASSEYMSLQYEQYF,1,0,1,1
TRBV6-1,TRBJ2-2,CASSEVRGNTGELFF,1,0,1,1
TRBV7-6,TRBJ2-7,CASSTSGGSSYEQYF,1,0,1,1
TRBV7-9,TRBJ2-5,CASSFMGQGQETQYF,2,0,1,2
TRBV5-4,TRBJ1-1,CASSLSRTGGTEAFF,1,0,1,1
TRBV7-2,TRBJ1-6,CASSLWSSYNSPLHF,1,0,1,1
TRBV5-6,TRBJ2-3,CASSLARRRGDTQYF,1,0,1,1
TRBV7-2,TRBJ2-7,CASSLVAGGLYEQYF,1,0,1,1
TRBV7-6,TRBJ2-3,CASSLVGGGTDTQYF,1,0,1,1
TRBV7-9,TRBJ2-7,CASSLAGWDGDEQYF,1,0,1,1
TRBV7-2,TRBJ2-7,CASSLEGGKSYEQYF,1,0,1,1
TRBV7-3,TRBJ2-2,CASSSRDPRTGELFF,1,0,1,1
TRBV7-2,TRBJ2-7,CASSYGVTGNYEQYF,1,0,1,1
TRBV6-2/3/5/6,TRBJ2-1,CASSLIPTGGNEQFF,1,0,1,1
TRBV4-2,TRBJ2-1,CASSLAGGISNEQFF,1,0,1,1
TRBV14,TRBJ2-7,CASSLDSLLLNEQYF,1,0,1,1
TRBV27,TRBJ2-5,CASSLTSGGRETQYF,2,0,1,2
TRBV7-9,TRBJ2-3,CASSPRGSLGDTQYF,1,0,1,1
TRBV6-2/3/5/6,TRBJ2-1,CASSPGSRIYNEQFF,1,0,1,1
TRBV9,TRBJ2-5,CASSPGQGEGETQYF,1,0,1,1
TRBV3-1,TRBJ1-6,CASSQNRGYNSPLHF,1,0,1,1
TRBV14,TRBJ2-5,CASSQAGAGAETQYF,1,0,1,1
TRBV14,TRBJ2-5,CASSQGTGPQETQYF,1,0,1,1
TRBV14,TRBJ2-1,CASSQDLGNYNEQFF,1,0,1,1
TRBV9,TRBJ2-5,CASSVGASGEETQYF,1,0,1,1
TRBV5-5,TRBJ2-5,CASRLTGVGVETQYF,1,0,1,1
TRBV7-9,TRBJ2-3,CASRRGVYATDTQYF,1,1,2,2
TRBV7-2,TRBJ1-2,CASRSWDRGNYGYTF,1,0,1,1
TRBV6-2/3/5/6,TRBJ1-5,CASRRGQGEYQPQHF,1,0,1,1
TRBV11-2,TRBJ2-5,CASRRQFMVGETQHF,1,0,1,1
TRBV2,TRBJ1-6,CASKNLGGGNSPLHF,1,0,1,1
TRBV5-1,TRBJ2-1,CASSRGGGMYNEQFF,1,0,1,1
TRBV10-2,TRBJ2-2,CASTWAGRNTGELFF,1,0,1,1
TRBV5-1,TRBJ1-1,CASSFVTGSDTEASY,1,0,1,1
TRBV5-1,TRBJ1-1,CASSLSAGRVTEAFF,1,0,1,1
TRBV5-1,TRBJ2-1,CASSLVVRGFNEQFF,1,0,1,1
TRBV5-1,TRBJ1-5,CASSLGGASNQPQHF,1,0,1,1
TRBV5-1,TRBJ2-7,CASSLGGTGSYEQYF,1,0,1,1
TRBV5-1,TRBJ2-1,CASSLGQGSYNEQFF,1,0,1,1
TRBV4-1,TRBJ1-2,CASSQPGQKKNGYTF,1,0,1,1
TRBV5-1,TRBJ2-1,CASRDADRGDNEQFF,1,0,1,1
TRBV20-1,TRBJ2-1,CSALLNREGSNEQFF,1,0,1,1
TRBV20-1,TRBJ1-1,CSAPPRGRPDTEAFF,1,0,1,1
TRBV20-1,TRBJ1-1,CSAIPPGVMNTEAFF,1,0,1,1
TRBV20-1,TRBJ2-7,CSASRGVGSSYEQYF,1,0,1,1
TRBV20-1,TRBJ2-1,CSARQPRDKRPEQFF,1,0,1,1
TRBV20-1,TRBJ1-4,CSARDHDRFDEKLFF,1,0,1,1
TRBV20-1,TRBJ2-1,CSANLGTSGVGEQFF,1,0,1,1
TRBV29-1,TRBJ1-5,CSVETGFGGNQPQHF,1,0,1,1
TRBV29-1,TRBJ2-3,CSVEGLLTATDTQYF,1,0,1,1
TRBV29-1,TRBJ2-3,CSVAVGTSGTDTQYF,1,0,1,1
TRBV29-1,TRBJ1-1,CSVRDGSKMNTEAFF,1,2,2,3
TRBV29-1,TRBJ1-6,CSVAETGTENSPLHF,1,0,1,1
TRBV12-5,TRBJ1-6,CASGLGSDNSPLHF,1,0,1,1
TRBV24-1,TRBJ2-3,CATSDLFSTDTQYF,1,0,1,1
TRBV19,TRBJ2-3,CATRLAGGKDTQYF,1,0,1,1
TRBV10-3,TRBJ1-2,CATTPGGLENGYTF,1,0,1,1
TRBV19,TRBJ2-7,CASTRDRASYEQYF,1,0,1,1
TRBV19,TRBJ1-3,CASSPDGLRNTIYF,1,0,1,1
TRBV19,TRBJ1-1,CASSQTGANTEAFF,1,0,1,1
TRBV19,TRBJ2-5,CASSIGIPQETQYF,1,0,1,1
TRBV18,TRBJ1-1,CASSPGTANTEAFF,1,0,1,1
TRBV6-4,TRBJ1-2,CASSREGSIYGYTF,1,0,1,1
TRBV18,TRBJ1-1,CASSPNDRNTEAFF,1,0,1,1
TRBV18,TRBJ2-7,CASSPPSGPFEQYF,1,0,1,1
TRBV18,TRBJ1-5,CASSPDRGNQPQHF,1,0,1,1
TRBV5-6,TRBJ2-1,CASLSRRLAHEQFF,1,0,1,1
TRBV5-4,TRBJ2-3,CASGSGGYTDTQYF,1,0,1,1
TRBV13,TRBJ1-3,CASGKGGAGNTIYF,1,0,1,1
TRBV5-6,TRBJ1-5,CASSFGSDNQPQHF,1,0,1,1
TRBV12-3/4,TRBJ2-1,CASSLGGGVDEQFF,1,0,1,1
TRBV12-3/4,TRBJ2-1,CASSSHPSTNEQFF,1,0,1,1
TRBV6-2/3/5/6,TRBJ2-1,CASSWGVGYNEQFF,1,0,1,1
TRBV12-3/4,TRBJ1-1,CASSWGRSGTEAFF,1,0,1,1
TRBV27,TRBJ1-1,CASSYTAQNTEAFF,1,0,1,1
TRBV12-3/4,TRBJ1-2,CASSPPGGIGGYTF,1,0,1,1
TRBV25-1,TRBJ1-2,CASSGAARFRGYTF,1,0,1,1
TRBV6-1,TRBJ1-2,CASSESHSNYGYTF,1,0,1,1
TRBV12-3/4,TRBJ1-4,CASSIQGSNEKLFF,1,0,1,1
TRBV12-3/4,TRBJ2-1,CASSTSGGYNEQFF,1,0,1,1
TRBV5-4,TRBJ1-1,CASSNGALNTEAFF,1,0,1,1
TRBV7-2,TRBJ2-7,CASSFGGGPFEQYF,1,0,1,1
TRBV5-4,TRBJ2-3,CASSFGGTTDTQYF,1,0,1,1
TRBV7-2,TRBJ2-7,CASSFDYSSYEQCF,1,0,1,1
TRBV5-4,TRBJ1-2,CASSLGQGVYGYTF,1,0,1,1
TRBV5-6,TRBJ2-7,CASSLDWGYDEQYF,1,0,1,1
TRBV5-4,TRBJ1-1,CASSLEGQNTEAFF,1,0,1,1
TRBV7-2,TRBJ1-5,CASSLTQANQPQHF,1,0,1,1
TRBV5-6,TRBJ2-4,CASSSRTGGNIQYF,1,0,1,1
TRBV2,TRBJ2-7,CASSSGTGDHEQYF,1,0,1,1
TRBV3-1,TRBJ2-6,CASSSGGGANVLTF,1,0,1,1
TRBV7-2,TRBJ2-5,CASSSTRATETQYF,1,0,1,1
TRBV3-1,TRBJ1-6,CASSLRQGASPLHF,1,0,1,1
TRBV7-3,TRBJ1-1,CASSLNRESTEAFF,1,0,1,1
TRBV28,TRBJ2-3,CASSLRGGTDTQYF,1,0,1,1
TRBV3-1,TRBJ2-5,CASSLLDLPETQYF,1,0,1,1
TRBV3-1,TRBJ2-7,CASSPRDSAYEQYF,1,0,1,1
TRBV7-2,TRBJ2-7,CASSPRDSPYEQYF,1,0,1,1
TRBV7-9,TRBJ1-2,CASSPSTGVYGYTF,1,0,1,1
TRBV6-2/3/5/6,TRBJ2-4,CASSQEPGVDIQYF,1,0,1,1
TRBV6-2/3/5/6,TRBJ1-1,CASSGTGMNTEAFF,1,0,1,1
TRBV7-2,TRBJ2-5,CASSIQGAGETQYF,1,0,1,1
TRBV6-2/3/5/6,TRBJ2-3,CASSRTGLTDTQYF,1,0,1,1
TRBV9,TRBJ2-1,CASRGAVIYNEQLF,1,0,1,1
TRBV11-1,TRBJ2-7,CASRRTGTGNEQYF,1,0,1,1
TRBV6-2/3/5/6,TRBJ2-2,CASRRELGSGELFF,1,0,1,1
TRBV3-1,TRBJ1-1,CASRVQGENTEAFF,1,0,1,1
TRBV2,TRBJ1-5,CASRADYSNQPQHF,1,0,1,1
TRBV7-2,TRBJ2-5,CASNPGHPQETQYF,1,0,1,1
TRBV3-1,TRBJ2-1,CASKPGPAYNEQFF,1,0,1,1
TRBV5-1,TRBJ2-5,CASSFGTWKETQYF,1,0,1,1
TRBV5-1,TRBJ2-5,CASSLAGTAETQYF,2,0,1,2
TRBV5-1,TRBJ2-7,CASSLEGTGAEQYF,1,0,1,1
TRBV7-2,TRBJ2-1,CASSSVGHYNEQFF,1,0,1,1
TRBV4-1,TRBJ1-4,CASSLGQGAEKLFF,1,0,1,1
TRBV5-1,TRBJ2-7,CASSQRGGSYEQYF,1,0,1,1
TRBV4-1,TRBJ1-4,CASSQPGLNEKLFF,1,0,1,1
TRBV5-1,TRBJ2-7,CASSQPTSNYEQYF,1,0,1,1
TRBV5-1,TRBJ1-2,CASSTGEIPYGYTF,1,0,1,1
TRBV5-1,TRBJ2-7,CASSTPTGPYEQYF,1,0,1,1
TRBV5-1,TRBJ2-3,CASRQGQVSDTQYF,1,0,1,1
TRBV20-1,TRBJ2-5,CSAATGTGQETQYF,1,1,2,2
TRBV20-1,TRBJ1-5,CSASDRAPYQPQHF,2,0,1,2
TRBV20-1,TRBJ2-4,CSASPRTSKNIQYF,1,0,1,1
TRBV29-1,TRBJ2-5,CSVNPGAVLPLRDF,1,0,1,1
TRBV29-1,TRBJ1-5,CSVGEGLSNQPQHF,1,0,1,1
TRBV20-1,TRBJ2-1,RSASGTGGYNEQFF,1,0,1,1
TRBV20-1,TRBJ2-3,SSAGKDFFTDTKYF,1,0,1,1
TRBV12-5,TRBJ1-5,CASGLISNQPQHF,1,0,1,1
TRBV10-3,TRBJ2-5,CAIAEGYQETQYF,1,0,1,1
TRBV10-3,TRBJ2-3,CAISLAVKDTQYF,1,0,1,1
TRBV10-3,TRBJ2-5,CAISVQPIETQYF,1,0,1,1
TRBV15,TRBJ1-1,CATTWTANTEAFF,1,0,1,1
TRBV3-1,TRBJ1-2,CATTRTQNYGYTF,1,0,1,1
TRBV19,TRBJ2-2,CASVPWGTGELFF,1,0,1,1
TRBV19,TRBJ1-2,CASTAQGTYGYTF,1,0,1,1
TRBV19,TRBJ2-5,CASSPGQGGRQYF,1,0,1,1
TRBV19,TRBJ1-1,CASSIDRTTEAFF,1,0,1,1
TRBV19,TRBJ2-2,CASSKGNTGELFF,1,0,1,1
TRBV19,TRBJ1-5,CASNEGGNQPQHF,1,0,1,1
TRBV2,TRBJ1-1,CASSRDTNAEAFL,1,0,1,1
TRBV18,TRBJ2-3,CASSPTSADTQYF,1,0,1,1
TRBV6-2/3/5/6,TRBJ1-2,CASALTRDDGYTF,1,0,1,1
TRBV7-2,TRBJ2-3,CASGRGGADTQYF,1,0,1,1
TRBV5-6,TRBJ1-1,CASIQSLNTEAFF,2,2,2,4
TRBV12-3/4,TRBJ2-1,CASSLRQGHEQFF,1,0,1,1
TRBV12-3/4,TRBJ1-2,CASSSQGYYGYTF,1,0,1,1
TRBV2,TRBJ2-2,CASSSRGSGELFF,1,0,1,1
TRBV12-3/4,TRBJ1-2,CASSPRQGGGYTF,1,0,1,1
TRBV6-4,TRBJ1-1,CASSAGVGTEAFF,1,0,1,1
TRBV2,TRBJ1-1,CASSGQANTEAFF,1,0,1,1
TRBV5-4,TRBJ2-1,CASSLGRNNEQFF,1,1,2,2
TRBV5-4,TRBJ1-1,CASSLSGNTEAFF,1,0,1,1
TRBV7-2,TRBJ1-3,CASSLGAGNTIYF,1,0,1,1
TRBV7-3,TRBJ1-1,CASSLSRDTEAFF,1,0,1,1
TRBV6-2/3/5/6,TRBJ2-2,CASSSAVTGELFF,1,0,1,1
TRBV7-9,TRBJ1-1,CASSSALNREAFF,1,0,1,1
TRBV7-9,TRBJ1-1,CASSWTGDTEAFF,1,0,1,1
TRBV3-1,TRBJ1-1,CASSLQGAAEAFF,1,0,1,1
TRBV3-1,TRBJ2-4,CASSLIGENIQYF,1,0,1,1
TRBV13,TRBJ2-7,CASSPPTSYEQYF,1,0,1,1
TRBV7-2,TRBJ2-3,CASSPGGADTQYF,1,0,1,1
TRBV4-2,TRBJ1-6,CASSPGTDSPLHF,1,0,1,1
TRBV12-3/4,TRBJ2-5,CASSRRPTETQYF,2,0,1,2
TRBV11-2,TRBJ1-6,CASSRPARVPLHF,1,0,1,1
TRBV7-2,TRBJ2-1,CASSRGTQTEQFF,1,0,1,1
TRBV11-3,TRBJ1-1,CASSRTDSPEAFF,1,0,1,1
TRBV7-9,TRBJ1-5,CASSQDRDQPQHF,1,0,1,1
TRBV7-3,TRBJ1-2,CASSQTGGYGYTF,1,0,1,1
TRBV5-4,TRBJ2-5,CASSQQGPETQYF,1,0,1,1
TRBV3-1,TRBJ1-2,CASSQVTSDGYTF,1,0,1,1
TRBV3-1,TRBJ2-5,CASSQDNRGTQYF,1,0,1,1
TRBV10-2,TRBJ1-1,CASSRDTYTEAFF,1,0,1,1
TRBV5-1,TRBJ2-5,CASSPDRDQTQYF,1,0,1,1
TRBV5-1,TRBJ1-1,CASSPVVNTEAFF,1,0,1,1
TRBV20-1,TRBJ2-5,CSATRGYRETQYF,1,0,1,1
TRBV20-1,TRBJ1-4,CSASAGGVEKLFF,1,0,1,1
TRBV20-1,TRBJ1-1,CSARPSTRVEAFF,1,0,1,1
TRBV20-1,TRBJ2-5,CSAGLAGEVTQYF,1,0,1,1
TRBV20-1,TRBJ2-7,CSATRQPVYEQYF,1,0,1,1
TRBV29-1,TRBJ1-2,CSVVGGSYYGYTF,1,0,1,1
TRBV29-1,TRBJ2-2,CSVGEGGPGELFF,1,1,2,2
TRBV29-1,TRBJ1-6,CSVRGQGDSPLHF,1,0,1,1
TRBV29-1,TRBJ1-1,CSAVRQGGTEAFF,1,0,1,1
TRBV29-1,TRBJ2-5,CSIASGTGETQYF,1,0,1,1
TRBV30,TRBJ2-2,CAWTQGTGELFF,1,0,1,1
TRBV30,TRBJ1-5,CAWSGTSPPQHF,1,0,1,1
TRBV30,TRBJ1-6,CAWSQEGSPLHF,1,0,1,1
TRBV10-3,TRBJ2-5,CAISESGETQYF,1,0,1,1
TRBV19,TRBJ2-3,CASSSRGDTQYF,1,0,1,1
TRBV12-3/4,TRBJ2-5,CASGRKQETQYF,1,0,1,1
TRBV12-3/4,TRBJ1-5,CASSLGNQPQHF,1,0,1,1
TRBV6-2/3/5/6,TRBJ1-1,CASSSQGPEAFF,1,0,1,1
TRBV12-3/4,TRBJ1-1,CASSRLNTEAFF,1,0,1,1
TRBV2,TRBJ1-2,CASSGDSGGYTF,1,0,1,1
TRBV6-2/3/5/6,TRBJ2-5,CASSNTRETQYF,1,0,1,1
TRBV5-4,TRBJ1-1,CASSLLNTEAFF,1,0,1,1
TRBV12-3/4,TRBJ2-7,CASSSVPVGQYF,1,0,1,1
TRBV7-2,TRBJ2-5,CASSPGVETQYF,1,0,1,1
TRBV7-6,TRBJ2-3,CASSARGDTQYF,1,0,1,1
TRBV5-4,TRBJ2-1,CASSDRYNEQFF,1,0,1,1
TRBV7-2,TRBJ2-2,CARGGWTGELFF,1,0,1,1
TRBV10-1,TRBJ1-1,CASSETGTEAFF,1,0,1,1
TRBV5-1,TRBJ2-7,CASSLDRNEQYF,1,0,1,1
TRBV5-1,TRBJ2-5,CASRRGQETQYF,1,0,1,1
TRBV20-1,TRBJ2-1,CSAPGALDEQFF,1,0,1,1
TRBV20-1,TRBJ2-1,CSADDRGHEQFF,1,0,1,1
TRBV29-1,TRBJ2-7,CSVGQSSYEQYF,1,0,1,1
TRBV29-1,TRBJ1-2,CSVDFGGYGYTF,1,0,1,1
TRBV29-1,TRBJ2-7,CSVEVRAYEQYF,1,0,1,1
TRBV29-1,TRBJ2-2,CSVEDGTLGLFF,1,0,1,1
TRBV29-1,TRBJ2-7,CSTRTESYEQYF,1,0,1,1
TRBV24-1,TRBJ2-7,CATSDRLEQYF,1,0,1,1
TRBV12-3/4,TRBJ2-7,CASSLGPEQYF,1,0,1,1
TRBV14,TRBJ2-7,CASSQAVGQYF,1,0,1,1
TRBV6-2/3/5/6,TRBJ1-1,CASKESGEAFF,1,0,1,1
TRBV20-1,TRBJ2-5,CSAKVRETQYF,1,0,1,1
TRBV29-1,TRBJ1-2,CSVYREDGYTF,1,0,1,1
TRBV29-1,TRBJ1-1,CSVGQGVGAFF,1,0,1,1
TRBV2,TRBJ1-1,CASRGFLAFF,1,0,1,1
TRBV27,TRBJ1-1,CANLGTEAFF,1,0,1,1
TRBV20-1,TRBJ1-2,CSARDEGYTF,1,0,1,1
TRBV29-1,TRBJ2-5,CSVAWETQYF,1,0,1,1
TRBV7-2,TRBJ2-1,CASSFVAGGGVNEQFF,1,0,1,1
TRBV5-1,TRBJ1-1,CASSLDPGATNTEAFF,1,0,1,1
TRBV2,TRBJ2-1,CAIWGTGGSYNEQFF,1,0,1,1
TRBV18,TRBJ2-7,CASSPLAGGGHEQYF,2,0,1,2
TRBV19,TRBJ2-1,CASRSGTGGGEQFF,1,0,1,1
TRBV7-9,TRBJ2-5,CASSSMGGAETQYF,2,0,1,2
TRBV20-1,TRBJ1-6,CSARTLGNSPLHF,1,0,1,1
TRBV5-1,TRBJ2-7,RASSLWPEGEQYF,1,0,1,1
TRBV12-3/4,TRBJ2-7,CASTLGNGQYF,2,0,1,2
TRBV3-1,TRBJ2-5,CASSQVEGATSGTTGPETQYF,1,0,1,1
TRBV7-3,TRBJ2-1,CASSLTGTGASGPYNEQFF,1,0,1,1
TRBV6-2/3/5/6,TRBJ2-1,CASSINSHQAGTSRGEQFF,1,0,1,1
TRBV5-1,TRBJ2-6,CASSLVGDGRVSGANVLTF,1,0,1,1
TRBV20-1,TRBJ2-1,CSARAQRIPGLEFRYEQFF,1,0,1,1
TRBV6-2/3/5/6,TRBJ1-5,CASTQSYRTLYSNQPQHF,1,0,1,1
TRBV6-2/3/5/6,TRBJ2-3,CASTVIGAGGKSPDTQYF,1,0,1,1
TRBV12-3/4,TRBJ1-5,CASTASRSGWGSNQPQHF,1,0,1,1
TRBV7-2,TRBJ2-3,CASSLTYSQGPIADTQYF,1,0,1,1
TRBV11-2,TRBJ2-1,CASSLSVPGGGTYNEQFF,1,0,1,1
TRBV7-2,TRBJ1-1,CASSLEWLGTGNRTEAFF,1,0,1,1
TRBV11-3,TRBJ2-1,CASSLRAGGFNSYNEQFF,1,0,1,1
TRBV3-1,TRBJ1-3,CASSQVPSGPGSGNTIYF,1,0,1,1
TRBV14,TRBJ2-5,CASSQESTGLVLEETQYF,1,0,1,1
TRBV7-8,TRBJ2-1,CASSAQNFGAPLYNEQFF,1,1,2,2
TRBV24-1,TRBJ2-5,CATSDSYAGENQETQYF,1,0,1,1
TRBV24-1,TRBJ2-1,CATSDPQTGSSYNEQFL,1,0,1,1
TRBV24-1,TRBJ2-3,CATSDRTSGGITDTQYF,1,0,1,1
TRBV19,TRBJ1-1,CASSTFEDRRMNTGAFF,1,0,1,1
TRBV12-3/4,TRBJ1-5,CASSSGQGLYSNQPQHF,1,0,1,1
TRBV6-2/3/5/6,TRBJ2-1,CASSYSSQGFSYNEQFF,1,0,1,1
TRBV2,TRBJ2-2,CASSEGGRGQGTGELFF,1,0,1,1
TRBV5-6,TRBJ2-1,CASSLASRDLHHNEQFF,1,0,1,1
TRBV5-5,TRBJ1-5,CASSLDPPRTSNQPQHF,1,0,1,1
TRBV11-2,TRBJ1-2,CASSLGRLRDFNYGYTF,1,0,1,1
TRBV7-8,TRBJ2-5,CASSLIFGGGNQETQYF,1,0,1,1
TRBV9,TRBJ2-2,CASSPDGGDSYTGELFF,1,0,1,1
TRBV3-1,TRBJ2-1,CASSPLAGRRSYNEQFF,1,0,1,1
TRBV14,TRBJ2-2,CASSQSAGRLNTGELFF,1,0,1,1
TRBV3-1,TRBJ1-1,CASSQDSYTGEQYRAFF,1,0,1,1
TRBV4-1,TRBJ2-1,CASSQASTRHSYNEQFF,1,0,1,1
TRBV4-1,TRBJ1-5,CASSQDGWGQGNQPQHF,1,0,1,1
TRBV24-1,TRBJ2-3,CATSVVGGNRRDTQYF,1,0,1,1
TRBV24-1,TRBJ2-1,CATSDSGAAKYNEQFF,1,0,1,1
TRBV19,TRBJ2-1,CASILKGGGTRDEQFF,1,0,1,1
TRBV19,TRBJ2-7,CASSLTASGGTYEQYF,1,0,1,1
TRBV19,TRBJ2-5,CASSRWGAGGQETQYF,1,0,1,1
TRBV19,TRBJ2-2,CASSMPTSGGAGELFF,1,0,1,1
TRBV19,TRBJ2-1,CASSMAPGNSYNEQFF,1,0,1,1
TRBV19,TRBJ2-2,CASSIESVNSAGELFF,1,0,1,1
TRBV19,TRBJ1-2,CASSITGVQTEHGYTF,1,0,1,1
TRBV18,TRBJ1-1,CASSPPGQGLYTEAFF,1,0,1,1
TRBV7-2,TRBJ1-3,CASTLGGSGRGNTIYF,1,0,1,1
TRBV6-2/3/5/6,TRBJ1-3,CASSYSIGLSGNTIYF,1,0,1,1
TRBV6-2/3/5/6,TRBJ1-5,CASSYSNGEFGQPQHF,1,0,1,1
TRBV6-2/3/5/6,TRBJ2-7,CASSYVRRRSSYEQYF,1,0,1,1
TRBV14,TRBJ2-7,CASSLNAGTGTSEQYF,1,0,1,1
TRBV6-2/3/5/6,TRBJ1-2,CASSPGTGDGRGGYTF,1,0,1,1
TRBV6-2/3/5/6,TRBJ2-3,CASSPDSSSSTDTQYF,1,0,1,1
TRBV28,TRBJ2-2,CASSHRLAEITGELFF,1,0,1,1
TRBV5-5,TRBJ1-5,CASSLASGQGTQPQHF,1,0,1,1
TRBV5-4,TRBJ1-2,CASSLGPADVNYGYTF,1,0,1,1
TRBV13,TRBJ1-4,CASSYNKQGGEEKLFF,1,0,1,1
TRBV7-9,TRBJ1-5,CASSLRDRDGNQPQHF,1,0,1,1
TRBV7-8,TRBJ2-1,CASSLMQGILYNEQFF,1,0,1,1
TRBV3-1,TRBJ1-2,CASSPNWDPETSGYTF,1,0,1,1
TRBV11-3,TRBJ2-2,CASSPGTSTNTGELFF,1,0,1,1
TRBV14,TRBJ2-5,CASSQDLPGSGETQYF,1,0,1,1
TRBV6-2/3/5/6,TRBJ2-2,CASKGGVLAGSGELFF,1,0,1,1
TRBV5-1,TRBJ2-2,CASTQRGGTNTGELFF,1,0,1,1
TRBV5-1,TRBJ1-1,CASSLPPGGENTEAFF,1,0,1,1
TRBV5-1,TRBJ1-1,CASSLGQFIQNTEAFF,1,0,1,1
TRBV4-1,TRBJ2-2,CASSQDWLVSTGELFF,1,0,1,1
TRBV4-3,TRBJ1-2,CASSQDRQSGVYGYTF,1,0,1,1
TRBV29-1,TRBJ2-3,CSVSGKRGTSTDTQYF,1,0,1,1
TRBV12-5,TRBJ2-1,CASSPWTDLYNEQFF,1,0,1,1
TRBV10-3,TRBJ1-5,CAIRDREDSNQPQHF,1,0,1,1
TRBV10-3,TRBJ1-6,CAIRERTGDYSPLHF,1,0,1,1
TRBV24-1,TRBJ2-5,CATSGVDGPQETQYF,1,0,1,1
TRBV24-1,TRBJ2-3,CATSDPGLASDTQYF,1,0,1,1
TRBV19,TRBJ1-1,CASSMRTEYRTEAFF,1,0,1,1
TRBV19,TRBJ1-1,CASSMGGGFDTEAFF,1,0,1,1
TRBV19,TRBJ2-1,CASSIGQGMGDEQFF,1,0,1,1
TRBV19,TRBJ2-1,CASSTTSGGRSEQFF,1,0,1,1
TRBV19,TRBJ1-2,CASNGGTGGFHGYTF,1,0,1,1
TRBV6-2/3/5/6,TRBJ2-1,CASPRPGFYYNEQFF,1,0,1,1
TRBV5-8,TRBJ2-5,CASGPRVAGRETQYF,1,0,1,1
TRBV12-3/4,TRBJ2-7,CASGEGGAVGYEQYF,1,0,1,1
TRBV25-1,TRBJ2-2,CASGRGDRDTGELFF,1,0,1,1
TRBV3-1,TRBJ2-3,CASTRQGANTDTQYF,1,0,1,1
TRBV3-1,TRBJ1-4,CASTNKPGRTEKLFF,1,0,1,1
TRBV6-2/3/5/6,TRBJ2-7,CASSLGLADSYEQYL,1,0,1,1
TRBV12-3/4,TRBJ2-5,CASSLRLAGEETQYF,1,0,1,1
TRBV12-3/4,TRBJ2-3,CASSSLPDGLDTQYF,1,0,1,1
TRBV12-3/4,TRBJ2-7,CASSSRVTAAYEQYF,1,0,1,1
TRBV6-2/3/5/6,TRBJ2-1,CASSSRDRVYNEQFF,1,0,1,1
TRBV28,TRBJ2-4,CASSSTTLSGNIQYF,1,0,1,1
TRBV6-2/3/5/6,TRBJ2-7,CASSSRGGKSYEQYF,1,0,1,1
TRBV5-6,TRBJ1-4,CASSYGTASNEKLFF,1,0,1,1
TRBV27,TRBJ2-1,CASSPSLIGMDEQFF,1,0,1,1
TRBV28,TRBJ1-2,CASSPGTGGGIGYTF,1,0,1,1
TRBV12-3/4,TRBJ1-1,CASSPGGRQNTEAFF,1,0,1,1
TRBV6-1,TRBJ2-7,CASSAPLIATYEQYF,1,0,1,1
TRBV2,TRBJ1-4,CASSATGGRNEKLFF,1,0,1,1
TRBV2,TRBJ1-5,CASSGGRDSNQPQHF,1,0,1,1
TRBV6-1,TRBJ2-1,CASSGGQEKRNEQFF,1,0,1,1
TRBV6-1,TRBJ1-1,CASSEWGQSNTEAFF,1,0,1,1
TRBV6-1,TRBJ1-2,CASSEYYQGDHGYTF,1,0,1,1
TRBV7-9,TRBJ2-1,CASSFWLSSYNEQFF,1,0,1,1
TRBV11-3,TRBJ1-2,CASSFLSAGGERYTF,1,0,1,1
TRBV7-9,TRBJ2-1,CASSFGGAKYNEQFF,1,0,1,1
TRBV11-1,TRBJ2-4,CASSFLAGQGNIQYF,1,0,1,1
TRBV7-3,TRBJ2-1,CASSLRASSYNEQFF,1,0,1,1
TRBV7-6,TRBJ1-4,CASSLVGGKDEKLFF,1,0,1,1
TRBV7-2,TRBJ2-1,CASSLVRGADNEQFF,1,0,1,1
TRBV5-5,TRBJ1-1,CASSLAQGRYTEAFF,1,0,1,1
TRBV5-5,TRBJ2-7,CASSLGRSLSYEQYF,1,0,1,1
TRBV5-4,TRBJ2-2,CASSLEGGVTGELFF,1,0,1,1
TRBV5-8,TRBJ1-2,CASSLRFRADYGYTF,1,0,1,1
TRBV13,TRBJ2-3,CASSLRGGGADTQYF,1,0,1,1
TRBV11-2,TRBJ2-2,CASSLATPGTGELFF,1,0,1,1
TRBV7-2,TRBJ2-1,CASSLGEGGWDEQFF,1,0,1,1
TRBV7-2,TRBJ2-5,CASSLELRGKETQYF,1,0,1,1
TRBV7-2,TRBJ1-2,CASSSSGTGAFGYTF,1,0,1,1
TRBV13,TRBJ1-1,CASSSRQNSNTEAFF,1,0,1,1
TRBV5-6,TRBJ1-4,CASSYTGATNEKLFF,1,0,1,1
TRBV5-6,TRBJ2-1,CASSLTSGDYNEQFF,1,0,1,1
TRBV2,TRBJ2-1,CASSPRSGGADEQFF,1,0,1,1
TRBV7-9,TRBJ1-1,CASSPPAGVNTEAFF,1,0,1,1
TRBV11-2,TRBJ2-5,CASSPQMVRGETQYF,1,0,1,1
TRBV14,TRBJ1-1,CASSPSGTGNTEAFF,1,0,1,1
TRBV7-6,TRBJ2-2,CASSPSLQGTGELFF,1,0,1,1
TRBV6-2/3/5/6,TRBJ2-7,CASSRSGGIAYEQYF,1,0,1,1
TRBV14,TRBJ2-6,CASSREGARANVLTF,1,0,1,1
TRBV4-2,TRBJ1-5,CASSRELGGAQPQHF,1,0,1,1
TRBV5-6,TRBJ2-3,CASSHMMEGDDTQYF,1,0,1,1
TRBV3-1,TRBJ2-5,CASSQGLAGKETQYF,1,0,1,1
TRBV7-9,TRBJ2-1,CASSDSGEVVGEQFF,1,0,1,1
TRBV12-3/4,TRBJ1-3,CASSTGTGFRNTIYF,2,0,1,2
TRBV7-6,TRBJ1-2,CASSNPESGNYGYTF,1,0,1,1
TRBV6-2/3/5/6,TRBJ2-2,CASRAGAANTGELFF,1,0,1,1
TRBV7-2,TRBJ2-7,CASRPEIGTGYEQYF,2,0,1,2
TRBV6-2/3/5/6,TRBJ1-1,CASRILDRGNTEAFF,1,0,1,1
TRBV12-3/4,TRBJ1-4,CASRKAGGVSEKLFF,1,0,1,1
TRBV7-2,TRBJ1-1,CASNPRQGANTEAFF,1,0,1,1
TRBV5-1,TRBJ2-1,CASSLVGPSYNEQFF,1,0,1,1
TRBV5-1,TRBJ1-4,CASSLDPDRVEKLFF,1,0,1,1
TRBV5-1,TRBJ1-5,CASSLEGMSNQPQHF,1,0,1,1
TRBV4-1,TRBJ1-1,CASSLRNRSPTEAFF,1,0,1,1
TRBV5-1,TRBJ1-5,CASSPDGQGNQPQHF,1,0,1,1
TRBV5-1,TRBJ1-3,CASSRTSSSGNTIYF,1,0,1,1
TRBV5-1,TRBJ1-5,CASSRDPGDNQPQHF,1,0,1,1
TRBV4-1,TRBJ2-7,CASSQVDRASYEQYF,1,0,1,1
TRBV4-1,TRBJ1-2,CASSQGAGADYGYTF,1,0,1,1
TRBV5-1,TRBJ2-7,CASSMNSGALYEQYF,1,0,1,1
TRBV5-1,TRBJ1-1,CASNPYGGGDTEAFF,1,0,1,1
TRBV20-1,TRBJ2-3,CSASRAAWSTDTQYF,1,0,1,1
TRBV20-1,TRBJ1-6,CSASQEGSYNSPLHF,1,0,1,1
TRBV20-1,TRBJ2-2,CSARSLGGVTGELFF,1,0,1,1
TRBV20-1,TRBJ2-4,CSARQGAWAKNIQYF,1,0,1,1
TRBV20-1,TRBJ2-1,CSARDLGDNYNEQFF,1,0,1,1
TRBV20-1,TRBJ2-1,CSARDVASGVYEQFF,1,0,1,1
TRBV20-1,TRBJ1-4,CSAKGPLGTAEKLFF,1,0,1,1
TRBV20-1,TRBJ2-7,CSATVTSVTSYEQYF,1,0,1,1
TRBV20-1,TRBJ2-5,CSGQTGTLNTETQYF,1,0,1,1
TRBV29-1,TRBJ2-7,CSVAWGAQSSYEQYF,1,0,1,1
TRBV29-1,TRBJ2-3,CSVEAEQMFGDTQYF,1,0,1,1
TRBV29-1,TRBJ1-1,CSVANLGTLNTEAFF,1,0,1,1
TRBV12-5,TRBJ2-1,RASARGGTRRYEQFS,1,0,1,1
TRBV6-2/3/5/6,TRBJ1-2,RASSPSGTANYGYTF,1,0,1,1
TRBV19,TRBJ2-1,CATKGLSPYNEQFF,1,0,1,1
TRBV5-4,TRBJ2-7,CATGTGNSHYEQYF,1,0,1,1
TRBV19,TRBJ2-5,CASSIVLARETQYF,1,0,1,1
TRBV19,TRBJ1-2,CASRDPGTRNGYTF,1,0,1,1
TRBV18,TRBJ2-7,CASSQLADTYEQYF,1,0,1,1
TRBV18,TRBJ1-1,CASSRDRGGTEAFF,1,0,1,1
TRBV18,TRBJ2-7,CASSLGTGDHEQYF,1,0,1,1
TRBV18,TRBJ2-3,CASSPAASTDTQYF,1,0,1,1
TRBV6-2/3/5/6,TRBJ2-2,CASPPQRSTGELFF,1,0,1,1
TRBV12-3/4,TRBJ1-6,CASASTGYNSPLHF,1,0,1,1
TRBV19,TRBJ1-1,CASGRTVMDTEAFF,1,1,2,2
TRBV7-9,TRBJ2-5,CASTRDQVQETQYF,1,0,1,1
TRBV12-3/4,TRBJ2-5,CASSLAGGWETQYF,1,0,1,1
TRBV6-2/3/5/6,TRBJ1-1,CASSYGIMNTEAFF,1,0,1,1
TRBV6-2/3/5/6,TRBJ2-3,CASSYGQGTDTQYF,1,0,1,1
TRBV27,TRBJ1-2,CASSGQGLIGSYTF,1,0,1,1
TRBV2,TRBJ1-2,CASSELKGQDGYTF,1,0,1,1
TRBV6-1,TRBJ1-2,CASSEGRGNYGYTI,1,0,1,1
TRBV6-1,TRBJ1-1,CASSEGRGNTEAFF,1,0,1,1
TRBV25-1,TRBJ1-1,CASSENFEDFEAFF,1,0,1,1
TRBV28,TRBJ2-4,CASSIGGFEDIQYF,1,0,1,1
TRBV28,TRBJ1-1,CASSTSTVNTEAFF,1,0,1,1
TRBV5-6,TRBJ1-4,CASSFKGLGEKLFF,1,0,1,1
TRBV5-6,TRBJ1-6,CASSLGSLHSPLHF,1,0,1,1
TRBV11-2,TRBJ2-5,CASSLSGGRETQYF,1,0,1,1
TRBV5-5,TRBJ2-3,CASSSPGAAGTQYF,1,0,1,1
TRBV7-2,TRBJ2-3,CASSYGTTTDTQYF,1,0,1,1
TRBV3-1,TRBJ1-5,CASSLGLTNQPQHF,1,0,1,1
TRBV7-9,TRBJ1-1,CASSLSGGNTEAFF,1,0,1,1
TRBV3-1,TRBJ1-1,CASSLQSDRTEAFF,1,0,1,1
TRBV13,TRBJ2-7,CASSLTGLTYEQYF,1,0,1,1
TRBV7-2,TRBJ1-1,CASSPPFLNTEAFF,1,0,1,1
TRBV5-6,TRBJ2-7,CASSPGAGDDEQYF,1,0,1,1
TRBV7-2,TRBJ2-2,CASSPGPNTGELFF,1,1,2,2
TRBV7-2,TRBJ2-4,CASSPDTGANIQYF,1,0,1,1
TRBV12-3/4,TRBJ2-5,CASSPTGTEETQYF,1,0,1,1
TRBV5-5,TRBJ1-4,CASSPDRGGEKLFI,1,0,1,1
TRBV5-5,TRBJ1-1,CASSPFPWNTEAFF,1,0,1,1
TRBV6-2/3/5/6,TRBJ2-6,CASSQASGANVLTF,1,0,1,1
TRBV3-1,TRBJ2-7,CASSQHRDRVEQYF,1,0,1,1
TRBV3-1,TRBJ2-3,CASSQTRGPDTQYF,1,0,1,1
TRBV3-1,TRBJ1-2,CASSQTGDPDGYTF,1,0,1,1
TRBV9,TRBJ2-7,CASSVGTDPYEQYF,1,0,1,1
TRBV11-1,TRBJ1-5,CASSATDSNQPQHF,1,0,1,1
TRBV7-2,TRBJ1-4,CASSGRAGNEKLFF,1,0,1,1
TRBV7-3,TRBJ2-3,CASSMTGGTDTQYF,1,0,1,1
TRBV7-9,TRBJ1-5,CASSTQGSHQPQHF,1,0,1,1
TRBV7-3,TRBJ2-2,CASRPGTGTGELFF,1,0,1,1
TRBV12-3/4,TRBJ2-5,CASRGRLATGTQYF,1,0,1,1
TRBV5-1,TRBJ2-3,CASRLAGTTDTQYF,1,0,1,1
TRBV5-1,TRBJ1-6,CASSRGTVNSPLHF,1,0,1,1
TRBV5-1,TRBJ2-5,CASSSGQGKETQYF,1,0,1,1
TRBV5-1,TRBJ2-1,CASSSLAEGDEQFF,1,0,1,1
TRBV5-1,TRBJ2-7,CASSLTSGGYEQYF,1,0,1,1
TRBV4-3,TRBJ2-5,CASSQDSMGETQYF,1,0,1,1
TRBV5-1,TRBJ2-5,CASSTGTSGETQYF,1,0,1,1
TRBV5-1,TRBJ2-1,CASRVTGEYNEQFF,1,0,1,1
TRBV20-1,TRBJ1-2,CSAPARAITHGYTF,1,0,1,1
TRBV20-1,TRBJ2-7,CSASRLAASREQYF,1,0,1,1
TRBV20-1,TRBJ2-7,CSARALGGAYEQYF,1,0,1,1
TRBV20-1,TRBJ1-5,CSARDEQASWGWHF,1,0,1,1
TRBV20-1,TRBJ1-6,CSAKGTSYNSPLHF,1,0,1,1
TRBV20-1,TRBJ2-7,CSAEPGTGGYEQYF,1,0,1,1
TRBV29-1,TRBJ2-2,CSVTRGFLTGELYF,1,0,1,1
TRBV27,TRBJ2-7,YASTSVGGPYEQYF,1,0,1,1
TRBV10-3,TRBJ2-1,RAISETSLAPRQFF,1,0,1,1
TRBV19,TRBJ1-1,SATPDSLNTEAFF,1,0,1,1
TRBV30,TRBJ2-1,CAWSRAGGNEQFF,1,0,1,1
TRBV30,TRBJ2-2,CAWRRQDTGELFF,1,0,1,1
TRBV5-4,TRBJ2-1,CAQGREAPHEQFF,1,0,1,1
TRBV2,TRBJ1-3,CAGRGNLGNTIYS,1,0,1,1
TRBV10-3,TRBJ2-1,CAISGQGTNEQFF,1,0,1,1
TRBV10-3,TRBJ1-2,CAISGTPGYGYTF,1,0,1,1
TRBV10-3,TRBJ2-7,CAIRFSGGHEQYF,1,0,1,1
TRBV7-2,TRBJ1-2,CATRGADSYGYTF,1,0,1,1
TRBV2,TRBJ2-3,CASETSSTDTQYF,1,0,1,1
TRBV19,TRBJ1-5,CASMGQGHQPQHF,1,0,1,1
TRBV19,TRBJ1-2,CASSMTANYGYTF,1,0,1,1
TRBV19,TRBJ2-1,CASSRDYYNEQFF,1,0,1,1
TRBV19,TRBJ1-2,CASRRTVNYGYTF,1,0,1,1
TRBV19,TRBJ1-1,CASKQGAGTEAFF,1,0,1,1
TRBV6-2/3/5/6,TRBJ2-6,CASWRPGANVLTF,1,1,2,2
TRBV2,TRBJ2-5,CASRLGVGETQYF,1,0,1,1
TRBV12-3/4,TRBJ1-6,CASTFGDNSPLHF,1,0,1,1
TRBV7-9,TRBJ1-1,CASTPRGNTEAFF,1,0,1,1
TRBV12-3/4,TRBJ2-7,CASSFGGGHEQYF,1,0,1,1
TRBV12-3/4,TRBJ1-2,CASSLGTNYGYTF,1,0,1,1
TRBV12-3/4,TRBJ2-2,CASSLGGSGELFF,1,0,1,1
TRBV27,TRBJ1-1,CASSLKGSTEAFF,1,0,1,1
TRBV12-3/4,TRBJ2-5,CASSSRGQETQYF,1,0,1,1
TRBV13,TRBJ2-3,CASSSTGTDTQYF,1,0,1,1
TRBV6-2/3/5/6,TRBJ1-2,CASSSDSIYGYTF,1,0,1,1
TRBV2,TRBJ1-5,CASSPTGFQPQHF,1,0,1,1
TRBV7-2,TRBJ1-5,CASSPRRDQPQHF,1,0,1,1
TRBV6-1,TRBJ2-7,CASSRATGREQYF,1,0,1,1
TRBV6-1,TRBJ1-2,CASSEVARYGYTF,1,0,1,1
TRBV6-2/3/5/6,TRBJ2-1,CASSTQGAGEQFF,1,0,1,1
TRBV7-2,TRBJ1-1,CASSRAGSTEAFF,1,0,1,1
TRBV11-3,TRBJ2-1,CASSLATYNEQFF,1,0,1,1
TRBV5-6,TRBJ2-2,CASSLRGPGELFF,1,0,1,1
TRBV7-2,TRBJ1-1,CASSLVLNTEAFF,1,0,1,1
TRBV7-2,TRBJ2-1,CASSLGSYNEQFF,1,1,2,2
TRBV11-2,TRBJ2-7,CASSLGQTYEQYF,1,0,1,1
TRBV7-2,TRBJ2-7,CASSLRAGHEQYF,1,0,1,1
TRBV3-1,TRBJ1-3,CASSLTGQNTIYF,1,0,1,1
TRBV7-2,TRBJ2-1,CASSPLERDEQFF,1,0,1,1
TRBV3-1,TRBJ2-5,CASSPRTQETQYF,1,0,1,1
TRBV4-2,TRBJ2-7,CASSHRSAYEQYF,1,0,1,1
TRBV3-1,TRBJ1-1,CASSQVGSTEAFF,1,0,1,1
TRBV14,TRBJ1-5,CASSQGGAQPQHF,1,0,1,1
TRBV3-1,TRBJ2-1,CASSQDQGARGFF,1,0,1,1
TRBV12-3/4,TRBJ2-1,CASSATVYNEQFF,1,0,1,1
TRBV6-2/3/5/6,TRBJ2-5,CASSGQGPETQYF,1,0,1,1
TRBV7-2,TRBJ2-3,CASSRPNTDTQYF,1,0,1,1
TRBV7-6,TRBJ1-1,CASSRTVNTEAFF,1,0,1,1
TRBV6-2/3/5/6,TRBJ1-5,CASRSTGNQPQHF,1,0,1,1
TRBV28,TRBJ1-1,CASRQIDLPEAFF,1,0,1,1
TRBV28,TRBJ2-3,CASRAPGLGTQYF,2,0,1,2
TRBV6-2/3/5/6,TRBJ2-7,CASKTGGRSEQYF,1,0,1,1
TRBV5-1,TRBJ1-1,CASRGLENTEAFF,1,0,1,1
TRBV3-1,TRBJ1-6,CASSFIGDSPLHF,1,2,2,3
TRBV5-1,TRBJ2-7,CASSLAGTEKQYF,1,0,1,1
TRBV5-1,TRBJ2-7,CASSLEVAGEQYF,1,0,1,1
TRBV4-1,TRBJ1-1,CASSLPGDTEAFF,1,0,1,1
TRBV4-1,TRBJ2-7,CASSQDGFYEQYF,2,0,1,2
TRBV5-1,TRBJ2-1,CASSNDRAGEQFF,1,0,1,1
TRBV20-1,TRBJ2-3,CGASLLVTDTQYF,1,0,1,1
TRBV20-1,TRBJ2-1,CSASLPSLDEQFF,1,0,1,1
TRBV20-1,TRBJ1-2,CSASPNIGYGYTF,1,0,1,1
TRBV20-1,TRBJ1-5,CSARDVRGQPQHF,1,0,1,1
TRBV20-1,TRBJ2-5,CSALGLDQETQYF,1,0,1,1
TRBV20-1,TRBJ1-1,CSALGLLNTEAFF,2,0,1,2
TRBV20-1,TRBJ2-3,CSAQRSERGTQYF,1,0,1,1
TRBV20-1,TRBJ1-2,CSAPDRGSSGYTF,1,0,1,1
TRBV20-1,TRBJ1-5,CSATDSPNQPQHF,1,0,1,1
TRBV29-1,TRBJ2-7,CSVGGGLGYEQYF,1,0,1,1
TRBV29-1,TRBJ2-4,CSVGGLAKNIQYF,1,1,2,2
TRBV29-1,TRBJ1-2,CSVDQGRVDGYTF,1,0,1,1
TRBV29-1,TRBJ2-7,CSVEDWVTYEQYF,1,0,1,1
TRBV29-1,TRBJ2-3,CSVRTSARDTQYF,1,0,1,1
TRBV29-1,TRBJ1-2,CSVETGGIHGYTF,1,0,1,1
TRBV29-1,TRBJ1-4,CSATGLTNEKLFL,1,0,1,1
TRBV12-5,TRBJ2-7,CASGSSSYEQYF,1,0,1,1
TRBV30,TRBJ1-1,CAWLTGTIEAFF,1,0,1,1
TRBV30,TRBJ2-1,CAWTTGGNEQFF,1,0,1,1
TRBV30,TRBJ1-2,CAWSVQGYGYTF,1,0,1,1
TRBV19,TRBJ2-5,CASNPRVETQYF,1,0,1,1
TRBV7-9,TRBJ2-3,CASGRGTDTQYF,1,0,1,1
TRBV27,TRBJ2-1,CASGPQGNEQFF,1,0,1,1
TRBV3-1,TRBJ2-3,CASIGATDTQYF,1,0,1,1
TRBV6-2/3/5/6,TRBJ2-1,CASSFPGTEQFF,1,0,1,1
TRBV28,TRBJ2-7,CASSLVGCGQYF,1,0,1,1
TRBV6-2/3/5/6,TRBJ2-7,CASSLIFYEQYF,1,0,1,1
TRBV12-3/4,TRBJ2-7,CASSPSGIEQYF,1,0,1,1
TRBV28,TRBJ1-5,CASSEFDQPQHF,1,0,1,1
TRBV12-3/4,TRBJ2-5,CASSILGETQYF,1,0,1,1
TRBV5-4,TRBJ1-1,CASSLGQGEAFF,1,0,1,1
TRBV7-9,TRBJ1-2,CASSLTGAGYTF,1,0,1,1
TRBV7-9,TRBJ1-1,CASSLGSTEAFF,1,0,1,1
TRBV7-8,TRBJ2-3,CASSLGEDTQYF,1,1,2,2
TRBV7-2,TRBJ1-2,CASSLMDYGYTF,1,0,1,1
TRBV7-9,TRBJ2-1,CASSWDNNEQFF,1,0,1,1
TRBV14,TRBJ1-5,CASSLGTQPQHF,1,0,1,1
TRBV7-2,TRBJ2-1,CASSPRQTEQFF,1,0,1,1
TRBV5-4,TRBJ2-7,CASSPTGIEQYF,1,0,1,1
TRBV11-2,TRBJ2-1,CASSPPYNEQFF,1,0,1,1
TRBV3-1,TRBJ1-1,CASSHRNTEAFF,1,0,1,1
TRBV3-1,TRBJ2-5,CASSHGTETQYF,1,0,1,1
TRBV6-2/3/5/6,TRBJ2-1,CASRIRRGAKFF,1,0,1,1
TRBV3-1,TRBJ2-5,CASNGGGETQYF,1,0,1,1
TRBV5-1,TRBJ2-7,CASSLGDYEQYF,1,0,1,1
TRBV5-1,TRBJ1-1,CASSPGQGEAFF,1,0,1,1
TRBV4-1,TRBJ2-7,CASSQESGPEYF,1,0,1,1
TRBV5-1,TRBJ2-1,CASRREGNEQFF,1,0,1,1
TRBV20-1,TRBJ2-1,CSVDSSYNEQFF,1,0,1,1
TRBV20-1,TRBJ1-1,CSASPGNTEAFF,1,0,1,1
TRBV20-1,TRBJ1-2,CSASASNYGYTF,1,0,1,1
TRBV20-1,TRBJ2-7,CSARPTAGKQYF,1,0,1,1
TRBV20-1,TRBJ2-5,CSARGTGETQYF,1,0,1,1
TRBV20-1,TRBJ1-1,CSARGTGFLAFF,1,0,1,1
TRBV20-1,TRBJ2-5,CSARRTGETQYF,1,0,1,1
TRBV20-1,TRBJ1-1,CSALDLNTEAFF,1,0,1,1
TRBV29-1,TRBJ1-1,CSVGDRVTEAFF,1,0,1,1
TRBV29-1,TRBJ2-5,CSVDGNMETQYF,1,0,1,1
TRBV29-1,TRBJ1-1,CSVEPNISEAFF,1,0,1,1
TRBV29-1,TRBJ2-3,CSVEDLLDTQYF,1,0,1,1
TRBV12-5,TRBJ2-1,CASGLVTGWVF,1,0,1,1
TRBV10-3,TRBJ2-7,CAITDSAVQYS,1,0,1,1
TRBV28,TRBJ2-7,CASVGRYEQYF,1,0,1,1
TRBV2,TRBJ1-1,CASSDWSEAFF,1,0,1,1
TRBV2,TRBJ2-1,CASSEGVKLFF,1,0,1,1
TRBV7-9,TRBJ2-5,CASSFKETQYF,1,0,1,1
TRBV6-2/3/5/6,TRBJ1-2,CASSPLDGYTF,1,0,1,1
TRBV20-1,TRBJ1-1,CSARGRTEAFF,1,0,1,1
TRBV7-9,TRBJ1-2,CASSRIPATF,1,0,1,1
TRBV29-1,TRBJ1-1,CSAQNTEAFF,1,0,1,1
TRBV7-2,TRBJ1-1,CASSLYPPGQGMNTEAFF,2,0,1,2
TRBV18,TRBJ1-2,CASSPLGGDSINYGYTF,1,0,1,1
TRBV2,TRBJ2-1,CASSGLEGGFYNEQFF,2,0,1,2
TRBV29-1,TRBJ2-2,CSATGGGTITGELFF,1,0,1,1
TRBV3-1,TRBJ2-3,CASSHRSVTDTQYF,1,0,1,1
TRBV28,TRBJ1-1,CASRPPSRGTEAFF,2,0,1,2
TRBV15,TRBJ2-6,CATSRDAWVRGYEKSGANVLTF,1,0,1,1
TRBV28,TRBJ2-3,CASSSPGIAVERSASTDTQCF,1,0,1,1
TRBV27,TRBJ1-5,CASSRIVGQGVGRGNQPQHF,1,0,1,1
TRBV13,TRBJ2-2,CASSPPGSLVGVDTGELFF,1,0,1,1
TRBV14,TRBJ2-1,CASSQVTGLAGGIDNEQFF,1,0,1,1
TRBV20-1,TRBJ2-3,CSARDGSSGGGGQTDTQYF,1,0,1,1
TRBV30,TRBJ1-6,CAWSVRPVGAGLNSPLHF,1,0,1,1
TRBV24-1,TRBJ2-2,CATSQQGGGSRTTGELFF,1,0,1,1
TRBV19,TRBJ1-2,CASSIGTGSHSFNYGYTF,1,0,1,1
TRBV6-2/3/5/6,TRBJ2-3,CASSYFLKAGGARDTQYF,1,0,1,1
TRBV6-1,TRBJ2-2,CASSAGQGVGFDTGELFF,1,0,1,1
TRBV7-2,TRBJ1-2,CASSLVRTAPGASYGYTF,1,0,1,1
TRBV7-2,TRBJ1-5,CASSLEGLKGGSNQPQHF,1,0,1,1
TRBV5-4,TRBJ2-1,CASSGGTSGGASYNEQFF,1,0,1,1
TRBV4-1,TRBJ2-3,CASARRAERREYIDTQYF,1,0,1,1
TRBV5-1,TRBJ2-1,CASRRGLSRQSPYNEQFF,1,0,1,1
TRBV20-1,TRBJ2-4,CSASHYQAEPLAKNIQYF,1,0,1,1
TRBV24-1,TRBJ2-2,CATSDLFGQINTGELFF,1,0,1,1
TRBV24-1,TRBJ2-1,CATSDPLAGGPLYEQFF,1,0,1,1
TRBV12-3/4,TRBJ2-1,CASTTLGPGQGTAEQFF,1,0,1,1
TRBV6-2/3/5/6,TRBJ2-3,CASSLPGTGGPQNTQYF,1,0,1,1
TRBV6-2/3/5/6,TRBJ2-1,CASSYVRGRSSYNKQFF,1,0,1,1
TRBV6-2/3/5/6,TRBJ2-1,CASSPSPLAGGRNEQFF,1,0,1,1
TRBV12-3/4,TRBJ1-1,CASSRGGDRGLWTEAFF,1,0,1,1
TRBV5-6,TRBJ1-6,CASSLVAGVANNSPLHF,1,0,1,1
TRBV13,TRBJ2-7,CASSLGLPQGRSYEQYF,1,0,1,1
TRBV7-2,TRBJ1-3,CASSLGGQGAAGNTIYF,1,0,1,1
TRBV11-3,TRBJ2-5,CASSLRRSTELQETQYF,1,0,1,1
TRBV5-8,TRBJ2-1,CASSSLSQPGSYNEQFF,1,0,1,1
TRBV6-1,TRBJ2-7,CASSSQRWEGMAYEQYF,1,0,1,1
TRBV5-5,TRBJ1-1,CASSPDRGWIMNTEAFF,1,0,1,1
TRBV7-9,TRBJ2-7,CASSRSWRDMSDYEQYF,1,0,1,1
TRBV5-6,TRBJ2-5,CASSHWFGLAGQETQYF,1,0,1,1
TRBV3-1,TRBJ2-5,CASSHGVSGGQQETQYF,1,0,1,1
TRBV3-1,TRBJ2-1,CASSQYPAASPYNEQFF,1,0,1,1
TRBV7-9,TRBJ2-2,CASSKGLAGGNTGELFF,1,0,1,1
TRBV6-2/3/5/6,TRBJ1-5,CASRGTGKNYSNQPQHF,1,0,1,1
TRBV2,TRBJ2-6,CASRPDRVGTGANVLTF,1,0,1,1
TRBV5-1,TRBJ2-3,CASSLTPQGRGTDTQYF,1,0,1,1
TRBV4-3,TRBJ2-7,CASSHDAGTGGVYEQYF,1,0,1,1
TRBV20-1,TRBJ1-5,CSARDPNRDIGNQPQHF,1,0,1,1
TRBV29-1,TRBJ2-5,CSFRYPRRGGFEETQYF,1,0,1,1
TRBV7-9,TRBJ1-5,RASRPLKAGLGNQPQHF,1,0,1,1
TRBV24-1,TRBJ1-1,CATSKDRVDGNTEAFF,1,0,1,1
TRBV19,TRBJ2-1,CASRGVGRGAHNEQFF,1,0,1,1
TRBV18,TRBJ2-2,CASSVGQPRNTGELFF,1,0,1,1
TRBV7-2,TRBJ2-1,CASTLAASGGFNEQFF,1,0,1,1
TRBV28,TRBJ2-2,CASTALGLAGPDRLFF,1,0,1,1
TRBV12-3/4,TRBJ1-5,CASSLARQGLRQPQHF,1,0,1,1
TRBV28,TRBJ1-5,CASSLLQGQGNQPQHF,1,0,1,1
TRBV6-2/3/5/6,TRBJ2-3,CASSYVERGGTDTQYF,1,0,1,1
TRBV12-3/4,TRBJ1-5,CASSPPGQGANQPLHF,1,0,1,1
TRBV2,TRBJ1-5,CASSVRQGSPNQPQHF,1,0,1,1
TRBV6-1,TRBJ1-5,CASSEADGTGFQPQHF,1,0,1,1
TRBV6-1,TRBJ2-3,CASSEGLLQFTDTQYF,1,0,1,1
TRBV28,TRBJ2-5,CASSITGGFGVETQYF,1,0,1,1
TRBV11-2,TRBJ2-5,CASSLVSSGGGGTQYF,1,0,1,1
TRBV5-4,TRBJ1-1,CASSLVDRGPNTEAFF,1,0,1,1
TRBV6-2/3/5/6,TRBJ2-1,CASSLGRRLALNEQFF,1,0,1,1
TRBV5-5,TRBJ2-3,CASSLELAGGRDTQYF,1,0,1,1
TRBV5-5,TRBJ1-2,CASSLKRGAVNYGYTF,1,0,1,1
TRBV7-2,TRBJ2-1,CASSLVWTGGRNEQFF,1,0,1,1
TRBV7-2,TRBJ2-7,CASSLALVTGEDEQYF,1,1,2,2
TRBV7-6,TRBJ2-1,CASSLAVASGGGEQFF,1,0,1,1
TRBV7-9,TRBJ2-3,CASSLMTSASTDTQYF,1,0,1,1
TRBV13,TRBJ2-7,CASSLSGGTSSYEQYF,1,0,1,1
TRBV7-8,TRBJ1-1,CASSLGAGGSNTEAFF,1,0,1,1
TRBV11-2,TRBJ1-5,CASSLAQGQGRQPQHF,1,0,1,1
TRBV7-6,TRBJ2-3,CASSLGSPGARDTQYF,1,0,1,1
TRBV5-4,TRBJ2-2,CASSPGGGKNTGELFF,1,0,1,1
TRBV5-4,TRBJ2-7,CASSPGTSGISYEQYF,1,0,1,1
TRBV7-2,TRBJ2-3,CASSPGLAGGGDTQYF,1,0,1,1
TRBV14,TRBJ1-4,CASSQELPGTNEKLFF,1,0,1,1
TRBV9,TRBJ2-3,CASSVLGRGYTDTQYF,1,0,1,1
TRBV9,TRBJ2-2,CASSVQGIGYTGELFF,1,0,1,1
TRBV7-8,TRBJ2-5,CASSDWDSAPQETQYF,2,0,1,2
TRBV5-6,TRBJ1-5,CASSTRDRVLNQPQHF,1,0,1,1
TRBV7-2,TRBJ2-5,CASSTGLAGGVETQYF,1,0,1,1
TRBV11-2,TRBJ1-6,CASRQTGNSYNSPLHF,1,0,1,1
TRBV2,TRBJ2-1,CASRDSGGRLYNEQFF,1,0,1,1
TRBV5-6,TRBJ1-4,CARPFGGVGANEKLFF,1,0,1,1
TRBV5-1,TRBJ2-1,CASISGLGALYNEQFF,1,0,1,1
TRBV5-1,TRBJ2-7,CASSLGATSLSYEQYF,1,0,1,1
TRBV5-1,TRBJ1-1,CASSLESGIRHTEAFF,1,0,1,1
TRBV5-1,TRBJ2-7,CASSSSRGTTTYEQYF,1,0,1,1
TRBV11-2,TRBJ2-2,CASSRGQGSNTGELFF,1,0,1,1
TRBV4-1,TRBJ2-5,CASSQVTGGGQETQYF,1,0,1,1
TRBV4-3,TRBJ1-4,CASSQDSTGDAEKLFF,1,0,1,1
TRBV4-1,TRBJ1-6,CASSQEDFSYNSPLHF,1,0,1,1
TRBV4-3,TRBJ2-3,CASSQETAGLTDTQYF,1,0,1,1
TRBV4-1,TRBJ2-4,CASSQITGFAKNIQYF,1,0,1,1
TRBV5-1,TRBJ2-1,CASSAERGFLYNEQFF,1,0,1,1
TRBV5-1,TRBJ2-5,CASSIRLAGDLETQYF,1,0,1,1
TRBV20-1,TRBJ1-6,CSARSGTGRSNSPLHF,1,0,1,1
TRBV20-1,TRBJ2-2,CSARDWGGADTGELFF,1,0,1,1
TRBV20-1,TRBJ2-7,CSARDRDSGNPYEQYF,1,0,1,1
TRBV29-1,TRBJ2-5,CSVEGAVGGPQETQYF,1,0,1,1
TRBV12-5,TRBJ1-5,CASAAPGDSNQPQHF,1,0,1,1
TRBV30,TRBJ2-3,CAWLRAGGRPDTQYF,1,0,1,1
TRBV30,TRBJ2-3,CAWSNPHSDTDTQYF,1,0,1,1
TRBV3-1,TRBJ2-2,CAGSQDRVGTGELSF,1,0,1,1
TRBV12-3/4,TRBJ1-2,CATMERWGQTSRYTF,1,0,1,1
TRBV24-1,TRBJ2-6,CATSDTISGANVLTF,1,0,1,1
TRBV19,TRBJ2-7,CASSMERGSSYEQYF,1,0,1,1
TRBV19,TRBJ1-1,CASSTQPQGASEAFF,1,0,1,1
TRBV19,TRBJ2-6,CASSTQGAGANVLTF,1,0,1,1
TRBV18,TRBJ2-1,CASSPSTGVHNEQFF,1,0,1,1
TRBV18,TRBJ2-7,CASSPAGRDSYEQYF,1,0,1,1
TRBV18,TRBJ1-2,CASSPGQGNVYGYTF,1,0,1,1
TRBV6-4,TRBJ2-2,CASRDRGVVSGELFF,1,0,1,1
TRBV12-3/4,TRBJ1-5,CASGLGILSNQPQHF,1,0,1,1
TRBV28,TRBJ2-1,CASTESTGKNNEQFF,1,0,1,1
TRBV12-3/4,TRBJ2-7,CASSFRGQGTYEQYF,1,0,1,1
TRBV12-3/4,TRBJ1-5,CASSFHLNSIQPQHF,1,0,1,1
TRBV6-2/3/5/6,TRBJ1-1,CASSFRRQGNTEAFF,1,0,1,1
TRBV28,TRBJ2-2,CASSLTRQGSGELFF,1,0,1,1
TRBV12-3/4,TRBJ1-4,CASSLATGGAEKLFF,1,0,1,1
TRBV7-9,TRBJ1-5,CASSLGGRTEQPQHF,1,0,1,1
TRBV28,TRBJ1-6,CASSLNTGYNSPLHF,1,0,1,1
TRBV6-2/3/5/6,TRBJ1-1,CASSSFGQGNTEAFF,1,0,1,1
TRBV5-4,TRBJ2-2,CASSSDGGGNGELFF,1,0,1,1
TRBV6-2/3/5/6,TRBJ1-4,CASSLPGGGNEKLFF,1,0,1,1
TRBV12-3/4,TRBJ2-3,CASSPRGGSTDTQYF,1,0,1,1
TRBV3-1,TRBJ2-5,CASSRRGGLEETQYF,1,0,1,1
TRBV7-9,TRBJ2-6,CASSHRTAGANVLTF,1,0,1,1
TRBV12-3/4,TRBJ2-2,CASSQDRSNTGELFF,1,0,1,1
TRBV2,TRBJ2-4,CASSVPRLAKNIQYF,1,0,1,1
TRBV2,TRBJ2-5,CASSKEGTFQETQYF,1,0,1,1
TRBV7-9,TRBJ1-6,CASSFVAGGNSPPHF,1,0,1,1
TRBV7-6,TRBJ2-1,CASSFGGSVYNEQFF,1,0,1,1
TRBV7-3,TRBJ1-2,CASSLYGTGNYGYTF,1,0,1,1
TRBV7-2,TRBJ2-3,CASSLRQRSPDTQYF,1,0,1,1
TRBV7-2,TRBJ1-6,CASSLVAGRDSPLHF,1,0,1,1
TRBV7-9,TRBJ1-2,CASSLVSGQDYGYTL,1,0,1,1
TRBV11-3,TRBJ2-1,CASSLDQRGGNEQFF,1,0,1,1
TRBV11-2,TRBJ1-2,CASSLDPGAGYGYTF,1,0,1,1
TRBV6-2/3/5/6,TRBJ2-3,CASSLTGGLRDTQYF,1,0,1,1
TRBV7-3,TRBJ2-5,CASSLRRGGQETQYF,1,0,1,1
TRBV7-2,TRBJ2-7,CASSSPGQGFYEQYF,1,0,1,1
TRBV7-9,TRBJ1-1,CASSSEVGSLTEAFF,1,0,1,1
TRBV7-3,TRBJ2-2,CASSSRVSRTGELFF,1,0,1,1
TRBV7-2,TRBJ1-4,CASSSRGATNEKLFF,1,0,1,1
TRBV13,TRBJ1-1,CASSSPGERGTEAFF,1,0,1,1
TRBV12-3/4,TRBJ1-2,CASSLYNRRGYGYTF,1,0,1,1
TRBV7-9,TRBJ2-2,CASSLRGSNAGELFF,1,0,1,1
TRBV4-2,TRBJ1-5,CASSLDGQGDQPQHF,1,0,1,1
TRBV5-6,TRBJ2-3,CASSLTGGNTDTQYF,1,0,1,1
TRBV3-1,TRBJ2-1,CASSPGKSPYNEQFF,1,0,1,1
TRBV9,TRBJ2-2,CASSPRVQDFGELFF,1,0,1,1
TRBV6-2/3/5/6,TRBJ2-6,CASSPRPSGANVLTF,1,0,1,1
TRBV6-2/3/5/6,TRBJ2-5,CASSPRRGGEETQYF,1,0,1,1
TRBV3-1,TRBJ2-4,CASSPVGLAKNIQYF,1,0,1,1
TRBV7-9,TRBJ2-5,CASSPGTASQETQYF,1,0,1,1
TRBV7-2,TRBJ1-2,CASSPAPPNMGGYTF,1,0,1,1
TRBV7-9,TRBJ2-1,CASSPKGGYLGEQFF,1,0,1,1
TRBV7-2,TRBJ1-5,CASSRIQDRGQPQHF,1,0,1,1
TRBV3-1,TRBJ1-2,CASSRGQGENYGYTF,1,0,1,1
TRBV14,TRBJ2-7,CASSHETGWFQEQYF,1,0,1,1
TRBV3-1,TRBJ2-7,CASSHRARGESEQYF,1,0,1,1
TRBV13,TRBJ2-1,CASSQSGTGSHEQFF,1,0,1,1
TRBV4-2,TRBJ1-2,CASSQASRDGNGYTF,1,0,1,1
TRBV3-1,TRBJ1-5,CASSQAGQGNQPQHF,1,0,1,1
TRBV3-1,TRBJ1-6,CASSQGGQGNSPLHF,1,0,1,1
TRBV3-1,TRBJ1-2,CASSQGRQVNYGYTF,1,0,1,1
TRBV9,TRBJ2-3,CASSVSGTSTDTQYF,1,1,2,2
TRBV9,TRBJ1-5,CASSVGEGRHQPQHF,1,0,1,1
TRBV9,TRBJ2-3,CASSVEAGLGDTQYF,1,0,1,1
TRBV9,TRBJ2-5,CASSVAGGGGETQYF,1,0,1,1
TRBV7-2,TRBJ2-2,CASSGGLALTGELFS,1,0,1,1
TRBV5-5,TRBJ1-6,CASSGGGQGNSPLHF,1,0,1,1
TRBV6-2/3/5/6,TRBJ1-1,CASRVGQLLNTEAFF,1,0,1,1
TRBV2,TRBJ2-1,CASRGLAGTYNEQFF,1,0,1,1
TRBV12-3/4,TRBJ1-5,CASRTTGAGNQPQHF,1,0,1,1
TRBV7-2,TRBJ2-3,CTSSLGPAGTDTQYF,1,0,1,1
TRBV5-1,TRBJ2-1,CASGGLAGTYNERFF,1,0,1,1
TRBV5-1,TRBJ2-5,CASSRGGPPQETQYF,1,0,1,1
TRBV10-2,TRBJ1-6,CASSDPGQGNSPLHF,1,0,1,1
TRBV10-2,TRBJ1-6,CASSTGQANNSPLHF,1,0,1,1
TRBV5-1,TRBJ1-1,CASSLAGVKNTEAFF,1,0,1,1
TRBV5-1,TRBJ2-4,CASSLGGLAKNIQYF,1,0,1,1
TRBV5-1,TRBJ2-1,CASSSDPGGHNEQFF,1,0,1,1
TRBV5-1,TRBJ1-6,CASSSTQGRGSPLHF,1,0,1,1
TRBV5-1,TRBJ1-4,CASSSTGGRNEKLFF,1,0,1,1
TRBV5-1,TRBJ2-7,CASSLDWQNSYEQYF,1,0,1,1
TRBV5-1,TRBJ1-1,CASSLDLRAQSKAFF,1,0,1,1
TRBV4-3,TRBJ2-2,CASSPQSPNTGELFF,1,0,1,1
TRBV4-1,TRBJ2-1,CASSPGRQVNNEQFF,1,0,1,1
TRBV4-3,TRBJ1-1,CASSREGAGSTEAFF,1,0,1,1
TRBV5-1,TRBJ2-7,CASSRTGTGAYEQYF,1,0,1,1
TRBV4-1,TRBJ2-7,CASSQRQGAPYEQYF,1,0,1,1
TRBV4-3,TRBJ2-5,CASSQGTGVQETQYF,1,0,1,1
TRBV4-3,TRBJ2-3,CASSQDILAGDTQYF,1,0,1,1
TRBV5-1,TRBJ2-1,CASSGTGTGGNEQFF,1,0,1,1
TRBV5-1,TRBJ2-7,CASSEGQGLSYEQYF,1,0,1,1
TRBV5-1,TRBJ2-7,CASRSYQGVGGEQYF,1,0,1,1
TRBV20-1,TRBJ2-5,CSASQTSGGQETQYF,1,0,1,1
TRBV20-1,TRBJ2-2,CSAAPGGPLTGELFF,1,0,1,1
TRBV20-1,TRBJ2-7,CSATLSGGSSYEQYF,1,0,1,1
TRBV20-1,TRBJ1-1,CSARDPRRTHTEAFF,1,0,1,1
TRBV20-1,TRBJ2-4,CSELAGGLAKNIQYF,1,0,1,1
TRBV29-1,TRBJ2-1,CSVEGSRAGGDEQFF,1,0,1,1
TRBV14,TRBJ1-1,RASSNLGTRNTEAFF,1,0,1,1
TRBV15,TRBJ2-1,SATSRRGNSYNEQFF,1,0,1,1
TRBV12-5,TRBJ2-5,CASAIAGGQETQYF,1,0,1,1
TRBV30,TRBJ1-2,CAWSLPRQSYGYTF,1,0,1,1
TRBV10-3,TRBJ2-1,CAINPSGGYNEQFF,1,0,1,1
TRBV24-1,TRBJ2-2,CATSEPGVAGELFF,1,0,1,1
TRBV24-1,TRBJ1-1,CATSENGVWAEAFF,1,0,1,1
TRBV15,TRBJ2-5,CATSRVRFKETQYF,1,0,1,1
TRBV19,TRBJ2-5,CASSIGQAQETQYF,1,0,1,1
TRBV2,TRBJ2-1,CASSSGGAYNEQFF,1,0,1,1
TRBV18,TRBJ2-1,CASSKEQGVNEQFF,1,0,1,1
TRBV18,TRBJ2-3,CASSPSHGTDTQYF,1,0,1,1
TRBV18,TRBJ2-5,CASSPVAGEETQYF,1,0,1,1
TRBV18,TRBJ2-3,CASSPPRSDDTQYF,1,0,1,1
TRBV18,TRBJ1-3,CASSHDRSGNTIYF,1,0,1,1
TRBV18,TRBJ1-6,CASSQDRINSPLHF,1,0,1,1
TRBV12-3/4,TRBJ2-5,CASSMAGRQETQYF,1,0,1,1
TRBV2,TRBJ1-5,CASGERTGDQPQHF,1,1,2,2
TRBV5-4,TRBJ2-2,CASGTGGLNGELFF,1,0,1,1
TRBV6-4,TRBJ2-1,CASTVRGSYNEQFF,1,0,1,1
TRBV25-1,TRBJ1-1,CASTSDRTNTEAFF,1,0,1,1
TRBV6-2/3/5/6,TRBJ2-4,CASTQGIAKNIQYF,1,0,1,1
TRBV28,TRBJ2-7,CASTTHGDTYEQYF,1,1,2,2
TRBV27,TRBJ2-5,CASSLFGGGETQYF,1,0,1,1
TRBV27,TRBJ1-4,CASSLSMAGGKLFF,1,1,2,2
TRBV6-2/3/5/6,TRBJ1-6,CASSLSGVRSPLLF,1,0,1,1
TRBV12-3/4,TRBJ1-6,CASSLSGVRSPLHF,1,0,1,1
TRBV12-3/4,TRBJ2-5,CASSLGVSRETQYF,1,0,1,1
TRBV27,TRBJ2-3,CASSLEGYTDTQYF,1,0,1,1
TRBV6-2/3/5/6,TRBJ2-3,CASSLETGTDTQYF,1,0,1,1
TRBV6-2/3/5/6,TRBJ1-1,CASSYLQQNTEAFF,1,0,1,1
TRBV12-3/4,TRBJ2-6,CASSLSSGANVLTF,1,0,1,1
TRBV6-1,TRBJ2-3,CASSANPGGYTQYF,1,0,1,1
TRBV25-1,TRBJ1-4,CASSGQGLGEKLFF,1,0,1,1
TRBV2,TRBJ2-7,CASSGAGSSYEQYF,1,0,1,1
TRBV2,TRBJ2-2,CASSEIHGSGELFF,1,0,1,1
TRBV6-2/3/5/6,TRBJ1-4,CASSFGQFNEKLFF,1,0,1,1
TRBV7-2,TRBJ2-3,CASSFWTDLDTQYF,1,0,1,1
TRBV5-6,TRBJ1-1,CASSLVDGSGEAFF,1,0,1,1
TRBV5-4,TRBJ2-6,CASSLDSGANVLTF,1,0,1,1
TRBV11-2,TRBJ2-7,CASSLLSGQGILYF,1,0,1,1
TRBV7-3,TRBJ2-3,CASSLSGGTDTQYF,1,0,1,1
TRBV7-2,TRBJ2-3,CASSLGRGQDTQYF,1,0,1,1
TRBV11-3,TRBJ2-7,CASSLGRWSYEQYF,1,0,1,1
TRBV11-2,TRBJ1-6,CASSLGQQYSPLHF,1,0,1,1
TRBV5-6,TRBJ1-2,CASSSGRTLYGYTF,1,0,1,1
TRBV12-3/4,TRBJ1-5,CASSLLGANQPQHF,1,0,1,1
TRBV7-3,TRBJ2-1,CASSLTGLLDEQFF,1,0,1,1
TRBV7-9,TRBJ1-4,CASSLTGVNEKLFF,1,0,1,1
TRBV7-2,TRBJ2-2,CASSPLLDSGELFF,1,0,1,1
TRBV28,TRBJ1-6,CASSPGGRDSPLHF,1,0,1,1
TRBV7-9,TRBJ1-2,CASSPGSKVYGYTF,1,0,1,1
TRBV7-6,TRBJ1-5,CASSPGQGGQPQHF,1,1,2,2
TRBV11-3,TRBJ2-1,CASSPGQRDNEQFF,1,0,1,1
TRBV11-2,TRBJ2-5,CASSPQAGQETQYF,1,0,1,1
TRBV12-3/4,TRBJ2-7,CASSPRLAPYEQYF,1,0,1,1
TRBV7-3,TRBJ2-5,CASSPGGGAETQYF,1,0,1,1
TRBV6-2/3/5/6,TRBJ1-1,CASSPGTGQFEAFF,1,0,1,1
TRBV5-4,TRBJ2-5,CASSPGLAQETQYF,1,0,1,1
TRBV7-9,TRBJ1-1,CASSPDSSRTEAFF,1,0,1,1
TRBV3-1,TRBJ2-1,CASSQSTQYNEQFF,1,0,1,1
TRBV3-1,TRBJ1-2,CASSQVQGNYGYTF,1,0,1,1
TRBV3-1,TRBJ2-3,CASSQEPAGDTQYF,1,0,1,1
TRBV9,TRBJ1-2,CASSVDGSAYGYTF,1,0,1,1
TRBV7-9,TRBJ2-3,CASSAGLPRDTQYF,1,0,1,1
TRBV7-9,TRBJ2-5,CASSAGQGLETQYF,1,0,1,1
TRBV11-2,TRBJ2-1,CASSGRGSTWEQFF,1,0,1,1
TRBV7-9,TRBJ1-4,CASSDDRGLEKLFF,1,0,1,1
TRBV7-9,TRBJ2-2,CASSIWTETGELFF,1,0,1,1
TRBV3-1,TRBJ2-3,CASSTRSLTDTQYF,1,0,1,1
TRBV2,TRBJ1-2,CASSNVLGVFGYTF,1,0,1,1
TRBV27,TRBJ1-1,CASRPTGFATEAFF,1,0,1,1
TRBV6-4,TRBJ1-1,CASRGHREVTEAFF,1,0,1,1
TRBV12-3/4,TRBJ1-2,CASRDSNTPLGYTF,1,0,1,1
TRBV9,TRBJ2-7,CASRRDLTSYEQYF,1,0,1,1
TRBV7-2,TRBJ2-1,CASRVSGRPGEQFF,1,0,1,1
TRBV5-8,TRBJ1-5,CASNPTDSNQPQHF,1,0,1,1
TRBV2,TRBJ2-7,CANKGASGDYEQYF,1,0,1,1
TRBV5-1,TRBJ2-3,CASSLTSGGDTQYF,1,0,1,1
TRBV5-1,TRBJ1-5,CASSPDSLNQPQHF,1,0,1,1
TRBV5-1,TRBJ2-1,CASSLVEGSREQFF,1,0,1,1
TRBV5-1,TRBJ1-1,CASSLGWGNTEAFF,1,0,1,1
TRBV5-1,TRBJ2-1,CASSLLGKGNEQFF,1,0,1,1
TRBV5-1,TRBJ2-1,CASSLGGNRNEQFF,1,0,1,1
TRBV5-1,TRBJ1-2,CASSLDRGKYGYTF,1,0,1,1
TRBV5-1,TRBJ1-1,CASSPGTGNTEAFF,1,0,1,1
TRBV5-1,TRBJ2-7,CASSPRGQAYEQYF,1,0,1,1
TRBV4-3,TRBJ2-1,CASSHGDIGNEQFF,1,0,1,1
TRBV5-1,TRBJ1-5,CASSTSGSSEPQHF,1,0,1,1
TRBV20-1,TRBJ1-5,CSALQGGGNQPQHF,1,0,1,1
TRBV20-1,TRBJ2-3,CSAPRNGGPDTQYF,1,0,1,1
TRBV20-1,TRBJ1-5,CSASSGYSNQPQHF,1,0,1,1
TRBV20-1,TRBJ1-5,CSARRADSNQPQHF,1,0,1,1
TRBV20-1,TRBJ1-2,CSARGDRLNYGYTF,1,0,1,1
TRBV20-1,TRBJ1-1,CSARDGAWGTEAFF,1,0,1,1
TRBV20-1,TRBJ1-6,CSARERTGNSPLHF,1,0,1,1
TRBV20-1,TRBJ2-3,CSKGTSGGANTQYF,1,1,2,2
TRBV20-1,TRBJ2-5,CSSSGGALRETQYF,1,0,1,1
TRBV29-1,TRBJ2-2,CSVVGTSNTGELFF,1,0,1,1
TRBV29-1,TRBJ2-1,CSVASGGVSSEQFF,1,2,2,3
TRBV29-1,TRBJ2-3,CSVGEQGYSDTQYF,1,0,1,1
TRBV29-1,TRBJ2-5,CSVEVGQWGETQYF,1,0,1,1
TRBV7-3,TRBJ1-5,RASSLWRENQPQHF,1,0,1,1
TRBV30,TRBJ1-2,CAWSDTRNYGYTF,1,0,1,1
TRBV24-1,TRBJ2-3,CATIEDLTDTQYF,1,0,1,1
TRBV24-1,TRBJ2-5,CATSGGGKETQYF,1,0,1,1
TRBV19,TRBJ1-1,CASTPGGKTEAFF,1,0,1,1
TRBV19,TRBJ2-5,CASTRQGAATQYF,1,0,1,1
TRBV19,TRBJ2-3,CASSLSVADTQYF,1,0,1,1
TRBV19,TRBJ2-1,CASSTSPGTPQFF,1,0,1,1
TRBV19,TRBJ2-7,CASRDRASYEQYF,1,0,1,1
TRBV19,TRBJ1-2,CASKGTELYAYTF,1,0,1,1
TRBV6-2/3/5/6,TRBJ1-2,CASLETGNYGYTF,1,0,1,1
TRBV3-1,TRBJ2-7,CASRASGVYEQYF,1,0,1,1
TRBV6-2/3/5/6,TRBJ1-5,CASQETSNQPQHF,1,0,1,1
TRBV6-2/3/5/6,TRBJ2-1,CASSLRTPNGQFF,1,0,1,1
TRBV28,TRBJ1-2,CASSLVGTNGYTF,1,0,1,1
TRBV6-2/3/5/6,TRBJ1-5,CASSSSLHQPQHF,1,0,1,1
TRBV6-2/3/5/6,TRBJ1-5,CASSYLMSQPQHF,1,0,1,1
TRBV12-3/4,TRBJ1-2,CASSPRPGFGYTF,1,0,1,1
TRBV6-2/3/5/6,TRBJ1-2,CASSPRGGVGYAF,1,0,1,1
TRBV6-2/3/5/6,TRBJ2-5,CASSRGQQETQYF,1,0,1,1
TRBV6-2/3/5/6,TRBJ2-5,CASSQRLAETQYF,1,0,1,1
TRBV14,TRBJ2-5,CASSQRPYETQYF,1,0,1,1
TRBV6-1,TRBJ2-1,CASSVRGLYEQFF,1,0,1,1
TRBV14,TRBJ2-1,CASSFGTAGEQFF,1,0,1,1
TRBV11-2,TRBJ1-1,CASSLAGGTEAFF,1,0,1,1
TRBV7-2,TRBJ2-7,CASSLGAVPEQYF,1,0,1,1
TRBV7-2,TRBJ2-5,CASSYAVQETQYF,1,0,1,1
TRBV11-3,TRBJ2-3,CASSPTPALTQYF,1,0,1,1
TRBV7-9,TRBJ2-7,CASSPGGAYEQYF,1,0,1,1
TRBV7-2,TRBJ1-1,CASSPGTGERAFF,1,0,1,1
TRBV6-2/3/5/6,TRBJ1-5,CASSPFGGQPQHF,1,0,1,1
TRBV7-9,TRBJ1-2,CASSPQGGYGYTF,1,0,1,1
TRBV7-6,TRBJ2-7,CASSRSSSYEQYF,1,0,1,1
TRBV3-1,TRBJ2-7,CASSHSSSYEQYF,1,0,1,1
TRBV3-1,TRBJ1-5,CASSQAQIGAQHF,1,0,1,1
TRBV3-1,TRBJ2-3,CASSQQLADTQYF,1,0,1,1
TRBV7-2,TRBJ2-7,CASSAMGGGEQYF,1,0,1,1
TRBV12-3/4,TRBJ2-3,CASSGGITDTQYF,1,0,1,1
TRBV7-9,TRBJ2-3,CASSRTDTDTQYF,1,0,1,1
TRBV12-3/4,TRBJ1-2,CASRSPRVDGYTF,1,1,2,2
TRBV27,TRBJ1-5,CASRSTGPEPQHF,1,0,1,1
TRBV28,TRBJ2-5,CASRPQGVETQYF,1,0,1,1
TRBV12-3/4,TRBJ2-7,CASREAAGGQQYF,1,0,1,1
TRBV20-1,TRBJ2-7,CCARVGGRYEQYF,1,0,1,1
TRBV5-1,TRBJ1-1,CASSPELNTEAFF,1,0,1,1
TRBV5-1,TRBJ2-3,CASSLVLTDTQYF,1,0,1,1
TRBV5-1,TRBJ2-6,CASSSSGANVLTF,1,0,1,1
TRBV4-1,TRBJ1-1,CASSPLIDTEAFF,1,0,1,1
TRBV20-1,TRBJ2-5,CGRSRGGPETQYF,1,0,1,1
TRBV29-1,TRBJ1-5,CGTAAALGQPQHF,1,0,1,1
TRBV20-1,TRBJ2-1,CSAPRGNVDEQFF,1,0,1,1
TRBV20-1,TRBJ1-5,CSAPQQGSGTQHF,1,0,1,1
TRBV20-1,TRBJ2-7,CSASSGILYEQYF,1,0,1,1
TRBV20-1,TRBJ2-2,CSASEPKGGELFF,1,0,1,1
TRBV20-1,TRBJ1-2,CSASRQGTHGYTF,1,0,1,1
TRBV20-1,TRBJ1-4,CSASGPLGEKLFF,1,0,1,1
TRBV20-1,TRBJ2-3,CSARQGGTDTQYF,1,0,1,1
TRBV20-1,TRBJ2-6,CSARGSGANVLTF,1,0,1,1
TRBV20-1,TRBJ1-3,CSARAGAGNTIYF,1,0,1,1
TRBV20-1,TRBJ2-7,CSAARGSSYEQYF,1,0,1,1
TRBV20-1,TRBJ2-5,CSAGVLGRQGQYF,1,0,1,1
TRBV20-1,TRBJ2-3,CSADTSWADTQYF,1,0,1,1
TRBV29-1,TRBJ2-2,CSGWGSDTGELFF,1,0,1,1
TRBV29-1,TRBJ2-7,CSVRTVDHYEQYF,1,0,1,1
TRBV29-1,TRBJ2-3,CSVVPSSTDTQYF,1,0,1,1
TRBV29-1,TRBJ1-1,CSVEGKMNTEAFF,1,0,1,1
TRBV29-1,TRBJ2-7,CSVQGLNSYEQYF,1,0,1,1
TRBV29-1,TRBJ2-1,CSEAGQGVGEQFS,1,0,1,1
TRBV29-1,TRBJ2-5,CSTKGPSQETQYF,1,1,2,2
TRBV10-3,TRBJ1-5,YASSERSNQPQHF,1,0,1,1
TRBV12-5,TRBJ1-2,CASGGENYGYTF,1,0,1,1
TRBV30,TRBJ2-4,CAWGPGTNIQYF,1,0,1,1
TRBV30,TRBJ2-7,CAWKQGTYEQYF,1,0,1,1
TRBV24-1,TRBJ1-1,CATKTGGLKAFF,1,0,1,1
TRBV12-3/4,TRBJ1-5,CASSRGNQPQHF,1,0,1,1
TRBV18,TRBJ1-1,CASSPDIQEAFF,1,0,1,1
TRBV7-2,TRBJ1-4,CASSIRGEKLFF,1,0,1,1
TRBV28,TRBJ2-7,CASRPDLYEQYF,1,0,1,1
TRBV5-5,TRBJ2-7,CASTLNYYEQYF,1,0,1,1
TRBV6-2/3/5/6,TRBJ1-1,CASSFTNTEAFF,1,0,1,1
TRBV6-2/3/5/6,TRBJ2-7,CASSYGAYEQYF,1,0,1,1
TRBV2,TRBJ2-2,CASSVDSGELFF,1,0,1,1
TRBV6-1,TRBJ1-5,CASSDSRGPQHF,1,0,1,1
TRBV5-6,TRBJ1-1,CASSLQNTEAFF,1,0,1,1
TRBV7-8,TRBJ2-3,CASSLVGGTQYF,1,0,1,1
TRBV7-9,TRBJ1-2,CASSLSGNGYTF,1,0,1,1
TRBV7-9,TRBJ2-1,CASSLEAGEQFF,1,0,1,1
TRBV5-4,TRBJ1-2,CASSSSGPGYTF,1,0,1,1
TRBV7-9,TRBJ2-1,CASSPRPVEQFF,1,0,1,1
TRBV3-1,TRBJ2-7,CASSARPYEQYF,1,0,1,1
TRBV12-3/4,TRBJ1-5,CASRYKHQPQHF,1,0,1,1
TRBV5-1,TRBJ2-7,CASSLDSYEQYF,1,0,1,1
TRBV5-1,TRBJ2-5,CASSLGKETQYF,1,1,2,2
TRBV20-1,TRBJ2-1,CSAAEAGIEQFF,1,0,1,1
TRBV20-1,TRBJ1-2,CSARGTGGGYTF,1,0,1,1
TRBV20-1,TRBJ2-1,CSAVAGVGEQFF,1,0,1,1
TRBV20-1,TRBJ1-1,CSAGRINTEAFF,1,0,1,1
TRBV29-1,TRBJ2-3,CSVDGGTDTQYF,1,0,1,1
TRBV29-1,TRBJ1-2,CSVEDAVNGYTF,1,0,1,1
TRBV29-1,TRBJ2-3,CSVEETTDTQYF,1,0,1,1
TRBV29-1,TRBJ1-5,CSVTSGDQPQHF,1,0,1,1
TRBV29-1,TRBJ1-2,CSAGQGERGYTF,1,0,1,1
TRBV10-3,TRBJ2-3,CASLAFDTQYF,1,0,1,1
TRBV30,TRBJ2-5,CAWSVLETQYF,1,0,1,1
TRBV15,TRBJ2-5,CATSRVETQYF,1,0,1,1
TRBV2,TRBJ2-1,CASTRNNEQFF,1,0,1,1
TRBV12-3/4,TRBJ2-7,CASSLGAEQYF,1,0,1,1
TRBV25-1,TRBJ1-1,CASSYSYEAFF,1,0,1,1
TRBV12-3/4,TRBJ2-3,CASSPRDTQYF,1,0,1,1
TRBV2,TRBJ2-3,CASSAEATQYF,1,0,1,1
TRBV6-2/3/5/6,TRBJ1-1,CASSTYTEAFF,1,0,1,1
TRBV3-1,TRBJ2-7,CASSQYYEQYF,1,0,1,1
TRBV3-1,TRBJ2-7,CASSQTWEQYF,1,1,2,2
TRBV7-9,TRBJ2-7,CASSDSGEQYF,1,0,1,1
TRBV5-1,TRBJ1-1,CASSERYEAFF,1,0,1,1
TRBV20-1,TRBJ1-1,CSARGDTEAFF,1,0,1,1
TRBV29-1,TRBJ1-1,CSPTGLTEAFF,1,0,1,1
TRBV29-1,TRBJ2-3,CSVDGGLTQYF,1,0,1,1
TRBV29-1,TRBJ2-5,CSGRLGETQYF,1,0,1,1
TRBV12-3/4,TRBJ1-1,CASSFSEAFF,1,0,1,1
TRBV7-9,TRBJ2-1,CASSKNEQFF,1,0,1,1
TRBV29-1,TRBJ1-4,CSVLGEKLFF,1,0,1,1
TRBV27,TRBJ1-1,CASRTGTDLITFGVGNTEAFF,1,0,1,1
TRBV7-9,TRBJ2-1,CASSYSISGGAPRGNNEQFF,1,0,1,1
TRBV5-4,TRBJ2-3,CASSSPPLALPGESTDTQYF,1,1,2,2
TRBV4-1,TRBJ1-5,CASSQEWNIPTGYSNQPQHF,1,0,1,1
TRBV18,TRBJ2-6,CASSPPDRGRPAGANVLTF,1,0,1,1
TRBV6-2/3/5/6,TRBJ2-5,CASSLESPLCVGVQETQYF,1,0,1,1
TRBV5-6,TRBJ2-3,CASSSLALAGALGTDTQYF,1,0,1,1
TRBV11-3,TRBJ2-1,CASSPRDRETVIVYNEQFF,1,0,1,1
TRBV7-9,TRBJ2-1,CASSAAPGLAGAYYNEQFF,1,0,1,1
TRBV10-2,TRBJ2-1,CASSVILAGPHPDYNEQFF,1,0,1,1
TRBV29-1,TRBJ2-2,CSVYGRASGGERGTGELFS,1,0,1,1
TRBV12-3/4,TRBJ2-2,CAGSKTSGRIGNTGELFF,1,0,1,1
TRBV3-1,TRBJ1-5,CASSRGFAVTGSNQPQHF,1,0,1,1
TRBV28,TRBJ1-1,CASGVPPDYGRMNTEAFF,1,0,1,1
TRBV6-2/3/5/6,TRBJ2-1,CASSFGLAGGFSYNEQFF,1,0,1,1
TRBV2,TRBJ2-2,CASSRERPGQGRTGELFF,1,0,1,1
TRBV6-2/3/5/6,TRBJ1-2,CASSRSGQGYLVRASYTF,1,0,1,1
TRBV11-2,TRBJ2-2,CASSLKTSGGLYTGELFF,1,0,1,1
TRBV13,TRBJ1-2,CASSSIRQGGPYNYGYTF,1,0,1,1
TRBV4-2,TRBJ1-6,CASSQDVGPSSYNSPLHF,1,0,1,1
TRBV5-4,TRBJ2-3,CASSVVTLAGGSTDTQYF,1,0,1,1
TRBV9,TRBJ2-6,CASSVGGGRFSGANVLTF,1,0,1,1
TRBV9,TRBJ2-2,CASSVIGTTGGNTGELFF,1,0,1,1
TRBV2,TRBJ2-1,CASRLGTSGGLSYNEQFF,1,0,1,1
TRBV30,TRBJ2-5,CAWKPWGSGGGRETQYF,1,0,1,1
TRBV24-1,TRBJ2-7,CATSSCLAGGSSYEQYF,1,0,1,1
TRBV19,TRBJ2-3,CASSMYPPGLGTDTQYF,1,0,1,1
TRBV19,TRBJ2-5,CASSAPPGRGNQETQYF,1,0,1,1
TRBV28,TRBJ2-4,CASSFPDRGKLKNIQYF,1,0,1,1
TRBV6-2/3/5/6,TRBJ2-1,CASSYSFQDTRINEQFF,1,0,1,1
TRBV19,TRBJ1-5,CASSLRGSGNFYQPQHF,1,0,1,1
TRBV28,TRBJ1-5,CASSTLDRGNSNQPQHF,1,0,1,1
TRBV5-4,TRBJ2-2,CASSLAAGRSNSGELFF,1,0,1,1
TRBV5-6,TRBJ2-5,CASSLTFPEDRQETQYF,1,0,1,1
TRBV7-6,TRBJ1-5,CASSLRPMQESNQPQHF,1,1,2,2
TRBV7-3,TRBJ2-3,CASSLRPAGASTDTQYF,1,0,1,1
TRBV11-2,TRBJ2-5,CASSLVGQGAFGETQYF,1,0,1,1
TRBV7-3,TRBJ2-6,CASSPSFEGYGANVLTF,1,0,1,1
TRBV6-2/3/5/6,TRBJ2-3,CASSQPGLAGFTDTQYF,1,0,1,1
TRBV6-2/3/5/6,TRBJ2-3,CASSSYGLAGGSDTQYF,1,0,1,1
TRBV27,TRBJ2-6,CASRRDTLLSGANVLTF,1,0,1,1
TRBV5-1,TRBJ2-2,CASSYLAGAVNTGELFF,1,0,1,1
TRBV5-1,TRBJ1-5,CASSPGTGMNSNQPQHF,1,0,1,1
TRBV4-1,TRBJ2-2,CASSQVDLGFLTGELFF,1,0,1,1
TRBV20-1,TRBJ2-7,CSAQREFGQGLSYEQYF,1,0,1,1
TRBV12-5,TRBJ1-2,CASGSTTGNLNYGYTF,1,0,1,1
TRBV10-3,TRBJ2-5,CAISTPPGTGEETQYF,1,0,1,1
TRBV19,TRBJ1-5,CASSREQGFRNQPQHF,1,0,1,1
TRBV6-2/3/5/6,TRBJ2-1,CASRPNRDRGSNEQFF,1,0,1,1
TRBV27,TRBJ1-5,CASSISQSGHNQPQHF,1,0,1,1
TRBV6-2/3/5/6,TRBJ2-7,CASTYGGQGRLDEQYF,1,0,1,1
TRBV12-3/4,TRBJ2-7,CASSFNRVTDTYEQYF,1,0,1,1
TRBV28,TRBJ2-7,CASSFLGVLRSYEQYF,1,0,1,1
TRBV12-3/4,TRBJ1-3,CASSLGDWGSGDTIYF,1,0,1,1
TRBV12-3/4,TRBJ1-2,CASSSGTGRVYYGYTF,1,1,2,2
TRBV6-2/3/5/6,TRBJ1-3,CASSYSVTGAENTIYF,1,0,1,1
TRBV6-2/3/5/6,TRBJ2-7,CASSYSIRGLTYEQYF,1,0,1,1
TRBV6-2/3/5/6,TRBJ2-1,CASSYPGRGRNNEQFF,1,0,1,1
TRBV12-3/4,TRBJ2-3,CASSPHRGGGTDTQYF,1,0,1,1
TRBV12-3/4,TRBJ2-7,CASSPPRGRSPYEQYF,1,0,1,1
TRBV6-4,TRBJ1-6,CASSESGVSYNSPLHF,1,0,1,1
TRBV7-2,TRBJ2-5,CASSFLSGGRGETQYF,1,0,1,1
TRBV5-6,TRBJ2-3,CASSFMRGASTDTQYF,1,0,1,1
TRBV5-4,TRBJ1-6,CASSLGGGQVNSPLHF,1,0,1,1
TRBV5-5,TRBJ2-7,CASSLDAGQMTYEQYF,1,0,1,1
TRBV7-2,TRBJ1-5,CASSLSSGGGGQPQHF,1,0,1,1
TRBV7-2,TRBJ2-4,CASSLARVVAKNIQYF,1,0,1,1
TRBV7-2,TRBJ2-7,CASSLGLAGVTYEQYF,1,0,1,1
TRBV7-4,TRBJ1-5,CASSLGLCLSNQPQHF,1,0,1,1
TRBV11-3,TRBJ2-7,CASSLGSGTGIYKQYF,1,0,1,1
TRBV7-2,TRBJ2-1,CASSLETRRLYNEQFF,1,0,1,1
TRBV7-2,TRBJ2-7,CASSSGWDRTSYEQYF,1,0,1,1
TRBV3-1,TRBJ1-6,CASSSLSGHDNSPLHF,1,0,1,1
TRBV7-2,TRBJ2-3,CASSSEQGMRTDTQYF,1,0,1,1
TRBV7-9,TRBJ2-5,CASSLIRGLSGETQYF,1,0,1,1
TRBV11-2,TRBJ2-5,CASSPRLAGASETQYF,1,0,1,1
TRBV4-2,TRBJ1-6,CASSPTVEKRNSPLHF,1,0,1,1
TRBV5-4,TRBJ2-3,CASSPSGGFPGDTQYF,1,0,1,1
TRBV13,TRBJ2-5,CASSPPTSGGTGTQYF,1,0,1,1
TRBV7-2,TRBJ1-2,CASSPEVSGPSYGYTF,1,0,1,1
TRBV3-1,TRBJ2-5,CASSQVSWDHQETQYF,1,0,1,1
TRBV3-1,TRBJ2-1,CASSQDLGGASNEQFF,1,0,1,1
TRBV4-2,TRBJ2-1,CASSQDTGTGENEQFF,1,0,1,1
TRBV4-2,TRBJ2-7,CASSQELLGKSYEQYF,1,0,1,1
TRBV9,TRBJ1-4,CASSVGSYPTNEKLFF,1,0,1,1
TRBV7-2,TRBJ2-4,CASSEQIQGGKNIQYF,1,0,1,1
TRBV7-6,TRBJ1-1,CASSERTGGMNTEAFF,1,0,1,1
TRBV9,TRBJ2-3,CASSTRQGASTDTQYF,1,0,1,1
TRBV5-6,TRBJ1-5,CASSTGRANRNQPQHF,1,0,1,1
TRBV7-2,TRBJ2-7,CASSTGLAGGPWEQYF,1,0,1,1
TRBV7-9,TRBJ2-1,CASSNLGPGSYNEQFF,1,0,1,1
TRBV7-2,TRBJ2-2,CASSKEGPTSTGELFF,1,0,1,1
TRBV6-1,TRBJ1-5,CASRSGQGRRNQPQHF,1,0,1,1
TRBV4-2,TRBJ2-1,CASRQGSGGLYNEQFF,1,0,1,1
TRBV5-1,TRBJ2-1,CASTQQPGTGGNEQFF,1,0,1,1
TRBV4-1,TRBJ2-2,CASSPLKGGAGGELFF,1,1,2,2
TRBV5-1,TRBJ2-1,CASSRLSGGVGDEQFF,1,1,2,2
TRBV5-1,TRBJ2-1,CASSRTSGGAPNEQFF,1,0,1,1
TRBV4-1,TRBJ2-3,CASSQAERGGPPSRYF,1,0,1,1
TRBV4-1,TRBJ1-6,CASSQGGIDGNSPLHF,1,0,1,1
TRBV5-1,TRBJ1-1,CASSAQGTGESTEAFF,1,0,1,1
TRBV20-1,TRBJ2-2,CSARTLRRDYTGELFF,1,0,1,1
TRBV20-1,TRBJ2-5,CSAVPLIAGEQETQYF,1,0,1,1
TRBV29-1,TRBJ2-3,CSVEDRSRGSTDTQYF,1,0,1,1
TRBV29-1,TRBJ1-3,CSITPETGEEVRTIYF,1,0,1,1
TRBV12-5,TRBJ1-2,CASGLRTGSNYGYTF,1,0,1,1
TRBV7-7,TRBJ2-1,CASSRLGGAGGEQFF,1,0,1,1
TRBV12-3/4,TRBJ1-2,CACSLSGPHYGGYTF,1,0,1,1
TRBV7-3,TRBJ1-2,CACSFVDRVNYGYTF,1,0,1,1
TRBV30,TRBJ2-2,CAWSPGDRHTGELFF,1,1,2,2
TRBV30,TRBJ2-5,CAWSVQGHLQETQYF,1,0,1,1
TRBV24-1,TRBJ2-3,CATSAAFPGTDTQYF,1,0,1,1
TRBV24-1,TRBJ2-1,CATSDRDRFYNEQFF,1,0,1,1
TRBV24-1,TRBJ1-1,CATSDAQGHRTEAFF,1,0,1,1
TRBV7-9,TRBJ2-2,CASFPGQANTGELFF,1,0,1,1
TRBV19,TRBJ1-2,CASRGSRMANYGYTF,1,0,1,1
TRBV18,TRBJ2-7,CASSRTGTGGYEQYF,1,0,1,1
TRBV7-9,TRBJ2-5,CASSPPSGGLETQYF,1,0,1,1
TRBV18,TRBJ2-1,CASSPPGVSYNEQFF,1,0,1,1
TRBV18,TRBJ1-5,CASSPTGNSNQPQHF,1,0,1,1
TRBV7-9,TRBJ2-1,CASVRLGGGSWEQFF,1,2,2,3
TRBV7-9,TRBJ2-1,CASIPSGGTYNEQFF,1,0,1,1
TRBV7-2,TRBJ2-7,CASIRPGTGEYEQYF,1,0,1,1
TRBV6-2/3/5/6,TRBJ2-2,CASSFGPANTGELFI,1,0,1,1
TRBV12-3/4,TRBJ2-7,CASSFEAGRYYEQYF,1,0,1,1
TRBV27,TRBJ2-3,CASSFMGGRGDTQYF,1,0,1,1
TRBV6-2/3/5/6,TRBJ1-5,CASSLGILSNQPQHF,1,0,1,1
TRBV28,TRBJ1-5,CASSLYRQSNQPQHF,1,0,1,1
TRBV28,TRBJ2-3,CASSLTPSPIDTQYF,1,0,1,1
TRBV6-2/3/5/6,TRBJ2-7,CASSLKLAGRQEQYF,1,0,1,1
TRBV6-2/3/5/6,TRBJ1-2,CASSSPVQGDYGYTF,1,0,1,1
TRBV6-2/3/5/6,TRBJ2-7,CASSSGTENSYEQYF,1,0,1,1
TRBV10-3,TRBJ2-4,CASSSTTLPGNIQYF,1,0,1,1
TRBV6-2/3/5/6,TRBJ1-5,CASSSGTGPKQPQHF,1,0,1,1
TRBV27,TRBJ2-7,CASSWDRGPAYEQYF,1,0,1,1
TRBV6-2/3/5/6,TRBJ2-1,CASSYSGGGADEQFF,1,0,1,1
TRBV27,TRBJ1-5,CASSLRRGTNQPQHF,1,0,1,1
TRBV6-2/3/5/6,TRBJ2-7,CASSLGTGFRNEQYF,1,0,1,1
TRBV12-3/4,TRBJ1-1,CASSPRTGGRTEAFF,1,0,1,1
TRBV7-3,TRBJ2-5,CASSRAGGFQETQYF,1,0,1,1
TRBV6-2/3/5/6,TRBJ2-1,CASSHRKTPDNEQFF,1,0,1,1
TRBV6-1,TRBJ2-5,CASSQPPGQKETQYF,1,0,1,1
TRBV25-1,TRBJ1-6,CASSVLGSNNSPLHS,1,0,1,1
TRBV12-3/4,TRBJ1-1,CASSVGQVAGTEAFF,1,0,1,1
TRBV12-3/4,TRBJ1-3,CASSDNKHPGNTIYF,1,0,1,1
TRBV2,TRBJ2-2,CASSEVTRGTGELFF,1,0,1,1
TRBV6-1,TRBJ2-7,CASSEVVRVGYEQYF,1,0,1,1
TRBV2,TRBJ1-6,CASSESSGDNSPLHF,1,0,1,1
TRBV6-2/3/5/6,TRBJ2-3,CASSTGLAGVDTQYF,1,0,1,1
TRBV12-3/4,TRBJ2-2,CASSNRQGLTGELFF,1,0,1,1
TRBV6-1,TRBJ2-7,CASSKDRGTRYEQYF,1,0,1,1
TRBV2,TRBJ2-4,CASSKERQVPNIQYF,1,0,1,1
TRBV7-3,TRBJ2-1,CASSFSSGGTNEQFF,1,0,1,1
TRBV7-9,TRBJ1-2,CASSFVDRVNYGYTF,1,0,1,1
TRBV5-6,TRBJ2-5,CASSLFYRGLETQYF,1,0,1,1
TRBV7-2,TRBJ2-1,CASSLSWGDHNERFF,1,0,1,1
TRBV5-5,TRBJ2-3,CASSLWADAQWAQYL,1,0,1,1
TRBV5-8,TRBJ1-2,CASSLWTGVGYGYTF,1,0,1,1
TRBV5-5,TRBJ1-2,CASSLAVWGGYGYTF,1,0,1,1
TRBV7-2,TRBJ2-7,CASSLGLAGGREQYF,1,0,1,1
TRBV7-9,TRBJ1-5,CASSLGGGGNQPQHF,1,0,1,1
TRBV7-9,TRBJ1-6,CASSLDDVGRSPLHF,1,0,1,1
TRBV5-5,TRBJ1-4,CASSLTPATNEKLFF,1,0,1,1
TRBV5-4,TRBJ2-3,CASSLRTSGVDTQYF,1,0,1,1
TRBV7-9,TRBJ2-2,CASSLFLGLAGELFF,1,0,1,1
TRBV7-3,TRBJ2-5,CASSLFPRDKETQYF,1,0,1,1
TRBV11-2,TRBJ2-3,CASSLFSGPTDTQYF,1,0,1,1
TRBV7-8,TRBJ1-2,CASSLFPQGNYGYTF,1,0,1,1
TRBV7-3,TRBJ2-1,CASSLSGYYYNEQFF,1,0,1,1
TRBV7-2,TRBJ1-2,CASSLAKGADYGYTF,1,0,1,1
TRBV7-2,TRBJ2-2,CASSLALVGGGELFF,1,0,1,1
TRBV7-9,TRBJ1-2,CASSLGGVTNYGYTF,1,0,1,1
TRBV7-9,TRBJ2-1,CASSLGESSYNEQFF,1,0,1,1
TRBV7-9,TRBJ2-7,CASSLEGEGPYEQYF,1,0,1,1
TRBV7-9,TRBJ1-2,CASSSRDRGDYGYTF,1,0,1,1
TRBV7-2,TRBJ2-6,CASSSRGTGANVLTF,1,0,1,1
TRBV28,TRBJ2-3,CASSPQGSYTDTQYF,1,0,1,1
TRBV7-2,TRBJ2-1,CASSPDIVSYNEQFF,1,0,1,1
TRBV7-2,TRBJ2-7,CASSPVRGATYEQYF,1,0,1,1
TRBV14,TRBJ1-1,CASSPINAGSGEAFF,1,0,1,1
TRBV7-2,TRBJ2-7,CASSRGQGSLDEQYF,1,0,1,1
TRBV6-2/3/5/6,TRBJ2-1,CASSRSGGAWDEQFF,1,0,1,1
TRBV16,TRBJ1-2,CASSHRQGAVNGYTF,1,0,1,1
TRBV11-2,TRBJ2-1,CASSQGLAGYNEQFF,1,0,1,1
TRBV3-1,TRBJ1-5,CASSQDYGGNQPQHF,1,0,1,1
TRBV3-1,TRBJ2-7,CASSQDLPRAHEQYF,1,0,1,1
TRBV14,TRBJ1-4,CASSQDRGNHEKLFF,1,0,1,1
TRBV4-2,TRBJ1-5,CASSQEPTGDQPQHF,1,0,1,1
TRBV9,TRBJ2-7,CASSVGVTPTHEQYF,1,0,1,1
TRBV5-6,TRBJ2-1,CASSAVAALGNEQFF,1,0,1,1
TRBV6-2/3/5/6,TRBJ2-1,CASSASGGAVDEQFF,1,0,1,1
TRBV5-4,TRBJ2-5,CASSGRRGGQETQYF,1,0,1,1
TRBV7-6,TRBJ2-7,CASSISGGVPNEQYF,1,0,1,1
TRBV5-6,TRBJ1-5,CASSKFLDRLQPQHF,1,0,1,1
TRBV6-2/3/5/6,TRBJ1-3,CASRLGRYSGNTIYF,1,0,1,1
TRBV12-3/4,TRBJ2-7,CASRAPGPGLVEQYF,1,0,1,1
TRBV7-9,TRBJ2-3,CASRDGTASTDTQYF,1,0,1,1
TRBV6-4,TRBJ2-2,CASRTGTGGTGELFF,1,0,1,1
TRBV12-3/4,TRBJ1-5,CASRKGARVNQPQHF,1,0,1,1
TRBV6-2/3/5/6,TRBJ2-2,CASRPSGGNTGELFF,1,0,1,1
TRBV6-2/3/5/6,TRBJ1-1,CASRTTGTPYTEAFF,1,0,1,1
TRBV2,TRBJ2-5,CASNPDGTTQETQYF,1,0,1,1
TRBV30,TRBJ2-1,CARSVQQGPYNERFF,1,0,1,1
TRBV5-1,TRBJ1-4,CASTPLGVGNEKLFF,1,0,1,1
TRBV5-1,TRBJ1-5,CASSWDGLSNQPQHF,1,0,1,1
TRBV5-1,TRBJ1-5,CASSPRTYYNQPQHF,1,0,1,1
TRBV5-1,TRBJ2-3,CASSFGSGASDTQYF,1,0,1,1
TRBV5-1,TRBJ2-1,CASSLLATMGNEQFF,1,0,1,1
TRBV5-1,TRBJ2-7,CASSLARSLSYEQYF,1,0,1,1
TRBV5-1,TRBJ2-7,CASSLARDGDYEQYF,1,0,1,1
TRBV5-1,TRBJ2-7,CASSLGAVQGYEQYF,1,0,1,1
TRBV5-1,TRBJ2-3,CASSLGDSPADTQYF,1,0,1,1
TRBV5-1,TRBJ2-7,CASSLELAGTYEQYF,1,0,1,1
TRBV5-1,TRBJ1-2,CASSLEPGIANGYTF,1,0,1,1
TRBV5-1,TRBJ1-1,CASSLEAGGLGGAFF,1,0,1,1
TRBV5-1,TRBJ2-2,CASSLAGAHTGELFF,1,0,1,1
TRBV4-1,TRBJ2-5,CASSPFLGGGETQYF,1,0,1,1
TRBV5-1,TRBJ2-1,CASSPSAGGGLEQFF,1,0,1,1
TRBV4-3,TRBJ1-4,CASSQSGQGQEKLFF,1,0,1,1
TRBV4-1,TRBJ2-7,CASSQPDRSAYEQYF,1,0,1,1
TRBV4-1,TRBJ1-1,CASSQDSDRAGRTFF,1,0,1,1
TRBV4-3,TRBJ2-1,CASSQDLVSYNEQFF,1,0,1,1
TRBV4-1,TRBJ1-2,CASSQSRAGGYGYTF,1,0,1,1
TRBV5-1,TRBJ2-3,CASSEQGISTDTQYF,1,0,1,1
TRBV5-1,TRBJ2-1,CASSTGASGGNEQFF,1,0,1,1
TRBV5-1,TRBJ2-3,CASRLGNAGTDTQYF,1,0,1,1
TRBV20-1,TRBJ1-1,CSAGLHAVQNTEAFF,1,0,1,1
TRBV20-1,TRBJ2-7,CSAIGTIGGAYEQYF,1,0,1,1
TRBV29-1,TRBJ1-4,CSATGPLGTAEKLFF,1,0,1,1
TRBV20-1,TRBJ2-3,CSASWDRGSTDTQYF,1,0,1,1
TRBV20-1,TRBJ1-2,CSARPPGGSGYGYTF,1,0,1,1
TRBV20-1,TRBJ1-5,CSARSRGGFNQPQHF,1,0,1,1
TRBV20-1,TRBJ1-5,CSARVRRQGDQPQHF,1,0,1,1
TRBV20-1,TRBJ2-1,CSALRAGEFYNEQFF,1,1,2,2
TRBV20-1,TRBJ2-1,CSASSDGGPYNEQFF,1,0,1,1
TRBV29-1,TRBJ2-5,CSVGPWGGKGETQYF,1,1,2,2
TRBV29-1,TRBJ2-4,CSVAGTGDSKNIQYF,1,1,2,2
TRBV27,TRBJ2-3,CASVGDYRTDTQYF,1,0,1,1
TRBV30,TRBJ1-2,CAWTGAVRNYGYTF,1,0,1,1
TRBV30,TRBJ1-6,CAWSVGQGNSPLHF,1,0,1,1
TRBV30,TRBJ1-1,CAWSVHVGSSEAFF,1,0,1,1
TRBV30,TRBJ1-4,CAWRRETEEGKLFF,1,0,1,1
TRBV30,TRBJ1-1,CAWRHETGRSEAFF,1,0,1,1
TRBV5-4,TRBJ1-2,CAGSLEGGSYGYTF,1,0,1,1
TRBV10-3,TRBJ1-5,CAISRDRGNQPQHF,1,0,1,1
TRBV7-2,TRBJ1-2,CATQRGPGNYGYTF,1,0,1,1
TRBV24-1,TRBJ1-1,CATSAGQGNTEAFF,1,0,1,1
TRBV19,TRBJ2-2,CASSLARGAGELFF,1,0,1,1
TRBV19,TRBJ2-2,CASSTPGLRGELFF,1,0,1,1
TRBV19,TRBJ1-1,CASRTGQSYTEAFF,1,0,1,1
TRBV19,TRBJ1-1,CASRNRGPNTEAFF,1,0,1,1
TRBV7-6,TRBJ2-1,CASSGPNNYNEQFF,1,0,1,1
TRBV18,TRBJ2-2,CASSEKTSAGELFF,1,0,1,1
TRBV18,TRBJ1-2,CASSLTGQGDGYTF,1,0,1,1
TRBV18,TRBJ1-4,CASSPGGSNGKLFF,1,0,1,1
TRBV18,TRBJ2-1,CASSPPGTSGAQFF,1,0,1,1
TRBV18,TRBJ1-1,CASSGQVMNTEAFF,1,0,1,1
TRBV4-2,TRBJ2-3,CASLQSGRGDTQYF,1,0,1,1
TRBV12-3/4,TRBJ2-1,CASGYVSSYNEQFF,1,0,1,1
TRBV7-9,TRBJ2-2,CASGLMVGTGELFF,1,0,1,1
TRBV6-2/3/5/6,TRBJ2-6,CASGGGSGANVLTF,1,0,1,1
TRBV5-5,TRBJ2-7,CASGHRQNSYEQYF,1,0,1,1
TRBV12-3/4,TRBJ2-7,CASTRDRSSYEQYF,1,0,1,1
TRBV6-2/3/5/6,TRBJ1-5,CASTRTGGGQPQHF,1,0,1,1
TRBV12-3/4,TRBJ2-1,CASTMVGWRREQFF,1,0,1,1
TRBV28,TRBJ2-7,CASTKGTGPYEQYF,1,0,1,1
TRBV12-3/4,TRBJ1-5,CASSFFSLNQPQHF,1,0,1,1
TRBV12-3/4,TRBJ1-2,CASSFRGSGDGYTF,1,2,2,3
TRBV6-2/3/5/6,TRBJ2-7,CASSFSTGDRQQYF,1,0,1,1
TRBV28,TRBJ2-7,CASSFARPPYEQYF,1,0,1,1
TRBV6-2/3/5/6,TRBJ1-2,CASSLAPSVYGYTF,1,0,1,1
TRBV6-2/3/5/6,TRBJ2-2,CASSLAGGTGELFF,1,0,1,1
TRBV12-3/4,TRBJ2-3,CASSLFSAADTQYF,1,0,1,1
TRBV27,TRBJ2-5,CASSLSPAQETQYF,1,0,1,1
TRBV12-3/4,TRBJ1-6,CASSLSGERAPLHF,1,0,1,1
TRBV27,TRBJ2-1,CASSLPAGAGVGFF,1,0,1,1
TRBV12-3/4,TRBJ2-7,CASSLVTSRGEQYF,1,0,1,1
TRBV12-3/4,TRBJ2-7,CASSLGGGDYEQYF,1,1,2,2
TRBV6-2/3/5/6,TRBJ2-3,CASSLDHFSDTQYF,1,0,1,1
TRBV6-2/3/5/6,TRBJ2-5,CASSLETGRETQYF,1,1,2,2
TRBV6-2/3/5/6,TRBJ2-5,CASSSGGPQETQYF,1,0,1,1
TRBV12-3/4,TRBJ1-6,CASSWQGGNSPLHF,1,0,1,1
TRBV6-2/3/5/6,TRBJ2-5,CASSWGTSSETQYF,1,0,1,1
TRBV6-2/3/5/6,TRBJ2-7,CASSYSGGSYEQYF,1,0,1,1
TRBV6-2/3/5/6,TRBJ1-1,CASSYSGKNTEAFF,1,0,1,1
TRBV6-2/3/5/6,TRBJ2-3,CASSPSGSTDTQYF,1,0,1,1
TRBV12-3/4,TRBJ1-6,CASSRGGLQSPLHF,1,0,1,1
TRBV6-2/3/5/6,TRBJ1-1,CASSHGGGETEAFF,1,0,1,1
TRBV11-2,TRBJ1-2,CASSQSTDYGGYTF,1,0,1,1
TRBV6-1,TRBJ2-1,CASSQQGINNEQFF,1,0,1,1
TRBV6-1,TRBJ1-2,CASSGGDRSYGYTF,1,0,1,1
TRBV12-3/4,TRBJ2-3,CASSTGGYKDTQYF,1,0,1,1
TRBV6-2/3/5/6,TRBJ1-4,CASSNTQGGEKLFF,1,0,1,1
TRBV12-3/4,TRBJ1-5,CASSKGQADQPQHF,1,0,1,1
TRBV25-1,TRBJ2-1,CASSKSGNVNEQFF,1,0,1,1
TRBV7-9,TRBJ2-1,CASSFLDGPNEQFF,1,0,1,1
TRBV7-9,TRBJ1-4,CASSFGGGREKLFF,1,0,1,1
TRBV5-4,TRBJ2-5,CASSLWAGEETLYF,1,0,1,1
TRBV5-6,TRBJ1-5,CASSLAAGNQPQHF,1,0,1,1
TRBV7-2,TRBJ1-2,CASSLDRGLSGYTF,1,0,1,1
TRBV7-2,TRBJ2-7,CASSLTGEAREQYF,1,0,1,1
TRBV5-5,TRBJ1-2,CASSLKEQLGGYTF,1,0,1,1
TRBV7-2,TRBJ2-7,CASSLPGPLYEQYF,1,0,1,1
TRBV7-2,TRBJ1-2,CASSLAGSQYGYTF,1,0,1,1
TRBV7-9,TRBJ2-1,CASSLAGSYNEQFF,1,0,1,1
TRBV11-2,TRBJ1-4,CASSLGRKNEKLFF,1,0,1,1
TRBV7-9,TRBJ1-1,CASSLGQKNTEAFF,1,0,1,1
TRBV7-9,TRBJ2-3,CASSLGVDGDTQYF,1,0,1,1
TRBV7-9,TRBJ1-5,CASSLGQGGQPQHF,1,0,1,1
TRBV7-6,TRBJ2-7,CASSLDGGTSGQYF,1,0,1,1
TRBV7-6,TRBJ2-3,CASSLEASTDTQYF,1,0,1,1
TRBV5-6,TRBJ2-7,CASSLMRGVHEQYF,1,0,1,1
TRBV7-3,TRBJ2-1,CASSLRQGGNEQFF,1,0,1,1
TRBV7-9,TRBJ1-1,CASSLREGAVEAFF,1,0,1,1
TRBV5-4,TRBJ2-3,CASSSVGDTDTQYF,1,0,1,1
TRBV7-2,TRBJ1-3,CASSSGASGNTIYF,1,0,1,1
TRBV7-2,TRBJ2-7,CASSSGTKFYEQYF,1,0,1,1
TRBV5-5,TRBJ1-1,CASSSGPEHGEAFF,1,0,1,1
TRBV5-6,TRBJ1-6,CASSYGRENSPLHF,1,0,1,1
TRBV6-2/3/5/6,TRBJ1-2,CASSLGQVNYGYTF,1,0,1,1
TRBV7-2,TRBJ1-2,CASSPDGLLGGYTF,1,0,1,1
TRBV7-9,TRBJ2-7,CASSPRTGHYEQYF,1,1,2,2
TRBV3-1,TRBJ1-4,CASSRVPTNEKLFF,1,0,1,1
TRBV6-2/3/5/6,TRBJ2-1,CASSHWDRYNEQFF,1,0,1,1
TRBV14,TRBJ1-1,CASSQDRTYTEAFF,1,0,1,1
TRBV3-1,TRBJ1-5,CASSQAGGNQPQHF,1,0,1,1
TRBV3-1,TRBJ1-1,CASSQGSKNTEAFF,1,0,1,1
TRBV9,TRBJ2-1,CASSVKGVTSEQFF,1,0,1,1
TRBV7-2,TRBJ2-5,CASSGTRGVETQYF,1,0,1,1
TRBV12-3/4,TRBJ1-4,CASRTSDPNEKLFF,1,0,1,1
TRBV27,TRBJ2-3,CASRPIEALDTQYF,1,0,1,1
TRBV6-2/3/5/6,TRBJ2-1,CASRSSSSYNKQFF,1,0,1,1
TRBV2,TRBJ2-5,CASKAGANQETQYF,1,0,1,1
TRBV7-2,TRBJ2-5,CASKAGGPIETQYF,1,0,1,1
TRBV12-3/4,TRBJ2-3,CASKAAGSTGTQYF,1,0,1,1
TRBV10-2,TRBJ2-3,CASLGELGTDTQYF,1,0,1,1
TRBV5-1,TRBJ2-5,CASEGEQAQETQYF,1,0,1,1
TRBV5-1,TRBJ2-3,CASILGTGADTQYF,1,0,1,1
TRBV5-1,TRBJ2-7,CASSFGQGAYEQYF,1,0,1,1
TRBV5-1,TRBJ1-3,CASSFADIGNTIYF,1,0,1,1
TRBV5-1,TRBJ2-7,CASSLSWGSYEQYF,1,0,1,1
TRBV5-1,TRBJ2-5,CASSLWGQQETQYF,1,0,1,1
TRBV5-1,TRBJ1-1,CASSLDGLNTEAFF,1,0,1,1
TRBV5-1,TRBJ1-5,CASSWGTSNQPQHF,1,0,1,1
TRBV5-1,TRBJ1-1,CASSYQQGEGEAFF,1,0,1,1
TRBV4-1,TRBJ2-5,CASSPWTEQETQYF,1,0,1,1
TRBV5-1,TRBJ1-6,CASSPGQGDSPLHF,1,0,1,1
TRBV5-1,TRBJ1-6,CASSPELGNSPLHF,1,1,2,2
TRBV4-3,TRBJ1-3,CASSQEPSGNTIYF,1,0,1,1
TRBV4-3,TRBJ2-6,CASSQTDTSNVLTF,1,0,1,1
TRBV4-3,TRBJ1-2,CASSQGAGKDGYTF,1,0,1,1
TRBV5-1,TRBJ2-7,CASSTQGGTYEQYF,1,0,1,1
TRBV4-1,TRBJ2-7,CASRPSDGTYEQYF,1,0,1,1
TRBV20-1,TRBJ2-1,CGAPGGQGRNEQFF,1,0,1,1
TRBV20-1,TRBJ2-7,CSVRSGQNSYEQYF,1,0,1,1
TRBV20-1,TRBJ2-1,CSASPGTSINEQFF,1,0,1,1
TRBV20-1,TRBJ2-5,CSARSMLVQETQYF,1,0,1,1
TRBV20-1,TRBJ2-3,CSARPGQRVDTQYF,1,0,1,1
TRBV20-1,TRBJ1-4,CSARDWVQAGTLFF,1,0,1,1
TRBV20-1,TRBJ2-5,CSANPGTGQETQYF,1,0,1,1
TRBV20-1,TRBJ1-5,CSAVPHQNNQPQHF,1,0,1,1
TRBV20-1,TRBJ2-1,CSARDAGAYNEQFF,1,0,1,1
TRBV29-1,TRBJ2-1,CSVEGGGKYNEQFF,1,0,1,1
TRBV29-1,TRBJ1-5,CSVEVAGFNQPQHF,1,0,1,1
TRBV29-1,TRBJ2-2,CSVEAGLNTGELFF,1,0,1,1
TRBV29-1,TRBJ2-7,CSVEGGGTGDEQYF,1,1,2,2
TRBV29-1,TRBJ2-7,CSVESLGTRSEQYF,1,0,1,1
TRBV29-1,TRBJ2-2,CSVGQGGYTGELFF,1,0,1,1
TRBV12-5,TRBJ2-2,CASGPTGSGELFF,1,0,1,1
TRBV30,TRBJ2-5,CAWTAGGPETQYF,1,0,1,1
TRBV30,TRBJ1-4,CAWRNGGREKLFF,1,0,1,1
TRBV24-1,TRBJ1-1,CARQGDRDTEAFF,1,0,1,1
TRBV10-3,TRBJ1-2,CAALRASNYGYTF,1,0,1,1
TRBV24-1,TRBJ2-2,CATRDRVAGELFF,1,0,1,1
TRBV10-3,TRBJ1-2,CATHRQGNYGYTF,1,0,1,1
TRBV19,TRBJ1-1,CASSPPGQVEAFF,1,0,1,1
TRBV19,TRBJ1-1,CASSRDILHEAFF,1,1,2,2
TRBV19,TRBJ2-1,CASSNQAYNEQFF,1,0,1,1
TRBV18,TRBJ2-7,CASSPQGTDEQYF,1,0,1,1
TRBV5-4,TRBJ1-1,CASYAGGYGEAFF,1,0,1,1
TRBV14,TRBJ1-1,CASVRGGNTEAFF,1,0,1,1
TRBV6-2/3/5/6,TRBJ1-2,CASTLRQGGGYTF,1,0,1,1
TRBV2,TRBJ2-5,CASTQWGQETQYF,1,0,1,1
TRBV7-9,TRBJ1-1,CASSFTWGTEAFF,1,0,1,1
TRBV27,TRBJ1-5,CASSLAGTGPQHF,1,0,1,1
TRBV6-2/3/5/6,TRBJ2-7,CASSYSEAREQYF,1,0,1,1
TRBV6-2/3/5/6,TRBJ2-1,CASSYDTYNEQFF,1,0,1,1
TRBV6-2/3/5/6,TRBJ2-3,CASSLGRADTQYF,1,0,1,1
TRBV12-3/4,TRBJ2-2,CASSPTGTGELFF,1,1,2,2
TRBV6-1,TRBJ1-2,CASSGQGFYGYTF,1,0,1,1
TRBV25-1,TRBJ1-1,CASSDGGRGEAFF,1,0,1,1
TRBV6-4,TRBJ2-1,CASSDSIVTEQFF,1,0,1,1
TRBV6-1,TRBJ1-1,CASSEPLNTEAFF,1,0,1,1
TRBV6-1,TRBJ2-7,CASSEQFSYEQYF,1,0,1,1
TRBV2,TRBJ2-3,CASSEGPTDTQYF,1,0,1,1
TRBV5-6,TRBJ2-1,CASSTDSRNEQFF,1,0,1,1
TRBV7-6,TRBJ2-1,CASSLAEYNEQFF,1,0,1,1
TRBV14,TRBJ2-2,CASSSRPTGELFF,1,0,1,1
TRBV7-2,TRBJ1-1,CASSSGQYTEAFF,1,0,1,1
TRBV3-1,TRBJ1-1,CASSLVRNTEAFF,1,0,1,1
TRBV5-4,TRBJ2-2,CASSLMNTGELFF,1,0,1,1
TRBV7-2,TRBJ2-1,CASSLDRYNEQFF,1,0,1,1
TRBV7-2,TRBJ2-7,CASSPHWGPEQYF,1,0,1,1
TRBV14,TRBJ2-7,CASSPARGGEQYF,1,0,1,1
TRBV14,TRBJ1-2,CASSRWTGVGYTF,1,0,1,1
TRBV7-9,TRBJ1-2,CASSRAGGGGYTF,1,0,1,1
TRBV3-1,TRBJ2-1,CASSQDDRHEQFF,1,0,1,1
TRBV3-1,TRBJ2-5,CASSVPYVGREYF,1,0,1,1
TRBV7-2,TRBJ2-3,CASSEDITDTQYF,1,1,2,2
TRBV11-2,TRBJ1-2,CASSISGNYGYTF,1,0,1,1
TRBV3-1,TRBJ1-1,CASSTQGLTEAFF,1,0,1,1
TRBV11-2,TRBJ1-1,CASSNRQGGEAFF,1,0,1,1
TRBV2,TRBJ2-7,CASRAGVSYEQYF,1,1,2,2
TRBV2,TRBJ1-5,CASRLLGAGPQHF,1,0,1,1
TRBV12-3/4,TRBJ1-1,CASRDRGEVEAFF,1,0,1,1
TRBV2,TRBJ1-1,CASNNFPNTEAFF,1,0,1,1
TRBV28,TRBJ1-4,CANSRATGEKLFF,1,0,1,1
TRBV5-1,TRBJ2-7,CASTSDNSYEQYF,1,0,1,1
TRBV5-1,TRBJ1-6,CASSLLTDSPLHF,1,0,1,1
TRBV5-1,TRBJ2-1,CASSLSGGNEQFF,1,0,1,1
TRBV5-1,TRBJ2-4,CASSLEGRVIQYF,1,0,1,1
TRBV5-1,TRBJ1-5,CASSPMPDQPQHF,1,0,1,1
TRBV4-3,TRBJ2-1,CASSQGLWNEQFF,1,0,1,1
TRBV4-1,TRBJ1-2,CASSQGGARGYTF,1,0,1,1
TRBV20-1,TRBJ1-6,CSAARFYNSPLHF,1,0,1,1
TRBV20-1,TRBJ1-5,CSASSTVNQPQHF,1,0,1,1
TRBV20-1,TRBJ2-7,CSASGPPENEQYF,1,0,1,1
TRBV20-1,TRBJ1-1,CSASMQVNTEAFF,1,0,1,1
TRBV20-1,TRBJ2-5,CSARGELQETQYF,1,0,1,1
TRBV29-1,TRBJ2-2,CSVAGTGTGELFF,1,0,1,1
TRBV29-1,TRBJ2-1,CSVGTTTYNEQFF,1,0,1,1
TRBV29-1,TRBJ1-5,CSVDGQGNQPQHF,1,0,1,1
TRBV29-1,TRBJ2-5,CSVVGLGGETQYF,1,0,1,1
TRBV29-1,TRBJ2-1,CSVGTSGENEQFF,1,0,1,1
TRBV29-1,TRBJ1-2,CSATQGADYGYTF,1,0,1,1
TRBV28,TRBJ1-2,RASSLHQGMGYTF,1,0,1,1
TRBV30,TRBJ1-1,CAWSPGLTEAFF,1,0,1,1
TRBV30,TRBJ2-3,CAWRSVLDTQYF,1,0,1,1
TRBV28,TRBJ1-2,CAGKSGVGGYTF,1,0,1,1
TRBV19,TRBJ1-2,CASSMAVYGYTF,1,0,1,1
TRBV19,TRBJ2-1,CASRLTAGEQFF,1,0,1,1
TRBV12-3/4,TRBJ2-7,CASGRSSYEQYL,1,0,1,1
TRBV7-8,TRBJ2-7,CASMGGGYEQYF,1,0,1,1
TRBV7-9,TRBJ2-3,CASTLLGDTQYF,1,0,1,1
TRBV2,TRBJ2-1,CASTGDGNEQFF,1,0,1,1
TRBV6-4,TRBJ2-5,CASTRLEETQYF,1,0,1,1
TRBV6-2/3/5/6,TRBJ2-1,CASSFPGGEQFF,1,0,1,1
TRBV12-3/4,TRBJ1-1,CASSLNREEAFF,1,0,1,1
TRBV25-1,TRBJ2-3,CASSESTDTQYF,1,0,1,1
TRBV28,TRBJ2-5,CASSNTRETRYF,1,0,1,1
TRBV5-6,TRBJ2-1,CASSFASNEQFF,1,0,1,1
TRBV5-4,TRBJ2-4,CASSFGGYIQYF,1,0,1,1
TRBV5-4,TRBJ2-2,CASSLYSGELYF,1,0,1,1
TRBV7-9,TRBJ2-5,CASSLLGETQYF,1,0,1,1
TRBV7-9,TRBJ2-7,CASSLALYEQYF,1,0,1,1
TRBV7-2,TRBJ2-7,CASSLAGGEQYF,1,0,1,1
TRBV11-2,TRBJ1-1,CASSLGFGEAFF,1,0,1,1
TRBV7-6,TRBJ2-2,CASSLGGGELFF,1,0,1,1
TRBV7-2,TRBJ2-5,CASSSLPETQYL,1,0,1,1
TRBV7-9,TRBJ1-2,CASSSLTEGYTF,1,0,1,1
TRBV7-2,TRBJ1-1,CASSSHPQGVFF,1,0,1,1
TRBV7-9,TRBJ1-1,CASSPGRQGALF,1,0,1,1
TRBV11-2,TRBJ1-1,CASSPDSYEAFF,1,0,1,1
TRBV5-4,TRBJ2-1,CASSPRLNEQFF,1,0,1,1
TRBV5-4,TRBJ1-3,CASSPRGNTIYF,1,0,1,1
TRBV5-4,TRBJ2-7,CASSRDGYEQYF,1,0,1,1
TRBV7-6,TRBJ1-2,CASSHPGAGYTF,1,0,1,1
TRBV6-2/3/5/6,TRBJ2-3,CASSVTGDTQYF,1,0,1,1
TRBV7-9,TRBJ1-6,CASSVGGAELHF,1,0,1,1
TRBV6-4,TRBJ1-5,CASSSPPQPQHF,1,0,1,1
TRBV12-3/4,TRBJ2-7,CASRLGSYEQYF,1,0,1,1
TRBV18,TRBJ1-1,CASSPDRSWAFF,1,0,1,1
TRBV5-1,TRBJ1-1,CASSLANTEAFF,1,0,1,1
TRBV5-1,TRBJ2-2,CASSLGTGELFF,1,0,1,1
TRBV5-1,TRBJ2-5,CASSLTGETQYF,1,0,1,1
TRBV4-3,TRBJ2-6,CASRGGGRLLTF,1,0,1,1
TRBV29-1,TRBJ2-2,CSVGQNTGELFF,1,0,1,1
TRBV20-1,TRBJ2-7,CSALPGDGEQYF,1,0,1,1
TRBV20-1,TRBJ2-3,CSASLAGGPRYF,1,0,1,1
TRBV20-1,TRBJ2-5,CSARVGVETQYF,1,0,1,1
TRBV20-1,TRBJ1-1,CSARVPNTEAFF,1,0,1,1
TRBV20-1,TRBJ2-3,CSALKGADTQYF,1,0,1,1
TRBV29-1,TRBJ2-7,CSAMFGTYEQYF,1,0,1,1
TRBV29-1,TRBJ1-5,CSVDAGDQPQHF,1,0,1,1
TRBV29-1,TRBJ1-1,CSVRRGMSEAFF,1,0,1,1
TRBV30,TRBJ2-1,CAWARLSEQFF,1,0,1,1
TRBV30,TRBJ2-7,CAWTRAHEQYF,1,0,1,1
TRBV19,TRBJ2-1,CASSLQDEQFF,1,0,1,1
TRBV10-3,TRBJ2-5,CASRLGETQYF,1,0,1,1
TRBV12-3/4,TRBJ1-2,CASSSYRGYTF,1,0,1,1
TRBV28,TRBJ2-5,CASSSEETQYF,1,0,1,1
TRBV12-3/4,TRBJ2-1,CASSAGTIQFF,1,0,1,1
TRBV11-1,TRBJ2-1,CASSLGGVWFF,1,0,1,1
TRBV7-2,TRBJ2-7,CASSSAYEQYF,1,0,1,1
TRBV12-3/4,TRBJ2-2,CASSPHGELFF,1,0,1,1
TRBV3-1,TRBJ2-7,CASSQDYEQYF,1,0,1,1
TRBV14,TRBJ2-1,CASSQVNEQFF,1,0,1,1
TRBV3-1,TRBJ2-7,CASSDSYEQYF,1,0,1,1
TRBV5-1,TRBJ2-1,CASSLDSEQFF,1,0,1,1
TRBV20-1,TRBJ2-3,CSARDRNTQYF,1,0,1,1
TRBV29-1,TRBJ1-5,CSAGGDQPQHF,1,0,1,1
TRBV7-9,TRBJ2-5,CASSSETQYF,1,0,1,1
TRBV29-1,TRBJ1-2,CSVRGGGYTF,1,0,1,1
TRBV29-1,TRBJ1-3,CSGGENTIYF,1,0,1,1
TRBV3-1,TRBJ1-5,CASSQTENRHQPQHF,0,1,1,1
TRBV18,TRBJ1-1,CASSKEAMAEAFF,0,1,1,1
TRBV29-1,TRBJ1-1,CSGRRDSGTEAFF,0,1,1,1
TRBV3-1,TRBJ2-5,CASSQDRHPGETQYF,0,2,1,2
TRBV5-1,TRBJ2-1,CASSYLGGVQFF,0,1,1,1
TRBV5-1,TRBJ1-2,CASSEGQGYSYGYTF,0,1,1,1
TRBV5-1,TRBJ1-5,CASSLGQNQPQHL,0,1,1,1
TRBV3-1,TRBJ1-5,CASSLGTAHSNQPQHF,0,1,1,1
TRBV11-2,TRBJ1-1,CASSQRGRNTEAFF,0,1,1,1
TRBV19,TRBJ2-5,CASSIISAETQYF,0,1,1,1
TRBV10-3,TRBJ2-3,CASRTLTDTQYF,0,1,1,1
TRBV19,TRBJ1-1,CASTIGGSEAFF,0,2,1,2
TRBV3-1,TRBJ2-1,CASSQGHSGGPRNEQFF,0,1,1,1
TRBV2,TRBJ1-1,CASTVPDRGGGTEAFF,0,1,1,1
TRBV3-1,TRBJ2-2,CASRTTGGATGELFF,0,1,1,1
TRBV5-4,TRBJ1-1,CASSPAGGTEAFF,0,1,1,1
TRBV5-4,TRBJ2-7,CASSLMGQGSYEQYF,0,1,1,1
TRBV3-1,TRBJ1-6,CASSLGRLDSPLHF,0,1,1,1
TRBV5-4,TRBJ2-7,CASSPWTGANEQYF,0,1,1,1
TRBV5-4,TRBJ2-7,CASSTRSRGDEQYF,0,1,1,1
TRBV11-2,TRBJ1-1,CASRIQGSNTEAFF,0,1,1,1
TRBV2,TRBJ2-7,CASSERGNEQYF,0,1,1,1
TRBV25-1,TRBJ1-1,CASSMANTEAFF,0,1,1,1
TRBV18,TRBJ2-7,CASSLRPDSEQYF,0,1,1,1
TRBV20-1,TRBJ2-1,CSAAAGLPSYNEQFF,0,1,1,1
TRBV20-1,TRBJ2-5,CSAEEGSRRQETQYF,0,1,1,1
TRBV20-1,TRBJ2-1,CSAFDTGYSYNEQFF,0,1,1,1
TRBV12-3/4,TRBJ2-3,CASLLLGGTDTQYF,0,1,1,1
TRBV12-3/4,TRBJ1-1,CASSSQIMDTEAFF,0,1,1,1
TRBV5-5,TRBJ1-5,CASSLGQSDQPQHF,0,1,1,1
TRBV29-1,TRBJ1-1,CSVSPSGMNTEAFF,0,1,1,1
TRBV29-1,TRBJ1-1,CSVVVGVMNTEAFF,0,1,1,1
TRBV29-1,TRBJ2-1,CSVGSGVLSNEQFF,0,1,1,1
TRBV5-4,TRBJ2-3,CASSGTNTDTQYF,0,1,1,1
TRBV5-1,TRBJ1-1,CASSFSGYTEAFF,0,1,1,1
TRBV20-1,TRBJ2-7,CSARLRLGEQYF,0,1,1,1
TRBV20-1,TRBJ2-7,CSARRAGGHYEQYF,0,1,1,1
TRBV20-1,TRBJ2-6,CSAPPAGTSGANVLTF,0,1,1,1
TRBV5-6,TRBJ1-2,CASSFQRVVGEGYTF,0,1,1,1
TRBV18,TRBJ2-6,CASSPSGENVLTF,0,1,1,1
TRBV12-3/4,TRBJ2-7,CASSLVTYEQYF,0,1,1,1
TRBV5-1,TRBJ2-3,CASSLRGLSTDTQYF,0,1,1,1
TRBV20-1,TRBJ2-7,CSARGQGFEQYF,0,1,1,1
TRBV5-1,TRBJ2-2,CASSPLAGQNTGELFF,0,1,1,1
TRBV19,TRBJ2-1,CASSRLLGGNYNEQFF,0,2,1,2
TRBV19,TRBJ1-2,CASSIAGTGTRDGYTF,0,2,1,2
TRBV7-9,TRBJ2-7,CASSLDFGTGFHEQYF,0,1,1,1
TRBV10-3,TRBJ1-1,CAIRDSSAVNTEAFF,0,1,1,1
TRBV10-3,TRBJ1-1,CAISYDTGGGAEAFF,0,1,1,1
TRBV12-3/4,TRBJ1-3,CASSMGPNSGNTIYF,0,1,1,1
TRBV19,TRBJ2-7,CASSIGGTGREQYF,0,1,1,1
TRBV18,TRBJ1-5,CASSPADSNQPQHF,0,1,1,1
TRBV12-3/4,TRBJ1-1,CASSFTGGNTEAFF,0,1,1,1
TRBV4-2,TRBJ1-2,CASSQGTDYGYTF,0,2,1,2
TRBV28,TRBJ1-4,CASSKTGAKKLFF,0,1,1,1
TRBV20-1,TRBJ2-3,CSARDQGSDTQYF,0,1,1,1
TRBV29-1,TRBJ2-1,CSGPGASYNEQFF,0,1,1,1
TRBV6-1,TRBJ1-1,CASSEVTEAFF,0,1,1,1
TRBV6-2/3/5/6,TRBJ1-1,CASSLGGTTEAFF,0,1,1,1
TRBV28,TRBJ1-2,CASTILLDRKHHGYTF,0,1,1,1
TRBV29-1,TRBJ2-5,CSVGLAGGGQETQYF,0,1,1,1
TRBV28,TRBJ2-7,CASSQGRDRELRYSYEQYF,0,1,1,1
TRBV4-2,TRBJ1-6,CASSQEARQGNSPLHF,0,2,1,2
TRBV7-2,TRBJ2-1,CASSYIAGGANEQFF,0,1,1,1
TRBV7-9,TRBJ2-3,CASSPGQNPTDTQYF,0,1,1,1
TRBV10-3,TRBJ1-1,CAISERQADTEAFF,0,1,1,1
TRBV7-8,TRBJ1-4,CASSLRAANEKLFF,0,1,1,1
TRBV28,TRBJ2-2,CASSPWSTGELFF,0,1,1,1
TRBV20-1,TRBJ2-5,CSAMMGGQETQYF,0,1,1,1
TRBV29-1,TRBJ1-1,CSAERGGSEKAFF,0,2,1,2
TRBV27,TRBJ2-1,CAVGVLYNEQFF,0,1,1,1
TRBV29-1,TRBJ2-5,CSVEANQETQYF,0,1,1,1
TRBV29-1,TRBJ1-1,CSAPSANTEAFF,0,1,1,1
TRBV20-1,TRBJ2-5,CSTSGGHQETQYF,0,1,1,1
TRBV6-2/3/5/6,TRBJ2-5,CASSLGPLGTGQETQYF,0,1,1,1
TRBV6-2/3/5/6,TRBJ2-1,CASSSGQVDWSYNEQFF,0,1,1,1
TRBV3-1,TRBJ2-7,CASSQTSAAYYEQYF,0,1,1,1
TRBV18,TRBJ1-1,CASSPQGATEAFF,0,1,1,1
TRBV20-1,TRBJ2-4,CSARDRLKTKNIQYF,0,1,1,1
TRBV28,TRBJ1-4,CASSHYRGKLFF,0,1,1,1
TRBV29-1,TRBJ2-1,CSELETRRRGSNEQFF,0,1,1,1
TRBV5-1,TRBJ1-1,CASSLRGRNTEAFF,0,2,1,2
TRBV12-3/4,TRBJ2-5,CASRDRGRETQYF,0,1,1,1
TRBV3-1,TRBJ2-3,CASSPTSSGGGTDTQYF,0,1,1,1
TRBV12-3/4,TRBJ1-5,CASSSQMNQPQHF,0,1,1,1
TRBV29-1,TRBJ2-7,CSVRNSHYEQYF,0,1,1,1
TRBV6-4,TRBJ1-5,CASSNLYAGAQDRAGQPQHF,0,1,1,1
TRBV19,TRBJ1-5,CASSSKGQGARRRNQPQHF,0,1,1,1
TRBV6-1,TRBJ2-1,CASSEEGLLSYNEQFF,0,1,1,1
TRBV7-2,TRBJ2-6,CASSLSYRGGANVLTF,0,1,1,1
TRBV7-6,TRBJ2-4,CASSRPGTRYKNIQYF,0,1,1,1
TRBV7-2,TRBJ2-5,CASSQSVAGGRETQYF,0,1,1,1
TRBV19,TRBJ2-2,CASRKDRVNTGELFF,0,1,1,1
TRBV12-3/4,TRBJ1-2,CASSLMGQPNYGYTF,0,1,1,1
TRBV6-4,TRBJ1-4,CASSRDRATNEKLFF,0,1,1,1
TRBV2,TRBJ1-6,CASSERRADNSPLHF,0,1,1,1
TRBV7-9,TRBJ1-5,CASSLEGGHNQPQHF,0,1,1,1
TRBV3-1,TRBJ1-5,CASSPTGGNNQPQHF,0,1,1,1
TRBV20-1,TRBJ1-5,CSAREQGIRNQPQHF,0,1,1,1
TRBV18,TRBJ2-1,CASSPPGEYNEQFF,0,1,1,1
TRBV7-3,TRBJ2-3,CASSSGTSGDTQYF,0,2,1,2
TRBV12-3/4,TRBJ1-4,CASSPGQGNEKLFF,0,2,1,2
TRBV6-4,TRBJ2-7,CASKVGGTPYEQYF,0,1,1,1
TRBV5-1,TRBJ1-1,CASSFGVLNTEAFF,0,1,1,1
TRBV29-1,TRBJ2-7,CSVGPRGALYEQYF,0,1,1,1
TRBV29-1,TRBJ1-1,CSVDRGTTEAFF,0,1,1,1
TRBV20-1,TRBJ2-3,CSAILGDTQYF,0,1,1,1
TRBV30,TRBJ1-2,CAWKGRVEYGYTF,0,1,1,1
TRBV5-1,TRBJ2-3,CASSLFRGQADTQYI,0,1,1,1
TRBV6-2/3/5/6,TRBJ1-1,CASSYSGRIVITTEAFF,0,1,1,1
TRBV6-2/3/5/6,TRBJ1-3,CASSYPPTGVSGNTIYF,0,1,1,1
TRBV28,TRBJ1-1,CHSGGRGFFSDTEAFF,0,1,1,1
TRBV6-1,TRBJ2-5,CASSEQSGEIQETQYF,0,2,1,2
TRBV3-1,TRBJ2-7,CASSPFMGISSYEQYF,0,1,1,1
TRBV2,TRBJ2-3,CASSGGLADHTDTQYF,0,1,1,1
TRBV20-1,TRBJ2-4,CSASPSGLAGGNIQYF,0,1,1,1
TRBV18,TRBJ1-2,CASSPTAGGDYGYTF,0,1,1,1
TRBV11-2,TRBJ2-1,CASGELAGGMGEQFF,0,1,1,1
TRBV25-1,TRBJ2-1,CASSFGGDPYNEQFF,0,3,1,3
TRBV27,TRBJ2-5,CASSFSGGSQETQYF,0,2,1,2
TRBV12-3/4,TRBJ1-1,CASSPKGRLNTEAFF,0,1,1,1
TRBV5-4,TRBJ2-3,CASSSGGQVTDTQYF,0,1,1,1
TRBV9,TRBJ1-6,CASSVAGSDNSPLHF,0,1,1,1
TRBV7-2,TRBJ1-5,CASSTGPVTNQPQHF,0,1,1,1
TRBV20-1,TRBJ2-3,CSAPGQGVGTDTQYF,0,1,1,1
TRBV12-3/4,TRBJ1-4,CATSIRGTNEKLFF,0,1,1,1
TRBV28,TRBJ2-2,CASSWSGGPGELFF,0,2,1,2
TRBV12-3/4,TRBJ1-1,CASSLTGLNTEAFF,0,1,1,1
TRBV7-2,TRBJ1-2,CASSLTPGGHGYTF,0,2,1,2
TRBV7-3,TRBJ2-5,CASSLNGGGETQYF,0,1,1,1
TRBV7-9,TRBJ1-3,CASKADFSGNTIYF,0,1,1,1
TRBV10-2,TRBJ2-5,CASSPVGAQETQYF,0,1,1,1
TRBV20-1,TRBJ2-1,CSARGRDRVNEQFF,0,1,1,1
TRBV20-1,TRBJ2-3,CSAMTGGWPDTQYF,0,1,1,1
TRBV30,TRBJ1-1,CAWSVRQGTEAFF,0,1,1,1
TRBV7-2,TRBJ1-1,CASGRQRNTEAFF,0,1,1,1
TRBV6-4,TRBJ2-2,CASSDFEAGELFF,0,2,1,2
TRBV3-1,TRBJ1-2,CASSQEPNYGYTF,0,1,1,1
TRBV6-1,TRBJ1-1,CASREGKNTEAFF,0,1,1,1
TRBV5-1,TRBJ2-7,CASSLPESREQYF,0,1,1,1
TRBV10-3,TRBJ1-2,CAIREGALGYTF,0,1,1,1
TRBV13,TRBJ2-7,CASSFSAEEQYF,0,1,1,1
TRBV5-6,TRBJ1-2,CASSLLEGGYTF,0,1,1,1
TRBV29-1,TRBJ2-5,CSVKLGQETQYF,0,1,1,1
TRBV30,TRBJ1-2,CANSPGYTF,0,2,1,2
TRBV3-1,TRBJ2-1,CASSQDPGLAGAYNEQFF,0,1,1,1
TRBV19,TRBJ1-1,CASSIVGREHTEAFF,0,1,1,1
TRBV7-9,TRBJ2-7,CASTPFGGSFHEQYF,0,1,1,1
TRBV29-1,TRBJ1-2,CSIEQWQGNYGYTF,0,1,1,1
TRBV5-1,TRBJ2-1,CASSPVTLNEQFF,0,1,1,1
TRBV12-3/4,TRBJ2-7,CASSRSPYEQYF,0,1,1,1
TRBV28,TRBJ1-5,CATQGGNQPQHF,0,1,1,1
TRBV29-1,TRBJ2-7,CSVATGPQEQYF,0,1,1,1
TRBV12-3/4,TRBJ2-7,CASSLTEVTGPSYEQYF,0,2,1,2
TRBV7-2,TRBJ1-1,CASSLSAAELEAFF,0,2,1,2
TRBV3-1,TRBJ2-3,CASSQSQNTQYF,0,1,1,1
TRBV20-1,TRBJ2-3,CSAFIWPPRGVSTDTQYF,0,1,1,1
TRBV5-6,TRBJ1-4,CASSLSLDPEREKLFF,0,1,1,1
TRBV5-5,TRBJ2-1,CASSSETGFLYNEQFF,0,1,1,1
TRBV14,TRBJ1-1,CASSRRDRGGSPEAFF,0,1,1,1
TRBV19,TRBJ1-5,CASSMRGSGDQPQHF,0,1,1,1
TRBV18,TRBJ2-1,CASSPSPNSYNEQFF,0,2,1,2
TRBV12-3/4,TRBJ1-1,CASTLRGGTNTEAFF,0,1,1,1
TRBV12-3/4,TRBJ2-1,CASSLDGVSGNEQFF,0,1,1,1
TRBV5-4,TRBJ2-1,CASSSPGTGYNEQFF,0,1,1,1
TRBV3-1,TRBJ2-3,CASSQGLAGTDTQYF,0,2,1,2
TRBV3-1,TRBJ1-5,CASSQGQNSNQPQHF,0,1,1,1
TRBV9,TRBJ1-1,CASSAGTGVGTEAFF,0,1,1,1
TRBV13,TRBJ1-2,CASSRRQRLDYGYTF,0,1,1,1
TRBV5-1,TRBJ2-5,CASSLETGGGETQYF,0,1,1,1
TRBV5-1,TRBJ1-2,CASSLSGGTNYGYTF,0,1,1,1
TRBV5-1,TRBJ1-1,CASSLLGRADTEAFF,0,1,1,1
TRBV5-1,TRBJ1-2,CASSMGTGGDYGYTF,0,1,1,1
TRBV20-1,TRBJ2-1,CSASPSSGGYNEQFF,0,1,1,1
TRBV20-1,TRBJ1-5,CSARARDRENQPQHF,0,1,1,1
TRBV29-1,TRBJ1-1,CSVGRSGTGLTEAFF,0,1,1,1
TRBV30,TRBJ1-1,CALKAGFWDTEAFF,0,1,1,1
TRBV12-3/4,TRBJ2-2,CASSFRGSTGELFF,0,1,1,1
TRBV7-9,TRBJ1-5,CASSFGTGNQPQHF,0,1,1,1
TRBV12-3/4,TRBJ1-4,CASSPTGGYEKLFF,0,1,1,1
TRBV12-3/4,TRBJ2-1,CASRTDSVINEQFF,0,1,1,1
TRBV28,TRBJ1-4,CASRPAGGYEKLFF,0,1,1,1
TRBV5-1,TRBJ1-1,CASSFGLMNTEAFF,0,1,1,1
TRBV5-1,TRBJ2-2,CASSLDTDTGELFF,0,1,1,1
TRBV20-1,TRBJ2-2,CSATENANTGELFF,0,1,1,1
TRBV29-1,TRBJ2-3,CSVASGVSTDTQYF,0,1,1,1
TRBV19,TRBJ1-1,CATRRGWNTEAFF,0,1,1,1
TRBV7-9,TRBJ1-4,CASLRGEGEKLFF,0,1,1,1
TRBV19,TRBJ1-2,CASSPGQRYGYTF,0,1,1,1
TRBV28,TRBJ2-1,CASSLPTDNEQFF,0,1,1,1
TRBV12-3/4,TRBJ1-2,CASSLKQVYGYTF,0,2,1,2
TRBV28,TRBJ1-1,CASSLNLNTEAFF,0,1,1,1
TRBV12-3/4,TRBJ2-3,CASSVDFRGAQYF,0,2,1,2
TRBV7-6,TRBJ1-1,CASSLGQHTEAFF,0,1,1,1
TRBV5-6,TRBJ2-4,CASSLAGGSIQYF,0,1,1,1
TRBV20-1,TRBJ1-4,CSASVGNHEKLFF,0,1,1,1
TRBV29-1,TRBJ1-1,CSVVRAMNTEAFF,0,1,1,1
TRBV19,TRBJ1-1,CASSTLPSEAFF,0,1,1,1
TRBV12-3/4,TRBJ1-2,CASSFSEHGYTF,0,1,1,1
TRBV13,TRBJ2-5,CASSLMSSPQYF,0,1,1,1
TRBV12-3/4,TRBJ2-2,CASRGVPGELFF,0,1,1,1
TRBV4-1,TRBJ2-2,CASSLNTGELFF,0,1,1,1
TRBV6-2/3/5/6,TRBJ1-1,CASSNTGEAFF,0,1,1,1
TRBV19,TRBJ2-1,CASSIGTSGGTNEQFF,0,1,1,1
TRBV20-1,TRBJ2-7,CSALGGERENYEQYF,0,1,1,1
TRBV5-1,TRBJ2-1,CASSFKGGDNEQFF,0,1,1,1
TRBV18,TRBJ1-5,CASSPPGDQPQHF,0,2,1,2
TRBV5-1,TRBJ1-1,CASSDHGQGHTEAFF,0,1,1,1
TRBV7-9,TRBJ2-5,CASSLNVDFQETQYF,0,1,1,1
TRBV5-1,TRBJ2-2,CASSLRGQYTGELFF,0,1,1,1
TRBV3-1,TRBJ1-2,CASSQQGVNNGYTF,0,1,1,1
TRBV4-1,TRBJ2-2,CASSRVKNTGELFF,0,1,1,1
TRBV29-1,TRBJ1-1,CSVVVRGQGTGAFF,0,1,1,1
TRBV5-1,TRBJ2-1,CASSLGGGNEQFF,0,1,1,1
TRBV7-2,TRBJ2-1,CASSLGGAGSHNEQLF,0,1,1,1
TRBV5-1,TRBJ2-1,CASSKDREWGNEQFF,0,2,1,2
TRBV29-1,TRBJ1-4,CSVEELTGGFGKLFF,0,2,1,2
TRBV2,TRBJ1-1,CASSEGLRGTEAFF,0,1,1,1
TRBV29-1,TRBJ2-7,CSVEGDRTYEQYF,0,1,1,1
TRBV2,TRBJ1-4,CASMERSEKLFF,0,2,1,2
TRBV5-1,TRBJ2-1,CASSSGGNEQFF,0,1,1,1
TRBV12-3/4,TRBJ2-3,CASLPTSTDTQYF,0,1,1,1
TRBV28,TRBJ2-3,CASSSPLERELGGTDTQYF,0,1,1,1
TRBV7-2,TRBJ1-2,CASSPGPNLGIDYGYTF,0,1,1,1
TRBV11-2,TRBJ2-2,CASSERALASNTGELFF,0,1,1,1
TRBV20-1,TRBJ1-5,CSAGRAPKGDRNQPQHF,0,1,1,1
TRBV20-1,TRBJ1-4,CSARDYPGDRVYEKLFF,0,1,1,1
TRBV20-1,TRBJ2-4,CSAKPGGSGGTKNIQYF,0,1,1,1
TRBV29-1,TRBJ2-1,CSTRGDREARAYNEQFF,0,1,1,1
TRBV18,TRBJ1-1,CASSDGDRGRNTEAFF,0,1,1,1
TRBV12-3/4,TRBJ2-2,CASSDSLSGEAGELFF,0,1,1,1
TRBV4-3,TRBJ2-2,CASSQEPAGSAGELFF,0,1,1,1
TRBV20-1,TRBJ2-4,CSARERPGLAKNIQYF,0,1,1,1
TRBV25-1,TRBJ2-3,CSSRAEGGPTDTQYF,0,1,1,1
TRBV19,TRBJ1-5,CASTFVGASNQPQHF,0,1,1,1
TRBV12-3/4,TRBJ2-1,CASTGGRGEYNEQFF,0,1,1,1
TRBV12-3/4,TRBJ2-1,CASSLGRSQYNEQFF,0,1,1,1
TRBV7-9,TRBJ2-2,CASSLGPTNTGELFF,0,1,1,1
TRBV6-1,TRBJ1-1,CASSEARGQVEAAFF,0,1,1,1
TRBV12-3/4,TRBJ1-5,CASSRSGGSNQPQHF,0,1,1,1
TRBV7-2,TRBJ2-3,CASSLVEHHTDTQYF,0,1,1,1
TRBV2,TRBJ2-2,CASSLDRANTGELFF,0,1,1,1
TRBV7-2,TRBJ1-3,CASSPQRVPGNTIYF,0,2,1,2
TRBV5-1,TRBJ2-7,CASSRGSMDSYEQYF,0,1,1,1
TRBV5-1,TRBJ2-3,CASSLSGTNTDTQYF,0,1,1,1
TRBV20-1,TRBJ2-7,CSARDLQQGIYEQYF,0,1,1,1
TRBV20-1,TRBJ1-5,CSARDLVTAGQPQHF,0,1,1,1
TRBV15,TRBJ1-1,CATSSNRAGAEAFF,0,1,1,1
TRBV19,TRBJ2-5,CASSMVRGTKTQYF,0,1,1,1
TRBV12-3/4,TRBJ2-7,CASSLADISYEQYF,0,1,1,1
TRBV7-6,TRBJ2-7,CASSFFDSLNEQYF,0,1,1,1
TRBV5-4,TRBJ1-1,CASSFDRSYTEAFL,0,1,1,1
TRBV7-2,TRBJ1-2,CASSLAAWDYGYTF,0,1,1,1
TRBV11-2,TRBJ1-5,CASSLGRGSGPQHF,0,1,1,1
TRBV12-3/4,TRBJ2-5,CASSRQTGLETQYF,0,2,1,2
TRBV3-1,TRBJ2-1,CASSQYQAGGEQFF,0,1,1,1
TRBV14,TRBJ2-7,CASSQDWASREQYF,0,1,1,1
TRBV6-2/3/5/6,TRBJ1-1,CASRQGGLYTEAFF,0,1,1,1
TRBV20-1,TRBJ2-5,CSQRGPRVWETQYF,0,1,1,1
TRBV20-1,TRBJ1-3,CSARSNKAGNTIYF,0,1,1,1
TRBV29-1,TRBJ1-5,CSVSGGAPNQPQHF,0,1,1,1
TRBV7-7,TRBJ2-1,CASSFSPYNEQFF,0,1,1,1
TRBV27,TRBJ2-1,CASGRAYYNEQFF,0,1,1,1
TRBV5-6,TRBJ2-1,CASTSTGYNEQFF,0,1,1,1
TRBV6-2/3/5/6,TRBJ1-1,CASSFYMNTEAFF,0,1,1,1
TRBV12-3/4,TRBJ1-5,CASSIHPHQPQHF,0,1,1,1
TRBV7-3,TRBJ2-1,CASSLDRGGEQFF,0,1,1,1
TRBV7-9,TRBJ1-1,CASSSEWNTEAFF,0,1,1,1
TRBV5-1,TRBJ1-2,CASSLAGANGYTF,0,2,1,2
TRBV29-1,TRBJ2-5,CSSERGPGETQYF,0,1,1,1
TRBV19,TRBJ2-4,CASRLAGDIQYF,0,1,1,1
TRBV28,TRBJ2-7,CASSLQFYEQYF,0,1,1,1
TRBV3-1,TRBJ1-2,CASSQALRGYTF,0,1,1,1
TRBV12-3/4,TRBJ2-7,CASRTGSYEQYF,0,1,1,1
TRBV5-1,TRBJ2-2,CASSFAGGELFF,0,1,1,1
TRBV12-3/4,TRBJ2-1,CASSFVSEQFF,0,1,1,1
TRBV7-2,TRBJ2-7,CASSDTSEQYF,0,1,1,1
TRBV29-1,TRBJ2-7,CSARSSYEQYF,0,1,1,1
TRBV19,TRBJ2-1,CASSTQGNLVDEQFF,0,1,1,1
TRBV29-1,TRBJ1-5,CSVGGNSNQPQHF,0,2,1,2
TRBV6-2/3/5/6,TRBJ1-1,CASSPGTGGSGVNTEAFF,0,1,1,1
TRBV19,TRBJ2-3,CASMGTTSGGITDTQYF,0,1,1,1
TRBV14,TRBJ1-1,CASSQDGLRHKNTEAFF,0,1,1,1
TRBV11-2,TRBJ1-2,CASSAFGGIGANYGYTF,0,1,1,1
TRBV4-3,TRBJ2-7,CASSQDALAGGAYEQYF,0,1,1,1
TRBV12-5,TRBJ2-3,CASGLGGGRLTDTQYF,0,1,1,1
TRBV24-1,TRBJ2-3,CATSDLQAGAIDTQYF,0,1,1,1
TRBV12-3/4,TRBJ1-5,CASSLGLGQNNQPQHF,0,1,1,1
TRBV28,TRBJ1-5,CASSSLEKRSNQPQHF,0,1,1,1
TRBV7-2,TRBJ2-7,CASSLVPNSPSYEQYF,0,1,1,1
TRBV6-2/3/5/6,TRBJ1-1,CASSSQLGGKNTEAFF,0,1,1,1
TRBV3-1,TRBJ1-1,CASSQGHRAMNTDAFF,0,1,1,1
TRBV5-1,TRBJ1-4,CASSLGGGAGNEKLFF,0,1,1,1
TRBV5-1,TRBJ1-6,CASSLEASSYNSPLHF,0,1,1,1
TRBV5-1,TRBJ1-1,CASSSGGTTGSDEAFF,0,1,1,1
TRBV5-1,TRBJ2-7,CASSGGNRARFYEQYF,0,1,1,1
TRBV20-1,TRBJ2-5,CSASLSSGGIQETQYF,0,3,1,3
TRBV20-1,TRBJ2-7,CSARDLRQGATYEQNF,0,1,1,1
TRBV29-1,TRBJ2-3,CSVEDLVGSAGNTQYF,0,1,1,1
TRBV10-3,TRBJ2-5,CAIRGRDGEQETQYF,0,1,1,1
TRBV28,TRBJ1-4,CATLKGTGVNEKLFF,0,1,1,1
TRBV27,TRBJ1-4,CASQPQGSTNEKLFF,0,1,1,1
TRBV18,TRBJ2-4,CASSPGTGAKNIQYF,0,1,1,1
TRBV12-3/4,TRBJ2-1,CASSLGGSSYNEQFF,0,1,1,1
TRBV28,TRBJ1-4,CASSSPGQGDGKLFF,0,1,1,1
TRBV6-2/3/5/6,TRBJ1-1,CASSYSGGPAVEAFF,0,1,1,1
TRBV6-2/3/5/6,TRBJ2-2,CASSYRDLNTGELFF,0,1,1,1
TRBV12-3/4,TRBJ2-5,CASSLKIIGVETQYF,0,1,1,1
TRBV7-9,TRBJ1-2,CASSLQPGQGFGYTF,0,1,1,1
TRBV7-2,TRBJ1-3,CASSLDSSSGNTIYF,0,1,1,1
TRBV5-6,TRBJ2-5,CASSSRVGGSETQYF,0,1,1,1
TRBV6-2/3/5/6,TRBJ2-3,CASSLLWARTDTQYF,0,1,1,1
TRBV3-1,TRBJ2-7,CASSPSRASSYEQYF,0,1,1,1
TRBV7-9,TRBJ2-3,CASSPPGTAADTQYF,0,2,1,2
TRBV14,TRBJ1-2,CASSQDLRWAGGYTF,0,1,1,1
TRBV5-4,TRBJ1-2,CASRTAGQGNYGYTF,0,1,1,1
TRBV12-3/4,TRBJ1-6,CASRRNGGADSPLHF,0,1,1,1
TRBV6-2/3/5/6,TRBJ2-3,CASSSTGQSTDTQYF,0,1,1,1
TRBV5-1,TRBJ1-2,CASSLETWAGYGYTF,0,1,1,1
TRBV4-3,TRBJ2-7,CASSQNPGLAAEQYF,0,1,1,1
TRBV20-1,TRBJ2-1,CSARDWASVSNEQFF,0,1,1,1
TRBV29-1,TRBJ2-3,CSVEGGFSSTDTQYF,0,1,1,1
TRBV10-3,TRBJ1-6,CAISDRDSSKPLHF,0,1,1,1
TRBV19,TRBJ1-6,CASSMGADGSPLHF,0,1,1,1
TRBV19,TRBJ2-7,CASSIAVGRYEQYF,0,1,1,1
TRBV18,TRBJ2-3,CASSPPGQSDTQYF,0,1,1,1
TRBV27,TRBJ1-2,CASSYRASNYGYTF,0,1,1,1
TRBV6-2/3/5/6,TRBJ1-3,CASSPGGSGNTIYF,0,1,1,1
TRBV7-3,TRBJ2-2,CASSLVGNTGELFF,0,1,1,1
TRBV7-2,TRBJ1-1,CASSLAGGNTEAFF,0,1,1,1
TRBV3-1,TRBJ2-7,CASSQVRGAQEQYF,0,1,1,1
TRBV3-1,TRBJ1-5,CASSQAGPGQPQHF,0,1,1,1
TRBV5-1,TRBJ1-6,CASSLETGPSPLHF,0,1,1,1
TRBV5-1,TRBJ2-1,CASSLIQGINEQFF,0,1,1,1
TRBV5-1,TRBJ2-2,CASSRQGNTGELFF,0,2,1,2
TRBV5-1,TRBJ1-4,CASSTTGYGEKLFF,0,1,1,1
TRBV5-1,TRBJ2-7,CASRDGTGPYEQYF,0,1,1,1
TRBV20-1,TRBJ2-4,CSARPSGGKNIQYF,0,1,1,1
TRBV24-1,TRBJ2-3,CATTGTDTDTQYF,0,1,1,1
TRBV19,TRBJ1-5,CASTRGRDQPQHF,0,1,1,1
TRBV27,TRBJ2-7,CASSLGGFYEQYF,0,1,1,1
TRBV2,TRBJ1-1,CASSEMAATEAFF,0,1,1,1
TRBV5-4,TRBJ2-6,CASSLPGANVLTF,0,1,1,1
TRBV6-1,TRBJ2-5,CASRNRSSETQYF,0,1,1,1
TRBV5-1,TRBJ2-3,CASRLVAPDTQYF,0,1,1,1
TRBV4-1,TRBJ1-4,CASSQESRPEMFF,0,1,1,1
TRBV20-1,TRBJ2-1,CSAPGTSEFEQFF,0,1,1,1
TRBV29-1,TRBJ2-7,CSVEYTSGDEQYF,0,2,1,2
TRBV10-3,TRBJ1-2,CAISESTNGYTF,0,1,1,1
TRBV12-3/4,TRBJ2-1,CASSFGPNEQFF,0,1,1,1
TRBV27,TRBJ1-5,CASSLSEGPQHF,0,1,1,1
TRBV6-2/3/5/6,TRBJ2-7,CASSRGSHEQYF,0,1,1,1
TRBV11-3,TRBJ2-7,CASSLVGYEQYF,0,1,1,1
TRBV3-1,TRBJ2-7,CASSQSHYEQYF,0,1,1,1
TRBV7-2,TRBJ1-6,CASSDPLSPLHF,0,1,1,1
TRBV4-1,TRBJ1-1,CASSHGGTEAFF,0,1,1,1
TRBV29-1,TRBJ2-7,CSVGDYSYEQYF,0,1,1,1
TRBV29-1,TRBJ1-2,CSVTDGVYGYTF,0,1,1,1
TRBV30,TRBJ2-5,CAGLVRETQYF,0,1,1,1
TRBV14,TRBJ2-1,CASSTHNEQFF,0,1,1,1
TRBV5-1,TRBJ2-5,CAGGQGGTQYF,0,1,1,1
TRBV29-1,TRBJ2-1,CSVEAPNEQFF,0,1,1,1
TRBV19,TRBJ2-2,CASILNPRGKTGELFF,0,1,1,1
TRBV20-1,TRBJ1-3,CSARPTHGRAGNTIYF,0,1,1,1
TRBV29-1,TRBJ1-1,CSVPQGVSTTEAFF,0,1,1,1
TRBV18,TRBJ1-2,CASSPTGNYGYTF,0,1,1,1
TRBV15,TRBJ2-3,CATSSRDSRNGDTQYF,0,1,1,1
TRBV5-1,TRBJ2-3,CASRLDWTSRADTQYF,0,1,1,1
TRBV7-2,TRBJ2-1,CASSLSGSGGGEQFF,0,1,1,1
TRBV20-1,TRBJ1-1,CSASGSGGMNTEAFF,0,2,1,2
TRBV3-1,TRBJ1-2,CASSAKDGHYGYSF,0,1,1,1
TRBV5-1,TRBJ2-1,CASSLDIRVPMQFL,0,1,1,1
TRBV20-1,TRBJ1-5,CSATESKGNQPQHF,0,1,1,1
TRBV12-3/4,TRBJ1-2,CASSLVREEGYTF,0,1,1,1
TRBV29-1,TRBJ2-5,CSLQSGPETQYF,0,1,1,1
TRBV4-2,TRBJ2-3,CASSQDPPSGGAGRADTQYF,0,1,1,1
TRBV20-1,TRBJ2-1,CSARDLFRGTHPGGTGEQFF,0,1,1,1
TRBV30,TRBJ1-3,CAWSEWGRDRGSGNTIYF,0,1,1,1
TRBV24-1,TRBJ2-3,CATSDLNQGGGWADTQYF,0,1,1,1
TRBV2,TRBJ2-1,CASSSGLAGGLGGNEQFF,0,1,1,1
TRBV7-2,TRBJ2-1,CASSLMGPGTSGYNEQFF,0,1,1,1
TRBV5-6,TRBJ2-1,CASSSSLAGGSSYNEQFF,0,1,1,1
TRBV20-1,TRBJ2-3,CSARDPPGLAGGTDTQYF,0,2,1,2
TRBV20-1,TRBJ2-6,CSAREGQELISGANVLTF,0,1,1,1
TRBV19,TRBJ2-1,CASSIRDREISYNEQFF,0,1,1,1
TRBV18,TRBJ1-5,CASSPRALAGSNQPQHF,0,1,1,1
TRBV12-3/4,TRBJ1-1,CASSFRISDSQNTEAFF,0,1,1,1
TRBV7-6,TRBJ2-1,CASSLDQRESSYNEQFF,0,1,1,1
TRBV4-2,TRBJ2-6,CASSQDPGGLGANVLTF,0,1,1,1
TRBV3-1,TRBJ2-1,CASSQDQGLPSYNEQFF,0,1,1,1
TRBV5-1,TRBJ1-3,CASSSLQGKPSGNTIYF,0,1,1,1
TRBV10-1,TRBJ2-2,CASSPPGTVGRTGELFF,0,1,1,1
TRBV12-5,TRBJ2-2,CASGLWGQTNTGELFF,0,1,1,1
TRBV11-3,TRBJ2-3,CASSPVPSGGRDTQYF,0,1,1,1
TRBV19,TRBJ2-1,CASSELAGGLRVEQFF,0,1,1,1
TRBV18,TRBJ2-2,CASSASRDANTGELFF,0,1,1,1
TRBV28,TRBJ2-1,CASSLRDRGLNNEQLF,0,1,1,1
TRBV28,TRBJ2-7,CASSSSGTGTPYEQYF,0,1,1,1
TRBV6-2/3/5/6,TRBJ2-1,CASSSLGGSSYNEQFF,0,1,1,1
TRBV6-2/3/5/6,TRBJ2-5,CASSSLAGGPRETQYF,0,1,1,1
TRBV6-2/3/5/6,TRBJ1-3,CASSYSGQQTGNTIYF,0,1,1,1
TRBV6-2/3/5/6,TRBJ2-2,CASSRSRAGPTGELFF,0,1,1,1
TRBV5-6,TRBJ1-3,CASSALIGGIGNTIYF,0,1,1,1
TRBV2,TRBJ2-1,CASSEEGAGFGDEQFF,0,1,1,1
TRBV11-2,TRBJ1-1,CASSLVGTGFGTEAFF,0,1,1,1
TRBV7-2,TRBJ2-2,CASSLASGTTFGELFF,0,1,1,1
TRBV7-2,TRBJ1-5,CASSLGNRGSNQPQHF,0,1,1,1
TRBV7-9,TRBJ2-7,CASSLSGTGTSYEQYF,0,1,1,1
TRBV7-8,TRBJ2-5,CASSLDYRGRRETQYF,0,1,1,1
TRBV9,TRBJ2-2,CASSVVSGGDTGELFF,0,1,1,1
TRBV4-3,TRBJ2-3,CASSQQGSGGTDTQYF,0,2,1,2
TRBV20-1,TRBJ2-5,CSARMYLAGGRETQYF,0,1,1,1
TRBV20-1,TRBJ1-2,CSARDGDRAYYEGYTF,0,1,1,1
TRBV10-3,TRBJ2-1,CAISGLAKSYNEQFF,0,1,1,1
TRBV24-1,TRBJ2-1,CATSGPGGTYNEQFF,0,1,1,1
TRBV24-1,TRBJ2-3,CATSDTGDGTDTQYF,0,1,1,1
TRBV15,TRBJ2-2,CATSRSRGDTGELFF,0,1,1,1
TRBV19,TRBJ2-1,CASSPAGDSYNEQFF,0,1,1,1
TRBV19,TRBJ1-3,CASRIGRLSGNTIYF,0,2,1,2
TRBV18,TRBJ1-1,CASSPGQGQNTEAFF,0,1,1,1
TRBV12-3/4,TRBJ2-1,CASIGGQGLYNEQFF,0,1,1,1
TRBV6-2/3/5/6,TRBJ2-1,CASTPGQGYTYEQFF,0,1,1,1
TRBV7-9,TRBJ2-3,CASSFTQGFADTQYF,0,1,1,1
TRBV28,TRBJ1-1,CASSFKPVVYTEAFF,0,1,1,1
TRBV12-3/4,TRBJ1-1,CASSLGGQGNTEAFF,0,1,1,1
TRBV28,TRBJ1-2,CASSLMGQGAYGYTF,0,1,1,1
TRBV12-3/4,TRBJ2-7,CASSSRGGQGREQYF,0,1,1,1
TRBV6-2/3/5/6,TRBJ2-3,CASSPSGGRTDTQYF,0,1,1,1
TRBV12-3/4,TRBJ1-4,CASSPREVVGEKLFF,0,1,1,1
TRBV6-2/3/5/6,TRBJ1-3,CASSRTGEAGNTIYF,0,1,1,1
TRBV6-1,TRBJ2-2,CASSGTSGDTGELFF,0,1,1,1
TRBV7-6,TRBJ2-7,CASSFLGTDSYEQYF,0,1,1,1
TRBV5-4,TRBJ2-1,CASSFRQGAFSEQFF,0,1,1,1
TRBV7-9,TRBJ2-1,CASSLGPGGDNEQFF,0,1,1,1
TRBV11-3,TRBJ2-1,CASSLGGGLGNEQFF,0,1,1,1
TRBV6-2/3/5/6,TRBJ2-3,CASSSRDWGVDTQYF,0,1,1,1
TRBV14,TRBJ1-1,CASSQDLGANTKAFF,0,1,1,1
TRBV3-1,TRBJ1-5,CASSQDAGGNQPQHF,0,1,1,1
TRBV7-9,TRBJ1-1,CASSEAVGQYTEAFS,0,1,1,1
TRBV12-3/4,TRBJ1-4,CASRPQGADNEKLFF,0,1,1,1
TRBV5-1,TRBJ2-1,CASSLSLAGDNEQFF,0,1,1,1
TRBV5-1,TRBJ1-2,CASSPGMGQNYGYTF,0,1,1,1
TRBV4-1,TRBJ1-6,CASSQESRQVGSLHF,0,1,1,1
TRBV5-1,TRBJ2-5,CASRLAGGPQETQYF,0,1,1,1
TRBV20-1,TRBJ2-3,CSARDLDRLTDTQYF,0,1,1,1
TRBV20-1,TRBJ2-5,CSARDLGAGGETQYF,0,2,1,2
TRBV20-1,TRBJ2-5,CSARDRIAGGETQYF,0,1,1,1
TRBV29-1,TRBJ2-2,CSVDTSLTRTGELFF,0,1,1,1
TRBV29-1,TRBJ2-3,CSVEGRDSSTDTQYF,0,1,1,1
TRBV29-1,TRBJ2-3,CSVEEAGGRGDTQYF,0,1,1,1
TRBV18,TRBJ1-5,CAGSPMADNQPQHF,0,1,1,1
TRBV30,TRBJ1-1,CATTGHPMNTEAFF,0,1,1,1
TRBV19,TRBJ2-1,CASSIHSSYNEQFF,0,2,1,2
TRBV13,TRBJ2-7,CASGAGPGTYEQYF,0,1,1,1
TRBV28,TRBJ2-1,CASTAGMDANEQFF,0,1,1,1
TRBV12-3/4,TRBJ1-5,CASSLGTGKQPQHF,0,1,1,1
TRBV6-1,TRBJ1-1,CASSGQGLVTEAFF,0,1,1,1
TRBV5-6,TRBJ2-2,CASSTGTGIGELFF,0,1,1,1
TRBV7-2,TRBJ1-2,CASSLSALAYGYTF,0,1,1,1
TRBV7-2,TRBJ1-1,CASSLQGMNTEAFF,0,1,1,1
TRBV13,TRBJ2-3,CASSSGLGTDTQYF,0,1,1,1
TRBV7-8,TRBJ2-7,CASSSGRGENEQYF,0,1,1,1
TRBV3-1,TRBJ2-2,CASSLRSSARELFF,0,1,1,1
TRBV14,TRBJ1-1,CASSPESPNTEAFF,0,1,1,1
TRBV7-2,TRBJ2-7,CASSPRQGVYEQYF,0,1,1,1
TRBV5-4,TRBJ2-7,CASSAAQGRHEQYF,0,1,1,1
TRBV5-6,TRBJ1-2,CASSGGTGSYGYTF,0,1,1,1
TRBV12-3/4,TRBJ1-2,CASRRQGARYGYTF,0,1,1,1
TRBV3-1,TRBJ2-2,CASRPRSITGELFF,0,1,1,1
TRBV6-2/3/5/6,TRBJ1-4,CASRQTATNEKLFF,0,1,1,1
TRBV6-2/3/5/6,TRBJ2-1,CASNDGGERKEQFF,0,1,1,1
TRBV2,TRBJ2-1,CASKQRTGYNEQFF,0,2,1,2
TRBV7-2,TRBJ2-5,CTSSAQPSGLTQYF,0,1,1,1
TRBV5-1,TRBJ2-1,CASSQNRQNNEQFF,0,1,1,1
TRBV5-1,TRBJ2-7,CASSLGGRNYEQYF,0,1,1,1
TRBV20-1,TRBJ1-2,CSARDGGGADGYTF,0,1,1,1
TRBV20-1,TRBJ2-7,CSASIGHSPYEQYF,0,1,1,1
TRBV29-1,TRBJ2-1,CSVRDRGWDNEQFF,0,2,1,2
TRBV12-5,TRBJ1-1,CASAWTANTEAFF,0,1,1,1
TRBV12-5,TRBJ2-3,CASGLVLTDTQYF,0,1,1,1
TRBV12-3/4,TRBJ1-5,CATTWTVNQPQHF,0,1,1,1
TRBV12-3/4,TRBJ1-2,CASSLVREDGYTF,0,1,1,1
TRBV28,TRBJ2-5,CASSAGGPETQYF,0,1,1,1
TRBV2,TRBJ1-1,CASSENKNTEASF,0,1,1,1
TRBV5-6,TRBJ2-5,CASSLGQQETQYF,0,1,1,1
TRBV5-4,TRBJ2-3,CASSLFGADTQYF,0,1,1,1
TRBV7-6,TRBJ1-3,CASSLANGNTIYF,0,1,1,1
TRBV7-2,TRBJ1-2,CASSLAGQYGYTF,0,1,1,1
TRBV7-2,TRBJ2-7,CASSLSPPYEQYF,0,1,1,1
TRBV7-3,TRBJ2-1,CASSSPPRVEQFF,0,1,1,1
TRBV13,TRBJ1-2,CASSLGQGYGYTF,0,1,1,1
TRBV12-3/4,TRBJ1-2,CASSRDPDGSYTF,0,1,1,1
TRBV14,TRBJ1-1,CASSQGLGTEAFF,0,1,1,1
TRBV4-2,TRBJ2-1,CASRPDLTEQQFF,0,1,1,1
TRBV5-1,TRBJ2-7,CASSSGPSYEQYF,0,1,1,1
TRBV5-1,TRBJ2-2,CASSWDNTGELFF,0,1,1,1
TRBV4-1,TRBJ2-7,CASSQDRNSKQYF,0,1,1,1
TRBV5-1,TRBJ2-5,CASSGGQGSTQYF,0,1,1,1
TRBV20-1,TRBJ2-7,CSAQTGIVYEQYF,0,1,1,1
TRBV20-1,TRBJ1-5,CSARQGYNQPQHF,0,2,1,2
TRBV20-1,TRBJ2-1,CSARDLFINEQFF,0,1,1,1
TRBV29-1,TRBJ1-1,CSVVRQLNTEAFF,0,2,1,2
TRBV29-1,TRBJ2-7,CSVARDTAYEQYF,0,1,1,1
TRBV29-1,TRBJ2-1,CSVGFQGEREQFF,0,1,1,1
TRBV29-1,TRBJ1-1,CSVEGEMNTEAFF,0,1,1,1
TRBV29-1,TRBJ2-3,CSEGQGATDTQYF,0,1,1,1
TRBV10-3,TRBJ2-5,CAISRLGSFQYF,0,1,1,1
TRBV24-1,TRBJ2-5,CATSDFGETQYF,0,1,1,1
TRBV6-4,TRBJ2-1,CASTLEVREQFF,0,1,1,1
TRBV12-3/4,TRBJ1-2,CASSLDGFGYTL,0,1,1,1
TRBV6-2/3/5/6,TRBJ1-2,CASSYEAGGYTL,0,1,1,1
TRBV12-3/4,TRBJ1-5,CASSYNRQPQHF,0,2,1,2
TRBV28,TRBJ1-4,CASSYLSEKLFF,0,1,1,1
TRBV12-3/4,TRBJ1-1,CASRLPGGEAFF,0,1,1,1
TRBV2,TRBJ2-7,CASRGGAYEQYF,0,1,1,1
TRBV12-3/4,TRBJ1-5,CASNSGNQPQHF,0,1,1,1
TRBV5-1,TRBJ2-1,CATEISGQKQFY,0,1,1,1
TRBV10-1,TRBJ1-2,CASSAGAEDYTF,0,1,1,1
TRBV20-1,TRBJ2-5,CSASGEQETQYF,0,1,1,1
TRBV20-1,TRBJ1-5,CSARDEGQPQHF,0,1,1,1
TRBV29-1,TRBJ1-1,CSVVRGNTEAFF,0,1,1,1
TRBV29-1,TRBJ2-5,CSVGDSQETQYF,0,1,1,1
TRBV30,TRBJ2-7,CAWSGAYEQYF,0,1,1,1
TRBV19,TRBJ2-3,CASSKTGTQYF,0,1,1,1
TRBV6-2/3/5/6,TRBJ2-7,CASSFLYEQYF,0,1,1,1
TRBV5-6,TRBJ1-1,CASRSGLISFF,0,1,1,1
TRBV29-1,TRBJ1-1,CSVPFNTEAFF,0,1,1,1
TRBV6-2/3/5/6,TRBJ1-4,CASSLEVEWTNEKLFF,0,1,1,1
TRBV5-6,TRBJ2-4,CASSFRRAVDKNIQYF,0,1,1,1
TRBV3-1,TRBJ1-5,CASSQMHGGQQPQHF,0,1,1,1
TRBV5-1,TRBJ1-6,CASSLNENSPLHF,0,1,1,1
TRBV7-2,TRBJ1-5,CASSLSGTYSNQPQHF,0,1,1,1
TRBV7-9,TRBJ1-1,CASSFRPVEATEAFF,0,2,1,2
TRBV7-6,TRBJ1-3,CASSLGSDSGNTIYF,0,1,1,1
TRBV29-1,TRBJ2-1,CSALVIAGPDNGQFF,0,1,1,1
TRBV9,TRBJ2-7,CASSVGVRDDEQYF,0,1,1,1
TRBV4-1,TRBJ2-3,CASSQDQPVRTTRSTDTQYF,0,1,1,1
TRBV6-2/3/5/6,TRBJ1-5,CASRSATFFSFYSNQPQHF,0,1,1,1
TRBV24-1,TRBJ2-3,CATSDLQTSGGRGGTQYF,0,1,1,1
TRBV7-2,TRBJ2-6,CASSFLARLNSGANVLTF,0,1,1,1
TRBV5-4,TRBJ2-2,CASSSRAGTGGFAGELFF,0,1,1,1
TRBV12-3/4,TRBJ2-1,CASSRPGRGISIDNEQFF,0,1,1,1
TRBV12-3/4,TRBJ2-1,CTSSPAKRGGFNYNEQFF,0,1,1,1
TRBV6-2/3/5/6,TRBJ2-2,CASITDAIAGKTGELFF,0,1,1,1
TRBV5-5,TRBJ2-1,CASSLGGGGSSYNEQFF,0,1,1,1
TRBV7-2,TRBJ2-1,CASSLGLGHSDDNEQFF,0,1,1,1
TRBV7-2,TRBJ2-5,CASSLDYRGGIQETQYF,0,1,1,1
TRBV3-1,TRBJ2-1,CASSPLGGRFLNNEQFF,0,1,1,1
TRBV7-8,TRBJ2-1,CASSRGLAGSRVNEQFF,0,1,1,1
TRBV7-9,TRBJ2-5,CASSHPRDGLWGVDQYF,0,1,1,1
TRBV3-1,TRBJ2-7,CASSQASGGLSSYEQYF,0,1,1,1
TRBV5-1,TRBJ2-3,CASSLLGVDNPTDTQYF,0,1,1,1
TRBV4-3,TRBJ2-5,CASSQVGSGMYQETQYF,0,1,1,1
TRBV24-1,TRBJ2-3,CATSDSLLQGTDTQYF,0,1,1,1
TRBV24-1,TRBJ2-3,CATSDGAVSSTDTQYF,0,2,1,2
TRBV19,TRBJ2-7,CASSSRGLAGAYEQYF,0,1,1,1
TRBV6-2/3/5/6,TRBJ2-1,CASTLQAGGTGNEQFF,0,1,1,1
TRBV28,TRBJ2-1,CASSLFTSGDYNEQFF,0,1,1,1
TRBV12-3/4,TRBJ2-5,CASSLSDHRDGETQYF,0,1,1,1
TRBV12-3/4,TRBJ2-5,CASSSRSGTTQETQYF,0,1,1,1
TRBV12-3/4,TRBJ2-7,CASSDRPGTPSYEQYF,0,1,1,1
TRBV5-4,TRBJ1-6,CASSFGARMGNSPLHF,0,1,1,1
TRBV5-4,TRBJ2-4,CASSLGGGVAKNIQYF,0,1,1,1
TRBV5-4,TRBJ2-5,CASSLEGQGRRKTQYF,0,1,1,1
TRBV7-2,TRBJ2-2,CASSLAGAPLAGELFF,0,1,1,1
TRBV11-2,TRBJ1-5,CASSLEGGTLNQPQHF,0,1,1,1
TRBV7-9,TRBJ2-4,CASSPDGGTGGNIQYF,0,1,1,1
TRBV3-1,TRBJ2-7,CASSQWAGSQALEQYF,0,1,1,1
TRBV3-1,TRBJ2-7,CASSQAGNDNSYEQYF,0,1,1,1
TRBV14,TRBJ1-2,CASSARMAGLNYGYTF,0,1,1,1
TRBV6-2/3/5/6,TRBJ2-3,CASSAGRGTGADTQYF,0,1,1,1
TRBV28,TRBJ1-2,CASSTDRGRINYGYTF,0,1,1,1
TRBV6-1,TRBJ2-5,CASRKGLAGFQEAQYF,0,1,1,1
TRBV5-1,TRBJ2-6,CASSFGTSSGANVLTF,0,1,1,1
TRBV5-1,TRBJ2-1,CASSLGPAGETNEQFF,0,1,1,1
TRBV5-1,TRBJ2-7,CASSLDGAGEIYEQYF,0,1,1,1
TRBV10-2,TRBJ2-3,CASRDWTGPSTDTQYF,0,1,1,1
TRBV24-1,TRBJ1-5,CATSDRRGAAQPQHF,0,1,1,1
TRBV19,TRBJ1-6,CASSLQTGVNSPLHF,0,1,1,1
TRBV19,TRBJ2-7,CASSIIATTGYEQYF,0,1,1,1
TRBV19,TRBJ2-6,CASSIDSSGANVLTF,0,1,1,1
TRBV19,TRBJ2-7,CASSPRGMGPYEQYF,0,1,1,1
TRBV18,TRBJ1-1,CASSPQGSLNTEAFF,0,1,1,1
TRBV18,TRBJ2-2,CASSPQGPNTGELFF,0,1,1,1
TRBV6-4,TRBJ2-1,CASIIAGGPYNEQFF,0,1,1,1
TRBV12-3/4,TRBJ2-3,CASSLAGGQTDTQYF,0,1,1,1
TRBV6-2/3/5/6,TRBJ2-3,CASSYGGPLADTQYF,0,1,1,1
TRBV12-3/4,TRBJ1-2,CASSLSGPHYGGYTF,0,1,1,1
TRBV6-2/3/5/6,TRBJ2-3,CASSPSGGAPDTQYF,0,1,1,1
TRBV6-9,TRBJ2-3,CASSVGWGSTDTQYF,0,1,1,1
TRBV6-1,TRBJ2-5,CASSEAAGGPETQYF,0,1,1,1
TRBV25-1,TRBJ1-5,CASSETGNSNQPQHF,0,1,1,1
TRBV5-6,TRBJ1-5,CASSLAGDRPQPQHF,0,1,1,1
TRBV5-6,TRBJ2-2,CASSLGQGVTGELFF,0,1,1,1
TRBV3-1,TRBJ1-2,CASSSRDGGNYGYTF,0,1,1,1
TRBV6-2/3/5/6,TRBJ2-1,CASSPGQLAVNEQFF,0,1,1,1
TRBV9,TRBJ2-7,CASSPNPGQPIEQYF,0,1,1,1
TRBV3-1,TRBJ1-2,CASSPYGGQTYGYTF,0,1,1,1
TRBV7-9,TRBJ1-1,CASSPRRDMNTEAFF,0,1,1,1
TRBV5-5,TRBJ2-1,CASSRLAGGGNEQFF,0,1,1,1
TRBV14,TRBJ2-7,CASSQGHRSSYEQYF,0,1,1,1
TRBV3-1,TRBJ2-1,CASSQRGTSPHEQFF,0,1,1,1
TRBV6-2/3/5/6,TRBJ2-5,CASSASGGHQETQYF,0,1,1,1
TRBV9,TRBJ1-5,CASSAGGARNQPQHF,0,2,1,2
TRBV7-9,TRBJ2-3,CASSTIQSSTDTQYF,0,1,1,1
TRBV12-3/4,TRBJ2-1,CASRVTGRTYNEQFF,0,1,1,1
TRBV2,TRBJ2-7,CASNPTDRGGPEQYF,0,1,1,1
TRBV9,TRBJ1-4,CARRGRAPRNEKLFF,0,1,1,1
TRBV5-1,TRBJ1-4,CASSLAPGTDEKLFF,0,1,1,1
TRBV5-1,TRBJ1-1,CASSLGGSRGTEAFF,0,1,1,1
TRBV4-3,TRBJ1-2,CASSQEKGPDYGYTF,0,1,1,1
TRBV4-1,TRBJ1-3,CASSQSQGGGDTIYL,0,1,1,1
TRBV20-1,TRBJ2-7,CSAPPPLAGVYEQYF,0,1,1,1
TRBV20-1,TRBJ1-5,CSATQGSGSNQPQHF,0,1,1,1
TRBV20-1,TRBJ2-3,CSATASAAGPDTQYF,0,1,1,1
TRBV20-1,TRBJ2-2,CSARTEQANTGELFF,0,1,1,1
TRBV27,TRBJ2-3,CASSFLAGTDTQYF,0,1,1,1
TRBV10-3,TRBJ1-1,CAISEPLRTGRTFF,0,1,1,1
TRBV10-3,TRBJ1-1,CAISEGGGFTEAFF,0,1,1,1
TRBV5-4,TRBJ1-2,CATEEKRGNYGYTF,0,1,1,1
TRBV19,TRBJ1-1,CASSLMTRNTEAFF,0,1,1,1
TRBV12-3/4,TRBJ2-5,CASSTRLGGTAQYF,0,1,1,1
TRBV18,TRBJ1-5,CASSSLEGNQPQHF,0,1,1,1
TRBV18,TRBJ2-7,CASSRGAVTYEQYF,0,1,1,1
TRBV18,TRBJ1-1,CASSTKPMNTEAFF,0,1,1,1
TRBV12-3/4,TRBJ2-1,CASLPGVSYNEQFF,0,1,1,1
TRBV13,TRBJ2-7,CASAGSTRIGEQYF,0,1,1,1
TRBV6-1,TRBJ2-7,CASGKGAPSYEQYF,0,1,1,1
TRBV5-8,TRBJ2-1,CASTDSPAYNEQFF,0,1,1,1
TRBV6-2/3/5/6,TRBJ2-4,CASSSLAEQNIQYF,0,1,1,1
TRBV12-3/4,TRBJ2-7,CASSYGTGAYEQYF,0,1,1,1
TRBV6-2/3/5/6,TRBJ2-7,CASSYSIVGGEQYF,0,1,1,1
TRBV6-1,TRBJ2-1,CASSQQGGNNEQFF,0,1,1,1
TRBV7-8,TRBJ1-5,CASSFPRDFQPQHF,0,1,1,1
TRBV6-2/3/5/6,TRBJ2-7,CASSLGTVTYEQYF,0,1,1,1
TRBV11-2,TRBJ2-7,CASSLWPGTYEQYF,0,1,1,1
TRBV7-8,TRBJ2-3,CASSLQPSTDTQYF,0,1,1,1
TRBV11-2,TRBJ2-5,CASSLDQRGETQYF,0,1,1,1
TRBV11-3,TRBJ1-5,CASSLESGNQPQHF,0,1,1,1
TRBV5-6,TRBJ2-6,CASSWGIGANVLTF,0,1,1,1
TRBV7-6,TRBJ1-2,CASSLGTGIGGYTF,0,1,1,1
TRBV3-1,TRBJ2-3,CASSPRQSTDTQYF,0,1,1,1
TRBV5-4,TRBJ1-4,CASSPAGGNEKLFF,0,2,1,2
TRBV3-1,TRBJ2-1,CASSPGHSYNEQFF,0,1,1,1
TRBV7-6,TRBJ2-2,CASSPDGPAGELFF,0,1,1,1
TRBV14,TRBJ2-7,CASSQPLEGYEQYF,0,1,1,1
TRBV14,TRBJ2-7,CASSQRTGTYEQYF,0,1,1,1
TRBV14,TRBJ1-1,CASSQVRGNTEAFF,0,1,1,1
TRBV7-9,TRBJ2-1,CASSQASGGNEQFF,0,1,1,1
TRBV3-1,TRBJ1-4,CASSQGQVYEKLFF,0,1,1,1
TRBV2,TRBJ2-1,CASSAKGGATEQFF,0,1,1,1
TRBV25-1,TRBJ1-6,CASSEGAYNSPLHF,0,1,1,1
TRBV12-3/4,TRBJ1-2,CASRRKDGKYGYTF,0,1,1,1
TRBV5-1,TRBJ2-1,CASSLGDSYNEQFF,0,1,1,1
TRBV5-1,TRBJ1-1,CASSSGHSNTEAFF,0,1,1,1
TRBV20-1,TRBJ1-5,CSARSGTGAQPQHF,0,1,1,1
TRBV29-1,TRBJ2-4,CSVSQGVVKNIQYF,0,1,1,1
TRBV29-1,TRBJ2-1,CSVDTSGLYNEQFF,0,1,1,1
TRBV10-3,TRBJ2-7,CAMGQGAFGEQYF,0,1,1,1
TRBV24-1,TRBJ2-1,CATSDDRVNEQFF,0,1,1,1
TRBV15,TRBJ2-3,CATSRDLADTQYF,0,1,1,1
TRBV19,TRBJ2-7,CASTREGGYEQYF,0,1,1,1
TRBV28,TRBJ2-1,CASLLRGNNEQFF,0,1,1,1
TRBV7-9,TRBJ2-3,CASHSGLLDTQYF,0,1,1,1
TRBV4-2,TRBJ1-6,CASGPGGDSPLHF,0,1,1,1
TRBV12-3/4,TRBJ2-3,CASSFGRPDTQYF,0,1,1,1
TRBV12-3/4,TRBJ2-7,CASSLSSSYEQYF,0,1,1,1
TRBV6-2/3/5/6,TRBJ2-7,CASSQSGTIQQYF,0,1,1,1
TRBV28,TRBJ2-5,CASSIGPRETQYF,0,1,1,1
TRBV12-3/4,TRBJ1-1,CASSRTGYTEAFF,0,1,1,1
TRBV7-2,TRBJ2-7,CASSLAGVYEQYF,0,1,1,1
TRBV11-3,TRBJ2-3,CASSLGEAPTQYF,0,1,1,1
TRBV5-8,TRBJ1-1,CASSWVEGTEAFF,0,1,1,1
TRBV3-1,TRBJ1-1,CASSLGQNTEAFF,0,1,1,1
TRBV11-2,TRBJ1-5,CASSLTNDQPQHF,0,1,1,1
TRBV3-1,TRBJ1-1,CASSPKRDTEAFF,0,1,1,1
TRBV6-2/3/5/6,TRBJ1-5,CASSPTVQQPQHF,0,1,1,1
TRBV14,TRBJ2-1,CASSRPDLGEQFF,0,1,1,1
TRBV3-1,TRBJ1-1,CASSQGVGTEAFF,0,1,1,1
TRBV3-1,TRBJ2-7,CASSQGTSFEQYF,0,1,1,1
TRBV4-2,TRBJ2-1,CASSQDIASVRFF,0,1,1,1
TRBV7-9,TRBJ1-1,CASSASVGTEAFF,0,1,1,1
TRBV2,TRBJ1-5,CASRTGQYQPQHF,0,1,1,1
TRBV2,TRBJ2-1,CASNPRSYNELFF,0,1,1,1
TRBV2,TRBJ1-1,CASKGGGNTEAFF,0,1,1,1
TRBV5-1,TRBJ2-5,CASSSRGGETQYF,0,1,1,1
TRBV5-1,TRBJ1-2,CASSSGTGFGYTF,0,1,1,1
TRBV5-1,TRBJ1-1,CASSELENTEAFF,0,1,1,1
TRBV20-1,TRBJ1-1,CSAALDGITEAFF,0,1,1,1
TRBV20-1,TRBJ2-5,CSARSSGEETQYF,0,1,1,1
TRBV20-1,TRBJ1-2,CSARDGSTYGYTF,0,1,1,1
TRBV20-1,TRBJ1-4,CSARVGSAEKLFF,0,1,1,1
TRBV29-1,TRBJ1-1,CSVPGRGRTEAFF,0,1,1,1
TRBV29-1,TRBJ2-4,CSVARGAKNIQYF,0,1,1,1
TRBV29-1,TRBJ1-1,CSVGQLLNTEAFF,0,1,1,1
TRBV30,TRBJ2-1,CAWSKGSTGQFF,0,1,1,1
TRBV19,TRBJ2-5,CASGTEWGTQYF,0,1,1,1
TRBV18,TRBJ1-1,CASSRPTGEAFF,0,1,1,1
TRBV7-9,TRBJ1-5,CASCRSNQPQHF,0,1,1,1
TRBV12-3/4,TRBJ1-1,CASSFGGVEAFF,0,1,1,1
TRBV28,TRBJ2-7,CASSLITSGQYF,0,1,1,1
TRBV28,TRBJ2-7,CASSSRGYEQYF,0,1,1,1
TRBV6-1,TRBJ2-3,CASSVVGDTQYF,0,1,1,1
TRBV7-2,TRBJ2-1,CASSFLGAEQFF,0,1,1,1
TRBV11-2,TRBJ2-7,CASSLGGDEQYF,0,1,1,1
TRBV7-6,TRBJ1-1,CASSLDGGLAFF,0,1,1,1
TRBV7-2,TRBJ1-2,CASSSTDYGYTF,0,1,1,1
TRBV12-3/4,TRBJ2-7,CASSPEGYEQYF,0,1,1,1
TRBV12-3/4,TRBJ2-7,CASSPTGNEQYF,0,1,1,1
TRBV11-2,TRBJ1-1,CASSRSSSEAFF,0,1,1,1
TRBV14,TRBJ2-7,CASSHEGYEQYF,0,1,1,1
TRBV3-1,TRBJ2-4,CASSQAGEHQYF,0,1,1,1
TRBV5-6,TRBJ2-3,CASSTIRGRQYF,0,1,1,1
TRBV12-3/4,TRBJ1-5,CASRGRDQPQHF,0,1,1,1
TRBV28,TRBJ2-7,CASKASPYEQYF,0,1,1,1
TRBV5-1,TRBJ2-3,CASSFSPDTQYF,0,1,1,1
TRBV4-1,TRBJ2-1,CASSGSYNEQFF,0,1,1,1
TRBV20-1,TRBJ2-7,CSARRHSYEQYF,0,1,1,1
TRBV20-1,TRBJ2-7,CSARDPGLYETF,0,1,1,1
TRBV29-1,TRBJ2-5,CSVQGAAETQYF,0,1,1,1
TRBV29-1,TRBJ1-5,CSVRTSGQPQHF,0,1,1,1
TRBV29-1,TRBJ1-1,CSALVWDTEAFF,0,1,1,1
TRBV2,TRBJ2-5,CAVGAQETQYF,0,1,1,1
TRBV6-2/3/5/6,TRBJ2-1,CASSYSREKFF,0,1,1,1
TRBV7-2,TRBJ1-1,CASSQLKEAFF,0,1,1,1
TRBV12-3/4,TRBJ2-3,CASRDTDTQYF,0,1,1,1
TRBV29-1,TRBJ2-7,CSVFYSYEQYF,0,1,1,1
TRBV29-1,TRBJ1-2,CSVLEGAGYTF,0,1,1,1
TRBV29-1,TRBJ1-1,CSVELGQMAFF,0,1,1,1
TRBV7-9,TRBJ1-4,CAAGEEKLFF,0,1,1,1
TRBV28,TRBJ1-1,CASKDGEAFF,0,1,1,1
TRBV19,TRBJ2-7,CASSGPPGLELSYEQYF,0,1,1,1
TRBV7-6,TRBJ2-1,CASSRNGDSGNYNEQFF,0,1,1,1
TRBV28,TRBJ2-6,CASSLVPSSGANVLTF,0,1,1,1
TRBV4-2,TRBJ2-1,CASSPSSQRRNEQFF,0,2,1,2
TRBV5-1,TRBJ2-3,CASNLGGPSTDTQYF,0,1,1,1
TRBV20-1,TRBJ2-5,CSAISKGDLQETQYF,0,1,1,1
TRBV6-2/3/5/6,TRBJ2-7,CASSYYPGTYEQYF,0,2,1,2
TRBV25-1,TRBJ2-2,CASRYGMNTGELFF,0,1,1,1
TRBV20-1,TRBJ2-5,CSARADRGLETQYF,0,1,1,1
TRBV5-1,TRBJ1-1,CASSGVRGTEAFF,0,1,1,1
TRBV20-1,TRBJ1-1,CSARDAQGALAFS,0,1,1,1
TRBV10-3,TRBJ2-3,CAISWETGTQYF,0,1,1,1
TRBV12-3/4,TRBJ1-3,CTSGSNGNTIYF,0,1,1,1
TRBV27,TRBJ2-6,CASTVLGVAGATFSGANVLTF,0,1,1,1
TRBV19,TRBJ1-5,CASRAPRGQGPFYSNQPQHF,0,1,1,1
TRBV3-1,TRBJ1-1,CASSQDPRTGDRGLNTEAFF,0,1,1,1
TRBV9,TRBJ1-1,CASSVVPERLGQGPGTEAFF,0,1,1,1
TRBV6-2/3/5/6,TRBJ2-3,CASSFTRARLAGSADTQYF,0,1,1,1
TRBV19,TRBJ2-1,CANRRGLAGGLSSYNEQFF,0,1,1,1
TRBV29-1,TRBJ2-1,CSVEEETGGGMLSYNEQFF,0,2,1,2
TRBV5-8,TRBJ2-7,CASSFPHLGFRKPYEQYF,0,1,1,1
TRBV7-9,TRBJ2-2,CASSLARPASGGTGELFF,0,1,1,1
TRBV11-3,TRBJ2-1,CASSLGFPWNPTYNEQFF,0,1,1,1
TRBV7-2,TRBJ2-6,CASSLDVLGGYGANVLTF,0,1,1,1
TRBV5-1,TRBJ2-4,CASSLGQGDVGAKNIQYF,0,1,1,1
TRBV19,TRBJ2-1,CASSIQLHVSSYNEQFF,0,1,1,1
TRBV19,TRBJ2-1,CASSILSGGLTYNEQFF,0,1,1,1
TRBV18,TRBJ2-6,CASSDFAPSSGANVLTF,0,1,1,1
TRBV6-2/3/5/6,TRBJ1-1,CASSYPTGEGRNTEAFF,0,1,1,1
TRBV12-3/4,TRBJ2-3,CASSQGVGQASTDTQYF,0,1,1,1
TRBV7-2,TRBJ1-2,CASSLVEGQENYYGYTF,0,1,1,1
TRBV5-6,TRBJ2-1,CASSSASRDRGQDEQFF,0,1,1,1
TRBV3-1,TRBJ1-3,CASSRPPDKNSGNTIYF,0,1,1,1
TRBV7-2,TRBJ2-3,CASSRGTSGGPLNTQYF,0,1,1,1
TRBV14,TRBJ2-3,CASSQGPGISRTDTQYF,0,1,1,1
TRBV2,TRBJ2-4,CASRTTTSGLAKNIQYF,0,1,1,1
TRBV5-1,TRBJ2-7,CASSLFPGRMGSYEQYF,0,1,1,1
TRBV20-1,TRBJ1-2,CSATDGGHRPFYYGYTF,0,1,1,1
TRBV29-1,TRBJ2-3,CSVEGAVAGGSTDTQYF,0,1,1,1
TRBV30,TRBJ1-5,CAWSVWDRGNNQPQHF,0,1,1,1
TRBV15,TRBJ2-3,CATSSSERGFTDTQYF,0,1,1,1
TRBV19,TRBJ1-2,CASSIEQPFPNYGYTF,0,1,1,1
TRBV18,TRBJ1-1,CASSPLRTGTNTEAFF,0,1,1,1
TRBV9,TRBJ1-1,CASIGQEVSINTEAFF,0,1,1,1
TRBV27,TRBJ2-1,CASSFWTSGEYNEQFF,0,1,1,1
TRBV11-2,TRBJ2-2,CASSLAASGNTGELFF,0,1,1,1
TRBV6-2/3/5/6,TRBJ1-1,CASSSHSAGIVAEAFF,0,1,1,1
TRBV2,TRBJ2-3,CASSLLAGSSTDTQYF,0,1,1,1
TRBV28,TRBJ2-4,CASSQGAYPKPNIQYF,0,1,1,1
TRBV12-3/4,TRBJ2-3,CASSGDRTTSTDTQYF,0,1,1,1
TRBV5-5,TRBJ2-3,CASSLGQGTRTDTQYF,0,1,1,1
TRBV5-4,TRBJ2-1,CASSLTTLAGGNEQFF,0,1,1,1
TRBV7-9,TRBJ2-1,CASSLVPSGGGNEQFF,0,1,1,1
TRBV7-2,TRBJ2-5,CASSLVGQGATETQYF,0,1,1,1
TRBV7-9,TRBJ1-1,CASSLGPIRGNTEAFF,0,1,1,1
TRBV13,TRBJ2-7,CASSSFLAGGTYEQYF,0,1,1,1
TRBV13,TRBJ2-7,CASSSRTGAITYEQYF,0,1,1,1
TRBV11-1,TRBJ2-1,CASSYLRVSSYDEQFF,0,1,1,1
TRBV6-2/3/5/6,TRBJ1-6,CASSYGWGHDNSPLHF,0,1,1,1
TRBV14,TRBJ2-2,CASSLLRTRFPGELFF,0,1,1,1
TRBV12-3/4,TRBJ2-7,CASSPGQLIATYEQYF,0,1,1,1
TRBV6-2/3/5/6,TRBJ1-6,CASSPPRTDSNSPLHF,0,1,1,1
TRBV5-5,TRBJ2-1,CASSQSPSGGQNEQFF,0,1,1,1
TRBV16,TRBJ1-1,CASSQSAQGQGTEAFF,0,1,1,1
TRBV3-1,TRBJ2-2,CASSQAAGGNTGELFF,0,1,1,1
TRBV14,TRBJ2-7,CASSQGLAGGSYEQYF,0,1,1,1
TRBV9,TRBJ2-7,CASSVASGQGSYEQYF,0,1,1,1
TRBV9,TRBJ2-3,CASSEEQGTNTVTQYF,0,1,1,1
TRBV7-9,TRBJ2-7,CASRRFPDRMTYEQYF,0,1,1,1
TRBV27,TRBJ1-5,CASRDRVNFSNQPQHF,0,1,1,1
TRBV6-2/3/5/6,TRBJ2-7,CASNFYLRQGAGEQYF,0,1,1,1
TRBV6-2/3/5/6,TRBJ2-1,CASKTRTGGKVDEQSF,0,1,1,1
TRBV5-1,TRBJ2-3,CASLLRPGLDTDTQYF,0,1,1,1
TRBV5-1,TRBJ2-3,CASSLGVFPSTDTQYF,0,1,1,1
TRBV4-1,TRBJ2-3,CASSHVDMGFTDTQYF,0,1,1,1
TRBV4-3,TRBJ2-3,CASSQVLGGRTDTQYF,0,1,1,1
TRBV20-1,TRBJ2-1,CSARSGLAGGYNEQFF,0,1,1,1
TRBV20-1,TRBJ1-6,CSARDMGQGGNSPLHF,0,1,1,1
TRBV30,TRBJ1-1,CAWTAVSGRNTEAFF,0,1,1,1
TRBV30,TRBJ1-1,CAWSSGTGWITEAFF,0,1,1,1
TRBV30,TRBJ2-5,CAWSRVAGGQETQYF,0,1,1,1
TRBV2,TRBJ2-3,CATGQGGRSTDTQYF,0,1,1,1
TRBV24-1,TRBJ2-3,CATSDVGTSTDTQYF,0,1,1,1
TRBV15,TRBJ2-3,CATSPSGASTDTQYF,0,1,1,1
TRBV15,TRBJ2-2,CATSRGLTNTGELFF,0,1,1,1
TRBV19,TRBJ1-5,CASSIGTVYGQPQHF,0,1,1,1
TRBV18,TRBJ1-5,CASSPGTGANQPQHF,0,1,1,1
TRBV18,TRBJ1-1,CASSPGTGGISEAFF,0,1,1,1
TRBV28,TRBJ2-7,CASTPAGPAWAEQYF,0,1,1,1
TRBV12-3/4,TRBJ2-2,CASTRAGENTGELFF,0,1,1,1
TRBV12-3/4,TRBJ2-4,CASSFGGGGVDIQYF,0,1,1,1
TRBV6-2/3/5/6,TRBJ1-1,CASSFYTGGGTEAFF,0,1,1,1
TRBV6-2/3/5/6,TRBJ1-5,CASSLGGGTNQPQHF,0,1,1,1
TRBV12-3/4,TRBJ2-3,CASSLMTGGTDTQYF,0,1,1,1
TRBV28,TRBJ2-2,CASSLFKGATGELFF,0,1,1,1
TRBV27,TRBJ2-3,CASSLGLWGTDTQYF,0,1,1,1
TRBV28,TRBJ2-1,CASSLEGAFYNEQFF,0,1,1,1
TRBV12-3/4,TRBJ1-5,CASSLTSSGNQPQHF,0,1,1,1
TRBV28,TRBJ2-3,CASSSRRAATDTQYF,0,1,1,1
TRBV27,TRBJ2-3,CASSSGTTSTDTQYF,0,1,1,1
TRBV12-3/4,TRBJ2-3,CASSLSGGLTDTLYF,0,1,1,1
TRBV27,TRBJ2-7,CASSLQGRASYEQYF,0,1,1,1
TRBV12-3/4,TRBJ2-3,CASSPQGQNTDTQYF,0,1,1,1
TRBV6-2/3/5/6,TRBJ1-1,CASSPSDRGKNEAFF,0,1,1,1
TRBV6-1,TRBJ1-1,CASSAGTGGSAEAFF,0,1,1,1
TRBV2,TRBJ2-1,CASSEERGPYNEQFF,0,1,1,1
TRBV6-1,TRBJ2-2,CASSEEGLSAGELFF,0,1,1,1
TRBV5-6,TRBJ2-3,CASSLARREPDTQYF,0,1,1,1
TRBV5-6,TRBJ1-5,CASSLGRASNQPQHF,0,1,1,1
TRBV7-2,TRBJ2-3,CASSLLASSTDTQYF,0,1,1,1
TRBV7-9,TRBJ1-1,CASSLDAQPNTEAFF,0,1,1,1
TRBV7-2,TRBJ2-5,CASSLDGGGAETQYF,0,1,1,1
TRBV7-6,TRBJ2-1,CASSLEGLAFNEQFF,0,1,1,1
TRBV7-3,TRBJ1-1,CASSLMGRGDTEAFF,0,1,1,1
TRBV7-2,TRBJ2-5,CASSLTISQKETQYF,0,1,1,1
TRBV7-3,TRBJ2-3,CASSSPGLGTDTQYF,0,1,1,1
TRBV7-9,TRBJ1-5,CASSSGNGFNQPQHF,0,1,1,1
TRBV5-6,TRBJ1-1,CASSLGARSVTEAFF,0,1,1,1
TRBV4-2,TRBJ1-1,CASSLVGGLNTEAFF,0,1,1,1
TRBV3-1,TRBJ2-1,CASSLSGGASPEQFF,0,1,1,1
TRBV4-2,TRBJ1-2,CASSPEGGGFYGYTF,0,1,1,1
TRBV9,TRBJ1-1,CASSPTLGLETEAFF,0,1,1,1
TRBV7-3,TRBJ2-2,CASSPATGIVGELFF,0,1,1,1
TRBV3-1,TRBJ2-1,CASSPTSIAGEEQFF,0,1,1,1
TRBV3-1,TRBJ1-4,CASSPTSGTNEKLFF,0,1,1,1
TRBV3-1,TRBJ2-5,CASSRAGGPQETQYF,0,1,1,1
TRBV16,TRBJ1-6,CASSQLTGSVSALHF,0,1,1,1
TRBV14,TRBJ2-7,CASSQVGDRAYEQYF,0,1,1,1
TRBV6-2/3/5/6,TRBJ2-1,CASSAQGASYNEQFF,0,1,1,1
TRBV11-3,TRBJ2-1,CASSTRDSGGDEQFF,0,1,1,1
TRBV6-2/3/5/6,TRBJ2-2,CASSRTGSVTGELFF,0,1,1,1
TRBV2,TRBJ1-2,CASRRQLFGNYGYTF,0,1,1,1
TRBV6-2/3/5/6,TRBJ2-1,CASRASGGAYNEQSF,0,1,1,1
TRBV10-1,TRBJ2-7,CASSEKAVPSYEQYF,0,1,1,1
TRBV5-1,TRBJ2-5,CASSLSLVYQETQYF,0,1,1,1
TRBV5-1,TRBJ2-7,CASSPQTGITKEQYF,0,1,1,1
TRBV5-1,TRBJ2-7,CASSRDPWIAYEQYF,0,1,1,1
TRBV4-3,TRBJ2-1,CASSHSGTGANEQFF,0,1,1,1
TRBV5-1,TRBJ1-2,CASSQGHAWTDGYTF,0,1,1,1
TRBV5-1,TRBJ2-1,CASSKTSGGVVEQFF,0,1,1,1
TRBV10-1,TRBJ2-2,CASRPGTANTGELFF,0,1,1,1
TRBV20-1,TRBJ2-7,CSARRPGQGVDEQYF,0,1,1,1
TRBV20-1,TRBJ2-1,CSASIIGTPHNEQFF,0,1,1,1
TRBV20-1,TRBJ1-4,CSASFRDRGVEKLFF,0,1,1,1
TRBV20-1,TRBJ2-2,CSASPLAGGGGELFF,0,1,1,1
TRBV20-1,TRBJ2-2,CSARSSDRVPGELFF,0,1,1,1
TRBV20-1,TRBJ2-7,CSARAGTGVVGEQYF,0,1,1,1
TRBV20-1,TRBJ1-2,CSARDQAARGPGYTF,0,1,1,1
TRBV20-1,TRBJ2-1,CSAILTRGSYNEQFF,0,1,1,1
TRBV29-1,TRBJ2-5,CSVATSGGVRETQYF,0,1,1,1
TRBV7-3,TRBJ1-2,RASSTNWGGRRGYTF,0,1,1,1
TRBV30,TRBJ1-5,CAWSVATSNQPQHF,0,1,1,1
TRBV19,TRBJ1-1,CASMLTGFDTEAFF,0,1,1,1
TRBV19,TRBJ1-1,CASTPALIGTEAFF,0,1,1,1
TRBV19,TRBJ2-4,CASSLTSRKNIQYF,0,2,1,2
TRBV19,TRBJ2-7,CASSATGGPYEQYF,0,1,1,1
TRBV19,TRBJ1-1,CASSPFYRDTEAFF,0,1,1,1
TRBV19,TRBJ2-2,CASRDGRNTGELFF,0,1,1,1
TRBV18,TRBJ1-5,CASSPVGQGQPQHF,0,1,1,1
TRBV18,TRBJ2-5,CASSPGHRQETQYF,0,1,1,1
TRBV5-5,TRBJ2-5,CASPSLIEGETQYF,0,1,1,1
TRBV7-6,TRBJ2-2,CASIPMGNTGELFF,0,1,1,1
TRBV12-3/4,TRBJ1-6,CASSFWTGDSPLHF,0,1,1,1
TRBV12-3/4,TRBJ1-6,CASSLEQGRSPLHF,0,1,1,1
TRBV27,TRBJ2-1,CASSLRDREDEQFF,0,1,1,1
TRBV6-2/3/5/6,TRBJ2-7,CASSSAGRAYEQYF,0,1,1,1
TRBV6-2/3/5/6,TRBJ2-7,CASSYTGSSYEQYF,0,1,1,1
TRBV6-2/3/5/6,TRBJ2-4,CASSYRGPRDIQYF,0,1,1,1
TRBV6-2/3/5/6,TRBJ2-7,CASSPGQAREEQYF,0,1,1,1
TRBV2,TRBJ1-1,CASSATAMNTEAFF,0,1,1,1
TRBV6-1,TRBJ2-5,CASSEGLLRETQYF,0,1,1,1
TRBV6-1,TRBJ2-1,CASSEGQDYNEQFF,0,1,1,1
TRBV6-2/3/5/6,TRBJ2-5,CASSRDSHQETQYF,0,1,1,1
TRBV6-2/3/5/6,TRBJ2-2,CASSFYRDTGELFF,0,1,1,1
TRBV7-2,TRBJ1-2,CASSLLGRDYGYTF,0,1,1,1
TRBV11-2,TRBJ2-3,CASSLVVYTDTQYF,0,1,1,1
TRBV7-2,TRBJ2-1,CASSLGRGKNEQFF,0,1,1,1
TRBV7-8,TRBJ1-4,CASSLGRRNEKLFF,0,1,1,1
TRBV11-3,TRBJ2-1,CASSLRDISTEQFF,0,1,1,1
TRBV7-8,TRBJ2-1,CASSSMGHYNEQFF,0,1,1,1
TRBV5-4,TRBJ2-1,CASSSTSGGYEQFF,0,1,1,1
TRBV5-5,TRBJ2-5,CASSSTANQETQYF,0,1,1,1
TRBV3-1,TRBJ1-4,CASSPVGTGEKLFF,0,1,1,1
TRBV7-2,TRBJ1-5,CASSPAGPTQPQHF,0,1,1,1
TRBV6-2/3/5/6,TRBJ1-2,CASSPGSSDYGYTF,0,1,1,1
TRBV7-9,TRBJ2-2,CASSPTGVTGELFF,0,1,1,1
TRBV7-9,TRBJ2-5,CASSPSGTGGTQYF,0,2,1,2
TRBV5-6,TRBJ2-3,CASSPRGITDTQYF,0,1,1,1
TRBV7-2,TRBJ2-3,CASSRQGVGDTQYF,0,1,1,1
TRBV12-3/4,TRBJ1-6,CASSHSGANSPLHF,0,1,1,1
TRBV6-2/3/5/6,TRBJ2-3,CASSHRQGTDTQYF,0,1,1,1
TRBV3-1,TRBJ2-4,CASSQGGSKNIQYF,0,1,1,1
TRBV4-2,TRBJ2-3,CASSQDAGADTQYF,0,1,1,1
TRBV7-2,TRBJ2-1,CASSQTSIYNEQFF,0,1,1,1
TRBV9,TRBJ2-7,CASSVDGGYYEQYF,0,1,1,1
TRBV5-4,TRBJ1-6,CASSGGTGFSPLHF,0,1,1,1
TRBV5-6,TRBJ2-7,CASSGGTGLYEQYF,0,1,1,1
TRBV6-2/3/5/6,TRBJ1-2,CASSRGDRAAAVAF,0,1,1,1
TRBV4-2,TRBJ2-7,CASRRDFQTYEQYF,0,1,1,1
TRBV6-2/3/5/6,TRBJ1-3,CASRQGSGGNTIYF,0,1,1,1
TRBV6-2/3/5/6,TRBJ1-1,CGSRYRVPSTEAFF,0,1,1,1
TRBV10-2,TRBJ2-1,CASGTGITNNEQFF,0,1,1,1
TRBV10-2,TRBJ2-3,CASTLAGGADTQYF,0,1,1,1
TRBV5-1,TRBJ2-3,CASSLWQGSDTQYF,0,1,1,1
TRBV5-1,TRBJ2-7,CASSLGQLVDEQYF,0,2,1,2
TRBV5-1,TRBJ2-3,CASSLSQGTDTQYF,0,1,1,1
TRBV5-1,TRBJ1-2,CASSPPSNQDGYTF,0,1,1,1
TRBV20-1,TRBJ2-4,CSPWDRGLGNIQYF,0,1,1,1
TRBV20-1,TRBJ2-3,CSADKAESTDTQYF,0,1,1,1
TRBV20-1,TRBJ2-3,CSARVQGALNTQYF,0,1,1,1
TRBV20-1,TRBJ2-7,CSADIGGSGYEKYF,0,1,1,1
TRBV29-1,TRBJ1-3,CSVVLPDSGNTIYF,0,1,1,1
TRBV29-1,TRBJ1-1,CSVAPGQANTEAFF,0,1,1,1
TRBV29-1,TRBJ2-3,CSVAGAGNTDTQYF,0,1,1,1
TRBV29-1,TRBJ2-2,CSVGDRVLAGELFF,0,1,1,1
TRBV29-1,TRBJ1-1,CSVERTGVKSEAFF,0,1,1,1
TRBV29-1,TRBJ1-1,CSANAGISNTEAFF,0,1,1,1
TRBV6-2/3/5/6,TRBJ2-2,RASSTEQWAGELFF,0,1,1,1
TRBV30,TRBJ2-7,CAWSRNRASEQYF,0,1,1,1
TRBV2,TRBJ1-6,CARQGAGDSPLHF,0,1,1,1
TRBV10-3,TRBJ2-1,CAISDWLNNEQFF,0,1,1,1
TRBV24-1,TRBJ2-1,CATSPGGAEEQFF,0,1,1,1
TRBV15,TRBJ2-7,CATSRDLPYEQYF,0,1,1,1
TRBV15,TRBJ2-5,CATSRDLGETQYF,0,1,1,1
TRBV2,TRBJ1-4,CASEWRQAEKLFF,0,1,1,1
TRBV19,TRBJ2-7,CASSMGQGREQYF,0,1,1,1
TRBV19,TRBJ2-3,CASNQRGLDTQYF,0,1,1,1
TRBV18,TRBJ1-2,CASSRTVLDGYTF,0,1,1,1
TRBV18,TRBJ2-5,CASSPSRGETQYF,0,1,1,1
TRBV2,TRBJ1-1,CASRREAPTEAFF,0,1,1,1
TRBV2,TRBJ1-5,CASDGQSNQPQHF,0,2,1,2
TRBV12-3/4,TRBJ1-5,CASTWGRGQPQHF,0,1,1,1
TRBV7-2,TRBJ2-1,CASTLKRGGEQFF,0,1,1,1
TRBV6-2/3/5/6,TRBJ2-7,CASSFAGGYEQYF,0,1,1,1
TRBV27,TRBJ2-7,CASSLPGSYEQYF,0,1,1,1
TRBV6-2/3/5/6,TRBJ2-1,CASSLAGGNEQFF,0,1,1,1
TRBV6-2/3/5/6,TRBJ1-2,CASSLGDYYGYTF,0,1,1,1
TRBV6-2/3/5/6,TRBJ1-5,CASSYGRGQPQHF,0,1,1,1
TRBV6-2/3/5/6,TRBJ1-5,CASSYTDNQPQHF,0,1,1,1
TRBV6-1,TRBJ1-2,CASSESGIQGYTF,0,1,1,1
TRBV11-2,TRBJ1-1,CASSFLRNTEAFF,0,1,1,1
TRBV3-1,TRBJ2-5,CASSFTHEETQYF,0,1,1,1
TRBV7-9,TRBJ1-1,CASSFNAMDEAFF,0,1,1,1
TRBV5-6,TRBJ2-7,CASSLDQAYEQYF,0,1,1,1
TRBV5-6,TRBJ2-1,CASSLTGRNEQFF,0,1,1,1
TRBV11-3,TRBJ1-2,CASSLDRGYGYTF,0,1,1,1
TRBV7-2,TRBJ2-7,CASSSREVYEQYF,0,1,1,1
TRBV7-2,TRBJ2-5,CASSSPGEETQYF,0,1,1,1
TRBV3-1,TRBJ1-1,CASSLRPVTEAFF,0,1,1,1
TRBV28,TRBJ2-3,CASSLPSSDTQYF,0,1,1,1
TRBV7-8,TRBJ2-7,CASSPQNRGEQYF,0,1,1,1
TRBV5-6,TRBJ1-3,CASSPGTGNTIYF,0,1,1,1
TRBV14,TRBJ2-7,CASSRDRGREQYF,0,1,1,1
TRBV14,TRBJ1-1,CASSQMGMTEAFF,0,1,1,1
TRBV7-9,TRBJ1-5,CASSGAGNQPQHF,0,1,1,1
TRBV5-4,TRBJ2-7,CASSGQVTYEQYF,0,1,1,1
TRBV5-4,TRBJ1-1,CASSIGQGAEAFF,0,1,1,1
TRBV7-3,TRBJ1-1,CASSITRNTEAFF,0,1,1,1
TRBV6-4,TRBJ1-1,CASSKRQSTEAFF,0,1,1,1
TRBV6-2/3/5/6,TRBJ1-1,CASRGQGASEAFF,0,1,1,1
TRBV28,TRBJ2-7,CASRPATLSEQYF,0,1,1,1
TRBV25-1,TRBJ2-3,CASNRDRTDTQYF,0,1,1,1
TRBV12-3/4,TRBJ1-1,CASKPGVNTEAFF,0,1,1,1
TRBV10-1,TRBJ2-7,CATGPRLSYEQYF,0,1,1,1
TRBV5-1,TRBJ2-2,CASSLSGTGELFF,0,1,1,1
TRBV4-3,TRBJ1-1,CASSPGGDTEAFF,0,1,1,1
TRBV20-1,TRBJ2-3,CSAFRDREDTQYF,0,1,1,1
TRBV20-1,TRBJ2-1,CSARSGARIEQFF,0,1,1,1
TRBV20-1,TRBJ1-5,CSAGGVFDQPQHF,0,1,1,1
TRBV20-1,TRBJ1-2,CSARPQDNYGYTF,0,1,1,1
TRBV29-1,TRBJ2-4,CSVVKGAKNIQYF,0,1,1,1
TRBV29-1,TRBJ1-4,CSVGRQTNEKLFF,0,1,1,1
TRBV29-1,TRBJ1-5,CSVIGQGGQPQHF,0,1,1,1
TRBV29-1,TRBJ1-2,CSVPTGANYGYTF,0,1,1,1
TRBV29-1,TRBJ1-2,CSVVTGTGGGYTF,0,1,1,1
TRBV29-1,TRBJ1-5,CSVTLGGNQPQHF,0,1,1,1
TRBV29-1,TRBJ1-5,CSASTGFNQPQHF,0,1,1,1
TRBV12-5,TRBJ2-1,CASGRPWGEQFF,0,1,1,1
TRBV19,TRBJ1-2,CASSDSKDGYTF,0,1,1,1
TRBV19,TRBJ1-1,CASRNRGAEAFF,0,1,1,1
TRBV18,TRBJ1-4,CASSSTGEKLFF,0,1,1,1
TRBV14,TRBJ1-2,CASSRANYGYTF,0,1,1,1
TRBV6-2/3/5/6,TRBJ1-1,CASCRSNTEAFF,0,1,1,1
TRBV6-2/3/5/6,TRBJ2-7,CASLQGLNEQYF,0,1,1,1
TRBV7-2,TRBJ2-1,CASIRLVGEQFF,0,1,1,1
TRBV12-3/4,TRBJ1-1,CASTKDNTEAFF,0,1,1,1
TRBV12-3/4,TRBJ1-2,CASSLDRDGYTF,0,1,1,1
TRBV12-3/4,TRBJ1-6,CASSLSYSPLHF,0,1,1,1
TRBV5-4,TRBJ2-7,CASSFLFTEQYF,0,1,1,1
TRBV11-2,TRBJ2-1,CASSFGLVEQFF,0,1,1,1
TRBV7-9,TRBJ1-6,CASSLTPSPLHF,0,1,1,1
TRBV7-9,TRBJ1-1,CASSHGTDGAFF,0,1,1,1
TRBV13,TRBJ2-1,CASSHRGAEQFF,0,1,1,1
TRBV7-9,TRBJ1-2,CASSKRDYGYTF,0,2,1,2
TRBV12-3/4,TRBJ1-2,CASRGDGTGYTF,0,1,1,1
TRBV12-3/4,TRBJ1-5,CASRRQMEPQHF,0,1,1,1
TRBV3-1,TRBJ2-7,CASRGGGGEQYF,0,1,1,1
TRBV5-1,TRBJ2-3,CASSSNTDTQYF,0,1,1,1
TRBV5-1,TRBJ2-7,CASSLDRYEQYF,0,1,1,1
TRBV4-3,TRBJ2-1,CASSQGGGPQFF,0,1,1,1
TRBV20-1,TRBJ2-3,CSAPQGPDTQYF,0,1,1,1
TRBV20-1,TRBJ2-1,CSAGPSGNEQFF,0,1,1,1
TRBV20-1,TRBJ2-1,CSARLAGALEFF,0,1,1,1
TRBV20-1,TRBJ2-7,CSADDRGRQQYF,0,1,1,1
TRBV29-1,TRBJ2-7,CSVVGDYYEQYF,0,1,1,1
TRBV29-1,TRBJ1-2,CSVDPDGGLPRF,0,1,1,1
TRBV29-1,TRBJ2-1,CSVPGGPSEQFF,0,1,1,1
TRBV29-1,TRBJ1-1,CSVNDPGGEAFF,0,1,1,1
TRBV20-1,TRBJ2-1,CSADRGDNEQFF,0,1,1,1
TRBV29-1,TRBJ1-1,CSGQGARTEAFF,0,1,1,1
TRBV12-3/4,TRBJ2-1,CSSSLGAVQFF,0,1,1,1
TRBV19,TRBJ2-7,CASSTYREQYF,0,1,1,1
TRBV2,TRBJ2-7,CASATDYEQYF,0,1,1,1
TRBV27,TRBJ2-4,CASTRGNIQYF,0,1,1,1
TRBV6-2/3/5/6,TRBJ2-7,CASSHSYEQYF,0,1,1,1
TRBV7-2,TRBJ1-2,CASSLTGGYTF,0,1,1,1
TRBV4-2,TRBJ1-2,CASSRDYGYTF,0,1,1,1
TRBV7-9,TRBJ2-7,CASSHRYEQYF,0,1,1,1
TRBV5-1,TRBJ2-7,CASSSNYEQYF,0,1,1,1
TRBV29-1,TRBJ2-5,CSVDAPGNPGF,0,1,1,1
TRBV29-1,TRBJ1-1,CSVRMNTEAFF,0,1,1,1
TRBV29-1,TRBJ1-2,CSVDYGYTF,0,1,1,1
TRBV30,TRBJ1-2,CAWSPPREGARGYGCTF,0,1,1,1
TRBV4-1,TRBJ2-1,CASSQTFRGQGEGEQFF,0,1,1,1
TRBV27,TRBJ2-3,CASSTSSAGSTDTQYF,0,2,1,2
TRBV29-1,TRBJ2-5,CSVEDPKQGSQETQYF,0,1,1,1
TRBV5-1,TRBJ2-2,CASREWASDTGELFF,0,1,1,1
TRBV20-1,TRBJ1-1,CSARPGPGDTEAFF,0,1,1,1
TRBV7-2,TRBJ2-6,CASSLQVVTGTGGSTSGANVLTF,0,1,1,1
TRBV7-3,TRBJ2-2,RASSLTSTGTSDGGMGTGELFF,0,1,1,1
TRBV5-1,TRBJ2-1,CASSSDTSSGGLRQSYNEQFF,0,1,1,1
TRBV6-1,TRBJ1-5,CASSDSGGRLGAWGNQPQHF,0,1,1,1
TRBV4-1,TRBJ2-1,CASRGYLGTSGESSYNEQFF,0,1,1,1
TRBV6-2/3/5/6,TRBJ1-5,CASSLCRPGPGSSNQPQHF,0,1,1,1
TRBV5-1,TRBJ2-6,CASSPDRGPGLRGANVLTF,0,1,1,1
TRBV19,TRBJ2-1,CASSIGFVGTGVYNEQFF,0,1,1,1
TRBV19,TRBJ1-3,CASSIDQSGTSSGNTIYF,0,1,1,1
TRBV19,TRBJ2-3,CASRANRGRKGGTDTQYF,0,1,1,1
TRBV28,TRBJ2-7,CASSFTPFRDRGLNEQYF,0,1,1,1
TRBV12-3/4,TRBJ2-1,CASSSGVIGRVIYNEQFF,0,1,1,1
TRBV6-2/3/5/6,TRBJ2-7,CASSYSIGAGQGTYEQYF,0,1,1,1
TRBV11-2,TRBJ2-3,CASSSLPSSFPITDTQYF,0,1,1,1
TRBV5-5,TRBJ2-1,CASSGQGETGGSYNEQFF,0,1,1,1
TRBV14,TRBJ2-1,CASSKWTGGTRSYNEQFF,0,1,1,1
TRBV5-4,TRBJ2-6,CAGSPSWGLAGANVLTF,0,1,1,1
TRBV28,TRBJ2-2,CASSSRAGGLKAGELFF,0,1,1,1
TRBV27,TRBJ1-2,CASSSQGGGHKGYGYTF,0,1,1,1
TRBV28,TRBJ1-3,CASSPPPGRTPGNTIYF,0,1,1,1
TRBV6-2/3/5/6,TRBJ2-1,CASSPLAGGMTNNEQFF,0,1,1,1
TRBV6-2/3/5/6,TRBJ2-1,CASSPAGGAGLWNEQFF,0,1,1,1
TRBV6-2/3/5/6,TRBJ1-6,CASSRVSPGQGTSPLHF,0,1,1,1
TRBV7-9,TRBJ2-1,CASSLRLAGNPYNEQFF,0,1,1,1
TRBV7-2,TRBJ2-7,CASSLVRAGGHSYEQYF,0,1,1,1
TRBV11-3,TRBJ1-3,CASSLDGWRSSGNTIYF,0,1,1,1
TRBV7-2,TRBJ2-5,CASSLEPYGTRQETQYF,0,1,1,1
TRBV11-2,TRBJ2-5,CASSLGTSGGVQETQYF,0,1,1,1
TRBV12-3/4,TRBJ2-3,CASSRPVGLLTTDTQYF,0,1,1,1
TRBV5-1,TRBJ1-3,CASSLAGGTVSGNTIYF,0,1,1,1
TRBV5-1,TRBJ2-6,CASSLGGQASGANVLTF,0,1,1,1
TRBV4-3,TRBJ2-1,CASSHATGTSGGSGQFF,0,1,1,1
TRBV4-3,TRBJ1-1,CASSQVRPGARNTEAFF,0,1,1,1
TRBV20-1,TRBJ2-3,CSARRLAGTTAIDTQYF,0,1,1,1
TRBV20-1,TRBJ2-3,CSARNSWRGVSTDTQYF,0,1,1,1
TRBV3-1,TRBJ1-2,CVSSQLTGGGGYGYTF,0,1,1,1
TRBV30,TRBJ2-1,CAWSPGMGGFCNEQFF,0,1,1,1
TRBV15,TRBJ2-2,CATSRGTGAHTGELFF,0,1,1,1
TRBV19,TRBJ1-5,CASSIPTGGPNQPQHF,0,1,1,1
TRBV19,TRBJ1-2,CASSIPGRDTVYGYTF,0,1,1,1
TRBV19,TRBJ2-6,CASSIDPLGVANVLTF,0,1,1,1
TRBV5-4,TRBJ1-2,CASSRAGLRRDYGYTF,0,1,1,1
TRBV18,TRBJ1-1,CASSPEFGKGYTEAFF,0,1,1,1
TRBV28,TRBJ1-5,CASRVGTAGSNQPQHF,0,1,1,1
TRBV6-2/3/5/6,TRBJ2-1,CASSSEGLAGDNERFF,0,1,1,1
TRBV12-3/4,TRBJ2-3,CASSSPPRGGIDTQYF,0,1,1,1
TRBV6-2/3/5/6,TRBJ2-5,CASSYSGLAGQETQYF,0,1,1,1
TRBV12-3/4,TRBJ2-2,CASSYPGRDATGELFF,0,1,1,1
TRBV6-2/3/5/6,TRBJ2-3,CASSYRTSGVPDTQYF,0,1,1,1
TRBV6-2/3/5/6,TRBJ1-5,CASSYAGPYSNQPRHF,0,1,1,1
TRBV6-2/3/5/6,TRBJ2-3,CASSPPSGRGTDTQYF,0,1,1,1
TRBV6-2/3/5/6,TRBJ1-4,CASSPSRSGQGEKLFF,0,1,1,1
TRBV6-4,TRBJ2-1,CASSGAGTGVYNEQFF,0,1,1,1
TRBV27,TRBJ1-6,CASSTETARYNSPLHF,0,1,1,1
TRBV6-2/3/5/6,TRBJ2-1,CASSRDRGYSYNEQSF,0,1,1,1
TRBV7-9,TRBJ1-2,CASSLSLSTGNYGYTF,0,1,1,1
TRBV7-8,TRBJ2-3,CASSLVTSGSTDTQYF,0,1,1,1
TRBV7-9,TRBJ2-3,CASSLAGTGRTDTQYF,0,1,1,1
TRBV7-2,TRBJ2-5,CASSLGSSGRQETQYF,0,1,1,1
TRBV7-2,TRBJ2-1,CASSLGLAGGYNKQFF,0,1,1,1
TRBV11-2,TRBJ2-1,CASSLEGPWGDNEQFF,0,1,1,1
TRBV11-3,TRBJ2-2,CASSLERTEVTGELFF,0,1,1,1
TRBV7-2,TRBJ2-2,CASSLTAGGNTGELFF,0,1,1,1
TRBV7-3,TRBJ1-1,CASSSGGRPGDTEAFF,0,1,1,1
TRBV7-9,TRBJ2-7,CASSYPRGGGSYEQYF,0,1,1,1
TRBV7-9,TRBJ2-1,CASSLSMSVGAGEQFF,0,1,1,1
TRBV7-9,TRBJ2-7,CASSPWTGAKAYEQYF,0,1,1,1
TRBV3-1,TRBJ2-7,CASSPLSGQGRYEQYF,0,1,1,1
TRBV14,TRBJ2-1,CASSPQRWSSYNEQFF,0,1,1,1
TRBV3-1,TRBJ2-1,CASSQVGSGSYNEQFF,0,1,1,1
TRBV3-1,TRBJ2-4,CASSQGVAGGINIQYF,0,1,1,1
TRBV3-1,TRBJ1-3,CASSQGETGSRNTIYF,0,1,1,1
TRBV4-2,TRBJ2-1,CASSQGGGDRANEQFF,0,1,1,1
TRBV7-2,TRBJ2-5,CASSQGTSGGQETQYF,0,1,1,1
TRBV4-2,TRBJ2-3,CASSQDLGGGADTQYS,0,1,1,1
TRBV14,TRBJ2-2,CASSQEARGVLGELFF,0,1,1,1
TRBV9,TRBJ1-3,CASSADPRGAGNTIYF,0,1,1,1
TRBV5-5,TRBJ2-3,CASSELAGARIDTQYF,0,1,1,1
TRBV5-8,TRBJ2-5,CASSEGLAGGFETQYF,0,1,1,1
TRBV12-3/4,TRBJ1-1,CASRSQGRLMNTEAFF,0,1,1,1
TRBV6-4,TRBJ2-3,CASRDWTGPTTDTQYF,0,1,1,1
TRBV19,TRBJ2-5,CASKSLGLASDETQYF,0,1,1,1
TRBV5-1,TRBJ2-2,CACSLAGVRVNGELFF,0,1,1,1
TRBV10-1,TRBJ2-2,CASSSRLAGGTGELFF,0,1,1,1
TRBV5-1,TRBJ2-1,CASSLAFGGGYNEQFF,0,1,1,1
TRBV5-1,TRBJ1-4,CASSLAPPGVNEKLVF,0,1,1,1
TRBV5-1,TRBJ2-1,CASSLAGGRGYNEQFF,0,1,1,1
TRBV5-1,TRBJ2-1,CASSLGVRGGVNEQFF,0,1,1,1
TRBV5-1,TRBJ2-3,CASSRDGTNPTDTQYF,0,1,1,1
TRBV5-1,TRBJ2-3,CASSISGGTSTDTQYF,0,1,1,1
TRBV20-1,TRBJ2-1,CSAERQTGIQPNEQFF,0,1,1,1
TRBV29-1,TRBJ2-7,CSVRGSVRGSSYEQYF,0,1,1,1
TRBV30,TRBJ2-3,CAWSVGQGGTDTQYF,0,1,1,1
TRBV30,TRBJ1-5,CAWSVGGANSQPQHY,0,1,1,1
TRBV30,TRBJ2-1,CAWSMTGGLYNEQFF,0,1,1,1
TRBV30,TRBJ2-3,CAWSTGSVGADTQYF,0,1,1,1
TRBV3-1,TRBJ2-7,CAGSQGETTAGEQYF,0,1,1,1
TRBV10-3,TRBJ2-1,CAISEEASSYNEQFF,0,1,1,1
TRBV10-3,TRBJ2-3,CAISESGGDTDTQYF,0,1,1,1
TRBV24-1,TRBJ2-3,CATSVQGHDGDTQYF,0,1,1,1
TRBV24-1,TRBJ2-1,CATSDGGQGYNEQFF,0,1,1,1
TRBV15,TRBJ2-7,CATRRNLDRANEQYF,0,1,1,1
TRBV5-6,TRBJ1-5,CASHRQGAPGQPQHF,0,1,1,1
TRBV25-1,TRBJ1-5,CASSESPTVNQPQHF,0,1,1,1
TRBV19,TRBJ2-7,CASSTGKDSSYEQYF,0,1,1,1
TRBV19,TRBJ2-3,CASRLEGQGSDTQYF,0,1,1,1
TRBV18,TRBJ2-3,CASSPTGIWTDTQYF,0,1,1,1
TRBV18,TRBJ2-3,CASSLERPGTDTQYF,0,1,1,1
TRBV18,TRBJ1-1,CASSLGQGGNTEAFF,0,1,1,1
TRBV18,TRBJ2-7,CASSPRSGTRNEQYF,0,1,1,1
TRBV18,TRBJ2-2,CASAPRIANTGELFF,0,1,1,1
TRBV7-2,TRBJ2-1,CASIDPHLASHEQFF,0,1,1,1
TRBV6-2/3/5/6,TRBJ1-5,CASSFNRGYNQPQHF,0,1,1,1
TRBV28,TRBJ1-1,CASSLDRGRGTEAFF,0,1,1,1
TRBV27,TRBJ1-1,CASSLSFGQNTEAFF,0,1,1,1
TRBV28,TRBJ2-5,CASSLSVRLRGFQYF,0,1,1,1
TRBV12-3/4,TRBJ2-1,CASSLGAGVSGEQFF,0,1,1,1
TRBV12-3/4,TRBJ1-5,CASSSPGGTAQPQHF,0,1,1,1
TRBV6-2/3/5/6,TRBJ1-2,CASSSRDNPNYGYTF,0,1,1,1
TRBV6-2/3/5/6,TRBJ1-1,CASSYSLSGRTEAFF,0,1,1,1
TRBV6-2/3/5/6,TRBJ2-5,CASSYSDTNQETQYF,0,1,1,1
TRBV6-2/3/5/6,TRBJ1-5,CASSYDRALGQPQHF,0,1,1,1
TRBV6-2/3/5/6,TRBJ2-5,CASSPRGGQGKTQYF,0,1,1,1
TRBV12-3/4,TRBJ1-1,CASSPGWGSSTEAFF,0,1,1,1
TRBV11-2,TRBJ2-1,CASSRSGGVQDEQFF,0,1,1,1
TRBV6-1,TRBJ1-5,CASSQPGQGNKPQHF,0,1,1,1
TRBV12-3/4,TRBJ2-1,CASSIRQGTENEQFF,0,1,1,1
TRBV27,TRBJ2-5,CASSTRLAGGETQYF,0,1,1,1
TRBV28,TRBJ2-6,CASSTGSWGANVLTF,0,1,1,1
TRBV11-2,TRBJ2-1,CASSTTGRRYNEQFF,0,1,1,1
TRBV3-1,TRBJ2-1,CASSNPRGPYNEQFF,0,1,1,1
TRBV7-9,TRBJ1-1,CASSKPGQRNTEAFF,0,1,1,1
TRBV7-9,TRBJ2-1,CASSFQTGIRNEQFF,0,1,1,1
TRBV5-4,TRBJ1-6,CASSLVGGYGSPLHF,0,1,1,1
TRBV7-2,TRBJ2-3,CASSLGVPGTDTQYF,0,1,1,1
TRBV5-5,TRBJ1-1,CASSLEDTKGTEAFF,0,1,1,1
TRBV11-2,TRBJ2-1,CASSLQPSYNNEQFF,0,1,1,1
TRBV7-2,TRBJ1-1,CASSLVRGANTEAFF,0,1,1,1
TRBV6-2/3/5/6,TRBJ2-7,CASSLALTTVYEQYF,0,1,1,1
TRBV7-2,TRBJ2-1,CASSLAGQVADEQFF,0,1,1,1
TRBV11-3,TRBJ2-7,CASSLGGSKTYEQYF,0,1,1,1
TRBV11-3,TRBJ2-1,CASSLGRESYNEQFF,0,1,1,1
TRBV7-2,TRBJ2-1,CASSLDGQDYNEQFF,0,1,1,1
TRBV7-9,TRBJ2-3,CASSLDGTSADTQYF,0,1,1,1
TRBV7-2,TRBJ2-3,CASSLEGRESYTQYF,0,1,1,1
TRBV7-3,TRBJ1-1,CASSLTPGRDTEAFF,0,1,1,1
TRBV7-2,TRBJ1-5,CASSLSSTDNQPQHF,0,1,1,1
TRBV5-4,TRBJ2-5,CASSSPMGAGETQYF,0,1,1,1
TRBV5-4,TRBJ2-7,CASSSRDRGSYEQYF,0,1,1,1
TRBV5-4,TRBJ1-5,CASSSGTGSNQPQHF,0,1,1,1
TRBV11-1,TRBJ2-7,CASSSTGTGDHEQYF,0,1,1,1
TRBV5-4,TRBJ2-2,CASSWSGGNTGELFF,0,1,1,1
TRBV2,TRBJ1-1,CASSYQSGVNTEAFF,0,1,1,1
TRBV6-2/3/5/6,TRBJ2-1,CASSPIPGGWNEQFF,0,1,1,1
TRBV5-6,TRBJ2-4,CASSPTGRGKNIQYF,0,1,1,1
TRBV5-6,TRBJ1-5,CASSPSGAWGQPQHF,0,1,1,1
TRBV27,TRBJ2-1,CASSPNRGGDDEQFF,0,1,1,1
TRBV5-5,TRBJ2-1,CASSPTWISYNEQFF,0,1,1,1
TRBV3-1,TRBJ1-1,CASSRGQDLNTEAFF,0,1,1,1
TRBV3-1,TRBJ2-3,CASSRTTTSTDTQYF,0,1,1,1
TRBV5-6,TRBJ2-1,CASSRTSGAYNGQFF,0,1,1,1
TRBV3-1,TRBJ2-5,CASSRGLAGTETQYF,0,1,1,1
TRBV3-1,TRBJ1-1,CASSQGQGTGTEASF,0,1,1,1
TRBV3-1,TRBJ1-2,CASSQDGYPPNGYTF,0,1,1,1
TRBV9,TRBJ2-3,CASSVDQISTDTQYF,0,1,1,1
TRBV9,TRBJ2-3,CASSVRIGVTDTQYF,0,1,1,1
TRBV9,TRBJ2-4,CASSAGGLTKNIQYF,0,1,1,1
TRBV7-2,TRBJ1-5,CASSIGDTPNQPQHF,0,1,1,1
TRBV28,TRBJ2-5,CASSTPGEGPETQYF,0,1,1,1
TRBV28,TRBJ2-5,CASSTSGVVRETQYF,0,1,1,1
TRBV5-4,TRBJ2-1,CASSRTSGGINELFF,0,1,1,1
TRBV6-2/3/5/6,TRBJ2-5,CASSKLAGGRETQYF,0,1,1,1
TRBV2,TRBJ2-1,CASRPGQGANNEQFF,0,1,1,1
TRBV2,TRBJ2-5,CASRGIRLRRETQYF,0,1,1,1
TRBV7-2,TRBJ2-5,CASRRLAGGRETQYF,0,1,1,1
TRBV3-1,TRBJ2-1,CASRPSGGSYNEQFF,0,1,1,1
TRBV6-2/3/5/6,TRBJ2-3,CASRMTGGGVDTQYF,0,1,1,1
TRBV12-3/4,TRBJ1-2,CASRKTGGANYGYTF,0,1,1,1
TRBV5-1,TRBJ2-3,CASTHSGTSTDTQYF,0,1,1,1
TRBV5-1,TRBJ2-3,CASKADGQYTDTQYF,0,1,1,1
TRBV5-1,TRBJ1-5,CASSLDGRTDQPQHF,0,1,1,1
TRBV5-1,TRBJ2-3,CASSLEVRVGDTQYF,0,1,1,1
TRBV5-1,TRBJ2-3,CASSLTRSESDTQYF,0,1,1,1
TRBV5-1,TRBJ2-1,CASSLNPGGVNEQFF,0,1,1,1
TRBV5-1,TRBJ2-7,CASSLKGGTSYEQYF,0,1,1,1
TRBV4-1,TRBJ1-1,CASSLRTGGRTEAFF,0,1,1,1
TRBV4-3,TRBJ2-2,CASSQALDFTGELFF,0,1,1,1
TRBV5-1,TRBJ1-2,CASSGRHEANYGYTF,0,1,1,1
TRBV20-1,TRBJ2-1,CSAPTRSGRLNEQFF,0,1,1,1
TRBV20-1,TRBJ1-2,CSAPPGTDELYGYTF,0,1,1,1
TRBV20-1,TRBJ1-1,CSAGDPKSGNTEAFF,0,1,1,1
TRBV20-1,TRBJ2-3,CSASSPKAATDTQYF,0,1,1,1
TRBV20-1,TRBJ2-4,CSASRPGRAKNIQYF,0,1,1,1
TRBV20-1,TRBJ2-5,CSARDAASPVETQYF,0,1,1,1
TRBV20-1,TRBJ2-5,CSARDDQTSGETQYF,0,1,1,1
TRBV20-1,TRBJ2-6,CSARSASPGANVLTF,0,1,1,1
TRBV29-1,TRBJ2-7,CSVGGLAGASYEQYF,0,1,1,1
TRBV29-1,TRBJ2-3,CSVEDWGGSTDTQYF,0,1,1,1
TRBV29-1,TRBJ2-1,CSVETSGGHYNEQFF,0,1,1,1
TRBV29-1,TRBJ2-3,CSVITGGRGTDTQYF,0,1,1,1
TRBV7-2,TRBJ2-3,WASSRWAGETDTQYF,0,1,1,1
TRBV12-5,TRBJ1-1,CASGPDFQNTEAFF,0,1,1,1
TRBV30,TRBJ2-7,CAWSGTGYRYEQYF,0,1,1,1
TRBV30,TRBJ2-5,CAWSRLAGGETQYF,0,1,1,1
TRBV30,TRBJ2-3,CAWKMTGSTDTQYF,0,1,1,1
TRBV19,TRBJ2-2,CAGSIGWGTGELFF,0,1,1,1
TRBV12-3/4,TRBJ1-5,CAGSTGQGGQPQHF,0,1,1,1
TRBV7-9,TRBJ2-3,CAGGTGTGTDTQYF,0,1,1,1
TRBV10-3,TRBJ1-5,CAITPDSKRQPQHF,0,1,1,1
TRBV10-3,TRBJ2-5,CAISEAGRQETQYF,0,1,1,1
TRBV13,TRBJ2-1,CATQLAGGIYEQFF,0,1,1,1
TRBV24-1,TRBJ1-1,CATSDFGGVTEAFF,0,1,1,1
TRBV15,TRBJ2-1,CATSRDTNYNEQFF,0,1,1,1
TRBV19,TRBJ2-7,CASSGGPSSVGQYF,0,1,1,1
TRBV19,TRBJ1-2,CASSIIGGGYGYTF,0,1,1,1
TRBV18,TRBJ1-1,CASSSRTGDTEAFF,0,1,1,1
TRBV18,TRBJ2-1,CASSPLAGAGEQFF,0,1,1,1
TRBV2,TRBJ2-5,CASGYRGAQETQYF,0,1,1,1
TRBV5-4,TRBJ2-7,CASTRQGMSYEQYF,0,1,1,1
TRBV6-2/3/5/6,TRBJ1-4,CASTVGHLNEKLFF,0,1,1,1
TRBV25-1,TRBJ2-7,CASTGDPQTYEQYI,0,1,1,1
TRBV12-3/4,TRBJ1-5,CASTESGGHQPQHF,0,1,1,1
TRBV27,TRBJ1-2,CASSFGGYGYGYTF,0,1,1,1
TRBV12-3/4,TRBJ2-1,CASSFGTGDNEQFF,0,1,1,1
TRBV27,TRBJ2-3,CASSLGGSTDTQYL,0,1,1,1
TRBV28,TRBJ1-1,CASSLGSGISEAFF,0,1,1,1
TRBV6-2/3/5/6,TRBJ1-2,CASSLGGGLNGYTF,0,1,1,1
TRBV12-3/4,TRBJ2-3,CASSLGTGRDTQYF,0,1,1,1
TRBV12-3/4,TRBJ2-7,CASSSQDRNYEQYF,0,1,1,1
TRBV12-3/4,TRBJ1-2,CASSSIGQGGGYTF,0,1,1,1
TRBV6-2/3/5/6,TRBJ1-5,CASSYSGVGKPQHF,0,1,1,1
TRBV6-2/3/5/6,TRBJ2-4,CASSYSGQKNIQYF,0,1,1,1
TRBV12-3/4,TRBJ1-2,CASSLTTGLGGYTF,0,1,1,1
TRBV12-3/4,TRBJ2-5,CASSLSGGGETQYF,0,1,1,1
TRBV6-1,TRBJ2-5,CASSAGGGLKTQYF,0,1,1,1
TRBV11-3,TRBJ2-1,CASSLQVDYNEQFF,0,1,1,1
TRBV7-2,TRBJ1-1,CASSLVAGFTEAFF,0,1,1,1
TRBV7-9,TRBJ1-1,CASSLGGGGTEAFF,0,1,1,1
TRBV7-2,TRBJ1-1,CASSLDRGWTEAFF,0,1,1,1
TRBV7-2,TRBJ2-5,CASSSQGNQETQYF,0,1,1,1
TRBV2,TRBJ1-1,CASSLRQGATEAFF,0,1,1,1
TRBV7-2,TRBJ1-2,CASSLRTQGGGYTF,0,1,1,1
TRBV3-1,TRBJ2-2,CASSLDLGAGELFF,0,1,1,1
TRBV7-9,TRBJ1-4,CASSLQLGGEKLFF,0,1,1,1
TRBV5-8,TRBJ2-7,CASSPPPGLYEQYF,0,1,1,1
TRBV7-6,TRBJ2-7,CASSPGSMPGEQYF,0,1,1,1
TRBV12-3/4,TRBJ2-7,CASSPGTGSYEQYF,0,1,1,1
TRBV3-1,TRBJ1-6,CASSPRAGESPLHF,0,1,1,1
TRBV7-2,TRBJ2-1,CASSPTYSYNEQFF,0,1,1,1
TRBV3-1,TRBJ2-7,CASSPGLTNYEQYF,0,1,1,1
TRBV6-2/3/5/6,TRBJ1-5,CASSRDRSNQPQHF,0,1,1,1
TRBV7-8,TRBJ1-2,CASSRQGASYGYTF,0,1,1,1
TRBV7-9,TRBJ1-4,CASSRGQGHEKLFF,0,1,1,1
TRBV3-1,TRBJ2-3,CASSHRTVTDTQYF,0,1,1,1
TRBV3-1,TRBJ1-4,CASSQWKWGEKLFF,0,1,1,1
TRBV6-2/3/5/6,TRBJ2-7,CASSQDTKFYKQYF,0,1,1,1
TRBV3-1,TRBJ1-3,CASSQQGTGNTIYF,0,1,1,1
TRBV14,TRBJ2-1,CASSQAPGAGEQFF,0,1,1,1
TRBV14,TRBJ1-3,CASSQDLRSNTIYF,0,1,1,1
TRBV3-1,TRBJ1-1,CASSQRADNTEAFF,0,1,1,1
TRBV9,TRBJ2-7,CASSVGPGAGEQYF,0,1,1,1
TRBV5-4,TRBJ2-1,CASSVPGVGNEQFF,0,1,1,1
TRBV9,TRBJ1-6,CASSVGPHDSPLHF,0,1,1,1
TRBV7-2,TRBJ2-5,CASSTRLKWETQYF,0,1,1,1
TRBV5-4,TRBJ2-7,CASSTGQGLYEQYF,0,1,1,1
TRBV6-2/3/5/6,TRBJ1-5,CASSSGTSNQPQHF,0,1,1,1
TRBV5-6,TRBJ2-5,CASSSKGSGETRYF,0,1,1,1
TRBV12-3/4,TRBJ2-5,CASRLTGPQETQYF,0,1,1,1
TRBV12-3/4,TRBJ2-1,CASRLGTGGDEQFF,0,1,1,1
TRBV28,TRBJ2-1,CASRRGGLYNEQFF,0,1,1,1
TRBV12-3/4,TRBJ2-3,CASRTGGSTDTQYF,0,1,1,1
TRBV5-6,TRBJ1-2,CASRRDRVDYGYTF,0,1,1,1
TRBV7-6,TRBJ2-2,CASRSTGNTGELFF,0,1,1,1
TRBV7-2,TRBJ2-7,CASRPTSDSYEQYL,0,1,1,1
TRBV2,TRBJ2-5,CASRRLAGAETQYF,0,1,1,1
TRBV12-3/4,TRBJ1-1,CASRTTGKNTEAFF,0,1,1,1
TRBV5-1,TRBJ2-7,CASSLGDQVYEQYF,0,1,1,1
TRBV5-1,TRBJ1-4,CASRRGSTNEKLFF,0,1,1,1
TRBV10-2,TRBJ2-5,CASTRLAGEETQYF,0,1,1,1
TRBV4-1,TRBJ2-1,CASSFPGNNNEQFF,0,1,1,1
TRBV5-1,TRBJ2-2,CASSLELTTGELFF,0,1,1,1
TRBV5-1,TRBJ2-5,CASSSGQGLETQYF,0,1,1,1
TRBV5-1,TRBJ1-1,CASSSGQGNTEAFF,0,1,1,1
TRBV5-1,TRBJ2-7,CASSWTGPSYEQYF,0,1,1,1
TRBV4-3,TRBJ1-1,CASSRGQGGTEASF,0,1,1,1
TRBV4-3,TRBJ2-1,CASSQQGVGNEQFF,0,1,1,1
TRBV5-1,TRBJ2-1,CASSQGGGRNEQFF,0,1,1,1
TRBV4-3,TRBJ2-1,CASSQDQTSGGKFF,0,1,1,1
TRBV4-1,TRBJ2-5,CASSQDAEVTAQYF,0,1,1,1
TRBV4-3,TRBJ1-2,CASSQEGRGGGYTF,0,1,1,1
TRBV4-1,TRBJ1-5,CASSQEGGNQPQHF,0,1,1,1
TRBV4-3,TRBJ2-7,CASSQEVLAGEQYF,0,1,1,1
TRBV5-1,TRBJ2-5,CASSIAGTEETQYF,0,1,1,1
TRBV5-1,TRBJ2-5,CASSNGQAQETQYF,0,1,1,1
TRBV5-1,TRBJ2-3,CASRQGSSADTQYF,0,1,1,1
TRBV20-1,TRBJ2-7,CSAWSASGGNEQYF,0,1,1,1
TRBV20-1,TRBJ2-3,CSASKDTSTDTQYF,0,1,1,1
TRBV20-1,TRBJ2-2,CSARVSRAAGELFF,0,1,1,1
TRBV20-1,TRBJ1-1,CSARVPGRNTEAFF,0,1,1,1
TRBV20-1,TRBJ1-1,CSARGPHGDTEAFF,0,1,1,1
TRBV20-1,TRBJ2-5,CSARGTGGRETQYF,0,1,1,1
TRBV20-1,TRBJ1-5,CSARGQGSNQPQHF,0,1,1,1
TRBV20-1,TRBJ2-6,CSARRGTGANVLTF,0,1,1,1
TRBV20-1,TRBJ2-4,CSASAGGRLNIQYF,0,1,1,1
TRBV29-1,TRBJ2-3,CSVDPGRGTDTQYF,0,1,1,1
TRBV29-1,TRBJ1-1,CSVELTGLNTEAFF,0,1,1,1
TRBV29-1,TRBJ2-5,CSAGDRIIQETQYF,0,1,1,1
TRBV9,TRBJ2-2,SASSVVGQAGELFF,0,1,1,1
TRBV30,TRBJ1-6,CAWTDLDNSPLHF,0,1,1,1
TRBV30,TRBJ2-7,CAWSTRDPGEQYF,0,1,1,1
TRBV19,TRBJ2-7,CARSTGRPYEQYF,0,1,1,1
TRBV10-3,TRBJ2-5,CAISDQGSETQYF,0,1,1,1
TRBV10-3,TRBJ2-7,CAMSGQGGYEQYF,0,1,1,1
TRBV5-5,TRBJ2-3,CATRDGGSDTQYF,0,1,1,1
TRBV28,TRBJ1-2,CATRIAGIYGYTF,0,1,1,1
TRBV15,TRBJ2-3,CATSREPADTQYF,0,1,1,1
TRBV15,TRBJ2-3,CATRRGGTDTQYF,0,1,1,1
TRBV24-1,TRBJ1-6,CATRGPGNSPLHF,0,1,1,1
TRBV15,TRBJ2-3,CATRKHRADTQYF,0,1,1,1
TRBV19,TRBJ1-4,CASNPREGEKLFF,0,1,1,1
TRBV7-6,TRBJ1-4,CASSPRGGEKLFF,0,1,1,1
TRBV18,TRBJ2-7,CASSTKDREVQYF,0,1,1,1
TRBV18,TRBJ2-7,CASSPQGIYEQYF,0,1,1,1
TRBV18,TRBJ1-2,CASSPGGNYGYTF,0,1,1,1
TRBV18,TRBJ2-1,CASPPPIGNEQFF,0,1,1,1
TRBV4-2,TRBJ2-7,CASRPGDSYEQYF,0,1,1,1
TRBV7-9,TRBJ1-4,CASIGTGGRKLFF,0,1,1,1
TRBV12-3/4,TRBJ1-6,CASTGQPGVPLHF,0,1,1,1
TRBV12-3/4,TRBJ2-4,CASSFGTGGRAYF,0,1,1,1
TRBV6-2/3/5/6,TRBJ1-1,CASSFPMNTEAFF,0,1,1,1
TRBV12-3/4,TRBJ2-2,CASSLASVGELFF,0,1,1,1
TRBV12-3/4,TRBJ1-1,CASSLAGNTEAFF,0,1,1,1
TRBV12-3/4,TRBJ1-1,CASSLAVNTEAFF,0,1,1,1
TRBV7-8,TRBJ2-7,CASSSSPHYEQYF,0,1,1,1
TRBV7-8,TRBJ2-7,CASSPQRGSEQYF,0,1,1,1
TRBV6-1,TRBJ2-3,CASSVEDADTQYF,0,1,1,1
TRBV12-3/4,TRBJ2-3,CASSALRTDTQYF,0,1,1,1
TRBV2,TRBJ1-6,CASSGRENSPLHF,0,1,1,1
TRBV6-1,TRBJ2-1,CASSGWGDNEQFF,0,1,1,1
TRBV2,TRBJ1-5,CASSEGISGPQHF,0,1,1,1
TRBV6-2/3/5/6,TRBJ2-5,CASSRGGRSSQYF,0,1,1,1
TRBV7-2,TRBJ2-7,CASSFGTPYEQYF,0,1,1,1
TRBV7-9,TRBJ1-1,CASSFGPGTEAFF,0,1,1,1
TRBV11-2,TRBJ1-1,CASSFGPRAEAFF,0,1,1,1
TRBV5-4,TRBJ2-1,CASSLGEQGGKFF,0,1,1,1
TRBV5-6,TRBJ2-2,CASSLGAYGELFF,0,1,1,1
TRBV7-2,TRBJ1-1,CASSLRLNTEAFF,0,1,1,1
TRBV11-3,TRBJ1-1,CASSLVIPPEAFF,0,1,1,1
TRBV13,TRBJ2-1,CASSLAVINEQFF,0,1,1,1
TRBV7-9,TRBJ1-1,CASSLGGDTEAFF,0,1,1,1
TRBV5-5,TRBJ1-2,CASSSDRDYGYTF,0,1,1,1
TRBV3-1,TRBJ2-2,CASSLKGAGELFF,0,1,1,1
TRBV9,TRBJ1-2,CASSPGDIAGYTF,0,1,1,1
TRBV5-4,TRBJ1-2,CASSPGQTGPTTF,0,1,1,1
TRBV9,TRBJ1-3,CASSGPPGNTIYF,0,1,1,1
TRBV7-9,TRBJ1-2,CASSGQGWYGYTF,0,1,1,1
TRBV9,TRBJ2-7,CASSMGDPYEQYF,0,1,1,1
TRBV6-2/3/5/6,TRBJ1-1,CASRSTGHTEAFF,0,1,1,1
TRBV28,TRBJ1-2,CASRAQLGFGYTF,0,1,1,1
TRBV6-2/3/5/6,TRBJ1-2,CASRMDRESGYTF,0,1,1,1
TRBV6-2/3/5/6,TRBJ2-7,CASRGTDSYEQYF,0,1,1,1
TRBV5-4,TRBJ2-2,CASNRGLAGELFF,0,1,1,1
TRBV5-1,TRBJ1-1,CASSEDVITEAFF,0,1,1,1
TRBV5-1,TRBJ2-7,CASGVGTPYEQYF,0,1,1,1
TRBV5-1,TRBJ2-7,CASSLEGSYEQYF,0,1,1,1
TRBV5-1,TRBJ2-2,CASSLQRPGELFF,0,1,1,1
TRBV5-1,TRBJ1-1,CASSQTGNTEAFF,0,1,1,1
TRBV10-2,TRBJ1-1,CASSDPGSTEAFF,0,1,1,1
TRBV5-1,TRBJ2-7,CASRTSGGYEQYF,0,1,1,1
TRBV29-1,TRBJ1-2,CSLRQGDNYGYTF,0,1,1,1
TRBV20-1,TRBJ1-1,CSAQQDGNTEAFF,0,1,1,1
TRBV20-1,TRBJ2-7,CSARGSANYEQYF,0,1,1,1
TRBV20-1,TRBJ1-4,CSARDGKNEKLFF,0,1,1,1
TRBV20-1,TRBJ1-6,CSASGTGGSPLHF,0,1,1,1
TRBV20-1,TRBJ2-2,CSAHDRNTGELFF,0,1,1,1
TRBV20-1,TRBJ2-7,CSARDGILGEQYF,0,1,1,1
TRBV29-1,TRBJ2-2,CSVVVGGTGELFF,0,1,1,1
TRBV29-1,TRBJ2-3,CSVVVTSEGTQYF,0,1,1,1
TRBV29-1,TRBJ2-5,CSVAQISGETQYF,0,1,1,1
TRBV29-1,TRBJ2-2,CSVARDITGELFF,0,1,1,1
TRBV29-1,TRBJ1-5,CSVETSLNQPQHF,0,1,1,1
TRBV29-1,TRBJ1-2,CSVEDLRRGGYTF,0,1,1,1
TRBV29-1,TRBJ1-2,CSVEEAGFTGYTF,0,1,1,1
TRBV29-1,TRBJ2-3,CSVERQASDTQYF,0,1,1,1
TRBV29-1,TRBJ1-2,CSVRSGRDYGYTF,0,1,1,1
TRBV4-3,TRBJ2-3,RASSGGLAGGMYF,0,1,1,1
TRBV30,TRBJ2-5,CAWATGVETQYF,0,1,1,1
TRBV7-2,TRBJ1-2,CATSFGRDGYTF,0,1,1,1
TRBV5-5,TRBJ2-7,CATGQGAYEQYF,0,1,1,1
TRBV2,TRBJ2-1,CATTSSGNEQFF,0,1,1,1
TRBV24-1,TRBJ2-3,CATSETTDTQYF,0,1,1,1
TRBV19,TRBJ1-5,CASSIGYQPRHF,0,1,1,1
TRBV19,TRBJ2-5,CASSTATGTQYF,0,1,1,1
TRBV11-1,TRBJ2-1,CASGPLGNEQFF,0,1,1,1
TRBV6-2/3/5/6,TRBJ2-1,CASSLTGSEQFF,0,1,1,1
TRBV6-2/3/5/6,TRBJ1-1,CASSLQAGEAFF,0,1,1,1
TRBV12-3/4,TRBJ2-1,CASSLGPGESFF,0,1,1,1
TRBV6-2/3/5/6,TRBJ1-5,CASSWGNQPQHF,0,1,1,1
TRBV6-2/3/5/6,TRBJ2-7,CASSLSSGEQYF,0,1,1,1
TRBV2,TRBJ2-1,CASSETGDEQFF,0,1,1,1
TRBV7-9,TRBJ1-1,CASSFDRDEAFF,0,1,1,1
TRBV12-3/4,TRBJ1-2,CASSFGASGYAF,0,1,1,1
TRBV7-9,TRBJ2-3,CASSLSTDTQYF,0,1,1,1
TRBV3-1,TRBJ2-1,CASSLHRNEQFF,0,1,1,1
TRBV4-2,TRBJ1-1,CASSQELGKAFF,0,1,1,1
TRBV7-2,TRBJ2-7,CASSDWSYEQHF,0,1,1,1
TRBV11-3,TRBJ2-2,CASRVGTGELFF,0,1,1,1
TRBV6-1,TRBJ2-7,CASREDSYEQYF,0,1,1,1
TRBV13,TRBJ2-2,CASNRGTGELFF,0,1,1,1
TRBV6-2/3/5/6,TRBJ2-7,CASKQGAYEQYF,0,1,1,1
TRBV4-1,TRBJ2-7,CASSQGTDEQYF,0,1,1,1
TRBV20-1,TRBJ1-1,CSAWTLNTEAFF,0,1,1,1
TRBV20-1,TRBJ2-1,CSARDRYNEQFF,0,1,1,1
TRBV20-1,TRBJ2-7,CSAFYRLGEQYF,0,1,1,1
TRBV29-1,TRBJ2-1,CSVEDSVNEQFF,0,1,1,1
TRBV29-1,TRBJ1-3,CSVEEGLRGIYF,0,1,1,1
TRBV24-1,TRBJ2-3,CATGAGDTQYF,0,1,1,1
TRBV18,TRBJ2-3,CASSDPDTQYF,0,1,1,1
TRBV7-9,TRBJ1-2,CASSLIEGYTF,0,1,1,1
TRBV7-9,TRBJ1-6,CASSLDSPLHF,0,1,1,1
TRBV4-2,TRBJ1-2,CASSSMRGYTF,0,1,1,1
TRBV7-2,TRBJ2-7,CASSQGYEQYF,0,1,1,1
TRBV5-1,TRBJ1-4,CASSRDEKLFF,0,1,1,1
TRBV28,TRBJ1-2,CASGGLGYTF,0,1,1,1
TRBV20-1,TRBJ1-5,CSASGQPQHF,0,1,1,1
TRBV15,TRBJ2-6,CATSRDLRSRGRRGANVLTF,0,1,1,1
TRBV7-6,TRBJ2-5,RASSLGLTSGGWSTMETQYF,0,1,1,1
TRBV15,TRBJ2-7,CATSRSSTYRDRGVGEQYF,0,1,1,1
TRBV28,TRBJ2-5,CASSSLQGVPRLYQETQYF,0,1,1,1
TRBV4-3,TRBJ2-1,CASSQAYGTSGGAYNEQFF,0,1,1,1
TRBV20-1,TRBJ2-4,CSARDSVGLAGLAKNIQYF,0,1,1,1
TRBV19,TRBJ2-1,CASTPIGLAGGRYNEQFF,0,1,1,1
TRBV6-2/3/5/6,TRBJ2-3,CASTVIGAGGRSPDTQYF,0,1,1,1
TRBV28,TRBJ1-4,CASSLFTPARPENEKLFF,0,1,1,1
TRBV6-2/3/5/6,TRBJ2-3,CASSYSPAGAGGPHTQYF,0,1,1,1
TRBV6-2/3/5/6,TRBJ2-3,CASSYSATSGVLTDTQYF,0,1,1,1
TRBV3-1,TRBJ2-1,CASSFGLAGGGSYNEQFF,0,1,1,1
TRBV7-9,TRBJ2-3,CASSSLWVTLNYTDTQYF,0,1,1,1
TRBV7-3,TRBJ1-3,CASSPGPGLGRSGNTIYF,0,1,1,1
TRBV7-9,TRBJ2-1,CASSPDPVAGGPRNEQFF,0,1,1,1
TRBV4-2,TRBJ2-3,CASSQATTSGGQTDTQYF,0,1,1,1
TRBV5-1,TRBJ2-6,CASSSWDRDSSGANVLTF,0,1,1,1
TRBV5-1,TRBJ2-3,CASSPGDRGPLGTDTQYF,0,1,1,1
TRBV4-3,TRBJ2-2,CASSQRISGGADTGELFF,0,1,1,1
TRBV20-1,TRBJ2-1,CSAPWTSGGASSYNEQFF,0,1,1,1
TRBV19,TRBJ1-5,CASSGGSGHHSNQPQHF,0,1,1,1
TRBV19,TRBJ1-1,CASSIAGVLSANTEAFF,0,1,1,1
TRBV19,TRBJ2-2,CASSIEQRGRAAGELFF,0,1,1,1
TRBV19,TRBJ2-5,CASSIEGPAGVSETQYF,0,1,1,1
TRBV6-2/3/5/6,TRBJ1-5,CASTYGTGGPSNQPQHF,0,1,1,1
TRBV6-2/3/5/6,TRBJ2-6,CASSFNGGSSGANVLTF,0,1,1,1
TRBV6-2/3/5/6,TRBJ1-5,CASSLYSPSRLNQPQHF,0,1,1,1
TRBV28,TRBJ1-4,CASSLPQGSPTNEKLFF,0,1,1,1
TRBV12-3/4,TRBJ2-5,CASSSNREPLSGETQYF,0,1,1,1
TRBV12-3/4,TRBJ1-6,CASSYQGSVRYNSPLHF,0,1,1,1
TRBV6-2/3/5/6,TRBJ2-7,CASSYKQGPPIGYEQYF,0,1,1,1
TRBV7-6,TRBJ1-4,CASSLPPGAATNEKLFF,0,1,1,1
TRBV11-3,TRBJ2-2,CASSLDLGQGTTGELFF,0,1,1,1
TRBV11-3,TRBJ2-1,CASSSLTGADPYNEQFF,0,1,1,1
TRBV11-2,TRBJ2-2,CASSPLAGGQSVGELFF,0,1,1,1
TRBV27,TRBJ2-4,CASSPFGQGATKNIQYF,0,1,1,1
TRBV14,TRBJ1-1,CASSQEWSEALRAEAFF,0,1,1,1
TRBV4-2,TRBJ2-6,CASSQKKEYSGANVLTF,0,1,1,1
TRBV9,TRBJ2-7,CASSVGENRESSYEQYF,0,1,1,1
TRBV6-2/3/5/6,TRBJ2-7,CASRNPLLAGSAYEQYF,0,1,1,1
TRBV10-1,TRBJ1-1,CASSQATGIGMNTEAFF,0,1,1,1
TRBV5-1,TRBJ2-1,CASSLSPGLVSSNEQFF,0,1,1,1
TRBV4-1,TRBJ1-6,CASSPQIGQLINSPLHF,0,1,1,1
TRBV4-3,TRBJ2-3,CASSQDFSGGALDTQYF,0,1,1,1
TRBV4-1,TRBJ2-3,CASSQTHSGGSTDTQYF,0,1,1,1
TRBV4-1,TRBJ1-3,CASSNVHVTASGNTIYF,0,1,1,1
TRBV30,TRBJ2-2,CAWSGGKRGNTGELFS,0,1,1,1
TRBV10-3,TRBJ1-5,CAISEETAYSNQPQHF,0,1,1,1
TRBV19,TRBJ1-5,CASTLLATGGGQPQHF,0,1,1,1
TRBV19,TRBJ2-4,CASSKDKLGAKNIQYF,0,1,1,1
TRBV19,TRBJ1-1,CASSNQGRGDGTEAFF,0,1,1,1
TRBV18,TRBJ2-7,CASSPPWGTYTYEQYF,0,1,1,1
TRBV18,TRBJ1-2,CASSPRAGLGKEGYTF,0,1,1,1
TRBV3-1,TRBJ1-1,CASRRGTGVRDSEAFF,0,1,1,1
TRBV28,TRBJ2-1,CASSFIISSGDNEQFF,0,1,1,1
TRBV12-3/4,TRBJ1-2,CASSFTGRPSGYGYTF,0,1,1,1
TRBV27,TRBJ1-1,CASSLYDIKMNTEAFF,0,1,1,1
TRBV28,TRBJ1-2,CASSLPGEGVSSGYTF,0,1,1,1
TRBV27,TRBJ2-1,CASSSSSGGAYNEQFF,0,1,1,1
TRBV12-3/4,TRBJ1-6,CASSSWTGSYNSPLHF,0,1,1,1
TRBV6-2/3/5/6,TRBJ2-1,CASSPSGGAGYNEQFF,0,1,1,1
TRBV6-2/3/5/6,TRBJ1-4,CASSPPRQSRNEKLFF,0,1,1,1
TRBV28,TRBJ2-7,CASSPPALPPLYEQYF,0,1,1,1
TRBV6-2/3/5/6,TRBJ2-1,CASSPGGGGPYNEQFF,0,1,1,1
TRBV11-1,TRBJ2-1,CASSRTMGGRYNEQFF,0,1,1,1
TRBV6-4,TRBJ1-1,CASSDSTGTYGTEAFF,0,1,1,1
TRBV25-1,TRBJ1-4,CASSEYVRGSREKLFF,0,1,1,1
TRBV6-1,TRBJ2-1,CASSEIGPRAYNEQFF,0,1,1,1
TRBV28,TRBJ1-1,CASSRTGGVLNTEAFF,0,1,1,1
TRBV5-8,TRBJ2-4,CASSFGTNLAKNIQYF,0,1,1,1
TRBV7-9,TRBJ1-2,CASSLALGRTSYGYTF,0,1,1,1
TRBV7-2,TRBJ2-3,CASSLGTSGSTDTQYF,0,1,1,1
TRBV7-3,TRBJ2-2,CASSLRGRENTGKLFL,0,1,1,1
TRBV7-2,TRBJ2-6,CASSSSGGRGANVLTF,0,1,1,1
TRBV7-9,TRBJ2-2,CASSWAGLENTGELFF,0,1,1,1
TRBV5-4,TRBJ1-3,CASSYRVGATGNTIYF,0,1,1,1
TRBV7-9,TRBJ2-4,CASSPLVWGGGNIQYF,0,1,1,1
TRBV28,TRBJ2-4,CASSPGLAGAKNIQYF,0,1,1,1
TRBV7-2,TRBJ2-7,CASSPDSAFGSYEQYF,0,1,1,1
TRBV7-2,TRBJ2-1,CASSHPPGGVYNEQFF,0,1,1,1
TRBV28,TRBJ2-5,CASSQAGDPNGETQYF,0,1,1,1
TRBV4-2,TRBJ2-3,CASSQGTSGGLGTQYF,0,1,1,1
TRBV4-2,TRBJ2-5,CASSQGLTVNQETQYF,0,1,1,1
TRBV4-2,TRBJ2-7,CASSVGVSGGSYEQYF,0,1,1,1
TRBV9,TRBJ2-5,CASSVGPAAAQETQYF,0,1,1,1
TRBV7-3,TRBJ1-5,CASRLPGQGKNQPQHF,0,1,1,1
TRBV28,TRBJ2-1,CASRGGQTLPYNEQFF,0,1,1,1
TRBV10-2,TRBJ1-1,CASSELGLGGDTEAFF,0,1,1,1
TRBV5-1,TRBJ2-3,CASSLAAGGNTDTQYF,0,1,1,1
TRBV5-1,TRBJ2-1,CASSLAGAGVINEQFF,0,1,1,1
TRBV5-1,TRBJ1-1,CASSLGRTGQNTEAFF,0,1,1,1
TRBV5-1,TRBJ2-7,CASSLDRGTTLRLQYF,0,1,1,1
TRBV5-1,TRBJ1-1,CASSLFLERGIAEAFF,0,1,1,1
TRBV5-1,TRBJ2-1,CASSLGWTSVDNEQFF,0,1,1,1
TRBV4-3,TRBJ1-2,CASSHDWPLNSEGYTF,0,1,1,1
TRBV4-3,TRBJ2-1,CASSQQPSDGANEQFF,0,1,1,1
TRBV4-1,TRBJ1-6,CASSQDREAYNSPLHF,0,1,1,1
TRBV4-1,TRBJ2-7,CASSQDGNRGHYEQYF,0,1,1,1
TRBV4-1,TRBJ1-6,CASSQEYGTGGSPLHF,0,1,1,1
TRBV5-1,TRBJ2-6,CASSNHGVSGANVLTF,0,1,1,1
TRBV10-1,TRBJ2-3,CASKSGTSGGRDTQYF,0,1,1,1
TRBV20-1,TRBJ1-5,CSALLGGQTSNQPQHF,0,1,1,1
TRBV20-1,TRBJ2-3,CSASLLAGDLTDTQYF,0,1,1,1
TRBV20-1,TRBJ2-1,CSARQVSRTGVDEQFF,0,1,1,1
TRBV29-1,TRBJ2-6,CSVRDRGVAGANVLTF,0,1,1,1
TRBV29-1,TRBJ2-1,CSVEGMGGLEYNEQFF,0,1,1,1
TRBV29-1,TRBJ2-2,CSVENSMAGVTGELFF,0,1,1,1
TRBV29-1,TRBJ2-2,CSVEDRAGGSAGELFF,0,1,1,1
TRBV7-7,TRBJ2-5,CASSLAYRPLETQYF,0,1,1,1
TRBV7-7,TRBJ2-1,CASSLGGASYNEQFF,0,1,1,1
TRBV30,TRBJ1-1,CAWSAHLTRNTEAFF,0,1,1,1
TRBV30,TRBJ2-6,CAWSNERSGANVLTF,0,1,1,1
TRBV7-3,TRBJ1-5,CAGSRSAQGNQPQHF,0,1,1,1
TRBV10-3,TRBJ2-3,CAISESDRGRLTQYF,0,1,1,1
TRBV19,TRBJ1-6,CATASYMGGNSPLHF,0,1,1,1
TRBV24-1,TRBJ2-1,CATSDNRGRLNEQFF,0,1,1,1
TRBV15,TRBJ2-1,CATSRDGGGFNEQFF,0,1,1,1
TRBV15,TRBJ2-4,CATSRETAIKNIQYF,0,1,1,1
TRBV12-3/4,TRBJ1-2,CASNRDTFANYGYTF,0,1,1,1
TRBV18,TRBJ1-5,CASSASGQNNQPQHF,0,1,1,1
TRBV18,TRBJ2-1,CASSPLRGTYNEQFF,0,1,1,1
TRBV18,TRBJ2-1,CASSPGGATYNEQFF,0,1,1,1
TRBV6-4,TRBJ1-5,CASQDPDSRNQPQHF,0,1,1,1
TRBV2,TRBJ1-6,CASGGVQGPNSPLHF,0,1,1,1
TRBV2,TRBJ1-5,CASGEDRGGNQSQHF,0,1,1,1
TRBV6-1,TRBJ2-1,CASTGGSSSYNEQFF,0,1,1,1
TRBV6-2/3/5/6,TRBJ2-7,CASSLGARVDDEQYF,0,1,1,1
TRBV28,TRBJ2-6,CASSLRRSGANVLTF,0,1,1,1
TRBV6-2/3/5/6,TRBJ1-6,CASSYSRRDNSPLHF,0,1,1,1
TRBV6-2/3/5/6,TRBJ1-5,CASSYSRWGHQPQHF,0,1,1,1
TRBV6-2/3/5/6,TRBJ2-1,CASSYRPAHYNEQFF,0,1,1,1
TRBV12-3/4,TRBJ1-2,CASSPNREGNYGYTF,0,1,1,1
TRBV12-3/4,TRBJ2-3,CASSPHGLGPDTQYF,0,1,1,1
TRBV12-3/4,TRBJ2-1,CASSPSGTSGNEQFF,0,1,1,1
TRBV28,TRBJ2-4,CASSVMGQVSNIQYF,0,1,1,1
TRBV6-1,TRBJ2-5,CASSGGLATQETQYF,0,1,1,1
TRBV6-1,TRBJ2-1,CASSGGTGRWDEQFF,0,1,1,1
TRBV6-1,TRBJ2-1,CASSEVGGSYNEQFF,0,1,1,1
TRBV6-2/3/5/6,TRBJ2-1,CASSRVLGSGNEQFF,0,1,1,1
TRBV7-9,TRBJ2-3,CASSFDGGAGDTQYF,0,1,1,1
TRBV7-2,TRBJ2-3,CASSLSGSSADTQYF,0,1,1,1
TRBV5-5,TRBJ1-1,CASSLGGEVRTEAFF,0,1,1,1
TRBV5-4,TRBJ2-3,CASSLELASTDTQYF,0,1,1,1
TRBV7-2,TRBJ2-4,CASSLVAGSEDILYF,0,1,1,1
TRBV7-2,TRBJ2-5,CASSLVASGQETQYF,0,1,1,1
TRBV7-9,TRBJ2-1,CASSLAGLAGNEQFF,0,1,1,1
TRBV7-3,TRBJ2-1,CASSLAGSQGSEQFF,0,1,1,1
TRBV7-2,TRBJ2-7,CASSLAGEGSYEQYF,0,1,1,1
TRBV5-4,TRBJ2-2,CASSLGGTNTGELFF,0,1,1,1
TRBV7-2,TRBJ2-1,CASSLGASLGNEQFI,0,1,1,1
TRBV7-2,TRBJ2-5,CASSLGTAEGETQYF,0,1,1,1
TRBV7-9,TRBJ2-7,CASSLGPGKTYEQYF,0,1,1,1
TRBV7-9,TRBJ2-7,CASSLGEDKNYEQYF,0,1,1,1
TRBV11-1,TRBJ2-3,CASSLDRRPRDTQYF,0,1,1,1
TRBV7-3,TRBJ1-1,CASSLMGGGGTEAFF,0,1,1,1
TRBV7-9,TRBJ2-7,CASSLTSGDSYKQYF,0,1,1,1
TRBV7-2,TRBJ1-3,CASSLREGGGNTIYF,0,1,1,1
TRBV11-1,TRBJ2-7,CASSLNGGVSYEQYF,0,1,1,1
TRBV7-9,TRBJ2-1,CASSSPTGGLNEHFF,0,1,1,1
TRBV7-9,TRBJ2-7,CASSSDLVKPYEQYF,0,1,1,1
TRBV28,TRBJ2-7,CASSSILAGGYEQYF,0,1,1,1
TRBV5-4,TRBJ2-4,CASSSGQIAKNIQYF,0,1,1,1
TRBV7-2,TRBJ1-3,CASSSSGTGGNTIYF,0,1,1,1
TRBV7-9,TRBJ2-1,CASSWTSGGYNELFF,0,1,1,1
TRBV7-6,TRBJ2-3,CASSLSGGATDTQYF,0,1,1,1
TRBV5-4,TRBJ2-5,CASSLRTGGMETQYF,0,1,1,1
TRBV3-1,TRBJ1-2,CASSLNVRPPRGYTF,0,1,1,1
TRBV11-2,TRBJ1-1,CASSPRMGPFKEAFF,0,1,1,1
TRBV3-1,TRBJ2-5,CASSPPGAPQETQYF,0,1,1,1
TRBV7-9,TRBJ2-7,CASSPPIGTGGEQYF,0,1,1,1
TRBV7-9,TRBJ1-4,CASSPGDTVYEKLFF,0,1,1,1
TRBV28,TRBJ1-4,CASSPPGATNEKLFF,0,1,1,1
TRBV7-9,TRBJ1-5,CASSRSAQGNQPQHF,0,1,1,1
TRBV3-1,TRBJ2-7,CASSRGEGTAYEQYF,0,1,1,1
TRBV7-9,TRBJ2-7,CASSRDRTFSYEQYF,0,1,1,1
TRBV2,TRBJ2-5,CASSRQGAYQETQYF,0,1,1,1
TRBV3-1,TRBJ2-7,CASSHVPSGFYEQYF,0,1,1,1
TRBV7-9,TRBJ2-7,CASSQSRGQSYEQYF,0,1,1,1
TRBV7-3,TRBJ2-1,CASSQLAGSYNEQFF,0,1,1,1
TRBV3-1,TRBJ2-5,CASSQARQPPGTQYF,0,1,1,1
TRBV3-1,TRBJ1-2,CASSQDTGPFYGYTF,0,1,1,1
TRBV7-2,TRBJ2-2,CASSVSGSNTGELFF,0,1,1,1
TRBV9,TRBJ1-5,CASSVSGGANQPQHF,0,1,1,1
TRBV9,TRBJ2-3,CASSVEVRSTDTQYF,0,1,1,1
TRBV3-1,TRBJ2-5,CASSEQRGLGEAQYF,0,1,1,1
TRBV7-6,TRBJ2-6,CASSTPTQGANVLTF,0,1,1,1
TRBV5-4,TRBJ2-7,CASSTGTLSSYEQYF,0,1,1,1
TRBV3-1,TRBJ2-1,CASSTRAVVGNEQFF,0,1,1,1
TRBV7-9,TRBJ2-3,CASSKTSGGIDTQYF,0,1,1,1
TRBV2,TRBJ2-1,CASRGNSGVYNEQFF,0,1,1,1
TRBV28,TRBJ2-2,CASRITGVRTGELFF,0,1,1,1
TRBV12-3/4,TRBJ2-1,CASRVSGYSYNEQFF,0,1,1,1
TRBV2,TRBJ1-5,CASREDRGGNRPQHF,0,1,1,1
TRBV6-2/3/5/6,TRBJ1-5,CASRSEGGSNQPQHF,0,1,1,1
TRBV5-6,TRBJ2-5,CASNPDRAGQETQYF,0,1,1,1
TRBV6-2/3/5/6,TRBJ2-7,CASKPPGQVTYEQYF,0,1,1,1
TRBV12-3/4,TRBJ2-5,CASKPGPQGQETQYF,0,1,1,1
TRBV28,TRBJ1-5,CALGQGAGSNQPQHF,0,1,1,1
TRBV5-1,TRBJ2-7,CASSLSQPSSYEQYF,0,1,1,1
TRBV5-1,TRBJ2-7,CASSLGGTTRWEQYF,0,1,1,1
TRBV5-1,TRBJ2-3,CASSLESGRTDTQYF,0,1,1,1
TRBV5-1,TRBJ1-2,CASSLEQGGDYGYTF,0,1,1,1
TRBV5-1,TRBJ2-3,CASSLGHEAADTQYF,0,1,1,1
TRBV5-1,TRBJ1-1,CASSSKLGDPTEAFF,0,1,1,1
TRBV7-9,TRBJ2-5,CASSWDRPFQETQYF,0,1,1,1
TRBV4-1,TRBJ1-5,CASSQAQMGNQPQHF,0,1,1,1
TRBV4-1,TRBJ2-3,CASSQGLAGQDTQYF,0,1,1,1
TRBV4-3,TRBJ1-5,CASSQGGNSNQPQHF,0,1,1,1
TRBV4-1,TRBJ1-5,CASSQDPGAGQPQHF,0,1,1,1
TRBV4-3,TRBJ1-1,CASSQENQRGTEAFF,0,1,1,1
TRBV5-1,TRBJ2-7,CASSRGTSGVYEQYF,0,1,1,1
TRBV20-1,TRBJ1-2,CSAPKQGTPNYGYTF,0,1,1,1
TRBV20-1,TRBJ2-5,CSARDQRGAAETQHF,0,1,1,1
TRBV20-1,TRBJ2-5,CSARDPSGGKETQYF,0,1,1,1
TRBV20-1,TRBJ2-5,CSAPSLTGPQETQYF,0,1,1,1
TRBV20-1,TRBJ2-1,CSAHKLGGSYNEQFF,0,1,1,1
TRBV20-1,TRBJ1-5,CSEEGKYQFHQPQHF,0,1,1,1
TRBV29-1,TRBJ1-1,CSVEVHGTGYTEAFF,0,1,1,1
TRBV29-1,TRBJ2-7,CSVSRGGTGIYEQYF,0,1,1,1
TRBV29-1,TRBJ2-2,CSGTRGSGNTGELFF,0,1,1,1
TRBV13,TRBJ2-1,GASSPPGLAGSEQFF,0,1,1,1
TRBV10-3,TRBJ2-1,CAISRTETYNEQFF,0,1,1,1
TRBV10-3,TRBJ2-1,CAISDRGTYNEQFF,0,1,1,1
TRBV19,TRBJ1-2,CATSPGPSNYGYTF,0,1,1,1
TRBV24-1,TRBJ2-1,CATSAPRGGNEQFF,0,1,1,1
TRBV24-1,TRBJ2-5,CATSDSDREETQYF,0,1,1,1
TRBV15,TRBJ2-1,CATSVRRVNNEQFF,0,1,1,1
TRBV24-1,TRBJ2-3,CATSGGLSTDTQYF,0,1,1,1
TRBV19,TRBJ1-4,CASSIGAGREKLFF,0,1,1,1
TRBV19,TRBJ1-1,CASSNRGRHTEAFF,0,1,1,1
TRBV19,TRBJ2-7,CASRAPGQEYEQYF,0,1,1,1
TRBV18,TRBJ2-7,CASSPGTVTYERYF,0,1,1,1
TRBV18,TRBJ1-5,CASSQDSSNQPQHF,0,1,1,1
TRBV7-9,TRBJ2-7,CASRGSRGIYEQYF,0,1,1,1
TRBV6-2/3/5/6,TRBJ1-2,CASGLTGANYGYTF,0,1,1,1
TRBV6-2/3/5/6,TRBJ2-7,CASEYGTGVYEQYF,0,1,1,1
TRBV6-2/3/5/6,TRBJ2-3,CASIHGQRTDTQYF,0,1,1,1
TRBV11-3,TRBJ2-5,CASTYQGPEETQYF,0,1,1,1
TRBV12-3/4,TRBJ2-7,CASSLGGQFYEQYF,0,1,1,1
TRBV12-3/4,TRBJ2-2,CASSLLGLTGELFF,0,1,1,1
TRBV11-3,TRBJ2-1,CASSLAGAGNEQFF,0,1,1,1
TRBV12-3/4,TRBJ1-5,CASSLARGNQPQHF,0,1,1,1
TRBV12-3/4,TRBJ2-1,CASSLEINRGEQFF,0,1,1,1
TRBV6-2/3/5/6,TRBJ2-7,CASSLTWGLNEQYF,0,1,1,1
TRBV28,TRBJ1-5,CASSSPPGDQPQHF,0,1,1,1
TRBV28,TRBJ2-5,CASSSQRGLETQYF,0,1,1,1
TRBV7-9,TRBJ2-2,CASSSNPNTGELFF,0,1,1,1
TRBV6-2/3/5/6,TRBJ2-1,CASSYFAEVSEQFF,0,1,1,1
TRBV7-2,TRBJ2-7,CASSLGPGTYEQYF,0,1,1,1
TRBV12-3/4,TRBJ2-3,CASSPRQGGDTQYF,0,1,1,1
TRBV6-1,TRBJ1-4,CASSQPRESEKLFF,0,1,1,1
TRBV6-4,TRBJ2-3,CASSAVGGPDTQYF,0,1,1,1
TRBV25-1,TRBJ1-1,CASSDFPGTLKAFF,0,1,1,1
TRBV7-9,TRBJ1-4,CASSLFATNEKLFF,0,1,1,1
TRBV5-5,TRBJ2-7,CASSLVAQHYEQYF,0,1,1,1
TRBV7-9,TRBJ2-1,CASSLAGPGSEQFF,0,1,1,1
TRBV3-1,TRBJ1-1,CASSLGTGVVRAFF,0,1,1,1
TRBV7-9,TRBJ2-5,CASSLPRGQETQYF,0,1,1,1
TRBV5-4,TRBJ2-5,CASSLRTDQETQYF,0,1,1,1
TRBV7-2,TRBJ1-1,CASSLQGARTEAFF,0,1,1,1
TRBV7-9,TRBJ1-2,CASSLEASNYGYTF,0,1,1,1
TRBV7-2,TRBJ1-6,CASSLENRGSPLHF,0,1,1,1
TRBV7-3,TRBJ2-3,CASSSSWGTDTQYF,0,1,1,1
TRBV7-2,TRBJ2-3,CASSSDRDANTQYF,0,1,1,1
TRBV5-4,TRBJ2-7,CASSSPGGNDEQYF,0,1,1,1
TRBV7-2,TRBJ2-1,CASSLGLSENEQFF,0,1,1,1
TRBV7-9,TRBJ2-7,CASSLGSRSYEQYF,0,1,1,1
TRBV7-3,TRBJ2-5,CASSLTGTAETQYF,0,1,1,1
TRBV9,TRBJ2-7,CASSPWGAAREQYF,0,1,1,1
TRBV5-4,TRBJ2-5,CASSPPGGGETQYF,0,1,1,1
TRBV7-9,TRBJ2-7,CASSPGGGTGQQYF,0,1,1,1
TRBV7-2,TRBJ1-1,CASSPDRLNTEAFF,0,1,1,1
TRBV7-9,TRBJ2-5,CASSHGSGAETQYF,0,1,1,1
TRBV14,TRBJ1-2,CASSQDARGYGYTF,0,1,1,1
TRBV7-9,TRBJ2-3,CASSTRGGTDTQYF,0,1,1,1
TRBV12-3/4,TRBJ2-7,CASRLLQGHYEQCF,0,1,1,1
TRBV6-2/3/5/6,TRBJ2-4,CASRQGGTTNIQYF,0,1,1,1
TRBV6-4,TRBJ2-4,CASRQGGTKNIQYF,0,1,1,1
TRBV7-6,TRBJ2-3,CASRLTGDTDTQYF,0,1,1,1
TRBV27,TRBJ2-7,CASRLGTGSYEQYF,0,1,1,1
TRBV2,TRBJ2-7,CASRAGGVSYEQYF,0,1,1,1
TRBV12-3/4,TRBJ1-1,CASRAIGRGTEAFF,0,1,1,1
TRBV2,TRBJ2-7,CASRTTGAGDEQYF,0,1,1,1
TRBV12-3/4,TRBJ2-1,CASNRLASYNEQFF,0,1,1,1
TRBV12-3/4,TRBJ1-5,CASKRQGPNQPQHF,0,1,1,1
TRBV5-4,TRBJ2-5,CARSRDTASETQYF,0,1,1,1
TRBV12-3/4,TRBJ1-5,CTSSLGTDNQPQHF,0,1,1,1
TRBV5-1,TRBJ1-1,CASGQGGLKTEAFF,0,1,1,1
TRBV7-2,TRBJ2-3,CASIRDRVTDTQYF,0,1,1,1
TRBV5-1,TRBJ1-4,CASSFARNNEKLFF,0,1,1,1
TRBV5-1,TRBJ1-2,CASSFGKSYYGYTF,0,1,1,1
TRBV5-1,TRBJ2-5,CASSLGANQETQYF,0,1,1,1
TRBV5-1,TRBJ2-5,CASSLTGIRETQYF,0,1,1,1
TRBV5-1,TRBJ2-5,CASSLQGYQETQYF,0,1,1,1
TRBV5-1,TRBJ1-1,CASSLQLGDTEAFF,0,1,1,1
TRBV4-3,TRBJ1-2,CASSQDEASNGYTF,0,1,1,1
TRBV20-1,TRBJ2-1,CSAPDSSSYNEQFF,0,1,1,1
TRBV20-1,TRBJ1-5,CSASPVGSNQPQHF,0,1,1,1
TRBV20-1,TRBJ1-5,CSARLAGGDQPQHF,0,1,1,1
TRBV20-1,TRBJ2-7,CSARQETGSYEQYF,0,1,1,1
TRBV20-1,TRBJ2-2,CSARVPKNTGELFF,0,1,1,1
TRBV20-1,TRBJ2-1,CSASGQGAYNELFF,0,1,1,1
TRBV20-1,TRBJ1-1,CSAPIFGQSTEAFF,0,1,1,1
TRBV29-1,TRBJ1-2,CSVVSYRTNYGYTF,0,1,1,1
TRBV29-1,TRBJ1-6,CSVATGGNNSPLHF,0,1,1,1
TRBV29-1,TRBJ2-2,CSVEERGNTGELFF,0,1,1,1
TRBV29-1,TRBJ2-4,CSASDRGTKNIQYF,0,1,1,1
TRBV12-5,TRBJ1-6,CASGSRNYSPLHF,0,1,1,1
TRBV2,TRBJ1-1,CASPRDRRTEAFF,0,1,1,1
TRBV30,TRBJ2-5,CAWMTGGRETQYF,0,1,1,1
TRBV30,TRBJ1-2,CAWTPGLGHGYTF,0,1,1,1
TRBV30,TRBJ1-5,CAWTQQRNQPQHF,0,1,1,1
TRBV30,TRBJ1-2,CAWSVQGNYGYTF,0,1,1,1
TRBV30,TRBJ1-2,CAWSVKGMGGYTL,0,1,1,1
TRBV30,TRBJ2-5,CAWSEGYQETQYF,0,1,1,1
TRBV30,TRBJ1-1,CAWSEGGPTEAFF,0,1,1,1
TRBV10-3,TRBJ1-4,CAIRDGTHEKLFF,0,1,1,1
TRBV19,TRBJ1-1,CATRGTITTEAFF,0,1,1,1
TRBV24-1,TRBJ1-1,CATRAAGREEAFF,0,1,1,1
TRBV24-1,TRBJ1-1,CATRTGDRPEAFF,0,1,1,1
TRBV19,TRBJ1-4,CASATGRGEKLFF,0,1,1,1
TRBV19,TRBJ2-7,CASSTVSGGEQYF,0,1,1,1
TRBV18,TRBJ2-7,CASSPDIGSEQYF,0,1,1,1
TRBV18,TRBJ1-1,CASPHDADTEAFF,0,1,1,1
TRBV6-2/3/5/6,TRBJ1-1,CASTQGPDTEAFF,0,1,1,1
TRBV6-1,TRBJ1-1,CASTEGDSTEAFF,0,1,1,1
TRBV6-2/3/5/6,TRBJ2-7,CASSFRVVDEQYF,0,1,1,1
TRBV6-2/3/5/6,TRBJ1-2,CASSLVREDGFTF,0,1,1,1
TRBV12-3/4,TRBJ1-2,CASSLAGTGGYTF,0,1,1,1
TRBV12-3/4,TRBJ2-1,CASSYYLDWEQFF,0,1,1,1
TRBV6-2/3/5/6,TRBJ1-1,CASSYAENTEAFF,0,1,1,1
TRBV27,TRBJ1-2,CASSPQETYGYTF,0,1,1,1
TRBV28,TRBJ2-7,CASSRGGKDEQYF,0,1,1,1
TRBV2,TRBJ2-5,CASSEDLQETQYF,0,1,1,1
TRBV6-1,TRBJ1-2,CASSKGQGLGYTF,0,1,1,1
TRBV5-6,TRBJ2-3,CASSLWYVDTQYF,0,1,1,1
TRBV5-5,TRBJ1-5,CASSLQRDQPQHF,0,1,1,1
TRBV7-3,TRBJ2-3,CASSLLVSDTQYF,0,1,1,1
TRBV11-1,TRBJ2-1,CASSLVRHNEQFF,0,1,1,1
TRBV7-9,TRBJ2-1,CASSLAGTGQQFF,0,1,1,1
TRBV7-9,TRBJ2-7,CASSLAGAYEQYF,0,1,1,1
TRBV7-9,TRBJ2-3,CASSLAGGDTQYF,0,1,1,1
TRBV7-2,TRBJ1-1,CASSLGPITEAFF,0,1,1,1
TRBV7-9,TRBJ2-1,CASSLGGYNEQFF,0,1,1,1
TRBV7-2,TRBJ1-2,CASSLDGVGGYTF,0,1,1,1
TRBV7-3,TRBJ1-1,CASSLELNTEAFF,0,1,1,1
TRBV7-8,TRBJ1-1,CASSLEGGTEAFF,0,1,1,1
TRBV7-2,TRBJ2-3,CASSLSYTDTQYF,0,1,1,1
TRBV7-2,TRBJ2-1,CASSSDFGNEQFF,0,1,1,1
TRBV3-1,TRBJ2-3,CASSLRAQDTQYF,0,1,1,1
TRBV12-3/4,TRBJ1-2,CASSLTGVGGYTF,0,1,1,1
TRBV7-6,TRBJ2-7,CASSPDRAREQYF,0,1,1,1
TRBV7-9,TRBJ2-7,CASSPDHTTKQYF,0,1,1,1
TRBV6-2/3/5/6,TRBJ2-5,CASSRDSQETQYF,0,1,1,1
TRBV3-1,TRBJ2-7,CASSQSFLDEQYF,0,1,1,1
TRBV9,TRBJ2-7,CASSVGDSYEQYF,0,1,1,1
TRBV9,TRBJ1-2,CASSVAANYGYTF,0,1,1,1
TRBV9,TRBJ1-1,CASSVGSGTEAFF,0,1,1,1
TRBV5-4,TRBJ2-1,CASSGWGLGEQFF,0,1,1,1
TRBV12-3/4,TRBJ1-4,CASSIRTGEKLFF,0,1,1,1
TRBV6-2/3/5/6,TRBJ2-3,CASSKGRTDTQYF,0,1,1,1
TRBV12-3/4,TRBJ1-1,CASRTGLYTEAFF,0,1,1,1
TRBV3-1,TRBJ1-6,CASRQGVNSPLHF,0,1,1,1
TRBV6-2/3/5/6,TRBJ1-4,CASNLRSNEKLFF,0,1,1,1
TRBV2,TRBJ2-1,CASNPMSYNEQFF,0,1,1,1
TRBV5-1,TRBJ1-2,CASILDVNFGYTF,0,1,1,1
TRBV5-1,TRBJ2-1,CASSLVENNEQYF,0,1,1,1
TRBV5-1,TRBJ2-1,CASSLGTSNEQFF,0,1,1,1
TRBV5-1,TRBJ2-1,CASSSDVLTGQFF,0,1,1,1
TRBV4-1,TRBJ1-4,CASSQDSTEKLFF,0,1,1,1
TRBV5-1,TRBJ2-5,CASSVQGQETQYF,0,1,1,1
TRBV5-1,TRBJ2-2,CASSDTRTGELFF,0,1,1,1
TRBV5-1,TRBJ1-5,CASRRDSNQPQHF,0,1,1,1
TRBV10-2,TRBJ1-2,CASKSGQDYGYTF,0,1,1,1
TRBV20-1,TRBJ2-7,CSASGLGQGEQYF,0,1,1,1
TRBV20-1,TRBJ1-1,CSATSRGNTEAFF,0,1,1,1
TRBV20-1,TRBJ1-1,CSARLGGDTEAFF,0,1,1,1
TRBV20-1,TRBJ1-4,CSARSGSTEKLFF,0,1,1,1
TRBV20-1,TRBJ2-3,CSARVAPEDTQYF,0,1,1,1
TRBV20-1,TRBJ2-4,CSARDDSENIQYF,0,1,1,1
TRBV20-1,TRBJ2-4,CSAREGLMGIQYF,0,1,1,1
TRBV20-1,TRBJ1-2,CSAHRDRVDGYTF,0,1,1,1
TRBV20-1,TRBJ2-6,CSARVSGANVLTF,0,1,1,1
TRBV20-1,TRBJ2-3,CSTSSVGADTQYF,0,1,1,1
TRBV29-1,TRBJ1-5,CSVREGRDQPQHF,0,1,1,1
TRBV29-1,TRBJ2-3,CSVVWGGGYTQYF,0,1,1,1
TRBV29-1,TRBJ2-3,CSVGGGGTDTQYF,0,1,1,1
TRBV29-1,TRBJ2-3,CSVGLGGTDTQYF,0,1,1,1
TRBV29-1,TRBJ2-1,CSVDPLTYNEQFF,0,1,1,1
TRBV29-1,TRBJ1-2,CSVEKFGGYGYTF,0,1,1,1
TRBV29-1,TRBJ1-5,CSVGDRSNQPQHF,0,1,1,1
TRBV29-1,TRBJ2-4,CSTSQGAMDIQYF,0,1,1,1
TRBV12-5,TRBJ2-7,CASGLTFYEQYF,0,1,1,1
TRBV30,TRBJ2-7,CAWTDRSYEQYF,0,1,1,1
TRBV30,TRBJ2-4,CAWSGQVNIQYF,0,1,1,1
TRBV10-3,TRBJ2-5,CAVRDSQETQYF,0,1,1,1
TRBV10-3,TRBJ2-7,CAISDQTYEQYF,0,1,1,1
TRBV2,TRBJ2-7,CATSASSYEQYF,0,1,1,1
TRBV2,TRBJ2-4,CATQGAGDIQYF,0,1,1,1
TRBV7-9,TRBJ2-3,CASGGSTDTQYF,0,1,1,1
TRBV6-2/3/5/6,TRBJ2-5,CASEGVGETQYF,0,1,1,1
TRBV12-3/4,TRBJ2-1,CASSFPGNEQFF,0,1,1,1
TRBV12-3/4,TRBJ2-7,CASSFTITEQYF,0,1,1,1
TRBV6-2/3/5/6,TRBJ1-2,CASSFRGYGYTF,0,1,1,1
TRBV12-3/4,TRBJ2-1,CASSLRGFEQFF,0,1,1,1
TRBV7-9,TRBJ2-7,CASSGGVDEQYF,0,1,1,1
TRBV6-1,TRBJ2-7,CASSGRPYEQYF,0,1,1,1
TRBV13,TRBJ2-1,CASSFRSNEQFF,0,1,1,1
TRBV11-2,TRBJ2-1,CASSLQRGEQFF,0,1,1,1
TRBV7-9,TRBJ2-1,CASSLGRNEQFF,0,1,1,1
TRBV11-2,TRBJ2-3,CASSLDRDTQYF,0,1,1,1
TRBV5-4,TRBJ1-2,CASSSPGRGYTF,0,1,1,1
TRBV7-2,TRBJ1-4,CASSYPNEKLFF,0,1,1,1
TRBV12-3/4,TRBJ2-7,CASSLGPYEQYF,0,1,1,1
TRBV12-3/4,TRBJ2-7,CASSPSGVWQYF,0,1,1,1
TRBV7-9,TRBJ1-1,CASSQGLGEAFF,0,1,1,1
TRBV25-1,TRBJ2-7,CASSNRSYEQYF,0,1,1,1
TRBV12-3/4,TRBJ2-5,CASRAGQETQYF,0,1,1,1
TRBV12-3/4,TRBJ1-2,CASNRERWGYTF,0,1,1,1
TRBV5-1,TRBJ2-5,CASIRGQETQYF,0,1,1,1
TRBV5-1,TRBJ2-5,CASSFFQETQYF,0,1,1,1
TRBV20-1,TRBJ1-1,CSAPTEYTEAFF,0,1,1,1
TRBV20-1,TRBJ2-5,CSASRAQETQYF,0,1,1,1
TRBV20-1,TRBJ2-3,CSARDMRDTQYF,0,1,1,1
TRBV29-1,TRBJ2-7,CSVGQGAREQYF,0,1,1,1
TRBV29-1,TRBJ2-1,CSVVDLPNEQFF,0,1,1,1
TRBV29-1,TRBJ2-1,CSAFPGQALQFF,0,1,1,1
TRBV7-3,TRBJ2-1,RASSHNLGEQFF,0,1,1,1
TRBV30,TRBJ1-5,CAWRGLRLGAF,0,1,1,1
TRBV24-1,TRBJ2-5,CATSDLGTQYF,0,1,1,1
TRBV18,TRBJ1-1,CASSTQGEAFF,0,1,1,1
TRBV12-3/4,TRBJ1-2,CASSPGLGYTF,0,1,1,1
TRBV7-2,TRBJ2-7,CASSLKYEQYF,0,1,1,1
TRBV6-2/3/5/6,TRBJ2-7,CASSQTYEQYF,0,1,1,1
TRBV14,TRBJ1-1,CASSQGVEAFF,0,1,1,1
TRBV6-2/3/5/6,TRBJ1-4,CASRAPEKLFF,0,1,1,1
TRBV29-1,TRBJ1-2,CSVLGQHGYTF,0,1,1,1
TRBV29-1,TRBJ2-2,CSAGEAGELFF,0,1,1,1
