v_hit,j_hit,cdr3,S4-10ng_S9,S4-10ng_S21,freq,count_sum
TRAV26-2,TRAJ39,CIPLDGNAGNMLTF,223,353,2,576
TRAV13-1,TRAJ54,CASPPLQGAQKLVF,181,271,2,452
TRAV12-2,TRAJ20,CAVRPNDYKLSF,85,88,2,173
TRAV41,TRAJ52,CAVSTSYGKLTF,84,116,2,200
TRAV41,TRAJ54,CAVSRPRDLIIQGAQKLVF,79,136,2,215
TRAV26-2,TRAJ57,CILSPRGGQGGSEKLVF,65,104,2,169
TRAV24,TRAJ4,CASGGYNKLIF,39,63,2,102
TRAV21,TRAJ57,CAVRRPRDFITQGGSEKLVF,37,73,2,110
TRAV12-1,TRAJ3,CVVNKGRDLYSSASKIIF,34,39,2,73
TRAV8-6,TRAJ58,CAASETSGSRLTF,34,29,2,63
TRAV12-2,TRAJ52,CAVKRARDAGGTSYGKLTF,30,43,2,73
TRAV13-1,TRAJ22,CAAPTTGSARQLTF,28,0,1,28
TRAV30,TRAJ31,CGTEKHNARLMF,28,0,1,28
TRAV10,TRAJ38,CVVSGNNAGNNRKLIW,30,0,1,30
TRAV29DV5,TRAJ17,CAASAREIAGNKLTF,25,23,2,48
TRAV16,TRAJ37,CALSRSNTGKLIF,25,0,1,25
TRAV41,TRAJ22,CAVKPPRDQISSGSARQLTF,24,94,2,118
TRAV9-2,TRAJ52,CALANAGGTSYGKLTF,24,0,1,24
TRAV34,TRAJ57,CGADPEGGSEKLVF,24,14,2,38
TRAV13-1,TRAJ11,CAASTRYSTLTF,22,0,1,22
TRAV38-1,TRAJ35,CAFMAIGFGNVLHC,22,0,1,22
TRAV20,TRAJ48,CAVRFGNEKLTF,21,0,1,21
TRAV12-2,TRAJ6,CAARGGSYIPTF,21,58,2,79
TRAV14DV4,TRAJ8,CAMRESREKGFQKLVF,20,29,2,49
TRAV10,TRAJ47,CVVSVGREYGNKLVF,19,35,2,54
TRAV35,TRAJ52,CAGQPPGGGTSYGKLTF,19,0,1,19
TRAV38-2DV8,TRAJ56,CAYRREGHYTGANSKLTF,19,0,1,19
TRAV19,TRAJ42,CALSEARDGGSQGNLIF,18,0,1,18
TRAV12-2,TRAJ53,CAVNEGRDSGGSNYKLTF,17,78,2,95
TRAV17,TRAJ49,CATDAGNQFYF,17,0,1,17
TRAV36DV7,TRAJ29,CAVGTFSYSGNTPLVF,17,0,1,17
TRAV19,TRAJ45,CALSEYIGGGGADGLTF,16,0,1,16
TRAV13-1,TRAJ6,CAASSSGGSYIPTF,16,0,1,16
TRAV4,TRAJ37,CLVGLQLPSNTGKLIF,16,0,1,16
TRAV12-2,TRAJ12,CAVLMDSSYKLIF,16,0,1,16
TRAV14DV4,TRAJ32,CAMRVRENYGGATNKLIF,15,0,1,15
TRAV9-2,TRAJ42,CALSSGGSQGNLIF,15,0,1,15
TRAV21,TRAJ36,CAVSWRPGANNLFF,15,0,1,15
TRAV12-1,TRAJ29,CVVTFSGNTPLVF,15,0,1,15
TRAV19,TRAJ34,CALRGYNTDKLIF,15,0,1,15
TRAV21,TRAJ36,CAVPGANNLFF,15,0,1,15
TRAV17,TRAJ20,CATDDYKLSF,15,0,1,15
TRAV13-1,TRAJ30,CAASTGDDKIIF,15,0,1,15
TRAV8-3,TRAJ48,CAVGRTF,15,0,1,15
TRAV41,TRAJ45,CAVRKYSGGGADGLTF,15,35,2,50
TRAV9-2,TRAJ29,CALSDRSGNTPLVF,14,0,1,14
TRAV12-1,TRAJ52,CVVKRGRDAGGTSYGKLTF,14,24,2,38
TRAV30,TRAJ23,CGTEIPSGIYNQGGKLIF,14,9,2,23
TRAV12-2,TRAJ58,CAVNRGRETSGSRLTF,14,27,2,41
TRAV38-1,TRAJ10,CAFMTAGGGNKLTF,14,0,1,14
TRAV8-3,TRAJ34,CAVGAFGNTDKLIF,14,0,1,14
TRAV16,TRAJ3,CALSGRSSASKIIF,14,0,1,14
TRAV13-1,TRAJ47,CAAETEYGNKLVF,14,0,1,14
TRAV27,TRAJ58,CAGEETSGSRLTF,14,0,1,14
TRAV14DV4,TRAJ5,CAMRESQDTGRRALTF,14,2,2,16
TRAV19,TRAJ37,CALSFHSSNTGKLIF,14,0,1,14
TRAV20,TRAJ44,CAVPLNTGTASKLTF,13,0,1,13
TRAV14DV4,TRAJ27,CAMRGPNAGKSTF,13,0,1,13
TRAV16,TRAJ53,CALGGSNYKLTF,13,0,1,13
TRAV16,TRAJ43,CALRVLNDMRF,13,0,1,13
TRAV27,TRAJ16,CAGAVSDGQKLLF,13,0,1,13
TRAV9-2,TRAJ10,CALTPGSILTGGGNKLTF,12,0,1,12
TRAV26-2,TRAJ53,CILRDGANSGGSNYKLTF,12,0,1,12
TRAV41,TRAJ52,CADPNAGGTSYGKLTF,12,0,1,12
TRAV38-1,TRAJ28,CAFLNSGAGSYQLTF,12,0,1,12
TRAV19,TRAJ15,CALSEANQAGTALIF,12,0,1,12
TRAV21,TRAJ15,CAVRRPNQAGTALIF,12,6,2,18
TRAV19,TRAJ29,CALSGEGGNTPLVF,12,14,2,26
TRAV12-3,TRAJ57,CAMSAQGGSEKLVF,12,0,1,12
TRAV19,TRAJ13,CALLIGGYQKVTF,12,0,1,12
TRAV17,TRAJ33,CATGLLGNYQLIW,12,0,1,12
TRAV13-1,TRAJ34,CAASRGNTDKLIF,12,0,1,12
TRAV25,TRAJ48,CAGRGFGNEKLTF,12,0,1,12
TRAV30,TRAJ42,CGTPERSQGNLIF,12,0,1,12
TRAV12-1,TRAJ27,CVVNTNAGKSTF,12,0,1,12
TRAV16,TRAJ11,CALSDEYSTLTF,12,0,1,12
TRAV20,TRAJ21,CAVRDNFNKFYF,12,3,2,15
TRAV13-1,TRAJ36,CAASDWANNLFF,12,0,1,12
TRAV24,TRAJ48,CAFSKEKLTF,12,0,1,12
TRAV21,TRAJ37,CAVRMKSSNTGKLIF,12,0,1,12
TRAV13-1,TRAJ10,CAPGRGGGNKLTF,12,0,1,12
TRAV16,TRAJ57,CALSGRRGGSEKLVF,12,0,1,12
TRAV12-2,TRAJ18,CAVISDDRGSTLGRLYF,11,0,1,11
TRAV2,TRAJ9,CAVEDQGAGGFKTIF,11,0,1,11
TRAV13-1,TRAJ18,CAADDRGSTLGRLYF,11,0,1,11
TRAV38-1,TRAJ56,CAYGGEGANSKLTF,11,0,1,11
TRAV9-2,TRAJ38,CALHNAGNNRKLIW,11,3,2,14
TRAV5,TRAJ38,CARDNAGNNRKLIW,11,0,1,11
TRAV36DV7,TRAJ48,CAVELNFGNEKLTF,11,0,1,11
TRAV12-1,TRAJ42,CASHRGGSQGNLIF,11,0,1,11
TRAV12-3,TRAJ4,CAMTFSGGYNKLIF,11,0,1,11
TRAV10,TRAJ23,CVVSPNQGGKLIF,11,0,1,11
TRAV10,TRAJ49,CVVSGSTGNQFYF,11,0,1,11
TRAV3,TRAJ6,CAVREGGSYIPTF,11,0,1,11
TRAV12-2,TRAJ9,CAAPNTGGFKTIF,11,0,1,11
TRAV24,TRAJ6,CAILEGGSYIPTF,11,0,1,11
TRAV12-1,TRAJ40,CVVRRGTYKYIF,11,0,1,11
TRAV38-2DV8,TRAJ32,CAYSGATNKLIF,11,10,2,21
TRAV10,TRAJ6,CVVSRSYIPTF,11,0,1,11
TRAV38-2DV8,TRAJ49,CAYHTGNQFYF,11,0,1,11
TRAV27,TRAJ44,CAGETGTASKLTF,11,0,1,11
TRAV16,TRAJ10,CAPLGGLTGGGNKLTF,11,0,1,11
TRAV19,TRAJ26,CALSEGSYGQNFVF,11,0,1,11
TRAV12-3,TRAJ29,CAMSANSGNTPLVF,11,0,1,11
TRAV39,TRAJ49,CAVSYTTGNEFYF,11,0,1,11
TRAV13-1,TRAJ13,CAAIPNSGGYQKVTF,11,0,1,11
TRAV9-2,TRAJ36,CALVQTGANNLFS,11,0,1,11
TRAV19,TRAJ48,CALSAPRSNFGNEKLTF,10,0,1,10
TRAV41,TRAJ53,CAVRGWNSGGSNYKLTF,10,14,2,24
TRAV12-2,TRAJ56,CAVNNPGAGANSKLTF,10,0,1,10
TRAV38-1,TRAJ40,CAFMKIDSGTYKYIF,10,0,1,10
TRAV16,TRAJ54,CALRDPIQGAQKLVF,10,0,1,10
TRAV35,TRAJ32,CAGRSYGGATNKLIF,10,0,1,10
TRAV26-1,TRAJ23,CIVRVLYNQGGKLIF,10,0,1,10
TRAV9-2,TRAJ9,CALSSNTGGFKTIF,10,0,1,10
TRAV13-1,TRAJ6,CAAWESGGSYIPTF,10,0,1,10
TRAV13-1,TRAJ4,CAASNTGGYNKLIF,10,5,2,15
TRAV12-3,TRAJ37,CAMSRSSNTGKLIF,10,0,1,10
TRAV26-2,TRAJ13,CILRDAGGYQKVTF,10,8,2,18
TRAV12-1,TRAJ36,CVVIPTGANNLFF,10,0,1,10
TRAV41,TRAJ34,CAVSQYNTDKLIF,10,0,1,10
TRAV17,TRAJ13,CATDGGGYQKVTF,10,0,1,10
TRAV24,TRAJ11,CAFPDSGYSTLTF,10,0,1,10
TRAV13-1,TRAJ9,CAASKPGGFKTIF,10,0,1,10
TRAV30,TRAJ36,CGTDPAGANNLFF,10,0,1,10
TRAV38-2DV8,TRAJ31,CAYRVNNARLMF,10,0,1,10
TRAV3,TRAJ21,CAVRDIFNKFYF,10,0,1,10
TRAV27,TRAJ26,CAGDNYGQNFVF,10,19,2,29
TRAV13-1,TRAJ43,CAASVNDMRF,10,0,1,10
TRAV29DV5,TRAJ37,CAASSMRGGNTGKLIF,10,0,1,10
TRAV21,TRAJ22,CAGSISSGSARQLTF,10,0,1,10
TRAV9-2,TRAJ27,CALSGGTNAGKSTF,10,0,1,10
TRAV30,TRAJ5,YGTEREDTGRRALTF,10,0,1,10
TRAV12-3,TRAJ58,CAMKETSGSRLTF,10,0,1,10
TRAV9-2,TRAJ13,CALSGGSGGYQKVTF,10,0,1,10
TRAV41,TRAJ40,CAVTSGTYKYIL,10,0,1,10
TRAV36DV7,TRAJ52,CAVEAPRKAGGTSYGKLTF,9,0,1,9
TRAV38-2DV8,TRAJ57,CAYKGEDQGGSEKLVF,9,0,1,9
TRAV12-2,TRAJ16,CAVNPKPFSDGQKLLF,9,0,1,9
TRAV13-1,TRAJ53,CAASIQSGGSNYKLTF,9,0,1,9
TRAV19,TRAJ53,CALSDLGGSNYKLTF,9,0,1,9
TRAV12-1,TRAJ48,CVVTINFGNEKLTF,9,0,1,9
TRAV38-2DV8,TRAJ29,CAYRSKSGNTPLVF,9,0,1,9
TRAV9-2,TRAJ27,CALSSNTNAGKSTF,9,0,1,9
TRAV9-2,TRAJ27,CALSANTNAGKSTF,9,0,1,9
TRAV20,TRAJ13,CAVQPSGGYQKVTF,9,0,1,9
TRAV22,TRAJ31,CAVEQSYNNARLMF,9,0,1,9
TRAV3,TRAJ27,CAVRVNTNAGKSTF,9,8,2,17
TRAV8-1,TRAJ45,CAVTSGGGADGLTF,9,0,1,9
TRAV23DV6,TRAJ58,CAARKETSGSRLTF,9,0,1,9
TRAV13-2,TRAJ10,CAERTTGGGNKLTF,9,0,1,9
TRAV13-2,TRAJ10,CAENPGGGGNKLTF,9,0,1,9
TRAV12-3,TRAJ48,CAMTTLFGNEKLTF,9,0,1,9
TRAV14DV4,TRAJ54,CAMREIQGAQKLVF,9,0,1,9
TRAV4,TRAJ8,CLVGGRTGFQKLVF,9,0,1,9
TRAV26-1,TRAJ27,CIVRVSTNAGKSTF,9,0,1,9
TRAV9-2,TRAJ47,CALSDRYGNKLVF,9,0,1,9
TRAV8-3,TRAJ10,CAVESGGGNKLTF,9,0,1,9
TRAV3,TRAJ3,CAVRDSSASKIIF,12,0,1,12
TRAV39,TRAJ26,CAVDKDYGQNFVF,9,0,1,9
TRAV5,TRAJ33,CAERRDSNYQLIW,9,0,1,9
TRAV4,TRAJ30,CLVVGNRDDKIIF,9,0,1,9
TRAV16,TRAJ26,CVLRDYGQNFVF,9,0,1,9
TRAV2,TRAJ16,CAVEEDGQKLLF,9,0,1,9
TRAV20,TRAJ30,CAARNRDDKIIF,9,0,1,9
TRAV17,TRAJ53,CADGGSNYKLTF,9,0,1,9
TRAV5,TRAJ39,CAEYDAGNMLTF,9,0,1,9
TRAV13-2,TRAJ40,CAETTGTYKYIF,9,0,1,9
TRAV9-2,TRAJ27,CALPPRGKSTF,9,0,1,9
TRAV13-1,TRAJ27,CAASRAGKSTF,9,0,1,9
TRAV19,TRAJ16,CALSGLLF,9,0,1,9
TRAV22,TRAJ56,CPTLAF,9,0,1,9
TRAV23DV6,TRAJ13,CAASNSRLGNSGGYQKVTF,9,0,1,9
TRAV17,TRAJ37,CATVYLGNTGKLIF,9,0,1,9
TRAV39,TRAJ47,CAVDLMEYGNKLVF,9,0,1,9
TRAV14DV4,TRAJ52,CAMRESGRNAGGTSYGKLTF,9,0,1,9
TRAV12-3,TRAJ42,CAMGGGSQGNLIF,9,0,1,9
TRAV12-1,TRAJ5,CVVGGGRRALTF,9,7,2,16
TRAV26-1,TRAJ13,CIVRVVNSGGYQKVTF,9,0,1,9
TRAV29DV5,TRAJ6,CAASGATGGSYIPTF,9,0,1,9
TRAV4,TRAJ42,CLVGEHGGSQGNLIF,9,0,1,9
TRAV21,TRAJ57,CAVMLLRDASAITQGGSEKLVF,9,16,2,25
TRAV41,TRAJ53,CAVRLNSGGSNYKLTL,9,0,1,9
TRAV9-2,TRAJ54,CALSDRGGAQRLVF,9,0,1,9
TRAV9-2,TRAJ5,CALEDTGRRALTF,9,0,1,9
TRAV38-2DV8,TRAJ28,CAYLAYSGAGSYQLTF,8,0,1,8
TRAV36DV7,TRAJ54,CAVVNREIQGAQKLVF,8,0,1,8
TRAV21,TRAJ42,CAVSSGYGGSQGNLIF,8,0,1,8
TRAV17,TRAJ52,CATDGTGGTSYGKLTF,8,0,1,8
TRAV12-1,TRAJ24,CVVNGEPDSWGKFQF,8,0,1,8
TRAV12-1,TRAJ30,CVVNKGRNRDDKIIF,8,0,1,8
TRAV38-2DV8,TRAJ38,CAYPYNAGNNRKLIW,8,0,1,8
TRAV9-2,TRAJ49,CALSSGTNTGNQFYF,8,0,1,8
TRAV41,TRAJ26,CAVRSGDNYGQNFVF,8,0,1,8
TRAV3,TRAJ13,CAVSGYSGGYQKVTF,8,0,1,8
TRAV17,TRAJ4,CATDLSSGGYNKLIF,8,0,1,8
TRAV8-1,TRAJ36,CAVNRPLTGANNLFF,8,0,1,8
TRAV12-2,TRAJ10,CAVKGVTGGGNKLTF,8,0,1,8
TRAV13-1,TRAJ17,CAASPAWGAGNKLTF,8,0,1,8
TRAV13-2,TRAJ52,CAENAGGTSYGKLTF,8,0,1,8
TRAV12-3,TRAJ29,CAMTDASSGNTPLVF,8,0,1,8
TRAV14DV4,TRAJ49,CAMREGANTGNQFYF,8,0,1,8
TRAV30,TRAJ29,CGTEIIGSGNTPLVF,8,0,1,8
TRAV10,TRAJ4,CVVSPQGGYSKLIF,8,0,1,8
TRAV12-1,TRAJ48,CVVRGNFGNEKLTF,8,26,2,34
TRAV9-2,TRAJ39,CALGRNNAGNMLTF,8,0,1,8
TRAV21,TRAJ21,CAVWDIDNFNKFYF,8,7,2,15
TRAV8-1,TRAJ38,CAVLNAGNNRKLIW,8,2,2,10
TRAV5,TRAJ22,CAEKSSGSARQLTF,8,0,1,8
TRAV12-3,TRAJ56,CAMSATGANSKLTF,8,0,1,8
TRAV26-2,TRAJ27,CPWGLEANAGKSTF,8,0,1,8
TRAV19,TRAJ57,CVPPQGGSEKLVF,8,0,1,8
TRAV9-2,TRAJ54,CALSDQGAQKLVF,8,2,2,10
TRAV16,TRAJ23,CALSIYQGGKLIF,8,0,1,8
TRAV6,TRAJ11,CAPEGAGYSTLTF,8,0,1,8
TRAV20,TRAJ29,CAVKNSGNTPLVF,8,0,1,8
TRAV8-3,TRAJ8,CAVAPPGFQKLVF,8,0,1,8
TRAV8-1,TRAJ4,CAVFSGGYNKLIF,8,0,1,8
TRAV26-2,TRAJ58,CILRETSGSRLTF,8,0,1,8
TRAV19,TRAJ20,CALRIPDYKLSF,8,0,1,8
TRAV9-2,TRAJ26,CALKGYGQNFVF,8,0,1,8
TRAV8-3,TRAJ43,CAVVRGNNDMRF,8,0,1,8
TRAV24,TRAJ48,CAFNFGNEKLTF,8,0,1,8
TRAV13-1,TRAJ41,CAASTSGYALNF,8,0,1,8
TRAV27,TRAJ21,CAGVYNFNKFYF,8,0,1,8
TRAV4,TRAJ33,CLVGDSNYQLIW,8,0,1,8
TRAV22,TRAJ40,CAVLRTYKYIF,8,0,1,8
TRAV34,TRAJ43,CGAAPRNDMRF,8,0,1,8
TRAV4,TRAJ43,CLVGERDMRF,8,0,1,8
TRAV13-1,TRAJ22,CAARGVGSSGSARQLTF,8,0,1,8
TRAV12-2,TRAJ57,CAVDNRARGGSEKLVF,8,0,1,8
TRAV8-4,TRAJ6,CAVSVLSGGSYIPTF,8,0,1,8
TRAV12-2,TRAJ9,CAARVITGGFKTIF,8,0,1,8
TRAV8-4,TRAJ48,CAVLNFGNEKLTF,8,0,1,8
TRAV12-3,TRAJ49,CAMSAAGNQFYF,8,0,1,8
TRAV17,TRAJ45,CATDDGGYSGGGADGLTF,8,0,1,8
TRAV2,TRAJ32,CAVGGATNKLIF,8,0,1,8
TRAV38-2DV8,TRAJ42,CAYRSAWQGGSQGNLIF,7,0,1,7
TRAV13-2,TRAJ45,CAEKVGYSGGGADGLTF,7,0,1,7
TRAV12-3,TRAJ39,CAMSEARFSNAGNMLTF,7,0,1,7
TRAV9-2,TRAJ52,CALYEAGGTSYGELTF,7,0,1,7
TRAV23DV6,TRAJ32,CAARGNYGGATNKLIF,7,0,1,7
TRAV38-2DV8,TRAJ42,CAFNNYGGSQGNLIF,7,4,2,11
TRAV38-1,TRAJ39,CAFMSANNAGNMLTF,7,0,1,7
TRAV38-2DV8,TRAJ52,CAYLAGGTSYGKLTF,7,0,1,7
TRAV9-2,TRAJ54,CALSDSGQGAQKLVF,7,0,1,7
TRAV9-2,TRAJ39,CALSDRSNAGNMLTF,7,0,1,7
TRAV9-2,TRAJ56,CALSDDSGANSKLTF,7,0,1,7
TRAV8-3,TRAJ5,CAVGAGDTGRRALTF,7,0,1,7
TRAV2,TRAJ17,CAVEDPRAAGNKLTF,7,0,1,7
TRAV21,TRAJ53,CAVNPRGGSNYKLTF,7,0,1,7
TRAV17,TRAJ47,CATDAMAEYGNKLVF,7,0,1,7
TRAV13-1,TRAJ13,CAASRNSGGYQKVTF,11,0,1,11
TRAV13-1,TRAJ53,CAASNSGGSNYKLTF,7,0,1,7
TRAV25,TRAJ37,CAGHPETGNTGKLIF,7,0,1,7
TRAV14DV4,TRAJ13,CAMSEHGRGYQKVTF,7,0,1,7
TRAV14DV4,TRAJ15,CAMREPNQAGTALIF,7,0,1,7
TRAV26-1,TRAJ40,CIVRGTTSGTYKYIF,7,0,1,7
TRAV38-2DV8,TRAJ28,CAYIPGAGSYQLTF,7,0,1,7
TRAV9-2,TRAJ5,CALYGGTGRRALTF,7,0,1,7
TRAV16,TRAJ3,CALSGHSSASKIIF,7,0,1,7
TRAV19,TRAJ49,CALSEANTGNQFYF,7,8,2,15
TRAV20,TRAJ22,CAVRVSGSARQLTF,7,0,1,7
TRAV20,TRAJ15,CAVQWPVAGTALIF,7,0,1,7
TRAV8-3,TRAJ39,CAVGAHNAGNMLTF,7,0,1,7
TRAV23DV6,TRAJ42,CAVKDGGSQGNLIF,7,0,1,7
TRAV13-1,TRAJ27,CAASIGTNAGKSTF,7,0,1,7
TRAV13-1,TRAJ38,CAASNAGNNRKLIW,10,0,1,10
TRAV23DV6,TRAJ58,CAAKGETSGSRLTF,7,0,1,7
TRAV30,TRAJ33,CGTDNMDSNYQLIW,7,0,1,7
TRAV26-2,TRAJ57,CILRDVGGSEKLAF,7,0,1,7
TRAV26-1,TRAJ27,CIVRLNTNAGKSTF,7,0,1,7
TRAV9-2,TRAJ29,CALIISGNTPPVF,7,0,1,7
TRAV38-2DV8,TRAJ22,CAQIRGSARQLTF,7,10,2,17
TRAV20,TRAJ23,CAVQPNQGGKLIF,7,0,1,7
TRAV19,TRAJ5,CAQEATGRRALTF,7,0,1,7
TRAV39,TRAJ38,CAVNAGNNRKLIW,7,5,2,12
TRAV12-2,TRAJ22,CAVRSGSARQLTF,7,0,1,7
TRAV13-1,TRAJ40,CAATTSGTYKYIF,7,0,1,7
TRAV13-1,TRAJ36,CAASITGANNLFF,7,0,1,7
TRAV29DV5,TRAJ48,CAASPFGNEKLTF,7,0,1,7
TRAV23DV6,TRAJ33,CAASKGSNYQLIW,7,0,1,7
TRAV29DV5,TRAJ54,CAANLQGAQKLVF,7,0,1,7
TRAV13-2,TRAJ40,CAEWVSGTYKYIF,7,0,1,7
TRAV12-3,TRAJ23,CAMRVNQGGKLIF,7,12,2,19
TRAV26-2,TRAJ29,CILRGGRNTPLVF,7,0,1,7
TRAV38-1,TRAJ41,CAFRESGYALNF,7,0,1,7
TRAV16,TRAJ16,CALYSDGQKLLF,7,0,1,7
TRAV38-1,TRAJ54,CAPHQGAQKLVF,7,0,1,7
TRAV17,TRAJ8,CAPPTGFQKLVF,7,0,1,7
TRAV36DV7,TRAJ31,CAVEKVIARLMF,7,0,1,7
TRAV21,TRAJ49,CAVRDTGNQFYF,7,0,1,7
TRAV2,TRAJ15,CAASEGGTALIF,7,0,1,7
TRAV39,TRAJ32,CAVVSATNKLIF,7,0,1,7
TRAV29DV5,TRAJ36,CAASPRANNLFF,7,0,1,7
TRAV19,TRAJ34,CALKNTDKLIF,7,5,2,12
TRAV12-3,TRAJ27,CAVRHAGKSTF,7,0,1,7
TRAV13-2,TRAJ43,CAEKGVNDTRF,7,0,1,7
TRAV13-1,TRAJ34,CAANTDKLIF,7,0,1,7
TRAV12-1,TRAJ50,CVVMDKVIF,7,0,1,7
TRAV13-1,TRAJ43,CAATNDMRF,7,0,1,7
TRAV13-1,TRAJ4,CAARDLIF,7,0,1,7
TRAV12-1,TRAJ9,CVVNIRTGGFKTIF,7,0,1,7
TRAV26-1,TRAJ23,CIVRVAGGNQGRKLIF,7,0,1,7
TRAV12-2,TRAJ23,CAVPSLYNQGGKLIF,7,0,1,7
TRAV2,TRAJ13,CAVVSGGYQKVTF,7,0,1,7
TRAV3,TRAJ36,CPKTGANSLFF,7,0,1,7
TRAV12-3,TRAJ30,CATGRGDKIIF,7,0,1,7
TRAV8-3,TRAJ42,CAVGARSGRYGGSQGNLIF,6,0,1,6
TRAV12-2,TRAJ52,CAVKRARDAGGTSYGKLTL,6,0,1,6
TRAV16,TRAJ22,CALSGDLNSSGSARQLTF,6,0,1,6
TRAV35,TRAJ47,CAGRHPRDDMEYGNKLVF,6,0,1,6
TRAV38-1,TRAJ45,CAFMIGHVGGGADGLTF,6,0,1,6
TRAV16,TRAJ52,CALSPRFGGTSYGKLTF,6,0,1,6
TRAV25,TRAJ28,CAGPQAYSGAGSYQLTF,6,0,1,6
TRAV12-3,TRAJ28,CAMSPAYSGAGSYQLTF,6,0,1,6
TRAV4,TRAJ9,CLVVRPRGNTGGFKTIF,6,2,2,8
TRAV26-1,TRAJ27,CIVRAPKLESNAGKSTF,6,0,1,6
TRAV38-1,TRAJ52,CAFMKQGGTSYGKLTF,6,0,1,6
TRAV8-3,TRAJ7,CAVGAILERGNNRLAF,6,0,1,6
TRAV21,TRAJ41,CAVRDPNSNSGYALNF,6,0,1,6
TRAV35,TRAJ56,CAGHVPLGGANSKLTF,6,0,1,6
TRAV17,TRAJ49,CATGSHSPNTGNQFYF,6,0,1,6
TRAV12-2,TRAJ47,CAVNGIISEYGNKLVF,6,0,1,6
TRAV12-2,TRAJ44,CAVNMFYTGIASKLTF,6,0,1,6
TRAV29DV5,TRAJ22,CAPYLISSGSARQLTF,6,0,1,6
TRAV13-2,TRAJ3,CAENLAGYSSASKIIF,6,0,1,6
TRAV14DV4,TRAJ42,CAMRDYYGGSQGNLIF,6,0,1,6
TRAV26-1,TRAJ42,CIVRSDYGGSQGNLIF,6,0,1,6
TRAV12-1,TRAJ27,CVVIPPNTNAGKSTF,6,0,1,6
TRAV38-1,TRAJ49,CAFMKPLITGNQFYF,6,0,1,6
TRAV38-2DV8,TRAJ20,CAYRSANSPDYKLSF,6,0,1,6
TRAV38-1,TRAJ45,CALLLTGGGADGLTF,6,0,1,6
TRAV19,TRAJ47,CALSPSREYGNKLVF,6,0,1,6
TRAV19,TRAJ8,CALSERGTGFQKLVF,6,0,1,6
TRAV19,TRAJ27,CALSEARANAGKSTF,6,0,1,6
TRAV6,TRAJ16,CALDIAGSDGQKLLF,6,0,1,6
TRAV17,TRAJ5,CAPRGREEGRRALTF,6,15,2,21
TRAV22,TRAJ32,CAVVTRGGATNKLIF,6,0,1,6
TRAV22,TRAJ8,CAVVVMNTGFQKLVF,6,0,1,6
TRAV27,TRAJ45,CAGAKSGGGADGLTF,6,0,1,6
TRAV5,TRAJ13,CAEWIYSGGYQKVTF,6,0,1,6
TRAV5,TRAJ15,CAEIPLNQAGTALIF,6,0,1,6
TRAV13-2,TRAJ37,CAENPGSSNTGKLIF,6,0,1,6
TRAV14DV4,TRAJ15,CAMRDFGGAGTALIF,6,0,1,6
TRAV4,TRAJ13,CLVGLVSGGYQKVTF,6,0,1,6
TRAV26-2,TRAJ45,CIPLYSGGGADGLTF,6,0,1,6
TRAV16,TRAJ52,CVLGGGTSYGKLTF,6,0,1,6
TRAV10,TRAJ40,CVVSLSRGTYKYIF,6,0,1,6
TRAV12-1,TRAJ48,CVVNSNFGNEKLTF,6,6,2,12
TRAV9-2,TRAJ54,CALSGSQGAQKLVF,6,0,1,6
TRAV9-2,TRAJ8,CALSDPTGFQKLVF,6,0,1,6
TRAV9-2,TRAJ17,CALSERAAGNKLTF,6,0,1,6
TRAV16,TRAJ40,CALPSTSGTYKYIF,6,0,1,6
TRAV41,TRAJ22,CAVDFSGSARQLTF,6,0,1,6
TRAV22,TRAJ40,CAVRTTSGTYKYIF,6,0,1,6
TRAV36DV7,TRAJ49,CAVGPGNTGNQFYF,6,0,1,6
TRAV8-3,TRAJ56,CAVGADGANSKLTF,6,0,1,6
TRAV8-3,TRAJ6,CAVGASGGSYIPTF,8,0,1,8
TRAV36DV7,TRAJ27,CAVEANTNAGKSTS,6,0,1,6
TRAV2,TRAJ21,CAVEDRDNFNKFYF,6,0,1,6
TRAV12-2,TRAJ11,CAVRPGSGYSTLTL,6,0,1,6
TRAV3,TRAJ27,CAVRDATNAGKSTF,6,0,1,6
TRAV3,TRAJ23,CAVREDNQGGKLIF,6,0,1,6
TRAV12-2,TRAJ12,CAVGGMDSSYKLIF,6,0,1,6
TRAV13-1,TRAJ42,CAATSGGSQGNLIF,6,0,1,6
TRAV29DV5,TRAJ13,CAATLSGGYQKVTF,6,0,1,6
TRAV13-1,TRAJ13,CAASISGGYQKVTF,6,0,1,6
TRAV13-1,TRAJ16,CAASKFSDGQKLLF,6,0,1,6
TRAV29DV5,TRAJ53,CAAREGGSNYKLTF,6,0,1,6
TRAV25,TRAJ13,CAGGFAGGYQKVTF,6,9,2,15
TRAV5,TRAJ45,CADKGGGGADGLTF,6,0,1,6
TRAV5,TRAJ18,CAESRGSTLGRLYF,6,0,1,6
TRAV13-2,TRAJ12,CAENPMDSSYKLIF,6,0,1,6
TRAV14DV4,TRAJ6,CAMGSSGGSYTPTF,6,0,1,6
TRAV12-3,TRAJ10,CAMITAGGGNKPTF,6,0,1,6
TRAV30,TRAJ20,CGTEFFSNDYKLSF,6,0,1,6
TRAV12-1,TRAJ11,CVVISSGYSTLTF,6,0,1,6
TRAV10,TRAJ9,CVVSETGGFKTIF,6,0,1,6
TRAV12-1,TRAJ29,CVASNSGNTPLVY,6,0,1,6
TRAV41,TRAJ42,CAFKRGSQGNLIF,6,0,1,6
TRAV38-2DV8,TRAJ50,CAYRKTSYDKVIF,6,0,1,6
TRAV19,TRAJ21,CALAPYNFNKFYF,6,0,1,6
TRAV19,TRAJ43,CALSEVNNNDMRF,6,0,1,6
TRAV9-2,TRAJ7,CALSAYGNNRLAF,6,0,1,6
TRAV6,TRAJ5,CALDPPGRRALTF,6,0,1,6
TRAV36DV7,TRAJ32,CAVRIGATNKLIF,6,0,1,6
TRAV8-3,TRAJ45,CAVPGGGADGLTF,6,0,1,6
TRAV17,TRAJ13,CAARSGGYQKVTF,6,0,1,6
TRAV20,TRAJ15,CAAPNQAGTALIF,6,6,2,12
TRAV8-3,TRAJ37,CAATSSNTGKLIL,6,0,1,6
TRAV35,TRAJ40,CAGPGSGAYKYIF,6,0,1,6
TRAV35,TRAJ40,CAGFLRGTYKYIF,6,0,1,6
TRAV17,TRAJ23,CATGYNQGGKLIF,6,0,1,6
TRAV17,TRAJ5,CATDNTGRRALTF,6,0,1,6
TRAV12-2,TRAJ17,CAVRKAAGNKLTF,6,0,1,6
TRAV12-2,TRAJ47,CAVKVGYGNKLVF,6,0,1,6
TRAV12-2,TRAJ53,CAAGGGSNYKLTF,6,0,1,6
TRAV5,TRAJ42,CAPSGGSQGNLIF,6,0,1,6
TRAV13-1,TRAJ12,CAASWQSSYKLIF,6,0,1,6
TRAV25,TRAJ34,CAGGDYNTDKLIF,6,0,1,6
TRAV25,TRAJ37,CADPSSNTGKLIF,6,0,1,6
TRAV5,TRAJ20,CAEVPSNDYKLSF,6,0,1,6
TRAV5,TRAJ13,CAEVTGGYQKVTF,6,0,1,6
TRAV12-3,TRAJ49,CAMSSNTGNQFYF,6,0,1,6
TRAV12-3,TRAJ9,CAMSETGGFKTIF,6,0,1,6
TRAV17,TRAJ5,GAPMDTGRRALTF,6,0,1,6
TRAV23DV6,TRAJ9,CALLGGGFKTIF,6,0,1,6
TRAV16,TRAJ23,CALGNQGGKLIF,6,0,1,6
TRAV20,TRAJ34,CAVQDGDDKLIF,6,0,1,6
TRAV8-3,TRAJ49,CAVGARGNQFYF,6,0,1,6
TRAV8-6,TRAJ34,CAVTGNTDKLIF,6,0,1,6
TRAV17,TRAJ20,CATDEGDYKLSF,6,0,1,6
TRAV24,TRAJ20,CASSSNDYKLSF,6,0,1,6
TRAV36DV7,TRAJ53,CAPGGSNYKLTF,9,0,1,9
TRAV12-2,TRAJ22,CAVGGSARQLTF,6,0,1,6
TRAV13-1,TRAJ8,CAVSEGFQKLVF,6,0,1,6
TRAV29DV5,TRAJ40,CAAMGKTYKYIF,6,0,1,6
TRAV13-1,TRAJ11,CAASNGYSTLSF,6,0,1,6
TRAV13-1,TRAJ21,CAASNNFNKFYF,6,0,1,6
TRAV29DV5,TRAJ49,CAASAGDGQFYF,6,0,1,6
TRAV27,TRAJ26,CAGETDGQNFVF,6,0,1,6
TRAV26-2,TRAJ26,CILARMGQNFVF,6,0,1,6
TRAV26-2,TRAJ42,CILRGSQGNLIF,6,0,1,6
TRAV12-1,TRAJ52,CVVKNRQWVTF,6,6,2,12
TRAV9-2,TRAJ49,CAPNTSNQFYF,6,0,1,6
TRAV17,TRAJ29,CAPGGNTPLVF,6,0,1,6
TRAV41,TRAJ29,CAVRGNTPLVF,6,0,1,6
TRAV12-2,TRAJ49,CAVNWSNQFYF,6,0,1,6
TRAV13-2,TRAJ34,CAERGTDKLIF,6,0,1,6
TRAV13-1,TRAJ20,CAAGNDYKLSF,6,0,1,6
TRAV2,TRAJ31,CAVGNARLMF,6,0,1,6
TRAV8-3,TRAJ31,CAVGPARLMF,6,0,1,6
TRAV12-3,TRAJ35,CAMSGSFGNVLHC,6,0,1,6
TRAV26-1,TRAJ42,CIVRGGSQGNLIF,6,0,1,6
TRAV34,TRAJ20,CVVNPSDYKLSF,6,0,1,6
TRAV2,TRAJ44,CAVGANTGTASKLTF,6,0,1,6
TRAV20,TRAJ28,CATGRAGAGSYQLTF,6,0,1,6
TRAV9-2,TRAJ16,CALSEGSDGQKLLF,6,0,1,6
TRAV41,TRAJ49,CAVIPNTGNQFYF,6,0,1,6
TRAV17,TRAJ52,CATDGLRDAGGTSYGKLTF,5,12,2,17
TRAV26-2,TRAJ52,CILRDPVGAGGTSYGKLTF,5,0,1,5
TRAV12-2,TRAJ53,CAVNEGRDSGGSNYKMTF,5,0,1,5
TRAV12-1,TRAJ45,CVVKGAESGGGADGLTF,5,0,1,5
TRAV20,TRAJ53,CAVQAGSSGGSNYKLTF,5,0,1,5
TRAV21,TRAJ22,CAVRPLQSSGSARQLTF,5,0,1,5
TRAV35,TRAJ52,CAAAGPPGGTSYGKLTF,5,0,1,5
TRAV26-2,TRAJ57,CILSPRGGKGGSEKLVF,5,0,1,5
TRAV9-2,TRAJ40,CALTPPRRPGTYKYIF,5,0,1,5
TRAV9-2,TRAJ50,CALSARVKTSYDKVIF,5,0,1,5
TRAV9-2,TRAJ10,CALSGVLTGGGNKLTS,5,0,1,5
TRAV29DV5,TRAJ53,CALSEGSGGSNYKLTF,5,0,1,5
TRAV16,TRAJ52,CALSGDGGTSYGKLTF,5,0,1,5
TRAV8-3,TRAJ28,CAVGAYSGAGSYQLTF,5,4,2,9
TRAV20,TRAJ44,CAVGVMDTGTASKLTF,5,0,1,5
TRAV8-3,TRAJ10,CAVGGPREGGGNKLTF,5,0,1,5
TRAV17,TRAJ26,CATFVSWDNYGQNFVF,5,0,1,5
TRAV12-2,TRAJ3,CAVNPRTGSSASKIIF,5,2,2,7
TRAV12-2,TRAJ52,CAVKGTGGTSYGKLTF,5,0,1,5
TRAV29DV5,TRAJ40,CAASGGDTTGAYKYIF,5,0,1,5
TRAV29DV5,TRAJ52,CAASALSGTSYGKLTF,5,0,1,5
TRAV29DV5,TRAJ53,CAASGNSGGSNYKLTF,5,0,1,5
TRAV14DV4,TRAJ27,CAMREGYGTNAGKSTF,5,0,1,5
TRAV4,TRAJ32,CLVGERKGGATNKLIF,5,0,1,5
TRAV26-2,TRAJ30,CILRGGIMNRDDKIIF,5,0,1,5
TRAV9-2,TRAJ47,CSTESPMEYGNKLVF,5,0,1,5
TRAV10,TRAJ12,CVVSDDEDSSYKLIF,5,0,1,5
TRAV19,TRAJ34,CALSEAAYNTDKLIF,5,0,1,5
TRAV16,TRAJ13,CALSLYSGGYQKVTF,5,0,1,5
TRAV8-3,TRAJ9,CAVAPPGAGGFKTIF,5,0,1,5
TRAV21,TRAJ53,CAVEGSGGSNYKLTF,5,0,1,5
TRAV8-4,TRAJ45,CAVSGGREGADGLTF,5,0,1,5
TRAV21,TRAJ49,CAVRELSNTGNQFYF,5,0,1,5
TRAV3,TRAJ36,CAVRAVQTGANNLFF,5,0,1,5
TRAV3,TRAJ35,CAVRDLRSFGNVLHC,5,0,1,5
TRAV3,TRAJ9,CAVRDIGAGGFKTIF,5,0,1,5
TRAV3,TRAJ9,CAVREGSTGGFKTIF,5,0,1,5
TRAV35,TRAJ52,CAGRLSGTSYGKLTF,5,0,1,5
TRAV24,TRAJ44,CARCRNTGTASKLTF,5,0,1,5
TRAV8-1,TRAJ44,CAVGPSTGTASKLTF,5,0,1,5
TRAV12-2,TRAJ42,CAVTNYGGSQGNLIF,5,0,1,5
TRAV23DV6,TRAJ6,CAARFPAGGSYIPTF,5,0,1,5
TRAV13-1,TRAJ52,CAARTGGTSYGKLTF,5,0,1,5
TRAV12-3,TRAJ33,CAMEESADSNYQLIW,5,0,1,5
TRAV14DV4,TRAJ17,CAMTVDKAAGNKLTF,5,0,1,5
TRAV12-3,TRAJ57,CAMRETQGGSEKLVF,5,3,2,8
TRAV34,TRAJ29,CGADKRNSGNTPLVF,5,0,1,5
TRAV26-1,TRAJ36,CIVPSTQTGANNLFF,5,0,1,5
TRAV10,TRAJ17,CVVSVKAAGNKLTF,5,0,1,5
TRAV12-1,TRAJ3,CVVNLYSSASKIIF,5,0,1,5
TRAV12-1,TRAJ9,CVVNIYTGGFKTIF,5,14,2,19
TRAV12-1,TRAJ13,CVVNIPGGYQKVTF,5,0,1,5
TRAV38-1,TRAJ54,CAFMSFQGAQKLVF,5,0,1,5
TRAV38-2DV8,TRAJ49,CAYRSPLTGNQFYF,5,0,1,5
TRAV38-2DV8,TRAJ22,CAYRSMGSARQLTF,5,2,2,7
TRAV38-2DV8,TRAJ29,CAYRRIGLGTPLVF,5,0,1,5
TRAV9-2,TRAJ37,CALSLASNTGKLIF,5,0,1,5
TRAV16,TRAJ42,CALSGRGSQGNLIF,5,0,1,5
TRAV2,TRAJ37,CAVTISSNTGKLIF,5,0,1,5
TRAV8-3,TRAJ3,CAVALYSSASKIIF,5,0,1,5
TRAV8-3,TRAJ17,CAVGAGAAGNKLTF,5,0,1,5
TRAV21,TRAJ38,CAVGYAGNNRKLIW,5,0,1,5
TRAV22,TRAJ7,CAVGRAYGNNRLAF,5,0,1,5
TRAV2,TRAJ13,CAVEPPVGYQKVTF,5,0,1,5
TRAV21,TRAJ56,CAVRRTGANSKLTF,5,0,1,5
TRAV3,TRAJ9,CAVRANTGGFKTIF,5,0,1,5
TRAV21,TRAJ12,CAVKDEDSSYKLIF,5,0,1,5
TRAV21,TRAJ26,CAAPRDNYGQNFVF,5,0,1,5
TRAV29DV5,TRAJ52,CATAGGTSYGKLTF,5,0,1,5
TRAV17,TRAJ17,CATDAWAAGNKLTF,5,3,2,8
TRAV17,TRAJ26,CATDAWNYGQNFVF,5,0,1,5
TRAV24,TRAJ22,CAFAIRGSARQLTF,5,0,1,5
TRAV12-2,TRAJ42,CAVISVGSQGNLIF,5,0,1,5
TRAV8-1,TRAJ48,CAVNANFGNEKLTF,5,0,1,5
TRAV8-1,TRAJ42,CAVNEKGSQGNLIF,5,0,1,5
TRAV12-2,TRAJ39,CAVNPANAGNMLTF,5,0,1,5
TRAV13-1,TRAJ22,CAALRGGSARQLTF,5,0,1,5
TRAV13-1,TRAJ47,CAARRGLYGNKLVF,5,0,1,5
TRAV29DV5,TRAJ28,CAATSGAGSYQLTF,5,0,1,5
TRAV13-1,TRAJ20,CAATDSSNDYKLSF,5,0,1,5
TRAV23DV6,TRAJ40,CAATTLSGTYKYIF,5,0,1,5
TRAV29DV5,TRAJ45,CAASSGGGADGLTF,5,0,1,5
TRAV13-1,TRAJ37,CAASSSGNTGKLIF,5,0,1,5
TRAV23DV6,TRAJ44,CAASEAGTASKLTF,5,0,1,5
TRAV12-3,TRAJ54,CAMRLIQGAQKLVF,5,0,1,5
TRAV14DV4,TRAJ26,CAMRERNYGQNFVF,5,0,1,5
TRAV12-3,TRAJ10,CAMRITGGGNKLTF,5,0,1,5
TRAV12-3,TRAJ42,CATQTWGSQGNLIF,5,0,1,5
TRAV4,TRAJ8,CLVGEGTGFQKLVF,5,0,1,5
TRAV4,TRAJ13,CLVGTSGGYQKVTF,5,7,2,12
TRAV4,TRAJ9,CLVGINTGGFKTIF,5,0,1,5
TRAV30,TRAJ40,CGTERIRGTYKYIF,5,0,1,5
TRAV26-2,TRAJ27,CILRDWANAGKSTF,5,0,1,5
TRAV12-1,TRAJ40,CVVRGRGTYKYIF,5,0,1,5
TRAV10,TRAJ40,CVVRSSGTYKYIF,5,0,1,5
TRAV9-2,TRAJ22,CALLSGSARQLTF,5,0,1,5
TRAV9-2,TRAJ5,CALIDTGRRALTF,5,0,1,5
TRAV9-2,TRAJ22,CALSNGSARQLTF,5,0,1,5
TRAV16,TRAJ27,CALQGTNAGKSTF,5,0,1,5
TRAV21,TRAJ56,CAVVTGANSKLTF,5,0,1,5
TRAV41,TRAJ45,CAVGFGGADGLTF,5,0,1,5
TRAV36DV7,TRAJ27,CAVPNTNAGKSTF,5,6,2,11
TRAV36DV7,TRAJ21,CAVRGYNFNKFYF,5,0,1,5
TRAV20,TRAJ13,CAVQEGGYQKVTF,5,0,1,5
TRAV36DV7,TRAJ43,CAVDLYDNNDMRF,5,0,1,5
TRAV36DV7,TRAJ37,CAVSSGNTGKLIF,5,0,1,5
TRAV36DV7,TRAJ41,CAVKGNSGYALNF,5,0,1,5
TRAV35,TRAJ40,CAGQEGGTYKYIF,5,0,1,5
TRAV17,TRAJ56,CATGTGANSKLTF,5,0,1,5
TRAV17,TRAJ57,CATDQGGSEKLVF,5,2,2,7
TRAV17,TRAJ32,CATDAGGWNKLIF,5,0,1,5
TRAV17,TRAJ8,CATDDTGFQKLVF,5,0,1,5
TRAV12-2,TRAJ20,CAVRFSNDYKISF,5,0,1,5
TRAV12-2,TRAJ11,CAVRDSGYSTLTF,5,0,1,5
TRAV8-1,TRAJ5,CAVNRVGRRALTF,5,0,1,5
TRAV12-2,TRAJ3,CAVKGSSASKIIF,5,0,1,5
TRAV5,TRAJ13,CAAFSGGYQKVTF,5,0,1,5
TRAV23DV6,TRAJ44,CAAPLGTASKLTF,5,0,1,5
TRAV29DV5,TRAJ56,CAAGTGANSKLTF,5,0,1,5
TRAV13-1,TRAJ39,CAASGGAGNMLTF,5,0,1,5
TRAV23DV6,TRAJ33,CAAAMDSNYQLIW,5,0,1,5
TRAV13-1,TRAJ44,CAATTGTASKLTF,5,0,1,5
TRAV13-1,TRAJ13,CAASMGGYQKVTF,5,10,2,15
TRAV13-1,TRAJ11,CAASLSGYSTLTF,5,0,1,5
TRAV13-1,TRAJ35,CAAKGGFGNVLHC,5,0,1,5
TRAV27,TRAJ44,CAGAPGTASKLTF,5,0,1,5
TRAV13-2,TRAJ9,CAEILTGGFKTIF,5,0,1,5
TRAV14DV4,TRAJ22,CAMIPPLARQLTF,5,0,1,5
TRAV12-3,TRAJ7,CAMSPYGNNRLAF,5,0,1,5
TRAV12-3,TRAJ57,CAMSAGGSEKLVF,5,0,1,5
TRAV12-3,TRAJ10,CAMSAGGGNKLTF,5,0,1,5
TRAV30,TRAJ17,CGTEKAAGNKLTF,5,0,1,5
TRAV4,TRAJ30,CLVGENRDDKIIF,5,0,1,5
TRAV26-1,TRAJ53,CISRGGSNYKLTF,5,0,1,5
TRAV9-2,TRAJ7,YALSPYGNNRLAF,5,0,1,5
TRAV12-1,TRAJ9,CVVNNRGFKTIF,5,0,1,5
TRAV9-2,TRAJ15,CALREAGTALIF,5,0,1,5
TRAV36DV7,TRAJ33,CAVPDSNYQLIW,5,0,1,5
TRAV36DV7,TRAJ20,CAVEEADYKLSF,5,0,1,5
TRAV36DV7,TRAJ54,CAVEKGAQKLVF,5,0,1,5
TRAV8-3,TRAJ44,CATTGTASKLTF,5,0,1,5
TRAV20,TRAJ15,CATNQAGTALVF,5,0,1,5
TRAV17,TRAJ28,CATLGGSYQLTF,5,0,1,5
TRAV12-2,TRAJ16,CAVNSDGQKLLF,5,0,1,5
TRAV13-1,TRAJ30,CAASYQDDKIIF,5,0,1,5
TRAV25,TRAJ6,CAGAGGSYIPTF,5,0,1,5
TRAV25,TRAJ56,CAGAGANSKLTF,5,0,1,5
TRAV25,TRAJ56,CAGEGANSKLTF,5,0,1,5
TRAV14DV4,TRAJ20,CAMKPNDYKLSF,5,0,1,5
TRAV38-2DV8,TRAJ49,CAFHTGNQFYF,5,0,1,5
TRAV38-2DV8,TRAJ30,CALNRDDKIIF,5,0,1,5
TRAV21,TRAJ26,CAPLYGQNFVF,5,7,2,12
TRAV2,TRAJ20,CAVFNDYKLSF,5,0,1,5
TRAV21,TRAJ34,CAVSNTDKLIF,5,0,1,5
TRAV8-3,TRAJ9,CAVGGGFKTIF,5,26,2,31
TRAV35,TRAJ32,CAGRVTNRLIF,5,0,1,5
TRAV39,TRAJ31,CAVAKNARLMF,5,0,1,5
TRAV13-1,TRAJ33,CAASSNYQLIW,5,0,1,5
TRAV25,TRAJ8,CAGSRFQKLVF,5,0,1,5
TRAV26-2,TRAJ39,CPQQAGNMLTF,5,0,1,5
TRAV5,TRAJ34,CAEADKLIF,5,0,1,5
TRAV12-2,TRAJ31,SSGARLMF,5,0,1,5
TRAV29DV5,TRAJ45,CAAIPGQRRRGGGADGLTF,5,0,1,5
TRAV36DV7,TRAJ43,CAVYNNNDMRF,5,0,1,5
TRAV5,TRAJ44,CAEYNAGTASNLTF,5,0,1,5
TRAV13-1,TRAJ9,CAASETGGFKTIF,5,0,1,5
TRAV12-1,TRAJ3,CVVMDSSASKIIF,5,0,1,5
TRAV4,TRAJ30,CLVVENRDDKIIF,4,0,1,4
TRAV36DV7,TRAJ52,CAVRLSANAGGTSYGKLTF,4,0,1,4
TRAV12-1,TRAJ45,CVVNPPHPSGGGADGLTF,4,0,1,4
TRAV9-2,TRAJ52,CALSDQYAGGTSYGKLTF,4,0,1,4
TRAV35,TRAJ47,CAGRHPRDDMEYGNKLVL,4,0,1,4
TRAV26-2,TRAJ52,CILNHEVAGGTSYGKLTF,4,0,1,4
TRAV12-1,TRAJ42,CVVNRGFYGGSQGNLIF,4,0,1,4
TRAV38-2DV8,TRAJ32,CAYRSGGGGGATNKLIF,4,0,1,4
TRAV9-2,TRAJ52,CALLANAGGTSYGKLTF,4,0,1,4
TRAV9-2,TRAJ42,CALRSWDYGGSQGDLIF,4,0,1,4
TRAV21,TRAJ58,CAVIGGREETSGSRLTF,4,8,2,12
TRAV29DV5,TRAJ22,CAASGAFSSGSARQLTF,4,0,1,4
TRAV14DV4,TRAJ17,CAMREGPVKAAGNKLTF,4,0,1,4
TRAV10,TRAJ32,CVVSENRDGATNKLIF,4,0,1,4
TRAV38-2DV8,TRAJ45,CAYTQYSGGGADGLTF,4,0,1,4
TRAV9-2,TRAJ32,CALSDQGGGATNKLIF,4,0,1,4
TRAV19,TRAJ40,CALRGSGGSGTYKYIF,4,0,1,4
TRAV38-2DV8,TRAJ39,CAHRPGINNAGNMLTF,4,0,1,4
TRAV20,TRAJ13,CAVQAPRSGGYQKVTF,4,0,1,4
TRAV20,TRAJ46,CAVQAEKKSSGDKLTF,4,0,1,4
TRAV20,TRAJ28,CAVQAYSGAGSYQLTF,4,0,1,4
TRAV3,TRAJ3,CAVSPSPYSSASKIIF,4,0,1,4
TRAV21,TRAJ28,CAVRLYSGAGSYQLTF,4,3,2,7
TRAV21,TRAJ21,CAVRPPRESSFNKFYF,4,0,1,4
TRAV3,TRAJ6,CAVRRLSSGGSYIPTF,4,0,1,4
TRAV3,TRAJ4,CAVRDPISGGYNKLIF,4,0,1,4
TRAV35,TRAJ28,CAGSAYSGAGSYKLTF,4,0,1,4
TRAV12-2,TRAJ5,CAVMPRGDTGRRALTF,4,0,1,4
TRAV12-2,TRAJ42,CAVRRQSGGSQGNLIF,4,0,1,4
TRAV23DV6,TRAJ58,CAASIAGETSGSRLTF,4,0,1,4
TRAV14DV4,TRAJ45,CAMRLYSGGGADGLTF,4,0,1,4
TRAV4,TRAJ18,CLVGDNGGSTLGRLYF,4,0,1,4
TRAV4,TRAJ29,CLVGDTLYSGNTPLVF,4,0,1,4
TRAV26-2,TRAJ52,CILANAGGTSYGKLTF,4,0,1,4
TRAV8-3,TRAJ45,SHLASSGGGADGLTF,4,0,1,4
TRAV38-2DV8,TRAJ39,CVHGGVGNAGNMLTF,4,0,1,4
TRAV12-1,TRAJ12,CVVNGDTNSSYKLIF,4,0,1,4
TRAV12-1,TRAJ13,CVVNRHSGGHQKVTF,4,0,1,4
TRAV12-1,TRAJ37,CVVKPPPGNTGKLIF,4,0,1,4
TRAV38-2DV8,TRAJ42,CALNNYGGSQGNLIF,4,0,1,4
TRAV16,TRAJ27,CALPLTHTNAGKSTF,4,0,1,4
TRAV9-2,TRAJ47,CALTRGREYGNKLVF,4,14,2,18
TRAV9-2,TRAJ12,CALSDRGDSSYKLIF,4,0,1,4
TRAV9-2,TRAJ8,CALSDRDTGFQKLVF,4,0,1,4
TRAV19,TRAJ38,CALSRQAGNNRKLIW,4,0,1,4
TRAV19,TRAJ3,CALRDLYSSASKIIF,4,0,1,4
TRAV19,TRAJ47,CALKRSREYGNKLVF,4,2,2,6
TRAV2,TRAJ3,CAVSSGYSSASKIIF,4,0,1,4
TRAV23DV6,TRAJ20,CAVPGMRANDYKLSF,4,0,1,4
TRAV20,TRAJ16,CAVQPNLGNGQKLLF,4,0,1,4
TRAV8-3,TRAJ36,CAVGARRTGANNLFF,4,0,1,4
TRAV2,TRAJ9,CAVEDQGTGGFKTIF,4,0,1,4
TRAV2,TRAJ30,CAVEDGMNRDDKIIF,4,0,1,4
TRAV22,TRAJ48,CAVEGRGFGNEKLTF,4,0,1,4
TRAV12-2,TRAJ44,CAVIRWTGTASKLTF,4,0,1,4
TRAV21,TRAJ38,CAVRRRAGNNCKLIW,4,0,1,4
TRAV41,TRAJ42,CAANPLRGSQGNLIF,4,0,1,4
TRAV17,TRAJ6,CATVKGSGGSYIPTF,4,0,1,4
TRAV8-3,TRAJ45,CARTNSGGGADGLTF,4,0,1,4
TRAV38-2DV8,TRAJ45,CAVLITGGGADGLTF,4,15,2,19
TRAV12-2,TRAJ22,CAVSARSGSARQLTF,4,0,1,4
TRAV12-2,TRAJ13,CAVILGSGGYQKVTY,4,0,1,4
TRAV20,TRAJ13,CAIHPYSGGYQKVTF,4,0,1,4
TRAV29DV5,TRAJ42,CAATELGGSQGNLIF,4,0,1,4
TRAV29DV5,TRAJ40,CAASEWFSGTYKYIF,4,0,1,4
TRAV29DV5,TRAJ21,CAASETGNNFNKFYF,4,0,1,4
TRAV23DV6,TRAJ22,CAASTPSGSARQLTF,4,0,1,4
TRAV23DV6,TRAJ44,CAASKNTGTASKLTF,4,0,1,4
TRAV12-3,TRAJ7,CAMSLEPYGNNRLAF,4,0,1,4
TRAV12-3,TRAJ6,CAMSPAAGGSYIPTF,4,0,1,4
TRAV12-3,TRAJ5,CAMSARGTGRRALTF,4,0,1,4
TRAV12-3,TRAJ10,CAMSESTGGGNKLTF,4,0,1,4
TRAV30,TRAJ31,CGTEKGPGNNARLMF,4,0,1,4
TRAV4,TRAJ37,CLVGGGSGNTGKLIF,4,0,1,4
TRAV4,TRAJ32,CLVGNPSGATNKLIF,4,0,1,4
TRAV26-2,TRAJ42,CILRDPGGSQGNLIF,4,0,1,4
TRAV26-1,TRAJ20,CIVRAVSSNDYKLSF,4,0,1,4
TRAV12-1,TRAJ42,CVLNYGGSQGNLIS,4,0,1,4
TRAV12-1,TRAJ16,CVVIVFSDGQKLLF,4,0,1,4
TRAV12-1,TRAJ40,CVVITTSGTYKYIF,4,0,1,4
TRAV12-1,TRAJ17,CVVNRKAAGNKLTF,4,0,1,4
TRAV38-1,TRAJ40,CAFMKHSGTYKYIF,4,0,1,4
TRAV38-2DV8,TRAJ29,CAYRSNSGNTPLVF,4,0,1,4
TRAV38-2DV8,TRAJ26,CAYRRGLYGQNFVF,4,0,1,4
TRAV12-2,TRAJ3,CALPEGSSASKIIF,4,0,1,4
TRAV19,TRAJ27,CALSPPLHAGKSTF,4,0,1,4
TRAV19,TRAJ6,CALSEAGGSYIPTF,4,0,1,4
TRAV16,TRAJ52,CALGGGTSYGKLTF,4,0,1,4
TRAV2,TRAJ36,CAVLDQTGANNLFF,4,0,1,4
TRAV22,TRAJ29,CAVPWNSGNTPLVF,4,0,1,4
TRAV22,TRAJ56,CAVDDTGANSKLTF,4,0,1,4
TRAV21,TRAJ24,CAVSGTDSWGKFQF,4,0,1,4
TRAV20,TRAJ15,CAVLINQAGTALIF,4,0,1,4
TRAV20,TRAJ10,CAVPVTGGGNKLTF,4,0,1,4
TRAV20,TRAJ36,CAVQSQTGANNLFF,4,0,1,4
TRAV8-3,TRAJ9,CAVVPNTGGFKTIF,4,0,1,4
TRAV8-3,TRAJ31,CAVGGLNNNARLMS,4,0,1,4
TRAV8-3,TRAJ27,CAVGDNTNAGKSTF,4,0,1,4
TRAV36DV7,TRAJ37,CAVEAASNTGKLIF,4,0,1,4
TRAV3,TRAJ37,CAVSRPSNTGKLIF,4,0,1,4
TRAV3,TRAJ30,CAVRAPGGDDKIIF,4,0,1,4
TRAV3,TRAJ9,CAVRDITGGFKTIF,4,2,2,6
TRAV3,TRAJ29,CAVRDKTGNTPLVF,4,0,1,4
TRAV35,TRAJ45,CAGRTGGGADGLTF,4,0,1,4
TRAV35,TRAJ42,CAGQKGGSQGNLIF,4,0,1,4
TRAV35,TRAJ44,CAGGNTGTASKLTF,4,0,1,4
TRAV17,TRAJ15,CATDVYPAGTALIF,4,0,1,4
TRAV9-2,TRAJ52,CARAGGTSYGKLTF,4,0,1,4
TRAV20,TRAJ52,CAFAGGTSYGKLTF,4,0,1,4
TRAV24,TRAJ42,CAFINGGSQGNLIF,4,0,1,4
TRAV39,TRAJ33,CAVDGMDSNYQLIW,4,0,1,4
TRAV8-1,TRAJ32,CAVNGGGATNKLIF,4,0,1,4
TRAV12-2,TRAJ47,CAVNAVEYGNKLVF,4,0,1,4
TRAV13-1,TRAJ42,CAASYGGSQGNLIF,4,3,2,7
TRAV12-2,TRAJ27,CAAPPHTNAGKSTF,4,0,1,4
TRAV12-2,TRAJ13,CAADITGGYQKVTF,4,0,1,4
TRAV29DV5,TRAJ58,CARSFETSGSRLTF,4,0,1,4
TRAV12-2,TRAJ44,CAVTNTGTASKLTF,4,0,1,4
TRAV13-2,TRAJ52,CAATGGTSYGKLTF,4,0,1,4
TRAV23DV6,TRAJ4,CAAAASGGYNKLIF,4,0,1,4
TRAV13-1,TRAJ16,CAATSFSDGQKLLF,4,0,1,4
TRAV13-1,TRAJ11,CAASANSGYSTLTF,4,0,1,4
TRAV13-1,TRAJ17,CAASMEAAGNKLTF,4,0,1,4
TRAV13-1,TRAJ48,CAASKNFGNEKLTF,4,0,1,4
TRAV13-1,TRAJ47,CAASKGEYGNKLVY,4,0,1,4
TRAV29DV5,TRAJ40,CAASPPSGTYKYIF,4,0,1,4
TRAV13-1,TRAJ29,CAASPNSGNTPLVF,4,0,1,4
TRAV29DV5,TRAJ22,CAASHSGSARQLTF,4,0,1,4
TRAV29DV5,TRAJ56,CAASETGANSKLTF,4,0,1,4
TRAV29DV5,TRAJ58,CAASEETSGSRLTF,4,0,1,4
TRAV13-1,TRAJ35,CAANLIGFGNVLHC,4,0,1,4
TRAV25,TRAJ43,CAGPKSYNNNDMRF,4,0,1,4
TRAV27,TRAJ17,CAGWDKAAGNKLTF,4,0,1,4
TRAV27,TRAJ53,CAGHPGGSNYKLTF,4,0,1,4
TRAV5,TRAJ33,CAERGPDSNYQLIW,4,0,1,4
TRAV13-2,TRAJ57,CAENRQGGSEKLVF,4,0,1,4
TRAV12-3,TRAJ40,CAMSVTSGTYKYIF,4,0,1,4
TRAV12-3,TRAJ4,CAMSASGGYNKLIF,4,0,1,4
TRAV12-3,TRAJ56,CAMSEGGANSKLTF,4,0,1,4
TRAV12-3,TRAJ24,CAMKSPDSWGKFQF,4,0,1,4
TRAV4,TRAJ13,CLVVNSGGYQKVTF,4,0,1,4
TRAV4,TRAJ45,CLVGSGGGADGLTF,4,0,1,4
TRAV4,TRAJ5,RLVANDTGRRALTF,4,0,1,4
TRAV12-1,TRAJ8,CVVEGTGFQKLVF,4,0,1,4
TRAV12-1,TRAJ49,CVVISPTGNQFYF,4,0,1,4
TRAV10,TRAJ4,CVVSPGGYNKLIF,4,0,1,4
TRAV38-2DV8,TRAJ36,CAYHLGRANNLFF,4,0,1,4
TRAV38-2DV8,TRAJ44,CAYGPGTASKLTF,4,0,1,4
TRAV9-2,TRAJ23,CALSLRQGGQLIF,4,0,1,4
TRAV9-2,TRAJ27,CALSDTNAGKSTF,4,0,1,4
TRAV9-2,TRAJ17,CALSRAAGNKLTF,4,0,1,4
TRAV9-2,TRAJ57,CALNQGGSEKLVF,4,0,1,4
TRAV6,TRAJ12,CALVKDSSYKLIF,4,0,1,4
TRAV16,TRAJ29,CALIGTGNTPLVF,4,0,1,4
TRAV41,TRAJ33,CAVRFISNYQLIW,4,0,1,4
TRAV41,TRAJ17,CAVKRAAGNKLTF,4,0,1,4
TRAV20,TRAJ49,CAVQGPTGNQFYF,4,0,1,4
TRAV22,TRAJ28,CAVVVAGSYQLTF,4,0,1,4
TRAV8-3,TRAJ40,CAVGLSGTYKYIF,4,0,1,4
TRAV8-3,TRAJ49,CAVGRITGNQFYF,4,0,1,4
TRAV8-6,TRAJ7,CAVGAYGNNRLAF,4,0,1,4
TRAV8-3,TRAJ49,CAVGTNTGNQFYF,4,0,1,4
TRAV8-4,TRAJ9,CAVTYTGGFKTIF,4,0,1,4
TRAV21,TRAJ49,CAVRPNTGNQFYF,4,0,1,4
TRAV21,TRAJ20,CAVRPINDYKLSF,4,0,1,4
TRAV36DV7,TRAJ27,CAVFNTNAGKSTF,4,0,1,4
TRAV35,TRAJ6,CAGRQGGSYIPTF,4,0,1,4
TRAV17,TRAJ53,CATERGSNYKLTF,4,0,1,4
TRAV24,TRAJ47,CAFPQEYGNKLVF,4,0,1,4
TRAV36DV7,TRAJ28,CASPAAGSYQLTF,4,0,1,4
TRAV39,TRAJ30,CAVGLGRDDKIIF,4,0,1,4
TRAV12-2,TRAJ26,CAVRRGYGQNFVF,4,0,1,4
TRAV12-2,TRAJ9,CAVNGAGGFKTIF,4,0,1,4
TRAV12-2,TRAJ28,CAVKGAGSYQLTF,4,0,1,4
TRAV12-2,TRAJ48,CAGGDFGNEKLTF,4,0,1,4
TRAV27,TRAJ15,CAARNQAGTALIF,4,9,2,13
TRAV13-1,TRAJ53,CAASAGSNYKLTL,4,0,1,4
TRAV13-1,TRAJ43,CAASIRGNNDMRF,4,0,1,4
TRAV29DV5,TRAJ39,CAASEDAGNMLTF,4,0,1,4
TRAV29DV5,TRAJ6,CAASIGGSYIPTF,4,0,1,4
TRAV13-1,TRAJ11,CAGIISGYSTLTF,4,0,1,4
TRAV25,TRAJ27,CAGGNTNAGKSTF,4,0,1,4
TRAV13-2,TRAJ38,CAENAGNNRKLIW,4,0,1,4
TRAV13-2,TRAJ32,CAEKHGATNKLIF,4,0,1,4
TRAV12-3,TRAJ56,CAMYTGANSKLTF,4,2,2,6
TRAV12-3,TRAJ39,CAMGNNAGNMLTF,4,0,1,4
TRAV12-3,TRAJ41,CAMSSNSGYALNF,4,0,1,4
TRAV12-3,TRAJ28,CAMSRAGSYQLSF,4,0,1,4
TRAV12-3,TRAJ29,CAMSASGNTPLVF,4,0,1,4
TRAV12-3,TRAJ7,CAMSAGGNNRLAF,4,0,1,4
TRAV30,TRAJ18,CGTRGSTLGRLYF,4,0,1,4
TRAV4,TRAJ30,CLVGENRDDRIIF,4,0,1,4
TRAV12-1,TRAJ20,LDGGEDDYKLSF,4,0,1,4
TRAV12-1,TRAJ6,CVVMGGSYIPTF,4,0,1,4
TRAV12-1,TRAJ20,CVVKRDDYKLSF,4,0,1,4
TRAV12-1,TRAJ23,CVGPWQGGKLIF,4,0,1,4
TRAV3,TRAJ40,CALPSGTYKYIF,4,0,1,4
TRAV9-2,TRAJ37,CALTSNTGKLIF,4,0,1,4
TRAV9-2,TRAJ3,CALYSSASKIIF,4,0,1,4
TRAV9-1,TRAJ5,CALTQGRRALTF,4,0,1,4
TRAV16,TRAJ45,CALGGGADGLTF,4,0,1,4
TRAV6,TRAJ20,CALGGEDYKLSF,4,9,2,13
TRAV38-2DV8,TRAJ48,CAPNFGNEKLTF,4,0,1,4
TRAV41,TRAJ30,CAPDRADDKIIF,4,0,1,4
TRAV20,TRAJ27,CAVQSNAGKSTF,4,0,1,4
TRAV20,TRAJ49,CAVGNTGNQFYF,4,0,1,4
TRAV29DV5,TRAJ48,CAANFGNEKLTF,4,11,2,15
TRAV12-3,TRAJ39,CAAVNAGNMLTF,4,0,1,4
TRAV2,TRAJ31,CAAGNNNARLMF,4,0,1,4
TRAV27,TRAJ31,CADRNNNARLMF,4,0,1,4
TRAV17,TRAJ40,CATQTGTYKYIF,4,0,1,4
TRAV17,TRAJ34,CATDWGTDKLIF,4,0,1,4
TRAV8-1,TRAJ13,CAVNLGYQKVTF,4,0,1,4
TRAV8-1,TRAJ47,CAVNEGGNKLVF,4,0,1,4
TRAV12-2,TRAJ13,CAVNARYQKVTF,4,0,1,4
TRAV23DV6,TRAJ15,CAAREAGTALIF,4,0,1,4
TRAV21,TRAJ40,CATNSGTYKYIF,4,0,1,4
TRAV29DV5,TRAJ57,CAVQGGSEKLVF,4,0,1,4
TRAV13-2,TRAJ57,CAAEGGSEKLVF,4,0,1,4
TRAV25,TRAJ21,CAGRYNFNKFYF,7,0,1,7
TRAV27,TRAJ36,CAGDSGANNLLF,4,0,1,4
TRAV13-2,TRAJ9,CAENTRGFKTIF,4,0,1,4
TRAV13-2,TRAJ9,CAENTGGFKTIF,4,0,1,4
TRAV12-3,TRAJ13,CAMSGGYQKVTF,4,0,1,4
TRAV2,TRAJ31,YAVEESNARLMF,4,0,1,4
TRAV12-1,TRAJ40,HVVHSGTYKYIF,4,0,1,4
TRAV27,TRAJ26,CVKENGQNFVF,4,0,1,4
TRAV9-2,TRAJ43,CALSDRGDMRF,4,0,1,4
TRAV16,TRAJ34,CAPPNTDKLIF,4,0,1,4
TRAV20,TRAJ36,CAVQVPNNLFF,4,0,1,4
TRAV8-3,TRAJ57,CAVGGSEKPVF,4,0,1,4
TRAV12-2,TRAJ31,CAVKGNARLMF,4,0,1,4
TRAV25,TRAJ43,CAGPRNNDMRF,4,0,1,4
TRAV21,TRAJ42,YEPGSQGNLIF,4,0,1,4
TRAV9-2,TRAJ24,CALSWGKFQF,4,0,1,4
TRAV21,TRAJ27,CAVTAGKSTF,4,0,1,4
TRAV12-2,TRAJ4,CAASYNKLIF,4,0,1,4
TRAV12-2,TRAJ49,CAVIEGQFYF,4,0,1,4
TRAV2,TRAJ31,CAVNNARLMF,6,0,1,6
TRAV12-2,TRAJ48,CAALVEKLTF,4,0,1,4
TRAV13-2,TRAJ47,CAESANKLVF,4,0,1,4
TRAV13-2,TRAJ31,CAEGRLMF,4,0,1,4
TRAV9-2,TRAJ10,CALSDVGVTGGGNKLTF,4,0,1,4
TRAV9-2,TRAJ57,CALSLTQGGSEKLVL,4,0,1,4
TRAV17,TRAJ18,CATDGRGSTLGRLYF,4,0,1,4
TRAV12-3,TRAJ37,CAMSYGSGNTGKPIF,4,0,1,4
TRAV3,TRAJ31,CAVRDGNNNARLMF,4,0,1,4
TRAV21,TRAJ53,CAVLRGSNYKLTF,4,0,1,4
TRAV17,TRAJ23,CATDGNQGGKLIF,4,0,1,4
TRAV8-1,TRAJ20,CSVKGDYKLSF,4,0,1,4
TRAV41,TRAJ22,CAVKPPRDQIFSGSARQLTF,3,0,1,3
TRAV21,TRAJ57,CAVRRPRDFRTQGGSEKLVF,3,0,1,3
TRAV38-2DV8,TRAJ34,CAYRSIRDPRSYNTDKLIF,3,0,1,3
TRAV12-1,TRAJ3,CVVNKGRDLHSSASKIIF,3,0,1,3
TRAV38-2DV8,TRAJ52,CAYRTVNAGGTSYGKLTF,3,0,1,3
TRAV17,TRAJ45,CATGEGRSPGGGADGLTF,3,0,1,3
TRAV13-2,TRAJ10,CAETQPLILTGGGNKLTF,3,4,2,7
TRAV4,TRAJ45,CLVGDPTYSGGGADGLTF,3,0,1,3
TRAV12-1,TRAJ8,CVVNGSPWDTGFQKLVF,3,0,1,3
TRAV20,TRAJ4,CAVQADYLSGGYNKLIF,3,0,1,3
TRAV21,TRAJ39,CAATPDRSYNAGNMLTF,3,0,1,3
TRAV38-2DV8,TRAJ52,CASSGNAGGTSYGKLTF,3,0,1,3
TRAV29DV5,TRAJ52,CAASARAGGTSYGKLTF,3,0,1,3
TRAV12-3,TRAJ4,CAMRATMFSGGYNKLIF,3,0,1,3
TRAV30,TRAJ52,CGTELGAGGTSYGKLTF,3,0,1,3
TRAV38-2DV8,TRAJ30,CAYRSSSMNRDDRIIF,3,0,1,3
TRAV9-2,TRAJ10,CALSDRLTGGGNKLTF,3,0,1,3
TRAV9-2,TRAJ39,CALSDQARDAGNMLTF,3,3,2,6
TRAV19,TRAJ17,CALSEAREAAGNKLTF,3,0,1,3
TRAV19,TRAJ8,CALSEEFGTGFQKLVF,3,0,1,3
TRAV16,TRAJ42,CALTQNYGGSQGNLIF,3,0,1,3
TRAV21,TRAJ41,CAVTSMNSNSGYALNF,3,0,1,3
TRAV12-2,TRAJ12,CAVVGAVMDSSYKLIF,3,3,2,6
TRAV41,TRAJ42,CAVSEGYGGSQGNLIF,3,0,1,3
TRAV8-3,TRAJ32,CAVVTTGGGATNKLIF,3,0,1,3
TRAV2,TRAJ52,CAVEGAGGTSYGKLTF,3,4,2,7
TRAV2,TRAJ10,CAVEDRITGGGNKLTF,3,0,1,3
TRAV8-6,TRAJ13,CAVSPPTGGGYQKVTF,3,0,1,3
TRAV8-6,TRAJ6,CAVSDLLNGGSYIPTF,3,0,1,3
TRAV8-4,TRAJ15,CAVSDPFNQAGTALIF,3,0,1,3
TRAV3,TRAJ15,CAVRDLSNQAGTALIF,3,0,1,3
TRAV17,TRAJ37,CATVPSGSGNTGKLIF,3,0,1,3
TRAV17,TRAJ49,CATAAYAWNTGNQFYF,3,0,1,3
TRAV39,TRAJ22,CAVDMYPSGSARQLTF,3,0,1,3
TRAV8-1,TRAJ28,CAVIHGSGAGSYQLTF,3,0,1,3
TRAV13-1,TRAJ52,CAASNRGGTSYGKLTF,3,0,1,3
TRAV29DV5,TRAJ32,CAASPPYGGATNKLIF,3,0,1,3
TRAV29DV5,TRAJ32,CAASTSYGGATSKLIF,3,0,1,3
TRAV12-3,TRAJ44,CAMSEWIAGTASKLTF,3,0,1,3
TRAV12-3,TRAJ27,CAMRPRINTNAGKSTF,3,0,1,3
TRAV14DV4,TRAJ50,CAMRGSRETSYDKVVF,3,0,1,3
TRAV14DV4,TRAJ50,CAMRGSRETSYDKVIF,3,20,2,23
TRAV14DV4,TRAJ8,CAMRESGEKGFQKLVF,3,0,1,3
TRAV14DV4,TRAJ8,SAMRESREKGFQKLVF,3,0,1,3
TRAV12-1,TRAJ15,CVVSAFNQAGTALIF,3,0,1,3
TRAV12-1,TRAJ24,CVVTQSPDSWGKFQF,3,0,1,3
TRAV10,TRAJ47,CVVSAGREYGNKLVF,3,0,1,3
TRAV12-1,TRAJ27,CVVNKLFGNAGKSTF,3,0,1,3
TRAV38-1,TRAJ28,CAFSNSGAGSYQLTF,3,0,1,3
TRAV38-2DV8,TRAJ48,CAYRSPNFGNEKLTF,3,0,1,3
TRAV38-2DV8,TRAJ29,CAYRSARRGNTPLVF,3,0,1,3
TRAV38-2DV8,TRAJ15,CAYRRANQAGTALIF,3,0,1,3
TRAV38-1,TRAJ37,CAYRSYSGNTGKLIF,3,0,1,3
TRAV19,TRAJ24,CALGRTTDSWGKFQF,3,3,2,6
TRAV9-2,TRAJ4,CALTRFSGGYNKLIF,3,0,1,3
TRAV16,TRAJ17,CALRGSKAAGNELTF,3,0,1,3
TRAV20,TRAJ37,CAVQGSSGNTGKLIF,3,0,1,3
TRAV8-3,TRAJ40,CAVGASTSGTYKYIF,3,0,1,3
TRAV2,TRAJ27,CAVDSLNTNAGKSTF,3,0,1,3
TRAV2,TRAJ12,CAVEDRKDSSYKLIF,3,0,1,3
TRAV12-2,TRAJ50,CAVRRLRTSYDKVIF,3,0,1,3
TRAV3,TRAJ6,CAVRDQAGGSYIPTF,3,0,1,3
TRAV3,TRAJ7,CAVRDAISGNNRLAF,3,0,1,3
TRAV41,TRAJ58,CAADPKETSGSRLTF,3,0,1,3
TRAV35,TRAJ42,CAGPNYGGSQGNLIF,3,2,2,5
TRAV35,TRAJ50,CAGPYMKTSYDKVIF,3,0,1,3
TRAV17,TRAJ37,CATAIGSSNTGKLIF,3,0,1,3
TRAV12-2,TRAJ18,CAVRSRGSTLGRLYF,3,0,1,3
TRAV39,TRAJ56,CAVETKTGANSKLTF,3,0,1,3
TRAV12-2,TRAJ49,CAVMRIGRTGNQFYF,3,0,1,3
TRAV12-2,TRAJ39,CAVSRGNNAGNMLTF,3,0,1,3
TRAV8-1,TRAJ17,CAVNERKAAGNKLTF,3,0,1,3
TRAV12-2,TRAJ9,CAVNGLDTGGFKTIF,3,0,1,3
TRAV12-2,TRAJ37,CAVNISGGNTGKLIL,3,0,1,3
TRAV12-3,TRAJ53,CAVQNSGGSNYKLTF,3,0,1,3
TRAV13-1,TRAJ53,CAAPNSGGSNYKLTF,3,0,1,3
TRAV13-1,TRAJ13,CAASLNSGGYQKVTF,5,0,1,5
TRAV13-1,TRAJ20,CAASPIRSNDYKLSF,3,0,1,3
TRAV29DV5,TRAJ30,CAASAVEGRDDKIIF,3,0,1,3
TRAV29DV5,TRAJ44,CAARNWGGTASKLTF,3,0,1,3
TRAV5,TRAJ23,CAEVPLGNQGGKPIF,3,0,1,3
TRAV12-3,TRAJ48,CAMSAEVRGNEKLTF,3,0,1,3
TRAV12-3,TRAJ37,CAMSATGGNTGKLIF,3,0,1,3
TRAV12-3,TRAJ45,CAMSGWGGGADGLTF,3,0,1,3
TRAV14DV4,TRAJ17,CAMREPRAAGNKLTF,3,0,1,3
TRAV14DV4,TRAJ15,CAMREKRQAGTALIF,3,0,1,3
TRAV26-1,TRAJ44,CIVRPGVGTASKLTF,3,0,1,3
TRAV26-1,TRAJ5,CIVRVPDTGRRALTF,3,0,1,3
TRAV26-1,TRAJ37,CIVRGSSGNTGKLIF,3,0,1,3
TRAV12-1,TRAJ22,CPNRREGSARQLTF,3,0,1,3
TRAV12-1,TRAJ3,CVVSSGSSASKIIF,3,0,1,3
TRAV12-1,TRAJ15,CVVVPFGAGTALIF,3,0,1,3
TRAV12-1,TRAJ43,CVVNGFNNNNDMRF,3,0,1,3
TRAV12-1,TRAJ27,CVVNGPTNAGKSTF,3,0,1,3
TRAV12-1,TRAJ20,CVVNTRSNDYKLSF,3,0,1,3
TRAV12-1,TRAJ4,CVALVSGGYNKLIL,3,0,1,3
TRAV12-1,TRAJ15,CVAKGFEAGTALIF,3,0,1,3
TRAV21,TRAJ45,CASDSGGGADGLTF,3,0,1,3
TRAV16,TRAJ12,CALQTRDSSYKLIF,3,0,1,3
TRAV9-2,TRAJ10,CALAVTGGGNKLTF,3,0,1,3
TRAV9-2,TRAJ50,CALMSQTSYDKVIF,3,0,1,3
TRAV9-2,TRAJ4,CALSDRGGYNKLIF,3,0,1,3
TRAV9-2,TRAJ6,CALSDKGGSYIPTF,3,0,1,3
TRAV9-2,TRAJ8,CALSDTTGFQKLVF,3,5,2,8
TRAV9-2,TRAJ30,CALSEIGRDDKIIF,3,0,1,3
TRAV19,TRAJ41,CALSNGDSGYALNF,3,0,1,3
TRAV9-2,TRAJ9,CALSANTGGFKTIF,3,0,1,3
TRAV9-2,TRAJ26,CALRSGNYGQNFVF,3,0,1,3
TRAV16,TRAJ29,CALSGGSGNTPLVF,3,0,1,3
TRAV16,TRAJ58,CALNQETSGSRLTF,3,0,1,3
TRAV16,TRAJ6,CAPLSSGGSYIPTF,3,0,1,3
TRAV41,TRAJ42,CAVYYGGSQGNLIF,3,0,1,3
TRAV20,TRAJ13,CAVLPSGGYQKVTF,3,0,1,3
TRAV20,TRAJ38,CAVQYAGNNRKLIW,3,0,1,3
TRAV20,TRAJ34,CAVQAGGDTDKLIF,3,0,1,3
TRAV8-3,TRAJ47,CAVGAMEYGNKLVF,3,0,1,3
TRAV2,TRAJ37,CAVGGPSNTGKLIF,3,0,1,3
TRAV8-6,TRAJ32,CAVSYGGATNKLIF,3,0,1,3
TRAV8-6,TRAJ27,CAVSDAANAGKSTF,3,0,1,3
TRAV8-6,TRAJ9,CAVSDGTGGFKTIF,3,0,1,3
TRAV21,TRAJ11,CAVRPGSGYSTLTF,3,0,1,3
TRAV3,TRAJ42,CAVRGRRSQGNLIF,3,0,1,3
TRAV3,TRAJ31,CAVRDRRNNARLMF,3,0,1,3
TRAV3,TRAJ29,CAVRDNSGNTPLVF,3,0,1,3
TRAV12-2,TRAJ41,CAVREKNSGYALNF,3,0,1,3
TRAV3,TRAJ32,CAVKGGGATNKPIF,3,0,1,3
TRAV3,TRAJ21,CAARPNINFNKFYF,3,0,1,3
TRAV2,TRAJ36,CAAGCQTGANNLFF,3,0,1,3
TRAV17,TRAJ10,CATAVTGGGNKLTF,3,4,2,7
TRAV17,TRAJ45,CATEAGGGADGLTF,3,0,1,3
TRAV16,TRAJ6,CALRRGGGSYIPTF,3,0,1,3
TRAV22,TRAJ45,CAPNSGGGADGLTF,3,0,1,3
TRAV8-1,TRAJ3,CAVTRYSSASKIIF,3,0,1,3
TRAV8-1,TRAJ36,CAVRGQTGANNLFF,3,0,1,3
TRAV12-2,TRAJ49,CAVNEGVAGNQFYF,3,0,1,3
TRAV12-2,TRAJ17,CAVKNKAAGNKLTF,3,0,1,3
TRAV12-2,TRAJ4,CAVKKAGGYNKLIF,3,0,1,3
TRAV25,TRAJ45,CAVLRGGGADGLTF,3,0,1,3
TRAV29DV5,TRAJ47,CAAERMEYGNKLVF,3,0,1,3
TRAV23DV6,TRAJ16,CAAEGGQDGQKLLF,3,0,1,3
TRAV13-1,TRAJ37,CAAIVVSNTGKLIF,3,0,1,3
TRAV23DV6,TRAJ32,CAAMMGGATNKLIF,3,0,1,3
TRAV13-1,TRAJ3,CAASRGSSASKIIF,3,0,1,3
TRAV29DV5,TRAJ58,CAASVETSGSRLTF,3,0,1,3
TRAV13-1,TRAJ42,CAASMTGSQGNLIF,3,0,1,3
TRAV13-1,TRAJ10,CAASTPGGGNKLTF,3,0,1,3
TRAV29DV5,TRAJ49,CAASAPGTGNQFYF,3,0,1,3
TRAV13-1,TRAJ42,CAASSGGSQGNLIF,3,0,1,3
TRAV27,TRAJ44,CAGDKAGTASKLTF,3,0,1,3
TRAV5,TRAJ44,CAEYNAGTASKLAF,3,0,1,3
TRAV5,TRAJ13,CAEAATGGYQKVTF,3,0,1,3
TRAV12-3,TRAJ10,CAMILTGGGNKLTF,3,0,1,3
TRAV12-3,TRAJ44,CAMSKAGTASKLTF,3,0,1,3
TRAV12-3,TRAJ27,CAMSSNTNAGKSTF,3,0,1,3
TRAV12-3,TRAJ26,CAMSARNYGQNFVF,3,0,1,3
TRAV12-3,TRAJ33,CAMSGRDSNYQLIW,3,0,1,3
TRAV12-3,TRAJ48,CAMRVEFGNEKLTF,3,0,1,3
TRAV12-3,TRAJ34,CAMRRPYNTDKLIF,3,0,1,3
TRAV14DV4,TRAJ58,CAMREGSWGSRLTF,3,0,1,3
TRAV12-3,TRAJ7,CAMNTLYGNNRLAF,3,0,1,3
TRAV34,TRAJ22,CGADYSGSARQLTF,3,0,1,3
TRAV39,TRAJ6,CTMTLSGGSYIPTF,3,0,1,3
TRAV4,TRAJ29,CLVGPNSGNTPLVF,3,0,1,3
TRAV26-2,TRAJ45,CILYSGGGADGLTF,3,0,1,3
TRAV26-2,TRAJ35,CILRVIGFGNVLHC,3,2,2,5
TRAV12-1,TRAJ8,CVVMDTGFQKLVF,3,0,1,3
TRAV12-1,TRAJ13,CVVRSGGYQKVTF,3,0,1,3
TRAV12-1,TRAJ4,CVVNGGGYNKLIF,3,0,1,3
TRAV12-1,TRAJ36,CVVNNAGANNLFF,3,0,1,3
TRAV3,TRAJ26,CASASNYGQNFVF,3,0,1,3
TRAV38-2DV8,TRAJ17,CAYETSAGNKLTF,3,0,1,3
TRAV9-2,TRAJ24,CALPTDSWGKFQF,3,0,1,3
TRAV16,TRAJ13,CALNSGGYQKVTF,3,0,1,3
TRAV9-2,TRAJ13,CALLSGGYQKVTF,3,0,1,3
TRAV19,TRAJ20,CALSEPNDYKLSF,3,0,1,3
TRAV6,TRAJ8,CALSDTGFQKLVF,3,0,1,3
TRAV16,TRAJ57,CALTQGGSEKLVF,3,4,2,7
TRAV17,TRAJ12,CAPEMDSSYKLIF,3,0,1,3
TRAV41,TRAJ31,CAVSTRNNARLMF,3,0,1,3
TRAV20,TRAJ6,CAVLKGGSYIPTF,3,0,1,3
TRAV2,TRAJ4,CAVLSGGYNKLIF,3,0,1,3
TRAV21,TRAJ15,CAVPHQAGTALIF,3,0,1,3
TRAV8-3,TRAJ47,CAVQREYGNKLVF,3,0,1,3
TRAV20,TRAJ26,CAVQASDGQNFVF,3,0,1,3
TRAV8-3,TRAJ7,CAVVSYGNNRLAF,3,0,1,3
TRAV2,TRAJ42,CAVVGGSQGNLIF,3,0,1,3
TRAV8-3,TRAJ7,CAVAPYGNNRLAF,3,0,1,3
TRAV2,TRAJ6,CAVAAGGSYIPTF,3,0,1,3
TRAV2,TRAJ10,CAVEERGGIKLTF,3,0,1,3
TRAV8-3,TRAJ27,CAVMDTNAGKSTF,3,3,2,6
TRAV12-2,TRAJ20,CAAFSSNDYKLSF,3,0,1,3
TRAV41,TRAJ34,CAAYVSNTDKLIF,3,0,1,3
TRAV17,TRAJ45,CATRRGGADGLTF,3,0,1,3
TRAV17,TRAJ16,CATLSGDGQKLLF,3,0,1,3
TRAV17,TRAJ34,CATDAGFTDKLIF,3,0,1,3
TRAV24,TRAJ23,CAFSDHQGGKLIF,3,0,1,3
TRAV12-2,TRAJ3,CASSKSSASKIIF,3,0,1,3
TRAV6,TRAJ44,CAPQTGTASKLTF,3,0,1,3
TRAV12-2,TRAJ29,CAVVSSGNTPLVF,3,0,1,3
TRAV12-2,TRAJ29,CAVKVDGNTPLVF,3,0,1,3
TRAV26-2,TRAJ40,CASEVSGTYKYIF,3,0,1,3
TRAV12-3,TRAJ22,CALLGGSARQLTF,3,0,1,3
TRAV5,TRAJ36,CAALREGANNLFF,3,0,1,3
TRAV23DV6,TRAJ32,CAALGGATNKLIF,3,0,1,3
TRAV13-1,TRAJ13,CAATPGGYQKVTF,3,4,2,7
TRAV13-1,TRAJ22,CAASQGSARQLTF,3,0,1,3
TRAV29DV5,TRAJ34,CAASKYRTDKLIF,3,0,1,3
TRAV13-1,TRAJ21,CAARPGGFNKFYF,3,0,1,3
TRAV29DV5,TRAJ36,CAARRTGANNLFF,3,0,1,3
TRAV29DV5,TRAJ53,CAANEGSNYKLTF,3,0,1,3
TRAV27,TRAJ24,CAGATDSWGKFQF,3,0,1,3
TRAV27,TRAJ49,CAGGRYTGNQFYF,3,0,1,3
TRAV5,TRAJ16,CAEGFSDGQKLLF,3,0,1,3
TRAV5,TRAJ40,CAESTSGTYKYIF,3,0,1,3
TRAV13-2,TRAJ5,CAENRAGRRALTF,3,3,2,6
TRAV12-3,TRAJ47,CAMGPRGGNKLVF,3,0,1,3
TRAV12-3,TRAJ17,CAMIKAAGNKLTF,3,5,2,8
TRAV12-3,TRAJ17,CAMSQAAGNKLTF,3,0,1,3
TRAV12-3,TRAJ58,CAMSKTSGSRLTF,3,0,1,3
TRAV12-3,TRAJ21,CAMSVYNFNKFYF,3,0,1,3
TRAV12-3,TRAJ22,CAMSGGSARQLTF,3,0,1,3
TRAV12-3,TRAJ37,CAMSEGNTGKLIF,3,0,1,3
TRAV14DV4,TRAJ49,CAMREGTGNQFYF,3,0,1,3
TRAV12-3,TRAJ8,CAMKNTGFQKLVF,3,0,1,3
TRAV12-3,TRAJ13,CATSRAGYQKVTF,3,0,1,3
TRAV4,TRAJ11,CLVGPSGYSTLTF,3,0,1,3
TRAV4,TRAJ21,CLVGEYNFNKFYF,3,0,1,3
TRAV4,TRAJ34,CLVDAYNTDELIF,3,0,1,3
TRAV16,TRAJ50,CLEAKTSYDKVIF,3,0,1,3
TRAV26-2,TRAJ46,CILRKSSGDKLTF,3,0,1,3
TRAV25,TRAJ41,WRGVSSSGYALNF,3,0,1,3
TRAV23DV6,TRAJ18,FRRGSTLGRLYF,3,0,1,3
TRAV8-2,TRAJ43,CVVSDLVRDMRF,3,0,1,3
TRAV12-1,TRAJ36,CVVNPGANNLFF,3,0,1,3
TRAV9-2,TRAJ4,CALSGGYNKLIF,3,0,1,3
TRAV9-2,TRAJ9,CALCTGGFKTIF,3,0,1,3
TRAV9-2,TRAJ49,CALRHTGNQFYF,3,0,1,3
TRAV16,TRAJ10,CALTGGGNKLTF,5,0,1,5
TRAV16,TRAJ20,CALSDNDYKLSF,3,0,1,3
TRAV16,TRAJ34,CALRANTDKLIF,3,0,1,3
TRAV19,TRAJ15,CAQNQAGTALIF,3,0,1,3
TRAV22,TRAJ44,CAVGRAASKLTF,3,0,1,3
TRAV8-3,TRAJ5,CAVGAPARALTF,3,0,1,3
TRAV2,TRAJ31,CAVEDNNARLMF,3,0,1,3
TRAV12-2,TRAJ27,CAVIGSAGKSTF,3,0,1,3
TRAV35,TRAJ21,CAGLYNFNKFYF,3,0,1,3
TRAV35,TRAJ33,CAGRRSNYQLIW,3,0,1,3
TRAV35,TRAJ49,CAGINTGNQFYF,3,0,1,3
TRAV17,TRAJ20,CATDLNDYKLSF,3,0,1,3
TRAV12-2,TRAJ8,CARGTGFQKLVF,3,0,1,3
TRAV21,TRAJ3,CAVYSSASKIIF,5,0,1,5
TRAV39,TRAJ39,CAVDGWSNMLTF,3,0,1,3
TRAV8-1,TRAJ30,CAVTPWDDKIIF,3,0,1,3
TRAV39,TRAJ21,CAVRNNFNKFYF,3,9,2,12
TRAV12-2,TRAJ43,CAVNEFLDDMRF,3,0,1,3
TRAV12-2,TRAJ9,CAVNEGGFKTIF,3,0,1,3
TRAV12-2,TRAJ20,CAVNENDYKLSF,3,0,1,3
TRAV12-2,TRAJ27,CAVKANAGKSTF,3,0,1,3
TRAV8-1,TRAJ5,CAVKAGRRALTF,3,0,1,3
TRAV8-1,TRAJ43,CAVKPEGNDMRF,3,0,1,3
TRAV8-1,TRAJ42,CAARGSQGNLIF,3,0,1,3
TRAV25,TRAJ31,CAVKNNNARLMF,3,0,1,3
TRAV13-1,TRAJ49,CAAITSGNQFYF,3,0,1,3
TRAV13-1,TRAJ49,CAASITGNQFYF,3,0,1,3
TRAV13-1,TRAJ30,CAASRGDDKIIF,3,0,1,3
TRAV13-1,TRAJ48,CAASGPSEKLTF,3,0,1,3
TRAV13-1,TRAJ3,CAARGSASKIIF,3,0,1,3
TRAV27,TRAJ22,CAGAGSARQLTF,3,0,1,3
TRAV27,TRAJ54,CAGGKGAQKLVF,3,0,1,3
TRAV5,TRAJ41,CAERRTGYALNF,3,0,1,3
TRAV14DV4,TRAJ43,CATPRENNDMRF,3,0,1,3
TRAV4,TRAJ30,CLVPRGEDKIIF,3,0,1,3
TRAV1-1,TRAJ33,CAVRDSNYQLIW,3,4,2,7
TRAV30,TRAJ27,CGTGTNAGKSTF,3,0,1,3
TRAV30,TRAJ40,CGTERGTYKYIF,3,0,1,3
TRAV8-2,TRAJ24,CVVPSWGKFQF,3,0,1,3
TRAV12-1,TRAJ49,CVVRTGNQFYF,3,4,2,7
TRAV19,TRAJ7,CALSGNNRLAF,3,0,1,3
TRAV8-3,TRAJ20,CAGGNDYKLSF,3,0,1,3
TRAV12-2,TRAJ23,CAVFPGGKLIF,3,0,1,3
TRAV13-1,TRAJ30,CAASKTDKIIF,3,0,1,3
TRAV13-2,TRAJ31,CAEGDNARLMF,3,0,1,3
TRAV12-3,TRAJ20,CAMWDDYKLSF,3,0,1,3
TRAV12-3,TRAJ20,CAMSAGYKLSF,3,0,1,3
TRAV26-2,TRAJ33,CILYSNYQLIW,3,0,1,3
TRAV8-2,TRAJ33,CVVSNYQLIW,3,0,1,3
TRAV13-2,TRAJ20,CVEGDYKLSF,3,0,1,3
TRAV21,TRAJ30,CAVRDDKIIF,3,0,1,3
TRAV12-2,TRAJ23,CAAQGGKLIF,3,0,1,3
TRAV13-1,TRAJ27,CAASRGKSTF,3,0,1,3
TRAV13-2,TRAJ57,CAERVPSQGGSERLVF,3,0,1,3
TRAV38-1,TRAJ42,CAFGFGGSQGNLIF,3,0,1,3
TRAV16,TRAJ23,CALTSYNRGGKLIF,3,0,1,3
TRAV12-3,TRAJ6,CAMSGAGGSYIPTF,3,0,1,3
TRAV8-6,TRAJ20,CAVSDRNDYKLSL,3,0,1,3
TRAV23DV6,TRAJ36,CAARPGANNLFF,3,0,1,3
TRAV8-1,TRAJ10,CAVNKVTGGGNKLIF,3,0,1,3
TRAV12-1,TRAJ52,CVVKRARDAGGTSYGKLTF,2,0,1,2
TRAV17,TRAJ52,CATDGLRDAGGTSYGKPTF,2,0,1,2
TRAV12-1,TRAJ3,CVVNKGRGLYSSASKIIF,2,0,1,2
TRAV38-1,TRAJ53,CAFMKLIRPGGSNYKLTF,2,0,1,2
TRAV38-2DV8,TRAJ32,CAYRSAFSGGGATNKLIF,2,0,1,2
TRAV8-6,TRAJ28,CAVRGPTYSGAGSYQLTF,2,0,1,2
TRAV3,TRAJ45,CAVRDPPYSGGGADGLTF,2,6,2,8
TRAV17,TRAJ53,CATDAGDFSGGSNYKLTF,2,0,1,2
TRAV23DV6,TRAJ11,CAAHPPGEVNSGYSTLTF,2,0,1,2
TRAV13-1,TRAJ53,CAASKGGNSGGSNYKLTF,2,0,1,2
TRAV29DV5,TRAJ45,CAASGVRGSGGGADGLTF,2,0,1,2
TRAV8-2,TRAJ5,CVVSDTYMDTGRRALTF,2,0,1,2
TRAV10,TRAJ48,CVVSDLISNFGNEKLTF,2,0,1,2
TRAV19,TRAJ44,CALSEARNTGTASKLTF,2,0,1,2
TRAV8-3,TRAJ42,CAVGPMNYGGSQGNLIF,2,0,1,2
TRAV3,TRAJ5,CAVREPPRPAGRRALTF,2,0,1,2
TRAV17,TRAJ18,CATPPADRGSTLGRLYF,2,0,1,2
TRAV12-2,TRAJ28,CAVNKGRTGAGSYQLTF,2,0,1,2
TRAV12-1,TRAJ42,CVVNKPRGGSQGNLIF,2,0,1,2
TRAV38-2DV8,TRAJ54,CAFSRGRFQGAQKLVF,2,0,1,2
TRAV9-2,TRAJ53,CALSGGSGGSNYKLTF,2,0,1,2
TRAV23DV6,TRAJ18,CAVPADRGSTLGRLYF,2,0,1,2
TRAV8-3,TRAJ45,CAVVAYSGGGADGLTF,2,0,1,2
TRAV2,TRAJ32,CAVESSNGGATNKLIF,2,0,1,2
TRAV36DV7,TRAJ45,CAVEIYSGGGADGLTF,2,0,1,2
TRAV8-4,TRAJ37,CAVSLVVTSNTGKLIF,2,0,1,2
TRAV8-4,TRAJ53,CAVSEGSGGSNYKLTF,2,0,1,2
TRAV17,TRAJ28,CATVPYSGAGSYQLTF,2,0,1,2
TRAV8-1,TRAJ13,CAVNAAGSGGYQKVTF,2,0,1,2
TRAV29DV5,TRAJ40,CAASAGGTSGTYKYIF,2,0,1,2
TRAV29DV5,TRAJ42,CAASGGYGGSQGNLIF,2,0,1,2
TRAV23DV6,TRAJ47,CAASDTGAEYGNKLVF,2,0,1,2
TRAV8-2,TRAJ40,CVVSDRASGTYKYIF,2,0,1,2
TRAV12-1,TRAJ17,CVQLTLRAAGNKLTF,2,0,1,2
TRAV10,TRAJ40,CVVSPQTSGTYKYIF,2,0,1,2
TRAV38-2DV8,TRAJ57,CAYRPSQGGSEKLVF,2,0,1,2
TRAV9-2,TRAJ12,CALISSGDSSYKLIF,2,0,1,2
TRAV19,TRAJ47,CALSEVMEYGNKLVF,2,0,1,2
TRAV19,TRAJ3,CALSEADSSASKIIF,2,0,1,2
TRAV9-2,TRAJ50,CALRMMKTSYDKVIF,2,0,1,2
TRAV9-2,TRAJ53,CALRASGGSNYKLTF,2,0,1,2
TRAV9-2,TRAJ18,CALKGGGSTLGRLYF,2,0,1,2
TRAV16,TRAJ18,CALTPRGSTLGRLYF,2,0,1,2
TRAV16,TRAJ28,CALSGHGAGSYQLTF,2,0,1,2
TRAV23DV6,TRAJ42,CAVGGYGGSQGNLIF,2,0,1,2
TRAV3,TRAJ5,CAVGGMDTGRRALTF,2,0,1,2
TRAV8-4,TRAJ10,CAVTSSKGGGNKLTF,2,0,1,2
TRAV3,TRAJ48,CAVRDPNFGNEKLTF,2,0,1,2
TRAV3,TRAJ15,CAVRDMRQAGTALIF,2,0,1,2
TRAV17,TRAJ44,CATASLTGTASKLTF,2,0,1,2
TRAV17,TRAJ12,CATDPLMDSSYKLIF,2,0,1,2
TRAV17,TRAJ24,CATEMTTDSWGKFQF,2,0,1,2
TRAV8-1,TRAJ45,CAVSASGGGADGLTF,2,0,1,2
TRAV8-1,TRAJ27,CAVNGGGTNAGKSTF,2,0,1,2
TRAV12-2,TRAJ11,CAVNGGYSGYSTLTF,2,0,1,2
TRAV12-2,TRAJ42,CAVNMRTGSQGNLIF,2,0,1,2
TRAV29DV5,TRAJ28,CAAARSGAGSYQLTF,2,0,1,2
TRAV13-1,TRAJ32,CAATDYGGATNKLIF,2,0,1,2
TRAV13-1,TRAJ36,CAASGVGTGANNLFF,2,0,1,2
TRAV13-1,TRAJ17,CAASIPRAAGNKLTF,2,0,1,2
TRAV29DV5,TRAJ21,CAASDSRGNFNKFYF,2,0,1,2
TRAV29DV5,TRAJ37,CAASEPGSNTGKLIF,2,0,1,2
TRAV23DV6,TRAJ32,CAASMDGGATNKLIF,2,0,1,2
TRAV23DV6,TRAJ37,CAAKSPPSNTGKLIF,2,0,1,2
TRAV5,TRAJ3,CAETGSYSSPSKIIF,2,0,1,2
TRAV5,TRAJ22,CAESITLGSARQLTF,2,0,1,2
TRAV12-3,TRAJ38,CAMRGPAGNNRKLIW,2,0,1,2
TRAV4,TRAJ6,CLVGSTSGGSYIPTF,2,0,1,2
TRAV4,TRAJ12,CLVGAGMDSSYKLIF,2,0,1,2
TRAV12-1,TRAJ11,CVVNWNSGYSTLTF,2,0,1,2
TRAV38-2DV8,TRAJ56,CAFLSTGANSKLTF,2,0,1,2
TRAV38-1,TRAJ43,CAFMKVQGNNDMRF,2,0,1,2
TRAV38-2DV8,TRAJ43,CAYRSVYNNNDMRF,2,0,1,2
TRAV9-2,TRAJ31,CALSDRNNNARLMF,2,0,1,2
TRAV9-2,TRAJ54,CALSDFQGAQKLVF,2,0,1,2
TRAV9-2,TRAJ12,CALSDEDSSYKLIF,2,0,1,2
TRAV9-2,TRAJ9,CALSENTGGFKTIF,2,0,1,2
TRAV9-2,TRAJ39,CALSEPNAGNMLTF,2,0,1,2
TRAV19,TRAJ39,CALRFGNAGNMLTF,2,0,1,2
TRAV29DV5,TRAJ9,CALRADTGGFKTIF,2,0,1,2
TRAV9-2,TRAJ10,CALILTGGGNKLTF,2,0,1,2
TRAV16,TRAJ35,CAPPPIGFGNVLHC,2,0,1,2
TRAV9-2,TRAJ23,CAPLSGNQGGKLIF,2,0,1,2
TRAV21,TRAJ58,CAVYKETSGSRLTF,2,0,1,2
TRAV20,TRAJ13,CAVQTTGGYQKVTF,2,0,1,2
TRAV21,TRAJ10,CAVGLTGGGNKLTF,2,0,1,2
TRAV8-3,TRAJ20,CAVGGRSNDYKLSF,2,0,1,2
TRAV36DV7,TRAJ52,CAVDRGTSYGKLTF,2,0,1,2
TRAV22,TRAJ58,CAVERGLGDSRLTF,2,0,1,2
TRAV8-4,TRAJ10,CAVSVGGGGNKLTF,2,0,1,2
TRAV8-4,TRAJ56,CAVSGGGANSRLTF,2,0,1,2
TRAV8-4,TRAJ42,CAVSERGSQGNLVF,2,0,1,2
TRAV8-3,TRAJ40,CAVSTTSGTYKYIF,2,0,1,2
TRAV12-2,TRAJ12,CAVRRLDSSYKLIF,2,0,1,2
TRAV21,TRAJ11,CAVRQASGYSTLTF,2,0,1,2
TRAV36DV7,TRAJ7,CAAQTRYGNNRLAF,2,0,1,2
TRAV8-4,TRAJ12,CAAGWMDSSYKLIF,2,0,1,2
TRAV35,TRAJ53,CAGPRGGSNYKLTF,2,0,1,2
TRAV17,TRAJ54,CATAPTQGAQKLVF,2,0,1,2
TRAV17,TRAJ29,CATARNSGNTPLVF,2,0,1,2
TRAV17,TRAJ39,CATDEDNAGNMLTF,2,0,1,2
TRAV17,TRAJ31,CATDLPVNNARLMF,2,0,1,2
TRAV17,TRAJ53,CATDVGGSNYKLTF,2,0,1,2
TRAV17,TRAJ13,CATDRRGGYQKVTF,2,0,1,2
TRAV39,TRAJ17,CALSPGAAGNKLTF,2,0,1,2
TRAV39,TRAJ17,CAPDRGAAGNKLTF,2,0,1,2
TRAV12-2,TRAJ6,CAVRGTGGSYIPTF,2,0,1,2
TRAV12-2,TRAJ45,CAVASGGGADGLTF,2,0,1,2
TRAV8-1,TRAJ30,CAVESMNRDDKIIF,2,0,1,2
TRAV8-1,TRAJ17,CAVIWEAAGNKLTF,2,0,1,2
TRAV8-1,TRAJ48,CAVIPSFGNEKLTF,2,0,1,2
TRAV8-1,TRAJ8,CAVTLNTGFQKLVF,2,0,1,2
TRAV8-1,TRAJ45,CAVNSGGGADGLTF,2,0,1,2
TRAV8-1,TRAJ46,CAVNAESSGDKLTF,2,0,1,2
TRAV12-2,TRAJ29,CAVNLGSGNTPLVF,2,0,1,2
TRAV12-2,TRAJ4,CAVKGSGGYNKLIF,2,0,1,2
TRAV12-2,TRAJ8,CAVKRNTGFQKLVF,2,0,1,2
TRAV25,TRAJ17,CARSLKAAGNKLTF,2,0,1,2
TRAV13-1,TRAJ6,CAALGGGGSYIPTF,2,0,1,2
TRAV13-1,TRAJ32,CAAGDGGATNKLIF,2,0,1,2
TRAV29DV5,TRAJ45,CAAESGGGADGLTF,2,0,1,2
TRAV13-1,TRAJ8,CAASRLAGFQKLVF,2,0,1,2
TRAV13-1,TRAJ20,CAASEWSNDYKLSF,2,14,2,16
TRAV29DV5,TRAJ3,CAASVYSSASKIIF,2,0,1,2
TRAV29DV5,TRAJ13,CAASGSGGYQKVTF,2,0,1,2
TRAV29DV5,TRAJ22,CAASGPGSARQLTF,2,0,1,2
TRAV29DV5,TRAJ27,CAASTVPNAGKSTF,2,0,1,2
TRAV27,TRAJ58,CAGPRETSGSRLTF,2,0,1,2
TRAV27,TRAJ26,CAGARNNYGQNFVF,2,0,1,2
TRAV27,TRAJ37,CAGEMGSNTGKLIF,2,0,1,2
TRAV27,TRAJ3,CAGTLYSSASKIIF,2,0,1,2
TRAV5,TRAJ27,CAERAYTNAGKSTF,2,0,1,2
TRAV13-2,TRAJ23,CAENINNQGGKLIF,2,0,1,2
TRAV5,TRAJ6,CAENVGGGSYIPTF,2,0,1,2
TRAV12-3,TRAJ54,CAMTPAWGAQKLVF,2,0,1,2
TRAV12-3,TRAJ54,CAMSFIQGAQKLVF,2,0,1,2
TRAV12-3,TRAJ53,CAMNSGGSNYKLTF,2,0,1,2
TRAV12-3,TRAJ8,CAMKGNTGFQKLVF,2,0,1,2
TRAV4,TRAJ39,CLVGPNNAGNMLTF,2,0,1,2
TRAV26-1,TRAJ37,CIVRVVFDTGKLIF,2,0,1,2
TRAV39,TRAJ32,WAGALGGATNKLIF,2,0,1,2
TRAV5,TRAJ6,RAENVGGGSYIPTF,2,0,1,2
TRAV8-2,TRAJ20,CVVSDRFDYKLSF,2,0,1,2
TRAV12-1,TRAJ26,CVVNSFYGQNFVF,2,0,1,2
TRAV12-1,TRAJ17,CVAWEAAGNKLTF,2,0,1,2
TRAV38-2DV8,TRAJ44,CALDTGTASKLTF,2,0,1,2
TRAV9-2,TRAJ56,CASLTGANSKLTF,2,8,2,10
TRAV9-2,TRAJ7,CALSPYGNNRLAF,2,0,1,2
TRAV9-2,TRAJ20,CALSDPSDYKLSF,2,0,1,2
TRAV9-2,TRAJ13,CALSDKGYQKVTF,2,0,1,2
TRAV9-2,TRAJ11,CALSGSGYSTLTF,2,0,1,2
TRAV9-2,TRAJ49,CALRENTGNQFYF,2,0,1,2
TRAV6,TRAJ36,CALVGTGANNLFF,2,4,2,6
TRAV21,TRAJ34,CAVDLYNTDKLIF,2,0,1,2
TRAV8-4,TRAJ8,CAVVGTGFQKLVF,2,0,1,2
TRAV8-3,TRAJ43,CAVASYNNNDMRF,2,0,1,2
TRAV22,TRAJ48,CAVADFGNEKLTF,2,0,1,2
TRAV36DV7,TRAJ40,CAVEASGTYKYIF,2,0,1,2
TRAV2,TRAJ33,CAVEDGGNYQLIW,2,0,1,2
TRAV36DV7,TRAJ53,CAVEGGSNYKLTF,2,0,1,2
TRAV8-4,TRAJ17,CAVIGAAGNKLTF,2,0,1,2
TRAV8-6,TRAJ49,CAVTSNTGNQFYF,2,0,1,2
TRAV8-4,TRAJ22,CAVSSGSARQLTF,2,0,1,2
TRAV8-4,TRAJ9,CAVSETGGFKTIF,2,0,1,2
TRAV8-6,TRAJ39,CAVSPLGGNMLTF,2,0,1,2
TRAV3,TRAJ40,CAVRDGGTYKYIF,2,0,1,2
TRAV12-2,TRAJ56,CAVRTGANSKLTF,2,6,2,8
TRAV35,TRAJ44,CAGPTGTASKLTF,2,0,1,2
TRAV17,TRAJ40,CATEGQGTYKYIF,2,0,1,2
TRAV17,TRAJ11,CATDATGYSTLTF,2,0,1,2
TRAV17,TRAJ11,CATDGRGYSTLTF,2,0,1,2
TRAV17,TRAJ13,CATVPEGYQKVTF,2,0,1,2
TRAV24,TRAJ37,CAFSVSNTGKLIF,2,0,1,2
TRAV24,TRAJ30,CAFPMNRDDKIIF,2,0,1,2
TRAV24,TRAJ28,CAFTRAGSYQLTF,2,0,1,2
TRAV12-2,TRAJ40,CAVFTSGTYKYIF,2,0,1,2
TRAV8-3,TRAJ15,CAVINQAGTALIF,2,0,1,2
TRAV8-1,TRAJ8,CAVLGQGFQKLVF,2,0,1,2
TRAV12-2,TRAJ28,CAVGRAGSYQLTF,2,0,1,2
TRAV12-2,TRAJ31,CAVMPPSRARLMF,2,0,1,2
TRAV8-1,TRAJ7,CAVTSYGNNRLAF,2,0,1,2
TRAV12-2,TRAJ6,CAVNVGGSYIPTF,2,0,1,2
TRAV8-1,TRAJ9,CAVKGTGGFKTIF,2,0,1,2
TRAV12-2,TRAJ10,CAVFTGGGNKLTF,2,0,1,2
TRAV12-2,TRAJ54,CAALIQGAQKLVF,2,0,1,2
TRAV29DV5,TRAJ20,CAAEPYNDYKLSF,2,0,1,2
TRAV13-1,TRAJ22,CAAYSGSARQLTF,2,0,1,2
TRAV29DV5,TRAJ46,CAAIESSGDKLTF,2,0,1,2
TRAV13-1,TRAJ5,CAATDTGRRALTF,2,0,1,2
TRAV13-1,TRAJ6,CAASKGGSYIPTF,2,0,1,2
TRAV13-1,TRAJ56,CAASKGANSKLTF,2,0,1,2
TRAV13-1,TRAJ50,CAASKTSYDKVIF,2,0,1,2
TRAV13-1,TRAJ6,CAARPGGSYIPTF,2,0,1,2
TRAV27,TRAJ3,CAGRYSSASKIIF,2,0,1,2
TRAV27,TRAJ27,CAGGRTNAGKSTF,2,0,1,2
TRAV13-2,TRAJ15,CAERSQAGTALIF,2,0,1,2
TRAV12-3,TRAJ5,CAMADTGRRALTF,2,0,1,2
TRAV12-3,TRAJ9,CAMGDTGGFKTIF,2,0,1,2
TRAV12-3,TRAJ49,CAMTSNTGNQFYF,2,0,1,2
TRAV12-3,TRAJ32,CAMSGGATNKLIF,2,0,1,2
TRAV12-3,TRAJ37,CAIDTGNTGKLIF,2,0,1,2
TRAV34,TRAJ40,CGADASGTYKYIF,2,0,1,2
TRAV4,TRAJ4,CLVISGGYNKLIF,2,0,1,2
TRAV4,TRAJ41,CLVGLNSGYALNF,2,0,1,2
TRAV26-2,TRAJ22,CILRGGSARQLTF,2,0,1,2
TRAV26-1,TRAJ44,CIGYTGTASKLTF,2,0,1,2
TRAV8-2,TRAJ20,CVVSFNDYKLSF,2,0,1,2
TRAV8-2,TRAJ7,CVVSEGNNRLAF,2,0,1,2
TRAV12-1,TRAJ22,CVASGSARQLTF,2,0,1,2
TRAV8-3,TRAJ17,CVEGAAGNKLTF,2,0,1,2
TRAV9-2,TRAJ49,CALSDPGNQFYF,2,0,1,2
TRAV6,TRAJ5,CALDTGRRALTF,2,3,2,5
TRAV1-2,TRAJ33,CAVQDSNYQLIW,2,0,1,2
TRAV41,TRAJ44,CAVPGTASKLTF,2,0,1,2
TRAV41,TRAJ35,CAVIRFGNVLHC,2,0,1,2
TRAV2,TRAJ31,CAVEESNARLMF,2,4,2,6
TRAV1-2,TRAJ33,CAVRDRNYQLIW,2,0,1,2
TRAV21,TRAJ23,CAGGNQGGKLIF,2,0,1,2
TRAV12-2,TRAJ6,CAVSGGSYIPTF,2,0,1,2
TRAV8-1,TRAJ29,CAVSAGNTPLVF,2,0,1,2
TRAV12-2,TRAJ49,CAVRWTGNQFYF,2,0,1,2
TRAV12-2,TRAJ43,CAVRVGNNDMRF,2,0,1,2
TRAV12-2,TRAJ5,CAVNQGRRALTF,2,0,1,2
TRAV12-2,TRAJ26,CAVKPYGQNFVF,2,0,1,2
TRAV25,TRAJ37,CAPASNTGKLIF,2,0,1,2
TRAV23DV6,TRAJ8,CAATTGFQKLVF,2,0,1,2
TRAV13-1,TRAJ36,CAASIRRDNLFF,2,0,1,2
TRAV29DV5,TRAJ43,CAASVNNNDMRF,2,0,1,2
TRAV27,TRAJ39,CAGENAGNMLTF,2,0,1,2
TRAV13-2,TRAJ20,CAEFPIRYKLSF,2,0,1,2
TRAV5,TRAJ34,CAEILNTDKLIF,2,0,1,2
TRAV12-3,TRAJ56,CAMSFREGKLTF,2,0,1,2
TRAV12-3,TRAJ20,CAMSANDYKLSF,2,0,1,2
TRAV30,TRAJ29,CGTETGNTPLVF,2,0,1,2
TRAV26-1,TRAJ49,CIVRVRGNQFYF,2,0,1,2
TRAV26-1,TRAJ31,CIVRVVYARLMF,2,0,1,2
TRAV26-1,TRAJ23,CIKENQGGKLFF,2,0,1,2
TRAV12-1,TRAJ5,RVVGGGRRALTF,2,0,1,2
TRAV24,TRAJ26,CVNNYGQNFVF,2,2,2,4
TRAV12-1,TRAJ40,CVFRPTDKYIF,2,0,1,2
TRAV12-1,TRAJ40,CVVSGTYKYIF,2,0,1,2
TRAV6,TRAJ11,CALVGYSTLTF,2,0,1,2
TRAV1-2,TRAJ20,CAVANDYKLSF,2,0,1,2
TRAV8-6,TRAJ43,CAVIINNDMRF,2,0,1,2
TRAV35,TRAJ43,CAGSLNNDLRF,2,0,1,2
TRAV17,TRAJ29,CATEGNTPLVF,2,0,1,2
TRAV26-2,TRAJ49,CILITGNQFYF,2,0,1,2
TRAV8-6,TRAJ10,WTSGGGNKLTF,2,0,1,2
TRAV41,TRAJ49,CAVTGNQFYF,2,6,2,8
TRAV13-1,TRAJ22,CAAKRVQLTF,2,0,1,2
TRAV27,TRAJ13,PSGGYQKVTF,2,0,1,2
TRAV8-4,TRAJ18,CASTGRLYF,2,0,1,2
TRAV36DV7,TRAJ54,CALAKKLVF,2,0,1,2
TRAV8-1,TRAJ30,CASPVKIIF,2,0,1,2
TRAV13-1,TRAJ26,RLRGQNFVF,2,0,1,2
TRAV27,TRAJ16,GSGQKLLF,2,0,1,2
TRAV8-2,TRAJ13,CVVSDREGGYQKVTF,2,0,1,2
TRAV12-2,TRAJ48,CPGGGNFGNEKLTF,2,0,1,2
TRAV21,TRAJ6,CAVLGGSYIPTF,0,31,1,31
TRAV17,TRAJ56,CATGANSKLTF,0,34,1,34
TRAV17,TRAJ48,CATSWAASARNFGNEKLTF,0,24,1,24
TRAV38-2DV8,TRAJ39,CAYNNAGNMLTF,0,24,1,24
TRAV8-3,TRAJ48,CAVDPISNFGNEKLTF,0,24,1,24
TRAV20,TRAJ3,CAVQGLYSSASKIIF,0,24,1,24
TRAV8-1,TRAJ6,CAVNRLSGGSYIPTF,0,23,1,23
TRAV3,TRAJ6,CAVRDIGGSYIPTF,0,23,1,23
TRAV26-2,TRAJ37,CILHGSSNTGKLIF,0,22,1,22
TRAV12-3,TRAJ22,CAFRASSGSARQLTF,0,22,1,22
TRAV4,TRAJ29,CLVGGRFSGNTPLVF,0,20,1,20
TRAV8-3,TRAJ17,CAVGARAAGNKLTF,0,19,1,19
TRAV17,TRAJ15,CATDDPNQAGTALIF,0,18,1,18
TRAV41,TRAJ32,CAVLGGATNKLIF,0,18,1,18
TRAV23DV6,TRAJ45,CAEGGGGADGLTF,0,18,1,18
TRAV12-2,TRAJ52,CAAGGTSYGKLTF,0,18,1,18
TRAV9-2,TRAJ31,CALSGNARLMF,0,18,1,18
TRAV26-2,TRAJ49,CILRDWRSNTGNQFYF,0,18,1,18
TRAV20,TRAJ42,CAVEGGSQGNLIF,0,18,1,18
TRAV14DV4,TRAJ52,CAMREVAGGTSYGKLTF,0,17,1,17
TRAV38-2DV8,TRAJ28,CAYIDAGAGSYQLTF,0,17,1,17
TRAV12-1,TRAJ13,CVVESSGGYQKVTF,0,16,1,16
TRAV9-2,TRAJ3,CAFPAPYSSASKIIF,0,16,1,16
TRAV9-2,TRAJ18,CALSDRESTLGRLYF,0,21,1,21
TRAV17,TRAJ30,CATDKMGSRDDKIIF,0,16,1,16
TRAV17,TRAJ15,CATDDNQAGTALIF,0,16,1,16
TRAV12-3,TRAJ58,CAFLQETSGSRLTF,0,16,1,16
TRAV20,TRAJ17,CAVQGAAGNKLTF,0,16,1,16
TRAV19,TRAJ12,CALSEPRMDSSYKLIF,0,15,1,15
TRAV12-3,TRAJ22,CAMSGWSSGSARQLTF,0,15,1,15
TRAV12-2,TRAJ22,CAVPHFSGSARQLTF,0,15,1,15
TRAV27,TRAJ37,CAGHGSSNTGKLIF,0,15,1,15
TRAV19,TRAJ49,CALRTNTGNQFYF,0,15,1,15
TRAV13-2,TRAJ11,CAAPNSGYSTLTF,0,15,1,15
TRAV27,TRAJ37,CAGGSNTGKLIF,0,15,1,15
TRAV29DV5,TRAJ34,CAANSLVKLIF,0,15,1,15
TRAV12-3,TRAJ26,CAMRDNYGQNFVF,0,15,1,15
TRAV17,TRAJ45,CATDEGRSPGGGADGLTF,0,15,1,15
TRAV12-2,TRAJ30,CAVRGRRDDKIIF,0,15,1,15
TRAV2,TRAJ9,CAVEALTGGFKTIF,0,15,1,15
TRAV8-1,TRAJ30,CAVNAPRDDKIIF,0,15,1,15
TRAV13-1,TRAJ39,CAAQDAGNMLTF,0,15,1,15
TRAV20,TRAJ21,CAVQAGYNFNKFYF,0,14,1,14
TRAV26-2,TRAJ40,CILYPASGTYKYIF,0,14,1,14
TRAV13-1,TRAJ4,CAAFPRSGGYNKLIF,0,14,1,14
TRAV17,TRAJ15,CATDANQAGTALIF,0,14,1,14
TRAV10,TRAJ33,CVVSADSNYQLIW,0,14,1,14
TRAV12-3,TRAJ6,CAMSARGSYIPTF,0,14,1,14
TRAV2,TRAJ29,CAGGSGNTPLVF,0,14,1,14
TRAV9-2,TRAJ11,CAQGGYSTLTF,0,14,1,14
TRAV38-2DV8,TRAJ43,CAYYNNDMRF,0,14,1,14
TRAV17,TRAJ52,CATDEDFNAGGTSYGKLTF,0,13,1,13
TRAV20,TRAJ58,CAVARRWETSGSRLTF,0,13,1,13
TRAV3,TRAJ42,CAVSPAYGGSQGNLIF,0,13,1,13
TRAV4,TRAJ8,CLVGDGMNTGFQKLVF,0,13,1,13
TRAV16,TRAJ34,CALGGSYNTDKLIF,0,13,1,13
TRAV17,TRAJ16,CATAPWTDGQKLLF,0,13,1,13
TRAV19,TRAJ29,CAQGRNSGNTPLVF,0,13,1,13
TRAV5,TRAJ29,CAESPFSGNTPLVF,0,19,1,19
TRAV9-2,TRAJ15,CALSDQAGTALIF,0,13,1,13
TRAV9-2,TRAJ20,CAPERSNDYKLSF,0,13,1,13
TRAV21,TRAJ41,CAVRQRSGYALNF,0,13,1,13
TRAV13-1,TRAJ5,CALSGPGRRALTF,0,13,1,13
TRAV13-2,TRAJ15,CAATNQAGTALIF,0,13,1,13
TRAV13-1,TRAJ13,CAATAGGYQKVTF,0,13,1,13
TRAV13-1,TRAJ13,CAASPGGYQKVTF,0,13,1,13
TRAV27,TRAJ27,CAGMVTNAGKSTF,0,13,1,13
TRAV12-2,TRAJ8,CAVTGFQKLVF,0,13,1,13
TRAV26-2,TRAJ44,CILQMTGTASKLTF,0,13,1,13
TRAV14DV4,TRAJ13,CAMGSSGGYQKVTF,0,13,1,13
TRAV17,TRAJ12,CATAGEWTRMDSSYKLIF,0,13,1,13
TRAV9-2,TRAJ32,CALSHGGATNKLIF,0,13,1,13
TRAV19,TRAJ37,CALSVLHGSSNTGKLIF,0,12,1,12
TRAV20,TRAJ53,CAVQARSGGSNYKLTF,0,12,1,12
TRAV16,TRAJ23,CALSGGANQGGKLIF,0,12,1,12
TRAV21,TRAJ58,CAVRLGETSGSRLTF,0,12,1,12
TRAV13-1,TRAJ6,CAASKGPGGSYIPTF,0,12,1,12
TRAV27,TRAJ37,CAGVFLGSNTGKLIF,0,12,1,12
TRAV14DV4,TRAJ5,CAMREGTSGRRALTF,0,12,1,12
TRAV22,TRAJ22,CAVVESGSARQLTF,0,12,1,12
TRAV8-1,TRAJ11,CAVTRNSGYSTLTF,0,12,1,12
TRAV9-2,TRAJ40,CALGHSGTYKYIF,0,12,1,12
TRAV8-1,TRAJ26,CAVSASSGQNFVF,0,12,1,12
TRAV13-1,TRAJ16,CAASISDGQKLLF,0,12,1,12
TRAV27,TRAJ22,CAGAGGSARQLTF,0,12,1,12
TRAV13-2,TRAJ13,CAENKGGYQKVTF,0,12,1,12
TRAV20,TRAJ15,CAVNQAGTALIF,0,12,1,12
TRAV26-1,TRAJ39,CIVNVPGNMLTF,0,12,1,12
TRAV3,TRAJ13,CAVVGYQKVTF,0,12,1,12
TRAV16,TRAJ42,CALGMARNYGGSQGNLIF,0,12,1,12
TRAV6,TRAJ45,CALGGSGGGADGLTF,0,12,1,12
TRAV30,TRAJ41,CGSERNSGYALNF,0,12,1,12
TRAV38-2DV8,TRAJ47,RAYRPRGVYGNKLVF,0,12,1,12
TRAV38-1,TRAJ57,CAFMKHGWTQGGSEKLVF,0,11,1,11
TRAV9-2,TRAJ58,CALGNMEETSASRLTF,0,11,1,11
TRAV12-2,TRAJ45,CAVNPPRGGADGLTF,0,11,1,11
TRAV24,TRAJ42,CASYYGGSQGNLIF,0,11,1,11
TRAV12-2,TRAJ23,CAVNIGNQGGKLIF,0,11,1,11
TRAV12-2,TRAJ9,CAVNNEGGGFKTIF,0,11,1,11
TRAV13-1,TRAJ6,CAASRSGGSYIPTF,0,11,1,11
TRAV14DV4,TRAJ37,CAMSYSGNTGKLTF,0,11,1,11
TRAV17,TRAJ26,CATDADYGQNFVF,0,11,1,11
TRAV5,TRAJ34,CAESGGNTDKLIF,0,11,1,11
TRAV26-2,TRAJ30,CILRDPRDDKIIF,0,11,1,11
TRAV2,TRAJ36,CAVETGANSLFF,0,11,1,11
TRAV13-1,TRAJ32,CAASATNKLIF,0,11,1,11
TRAV12-3,TRAJ30,CAMRRDDKIIF,0,11,1,11
TRAV14DV4,TRAJ30,CAMREGLRRDDKIIF,0,11,1,11
TRAV12-2,TRAJ45,CAVRGYHSGGGADGLTF,0,10,1,10
TRAV17,TRAJ40,CATDHALVFTSGTYKYIF,0,10,1,10
TRAV21,TRAJ22,CAVRSLFVGGSARQLTF,0,10,1,10
TRAV20,TRAJ32,CAVQGAYGGATNKLIF,0,10,1,10
TRAV2,TRAJ27,CAVEARRRANAGKSTF,0,10,1,10
TRAV10,TRAJ47,CVVTRGREYGNKLVF,0,10,1,10
TRAV38-2DV8,TRAJ45,CAYTRTGGGADGLTF,0,10,1,10
TRAV9-2,TRAJ47,CALSANMEYGNKLVF,0,10,1,10
TRAV17,TRAJ16,CATDGLYSDGQKLLF,0,10,1,10
TRAV12-2,TRAJ53,CAVPNSGGSNYKLTF,0,13,1,13
TRAV29DV5,TRAJ40,CAAHPVTSGTYKYIF,0,10,1,10
TRAV19,TRAJ45,CALPSGGGADGLTF,0,10,1,10
TRAV9-2,TRAJ15,CALSDPQAGTALIF,0,10,1,10
TRAV17,TRAJ23,CATDPLGQGGKLIF,0,10,1,10
TRAV12-3,TRAJ26,CAMRGNNYGQNFVF,0,10,1,10
TRAV34,TRAJ50,CGADFPTSYDKVIF,0,10,1,10
TRAV38-1,TRAJ31,CAFMNRNNARLMF,0,10,1,10
TRAV38-1,TRAJ30,CAFMKKRDDKIIF,0,10,1,10
TRAV9-2,TRAJ17,CALIKAAGNKLTF,0,10,1,10
TRAV8-3,TRAJ13,CAVAYGGYQKVTF,0,10,1,10
TRAV23DV6,TRAJ34,CAAKREDTDKLIF,0,10,1,10
TRAV9-2,TRAJ21,CALSGDFNKFYF,0,10,1,10
TRAV2,TRAJ39,CAVGNAGNMLTF,0,10,1,10
TRAV6,TRAJ3,CGVYSASKIIF,0,10,1,10
TRAV13-1,TRAJ47,CAASKGQKGNKLVF,0,10,1,10
TRAV14DV4,TRAJ11,CAMRPGYSTLTF,0,10,1,10
TRAV12-3,TRAJ38,CAFGNAGNNRKLIG,0,10,1,10
TRAV8-3,TRAJ49,CAVGANTGNQFYF,0,10,1,10
TRAV12-3,TRAJ42,CAMSGYGGSRGNLIF,0,10,1,10
TRAV6,TRAJ15,CARGEAGTALIF,0,10,1,10
TRAV5,TRAJ40,CAESVPSGTYKYIF,0,10,1,10
TRAV13-1,TRAJ7,CAASIGRSRLAF,0,10,1,10
TRAV4,TRAJ4,CLVGDVRGYNKLIF,0,9,1,9
TRAV35,TRAJ57,CAGQLGGSEKLVF,0,9,1,9
TRAV8-3,TRAJ21,CAVGDFNKFYF,0,9,1,9
TRAV19,TRAJ58,CALRGDRETSGSRLTF,0,9,1,9
TRAV13-1,TRAJ37,CAPWVTSSNTGKLIF,0,9,1,9
TRAV41,TRAJ57,CAVLTQGGSEKLVF,0,9,1,9
TRAV35,TRAJ45,CAGRATHSGGGADGLAF,0,9,1,9
TRAV29DV5,TRAJ45,CAARPGSSGGGADGLTF,0,9,1,9
TRAV41,TRAJ48,CAVRSSLGFGNEKLTF,0,9,1,9
TRAV20,TRAJ40,CAVQPRTTSGTYKYIF,0,9,1,9
TRAV8-3,TRAJ32,CAVAPGDGGATNKLIF,0,9,1,9
TRAV14DV4,TRAJ8,CAMRESRERGFQKLVF,0,9,1,9
TRAV26-2,TRAJ45,CILRDVSGGGADGLTF,0,9,1,9
TRAV20,TRAJ8,CAVQAGNTGFQKLVF,0,9,1,9
TRAV21,TRAJ57,CAVKVREGGSEKLVF,0,9,1,9
TRAV21,TRAJ21,CAAPPGGDNFNKFYF,0,9,1,9
TRAV2,TRAJ30,CADTLLMNRDDKIIF,0,9,1,9
TRAV24,TRAJ18,CAFMKRGSTLGRLYF,0,9,1,9
TRAV29DV5,TRAJ42,CAASARGGSQGNLIF,0,9,1,9
TRAV13-2,TRAJ10,CAEKILTGGGNKLTF,0,9,1,9
TRAV10,TRAJ16,CVVGARERGQKLLF,0,9,1,9
TRAV38-1,TRAJ44,CAFTSTGTASKLTF,0,9,1,9
TRAV22,TRAJ27,CAVEPNTNAGKSTF,0,9,1,9
TRAV3,TRAJ7,CAVRDEWGNNRLAF,0,9,1,9
TRAV21,TRAJ57,CAALTQGGSEKLVF,0,9,1,9
TRAV17,TRAJ57,CATPFRGGSEKLVF,0,9,1,9
TRAV17,TRAJ41,CATDFSNSGYALNF,0,9,1,9
TRAV17,TRAJ56,CATELTGANSKLTF,0,9,1,9
TRAV39,TRAJ15,CAVDTNQAGTALIF,0,9,1,9
TRAV13-1,TRAJ38,CAAKGGGNNRKLIW,0,9,1,9
TRAV23DV6,TRAJ32,CAASAGGATNKLIF,0,9,1,9
TRAV6,TRAJ3,CALFYSSASKIIF,0,9,1,9
TRAV16,TRAJ53,CALGGGSNYKLTF,0,9,1,9
TRAV8-3,TRAJ20,CAVGSTNDYKLSF,0,9,1,9
TRAV8-3,TRAJ30,CAVGGDRDDKIIF,0,9,1,9
TRAV8-3,TRAJ32,CAAGGGATNKLIF,0,11,1,11
TRAV25,TRAJ23,CAGPNDQGGKLIF,0,9,1,9
TRAV13-2,TRAJ40,CAEMDSGTYKYIF,0,9,1,9
TRAV14DV4,TRAJ48,CAMNGFGNEKLTF,0,9,1,9
TRAV30,TRAJ30,CGTESFSRGKIIF,0,9,1,9
TRAV20,TRAJ54,CAVQALPQKLVF,0,9,1,9
TRAV21,TRAJ37,CAVTPNTGKLIF,0,9,1,9
TRAV12-2,TRAJ43,CAVTNNNNDMRF,0,9,1,9
TRAV13-1,TRAJ20,CAASSNDYKLSF,0,9,1,9
TRAV27,TRAJ54,CAGGEGAQKLVF,0,9,1,9
TRAV12-1,TRAJ52,CVVKRGRDTGGTSYGKLTF,0,8,1,8
TRAV38-1,TRAJ45,CAFMKRMSGGGADGLTF,0,8,1,8
TRAV13-1,TRAJ17,CAARGVVIKAAGNKLTF,0,8,1,8
TRAV14DV4,TRAJ41,CAMREYVNSNSGYALNF,0,8,1,8
TRAV10,TRAJ13,CVVSSTNSGGYQKVTF,0,8,1,8
TRAV19,TRAJ8,CALSEARNTGFQKLVF,0,8,1,8
TRAV16,TRAJ58,CALNRTKETSGSRLTF,0,8,1,8
TRAV8-3,TRAJ13,CAVGAGLSGGYQKVTF,0,8,1,8
TRAV21,TRAJ41,CAVRDQNSNSGYALNF,0,8,1,8
TRAV13-1,TRAJ52,CAASRPGGTSYGKLTF,0,8,1,8
TRAV27,TRAJ52,CADINAGGTSYGKLTF,0,8,1,8
TRAV25,TRAJ24,CASRVMTTDSWGKFQF,0,8,1,8
TRAV38-2DV8,TRAJ48,CAYRTPNFGNEKLTF,0,8,1,8
TRAV9-2,TRAJ50,CALSEEATSYDKVIF,0,8,1,8
TRAV6,TRAJ4,CALDPVSGGYNKLIF,0,8,1,8
TRAV19,TRAJ21,CALTKGRDNFNKFYF,0,8,1,8
TRAV20,TRAJ37,CAVIWSSSNTGKLIF,0,8,1,8
TRAV21,TRAJ37,CAVSLGSSNTGKLIF,0,8,1,8
TRAV12-3,TRAJ15,CAVRLANQAGTALIF,0,8,1,8
TRAV35,TRAJ42,CAGQYYGGSQGNLIF,0,8,1,8
TRAV35,TRAJ52,CAGQLGGTSYGKLTF,0,8,1,8
TRAV13-1,TRAJ22,CAASNPSGSARQLTF,0,8,1,8
TRAV12-3,TRAJ10,CAMSEPLGGGNKLTF,0,8,1,8
TRAV4,TRAJ9,CLVGDIVTGGFKTIF,0,8,1,8
TRAV10,TRAJ28,CVHEVGAGSYQLTF,0,8,1,8
TRAV12-1,TRAJ33,CVVYAPGSNYQLIW,0,8,1,8
TRAV10,TRAJ29,CVVSGNSGNTPLVF,0,8,1,8
TRAV38-2DV8,TRAJ49,CAYRSALSGNQFYF,0,8,1,8
TRAV9-2,TRAJ31,CALSDRGNNARLMF,0,8,1,8
TRAV9-2,TRAJ50,CALRRETSYDKVIF,0,8,1,8
TRAV8-3,TRAJ6,CAVGAEGGSYIPTF,0,8,1,8
TRAV21,TRAJ10,CAVGPPGGGNKLTF,0,8,1,8
TRAV8-3,TRAJ6,CAVGATGGGYIPTF,0,8,1,8
TRAV3,TRAJ26,CAVRDTGHGQNFVF,0,8,1,8
TRAV2,TRAJ40,CAAGPYSGTYKYIF,0,8,1,8
TRAV38-2DV8,TRAJ32,CARPYGGATNKLIF,0,8,1,8
TRAV29DV5,TRAJ57,CAASGKGGSEKLVF,0,8,1,8
TRAV12-3,TRAJ6,CAMSGRGGSYIPTF,0,8,1,8
TRAV12-1,TRAJ4,CVVNLGGYNKLIF,0,8,1,8
TRAV6,TRAJ33,CAPPMDSNYQLIW,0,8,1,8
TRAV20,TRAJ34,CAVHPYNTDKLIF,0,8,1,8
TRAV8-4,TRAJ15,CAVSYQAGTALIF,0,8,1,8
TRAV21,TRAJ39,CAVRPNAGNMLTF,0,8,1,8
TRAV20,TRAJ32,CAVRGGATNKLIF,0,8,1,8
TRAV3,TRAJ30,CAVRDPRDDKIIF,0,8,1,8
TRAV35,TRAJ30,CAGPMNRDDKIIF,0,8,1,8
TRAV17,TRAJ9,CATAHTGGFKTIF,0,8,1,8
TRAV12-2,TRAJ6,CAVSSGGSYIPTF,0,8,1,8
TRAV13-1,TRAJ6,CAATSGGSYIPTF,0,8,1,8
TRAV27,TRAJ48,CAGANFGNEKLTF,0,8,1,8
TRAV4,TRAJ29,CLVGGSGNTPLVF,0,8,1,8
TRAV26-1,TRAJ49,CIVRFHTGNQFYF,0,8,1,8
TRAV12-1,TRAJ11,CVVNRGYSTLTF,0,8,1,8
TRAV9-2,TRAJ49,CALKHTGNQFYF,0,8,1,8
TRAV16,TRAJ29,CAPDSGNTPLVF,0,8,1,8
TRAV8-1,TRAJ20,CAVNGGDYKLSF,0,8,1,8
TRAV29DV5,TRAJ46,CAARGSGDKLTF,0,8,1,8
TRAV41,TRAJ49,CAVKFGNQFYF,0,8,1,8
TRAV13-1,TRAJ20,CAATLDYKLSF,0,8,1,8
TRAV13-1,TRAJ33,CAANSNYQLIW,0,8,1,8
TRAV22,TRAJ20,CAVNDYKLSF,0,14,1,14
TRAV12-1,TRAJ10,CVVLSGGGNKLTF,0,8,1,8
TRAV12-2,TRAJ22,CAVNTGSARQLTF,0,8,1,8
TRAV25,TRAJ30,CAGYRDDKIIF,0,8,1,8
TRAV41,TRAJ42,CAVTTMNYGGSQGNLIF,0,8,1,8
TRAV12-1,TRAJ3,CVVQYSSASKIIF,0,8,1,8
TRAV20,TRAJ37,CAGISGNTGKLIF,0,8,1,8
TRAV38-1,TRAJ48,CAFMNLLYFGNEKLTF,0,8,1,8
TRAV12-2,TRAJ42,CAVRRYGGSQGNLIF,0,8,1,8
TRAV23DV6,TRAJ53,CAASRSGGSNYKLTF,0,8,1,8
TRAV17,TRAJ9,CATVRNTGGFKTIF,0,8,1,8
TRAV12-2,TRAJ33,CAVNPPDSNYQLIW,0,8,1,8
TRAV27,TRAJ52,CAGEAGGTSYGKLTF,0,8,1,8
TRAV3,TRAJ9,CAVRPNTGGFKTIF,0,8,1,8
TRAV9-2,TRAJ4,CALTLYGGYNKLIF,0,7,1,7
TRAV41,TRAJ49,CAVKNTGNQFYF,0,7,1,7
TRAV38-1,TRAJ52,CAFRGPSAGGTSYGKLTF,0,7,1,7
TRAV12-2,TRAJ18,CAVKEVDRGSTLGRLYF,0,7,1,7
TRAV26-2,TRAJ42,CILRGMNYGGSQGNLIF,0,7,1,7
TRAV12-1,TRAJ48,CVVTAGGNFGNEKLTF,0,7,1,7
TRAV13-1,TRAJ52,CVASNAGGTSYGKLTF,0,7,1,7
TRAV38-2DV8,TRAJ52,CAYLKGGGTSYGKLTF,0,7,1,7
TRAV8-3,TRAJ52,CAVADAGGTSYGKLTF,0,7,1,7
TRAV21,TRAJ18,CAVRDDRGSTLGRLYF,0,7,1,7
TRAV17,TRAJ18,CATDRDRGSTLGRLYF,0,7,1,7
TRAV12-2,TRAJ42,CAVNGADGGSQGNLIF,0,7,1,7
TRAV13-1,TRAJ18,CAASRLGGSTLGRLYF,0,7,1,7
TRAV12-3,TRAJ42,CAMSGNYGGSQGNLIF,0,7,1,7
TRAV10,TRAJ18,CVVFDRGSTLGRLYF,0,7,1,7
TRAV12-1,TRAJ15,CVVNRGREAGTALIF,0,7,1,7
TRAV38-2DV8,TRAJ45,CAYTRTGGGADGLSF,0,7,1,7
TRAV38-2DV8,TRAJ57,CAYRSGWGGSEKLVF,0,7,1,7
TRAV9-2,TRAJ49,CALSPGRNTGSQFYF,0,7,1,7
TRAV9-2,TRAJ17,CALSGRRAAGNKLTF,0,7,1,7
TRAV9-2,TRAJ42,CALSDQEGSQGNLIF,0,7,1,7
TRAV19,TRAJ10,CALSEGTGGGNKLTF,0,7,1,7
TRAV9-2,TRAJ13,CALSENSGGYQKVTF,0,7,1,7
TRAV21,TRAJ37,CAVPPPPGNTGKLIF,0,7,1,7
TRAV36DV7,TRAJ53,CAVSYSGGSNYILTF,0,7,1,7
TRAV20,TRAJ28,CAVQASGAGSYQLTF,0,7,1,7
TRAV20,TRAJ44,CAVQDPTGTASKLTF,0,7,1,7
TRAV8-3,TRAJ7,CAVALGAHGNNRLAF,0,7,1,7
TRAV3,TRAJ38,CAVRGFRGNNRKLIW,0,7,1,7
TRAV3,TRAJ17,CAVRDIKAAGNKLTF,0,7,1,7
TRAV17,TRAJ45,CATEESGGGADGLTF,0,7,1,7
TRAV19,TRAJ37,CAQGDGSSNTGKLIF,0,7,1,7
TRAV29DV5,TRAJ53,CAASVSGGSNYKPTF,0,7,1,7
TRAV25,TRAJ29,CAGKYAYSGNTPLVF,0,7,1,7
TRAV13-2,TRAJ13,CAENNTPGGYQKVTF,0,7,1,7
TRAV12-3,TRAJ18,CAMIGRGSTLGRLYF,0,7,1,7
TRAV14DV4,TRAJ58,CAMREGETSGSRLTF,0,7,1,7
TRAV26-2,TRAJ20,CILRSARSNDYKLSF,0,7,1,7
TRAV38-2DV8,TRAJ21,CAYRSLIYFNKFYF,0,7,1,7
TRAV38-2DV8,TRAJ57,CALAPQGGSEKLVF,0,7,1,7
TRAV9-2,TRAJ12,CALSARDSSYKLIF,0,7,1,7
TRAV9-2,TRAJ44,CAPSRAGTASKLTF,0,7,1,7
TRAV21,TRAJ37,CAVPTSSNTGKLIF,0,7,1,7
TRAV8-3,TRAJ47,CAVVIMEYGNKLVF,0,7,1,7
TRAV8-3,TRAJ17,CAVGAMAAGNKLTF,0,7,1,7
TRAV8-3,TRAJ21,CAVGAPPDFNKFYF,0,7,1,7
TRAV8-3,TRAJ17,CAVGARAAGNKLTS,0,7,1,7
TRAV8-3,TRAJ26,CAVGPYGYGQNFVF,0,7,1,7
TRAV21,TRAJ26,CAVGSLVGGQNFVF,0,7,1,7
TRAV3,TRAJ24,CAVSPTDSWGKFQF,0,7,1,7
TRAV3,TRAJ27,CAVRDGTNAGKSTF,0,7,1,7
TRAV17,TRAJ16,CATKPFSDGQKLLF,0,7,1,7
TRAV8-1,TRAJ42,CAVNKAGSQGNLIF,0,7,1,7
TRAV12-2,TRAJ23,CAVNVGNQGGKLIF,0,7,1,7
TRAV13-1,TRAJ4,CAAPGTGGYNKLIF,0,7,1,7
TRAV13-1,TRAJ44,CAATLTGTASKLTF,0,7,1,7
TRAV13-1,TRAJ48,CAASSYFGNEKLTF,0,7,1,7
TRAV13-1,TRAJ7,CAASILDGNNRLAF,0,7,1,7
TRAV25,TRAJ21,CAGQRGDNFNKFYF,0,7,1,7
TRAV13-2,TRAJ53,CAEISGGSNYKLTF,0,7,1,7
TRAV12-3,TRAJ40,CAMAITSGTYKYIF,0,7,1,7
TRAV12-3,TRAJ6,CAMRESGGSYIPTF,0,7,1,7
TRAV30,TRAJ24,CGTGLTDSWGKFQF,0,7,1,7
TRAV4,TRAJ9,CLVGDNTGGFKTIF,0,7,1,7
TRAV38-2DV8,TRAJ20,CAYRTSNDYKLSF,0,7,1,7
TRAV9-2,TRAJ24,CALLTDSWGKFQF,0,7,1,7
TRAV12-2,TRAJ39,CAPKGNAGNMLTF,0,7,1,7
TRAV21,TRAJ34,CAVRSYNTDKLIF,0,7,1,7
TRAV17,TRAJ49,CATAPPGGNQFYF,0,7,1,7
TRAV12-2,TRAJ15,CAVVNQAGTALIF,0,7,1,7
TRAV29DV5,TRAJ49,CAAPTSTGNQFYF,0,7,1,7
TRAV23DV6,TRAJ33,CAARGASNYQLIW,0,7,1,7
TRAV27,TRAJ38,CAGGAGNNRKLIW,0,7,1,7
TRAV5,TRAJ4,CAEIRGGFNKLIF,0,7,1,7
TRAV12-3,TRAJ29,CAMIASGNTPLVF,0,7,1,7
TRAV30,TRAJ23,CGSLYNQGGKLIF,0,7,1,7
TRAV25,TRAJ48,CSPDTFGNEKLTF,0,7,1,7
TRAV30,TRAJ54,CGPSPGGAQKLVF,0,7,1,7
TRAV12-1,TRAJ27,CVVNWGAGKSTF,0,7,1,7
TRAV12-1,TRAJ34,CVVNRGTDKLIF,0,7,1,7
TRAV9-2,TRAJ21,CALPLNFNKFYF,0,7,1,7
TRAV9-2,TRAJ34,CALLYNTDKLIF,0,7,1,7
TRAV6,TRAJ40,CALSSGTYKYIF,0,7,1,7
TRAV13-2,TRAJ52,CALGGSYGKLTF,0,7,1,7
TRAV9-2,TRAJ29,CALDSGNTPLVF,0,7,1,7
TRAV9-2,TRAJ20,CALIANDYKLSF,0,7,1,7
TRAV19,TRAJ27,CALSGNAGKSTF,0,7,1,7
TRAV21,TRAJ28,CAVSAGSYQLTF,0,7,1,7
TRAV8-3,TRAJ48,CAVDPGNEKLTF,0,7,1,7
TRAV22,TRAJ3,CAVDSSASKIIF,0,7,1,7
TRAV21,TRAJ35,CAGIGFGNVLHC,0,7,1,7
TRAV17,TRAJ41,CATPHSGYALNF,0,7,1,7
TRAV17,TRAJ54,CATAQGAQKLVF,0,7,1,7
TRAV8-1,TRAJ6,CAVTGGSYIPTF,0,7,1,7
TRAV12-2,TRAJ16,CAVRRDGQKLLF,0,7,1,7
TRAV25,TRAJ39,CAGGNAGNMLTF,0,7,1,7
TRAV27,TRAJ20,CAGARGDYKLSF,0,7,1,7
TRAV13-2,TRAJ31,CAETPNNARLMF,0,7,1,7
TRAV13-2,TRAJ20,CAENMGDYKLSF,0,7,1,7
TRAV26-2,TRAJ54,CILRARAQKLVF,0,7,1,7
TRAV20,TRAJ16,CAVERAQKLLF,0,7,1,7
TRAV35,TRAJ27,CAAFNAGKSTF,0,7,1,7
TRAV21,TRAJ41,CASSSGYALNF,0,7,1,7
TRAV12-2,TRAJ49,CAVNAGNQFYF,0,7,1,7
TRAV12-2,TRAJ49,CAVNTGNQFYF,0,7,1,7
TRAV13-1,TRAJ31,CAASVNARLMF,0,7,1,7
TRAV13-1,TRAJ20,CAATDGYKLSF,0,7,1,7
TRAV25,TRAJ23,CAGPPGGKLIF,0,7,1,7
TRAV27,TRAJ42,CAGGSQGNLIF,0,15,1,15
TRAV26-1,TRAJ29,CTHSGNTPLVF,0,7,1,7
TRAV38-2DV8,TRAJ43,CAYFDNDMRF,0,7,1,7
TRAV17,TRAJ49,CAPAGNQFYF,0,7,1,7
TRAV12-2,TRAJ31,CAVNNAGLMF,0,7,1,7
TRAV17,TRAJ30,PLTPNDKIIF,0,7,1,7
TRAV38-2DV8,TRAJ33,CPRDYQLIW,0,7,1,7
TRAV3,TRAJ34,CAVHKLIF,0,7,1,7
TRAV12-3,TRAJ37,CAMSAFPSGNTGKLIF,0,7,1,7
TRAV41,TRAJ33,CAVRRGMDSNYQLIW,0,7,1,7
TRAV17,TRAJ22,CATDRGGSARQLTF,0,7,1,7
TRAV38-2DV8,TRAJ57,CAHREGGSEKLVF,0,7,1,7
TRAV9-2,TRAJ35,CAPSDPQGFGNVLHC,0,7,1,7
TRAV17,TRAJ10,CATAPTGGGNKLTF,0,7,1,7
TRAV41,TRAJ32,CAVRSVSSLLGGATNKLIF,0,7,1,7
TRAV8-3,TRAJ44,CAVGPLPINTGTASKLTF,0,7,1,7
TRAV9-2,TRAJ13,CARVNSGGYPKVTF,0,7,1,7
TRAV3,TRAJ34,CAVRDIKNTDKLIF,0,7,1,7
TRAV19,TRAJ29,CALSEAGNTPLVF,0,7,1,7
TRAV4,TRAJ3,CLVGGESASKIIF,0,7,1,7
TRAV36DV7,TRAJ40,CAVISGTYKYIF,0,7,1,7
TRAV8-3,TRAJ16,CAVDLLSDGQKLLF,0,7,1,7
TRAV12-2,TRAJ52,CAVNKGRDAGGTSYGKLTF,0,6,1,6
TRAV22,TRAJ45,CAVRTAYRTGGGADGLTF,0,6,1,6
TRAV9-2,TRAJ57,CALSDPFVQGGSEELVF,0,6,1,6
TRAV9-2,TRAJ50,CALKGRKGKTSYDEVIF,0,6,1,6
TRAV36DV7,TRAJ37,CAVERGTGSSNTGKLIF,0,6,1,6
TRAV13-1,TRAJ52,CAASMSAGGTSYGKLTF,0,6,1,6
TRAV38-1,TRAJ20,CAFMKRAGSYDYKLSF,0,6,1,6
TRAV38-2DV8,TRAJ58,CAYRRATITSGSRLTF,0,6,1,6
TRAV8-3,TRAJ38,CAVGAFWAGNNRKLIW,0,6,1,6
TRAV8-3,TRAJ48,CAVGPISNFGNERLTF,0,6,1,6
TRAV21,TRAJ21,CAVRPPRESNFNKFYF,0,6,1,6
TRAV35,TRAJ42,CAGQGNYGGSQGNLIF,0,6,1,6
TRAV12-2,TRAJ38,CAVNHYNAGNNRMLIW,0,6,1,6
TRAV12-2,TRAJ21,CAVKGSREYNFNKFYF,0,6,1,6
TRAV5,TRAJ37,CAVITHGSSNTGKLIF,0,6,1,6
TRAV14DV4,TRAJ8,CAMRESREKGSQKLVF,0,6,1,6
TRAV4,TRAJ42,CLVGDPSGGSQGNLIF,0,6,1,6
TRAV10,TRAJ18,CVVIDRGSTLGRLYF,0,6,1,6
TRAV10,TRAJ18,CVVSDRGSTLVRLYF,0,6,1,6
TRAV19,TRAJ11,CALSGPLSGYSTLTF,0,6,1,6
TRAV41,TRAJ35,CAVRSGGGFGNVLHC,0,6,1,6
TRAV20,TRAJ36,CAVQARVGGANNLFS,0,6,1,6
TRAV8-3,TRAJ10,CAVGILTGGGNKLTF,0,6,1,6
TRAV21,TRAJ3,CAVDEGESSASKIIF,0,6,1,6
TRAV3,TRAJ16,CAVRGVFSDGQKLLF,0,6,1,6
TRAV3,TRAJ7,CAVRDMYYGNNRLAF,0,6,1,6
TRAV22,TRAJ32,CAATNYGGATNKLIF,0,6,1,6
TRAV17,TRAJ58,CATDEVGTSGSRLTF,0,6,1,6
TRAV29DV5,TRAJ15,CAASVINQAGTALIF,0,6,1,6
TRAV12-3,TRAJ58,CAMLYWETSGSRLTF,0,6,1,6
TRAV14DV4,TRAJ4,CAMRGFSGGYNKLIF,0,6,1,6
TRAV14DV4,TRAJ9,CAMREGYTGGFKTIF,0,6,1,6
TRAV12-3,TRAJ8,CAMSGSNTGFQKLVF,0,6,1,6
TRAV26-2,TRAJ45,CIRMYSGGGADGLTF,0,6,1,6
TRAV10,TRAJ34,CVVSDTGNGDKLIF,0,6,1,6
TRAV38-1,TRAJ40,CAFMKQSGTYKYIF,0,6,1,6
TRAV6,TRAJ13,CALPPSGGYQKVTF,0,6,1,6
TRAV9-2,TRAJ13,CALIPSGGYQKVTF,0,6,1,6
TRAV9-2,TRAJ9,CALSDITGGFKTIF,0,6,1,6
TRAV9-2,TRAJ9,CALSDEDGGFKTIF,0,6,1,6
TRAV19,TRAJ23,CALSESNQGGKLIF,0,6,1,6
TRAV9-2,TRAJ37,CALSEISNTGKLIF,0,6,1,6
TRAV19,TRAJ54,CALSSFQGAQKLVF,0,6,1,6
TRAV9-2,TRAJ13,CALRDPGGYQKVTF,0,6,1,6
TRAV19,TRAJ32,CALKNGGATNKLIF,0,6,1,6
TRAV16,TRAJ52,CALARGTSYGKLTF,0,6,1,6
TRAV3,TRAJ41,CAVRDPNSGYALNF,0,6,1,6
TRAV3,TRAJ42,CAAPKGGSQGNLIF,0,6,1,6
TRAV17,TRAJ48,CATDYNFGNEKLTF,0,6,1,6
TRAV17,TRAJ37,CATDETGNTGKLIF,0,6,1,6
TRAV12-2,TRAJ29,CAVNLDSGNTPLVF,0,6,1,6
TRAV12-2,TRAJ15,CAAGIGQAGTALIF,0,6,1,6
TRAV13-1,TRAJ22,CAASLAGSARQLIF,0,6,1,6
TRAV13-1,TRAJ17,CAASIKAAGNKLTF,0,6,1,6
TRAV13-1,TRAJ49,CAASWRTTGNQFYF,0,6,1,6
TRAV29DV5,TRAJ6,CAASGSGGSYIPTF,0,6,1,6
TRAV29DV5,TRAJ42,CAAKIGRSQGNLIF,0,6,1,6
TRAV27,TRAJ10,CAGRLTGGGNKLTF,0,6,1,6
TRAV5,TRAJ22,CADASDVSARQLTF,0,6,1,6
TRAV5,TRAJ5,CAETPDTGRRALTF,0,6,1,6
TRAV13-2,TRAJ45,CAENLRGGADGLTF,0,6,1,6
TRAV13-2,TRAJ17,CAENSGAAGNKLTF,0,6,1,6
TRAV12-3,TRAJ56,CAMSDTGANSKLTF,0,6,1,6
TRAV9-2,TRAJ38,CTLHNAGNNRKLIW,0,6,1,6
TRAV26-2,TRAJ52,CFHAGGTSYGKLTF,0,6,1,6
TRAV26-2,TRAJ52,CIPPGGTSYGKLTF,0,6,1,6
TRAV26-1,TRAJ39,CIVSVYNAGNMLTF,0,6,1,6
TRAV9-2,TRAJ22,CSISSGSARQLTF,0,6,1,6
TRAV9-2,TRAJ13,CALFSGGYQKVTF,0,6,1,6
TRAV9-2,TRAJ8,CALSDKGFQKLVF,0,6,1,6
TRAV41,TRAJ58,CAVSRTSGSRLTF,0,6,1,6
TRAV8-3,TRAJ23,CAVLYNQGGKLIF,0,6,1,6
TRAV20,TRAJ30,CAVRSSRDDKIIF,0,6,1,6
TRAV8-3,TRAJ11,CAVAPYQYSTLTF,0,6,1,6
TRAV36DV7,TRAJ7,CAVGHHGNNRLAF,0,6,1,6
TRAV21,TRAJ15,CAVTHQAGTALIF,0,6,1,6
TRAV35,TRAJ26,CAGSDNYGQNFVF,0,6,1,6
TRAV2,TRAJ26,CAGFHNYGQNFVF,0,6,1,6
TRAV17,TRAJ9,CATVSTGGFKTIF,0,6,1,6
TRAV17,TRAJ13,CATDAKGYQKVTF,0,6,1,6
TRAV21,TRAJ32,CAPGGGATNKLIF,0,6,1,6
TRAV17,TRAJ9,CAVAYTGGFKTIF,0,6,1,6
TRAV12-2,TRAJ48,CAVNMSGNEKLTF,0,6,1,6
TRAV12-2,TRAJ13,CAVKRGGYQKVTF,0,6,1,6
TRAV5,TRAJ12,CAARVGSSYKLIF,0,6,1,6
TRAV12-2,TRAJ11,CAGNIEGYSTLTF,0,6,1,6
TRAV23DV6,TRAJ32,CAGYGGATNKLIF,0,6,1,6
TRAV13-1,TRAJ9,CAASMAGGFKTIF,0,6,1,6
TRAV13-1,TRAJ49,CAASMESGNQFYF,0,6,1,6
TRAV13-1,TRAJ36,CAASKSGANNLFF,0,6,1,6
TRAV23DV6,TRAJ13,CAASKGGYQKVTF,0,6,1,6
TRAV13-1,TRAJ11,CAAREGGYSTLTF,0,6,1,6
TRAV13-1,TRAJ5,CAARSPGRRALTF,0,6,1,6
TRAV5,TRAJ40,CAGGFSGTYKYIF,0,6,1,6
TRAV13-2,TRAJ9,CAENINGGFKTIF,0,6,1,6
TRAV12-3,TRAJ26,CAMRGAYGQNFVF,0,6,1,6
TRAV39,TRAJ27,CAMKEGNAGKSTF,0,6,1,6
TRAV12-1,TRAJ54,CVVNKGAQKLVF,0,6,1,6
TRAV41,TRAJ53,CASPGSNYKLTF,0,6,1,6
TRAV38-2DV8,TRAJ37,CAYASNTGKLIF,0,6,1,6
TRAV19,TRAJ27,CALSSNAGKSTF,0,6,1,6
TRAV41,TRAJ48,CAVFFGNEKLTF,0,6,1,6
TRAV21,TRAJ49,CAVFATGNQFYF,0,6,1,6
TRAV21,TRAJ29,CAVYSGNTPLVF,0,6,1,6
TRAV20,TRAJ42,CAVRGYQGNLIF,0,6,1,6
TRAV2,TRAJ21,CAVEYNFNKFYF,0,6,1,6
TRAV12-2,TRAJ39,CAVNDAGDMLTF,0,6,1,6
TRAV17,TRAJ29,CATQPGNTPLVF,0,6,1,6
TRAV17,TRAJ17,CATGAAGNKLTF,0,6,1,6
TRAV24,TRAJ16,CAFFSDGQKLLF,0,6,1,6
TRAV12-2,TRAJ21,CAVGHNFNKFYF,0,6,1,6
TRAV27,TRAJ49,CAPWGTGNQFYF,0,6,1,6
TRAV13-1,TRAJ44,CAAAGTASKLTF,0,6,1,6
TRAV13-1,TRAJ5,CAASAGRRALTF,0,6,1,6
TRAV13-1,TRAJ11,CAASKGYSTLTF,0,6,1,6
TRAV12-1,TRAJ29,CVVDINTPLVF,0,6,1,6
TRAV38-2DV8,TRAJ38,CAYRPRKKLIW,0,6,1,6
TRAV12-2,TRAJ11,CAVNTYSTLTF,0,6,1,6
TRAV13-1,TRAJ48,CAAGGNEKLTF,0,6,1,6
TRAV13-1,TRAJ23,CAAISGGKLIF,0,6,1,6
TRAV23DV6,TRAJ9,CGYTRGFKTIF,0,6,1,6
TRAV3,TRAJ23,CAFQGGKLIF,0,6,1,6
TRAV41,TRAJ43,CAVSNNDMRF,0,6,1,6
TRAV12-2,TRAJ20,CAAFGGQLSF,0,6,1,6
TRAV13-2,TRAJ27,CAEHAGKSTF,0,6,1,6
TRAV27,TRAJ6,CQGSYIPTF,0,6,1,6
TRAV12-2,TRAJ13,CAVKRDSGGYQKVTF,0,6,1,6
TRAV13-1,TRAJ49,CAASLSDTGNQFYF,0,6,1,6
TRAV19,TRAJ36,CALRLIGANNLFF,0,6,1,6
TRAV14DV4,TRAJ23,CAMTVAPGGKLIF,0,6,1,6
TRAV9-2,TRAJ31,CALMDLGARLMF,0,6,1,6
TRAV17,TRAJ58,CATETSGSRLTF,0,6,1,6
TRAV16,TRAJ10,CAHSCRVLTGGGNKLTF,0,6,1,6
TRAV12-1,TRAJ41,CVVNPRPNSGYALNF,0,6,1,6
TRAV9-2,TRAJ22,CALRGSARQLTF,0,6,1,6
TRAV26-1,TRAJ37,CITLIGSGNTGKLIF,0,6,1,6
TRAV19,TRAJ12,CALSEAGSSYKLIF,0,6,1,6
TRAV6,TRAJ5,CALSEYTGGRALTF,0,6,1,6
TRAV12-1,TRAJ42,CVPYGGSQGNLIF,0,5,1,5
TRAV30,TRAJ45,CGTELGRRVYSGGGADGLTF,0,5,1,5
TRAV36DV7,TRAJ42,CAVLRGPKFYGGSQGNLIF,0,5,1,5
TRAV12-2,TRAJ16,CAPLPTCRGCRDGQKLLF,0,5,1,5
TRAV14DV4,TRAJ18,CAILLAERRGSTLGRLYF,0,5,1,5
TRAV12-3,TRAJ28,CAMSARGNSGAGSYQLTF,0,5,1,5
TRAV17,TRAJ57,CASPSRDPQGGSEKLVF,0,5,1,5
TRAV16,TRAJ45,CALGLRGAGGGADGLTF,0,5,1,5
TRAV41,TRAJ42,CAVRPGNYGGSQGNLIF,0,5,1,5
TRAV20,TRAJ4,CAVQADYLSGGYNMLIF,0,5,1,5
TRAV13-1,TRAJ16,CAASKKVGFSDGQKLLF,0,8,1,8
TRAV29DV5,TRAJ52,CAARVDAGGTSYGKLTF,0,5,1,5
TRAV30,TRAJ38,CGTEKNPSAGNNRKLIW,0,5,1,5
TRAV12-1,TRAJ37,CVVNNDSASNTGKLIF,0,5,1,5
TRAV38-1,TRAJ42,CAFPMNYGGSQGNLIF,0,5,1,5
TRAV38-2DV8,TRAJ28,CAYTRYSGAGSYQLTF,0,5,1,5
TRAV38-2DV8,TRAJ56,CAYRSARTGANSKLTF,0,5,1,5
TRAV9-2,TRAJ52,CALKRAGGTSYGKLTF,0,5,1,5
TRAV16,TRAJ10,CALSGRQAGGGNKLTF,0,5,1,5
TRAV22,TRAJ28,CAVAAYSGAGSYQLTF,0,5,1,5
TRAV8-3,TRAJ28,CAVGAPPGAGSYQLTF,0,5,1,5
TRAV8-3,TRAJ10,CAVGEVLTGGGNKLTF,0,5,1,5
TRAV2,TRAJ28,CAVEKGSGAGSYQLTF,0,5,1,5
TRAV3,TRAJ3,CAVRREAGSSASKIIF,0,5,1,5
TRAV3,TRAJ5,CAVRPTFDTGRRALTF,0,5,1,5
TRAV12-2,TRAJ53,CAVRGSGGGSNYKLTF,0,5,1,5
TRAV12-2,TRAJ18,CAARGRRGSTLGRLYF,0,5,1,5
TRAV27,TRAJ42,CAGLMNYGGSQGNLIF,0,5,1,5
TRAV29DV5,TRAJ42,CAATKTLGGSQGNLIF,0,5,1,5
TRAV29DV5,TRAJ49,CAASQRSPSTGNQFYF,0,5,1,5
TRAV29DV5,TRAJ39,CAASARFANAGNMLTF,0,5,1,5
TRAV27,TRAJ42,CAGDEDYGGSQGNLIF,0,5,1,5
TRAV12-3,TRAJ42,CAMSPYYGGSQGNLIF,0,5,1,5
TRAV26-2,TRAJ38,CILRDVGAGNNRKLIW,0,5,1,5
TRAV26-2,TRAJ49,CILRDIPRKAGNQFYF,0,5,1,5
TRAV26-1,TRAJ5,CIVRVGEDTGRRALTF,0,5,1,5
TRAV10,TRAJ13,CVVSFDSGGYQKVTF,0,5,1,5
TRAV38-1,TRAJ23,CAFMKPGNQGGKLIF,0,5,1,5
TRAV38-2DV8,TRAJ47,CAYRSAVYNGNKLVF,0,5,1,5
TRAV19,TRAJ6,CALSEPKGGSYIPTF,0,5,1,5
TRAV19,TRAJ31,CALSEARNNNARLMF,0,5,1,5
TRAV19,TRAJ27,CALSEGSTNAGKSTF,0,5,1,5
TRAV9-2,TRAJ45,CALRDSGGGADGLTF,0,5,1,5
TRAV16,TRAJ17,CALSSIKAAGNKLTF,0,5,1,5
TRAV17,TRAJ18,CAHFDRGSTLGRLYF,0,5,1,5
TRAV2,TRAJ27,CAVSGSDTNAGKSTF,0,5,1,5
TRAV20,TRAJ39,CAVQPVRGTGNMVTF,0,5,1,5
TRAV20,TRAJ13,CAVQVRSGGYQKVTF,0,5,1,5
TRAV20,TRAJ15,CAVQAVNQAGTALIF,0,5,1,5
TRAV2,TRAJ36,CAVEQYQTGANNLFF,0,5,1,5
TRAV8-1,TRAJ48,CAVRITNFGNEKLTF,0,5,1,5
TRAV12-2,TRAJ42,CAVRNYGGSQGNLIF,0,5,1,5
TRAV12-2,TRAJ39,CAVNLNNNAGNMLTF,0,5,1,5
TRAV29DV5,TRAJ42,CAASVYGGSQGNLIF,0,5,1,5
TRAV14DV4,TRAJ16,CAPKEGFSDGQKLLF,0,5,1,5
TRAV23DV6,TRAJ58,CAAALQETSGSRLTF,0,5,1,5
TRAV13-2,TRAJ45,CAEKESGGGADGLTF,0,5,1,5
TRAV12-3,TRAJ11,CAMSLMNSGYSTLTF,0,5,1,5
TRAV12-3,TRAJ52,CAMSAGGTSYGKLTF,0,5,1,5
TRAV12-3,TRAJ48,CAMSASNFGNEKLTF,0,5,1,5
TRAV14DV4,TRAJ9,CAMREGRTGGFKTIF,0,5,1,5
TRAV4,TRAJ9,CLVGDDDTGGFKTIF,0,5,1,5
TRAV26-1,TRAJ56,CIVSSETGANSKLTF,0,5,1,5
TRAV12-1,TRAJ23,CVVIFYNQGGKLIF,0,5,1,5
TRAV12-1,TRAJ8,CVVNLNTGFQKLVF,0,5,1,5
TRAV12-1,TRAJ30,CVVNPQNRDDKIIF,0,5,1,5
TRAV12-1,TRAJ4,CVVKFSGGYNKLIF,0,5,1,5
TRAV12-1,TRAJ26,CVTFRDNYGQNFVF,0,5,1,5
TRAV38-1,TRAJ27,CAFMKHTNAGKSTF,0,5,1,5
TRAV38-2DV8,TRAJ54,CAYRSALGAQKLVF,0,5,1,5
TRAV9-2,TRAJ10,CALTHTGGGNKLTF,0,5,1,5
TRAV19,TRAJ20,CALSYPSGDYKLSF,0,5,1,5
TRAV9-2,TRAJ45,CALSDEGGADGLTF,0,5,1,5
TRAV19,TRAJ20,CALSEVSNDYKLCF,0,5,1,5
TRAV9-2,TRAJ9,CALNKNTGGFKTIF,0,5,1,5
TRAV9-2,TRAJ57,CALNREGGSEKLVF,0,5,1,5
TRAV41,TRAJ45,CAVYSGGGADGLTF,0,5,1,5
TRAV2,TRAJ10,CAVGGTGGGNKLTF,0,5,1,5
TRAV41,TRAJ45,CAVKIGGGADGLTF,0,5,1,5
TRAV41,TRAJ57,CAVKTQGGSEKLVF,0,5,1,5
TRAV8-3,TRAJ38,CAVGGAGNNRKLIW,0,5,1,5
TRAV36DV7,TRAJ30,CAVGGLTGDDKIIF,0,5,1,5
TRAV2,TRAJ29,CAVERGGGNTPLVF,0,5,1,5
TRAV12-2,TRAJ36,CAVMGRAGANNLFF,0,5,1,5
TRAV3,TRAJ36,CAVRDRPGANNLFF,0,5,1,5
TRAV35,TRAJ10,CAGHTTGGGNKLTF,0,5,1,5
TRAV17,TRAJ28,CATLSGAGSYQLTF,0,5,1,5
TRAV17,TRAJ40,CATDSASGTYKYIF,0,5,1,5
TRAV8-1,TRAJ48,CAVNPPFGNEKLTF,0,5,1,5
TRAV12-2,TRAJ53,CAGNSGGSNYKLTF,0,5,1,5
TRAV13-1,TRAJ52,CAASLDTSYGKLTF,0,5,1,5
TRAV13-1,TRAJ32,CAASVGGATNKLIF,0,5,1,5
TRAV29DV5,TRAJ13,CAASAAGGYQKVTF,0,5,1,5
TRAV29DV5,TRAJ58,CAASARTSGSRLTF,0,5,1,5
TRAV13-1,TRAJ9,CAARGNTGGFKTIF,0,5,1,5
TRAV27,TRAJ13,CAGATGGGYQKVTF,0,5,1,5
TRAV13-2,TRAJ54,CAEIPPSGAQKLVF,0,5,1,5
TRAV13-2,TRAJ12,CAEIPMDSSYKLIF,0,5,1,5
TRAV5,TRAJ9,CAETSSTGGFKTIF,0,5,1,5
TRAV14DV4,TRAJ37,CAMLGSSNTGKLIF,0,5,1,5
TRAV12-3,TRAJ53,CAMSGGGSNYKLTF,0,5,1,5
TRAV12-3,TRAJ15,CAMSLNQAGTALIF,0,5,1,5
TRAV12-3,TRAJ3,CAMSGDSSASKIIF,0,5,1,5
TRAV4,TRAJ9,CLVGDLNGGFKTIF,0,5,1,5
TRAV4,TRAJ26,CLVGDRDYGQNFVF,0,5,1,5
TRAV4,TRAJ5,CLVERPTGRRALTF,0,5,1,5
TRAV26-2,TRAJ44,CILRPTGTASKLTF,0,5,1,5
TRAV26-2,TRAJ23,CILREYNQGGKLIF,0,5,1,5
TRAV26-2,TRAJ41,CILNSLDSGYALNF,0,5,1,5
TRAV8-3,TRAJ3,RAVGGYSSASKIIF,0,5,1,5
TRAV8-2,TRAJ54,CVVTPKGAQKLVF,0,5,1,5
TRAV12-1,TRAJ49,CVVLDPSGNQFYF,0,5,1,5
TRAV12-1,TRAJ9,CVVTQTGGFKTIF,0,5,1,5
TRAV12-1,TRAJ23,CVVNNNQGGKLIF,0,5,1,5
TRAV38-2DV8,TRAJ42,CAYYGGSQGNLIF,0,5,1,5
TRAV38-2DV8,TRAJ47,CAYRVGYGNELVF,0,5,1,5
TRAV6,TRAJ3,CALLNSSASKIIF,0,5,1,5
TRAV6,TRAJ15,CALVNQAGTALIF,0,5,1,5
TRAV12-2,TRAJ44,CALSTGTASKLTF,0,5,1,5
TRAV9-2,TRAJ57,CALSKGGSEKLVF,0,5,1,5
TRAV16,TRAJ58,CALKETSGSRLTF,0,5,1,5
TRAV22,TRAJ4,CAVPSGGYNKLIF,0,5,1,5
TRAV36DV7,TRAJ40,CAVLGSGTYKYVF,0,5,1,5
TRAV3,TRAJ9,CAVYHTGGFKTIF,0,5,1,5
TRAV22,TRAJ3,CAVPYSSASKIIF,0,5,1,5
TRAV2,TRAJ16,CAVEDRSGQKLLF,0,5,1,5
TRAV22,TRAJ39,CAVNNNAGNMLTF,0,5,1,5
TRAV20,TRAJ24,CAVKADSWGKFQF,0,5,1,5
TRAV35,TRAJ39,CAGQDNAGNMLTF,0,5,1,5
TRAV17,TRAJ8,CATLNTGFQKLVF,0,5,1,5
TRAV17,TRAJ58,CATGSSSGSRLTF,0,5,1,5
TRAV24,TRAJ52,CAFIGTSYGKLTF,0,5,1,5
TRAV23DV6,TRAJ4,CAPGAGGYNKLIF,0,5,1,5
TRAV12-2,TRAJ26,CAVYDNYGQNFVF,0,5,1,5
TRAV12-2,TRAJ40,CAVASSGTYKYIF,0,5,1,5
TRAV12-2,TRAJ21,CAVRGGNFNKFYF,0,5,1,5
TRAV12-2,TRAJ39,CAVRNNAGNVVTF,0,5,1,5
TRAV12-2,TRAJ22,CAVNSGSARQLTF,0,5,1,5
TRAV8-1,TRAJ47,CAVNARGGNKLVL,0,5,1,5
TRAV12-2,TRAJ23,CAVNINPRGKLIF,0,5,1,5
TRAV12-3,TRAJ35,CAAGKGFGNMLHC,0,5,1,5
TRAV23DV6,TRAJ34,CAAHHDQTDKLIF,0,5,1,5
TRAV23DV6,TRAJ16,CAARTADGQKLLF,0,5,1,5
TRAV27,TRAJ30,CAGLSNRDDKIIF,0,5,1,5
TRAV27,TRAJ29,CAGRDSGNTPLVF,0,5,1,5
TRAV13-2,TRAJ54,CAENHQGAQKLAF,0,5,1,5
TRAV12-3,TRAJ33,CAIYMDSNYQLIW,0,5,1,5
TRAV12-3,TRAJ53,CAMPGGSNYKLTF,0,5,1,5
TRAV12-3,TRAJ26,CAMIGSYGQNFVF,0,5,1,5
TRAV12-3,TRAJ11,CAMKNSGYSTLTF,0,5,1,5
TRAV12-3,TRAJ13,CATESGGYQKVTF,0,5,1,5
TRAV4,TRAJ7,CLVGEWGNNRLAF,0,5,1,5
TRAV30,TRAJ40,CGTRTSGTYKYIL,0,5,1,5
TRAV26-1,TRAJ4,CIVPRGGYNKLIF,0,5,1,5
TRAV26-1,TRAJ44,CIVNTGTASKLTF,0,5,1,5
TRAV38-2DV8,TRAJ22,SAQIRGSARQLTF,0,5,1,5
TRAV34,TRAJ10,CCLTGGGNKLTF,0,5,1,5
TRAV12-1,TRAJ37,CVVRSNTGKLIF,0,5,1,5
TRAV12-1,TRAJ9,CVVTQGGFKTIF,0,5,1,5
TRAV12-1,TRAJ26,CVVNNYGQNFVF,0,5,1,5
TRAV12-1,TRAJ21,CVALYNFNKFYF,0,5,1,5
TRAV9-2,TRAJ26,CALHNYGQNFVF,0,5,1,5
TRAV9-2,TRAJ29,CALFSGNTPLVF,0,5,1,5
TRAV16,TRAJ17,CALGAAGNKLTF,0,5,1,5
TRAV2,TRAJ11,CAVVKGYSTLTF,0,5,1,5
TRAV22,TRAJ58,CAVGTSGSRLTF,0,5,1,5
TRAV2,TRAJ34,CAVEDGSDKLIF,0,5,1,5
TRAV21,TRAJ37,CAVMGNTGKLIF,0,5,1,5
TRAV23DV6,TRAJ43,CAVRPENNDMRF,0,5,1,5
TRAV21,TRAJ22,CAAPGSARQLTF,0,5,1,5
TRAV20,TRAJ10,CAATGGGNKLTF,0,5,1,5
TRAV17,TRAJ10,CATGGGGNKLTF,0,5,1,5
TRAV17,TRAJ11,CATDTGYSTLTF,0,5,1,5
TRAV41,TRAJ58,CALQTSGSRLTF,0,5,1,5
TRAV12-2,TRAJ26,CAVRGYGQNFVF,0,5,1,5
TRAV12-2,TRAJ45,CAVRGGADGLTF,0,5,1,5
TRAV8-1,TRAJ20,CAADPNDYKLSF,0,5,1,5
TRAV13-1,TRAJ26,CAARDYGQNFVF,0,5,1,5
TRAV29DV5,TRAJ43,CAASMNGNDMRF,0,5,1,5
TRAV29DV5,TRAJ30,CAASKRDVKIIF,0,5,1,5
TRAV27,TRAJ37,CAGDADTGKLIF,0,5,1,5
TRAV12-3,TRAJ29,CAIHSGNTPLVF,0,5,1,5
TRAV9-2,TRAJ45,CARGGGADGLTF,0,5,1,5
TRAV20,TRAJ31,SAVLTNNARLMF,0,5,1,5
TRAV4,TRAJ43,SLVGYNNNDMRF,0,5,1,5
TRAV9-2,TRAJ49,CALNLRDQFYF,0,5,1,5
TRAV23DV6,TRAJ9,CAHTGGFKTIF,0,5,1,5
TRAV2,TRAJ34,CAVLNTDKLIF,0,5,1,5
TRAV8-3,TRAJ50,CAVGVRDKVIF,0,5,1,5
TRAV22,TRAJ20,CAEFNDYKLSF,0,5,1,5
TRAV17,TRAJ49,CATNTGNQFYF,0,5,1,5
TRAV8-1,TRAJ23,CAVNWRGKLIF,0,5,1,5
TRAV23DV6,TRAJ15,CAAGRGTALIF,0,5,1,5
TRAV17,TRAJ57,CTQGGSEKLVF,0,5,1,5
TRAV4,TRAJ12,CRRDSSYKLIF,0,5,1,5
TRAV17,TRAJ30,CATVAGDKIIF,0,5,1,5
TRAV38-2DV8,TRAJ49,CASRGNQFYF,0,5,1,5
TRAV6,TRAJ34,CALPSHRLIF,0,5,1,5
TRAV16,TRAJ31,CALSSGRLMF,0,5,1,5
TRAV13-2,TRAJ27,CAEHAGKSTL,0,5,1,5
TRAV14DV4,TRAJ48,CAIVNEKLTF,0,5,1,5
TRAV13-1,TRAJ10,CAASSRGTEGGNKLTF,0,5,1,5
TRAV23DV6,TRAJ44,CAASAPAGTAGKLTF,0,5,1,5
TRAV2,TRAJ37,CAVEDGGNTGKLIF,0,5,1,5
TRAV14DV4,TRAJ3,CAMSPYSSASKIIF,0,5,1,5
TRAV10,TRAJ50,CVCLKTSYDKVIF,0,5,1,5
TRAV17,TRAJ6,CATDSRGSYIPTF,0,5,1,5
TRAV13-1,TRAJ11,CAASIGGYSTLTF,0,5,1,5
TRAV39,TRAJ30,CAVDTKNRDDKIIF,0,5,1,5
TRAV12-3,TRAJ4,CAIRFSGAYNKLIF,0,5,1,5
TRAV23DV6,TRAJ10,RAVRLTGGGNKLTF,0,5,1,5
TRAV29DV5,TRAJ44,CAAKGRGTASKLTF,0,4,1,4
TRAV6,TRAJ9,CALPNTGGFKTIF,0,4,1,4
TRAV26-1,TRAJ20,CIVLGSGYKLSF,0,4,1,4
TRAV29DV5,TRAJ27,CAATDYNTNAGKSTF,0,4,1,4
TRAV41,TRAJ45,CAVRSLFGNEKLTFGTGTRLTIIPRGGADGLTF,0,4,1,4
TRAV29DV5,TRAJ45,CAASEFDRVLTRSGGGADGLTF,0,4,1,4
TRAV12-1,TRAJ49,CVVNIGRDVGHFQDTGNQFYF,0,4,1,4
TRAV12-3,TRAJ52,CAMSAGRDAGGTSYGKLTF,0,4,1,4
TRAV12-3,TRAJ52,CAMSDGANAGGTSYGKLTF,0,4,1,4
TRAV19,TRAJ52,CALSEPGSRGTSYGKLTF,0,4,1,4
TRAV20,TRAJ52,CAVAHNNAGGTSYGKLTF,0,4,1,4
TRAV21,TRAJ45,CAVKRPRDSGGGADGLTF,0,4,1,4
TRAV35,TRAJ47,CAGRHPRDDMESGNKLVF,0,4,1,4
TRAV12-1,TRAJ13,CVVPHDYNSGGYQKVTF,0,4,1,4
TRAV12-1,TRAJ52,CVVKSNAGGTSYGKLTF,0,4,1,4
TRAV38-2DV8,TRAJ22,CAYRSTVSSGSARQLTF,0,4,1,4
TRAV38-2DV8,TRAJ42,CAYRSAYYGGSQGNLIF,0,4,1,4
TRAV38-2DV8,TRAJ53,CAYRRLNSGGSNYKLTF,0,4,1,4
TRAV19,TRAJ35,CALSEAPGGGFGNVLHC,0,4,1,4
TRAV19,TRAJ32,CALSEGLYGGATNKLIF,0,4,1,4
TRAV35,TRAJ53,CAGQTLNSGGSNYKLTF,0,4,1,4
TRAV8-1,TRAJ42,CAVNEMNYGGSQGNLIF,0,4,1,4
TRAV30,TRAJ28,CGTAHSYSGAGSYQLAF,0,4,1,4
TRAV26-1,TRAJ53,CIVRVANSGGSNYKLTF,0,4,1,4
TRAV26-1,TRAJ44,CIVRASRITGTASKLTF,0,4,1,4
TRAV38-1,TRAJ53,CAFMKPSGGSNYKLTF,0,4,1,4
TRAV38-2DV8,TRAJ35,CAYRSGVGGFGNVLHC,0,4,1,4
TRAV38-2DV8,TRAJ53,CAYRRGGGGSNYKLTF,0,4,1,4
TRAV19,TRAJ56,CALTPRDTGANSKLTF,0,4,1,4
TRAV19,TRAJ58,CALRAREETSGSRLTF,0,4,1,4
TRAV16,TRAJ48,CALSDISNFGNEKLTF,0,4,1,4
TRAV41,TRAJ54,CAVRPFGIQGAQKLVF,0,4,1,4
TRAV41,TRAJ53,CAVRRRSGGSNYKLTF,0,4,1,4
TRAV41,TRAJ42,CAVKRNYGGSQGNLIF,0,4,1,4
TRAV8-3,TRAJ40,CAVGTLTTSGTYKYIF,0,4,1,4
TRAV8-4,TRAJ13,CAVSAGNSGGYQKVTF,0,4,1,4
TRAV12-2,TRAJ28,CAVRLYSEAGSYQLTF,0,4,1,4
TRAV21,TRAJ9,CAVRPPARTGGFKTIF,0,4,1,4
TRAV3,TRAJ10,CAVRDSLTGGGNKLTF,0,4,1,4
TRAV3,TRAJ28,CAVRDMTGAGSYQLTF,0,4,1,4
TRAV17,TRAJ53,CATPGRSGGSNYKLTF,0,4,1,4
TRAV16,TRAJ42,CALGYLGGGSQGNLIF,0,4,1,4
TRAV20,TRAJ23,CAQAGVSKDQGGKLIF,0,4,1,4
TRAV12-2,TRAJ28,CAVTLSSGTGSYQLTF,0,4,1,4
TRAV12-3,TRAJ52,CAYAHAGGTSYGKLTF,0,4,1,4
TRAV23DV6,TRAJ36,CAASPQRQTGANNLFF,0,4,1,4
TRAV29DV5,TRAJ53,CAASMRSGGSNYKLTF,0,4,1,4
TRAV23DV6,TRAJ18,CAASTVRGSTLGRLYF,0,4,1,4
TRAV12-3,TRAJ52,CAMTYAGGTSYGKLTF,0,4,1,4
TRAV12-3,TRAJ10,CAMSARLTGGGNKLTF,0,4,1,4
TRAV12-3,TRAJ53,CAMSAHSGGSNYKLTF,0,4,1,4
TRAV14DV4,TRAJ23,CAMREGIHNQGGKLIF,0,4,1,4
TRAV4,TRAJ38,CLVGDGSAGNNRKLIW,0,4,1,4
TRAV26-2,TRAJ28,CILRSHPGAGSYQLTF,0,4,1,4
TRAV26-2,TRAJ61,CILRNHRYRVNRKLTF,0,4,1,4
TRAV26-1,TRAJ10,CIVSRILTGGGNKLTF,0,4,1,4
TRAV8-2,TRAJ41,CVVSANSNSGYALNF,0,4,1,4
TRAV10,TRAJ17,CVVGHQQAAGNKLTF,0,4,1,4
TRAV12-1,TRAJ47,CVVNPSREYGNKLVF,0,4,1,4
TRAV12-1,TRAJ18,CVVNDGGSTLGRLYF,0,4,1,4
TRAV12-1,TRAJ15,CVVNIPNQAGTALIF,0,4,1,4
TRAV12-1,TRAJ38,CVVNTHAGNNRKLIW,0,4,1,4
TRAV9-2,TRAJ24,CALQRSTDSWGKFQF,0,4,1,4
TRAV9-2,TRAJ13,CALIPLSGGYQKVTF,0,4,1,4
TRAV19,TRAJ37,CALTEGSSNTGKLIF,0,4,1,4
TRAV9-2,TRAJ56,CALSDSPGANSKPTF,0,4,1,4
TRAV9-2,TRAJ20,CALSDQQLNDYKLSF,0,4,1,4
TRAV19,TRAJ58,CALSERETSGSRLTF,0,4,1,4
TRAV9-2,TRAJ10,CALSSFTGGGNKLTF,0,4,1,4
TRAV23DV6,TRAJ42,CALLNYGGSQGNLIF,0,4,1,4
TRAV16,TRAJ52,CALMKGGTSYGKLTF,0,4,1,4
TRAV19,TRAJ38,CAPLPNAGNNRKLIW,0,4,1,4
TRAV2,TRAJ23,CAVPPIYNQGGKLIF,0,4,1,4
TRAV20,TRAJ57,CAVPPAQGGSEKLVF,0,4,1,4
TRAV20,TRAJ22,CAVRGDGGSARQLTF,0,4,1,4
TRAV20,TRAJ30,CAVQYLMNRDDKIIF,0,4,1,4
TRAV20,TRAJ9,CAVQPEWTGGFKTIF,0,4,1,4
TRAV8-3,TRAJ4,CAVGSFSGGYNKLIF,0,4,1,4
TRAV8-3,TRAJ3,CAVGGLYSSASKIIF,0,4,1,4
TRAV8-3,TRAJ34,CAVGEESYNTDKLIF,0,4,1,4
TRAV8-3,TRAJ45,CAVGTSGGGADGLTF,0,4,1,4
TRAV22,TRAJ7,CAVERSLYGNNRLAF,0,4,1,4
TRAV2,TRAJ15,CAVEQTNQAGTALIF,0,4,1,4
TRAV2,TRAJ29,CAVEDENSGNTPLVF,0,4,1,4
TRAV21,TRAJ28,CAVTLTGAGSYQLTF,0,4,1,4
TRAV3,TRAJ5,CAVRVSDTGRRALTF,0,4,1,4
TRAV3,TRAJ9,CAVRDAGSPHFKTIF,0,4,1,4
TRAV3,TRAJ6,CAVRDIRGGSYIPTF,0,4,1,4
TRAV3,TRAJ7,CAVRDTALGNNRLAF,0,4,1,4
TRAV3,TRAJ9,CAVRERETGGFKTIF,0,4,1,4
TRAV2,TRAJ26,CAGHHRDNYGQNLVF,0,4,1,4
TRAV35,TRAJ22,CAGRTSSGSARQLTF,0,4,1,4
TRAV35,TRAJ38,CAGHHNAGNNRKLIW,0,4,1,4
TRAV35,TRAJ43,CAGHIRPYNNNDMRF,0,4,1,4
TRAV17,TRAJ3,CATDTGLSSASKIIF,0,4,1,4
TRAV17,TRAJ16,CATESPFSDGQKLLF,0,4,1,4
TRAV12-2,TRAJ28,CASLFAGAGSYQLTF,0,4,1,4
TRAV12-2,TRAJ3,CAVPEGYSSASKIIF,0,4,1,4
TRAV8-1,TRAJ38,CAVTINAGNNRKLIW,0,4,1,4
TRAV8-1,TRAJ38,CAVNALAGNNRKLIW,0,4,1,4
TRAV8-1,TRAJ28,CAVNAVGAGSYQLTF,0,4,1,4
TRAV12-2,TRAJ33,CAVKDRMDSNYQLIW,0,4,1,4
TRAV12-1,TRAJ12,CAAAVLMDSSYKLIF,0,4,1,4
TRAV5,TRAJ32,CAAWLSGGATNKLIF,0,4,1,4
TRAV13-1,TRAJ41,CAASTASNSGYALNF,0,4,1,4
TRAV13-1,TRAJ13,CAASKRSGGYQKVTF,0,4,1,4
TRAV29DV5,TRAJ22,CAASRDPGSARQLTF,0,4,1,4
TRAV27,TRAJ18,CAGRYRGSTLGRLYF,0,4,1,4
TRAV27,TRAJ53,CAGARSGGSNYKLAF,0,4,1,4
TRAV27,TRAJ53,CAGEGGGGSNYKLTF,0,4,1,4
TRAV13-2,TRAJ13,CAENRVRGGYQKVTF,0,4,1,4
TRAV12-3,TRAJ6,CAMSGEAGGSYIPTF,0,4,1,4
TRAV12-3,TRAJ36,CAMSGIRTGANNLFF,0,4,1,4
TRAV14DV4,TRAJ3,CAMRDGYSSASKIIF,0,4,1,4
TRAV14DV4,TRAJ37,CAMREGSGNTGKLIF,0,4,1,4
TRAV14DV4,TRAJ37,CAMREGASNTGKLIF,0,4,1,4
TRAV14DV4,TRAJ27,CAMREGKTNAGKSTF,0,4,1,4
TRAV14DV4,TRAJ9,CAMREDNTGGFKTIF,0,4,1,4
TRAV4,TRAJ22,CLVAPTFGSARQLTF,0,4,1,4
TRAV4,TRAJ23,CLVGALYNQGGKLIF,0,4,1,4
TRAV4,TRAJ20,CLVGALSSNDYKLSF,0,4,1,4
TRAV4,TRAJ27,CLVGDGATNAGKSTF,0,4,1,4
TRAV4,TRAJ26,CLVGDIRNYGQNFVF,0,4,1,4
TRAV26-1,TRAJ18,CIVRVRGSTLGRLYF,0,4,1,4
TRAV26-1,TRAJ27,CIVNTRNTNAGKSTF,0,4,1,4
TRAV26-1,TRAJ13,CIARRFSGGYQKVTF,0,4,1,4
TRAV12-1,TRAJ41,CVVTLSNSGYALNF,0,4,1,4
TRAV10,TRAJ4,CVAAFSGGYNKLIF,0,4,1,4
TRAV6,TRAJ9,CALHTLTGGFKTIF,0,4,1,4
TRAV9-2,TRAJ30,CALTGPNRDDKIIF,0,4,1,4
TRAV9-2,TRAJ26,CALSTLNYGQNFVF,0,4,1,4
TRAV9-2,TRAJ12,CALSSMDSSYKLIF,0,4,1,4
TRAV19,TRAJ7,CALKEEKGNNRLAF,0,4,1,4
TRAV16,TRAJ36,CALSAYAGANNLFF,0,4,1,4
TRAV16,TRAJ37,CALKGSGNTGKLIF,0,4,1,4
TRAV41,TRAJ49,CAVPPLNTGNQFYF,0,4,1,4
TRAV41,TRAJ31,CAVRTGANNARLMF,0,4,1,4
TRAV41,TRAJ57,CAVKTQGGSEKLVS,0,4,1,4
TRAV8-3,TRAJ26,CAVVFDNYGQNFVF,0,4,1,4
TRAV8-3,TRAJ48,CAVGVGFGNEKLTF,0,4,1,4
TRAV8-3,TRAJ4,CAVGVTGGYNKLIF,0,4,1,4
TRAV8-3,TRAJ17,CAVGGKAAGNKLTF,0,4,1,4
TRAV8-3,TRAJ9,CAVGLNTGGFKTIF,0,4,1,4
TRAV8-3,TRAJ33,CAVGPMDSNYQLIW,0,4,1,4
TRAV22,TRAJ13,CAVERAGGYQKVTF,0,4,1,4
TRAV2,TRAJ17,CAVEDRAAGNKLTF,0,4,1,4
TRAV21,TRAJ56,CAVIPTGANSKLTF,0,4,1,4
TRAV8-6,TRAJ12,CAVSFDDSSYKLIF,0,4,1,4
TRAV8-4,TRAJ40,CAVSVASGTYKYIF,0,4,1,4
TRAV8-6,TRAJ6,CAVSDRGGSYIPTF,0,4,1,4
TRAV12-2,TRAJ9,CAVRRNTGGFKTIF,0,4,1,4
TRAV8-6,TRAJ57,CAVRTGGGSEKLVF,0,4,1,4
TRAV3,TRAJ3,CAVRGGSSASKIIF,0,4,1,4
TRAV3,TRAJ9,CAVRDPTGGFKTIF,0,4,1,4
TRAV36DV7,TRAJ36,CAAPRPTGANNLFF,0,4,1,4
TRAV35,TRAJ48,CAGQLNFGNEKLTF,0,4,1,4
TRAV12-2,TRAJ18,CAVSRGSTLGRLYF,0,4,1,4
TRAV12-2,TRAJ49,CAVNKPNTGNQFYF,0,4,1,4
TRAV29DV5,TRAJ45,CAARGGGGADGLTF,0,4,1,4
TRAV23DV6,TRAJ42,CAVSQGGSQGNLIF,0,4,1,4
TRAV27,TRAJ28,CAAYSGAGSYQLTF,0,4,1,4
TRAV29DV5,TRAJ12,CAARRRDSSYKLIF,0,4,1,4
TRAV13-1,TRAJ23,CAAVAYNQGGKLIF,0,4,1,4
TRAV13-1,TRAJ6,CAASIGGGSYIPTF,0,4,1,4
TRAV13-1,TRAJ34,CAASSSYNTDKLIF,0,4,1,4
TRAV13-1,TRAJ48,CAASRAFGNEKLTF,0,4,1,4
TRAV29DV5,TRAJ48,CAASSDFGNEKLTF,0,4,1,4
TRAV13-1,TRAJ47,CAANPTEYGNKLVF,0,4,1,4
TRAV27,TRAJ42,CAGAGAGSQGNLIS,0,4,1,4
TRAV27,TRAJ22,CAGISSGSARQLTF,0,4,1,4
TRAV13-2,TRAJ12,CAEIPMDSSYKSIF,0,4,1,4
TRAV13-2,TRAJ48,CAENKNFGNEKLTF,0,4,1,4
TRAV13-2,TRAJ44,CAENHTGTASKLTF,0,4,1,4
TRAV12-3,TRAJ20,CAMCRSPNDYKLSF,0,4,1,4
TRAV12-3,TRAJ22,CAMSGSGSARQLTF,0,4,1,4
TRAV12-3,TRAJ12,CAMRRMDSSYKSIF,0,4,1,4
TRAV14DV4,TRAJ6,CAMREEGGSYIPTF,0,4,1,4
TRAV14DV4,TRAJ49,CAMRERNTGNQFYF,0,4,1,4
TRAV12-3,TRAJ50,CATQRGTSYDKVIF,0,4,1,4
TRAV34,TRAJ44,CGADSAGTASKLTF,0,4,1,4
TRAV4,TRAJ47,CLVGAMEYGNKLVF,0,4,1,4
TRAV4,TRAJ37,CLVDAPGNTGKLIF,0,4,1,4
TRAV4,TRAJ30,CLVGVMNRDDKIIF,0,4,1,4
TRAV30,TRAJ53,CGTEMRGSNYKLTF,0,4,1,4
TRAV26-2,TRAJ39,CIPLDGNAGKMLTY,0,4,1,4
TRAV2,TRAJ37,RAVYGSSNTGKLIF,0,4,1,4
TRAV12-1,TRAJ49,CVVNRNTGNQFYF,0,4,1,4
TRAV12-1,TRAJ49,CVVNQNTGNQFYF,0,4,1,4
TRAV38-2DV8,TRAJ42,CASSSGSQGNLIF,0,4,1,4
TRAV2,TRAJ6,CASQGGGSYIPTF,0,4,1,4
TRAV38-2DV8,TRAJ34,CACYGDNTDKLIF,0,4,1,4
TRAV38-2DV8,TRAJ47,CAYRVGYGNELAF,0,4,1,4
TRAV9-2,TRAJ6,CALLYRGSYIPTF,0,4,1,4
TRAV19,TRAJ7,CALSEAGNNRLAF,0,4,1,4
TRAV19,TRAJ11,CALSEAGYSTLTF,0,4,1,4
TRAV9-2,TRAJ50,CALSTPSYDKVIF,0,4,1,4
TRAV9-2,TRAJ40,CALSQSGTYKYIF,0,4,1,4
TRAV6,TRAJ5,CALVGTGRRALTF,0,4,1,4
TRAV41,TRAJ54,CAVRSSGAQKLVF,0,4,1,4
TRAV20,TRAJ49,CAVLPNTGNQFYF,0,4,1,4
TRAV20,TRAJ49,CAVHSNTGNQFYF,0,4,1,4
TRAV8-3,TRAJ42,CAVARGSQGNLIF,0,4,1,4
TRAV8-3,TRAJ13,CAVGPPGYQKVTF,0,4,1,4
TRAV2,TRAJ23,CAVGDNQGGKLIF,0,4,1,4
TRAV2,TRAJ7,CAVEEWGNNRLAF,0,4,1,4
TRAV2,TRAJ4,CAVEIGGYNKLIF,0,4,1,4
TRAV21,TRAJ56,CAVETGANSKLTF,0,4,1,4
TRAV3,TRAJ5,CAVSYTGRRALTF,0,4,1,4
TRAV8-4,TRAJ49,CAVSEGTGNQFYF,0,4,1,4
TRAV8-6,TRAJ48,CAVSVFGNEKLTF,0,4,1,4
TRAV8-3,TRAJ28,CAASGAGSYQLTF,0,4,1,4
TRAV22,TRAJ36,CAASLSWANNLFF,0,4,1,4
TRAV35,TRAJ37,CAGRSSNTGKLIF,0,4,1,4
TRAV17,TRAJ34,CATASYNTDKLIF,0,4,1,4
TRAV24,TRAJ57,CAFREGGSEKLVF,0,4,1,4
TRAV24,TRAJ50,CAFERASYDKVIF,0,4,1,4
TRAV12-2,TRAJ29,CAVPNSGNTPLVF,0,4,1,4
TRAV12-2,TRAJ41,CAVSSNSGYALNF,0,4,1,4
TRAV39,TRAJ27,CAVDRTNAGKSTF,0,4,1,4
TRAV12-2,TRAJ5,CAVEDTGRRALTF,0,4,1,4
TRAV12-2,TRAJ20,CAVSFSNDYKLSF,0,4,1,4
TRAV12-2,TRAJ48,CAVRAFGNEKLTF,0,4,1,4
TRAV8-1,TRAJ13,CAVNAWGYQKVTF,0,4,1,4
TRAV12-2,TRAJ39,CAVNKDAGNMLTF,0,4,1,4
TRAV12-2,TRAJ28,CAGSGAGSYQLTF,0,4,1,4
TRAV12-2,TRAJ10,CAIPTGGGNKLTF,0,4,1,4
TRAV13-1,TRAJ37,CAASKGNTGKLIF,0,4,1,4
TRAV29DV5,TRAJ29,CAARGSGNTPLVF,0,4,1,4
TRAV5,TRAJ41,CAEISNSGYALNF,0,4,1,4
TRAV13-2,TRAJ28,CAEIPHPGYQLTF,0,4,1,4
TRAV13-2,TRAJ41,CAERSNSGYALNF,0,4,1,4
TRAV12-3,TRAJ49,CAMNSNTGNRFYF,0,4,1,4
TRAV4,TRAJ43,CLGGGYNNNDMRF,0,4,1,4
TRAV26-1,TRAJ49,CIVRVNTGNQFYF,0,4,1,4
TRAV12-1,TRAJ22,CVVSGSARQLTF,0,4,1,4
TRAV12-1,TRAJ29,CVVVSGNTPLVF,0,4,1,4
TRAV12-1,TRAJ5,CVVGGGRRALTL,0,4,1,4
TRAV12-1,TRAJ5,CVVNTGRRALTF,0,4,1,4
TRAV22,TRAJ20,CAFPHNDYKLSF,0,4,1,4
TRAV38-1,TRAJ20,CAFMKRDYKLSF,0,4,1,4
TRAV38-2DV8,TRAJ49,CAYRSAGNQFYF,0,4,1,4
TRAV9-2,TRAJ23,CALNNQGGKLIF,0,4,1,4
TRAV9-2,TRAJ15,CALSQAGTALIF,0,4,1,4
TRAV9-2,TRAJ31,CALSDANARLMF,0,4,1,4
TRAV9-2,TRAJ49,CALSPTGNQFYF,0,4,1,4
TRAV19,TRAJ21,CALRYNFNKFYF,0,4,1,4
TRAV12-2,TRAJ9,CARQAGGFKTIF,0,4,1,4
TRAV12-2,TRAJ36,CAVQTGANNLFF,0,4,1,4
TRAV41,TRAJ35,CAVRGFGNVLHC,0,4,1,4
TRAV12-2,TRAJ49,CAVVNTGNQFYF,0,4,1,4
TRAV8-3,TRAJ49,CAVGAGGNQFYF,0,4,1,4
TRAV8-3,TRAJ4,CAVGPRNNKLIF,0,4,1,4
TRAV2,TRAJ21,CAVERDFNKFYF,0,4,1,4
TRAV36DV7,TRAJ36,CAVEVGANNLFF,0,4,1,4
TRAV21,TRAJ35,CAVIGFGNVLHC,0,4,1,4
TRAV21,TRAJ37,CAVTSNTGKLIF,0,4,1,4
TRAV21,TRAJ57,CAVTPLSERLVF,0,4,1,4
TRAV3,TRAJ8,CAVNTGFQKLVF,0,4,1,4
TRAV17,TRAJ26,CATDTGGQNFVF,0,4,1,4
TRAV17,TRAJ6,CATEGGSYIPTF,0,4,1,4
TRAV12-2,TRAJ27,CAVSTNAGKSTF,0,4,1,4
TRAV8-1,TRAJ43,CAVNRNNNDMRF,0,4,1,4
TRAV12-2,TRAJ9,CAVYTGGFKTIF,0,4,1,4
TRAV14DV4,TRAJ11,CAFFSGYSTLTF,0,4,1,4
TRAV23DV6,TRAJ17,CAAKAAGNKLTF,0,4,1,4
TRAV23DV6,TRAJ33,CAALDSNYQLIW,0,4,1,4
TRAV13-1,TRAJ21,CAARKDFNKFYF,0,4,1,4
TRAV13-1,TRAJ30,CAASYGGDKIIF,0,4,1,4
TRAV29DV5,TRAJ31,CAASGNNARLMF,0,4,1,4
TRAV13-2,TRAJ26,CAESISGQNFVF,0,4,1,4
TRAV13-2,TRAJ49,CAEKRTGNQFYF,0,4,1,4
TRAV12-3,TRAJ13,CAIQGGYQKVTF,0,4,1,4
TRAV12-3,TRAJ37,CAMSGNTGKLIF,0,4,1,4
TRAV4,TRAJ33,CLVGFSNYQLIW,0,4,1,4
TRAV4,TRAJ34,CLVGVDTDKLIF,0,4,1,4
TRAV26-2,TRAJ40,CIHTSGTYKYIF,0,4,1,4
TRAV26-1,TRAJ20,CIVLGRGYKLSF,0,4,1,4
TRAV26-1,TRAJ34,CIVSSKTDKLIF,0,4,1,4
TRAV10,TRAJ31,CVVRAGARLMF,0,4,1,4
TRAV12-1,TRAJ34,CVEEDTDKLIF,0,4,1,4
TRAV41,TRAJ33,CAVYSNYQLIW,0,4,1,4
TRAV22,TRAJ20,CAVVNDYKLSF,0,4,1,4
TRAV22,TRAJ20,CAGGVDYKLSF,0,4,1,4
TRAV17,TRAJ58,CATGSGSRLTF,0,4,1,4
TRAV17,TRAJ16,CATLDGQKLLF,0,4,1,4
TRAV36DV7,TRAJ43,CASYNNNDMRF,0,4,1,4
TRAV39,TRAJ34,CAVGNTDKLIF,0,4,1,4
TRAV39,TRAJ34,CAVGNTDKLIV,0,4,1,4
TRAV12-2,TRAJ31,CAVRDNARLMF,0,4,1,4
TRAV12-2,TRAJ49,CAVNIGNQFYF,0,4,1,4
TRAV13-1,TRAJ20,CAAMGDYKLSF,0,4,1,4
TRAV13-1,TRAJ20,RAATLDYKLSF,0,4,1,4
TRAV38-2DV8,TRAJ48,CACSKGKLTF,0,4,1,4
TRAV8-3,TRAJ34,CAVATDKLIF,0,4,1,4
TRAV13-1,TRAJ37,CAPFAGKLIF,0,4,1,4
TRAV8-1,TRAJ34,CAAYTDKLIF,0,4,1,4
TRAV26-2,TRAJ61,CISVNRKLTF,0,4,1,4
TRAV34,TRAJ49,CVVWNQFYF,0,4,1,4
TRAV9-2,TRAJ58,CALGRLTF,0,4,1,4
TRAV10,TRAJ38,CVVSLLCVAGNNRKLIW,0,4,1,4
TRAV27,TRAJ22,CAAHSVSSGSARQLTF,0,4,1,4
TRAV38-2DV8,TRAJ30,CAYKFRNRDNKIIF,0,4,1,4
TRAV19,TRAJ23,CALSGHNQGGKLIF,0,4,1,4
TRAV9-2,TRAJ29,CALSGRSGNTPLVF,0,4,1,4
TRAV9-2,TRAJ8,CALSDTTGFQKLAF,0,4,1,4
TRAV2,TRAJ29,CAVDRNSGSTPLVF,0,4,1,4
TRAV26-2,TRAJ22,CILMPQGSARQLTF,0,4,1,4
TRAV38-1,TRAJ49,CAFMKNTGNQFYF,0,4,1,4
TRAV12-2,TRAJ6,CAVTSEGSYIPTF,0,4,1,4
TRAV12-3,TRAJ13,CAMSDTSYQKVTF,0,4,1,4
TRAV8-3,TRAJ36,CAVETGANNLFF,0,4,1,4
TRAV13-1,TRAJ18,CAASKRRGSTLGRLYF,0,3,1,3
TRAV17,TRAJ37,CATAAHGSGNTGKLIF,0,3,1,3
TRAV8-1,TRAJ18,CATEDRGSTLGRLYF,0,3,1,3
TRAV9-2,TRAJ44,CALSTDGTASKLTF,0,3,1,3
TRAV23DV6,TRAJ18,CAASRGSTLGRLYF,0,3,1,3
TRAV8-2,TRAJ7,CVVSAPYGNNRLAF,0,3,1,3
TRAV35,TRAJ58,CAGQLPYPSLSPYGVGSGSRLTS,0,3,1,3
TRAV12-1,TRAJ49,CVVNIGRGVGYFQDTGNQFYF,0,3,1,3
TRAV13-1,TRAJ52,CVAPNPPRWAGGTSYGKLTF,0,3,1,3
TRAV2,TRAJ45,CAATRPKGDGARGGADGLTF,0,3,1,3
TRAV4,TRAJ28,CLVGVLSPAYSGAGSYQLTF,0,3,1,3
TRAV17,TRAJ52,CATDLLFNAGGTSYGKLTF,0,3,1,3
TRAV12-1,TRAJ45,CVVTGRSGSGGGADGLAF,0,3,1,3
TRAV12-1,TRAJ3,CVVNKGRDLYSSASNIIF,0,3,1,3
TRAV13-1,TRAJ40,CAASIIGLGASGTYKYIF,0,3,1,3
TRAV5,TRAJ42,CAESIKGNYGGSQGNLIF,0,3,1,3
TRAV12-3,TRAJ52,CAMSASNAGGTSYGKLTF,0,3,1,3
TRAV26-2,TRAJ52,CILSRHNAGGTSYGKLTF,0,3,1,3
TRAV26-1,TRAJ32,CIVRPRGEYGGATNKLIF,0,3,1,3
TRAV38-2DV8,TRAJ42,CAYGGLPDGGSQGNLIF,0,3,1,3
TRAV19,TRAJ45,CALSEGYSGGGADGLTF,0,3,1,3
TRAV16,TRAJ28,CALMESYSGAGSYQLTF,0,3,1,3
TRAV16,TRAJ53,CALSGLGSGGSNYKLTF,0,3,1,3
TRAV21,TRAJ47,CAVYPDGIMEYGNKLVF,0,3,1,3
TRAV34,TRAJ28,CAVPPGRSGAGSYQLTF,0,3,1,3
TRAV29DV5,TRAJ22,CAATGGLSSGSARQLTF,0,3,1,3
TRAV29DV5,TRAJ28,CAATTPYSGAGSYQLTF,0,3,1,3
TRAV13-2,TRAJ42,CADSSPNYGGSQGNLIF,0,3,1,3
TRAV5,TRAJ13,CAENPPSSSGGYQEVTF,0,3,1,3
TRAV12-3,TRAJ22,CAMRGDPLRGSARQLTF,0,3,1,3
TRAV4,TRAJ18,CLVGDGDRGSTLGRLYF,0,3,1,3
TRAV12-1,TRAJ9,CVVGGGRNTGGFKTIF,0,3,1,3
TRAV12-1,TRAJ10,CVVNSILTGGGNKLTF,0,3,1,3
TRAV12-1,TRAJ9,CVVNMLINTGGFKTIF,0,3,1,3
TRAV12-1,TRAJ42,CVVNMDYGGSQGNLIF,0,3,1,3
TRAV12-1,TRAJ3,CVVSEPGYSSASKIIF,0,3,1,3
TRAV9-2,TRAJ45,CALSEGSGGGADGLTF,0,3,1,3
TRAV16,TRAJ57,CALSPQFQGGSEKLVF,0,3,1,3
TRAV41,TRAJ35,CAVMLRGGSFGSVLHC,0,3,1,3
TRAV41,TRAJ45,CAVRRDPGGGADGLTF,0,3,1,3
TRAV21,TRAJ53,CAVSSNSGGSNYKLTF,0,3,1,3
TRAV3,TRAJ5,CAVRDSPHTGRRALTF,0,3,1,3
TRAV3,TRAJ9,CAVRDQTNTGGFKTIF,0,3,1,3
TRAV3,TRAJ38,CAVREANAGNNRKLIW,0,3,1,3
TRAV17,TRAJ37,CATDGKGSSNTGKLIF,0,3,1,3
TRAV13-1,TRAJ42,CALRVNYGGSQGNLIF,0,3,1,3
TRAV12-2,TRAJ37,CAVKITGSGNTGKLIF,0,3,1,3
TRAV12-2,TRAJ52,CAPRNAGGTSYGKLTF,0,3,1,3
TRAV23DV6,TRAJ18,CAVPPDRGSTLGRLYF,0,3,1,3
TRAV13-1,TRAJ38,CAAPGRNAGNNRKLIW,0,3,1,3
TRAV23DV6,TRAJ45,CAASTYSGGGADGLTF,0,3,1,3
TRAV29DV5,TRAJ45,CAASEWGGGGADGLTF,0,3,1,3
TRAV5,TRAJ32,CAESMGYGGATNKLIF,0,3,1,3
TRAV13-2,TRAJ36,CAEKFELKTGANNLFF,0,3,1,3
TRAV12-3,TRAJ52,CAMIREGGTSYGKLTF,0,3,1,3
TRAV12-3,TRAJ45,CAMSPYSGGGADGLTF,0,3,1,3
TRAV12-3,TRAJ4,CAMSAAISGGYNKLIF,0,3,1,3
TRAV14DV4,TRAJ22,CAMRTFSSGSARQLTF,0,3,1,3
TRAV14DV4,TRAJ4,CAMRGIFSGGYNKLIS,0,3,1,3
TRAV14DV4,TRAJ16,CAMREGRGFDGQKLLF,0,3,1,3
TRAV12-2,TRAJ58,CTVNRGRETSGSRLTF,0,3,1,3
TRAV4,TRAJ37,CLVGDIGGGELGKLIF,0,3,1,3
TRAV10,TRAJ44,CVVSAGSGTASKLTF,0,3,1,3
TRAV10,TRAJ18,CVVSDRGSTLGRLYF,0,3,1,3
TRAV38-1,TRAJ42,CAFVNYGGSQGNLIF,0,3,1,3
TRAV38-1,TRAJ34,CAFMRSFYNTDKLIF,0,3,1,3
TRAV16,TRAJ32,CASRDYGGATSKLIF,0,3,1,3
TRAV38-1,TRAJ4,CAWTTVSGGYNKLIF,0,3,1,3
TRAV38-2DV8,TRAJ48,CAYRTSNFGNEKLTF,0,3,1,3
TRAV38-2DV8,TRAJ50,CAYSDSGTSYDKVIF,0,3,1,3
TRAV38-2DV8,TRAJ15,CAYRGDNQAGTALIF,0,3,1,3
TRAV6,TRAJ45,CALPHSGGGADGLTF,0,3,1,3
TRAV19,TRAJ22,CALGGLSGSARQLTF,0,3,1,3
TRAV9-2,TRAJ27,CALSDPRTNAGKSTF,0,3,1,3
TRAV6,TRAJ52,CALGRGGTSYGKLTF,0,3,1,3
TRAV6,TRAJ40,CALDDPGSGTYKYIF,0,3,1,3
TRAV16,TRAJ40,CALMQATSGTYKYIF,0,3,1,3
TRAV16,TRAJ53,CALRNSGGSNYKLTF,0,3,1,3
TRAV35,TRAJ42,CAPSNYGGSQGNLIF,0,3,1,3
TRAV22,TRAJ38,CAVLKYAGNNRKLIW,0,3,1,3
TRAV2,TRAJ16,CAVAGFLADGQKLLF,0,3,1,3
TRAV21,TRAJ33,CAVIPEEWSNYQLIW,0,3,1,3
TRAV21,TRAJ57,CAVIRREGGSEKLVF,0,3,1,3
TRAV3,TRAJ37,CAVSPGSGNTGKLIF,0,3,1,3
TRAV3,TRAJ13,CAVRGALVGYQKVTF,0,3,1,3
TRAV21,TRAJ10,CAVRGLAGGGNKLTF,0,3,1,3
TRAV3,TRAJ8,CAVRDINTGFQKLVF,0,3,1,3
TRAV41,TRAJ42,CAAPRGGGSQGNLIF,0,3,1,3
TRAV17,TRAJ10,CATGPPTGGGNKLTF,0,3,1,3
TRAV17,TRAJ42,CATDGDGGSQGNLIF,0,3,1,3
TRAV12-2,TRAJ28,CAVSLSGAGSYQLTF,0,3,1,3
TRAV12-2,TRAJ28,CAVRRDGAGSYQLTF,0,3,1,3
TRAV8-1,TRAJ38,CAVNVNAGNNRKLIW,0,3,1,3
TRAV12-2,TRAJ8,CAVNARNTGFQKLVF,0,3,1,3
TRAV12-2,TRAJ42,CAVNKRGGSQGNLIF,0,3,1,3
TRAV12-2,TRAJ22,CAVKFPSGSARQLTF,0,3,1,3
TRAV12-3,TRAJ52,CAAPRGGTSYGKLTF,0,3,1,3
TRAV13-2,TRAJ53,CAQAQGMGSNYKLTF,0,3,1,3
TRAV13-1,TRAJ28,CAAGPSGAGSYQLTF,0,3,1,3
TRAV13-1,TRAJ12,CAAISWMDSSYKLIF,0,3,1,3
TRAV13-1,TRAJ32,CAASIEGGATNKLIF,0,3,1,3
TRAV13-1,TRAJ43,CAASRRLRNNNDMRF,0,3,1,3
TRAV25,TRAJ53,CAGRRSGGSNYKLTF,0,3,1,3
TRAV27,TRAJ48,CAGGLSNFGNEKLTF,0,3,1,3
TRAV13-2,TRAJ5,CAERLMNTGRRALTF,0,3,1,3
TRAV13-2,TRAJ6,CAENKKAGGSYIPTF,0,3,1,3
TRAV12-3,TRAJ3,CAMRGGYSSASKIIF,0,3,1,3
TRAV12-3,TRAJ28,CAMTSSGAGSYQLTF,0,3,1,3
TRAV14DV4,TRAJ45,CAMREGGRGADGLTF,0,3,1,3
TRAV30,TRAJ26,CGTETPDNYGQNFVF,0,3,1,3
TRAV4,TRAJ6,CLVVRPTGGSYIPTF,0,3,1,3
TRAV4,TRAJ13,CLVGDGPGGYQKVTF,0,3,1,3
TRAV26-2,TRAJ44,CILSANTGTASKLTF,0,3,1,3
TRAV26-2,TRAJ53,CILRDRGGSIYKLTF,0,3,1,3
TRAV26-2,TRAJ53,CILRDRGGSNYKLTF,0,3,1,3
TRAV26-1,TRAJ29,CIVRSGPSGNTPLVF,0,3,1,3
TRAV12-1,TRAJ42,CVLNYGGSQGNLIF,0,3,1,3
TRAV12-1,TRAJ40,CVVTPTSGTYKYIF,0,3,1,3
TRAV12-1,TRAJ16,CVVTLLSDGQKLLF,0,3,1,3
TRAV10,TRAJ12,CVVRRMDSSYKLIF,0,3,1,3
TRAV12-1,TRAJ6,CVVNSAGGSYIPTF,0,3,1,3
TRAV12-1,TRAJ4,CVVNLSGGYNKLIF,0,3,1,3
TRAV38-1,TRAJ41,CAFATPNSGYALNF,0,3,1,3
TRAV38-1,TRAJ26,CAFMRGSYGQNFVF,0,3,1,3
TRAV38-2DV8,TRAJ17,CAYMIKAAGNKLTF,0,3,1,3
TRAV38-2DV8,TRAJ49,CAYRSRNTGNQFYF,0,3,1,3
TRAV38-2DV8,TRAJ30,CAYRSGYRDDKIIF,0,3,1,3
TRAV38-2DV8,TRAJ57,CAYVPPGGSEKPVF,0,3,1,3
TRAV9-2,TRAJ23,CALRSYNQGGKLIF,0,3,1,3
TRAV9-2,TRAJ27,CALFRGTNAGKSTF,0,3,1,3
TRAV9-2,TRAJ6,CALSLLGGSYIPTF,0,3,1,3
TRAV9-2,TRAJ9,CALSVPGGGFKTIF,0,3,1,3
TRAV9-2,TRAJ9,CALSVPGGGLKTIF,0,3,1,3
TRAV19,TRAJ30,CALSEVRRDDKIIF,0,3,1,3
TRAV19,TRAJ11,CALSEASGYSTLTF,0,3,1,3
TRAV9-2,TRAJ52,CALSEGPSYGKLTF,0,3,1,3
TRAV9-2,TRAJ53,CALSEGGSNYKLTF,0,3,1,3
TRAV9-2,TRAJ17,CALRGKAAGNKLTF,0,3,1,3
TRAV19,TRAJ58,CALRKGTSGSRLTF,0,3,1,3
TRAV19,TRAJ11,CALKPNSGYSTLTF,0,3,1,3
TRAV9-2,TRAJ26,CALKDGNYGQHFVF,0,3,1,3
TRAV22,TRAJ40,CALSLVLGTYKYIF,0,3,1,3
TRAV16,TRAJ32,CALSRGGATNKLIF,0,3,1,3
TRAV12-2,TRAJ28,CAVSSGAGSYQLTF,0,3,1,3
TRAV36DV7,TRAJ34,CAVLKASNTDKLIF,0,3,1,3
TRAV3,TRAJ5,CAVVKDTGRRALTF,0,3,1,3
TRAV8-3,TRAJ45,CAVSIPGGADGLTL,0,3,1,3
TRAV8-3,TRAJ5,CAVVMDTGRRALTF,0,3,1,3
TRAV20,TRAJ10,CAVVETGGGNKLTF,0,3,1,3
TRAV8-3,TRAJ47,CAVGAEDYGNKLVF,0,3,1,3
TRAV8-3,TRAJ54,CAVGSVGGAQKLVF,0,3,1,3
TRAV8-3,TRAJ49,CAVGAMGTGNQFYF,0,3,1,3
TRAV8-3,TRAJ27,CAVGGRTNAGKSTF,0,3,1,3
TRAV36DV7,TRAJ32,CAVEYGGATNKLIF,0,3,1,3
TRAV2,TRAJ20,CAVELLGNDYKLSF,0,3,1,3
TRAV21,TRAJ6,CAVSGPGGSYIPTF,0,3,1,3
TRAV8-4,TRAJ22,CAVSESGSARQLTF,0,3,1,3
TRAV8-4,TRAJ5,CAVRVDTGRRALTF,0,3,1,3
TRAV3,TRAJ39,CAVRPYNAGNMLTF,0,3,1,3
TRAV3,TRAJ11,CAVRANSGYSTLTF,0,3,1,3
TRAV3,TRAJ17,CAVRDLAAGNKLTF,0,3,1,3
TRAV3,TRAJ31,CAVRDGRNNARLMF,0,3,1,3
TRAV3,TRAJ10,CAVRDKGGGNKLTF,0,3,1,3
TRAV3,TRAJ5,CAVKGRAGRRALTF,0,3,1,3
TRAV12-2,TRAJ29,CAVKDDSGNTPLVF,0,3,1,3
TRAV35,TRAJ24,CAGPAPDSWGKFQF,0,3,1,3
TRAV35,TRAJ3,CAGTGSSSASKIIF,0,3,1,3
TRAV17,TRAJ13,CATSDSGGYQKVTF,0,3,1,3
TRAV17,TRAJ18,CATDRGSTLGRLYF,0,3,1,3
TRAV17,TRAJ40,CATEGMSGTYKYIF,0,3,1,3
TRAV12-2,TRAJ13,CAVWNSGGYQKVTF,0,3,1,3
TRAV12-2,TRAJ22,CAVEESGSARQLTF,0,3,1,3
TRAV12-2,TRAJ9,CAVNPDTGSFKTIF,0,3,1,3
TRAV12-2,TRAJ44,CAVNMRGTASKLTF,0,3,1,3
TRAV12-2,TRAJ35,CAVNMRGFGNVLHC,0,3,1,3
TRAV12-2,TRAJ11,CAVNRDSGYSTLTF,0,3,1,3
TRAV12-2,TRAJ28,CAVLFGAGSYQLTF,0,3,1,3
TRAV12-1,TRAJ3,CAVNMYSSASKIIF,0,3,1,3
TRAV13-1,TRAJ37,CAAPGESNTGKLIF,0,3,1,3
TRAV13-1,TRAJ48,CAASTNFGNEKLTF,0,3,1,3
TRAV29DV5,TRAJ13,CAAMNSGGYQKVTF,0,3,1,3
TRAV13-1,TRAJ34,CAASVRRNTDKLIF,0,3,1,3
TRAV13-1,TRAJ16,CAASIESDGQKLLF,0,3,1,3
TRAV13-1,TRAJ23,CAASKGNQGGKLIF,0,3,1,3
TRAV13-1,TRAJ13,CAASLSGGYQKVTF,0,3,1,3
TRAV29DV5,TRAJ37,CAASVPGNTGKLIF,0,3,1,3
TRAV29DV5,TRAJ27,CAASASTNAGKSTF,0,3,1,3
TRAV29DV5,TRAJ12,CAASGADSSYKLIF,0,3,1,3
TRAV27,TRAJ39,CAGALKDAGNMLTF,0,3,1,3
TRAV5,TRAJ39,CAERWDNAGNMLTF,0,3,1,3
TRAV13-2,TRAJ38,CAEKRAGNNRKLIW,0,3,1,3
TRAV12-3,TRAJ45,CAMYSGGGADGLTF,0,3,1,3
TRAV12-3,TRAJ57,CAMVPQGGSEKLVF,0,3,1,3
TRAV12-3,TRAJ26,CAMMEGGYGQNFVF,0,3,1,3
TRAV12-3,TRAJ10,CAMSFTGGGNKLTF,0,3,1,3
TRAV12-3,TRAJ21,CAMSAGYNFNKFYF,0,3,1,3
TRAV12-3,TRAJ21,CAMSGLYNFNKFYF,0,3,1,3
TRAV12-3,TRAJ3,CAMSDRSSASKIIF,0,3,1,3
TRAV14DV4,TRAJ5,CAMRERTGRRALAF,0,3,1,3
TRAV14DV4,TRAJ43,CAMREAQGNNDMRF,0,3,1,3
TRAV34,TRAJ57,CGADPEGGSGKLVF,0,3,1,3
TRAV26-1,TRAJ49,CFVRVQNTGNQFYF,0,3,1,3
TRAV4,TRAJ9,CLVGDLGGGFKTIF,0,3,1,3
TRAV26-2,TRAJ54,CILRGYQGAQKLVF,0,3,1,3
TRAV26-1,TRAJ17,CIVRVKAAGNKLTF,0,3,1,3
TRAV13-1,TRAJ20,YAASEWSNDYKLSF,0,3,1,3
TRAV13-1,TRAJ4,RAASNTGGYNKLIF,0,3,1,3
TRAV38-2DV8,TRAJ28,CFYSGAGSYQLTF,0,3,1,3
TRAV12-1,TRAJ10,CVVFTGGGNKLTF,0,3,1,3
TRAV12-1,TRAJ6,CVVLAGGSYIPTF,0,3,1,3
TRAV12-1,TRAJ4,CVVLSGGYNKLIF,0,3,1,3
TRAV12-1,TRAJ47,CVVIRLDGNKLVF,0,3,1,3
TRAV12-1,TRAJ34,CVVTPYNTDKLIF,0,3,1,3
TRAV12-1,TRAJ34,CVVTPMDTDKLIF,0,3,1,3
TRAV12-1,TRAJ6,CVVNRRGSYIPTF,0,3,1,3
TRAV12-1,TRAJ49,CVATKGGGNQFYF,0,3,1,3
TRAV38-1,TRAJ20,CAFRPPNDYKLSF,0,3,1,3
TRAV38-2DV8,TRAJ49,CAYRRETGNQFYF,0,3,1,3
TRAV38-2DV8,TRAJ56,CAYRAGANSKLTF,0,3,1,3
TRAV38-2DV8,TRAJ48,CAYKNFGNEKLTF,0,3,1,3
TRAV16,TRAJ25,CALSEGQGFSFIF,0,3,1,3
TRAV9-2,TRAJ49,CALSAPTGGQFYF,0,3,1,3
TRAV9-2,TRAJ9,CALSEPGGFKTIF,0,3,1,3
TRAV9-2,TRAJ8,CALRDTGFQKLVF,0,3,1,3
TRAV9-2,TRAJ12,CALRMDSSYKLIF,0,3,1,3
TRAV9-2,TRAJ27,CALRNTNAGKSTF,0,3,1,3
TRAV16,TRAJ58,CALGRVSGSRLTF,0,3,1,3
TRAV12-2,TRAJ44,CALGTGTASKLTF,0,3,1,3
TRAV16,TRAJ39,CALIRNAGNMLTF,0,3,1,3
TRAV16,TRAJ9,CAPTYTGGFKTIF,0,3,1,3
TRAV16,TRAJ4,CAPKGGGYNKLIF,0,3,1,3
TRAV6,TRAJ27,CARVNTNAGKSTF,0,3,1,3
TRAV21,TRAJ13,CAVDSGGYQKVTF,0,3,1,3
TRAV41,TRAJ45,CAVFGGGADGLTF,0,3,1,3
TRAV41,TRAJ57,CAVSKGGSEKLVF,0,3,1,3
TRAV21,TRAJ35,CAVFTGFGNVLHC,0,3,1,3
TRAV21,TRAJ22,CAVLSGSARQLTF,0,3,1,3
TRAV22,TRAJ50,CAVVETSYDKVIF,0,3,1,3
TRAV12-2,TRAJ54,CAVVIQGAQKLVF,0,3,1,3
TRAV8-3,TRAJ37,CAVGARGTGKLIF,0,3,1,3
TRAV8-3,TRAJ47,CAVGMEYGNKLVF,0,3,1,3
TRAV20,TRAJ7,CAVDSGGNNRLAF,0,3,1,3
TRAV12-2,TRAJ26,CAVDDNYGQNFVF,0,3,1,3
TRAV36DV7,TRAJ38,CAVEAGNNRKLIW,0,3,1,3
TRAV21,TRAJ10,CAVETGGGNKLTF,0,3,1,3
TRAV3,TRAJ5,CAVSYTGRRAFTF,0,3,1,3
TRAV8-4,TRAJ36,CAVSPTGANNLFF,0,3,1,3
TRAV8-4,TRAJ9,CAVSHTGGFKTIF,0,3,1,3
TRAV8-4,TRAJ7,CAVSERGNNRLAF,0,3,1,3
TRAV8-4,TRAJ7,CAVSERGNNRLAS,0,3,1,3
TRAV3,TRAJ21,CAVRPLDFNKFYF,0,3,1,3
TRAV3,TRAJ6,CAVREGGSFIPTF,0,3,1,3
TRAV8-4,TRAJ49,CAVNYRTGNQFYF,0,3,1,3
TRAV41,TRAJ35,CAATIGFGNVLHC,0,3,1,3
TRAV20,TRAJ6,CAGEGGGSYIPTF,0,3,1,3
TRAV35,TRAJ54,CAGRFQGAQKLVF,0,3,1,3
TRAV36DV7,TRAJ39,CAEGYNAGNMLTF,0,3,1,3
TRAV17,TRAJ16,CATALSDGQKLLF,0,3,1,3
TRAV24,TRAJ10,CAFPAGGGNKLTF,0,3,1,3
TRAV38-2DV8,TRAJ44,CASRAGTASKLTF,0,3,1,3
TRAV36DV7,TRAJ35,CALGGGFGNVLHC,0,3,1,3
TRAV12-2,TRAJ16,CAVSTPHGQKLLF,0,3,1,3
TRAV12-2,TRAJ42,CAVTRGSQGNLIF,0,3,1,3
TRAV12-2,TRAJ28,CAVTGAGSYQLTF,0,3,1,3
TRAV12-2,TRAJ8,CAVRITGFQKLVF,0,3,1,3
TRAV12-2,TRAJ41,CAVKSNSGYALNF,0,3,1,3
TRAV8-4,TRAJ12,CAAVMDSSYKLIF,0,3,1,3
TRAV12-2,TRAJ6,CAATRGGSYIPTF,0,3,1,3
TRAV12-2,TRAJ33,CAAGMDSNYQLIW,0,3,1,3
TRAV13-1,TRAJ17,CAEGGAAGNKLTF,0,3,1,3
TRAV12-3,TRAJ3,CASLVSSASKIIF,0,3,1,3
TRAV13-1,TRAJ13,CAAYSGGYQKVTF,0,3,1,3
TRAV13-1,TRAJ4,CAALPGGYNKLIF,0,3,1,3
TRAV29DV5,TRAJ45,CAAAGGGADGLTF,0,3,1,3
TRAV13-1,TRAJ30,CAAILNRDDKIIF,0,3,1,3
TRAV13-1,TRAJ5,CAAMDTGRRALTF,0,3,1,3
TRAV13-1,TRAJ24,CAATIDSWGKFQF,0,3,1,3
TRAV13-1,TRAJ7,CAASEEGNNRLAF,0,3,1,3
TRAV13-1,TRAJ34,CAASIWNTDKLIF,0,3,1,3
TRAV13-1,TRAJ49,CAASINTGNQFYF,0,3,1,3
TRAV13-1,TRAJ7,CAASKPGNNRLAF,0,3,1,3
TRAV23DV6,TRAJ48,CAASSGGNEKLTF,0,3,1,3
TRAV23DV6,TRAJ10,CAASPGGGNKLTV,0,3,1,3
TRAV23DV6,TRAJ57,CAASKGGSEKLVF,0,3,1,3
TRAV29DV5,TRAJ40,CAARTSGTYKYIF,0,3,1,3
TRAV27,TRAJ23,CAGHDNQGGKLIF,0,3,1,3
TRAV13-2,TRAJ4,CAETSGGYNKLIF,0,3,1,3
TRAV13-2,TRAJ4,CAENIGGYNKLIF,0,3,1,3
TRAV13-2,TRAJ58,CAEKETSGSRLTF,0,3,1,3
TRAV12-3,TRAJ52,CAMGLTSYGKLTF,0,3,1,3
TRAV12-3,TRAJ48,CAMSEQGNEKLTF,0,3,1,3
TRAV12-3,TRAJ10,CAMKTGGGNKLTF,0,3,1,3
TRAV27,TRAJ20,CASGPYNDYKLSF,0,3,1,3
TRAV30,TRAJ34,CGTETPNTDKLIF,0,3,1,3
TRAV4,TRAJ40,CLVVASGTYKYIF,0,3,1,3
TRAV4,TRAJ17,CLVAQAAGNKLTF,0,3,1,3
TRAV30,TRAJ48,CGSASFGNEKLTL,0,3,1,3
TRAV26-2,TRAJ40,CILYTSGTYKYIF,0,3,1,3
TRAV26-2,TRAJ34,CILRDMRADKLIF,0,3,1,3
TRAV26-2,TRAJ5,CILKGTGRRALTF,0,3,1,3
TRAV26-1,TRAJ20,CIVRVANDYKLSF,0,3,1,3
TRAV26-1,TRAJ40,CIVRIPGTYKYIF,0,3,1,3
TRAV26-1,TRAJ37,CIAPSGNTGKLIF,0,3,1,3
TRAV12-3,TRAJ35,YASVKGFGNVLHC,0,3,1,3
TRAV12-1,TRAJ36,RVVIPTGANNLFF,0,3,1,3
TRAV20,TRAJ4,CVVSGGYNKLIF,0,3,1,3
TRAV12-1,TRAJ39,CVVRVAGNMLTF,0,3,1,3
TRAV12-1,TRAJ21,CVVGYDFNKFYF,0,3,1,3
TRAV10,TRAJ20,CVVSAVDYKLSF,0,3,1,3
TRAV12-1,TRAJ16,CVVNADGQKLLF,0,3,1,3
TRAV12-1,TRAJ36,CVVKPPIGNLFF,0,3,1,3
TRAV2,TRAJ32,CAFSPGTNKLIF,0,3,1,3
TRAV38-2DV8,TRAJ34,CAYRSAADKLIF,0,3,1,3
TRAV6,TRAJ31,CALEPNNARLMF,0,3,1,3
TRAV16,TRAJ49,CALNRTGNQFYF,0,3,1,3
TRAV36DV7,TRAJ41,CAVGGSGYALNF,0,3,1,3
TRAV21,TRAJ56,CAVSGANSKLTF,0,3,1,3
TRAV2,TRAJ16,CAVGSDGQKLLF,0,3,1,3
TRAV22,TRAJ11,CAVERRYSTLTF,0,3,1,3
TRAV8-6,TRAJ30,CAVTNRDDKIIF,0,5,1,5
TRAV36DV7,TRAJ39,CAVHNAGNMLTF,0,3,1,3
TRAV20,TRAJ58,CAAETSGSRLTS,0,3,1,3
TRAV20,TRAJ5,CAAITGRRALTF,0,3,1,3
TRAV21,TRAJ6,CAAVGGSYIPTF,0,3,1,3
TRAV35,TRAJ27,CAGQLYAGKSTF,0,3,1,3
TRAV17,TRAJ34,CATDHNTDKLIF,0,3,1,3
TRAV17,TRAJ4,CATDGGYNKLIF,0,3,1,3
TRAV6,TRAJ9,CALGAGGFKTIF,0,3,1,3
TRAV12-2,TRAJ34,CAPRGNTDKLIF,0,3,1,3
TRAV8-1,TRAJ22,CAVSGTARQLTF,0,3,1,3
TRAV12-2,TRAJ6,CAVVPGSYIPTF,0,3,1,3
TRAV12-3,TRAJ31,CAVGQGSARLMF,0,3,1,3
TRAV12-2,TRAJ30,CAVMGRDDKIIF,0,3,1,3
TRAV12-2,TRAJ43,CAVNPQRNDMRF,0,3,1,3
TRAV12-2,TRAJ34,CAAMRNTDKLIF,0,3,1,3
TRAV12-2,TRAJ24,CAGADSWGKFQF,0,3,1,3
TRAV13-1,TRAJ49,CAASNTGNQFYF,0,3,1,3
TRAV29DV5,TRAJ36,CAASGGANNLFF,0,3,1,3
TRAV23DV6,TRAJ37,CAASKNTGKLIF,0,3,1,3
TRAV29DV5,TRAJ9,CAANTGGFKTIF,0,3,1,3
TRAV25,TRAJ49,CAGPNTGNQFYF,0,3,1,3
TRAV27,TRAJ20,CAGHRDDYKLSF,0,3,1,3
TRAV5,TRAJ34,CAESIGTDKLIF,0,3,1,3
TRAV12-3,TRAJ13,CAIRGGYQKVTF,0,3,1,3
TRAV12-3,TRAJ7,CAMAYGNNRLAF,0,3,1,3
TRAV12-3,TRAJ20,CAMREDDYKLSF,0,3,1,3
TRAV26-2,TRAJ47,CILSAYGNKLVF,0,3,1,3
TRAV26-1,TRAJ49,CIVRLTGNQFYF,0,3,1,3
TRAV25,TRAJ29,SIPGGNTPLVF,0,3,1,3
TRAV10,TRAJ20,CVVSVDYKLSF,0,3,1,3
TRAV38-1,TRAJ21,CAFINFNKFYF,0,3,1,3
TRAV38-1,TRAJ54,CASRRAQKLVF,0,3,1,3
TRAV9-2,TRAJ3,CALGVASKIIF,0,3,1,3
TRAV16,TRAJ23,CALTSTGKLIF,0,3,1,3
TRAV21,TRAJ49,CAVFDPNQFYF,0,3,1,3
TRAV8-3,TRAJ26,CAVGVGQNFVF,0,3,1,3
TRAV2,TRAJ36,CAVSGANNLFF,0,3,1,3
TRAV21,TRAJ21,CAVYNFNKFYF,0,3,1,3
TRAV21,TRAJ35,CAVGFGNVLHC,0,3,1,3
TRAV3,TRAJ6,CAAGGSYIPTF,0,3,1,3
TRAV39,TRAJ42,CAVDILGNLIF,0,3,1,3
TRAV12-2,TRAJ20,CAVNPNYKLSF,0,3,1,3
TRAV12-2,TRAJ15,CAAQAGTALIF,0,3,1,3
TRAV13-1,TRAJ34,CAAWNTDKLIF,0,3,1,3
TRAV13-1,TRAJ20,CAAGGDYKLSF,0,3,1,3
TRAV13-1,TRAJ38,CAARMDRKLIW,0,3,1,3
TRAV27,TRAJ16,CAGAGGQKLLF,0,3,1,3
TRAV27,TRAJ53,CAGGSNYKLTL,0,3,1,3
TRAV13-2,TRAJ16,CAEADGQKLLF,0,3,1,3
TRAV12-3,TRAJ31,CAMTYNARLMF,0,3,1,3
TRAV12-3,TRAJ43,CAMRDNNDMRF,0,3,1,3
TRAV12-3,TRAJ47,CATRYGNKLVF,0,3,1,3
TRAV12-2,TRAJ11,CGTSGYSTLTF,0,3,1,3
TRAV29DV5,TRAJ50,CTKTSYDKVIF,0,3,1,3
TRAV17,TRAJ3,CGYSSASKIIF,0,3,1,3
TRAV27,TRAJ49,SSNTGNQFYF,0,3,1,3
TRAV38-2DV8,TRAJ34,CAYSSDELIF,0,3,1,3
TRAV21,TRAJ20,CALNDYKLSF,0,3,1,3
TRAV1-2,TRAJ31,CAVGGARLMF,0,3,1,3
TRAV8-3,TRAJ33,CAASNYQLIW,0,3,1,3
TRAV13-2,TRAJ21,CADNFNKFYF,0,3,1,3
TRAV25,TRAJ31,CAQYNARLTF,0,3,1,3
TRAV27,TRAJ30,CAGDAGKIIF,0,3,1,3
TRAV5,TRAJ27,CAESISKSTF,0,3,1,3
TRAV12-1,TRAJ32,CSGATNKLIF,0,3,1,3
TRAV4,TRAJ11,CLEGYSTLTF,0,3,1,3
TRAV12-2,TRAJ21,CAVWVKFYF,0,3,1,3
TRAV39,TRAJ34,CAVEDKLIF,0,3,1,3
TRAV13-1,TRAJ16,LGGQKLLF,0,3,1,3
TRAV4,TRAJ35,CLVVVLHC,0,3,1,3
TRAV23DV6,TRAJ33,CAASNG,0,3,1,3
TRAV8-1,TRAJ35,CAAG,0,3,1,3
TRAV12-2,TRAJ44,CAVRAYPSSTGTASKLTF,0,2,1,2
TRAV35,TRAJ53,CAGQFRGNSGGSNYKLTF,0,2,1,2
TRAV12-2,TRAJ45,CAVNNRGRGGGGADGLTF,0,2,1,2
TRAV13-2,TRAJ52,CAEIQSYAGGTSYGKLTF,0,2,1,2
TRAV26-2,TRAJ42,CILRDKINYGGSQGNLIF,0,2,1,2
TRAV26-1,TRAJ52,CIVSLTLGGGTSYGKLTF,0,2,1,2
TRAV38-1,TRAJ10,CAFMKRRGTGGGNKLTF,0,2,1,2
TRAV38-2DV8,TRAJ42,CAYLYMNYGGSQGNLIF,0,2,1,2
TRAV38-2DV8,TRAJ32,CAYRSADYGGATNKLIF,0,2,1,2
TRAV9-2,TRAJ52,CALTPNAGGTSYGKLTF,0,2,1,2
TRAV19,TRAJ45,CALSEPYSGGGADGLTF,0,2,1,2
TRAV19,TRAJ11,CALSEAIMNSGYSTLTF,0,2,1,2
TRAV8-3,TRAJ39,CAVGPPGLNNAGNMLTF,0,2,1,2
TRAV3,TRAJ18,CAVGDYDRGSTLGRLYF,0,2,1,2
TRAV3,TRAJ38,CAVRDINNAGNNRKLIW,0,2,1,2
TRAV12-2,TRAJ28,CAARGRNSGAGSYQLTF,0,2,1,2
TRAV39,TRAJ54,CAVDFILSDQGAQKLVF,0,2,1,2
TRAV29DV5,TRAJ52,CAASPNAGGTSYGKLTF,0,2,1,2
TRAV29DV5,TRAJ28,CAASAAYSGAGSYQLTF,0,2,1,2
TRAV23DV6,TRAJ30,CAASICRVSNRDDKIIF,0,2,1,2
TRAV12-3,TRAJ10,CATTWAILTGGGNKLTF,0,2,1,2
TRAV30,TRAJ48,CGTERRASNFGNEKLTF,0,2,1,2
TRAV4,TRAJ38,CLVGDVTNAGNNRKLIW,0,2,1,2
TRAV26-2,TRAJ40,CILRDPLEGPGTYKYIF,0,2,1,2
TRAV26-1,TRAJ29,CIVRVARTVSGNTPLVF,0,2,1,2
TRAV8-2,TRAJ47,CVVSEKRREYGNKLVF,0,2,1,2
TRAV8-2,TRAJ32,CVESDNYGGATNKLIF,0,2,1,2
TRAV10,TRAJ28,CVVSADSEAGSYQLTF,0,2,1,2
TRAV12-1,TRAJ3,CVVNNRERSSASKIIF,0,2,1,2
TRAV38-1,TRAJ42,CAFMKPSQGSQGNLIF,0,2,1,2
TRAV38-2DV8,TRAJ28,CAYYLYSGAGSYQLTF,0,2,1,2
TRAV9-2,TRAJ58,CALGNMEETSGSRLTF,0,2,1,2
TRAV9-2,TRAJ22,CALSDADSGSVRQLTF,0,2,1,2
TRAV16,TRAJ42,CALSVGWGGSQGNLIF,0,2,1,2
TRAV2,TRAJ13,CAVEDLDSGGYQKVTF,0,2,1,2
TRAV2,TRAJ42,CAVEDLYGGSQGNLIF,0,2,1,2
TRAV8-6,TRAJ22,CAVISTSSGSARQLTF,0,2,1,2
TRAV8-4,TRAJ52,CAVSASGGTSYGKLTL,0,2,1,2
TRAV8-4,TRAJ49,CAVSDFFSNTGNQFYF,0,2,1,2
TRAV3,TRAJ40,CAVRDYYTSGTYEYIF,0,2,1,2
TRAV3,TRAJ17,CAVRDITKAAGNKLTF,0,2,1,2
TRAV17,TRAJ28,CATTAPSGAGSYQLTF,0,2,1,2
TRAV24,TRAJ52,CASSNAGGTSYGKLTF,0,2,1,2
TRAV8-1,TRAJ42,CAVNAGYGGSQGNLIL,0,2,1,2
TRAV12-2,TRAJ48,CAVNRYTDFGNEKLTF,0,2,1,2
TRAV13-1,TRAJ45,CAARSGSRGGADGLTF,0,2,1,2
TRAV23DV6,TRAJ37,CAARKPGSGNTGKLIF,0,2,1,2
TRAV29DV5,TRAJ52,CAATTIGGTSYGKLTF,0,2,1,2
TRAV13-1,TRAJ42,CAASEGYGGSQGNLIF,0,2,1,2
TRAV13-1,TRAJ53,CAASKGRGGSNYILTF,0,2,1,2
TRAV13-1,TRAJ30,CAASKIVGNRDDKIIF,0,2,1,2
TRAV13-1,TRAJ40,CAASKGRLSGTYKYIF,0,2,1,2
TRAV27,TRAJ52,CAGAEVGGTSYGKLTF,0,2,1,2
TRAV5,TRAJ45,CAEREYSGGGADGLTF,0,2,1,2
TRAV12-3,TRAJ6,CAMSAPPSGGSYIPTF,0,2,1,2
TRAV14DV4,TRAJ8,CAMRESREKGFQNLVF,0,2,1,2
TRAV23DV6,TRAJ13,CTAGPPNSGGYQKVTF,0,2,1,2
TRAV4,TRAJ11,CLVAPGGDSGYSTLTF,0,2,1,2
TRAV4,TRAJ37,CLVGDEYSGNTGKLIF,0,2,1,2
TRAV4,TRAJ22,CLVGDQRSGSARQLTF,0,2,1,2
TRAV30,TRAJ49,CGTEGGIIDTGNQFYF,0,2,1,2
TRAV12-1,TRAJ4,CVPLRSAGGYNKLIF,0,2,1,2
TRAV12-1,TRAJ23,CVVRAGNNQGGKLIF,0,2,1,2
TRAV12-1,TRAJ40,CVVNIQVVGTYKYIF,0,2,1,2
TRAV38-1,TRAJ26,CAFMKGGNYGQNFVF,0,2,1,2
TRAV38-2DV8,TRAJ39,CAYRSAEGAGNMLTF,0,2,1,2
TRAV38-2DV8,TRAJ29,CAYRSASSGNTPLVF,0,2,1,2
TRAV38-2DV8,TRAJ45,CAYRREGGGADGLTF,0,2,1,2
TRAV9-2,TRAJ40,CALIEPTSGTYKYIF,0,2,1,2
TRAV9-2,TRAJ8,CALTLEGTGFQKLVF,0,2,1,2
TRAV9-2,TRAJ53,CALSDRGGSNYKLTF,0,2,1,2
TRAV19,TRAJ4,CALSEALGGYNKLIF,0,2,1,2
TRAV17,TRAJ5,CALSPGGTGRRALTF,0,2,1,2
TRAV9-2,TRAJ16,CAPRAPFSDGQKLLF,0,2,1,2
TRAV22,TRAJ32,CAVRSYGGATNKLIF,0,2,1,2
TRAV41,TRAJ58,CAVSTKETSGSRLTF,0,2,1,2
TRAV20,TRAJ39,CAVQAGRNAGNMLTF,0,2,1,2
TRAV20,TRAJ3,CAVQPGYSSASKIIF,0,2,1,2
TRAV8-3,TRAJ10,CAVGAVTGGGNKLTS,0,2,1,2
TRAV36DV7,TRAJ42,CAVEALGGSQGNLIF,0,2,1,2
TRAV2,TRAJ28,CAVEDRGARSYQLTL,0,2,1,2
TRAV2,TRAJ8,CAVEDQGTGFQKLVF,0,2,1,2
TRAV8-6,TRAJ42,CAVTTLGGSQGNLIF,0,2,1,2
TRAV8-4,TRAJ9,CAVSEPGTGGFKTIF,0,2,1,2
TRAV21,TRAJ42,CAVRSYGGSQGNLIF,0,2,1,2
TRAV3,TRAJ33,CAVRRDVDSNYQLIW,0,2,1,2
TRAV3,TRAJ29,CAVRPSIAGNTPLVF,0,2,1,2
TRAV3,TRAJ11,CAVRDLNSGYSTLTF,0,2,1,2
TRAV3,TRAJ9,CAVRDPRGGGFKTIF,0,2,1,2
TRAV3,TRAJ36,CAVRDPGTGANNLFF,0,2,1,2
TRAV3,TRAJ27,CAVRDRETNAGKSTF,0,2,1,2
TRAV3,TRAJ15,CAVRDVNQAGTALIF,0,2,1,2
TRAV3,TRAJ24,CAVRDGGDSWGKFQF,0,2,1,2
TRAV3,TRAJ4,CAVRTFSGGYNKLIF,0,2,1,2
TRAV21,TRAJ44,CAVNPATGTASKLTF,0,2,1,2
TRAV17,TRAJ22,CAAFLSSGSARQLTF,0,2,1,2
TRAV35,TRAJ38,CAGRDNAGNNRKLIW,0,2,1,2
TRAV17,TRAJ37,CATVMNSGNTGKLIF,0,2,1,2
TRAV17,TRAJ56,CATDQLTGAYSKLTF,0,2,1,2
TRAV17,TRAJ37,CATNGIPSNTGKLIF,0,2,1,2
TRAV17,TRAJ52,CATRAGGTSYGKLTF,0,2,1,2
TRAV38-2DV8,TRAJ53,CANRSGGGSNYKLTF,0,2,1,2
TRAV24,TRAJ18,CAFLGRGSTLGRLYF,0,2,1,2
TRAV12-2,TRAJ41,CAVHENSNSGYALNF,0,2,1,2
TRAV39,TRAJ22,CAVVASSGSARQLTF,0,2,1,2
TRAV39,TRAJ40,CAVDITLRGTYKYIF,0,2,1,2
TRAV12-2,TRAJ4,CAVSAFSGGYNKLIF,0,2,1,2
TRAV8-1,TRAJ10,CAVNAFTGGGNKLTF,0,2,1,2
TRAV12-2,TRAJ22,CAVNKPPGSARQLTF,0,2,1,2
TRAV12-2,TRAJ18,CAVKDRGSTLGRLYF,0,2,1,2
TRAV34,TRAJ10,CAAKGLTGGGNKLTF,0,2,1,2
TRAV29DV5,TRAJ18,CAATDKGSTLGRLYF,0,2,1,2
TRAV29DV5,TRAJ52,CAAAAGGTSYGKLTF,0,2,1,2
TRAV13-1,TRAJ48,CAAPISNFGNEKLTF,0,2,1,2
TRAV29DV5,TRAJ34,CAAPEGLGNTDKLIF,0,2,1,2
TRAV13-1,TRAJ42,CAASPYGGSQGNLIF,0,2,1,2
TRAV13-1,TRAJ42,CAASQYGGSQGNLIF,0,2,1,2
TRAV13-1,TRAJ38,CAASRRPGNNRKLIW,0,2,1,2
TRAV29DV5,TRAJ42,CAASEYGGSQGNLIF,0,2,1,2
TRAV27,TRAJ52,CAGVGGGTSYGKLTF,0,2,1,2
TRAV27,TRAJ33,CAGDGGLDSNYQLIW,0,2,1,2
TRAV27,TRAJ53,CAGETSGGSNYKLTF,0,2,1,2
TRAV13-2,TRAJ9,CAEIEPHTGGFKTIF,0,2,1,2
TRAV13-2,TRAJ6,CAETEASGGSYIPTF,0,2,1,2
TRAV13-2,TRAJ34,CAENIPPDNTDKLIF,0,2,1,2
TRAV13-2,TRAJ30,CAENIPMNRDDKFIF,0,2,1,2
TRAV12-3,TRAJ22,CAMGMRLGSARQLTF,0,2,1,2
TRAV12-3,TRAJ10,CAMSSGTGGGNKLTF,0,2,1,2
TRAV12-3,TRAJ39,CAMSVGGNAGNMLTF,0,2,1,2
TRAV4,TRAJ26,CLVVTGDNYGQNFVF,0,2,1,2
TRAV4,TRAJ9,CLVGDDDTGGFRTIF,0,2,1,2
TRAV4,TRAJ5,CLVGEGRTGRRALTF,0,2,1,2
TRAV8-1,TRAJ10,CAVDSVTGGGNKLTF,0,2,1,2
TRAV12-2,TRAJ42,CAAFYYGGSQGNLIF,0,2,1,2
TRAV26-1,TRAJ26,CIVRVKSGYGQNFVF,0,2,1,2
TRAV8-2,TRAJ40,CVVTEPSGTYKYIF,0,2,1,2
TRAV5,TRAJ33,CVLGGKDSNYQLIW,0,2,1,2
TRAV12-1,TRAJ45,CVVYSGGGADGLTF,0,2,1,2
TRAV12-1,TRAJ26,CVVTLDNYGQNFVF,0,2,1,2
TRAV10,TRAJ39,CVVSANNAGNMLTF,0,2,1,2
TRAV12-1,TRAJ39,CVVRSNNAGNMLTF,0,2,1,2
TRAV12-1,TRAJ8,CVGEMNTGFQKLVF,0,2,1,2
TRAV38-1,TRAJ44,CAFMNPGTASKLTF,0,2,1,2
TRAV38-2DV8,TRAJ17,CAYRIQAAGNKLTF,0,2,1,2
TRAV38-2DV8,TRAJ27,CAYRSSGDAGKSTF,0,2,1,2
TRAV38-2DV8,TRAJ57,CAYRRGGGSEKLVF,0,2,1,2
TRAV6,TRAJ35,CALGALGFGNVLHC,0,2,1,2
TRAV9-2,TRAJ18,CALGGGSTLGRLYF,0,2,1,2
TRAV19,TRAJ22,CALTGPGSARQLTF,0,2,1,2
TRAV9-2,TRAJ53,CALTSGGSNYKLTF,0,2,1,2
TRAV9-2,TRAJ56,CALSGPGANSKLTF,0,2,1,2
TRAV19,TRAJ54,CALSEAWGAQKLVF,0,2,1,2
TRAV19,TRAJ52,CALRGGTSYGKLTF,0,2,1,2
TRAV9-2,TRAJ53,CALNSGGSNYKLTF,0,2,1,2
TRAV16,TRAJ6,CALSTTGGSYIPTF,0,2,1,2
TRAV16,TRAJ24,CALKGTDSWGKFQF,0,2,1,2
TRAV9-2,TRAJ17,CAQSDQAAGNKLTF,0,2,1,2
TRAV12-2,TRAJ57,CAVPSQGGSEKLVF,0,2,1,2
TRAV20,TRAJ4,CAVRLSGGYNKLIF,0,2,1,2
TRAV23DV6,TRAJ30,CAVHPMNRDDKIIF,0,2,1,2
TRAV20,TRAJ49,CAVQAFSTGNQFYF,0,2,1,2
TRAV20,TRAJ3,CAVQADSSASKIFF,0,2,1,2
TRAV20,TRAJ6,CAVQAAGGSYIPTF,0,2,1,2
TRAV20,TRAJ45,CAVQARGGADGLTF,0,2,1,2
TRAV8-3,TRAJ9,CAVVRNTGGFKTIF,0,2,1,2
TRAV22,TRAJ8,CAVVTNTGFQKLVF,0,2,1,2
TRAV8-3,TRAJ10,CAVAVTGGGNKLTF,0,2,1,2
TRAV29DV5,TRAJ42,CAVGIGGSQGNLIF,0,2,1,2
TRAV12-2,TRAJ17,CAVGIKAAGNKLTF,0,2,1,2
TRAV22,TRAJ45,CAVDPGGGADGLTF,0,2,1,2
TRAV8-6,TRAJ3,CAVTPYSSASKIIF,0,2,1,2
TRAV8-6,TRAJ31,CAVSDGDNNARLMF,0,2,1,2
TRAV21,TRAJ34,CAVRPTYNTDKLIF,0,2,1,2
TRAV21,TRAJ20,CAVRPGSNDYKLSF,0,2,1,2
TRAV3,TRAJ5,CAVRPDTGRRALTF,0,2,1,2
TRAV3,TRAJ20,CAVRDRSNDYKLSF,0,2,1,2
TRAV3,TRAJ34,CAVRDAGRTDKLIL,0,2,1,2
TRAV3,TRAJ40,CAVRDDAGTYKYIF,0,2,1,2
TRAV22,TRAJ17,CAVNPKAAGNKLTF,0,2,1,2
TRAV3,TRAJ23,CAVNHNNQGGKLIF,0,2,1,2
TRAV8-3,TRAJ26,CAATLTLYGQNFVF,0,2,1,2
TRAV17,TRAJ12,CATPRGDSSYKLIF,0,2,1,2
TRAV17,TRAJ18,CATDGGSTLGRLYF,0,2,1,2
TRAV24,TRAJ3,CAFNEGSSASKIIF,0,2,1,2
TRAV12-2,TRAJ13,CAVSLSGGYQKVTF,0,2,1,2
TRAV12-2,TRAJ6,CAVLLSGGSYIPTF,0,2,1,2
TRAV12-2,TRAJ43,CAVGGRYNNNDMRF,0,2,1,2
TRAV8-1,TRAJ22,CAVTTSGSARQLTF,0,2,1,2
TRAV12-2,TRAJ56,CAVNLRGANSKLTF,0,2,1,2
TRAV12-2,TRAJ3,CAVNGYSSASKIIF,0,2,1,2
TRAV12-2,TRAJ48,CAVNEAGGNEKLTF,0,2,1,2
TRAV27,TRAJ45,CAFPGGGGADGLTF,0,2,1,2
TRAV12-3,TRAJ17,CASEPKAAGNKLTF,0,2,1,2
TRAV29DV5,TRAJ22,CAAITSGSARQLIF,0,2,1,2
TRAV13-1,TRAJ53,CAAISGGSNYKLTS,0,2,1,2
TRAV13-1,TRAJ26,CAATSDNYGQNFVF,0,2,1,2
TRAV29DV5,TRAJ46,CAASRGSSGDKLTF,0,2,1,2
TRAV29DV5,TRAJ57,CAASAPGGSEKLVF,0,2,1,2
TRAV29DV5,TRAJ50,CAASAETSYDKVIF,0,2,1,2
TRAV29DV5,TRAJ28,CAASARAGSYQLTF,0,2,1,2
TRAV23DV6,TRAJ44,CAARGTGTASKLTF,0,2,1,2
TRAV29DV5,TRAJ17,CAAKIKAAGNKLTF,0,2,1,2
TRAV13-1,TRAJ37,CAAKGSSNTGKLIF,0,2,1,2
TRAV25,TRAJ52,CAGPAGTTYGKLTF,0,2,1,2
TRAV12-3,TRAJ48,CAMGSGIGNEKLTF,0,2,1,2
TRAV12-3,TRAJ13,CAMTSSGGYQKVTF,0,2,1,2
TRAV12-3,TRAJ20,CAMSSGSNDYKLSF,0,2,1,2
TRAV12-3,TRAJ15,CAMSPGQAGTALIF,0,2,1,2
TRAV12-3,TRAJ53,CAMSAGGSNYKLTF,0,2,1,2
TRAV12-3,TRAJ9,CAMSADTGGFKTIF,0,2,1,2
TRAV12-3,TRAJ5,CAMSANTGRRALTF,0,2,1,2
TRAV12-3,TRAJ6,CAMSGAGGNYIPTF,0,2,1,2
TRAV12-3,TRAJ16,CAMSGSSDGQKLLF,0,2,1,2
TRAV12-3,TRAJ13,CAMSESGGYQKVTF,0,2,1,2
TRAV12-3,TRAJ27,CAMSEIGNAGKSTF,0,2,1,2
TRAV12-3,TRAJ38,CAMRYAGNNRKLIW,0,2,1,2
TRAV4,TRAJ34,CLVGDIGETDKLIF,0,2,1,2
TRAV5,TRAJ26,CAVNPPSFGQNFVF,0,2,1,2
TRAV26-1,TRAJ43,CIVRVLYNNNDMRF,0,2,1,2
TRAV26-1,TRAJ17,CIVRVEAAGNKLTF,0,2,1,2
TRAV12-3,TRAJ13,APMGNSGGYQKVTF,0,2,1,2
TRAV22,TRAJ52,SAVPGGTSYGKLTF,0,2,1,2
TRAV8-1,TRAJ37,SSPFSGNTGKLIF,0,2,1,2
TRAV8-1,TRAJ37,CPVFPSNTGKLIF,0,2,1,2
TRAV8-2,TRAJ9,CVVSRGGGFKTIF,0,2,1,2
TRAV8-2,TRAJ40,CVVTGLRTYKYIF,0,2,1,2
TRAV8-2,TRAJ48,CVVSEFGNEKLTF,0,2,1,2
TRAV12-1,TRAJ32,CVPTGGATNKLIF,0,2,1,2
TRAV12-1,TRAJ9,CVVFLGGGFKTIF,0,2,1,2
TRAV12-1,TRAJ32,CVVNGGATNKLIF,0,2,1,2
TRAV12-1,TRAJ17,CVVNYGAGNKLTF,0,2,1,2
TRAV12-1,TRAJ40,CVVNGPGTYKYIF,0,2,1,2
TRAV20,TRAJ24,CAFSTDSWGKFQF,0,2,1,2
TRAV38-1,TRAJ34,CAFMITNTDKLIF,0,2,1,2
TRAV41,TRAJ57,CAFTQGGSEKLVF,0,2,1,2
TRAV2,TRAJ5,CALFDTGRRALTF,0,2,1,2
TRAV22,TRAJ26,CASRDNYGQYFVF,0,2,1,2
TRAV38-1,TRAJ43,CASVLNNNNDMRF,0,2,1,2
TRAV38-2DV8,TRAJ33,CAYFPDSNYQLIW,0,2,1,2
TRAV38-2DV8,TRAJ43,CAYRGPSNNDMRF,0,2,1,2
TRAV9-2,TRAJ48,CALSNFGNEKLTF,0,2,1,2
TRAV16,TRAJ39,CALLPGAGNMLTF,0,2,1,2
TRAV29DV5,TRAJ39,CALLNNAGNMLTF,0,2,1,2
TRAV9-2,TRAJ15,CALFFEAGTALIF,0,2,1,2
TRAV9-2,TRAJ3,CALTDSSASKIIF,0,2,1,2
TRAV9-2,TRAJ34,CALSGYNTDKLIF,0,2,1,2
TRAV9-2,TRAJ30,CALSMNRDDKIIF,0,2,1,2
TRAV16,TRAJ13,CALKGGGYQKVTF,0,2,1,2
TRAV12-2,TRAJ39,CAPKGNAGNMLTL,0,2,1,2
TRAV2,TRAJ24,CAVPTDSWGKFQF,0,2,1,2
TRAV2,TRAJ6,CAVGSGGSYIPTF,0,2,1,2
TRAV8-4,TRAJ29,CAVTLSGNTPLVF,0,2,1,2
TRAV41,TRAJ41,CAVSPNSGCALNF,0,2,1,2
TRAV20,TRAJ39,CAVRNNAGNMLTF,0,2,1,2
TRAV20,TRAJ29,CAVQAATDTPLVF,0,2,1,2
TRAV20,TRAJ40,CAVQASGTYKYIF,0,2,1,2
TRAV20,TRAJ36,CAVQGSGANNLFF,0,2,1,2
TRAV8-3,TRAJ29,CAVGASGNTPLVF,0,2,1,2
TRAV8-3,TRAJ34,CAVGNSNTDKLIF,0,2,1,2
TRAV2,TRAJ21,CAVGVNNFNKFYF,0,2,1,2
TRAV2,TRAJ33,CAVEDRSNYQLIW,0,2,1,2
TRAV8-6,TRAJ52,CAVTGGSYGKLTF,0,2,1,2
TRAV8-4,TRAJ40,CAVTPSGTYKYIF,0,2,1,2
TRAV8-4,TRAJ7,CAVSAGGNNRLAF,0,2,1,2
TRAV8-6,TRAJ21,CAVSEGNFNKFYF,0,2,1,2
TRAV12-2,TRAJ22,CAVSMGSARQLTF,0,2,1,2
TRAV3,TRAJ22,CAVRLGSARQLTF,0,2,1,2
TRAV3,TRAJ27,CAVRSFNAGKSTF,0,2,1,2
TRAV12-2,TRAJ26,CAVRGNYGQNFVF,0,2,1,2
TRAV1-2,TRAJ30,CAVRGGRDVKIIF,0,2,1,2
TRAV36DV7,TRAJ48,CAVSNFGNEKLTF,0,2,1,2
TRAV12-2,TRAJ22,CAATSGSARQLTF,0,2,1,2
TRAV2,TRAJ3,CAATYSSASKIIF,0,2,1,2
TRAV3,TRAJ6,CAAPGGGSYIPTF,0,2,1,2
TRAV8-6,TRAJ27,CAAKNTNAGKSTF,0,2,1,2
TRAV12-2,TRAJ10,CAADTGGGDKLTF,0,2,1,2
TRAV35,TRAJ40,CAGLTSGTYKYIF,0,2,1,2
TRAV35,TRAJ23,CAGRRNQGGKLIF,0,2,1,2
TRAV35,TRAJ44,CAGQAGTASKLTF,0,2,1,2
TRAV21,TRAJ57,CAGAQGGSEKLVF,0,2,1,2
TRAV17,TRAJ40,CATYTSGTYKYIF,0,2,1,2
TRAV17,TRAJ29,CATARPGNTPLVF,0,2,1,2
TRAV17,TRAJ49,CATDEDTGNQFYF,0,2,1,2
TRAV17,TRAJ57,CATDTGGSEKLVF,0,2,1,2
TRAV8-3,TRAJ42,CASRRGSQGNLIF,0,2,1,2
TRAV12-2,TRAJ16,CAPRYSDGQKLLF,0,2,1,2
TRAV8-1,TRAJ34,CAVLLYNTDKLIF,0,2,1,2
TRAV39,TRAJ43,CAVVEGGNNDMRF,0,2,1,2
TRAV8-1,TRAJ4,CAVGAGGYNKLIF,0,2,1,2
TRAV12-2,TRAJ37,CAVSPGNTGKLIF,0,2,1,2
TRAV8-1,TRAJ43,CAVNADWSNDMRF,0,2,1,2
TRAV8-1,TRAJ41,CAVNSNSGYALNF,0,2,1,2
TRAV12-2,TRAJ58,CAVNLDSGSRLTF,0,2,1,2
TRAV12-2,TRAJ57,CAAGQGGSEKLVF,0,2,1,2
TRAV12-2,TRAJ15,CAGANQAGTTLIF,0,2,1,2
TRAV13-1,TRAJ39,CAASNNAGNMLTF,0,2,1,2
TRAV25,TRAJ49,CAVITNTGNQFYF,0,2,1,2
TRAV5,TRAJ21,CAAPGYNFNKFYF,0,2,1,2
TRAV29DV5,TRAJ20,CAAIGSNDYKLSF,0,2,1,2
TRAV13-1,TRAJ20,CAATLFYDYKLSF,0,2,1,2
TRAV23DV6,TRAJ35,CAASRGFGNVLHC,0,2,1,2
TRAV13-1,TRAJ3,CAASGSSASKIIF,0,2,1,2
TRAV13-1,TRAJ11,CAASIPGYSTLTF,0,2,1,2
TRAV29DV5,TRAJ47,CAASALIGNKLVF,0,2,1,2
TRAV13-1,TRAJ4,CAARPGGYNKLIF,0,2,1,2
TRAV23DV6,TRAJ9,CAAKIGGGFKTIF,0,2,1,2
TRAV27,TRAJ6,CAGISGGSYIPTF,0,2,1,2
TRAV27,TRAJ17,CAGGWAADNKLTF,0,2,1,2
TRAV5,TRAJ8,CADLNTGFQKLVF,0,2,1,2
TRAV13-2,TRAJ20,CAEASRSDYKLSF,0,2,1,2
TRAV13-2,TRAJ24,CAENTDSWGKFQF,0,2,1,2
TRAV13-2,TRAJ37,CAENTGNTGKLIF,0,2,1,2
TRAV13-2,TRAJ12,CAEKGDSSYKLIF,0,2,1,2
TRAV13-2,TRAJ53,CAEKSGSNYKLTF,0,2,1,2
TRAV12-3,TRAJ20,CAMSTSNDYKLSF,0,2,1,2
TRAV12-3,TRAJ58,CAMEETSGSRLTF,0,2,1,2
TRAV14DV4,TRAJ9,CAMSYTGGFKTIF,0,2,1,2
TRAV12-3,TRAJ22,CAMSGISARQLTF,0,2,1,2
TRAV4,TRAJ34,CLVGPSYTDKLIF,0,2,1,2
TRAV30,TRAJ39,CGTGVNAGNMLTF,0,2,1,2
TRAV26-1,TRAJ40,CIVKKSGTYKYIS,0,2,1,2
TRAV26-1,TRAJ20,CIVRDSNDYKLSF,0,2,1,2
TRAV29DV5,TRAJ53,RAAGGGSNYKLTF,0,2,1,2
TRAV3,TRAJ30,SAVRDPRDDKIIF,0,2,1,2
TRAV20,TRAJ12,CVLMDSSYKLIF,0,2,1,2
TRAV12-1,TRAJ21,CVVGYNFNKFYF,0,2,1,2
TRAV12-1,TRAJ31,CVVNNFNARLMF,0,2,1,2
TRAV12-1,TRAJ37,CVVNMVVGKLIF,0,2,1,2
TRAV38-1,TRAJ29,CAFIVGNTPLVF,0,2,1,2
TRAV38-2DV8,TRAJ43,CAYRSFVHDMRF,0,2,1,2
TRAV38-2DV8,TRAJ23,CALYNQGGKLIF,0,2,1,2
TRAV9-2,TRAJ20,CALRSNDYKLSF,0,2,1,2
TRAV6,TRAJ38,CALVPVNRKLIW,0,2,1,2
TRAV6,TRAJ3,CALGGSASKIIF,0,2,1,2
TRAV17,TRAJ40,CAPTSGTYKYIF,0,2,1,2
TRAV6,TRAJ26,CAPDNYGQNFVF,0,2,1,2
TRAV12-2,TRAJ6,CAQAGGSYIPTF,0,2,1,2
TRAV41,TRAJ49,CAVEQGSNQFYF,0,2,1,2
TRAV41,TRAJ49,CAVRSTGNQFYS,0,2,1,2
TRAV8-6,TRAJ7,CAVWYGNNRLAF,0,2,1,2
TRAV23DV6,TRAJ5,CAVGTGRRALTF,0,2,1,2
TRAV36DV7,TRAJ31,CAVGNNNARLMF,0,2,1,2
TRAV21,TRAJ45,CAVGGGADGLTF,0,2,1,2
TRAV2,TRAJ26,CAVEDKGQNFVL,0,2,1,2
TRAV2,TRAJ31,CAVEESNARLMS,0,2,1,2
TRAV22,TRAJ34,CAVEDNTDKLIF,0,2,1,2
TRAV22,TRAJ9,CAVITGGFKTIF,0,2,1,2
TRAV8-4,TRAJ20,CAVSHNDYKLSF,0,2,1,2
TRAV21,TRAJ20,CAVRQHDYKLSF,0,2,1,2
TRAV3,TRAJ26,CAVRVAGQNFVF,0,2,1,2
TRAV8-3,TRAJ34,CAVRAEGDKPIF,0,2,1,2
TRAV8-6,TRAJ5,CAVKSGRRALTF,0,2,1,2
TRAV21,TRAJ37,CAVKSNTGKLIF,0,2,1,2
TRAV17,TRAJ20,CATSRSDYKLSF,0,2,1,2
TRAV17,TRAJ31,CATVLGHARLMF,0,2,1,2
TRAV17,TRAJ40,CATVSGTYKYIF,0,2,1,2
TRAV23DV6,TRAJ37,CARSGNTGKLIF,0,2,1,2
TRAV12-2,TRAJ20,CAVTPNDYKLGF,0,2,1,2
TRAV8-1,TRAJ9,CAVNTGGFKTIF,0,2,1,2
TRAV8-6,TRAJ15,CAAQQAGTALIF,0,2,1,2
TRAV8-6,TRAJ12,CATMDSSYKLIF,0,2,1,2
TRAV13-1,TRAJ23,CAPRSEGGKLIL,0,2,1,2
TRAV13-1,TRAJ49,CAAPNTGNQFYF,0,2,1,2
TRAV13-1,TRAJ6,CAAPGGSYIPTF,0,2,1,2
TRAV23DV6,TRAJ49,CAATPNPNQFYF,0,2,1,2
TRAV13-1,TRAJ8,CAATPGFQKLVF,0,2,1,2
TRAV13-1,TRAJ22,CAATGSARQLTF,0,2,1,2
TRAV13-1,TRAJ20,CAASMKDYKLSF,0,2,1,2
TRAV29DV5,TRAJ29,CAASAGNTPLVF,0,2,1,2
TRAV25,TRAJ30,CAGLSRDDKIIF,0,2,1,2
TRAV13-2,TRAJ20,CAEKKYDYKLSF,0,2,1,2
TRAV9-2,TRAJ20,CTLNPNDYKLSF,0,2,1,2
TRAV35,TRAJ28,CFSGAGSYQLTF,0,2,1,2
TRAV4,TRAJ27,CLVSTNAGKSTF,0,2,1,2
TRAV26-2,TRAJ49,CILRDRVGQFYF,0,2,1,2
TRAV26-1,TRAJ34,CIVSSNTDKLIF,0,2,1,2
TRAV12-2,TRAJ42,CALGSQGNLIF,0,2,1,2
TRAV22,TRAJ20,CAVPGDYKLSF,0,2,1,2
TRAV20,TRAJ30,CAVQAGDKIIF,0,2,1,2
TRAV2,TRAJ43,CAVDVGPNMRF,0,2,1,2
TRAV12-2,TRAJ21,CAVDNFNKFYF,0,2,1,2
TRAV24,TRAJ54,CAFEGAQKLVF,0,2,1,2
TRAV17,TRAJ26,CALNYGQNFVF,0,2,1,2
TRAV12-2,TRAJ48,CAVSGNEKLTF,0,2,1,2
TRAV12-2,TRAJ31,CAVNDNARLMF,0,2,1,2
TRAV12-2,TRAJ31,CAVNNNARLMF,0,2,1,2
TRAV17,TRAJ39,CAGDAGNMLTF,0,2,1,2
TRAV12-3,TRAJ34,CASYKTDKLIF,0,2,1,2
TRAV13-1,TRAJ49,CAASIGNQFYF,0,2,1,2
TRAV29DV5,TRAJ43,CAASGAYDMRF,0,2,1,2
TRAV25,TRAJ49,CAGNTGNQFYF,0,2,1,2
TRAV13-2,TRAJ16,CAERRGQKLLF,0,2,1,2
TRAV36DV7,TRAJ32,CLGGATNKLIF,0,2,1,2
TRAV27,TRAJ45,CRGGGADGLTF,0,2,1,2
TRAV41,TRAJ43,CAASTDDMRF,0,2,1,2
TRAV12-2,TRAJ23,CAVLGGKLIF,0,2,1,2
TRAV13-1,TRAJ18,CAAPLGRLYF,0,2,1,2
TRAV25,TRAJ27,CAGGAGKSTF,0,2,1,2
TRAV13-2,TRAJ34,CAEATDKLIY,0,2,1,2
TRAV12-2,TRAJ42,CAVGGNLIF,0,2,1,2
TRAV25,TRAJ29,CARDTPLVF,0,2,1,2
TRAV13-1,TRAJ43,CAALDDMRF,0,2,1,2
TRAV41,TRAJ49,CAPPF,0,2,1,2
TRAV19,TRAJ28,CALRLYSGAGSYQLTF,0,2,1,2
TRAV26-2,TRAJ28,CILSSRGAGSYQLTF,0,2,1,2
TRAV3,TRAJ35,CAVGDKGFGYVLHC,0,2,1,2
TRAV3,TRAJ13,CAVRPPGGYHKVTF,0,2,1,2
TRAV4,TRAJ34,CLVGGPDNTDKLIF,0,2,1,2
