v_hit,j_hit,cdr3,S4-10ng_S9,S4-10ng_S21,freq,count_sum
TRBV19,TRBJ2-1,CASSVTSGDYNEQFF,206,175,2,381
TRBV18,TRBJ2-3,CASSPQGRAYTDTQYF,161,182,2,343
TRBV28,TRBJ2-7,CASKGRVEEQYF,123,147,2,270
TRBV5-1,TRBJ2-7,CASSLVWGPQYF,62,86,2,148
TRBV20-1,TRBJ2-4,CSARMPPGFSALAKNIQYF,57,78,2,135
TRBV2,TRBJ2-5,CASSDLASGNLRETQYF,48,80,2,128
TRBV19,TRBJ2-1,CASSRVPTNEQFF,22,27,2,49
TRBV19,TRBJ2-1,CASRKAGLYNEQFF,16,28,2,44
TRBV6-2/3/5/6,TRBJ2-3,CASISGSTDTQYF,23,21,2,44
TRBV19,TRBJ1-5,CASRIHPTGVDQPQHF,15,19,2,34
TRBV14,TRBJ2-7,CASSPANYEQYF,17,13,2,30
TRBV2,TRBJ1-4,CASSPMTALNEKLFF,11,17,2,28
TRBV19,TRBJ2-2,CASKPPSLTGELFF,9,17,2,26
TRBV19,TRBJ1-1,CASRTGSGTEAFF,12,14,2,26
TRBV3-1,TRBJ2-1,CASSPGRQQIDEQFF,8,4,2,12
TRBV19,TRBJ2-1,CASSMTSGSFDEQFF,11,15,2,26
TRBV19,TRBJ2-1,CASSVGRGEQFF,9,4,2,13
TRBV20-1,TRBJ2-7,CSARGLAAYYLEQYF,6,7,2,13
TRBV19,TRBJ2-3,CASEGDTQYF,5,6,2,11
TRBV28,TRBJ1-5,CASILSQARDQPQHF,9,6,2,15
TRBV29-1,TRBJ2-7,CSVEKGHDRGREEQYF,1,0,1,1
TRBV5-6,TRBJ2-1,CASSLIVNEQFF,1,0,1,1
TRBV19,TRBJ1-5,CASWRQGNQPQHF,4,3,2,7
TRBV14,TRBJ2-1,CASSQSPGGEQFF,7,6,2,13
TRBV27,TRBJ1-1,CASRIVGRGREAFF,8,12,2,20
TRBV12-5,TRBJ2-2,CASALRAGPNTGELFF,3,3,2,6
TRBV19,TRBJ2-1,CASSIGGHNEQFF,8,14,2,22
TRBV14,TRBJ1-2,CASSQGLNYGYTF,2,6,2,8
TRBV2,TRBJ2-7,CASSEGTSGIYEQYF,2,0,1,2
TRBV5-1,TRBJ2-2,CASSQRPPTGMGAGELFF,7,12,2,19
TRBV11-3,TRBJ2-1,CASSAYGSYNEQFF,1,1,2,2
TRBV5-1,TRBJ2-7,CASGQGLFSYEQYF,6,7,2,13
TRBV29-1,TRBJ1-2,CSVEEPGAGRGYTF,2,3,2,5
TRBV5-1,TRBJ2-1,CASSSQGSGYNEQFF,3,5,2,8
TRBV19,TRBJ2-7,CASSMASGAYEQYF,4,8,2,12
TRBV20-1,TRBJ2-3,CSATRTGPDTDTQYF,2,0,1,2
TRBV29-1,TRBJ2-1,CSGGRSGEQFF,3,5,2,8
TRBV20-1,TRBJ2-3,CSARDSLTTDTQYF,1,0,1,1
TRBV29-1,TRBJ1-4,CSVGSGGTNEKLFF,5,5,2,10
TRBV2,TRBJ2-4,CASSEREGVAKNIQYF,6,3,2,9
TRBV19,TRBJ2-7,CASSLTSGSSEQYF,4,7,2,11
TRBV14,TRBJ2-6,CASSQRESGANVLTF,4,1,2,5
TRBV29-1,TRBJ2-4,CSVEDQTLPNGDIQYF,3,2,2,5
TRBV29-1,TRBJ2-1,CSALTGNEQFF,4,5,2,9
TRBV29-1,TRBJ2-7,CSASGGIDYEQYF,4,0,1,4
TRBV12-3/4,TRBJ2-7,CASSLGRELVGQYF,1,0,1,1
TRBV7-9,TRBJ2-7,CASSSYRVPSSYEQYF,3,3,2,6
TRBV3-1,TRBJ2-1,CASSQEAGDNEQFF,5,0,1,5
TRBV19,TRBJ2-3,CASEADTQYF,2,4,2,6
TRBV12-5,TRBJ1-2,CASGLVPSTLANYGYTF,1,0,1,1
TRBV19,TRBJ1-5,CASRPRGASAQHF,1,0,1,1
TRBV19,TRBJ1-5,CASSLGVGQPQHF,5,3,2,8
TRBV5-1,TRBJ1-1,CASSLRRPARTEAFF,4,8,2,12
TRBV19,TRBJ2-1,CASSIVPSGPSAEQFF,4,6,2,10
TRBV7-9,TRBJ2-1,CASSYAFRTGQSSDEQFF,6,6,2,12
TRBV6-4,TRBJ1-4,CASSDSGTPTNEKLFF,1,0,1,1
TRBV19,TRBJ2-1,CASSNPGLAGGPSEQFF,1,0,1,1
TRBV19,TRBJ2-1,CASSPGTSGREDEQFF,1,0,1,1
TRBV2,TRBJ2-4,CASTPPGSGSDIQYF,5,4,2,9
TRBV5-6,TRBJ2-1,CASSSRDGTLRNEQFF,1,0,1,1
TRBV24-1,TRBJ2-1,CATTGVPYYYNEQFF,5,8,2,13
TRBV5-6,TRBJ2-7,CASSLESRPSDEQYF,2,0,1,2
TRBV29-1,TRBJ2-3,CSVERLAGDTDMQYF,2,0,1,2
TRBV28,TRBJ2-7,CASSFVSGTDEQYF,3,0,1,3
TRBV19,TRBJ1-1,CASSIGMGTGGVNTEAFF,2,0,1,2
TRBV5-1,TRBJ2-1,CASSSRSGGYNEQFF,1,0,1,1
TRBV20-1,TRBJ1-5,CSASGSPNQPQHF,5,12,2,17
TRBV29-1,TRBJ1-3,CSFRPDSGNTIYF,1,0,1,1
TRBV27,TRBJ1-2,CASSLGDYTF,3,6,2,9
TRBV10-2,TRBJ2-5,CASSSGLPLETQYF,1,0,1,1
TRBV3-1,TRBJ2-1,CASSLGLAGLEFF,1,0,1,1
TRBV7-9,TRBJ2-5,CASSPRAEETQYF,4,4,2,8
TRBV5-6,TRBJ1-3,CASSLIGVVGTLSGNTIYF,1,0,1,1
TRBV29-1,TRBJ2-7,CSARTTTIEQYF,3,5,2,8
TRBV29-1,TRBJ2-3,CSADQETSTDTQYF,3,2,2,5
TRBV2,TRBJ2-5,CASSERVAGGRETQYF,2,0,1,2
TRBV7-2,TRBJ2-3,CASSWTSLSTDTQYF,1,0,1,1
TRBV14,TRBJ1-1,CASSSQGALLPEAFF,3,3,2,6
TRBV20-1,TRBJ1-1,CSARGPRENTEAFF,1,0,1,1
TRBV20-1,TRBJ2-3,CSAGPLTSTDTQYF,4,2,2,6
TRBV20-1,TRBJ2-3,CSASSGADTQYF,1,0,1,1
TRBV20-1,TRBJ2-2,CSARAVTGELFF,1,0,1,1
TRBV29-1,TRBJ2-1,CSAREVDEQFF,4,1,2,5
TRBV9,TRBJ2-7,CASSVGSGTAYEQYF,5,5,2,10
TRBV20-1,TRBJ2-7,CSARAALAGPGGM,5,8,2,13
TRBV20-1,TRBJ2-7,CSGAPPEEYEQYF,1,0,1,1
TRBV2,TRBJ1-2,CASRESVVRQGTYTF,1,0,1,1
TRBV5-6,TRBJ2-3,CASSPGASTDTQYF,5,3,2,8
TRBV5-4,TRBJ2-7,CASSSGGREQYF,1,0,1,1
TRBV6-2/3/5/6,TRBJ2-1,CASSYGGNEQFF,1,0,1,1
TRBV2,TRBJ2-2,CAIRGTANTGELFF,2,0,1,2
TRBV19,TRBJ2-2,CAGGTGTGELFF,2,2,2,4
TRBV7-9,TRBJ2-2,CASSLANRRGGPGTGELFF,5,7,2,12
TRBV7-9,TRBJ1-6,CASAGGFYNSPLHF,1,0,1,1
TRBV29-1,TRBJ2-1,CSVEVTSRKPVLYNEQFF,1,0,1,1
TRBV5-4,TRBJ1-2,CASSLAVGGAYGYTF,2,2,2,4
TRBV11-2,TRBJ2-3,CASSLAHTTTDTQYF,1,0,1,1
TRBV19,TRBJ2-1,CASSSGRTYNEQFF,1,0,1,1
TRBV6-4,TRBJ2-1,CASSDGTDGHEQFF,5,0,1,5
TRBV19,TRBJ2-4,CASSIGDGLRRYF,3,0,1,3
TRBV18,TRBJ2-1,CASSPLREGEQFF,2,1,2,3
TRBV6-2/3/5/6,TRBJ1-1,CASSSSYWNTEAFF,1,0,1,1
TRBV16,TRBJ1-2,CASSPRLRGTYNGYTF,3,2,2,5
TRBV11-2,TRBJ1-2,CASSFSTVYGYTF,1,0,1,1
TRBV5-4,TRBJ2-7,CATSLDGTAYEQYF,1,0,1,1
TRBV12-3/4,TRBJ1-5,CASSFRNQPQHF,3,0,1,3
TRBV5-1,TRBJ2-1,CASSIARPGSTNNEQFF,2,0,1,2
TRBV11-2,TRBJ2-3,CASSLEQGPSTDTQYF,1,0,1,1
TRBV12-3/4,TRBJ1-1,CASSSEAQGGTEAFF,1,0,1,1
TRBV5-5,TRBJ1-3,CASSLGGPSGNTIYF,1,0,1,1
TRBV5-1,TRBJ2-1,CASSLASGPYNEQFF,4,13,2,17
TRBV5-6,TRBJ2-5,CASSLASVGETQYF,2,0,1,2
TRBV12-3/4,TRBJ2-1,CASSVGQYNEQFF,2,3,2,5
TRBV7-9,TRBJ1-1,CASSLPGQREAFF,1,0,1,1
TRBV5-1,TRBJ2-2,CATRSGAGELFF,1,0,1,1
TRBV2,TRBJ1-6,CASLGQRRFHF,1,0,1,1
TRBV12-3/4,TRBJ2-7,CASSLEGLVHF,1,0,1,1
TRBV19,TRBJ2-4,CASEGDIQYF,3,0,1,3
TRBV7-9,TRBJ2-1,CASSLVGGRVDNEQFF,3,0,1,3
TRBV5-1,TRBJ2-3,CASSPDSTDTQYF,1,0,1,1
TRBV12-3/4,TRBJ2-3,CASSQRQVGAVTDTQYF,1,0,1,1
TRBV29-1,TRBJ2-3,CSVFNPGSRLTDTQYF,3,1,2,4
TRBV14,TRBJ2-1,CASSPGSHNEQFF,3,0,1,3
TRBV29-1,TRBJ1-1,CSVDDTGYNTEAFF,1,0,1,1
TRBV20-1,TRBJ2-7,CSARGTSGGKNEQYF,1,0,1,1
TRBV5-4,TRBJ2-2,CASSLPRGGRITGELFF,2,2,2,4
TRBV5-1,TRBJ2-3,CASSLSGQITTNTQYF,1,0,1,1
TRBV29-1,TRBJ2-1,CSVEKVGVSSYNEQFF,1,0,1,1
TRBV27,TRBJ2-7,CASRGPQGLGYEQYF,1,0,1,1
TRBV5-1,TRBJ1-1,CASSLPKEPNTEAFF,3,2,2,5
TRBV7-2,TRBJ1-5,CASTIGVNNQPQHF,1,0,1,1
TRBV5-8,TRBJ1-2,CASSLGQADYGYTF,1,0,1,1
TRBV29-1,TRBJ1-1,CSAKSTGSSRGAFF,2,2,2,4
TRBV29-1,TRBJ1-2,CSVYSQGYNGYTF,1,0,1,1
TRBV2,TRBJ1-1,CATRQELTEAFF,1,0,1,1
TRBV5-5,TRBJ2-7,CASSFSSGEQYF,1,0,1,1
TRBV2,TRBJ2-1,CARKREEEQFF,1,0,1,1
TRBV28,TRBJ2-5,CASTKAGTHLETQYF,1,0,1,1
TRBV20-1,TRBJ2-7,CSAFRRDSSLRVQYF,1,0,1,1
TRBV5-6,TRBJ2-7,CASSLGPSQAVTYEQYF,1,0,1,1
TRBV25-1,TRBJ2-5,CASSEGQGARETQYF,1,0,1,1
TRBV11-3,TRBJ2-3,CASSTSGSMTDTQYF,1,0,1,1
TRBV6-2/3/5/6,TRBJ2-2,CASSYRTGPTGELFF,1,0,1,1
TRBV6-2/3/5/6,TRBJ2-7,CASSFHRTSQREATYEQYF,2,0,1,2
TRBV12-3/4,TRBJ2-3,CASSVNWDPWFTDTQYF,1,0,1,1
TRBV9,TRBJ2-1,CASSVAGASSYNEQFF,1,0,1,1
TRBV20-1,TRBJ2-7,CSARDRGPSGSYEQYF,2,0,1,2
TRBV2,TRBJ1-6,CASSETGGYNSPLHF,1,0,1,1
TRBV6-2/3/5/6,TRBJ1-4,CASRLGQGFDEKLFF,1,0,1,1
TRBV5-1,TRBJ2-5,CASSLEAGRGETQYF,1,0,1,1
TRBV5-1,TRBJ2-1,CASSLTSDSYNEQFF,1,0,1,1
TRBV11-2,TRBJ2-1,CAPTGNTSYNEQFF,2,3,2,5
TRBV7-2,TRBJ2-3,CASSFTTSTDTQYF,2,0,1,2
TRBV7-9,TRBJ2-7,CASSSYPPGLSHFF,1,0,1,1
TRBV11-1,TRBJ2-3,CASSSPRGGDTQYF,1,0,1,1
TRBV11-1,TRBJ2-7,CASSANRGLYEQYF,1,0,1,1
TRBV5-1,TRBJ2-1,CASSFLASGYEQFF,1,0,1,1
TRBV10-3,TRBJ2-7,CATLETGSYEQYF,1,0,1,1
TRBV6-2/3/5/6,TRBJ2-7,CASSPGQGSQYYF,2,2,2,4
TRBV20-1,TRBJ2-3,CSALAGLTDTQYF,1,0,1,1
TRBV29-1,TRBJ2-5,CSVEGQGVETQYF,1,0,1,1
TRBV3-1,TRBJ2-3,CASSQEEDTQYF,1,0,1,1
TRBV28,TRBJ2-1,CASREARSEQFF,3,1,2,4
TRBV20-1,TRBJ2-3,CSARAPSGDISTDTQYF,1,0,1,1
TRBV11-1,TRBJ2-1,CASSDRQGGSYNEQFF,2,0,1,2
TRBV7-2,TRBJ2-3,CASSPMGFSTDTQYF,1,0,1,1
TRBV19,TRBJ2-1,CASSPSDWPNEQVF,1,0,1,1
TRBV10-3,TRBJ2-3,CAIKVTDTQYF,2,1,2,3
TRBV5-1,TRBJ2-1,CASSLGTGGNEQFF,1,1,2,2
TRBV29-1,TRBJ2-3,CSVDRPPGTDTQYF,2,0,1,2
TRBV7-2,TRBJ2-1,CASSLRTGDEQFF,1,0,1,1
TRBV5-1,TRBJ1-2,CASSFNYRQGYTF,1,0,1,1
TRBV25-1,TRBJ2-7,CASSEFLYEQYF,1,0,1,1
TRBV6-2/3/5/6,TRBJ2-5,CASSYPIETGGRRETQYF,1,0,1,1
TRBV29-1,TRBJ2-7,CSVVSRSGENRAPYEQYF,1,0,1,1
TRBV19,TRBJ2-4,CASSSTPGSGAKNIQYF,1,0,1,1
TRBV20-1,TRBJ2-3,CSASYPFTGRPSDTQYF,1,0,1,1
TRBV5-1,TRBJ2-1,CASSLTTGGSYNEQFF,1,0,1,1
TRBV20-1,TRBJ2-3,CSATIEGGRGTDTQYF,1,0,1,1
TRBV12-3/4,TRBJ1-2,CASSLGTGLSYGYTF,1,0,1,1
TRBV6-2/3/5/6,TRBJ1-4,CASSYGGATNEKLFF,1,0,1,1
TRBV6-4,TRBJ2-2,CASSEHGAHLGELFF,2,0,1,2
TRBV5-6,TRBJ1-5,CASSLGWDSNQPQHF,1,0,1,1
TRBV5-1,TRBJ1-5,CASSLGTSSNQPQHF,1,0,1,1
TRBV5-1,TRBJ1-5,CASSPEGGSNQPQHF,1,0,1,1
TRBV29-1,TRBJ2-1,CSVEMTSGGYNEQFF,1,2,2,3
TRBV10-3,TRBJ2-5,CAISESGQGVTQYF,1,0,1,1
TRBV19,TRBJ2-3,CASTEREVTDTQYF,3,1,2,4
TRBV19,TRBJ1-5,CASSSRQGNQPQHF,1,0,1,1
TRBV12-3/4,TRBJ1-1,CASSLQYMNTEAFF,1,1,2,2
TRBV19,TRBJ1-1,CAAQAGTGVSEAFF,1,0,1,1
TRBV5-1,TRBJ2-1,CASCPFGGINEQFF,2,0,1,2
TRBV5-1,TRBJ2-7,CASSLGPETYEQYF,2,0,1,2
TRBV20-1,TRBJ2-7,CSASLAGGPDEQYF,1,0,1,1
TRBV29-1,TRBJ1-1,CSVDRGSMNTEAFF,1,0,1,1
TRBV19,TRBJ2-7,CASSAGQLYEQYF,1,1,2,2
TRBV19,TRBJ2-3,CASSVSGADTQYF,2,0,1,2
TRBV9,TRBJ2-7,CASSRDRGYEQYF,2,0,1,2
TRBV3-1,TRBJ2-1,CASSLLGGDEQFF,2,0,1,2
TRBV7-6,TRBJ2-3,CASSEGGVYTQYF,1,0,1,1
TRBV29-1,TRBJ2-7,CSVERQGVGEQYF,1,1,2,2
TRBV29-1,TRBJ2-1,CSVGSGVTREQFF,3,0,1,3
TRBV29-1,TRBJ2-1,CSALASENNEQFF,1,0,1,1
TRBV3-1,TRBJ1-1,CASSQPDSEAFF,1,0,1,1
TRBV4-2,TRBJ1-1,CASSLQHTEAFF,1,0,1,1
TRBV7-8,TRBJ2-5,CASSPQETQYF,1,0,1,1
TRBV6-2/3/5/6,TRBJ2-3,CASRTTGPQYF,5,3,2,8
TRBV20-1,TRBJ2-7,CSATRGTNSYEQYF,2,0,1,2
TRBV6-2/3/5/6,TRBJ2-5,CASSFRGLETQYF,1,0,1,1
TRBV7-2,TRBJ2-7,CASSLGTGGYEQYF,1,0,1,1
TRBV12-3/4,TRBJ2-1,CASSPTTEHNEQFF,2,1,2,3
TRBV11-2,TRBJ2-7,CASSPAREQYF,1,0,1,1
TRBV7-2,TRBJ2-3,CASSSGLVRDTQYF,2,1,2,3
TRBV12-3/4,TRBJ2-1,CASSKGGTSGTFYNEQFF,1,0,1,1
TRBV2,TRBJ2-1,CASSLSVTSGNYNERFF,1,0,1,1
TRBV20-1,TRBJ2-3,CSAASGDTDTQYF,1,0,1,1
TRBV19,TRBJ2-1,CASHYSKTGVPYNEQFF,1,0,1,1
TRBV5-4,TRBJ2-6,CASSPRGSPSGANVLTF,1,0,1,1
TRBV7-2,TRBJ2-5,CASSSGLAGQETQYF,1,0,1,1
TRBV20-1,TRBJ1-1,CSARVFKGDNTEAFF,2,0,1,2
TRBV20-1,TRBJ2-7,CSAGALGGSYEQYF,1,0,1,1
TRBV5-6,TRBJ2-7,CASSFPSSYEQYF,2,0,1,2
TRBV18,TRBJ1-1,CASSPPNTGTENTEAFF,2,0,1,2
TRBV27,TRBJ2-7,CASSLKVWGRTGYEQYF,3,3,2,6
TRBV7-2,TRBJ2-1,CASSSQLGGSDYNEQFF,1,0,1,1
TRBV3-1,TRBJ1-4,CASSQDRQPATNEKLFF,1,0,1,1
TRBV5-6,TRBJ1-2,CASSLPPGTDRYGYTF,1,0,1,1
TRBV7-9,TRBJ2-1,CASSLRTGAGYNEQFF,1,0,1,1
TRBV7-2,TRBJ2-7,CASSSGGTSRSYEQYF,1,0,1,1
TRBV12-3/4,TRBJ2-1,CASSLRQGTFYNEQFF,2,0,1,2
TRBV3-1,TRBJ2-1,CASSPGGSRSYNEQFF,2,0,1,2
TRBV19,TRBJ2-6,CASSLWSPEANVLTF,1,0,1,1
TRBV18,TRBJ2-3,CASSLLAESTDTQYF,1,0,1,1
TRBV14,TRBJ2-7,CASCQERGVSYEQYF,1,0,1,1
TRBV7-9,TRBJ2-1,CASSQGLAIYNEQFF,1,0,1,1
TRBV6-4,TRBJ1-6,CASSTEGQGLSPLHF,1,0,1,1
TRBV20-1,TRBJ2-1,CSARLLADTYNEQFF,1,0,1,1
TRBV29-1,TRBJ2-1,CSVEDTASSTNEQFF,2,1,2,3
TRBV18,TRBJ2-5,CASSPPGLQETQYF,1,0,1,1
TRBV6-2/3/5/6,TRBJ1-5,CASSLRESNQPQHF,1,0,1,1
TRBV13,TRBJ2-7,CASSPGQGATEQYF,3,0,1,3
TRBV2,TRBJ2-7,CASSEFQGGYEQYF,1,0,1,1
TRBV5-5,TRBJ2-1,CASSLGQGAGEQFF,1,0,1,1
TRBV3-1,TRBJ2-7,CASSRSDYQYEQYF,2,0,1,2
TRBV10-3,TRBJ2-7,CAINLGVAYEQYF,1,0,1,1
TRBV2,TRBJ1-1,CASILDWNTEAFF,1,0,1,1
TRBV12-3/4,TRBJ1-2,CASSPDRVRGYTF,2,0,1,2
TRBV2,TRBJ1-2,CASSDARVGGYTF,1,0,1,1
TRBV28,TRBJ2-3,CASNTGSTDTQYF,2,0,1,2
TRBV29-1,TRBJ1-2,CSVLLGQSNGYAF,1,0,1,1
TRBV29-1,TRBJ2-1,CSVGEGRHQGRFF,3,0,1,3
TRBV19,TRBJ1-1,CASSISSAEAFF,2,3,2,5
TRBV18,TRBJ2-1,CASSQEGNEQFF,2,0,1,2
TRBV6-2/3/5/6,TRBJ2-7,CASSSARYEQYF,2,0,1,2
TRBV28,TRBJ2-2,CASSSGTAELFF,1,0,1,1
TRBV5-6,TRBJ2-1,CASSFLASGQFF,1,1,2,2
TRBV29-1,TRBJ2-5,CSVADNQETQYF,1,0,1,1
TRBV10-3,TRBJ2-1,CAISSSAEQFF,1,0,1,1
TRBV3-1,TRBJ2-1,CASGSHGEQFF,2,0,1,2
TRBV5-1,TRBJ1-3,CASSLKRNQVEDAGNTIYF,1,0,1,1
TRBV20-1,TRBJ2-4,CSARDKLAGLAKNIQYF,1,0,1,1
TRBV19,TRBJ1-5,CASLESHTYSNQPQHF,1,0,1,1
TRBV5-1,TRBJ2-7,CASSLDSLSYEQYF,1,0,1,1
TRBV20-1,TRBJ2-1,CSARTIYRDRDFNEQFF,1,0,1,1
TRBV7-9,TRBJ2-2,CASSLAGYTGELFF,1,0,1,1
TRBV18,TRBJ2-1,CASSPESNEQFF,2,0,1,2
TRBV7-9,TRBJ2-7,CAIPGDYEQYF,2,1,2,3
TRBV18,TRBJ2-7,CASSLREAGTSGRVEQYF,1,1,2,2
TRBV7-2,TRBJ2-1,CASSLTTGVNEQFF,3,1,2,4
TRBV19,TRBJ2-1,CVSSITPRWTSGNNEQFF,1,0,1,1
TRBV28,TRBJ1-5,CASSLFEGSGNQPQHF,1,2,2,3
TRBV20-1,TRBJ2-3,CSGGLPGGSTDTQYF,1,0,1,1
TRBV30,TRBJ2-1,CASKGRVGVGEQFF,1,0,1,1
TRBV19,TRBJ2-7,CASSIEFAGLLTSYEQYF,1,0,1,1
TRBV14,TRBJ1-4,CASSPDRGRADNEKLFF,1,0,1,1
TRBV7-2,TRBJ2-5,CASSHRTSGSWGETQYF,1,1,2,2
TRBV10-3,TRBJ1-3,CAISDRRQGTGNTIYF,1,0,1,1
TRBV19,TRBJ2-2,CASSIGGQGGTGELFF,1,0,1,1
TRBV7-6,TRBJ2-1,CASSSPGGSTAHGQFF,2,1,2,3
TRBV28,TRBJ2-3,CASSGSGQGAIDTQYF,1,0,1,1
TRBV4-1,TRBJ2-4,CASSQDLRAAKNIQYF,1,0,1,1
TRBV29-1,TRBJ2-7,CSVRLELAVTSYEQYF,1,0,1,1
TRBV19,TRBJ2-7,CASSIRGRSSYEQYF,1,0,1,1
TRBV28,TRBJ1-5,CASSSYRGGNQPQHF,2,0,1,2
TRBV12-3/4,TRBJ2-5,CASSPGTGAGETQYF,1,0,1,1
TRBV9,TRBJ2-1,CASSASGVYTNEQFF,1,0,1,1
TRBV5-1,TRBJ2-1,CASDPGSGSFHEQFF,1,0,1,1
TRBV4-1,TRBJ1-2,CASSQLRAGEYGYTF,2,0,1,2
TRBV5-1,TRBJ1-5,CASRPGTGEGQPRHF,1,0,1,1
TRBV6-2/3/5/6,TRBJ2-3,CASTSYSRTDTQYF,1,0,1,1
TRBV2,TRBJ1-5,CASSEAGGNQPQHF,1,0,1,1
TRBV28,TRBJ1-1,CASSKGTAGTEAFF,2,0,1,2
TRBV5-6,TRBJ2-3,CASSPGTGRHTQYF,2,0,1,2
TRBV7-9,TRBJ2-1,CDGVDRGLYNEQFF,1,0,1,1
TRBV5-1,TRBJ2-7,CASSLFSGTSEQYF,1,0,1,1
TRBV5-1,TRBJ2-7,CASSLEMAAYEQYF,3,1,2,4
TRBV20-1,TRBJ2-3,CSARVVGVTDTQYF,1,0,1,1
TRBV29-1,TRBJ2-5,CSVGARDLQETQYF,1,0,1,1
TRBV18,TRBJ2-7,CASSPGEREKQYF,1,0,1,1
TRBV18,TRBJ2-3,CASSREGVDTQYF,1,0,1,1
TRBV2,TRBJ1-1,CASRETWDTEAFF,1,0,1,1
TRBV24-1,TRBJ2-2,CATSGYTGELFF,2,0,1,2
TRBV11-3,TRBJ2-3,CASSLGSDTQYF,1,0,1,1
TRBV11-2,TRBJ2-7,CASSLASYEQYF,1,0,1,1
TRBV20-1,TRBJ2-7,CSARTFSYEQYF,1,0,1,1
TRBV5-5,TRBJ2-3,CASSLPRNPGDTQYF,1,0,1,1
TRBV3-1,TRBJ2-7,RASTAGQARDQYF,1,0,1,1
TRBV7-9,TRBJ1-1,CASSLNQPEAFF,3,1,2,4
TRBV7-9,TRBJ1-1,CASSLVSSNEAFF,2,0,1,2
TRBV29-1,TRBJ1-4,CSVGQGGTNEKLFF,3,8,2,11
TRBV19,TRBJ2-1,CASSLTGGNEQFF,2,0,1,2
TRBV30,TRBJ1-2,CSLRKGGYTF,2,0,1,2
TRBV29-1,TRBJ2-3,CSVASGSVTDTQYF,1,0,1,1
TRBV20-1,TRBJ2-4,CSVRRQSKTIQYF,1,0,1,1
TRBV29-1,TRBJ2-1,CSASASDYNEQFF,2,0,1,2
TRBV3-1,TRBJ1-1,CASSQDFGHRIGKNTEAFL,1,0,1,1
TRBV18,TRBJ1-4,CASSPETTNEKLFF,2,0,1,2
TRBV9,TRBJ2-1,CASSVNRGRDNEQFF,1,0,1,1
TRBV7-9,TRBJ1-3,CASSLGISRQGDSGNTIYF,4,3,2,7
TRBV5-6,TRBJ1-1,CASSLRGQGANRAEAFF,1,0,1,1
TRBV18,TRBJ2-7,CASSPGLAGSSYEQYF,1,0,1,1
TRBV18,TRBJ2-1,CASSPRPPSSYNEQFF,1,0,1,1
TRBV28,TRBJ2-1,CASSSGGTQGWNEQFF,1,0,1,1
TRBV27,TRBJ1-2,CASSLTSERTNYGYTF,1,0,1,1
TRBV27,TRBJ1-3,CASSPLQGFSGNTIYF,1,0,1,1
TRBV7-9,TRBJ1-2,CASSPFGGTESYGYTF,1,0,1,1
TRBV5-6,TRBJ2-2,CASSVASGSFHRELFF,1,0,1,1
TRBV19,TRBJ2-5,CASSRTSGSYETQYF,2,9,2,11
TRBV18,TRBJ2-3,CASSKGAFLTDTQYF,1,0,1,1
TRBV5-5,TRBJ2-1,CASCLEGQTYNEQFF,1,0,1,1
TRBV28,TRBJ1-5,CASQKGGAGNQPQHF,2,2,2,4
TRBV5-4,TRBJ2-7,CASSFPTGGSYEQYF,1,0,1,1
TRBV5-5,TRBJ2-3,CASSFHSRGTDTQYF,1,0,1,1
TRBV7-2,TRBJ2-5,CASSSLAASRGTQYF,1,0,1,1
TRBV7-2,TRBJ2-3,CASSQGQGNTDTQYF,1,0,1,1
TRBV12-3/4,TRBJ2-3,CASRETHEGTDTQYF,1,0,1,1
TRBV5-1,TRBJ2-1,CASSSLAGAVNEQFF,1,0,1,1
TRBV20-1,TRBJ2-7,CSASGIAGSFAEQYF,1,0,1,1
TRBV12-5,TRBJ2-5,CASGTGTDRETQYF,1,0,1,1
TRBV19,TRBJ2-5,CASSISGGPGTQYF,1,0,1,1
TRBV19,TRBJ2-1,CASSIAPFPYEQFF,1,1,2,2
TRBV19,TRBJ2-2,CASSIAWGTGELFF,1,0,1,1
TRBV2,TRBJ2-3,CASSPGQSTDTQYF,2,2,2,4
TRBV18,TRBJ2-4,CASSPPSGSDIQYF,1,0,1,1
TRBV28,TRBJ2-7,CASTPPDSYHEQYF,1,0,1,1
TRBV28,TRBJ1-4,CASSWDGRDEKLFF,1,0,1,1
TRBV25-1,TRBJ2-5,CASSENRGRETQYF,1,0,1,1
TRBV6-1,TRBJ2-2,CASSEDVDPGELFF,1,0,1,1
TRBV5-8,TRBJ2-7,CASSFGTGSYEQYF,1,0,1,1
TRBV7-9,TRBJ2-3,CASSLEASGGTQYF,1,0,1,1
TRBV7-6,TRBJ2-2,CASSLVQGSGELFF,1,0,1,1
TRBV7-3,TRBJ2-3,CASSLNTGPDTQYF,1,0,1,1
TRBV5-6,TRBJ2-7,CASSSRTGSYEQYF,1,0,1,1
TRBV7-2,TRBJ2-7,CASSRSNWGYEQYF,2,1,2,3
TRBV28,TRBJ2-7,CASRSGGSTMKQYF,1,0,1,1
TRBV5-1,TRBJ1-5,CASSLGDKNQPQHF,1,0,1,1
TRBV5-1,TRBJ2-1,CASSLGFSYNEQFF,2,0,1,2
TRBV5-1,TRBJ2-7,CASNGDGRSYEQYF,1,0,1,1
TRBV20-1,TRBJ2-6,CSAHSNSGANVLTF,3,2,2,5
TRBV12-5,TRBJ1-1,CASGRGVGTEAFF,1,0,1,1
TRBV7-7,TRBJ2-5,CASSPGGRETQYF,1,0,1,1
TRBV2,TRBJ2-5,CASSVGDLETQYF,1,0,1,1
TRBV18,TRBJ2-5,CASSPGQQETQYF,1,0,1,1
TRBV6-2/3/5/6,TRBJ2-5,CASSLVLQETQYF,1,0,1,1
TRBV6-2/3/5/6,TRBJ2-7,CASSTSGSYEQYF,1,0,1,1
TRBV5-4,TRBJ2-1,CASSLTGYNEQFF,1,0,1,1
TRBV11-2,TRBJ2-1,CASSLGLSNEQFF,1,0,1,1
TRBV3-1,TRBJ2-7,CASSQEPQGEQYF,1,0,1,1
TRBV2,TRBJ2-2,CASSIRKTGELFF,1,0,1,1
TRBV12-5,TRBJ2-1,CASGSNDWRQFF,1,0,1,1
TRBV14,TRBJ2-5,CASSQGWETQYF,2,0,1,2
TRBV20-1,TRBJ2-7,CSATWDRYEQYF,1,0,1,1
TRBV29-1,TRBJ1-2,CSVGEGSYGYTF,1,0,1,1
TRBV29-1,TRBJ2-1,CSAARRFNEQFF,1,0,1,1
TRBV20-1,TRBJ2-1,CSAWGYNEQFF,2,0,1,2
TRBV6-2/3/5/6,TRBJ2-1,CASSYGGSYNEQFF,2,0,1,2
TRBV29-1,TRBJ2-1,CSVEDWMGLAGQPYNEQFF,1,0,1,1
TRBV6-2/3/5/6,TRBJ2-2,CASSYGSSGRAPTGELFF,1,0,1,1
TRBV25-1,TRBJ2-1,CASSSRVAGWENNEQFF,1,0,1,1
TRBV20-1,TRBJ2-1,CSAKPGLAGSFYNEQFF,1,0,1,1
TRBV24-1,TRBJ2-2,CATSDSRASNTGELFF,1,0,1,1
TRBV18,TRBJ1-3,CASSPREWLSGNTIYF,1,0,1,1
TRBV18,TRBJ2-4,CASSPQDSVSKNIQYF,1,0,1,1
TRBV27,TRBJ2-2,CASSLRARDHTGELFF,1,0,1,1
TRBV28,TRBJ2-1,CASSPMDYTAYNEQFF,1,0,1,1
TRBV7-9,TRBJ2-1,CASSLAVAGLYNEQFF,1,0,1,1
TRBV7-3,TRBJ2-5,CASSLNPAGGGETQYF,1,0,1,1
TRBV5-4,TRBJ2-2,CASSPNRGPSTGELFF,1,0,1,1
TRBV3-1,TRBJ2-5,CASSQDRGTAQETQYF,1,0,1,1
TRBV3-1,TRBJ2-1,CASNLGTSGSRNEQFF,1,0,1,1
TRBV20-1,TRBJ1-5,CSAVTGYRYSNQPQHF,2,1,2,3
TRBV19,TRBJ1-5,CATLRTGNGNQPQHF,1,0,1,1
TRBV24-1,TRBJ2-5,CATSDGGRAEETQYF,1,0,1,1
TRBV19,TRBJ2-7,CASSMTSGSLDEQYF,2,0,1,2
TRBV19,TRBJ1-1,CASSKTLGDRAEAFF,1,1,2,2
TRBV18,TRBJ2-1,CASSPPAAAYNEQFF,1,0,1,1
TRBV12-3/4,TRBJ1-6,CASGHSTVYNSPLHF,1,0,1,1
TRBV2,TRBJ2-1,CASTKLPSGSGEQFF,1,0,1,1
TRBV28,TRBJ2-7,CASSSVKRGPPEQYF,1,0,1,1
TRBV7-2,TRBJ2-3,CASSFGQGGTDTQYF,1,0,1,1
TRBV5-5,TRBJ2-1,CASSLAPGQGNEQFF,1,0,1,1
TRBV7-2,TRBJ1-2,CASSSDSFTTYGYTF,1,0,1,1
TRBV3-1,TRBJ2-7,CASSLFAGQSYEQYF,1,0,1,1
TRBV7-9,TRBJ2-1,CASSRPGLDSNEQFF,1,0,1,1
TRBV5-1,TRBJ2-1,CASSLPSGRSREQFF,1,0,1,1
TRBV5-1,TRBJ2-1,CASSPRTGGDNEQFF,1,1,2,2
TRBV20-1,TRBJ1-6,CSAGEERGYGSPLHF,1,0,1,1
TRBV20-1,TRBJ2-1,CSASPGTGGRNEQFF,1,0,1,1
TRBV20-1,TRBJ2-1,CSAPEYAAGNNEQFF,1,0,1,1
TRBV29-1,TRBJ2-1,CSVLVGLAGDNEQFF,2,0,1,2
TRBV29-1,TRBJ1-5,CSVVIGRVCNQPQHF,1,0,1,1
TRBV29-1,TRBJ2-5,CSVESIAGPQETQYF,1,0,1,1
TRBV29-1,TRBJ2-3,CSVARQGGSTDTQYF,1,0,1,1
TRBV4-1,TRBJ2-7,CNIRDYAGDLYEQYF,1,0,1,1
TRBV30,TRBJ2-3,CAWSVLGRADTQYF,2,1,2,3
TRBV24-1,TRBJ2-1,CATSAAGSYNEQFF,1,0,1,1
TRBV24-1,TRBJ2-1,CATQDRGSYNEQFF,2,0,1,2
TRBV18,TRBJ1-1,CASSPPSQNTEAFF,1,0,1,1
TRBV18,TRBJ1-5,CASSPGGGNQPQHF,2,0,1,2
TRBV12-3/4,TRBJ2-1,CASSLGRSYNEQFF,1,0,1,1
TRBV6-2/3/5/6,TRBJ2-3,CASSYYQRADTQYF,1,0,1,1
TRBV6-1,TRBJ1-5,CASSGQGGNQPQHF,1,0,1,1
TRBV2,TRBJ2-1,CASSIADTYNEQFF,1,0,1,1
TRBV7-2,TRBJ2-5,CASSFQTSEETQYF,1,0,1,1
TRBV7-2,TRBJ2-7,CASSSLLGQEEQYF,1,0,1,1
TRBV6-2/3/5/6,TRBJ1-1,CASSRRPDGSEAFF,1,0,1,1
TRBV3-1,TRBJ1-1,CASSQHSGDTEAFF,1,0,1,1
TRBV6-2/3/5/6,TRBJ2-7,CASSQVGDSYEQYF,1,0,1,1
TRBV11-2,TRBJ2-7,CASNSPGRDDEQYF,2,0,1,2
TRBV19,TRBJ2-7,CASSQGPSGDEQYF,1,0,1,1
TRBV5-1,TRBJ2-7,CASSLPGLAYEQYF,2,0,1,2
TRBV20-1,TRBJ2-7,CSAGGTSGSYEQYF,1,0,1,1
TRBV20-1,TRBJ2-3,CSARHAGGTDTQYF,1,0,1,1
TRBV20-1,TRBJ2-7,CSARDSGTAYEQYF,1,0,1,1
TRBV29-1,TRBJ2-1,CSVNRDRIYNEQFF,1,0,1,1
TRBV29-1,TRBJ1-2,CSILQGGESNGYTF,1,0,1,1
TRBV2,TRBJ2-6,CAGHPPGANVLTF,2,0,1,2
TRBV19,TRBJ1-1,CASSMLGRTEAFF,2,1,2,3
TRBV13,TRBJ2-2,CASGPLGTGELFF,1,0,1,1
TRBV6-4,TRBJ1-1,CASGGQLNTEAFF,1,0,1,1
TRBV12-3/4,TRBJ2-6,CASSLAGANVLTF,1,0,1,1
TRBV12-3/4,TRBJ2-1,CASSKGTPNEQFF,1,0,1,1
TRBV7-2,TRBJ2-7,CASSFPRRDEQYF,1,0,1,1
TRBV7-9,TRBJ2-7,CASSLTAQYEQYF,1,0,1,1
TRBV7-2,TRBJ1-5,CASSPRQGGTQHF,1,0,1,1
TRBV14,TRBJ2-5,CASSQDLEGTQYF,1,0,1,1
TRBV5-1,TRBJ2-3,CASSLFSTDTQYF,1,0,1,1
TRBV5-1,TRBJ2-7,CASSWDKPYEQYF,2,2,2,4
TRBV20-1,TRBJ1-5,CSATGDSNQPQHF,1,0,1,1
TRBV20-1,TRBJ1-5,CSATTGGDQPQHF,1,0,1,1
TRBV20-1,TRBJ2-7,CSASDREPYEQYF,1,0,1,1
TRBV29-1,TRBJ2-3,CSAQGLGTDTQYF,1,0,1,1
TRBV12-5,TRBJ2-1,CASGLGQNEQFF,3,4,2,7
TRBV10-3,TRBJ2-5,CAISVSGETQYF,1,0,1,1
TRBV19,TRBJ1-1,CASSELNTEAFF,2,2,2,4
TRBV19,TRBJ1-1,CASVPTGGEAFF,1,0,1,1
TRBV2,TRBJ2-7,CASGDIFYEQYF,2,1,2,3
TRBV14,TRBJ2-3,CASSRDRHTQYF,1,0,1,1
TRBV6-1,TRBJ2-2,CASSEVTGELFF,1,0,1,1
TRBV5-8,TRBJ1-3,CASSLVGNTIYF,1,0,1,1
TRBV12-3/4,TRBJ2-3,CASNPQEDTQYF,1,0,1,1
TRBV5-1,TRBJ1-1,CASSFDQEKAFF,1,0,1,1
TRBV20-1,TRBJ1-1,CSARVRNTEAFF,1,0,1,1
TRBV30,TRBJ2-5,CAWSEGETQYF,1,0,1,1
TRBV2,TRBJ2-3,CASTASDTQYF,1,0,1,1
TRBV29-1,TRBJ2-1,CSAPSGDEQFF,2,0,1,2
TRBV25-1,TRBJ2-3,CASTRDTQYF,2,1,2,3
TRBV29-1,TRBJ2-1,CSVRGESSYNEQFF,2,1,2,3
TRBV5-1,TRBJ2-1,CASSPEIFWREGLNEQFF,1,0,1,1
TRBV3-1,TRBJ1-5,CASSQGRRGNQPQHF,1,0,1,1
TRBV19,TRBJ1-1,CASSITGVNTEAFF,1,0,1,1
TRBV6-2/3/5/6,TRBJ1-1,CASSYARVNTEAFF,2,0,1,2
TRBV25-1,TRBJ1-1,CASNQGLTTEAFF,1,0,1,1
TRBV9,TRBJ2-5,CASSPGGRAQETQYF,1,0,1,1
TRBV9,TRBJ2-1,CASSGYSGSIDEQFF,1,0,1,1
TRBV15,TRBJ2-1,CATSRDSASAQFF,1,0,1,1
TRBV6-2/3/5/6,TRBJ1-1,CASRTEMNTEAFF,1,0,1,1
TRBV20-1,TRBJ2-1,CSARDPQSSYNEQFF,2,0,1,2
TRBV6-2/3/5/6,TRBJ2-5,CASSYSRTVETQYF,1,0,1,1
TRBV4-2,TRBJ2-5,CASSPQDREETQYF,1,0,1,1
TRBV19,TRBJ2-1,CASNRDIFNNEQFF,1,0,1,1
TRBV20-1,TRBJ2-1,CSATTSGEYNEQFF,1,0,1,1
TRBV12-3/4,TRBJ1-1,CASTSWGRSEAFF,1,0,1,1
TRBV7-9,TRBJ1-2,CASSIPAGYTF,1,0,1,1
TRBV15,TRBJ2-6,CATSSHLGTGPFSGANVLTF,2,0,1,2
TRBV7-2,TRBJ2-4,CASSPDPGQPLILAKNIQYF,1,0,1,1
TRBV19,TRBJ2-1,CASTLRRTSGSRSYNEQFF,2,0,1,2
TRBV28,TRBJ2-4,CASSLVYRQVALGSNIQYF,1,0,1,1
TRBV29-1,TRBJ2-1,CSVDPPTSGRTAPYNEQFF,1,0,1,1
TRBV28,TRBJ2-3,RASTSHWTRGPSSTDTQYF,1,0,1,1
TRBV18,TRBJ2-3,CASSPPGTSGTRTDTQYF,1,0,1,1
TRBV18,TRBJ2-7,CASSQGLRSERSFRKQYF,1,0,1,1
TRBV6-2/3/5/6,TRBJ2-3,CASSYIAMTSGSTDTQYF,1,0,1,1
TRBV27,TRBJ1-2,CASSPESTGSGLGNGYTF,1,0,1,1
TRBV13,TRBJ2-1,CASSSILGPSGRKNEQFF,1,0,1,1
TRBV10-1,TRBJ2-2,CASSGTSGSIIDSGELFL,1,0,1,1
TRBV24-1,TRBJ2-3,CATSDSKNSRGVDTQYF,1,0,1,1
TRBV19,TRBJ2-1,CASSISRSGGAYNEQFF,1,0,1,1
TRBV19,TRBJ2-6,CASSIRTAPSGANVLTF,1,0,1,1
TRBV6-2/3/5/6,TRBJ2-5,CASSSLKRGGGRETQYF,1,0,1,1
TRBV6-2/3/5/6,TRBJ2-4,CASSYSVSQWAKNIQYF,1,0,1,1
TRBV11-2,TRBJ2-5,CASSSGGALADQETQYF,1,0,1,1
TRBV7-6,TRBJ2-1,CASSSTLGQGRPNEQFF,1,0,1,1
TRBV7-9,TRBJ2-1,CASSPPGGAGGGGEQFF,1,0,1,1
TRBV7-9,TRBJ2-1,CASSPHSGGSWNYEQFF,1,0,1,1
TRBV29-1,TRBJ2-6,CSVERTDTNSGANVLTF,1,1,2,2
TRBV29-1,TRBJ2-3,CSGAHGSSGSFADTQYF,1,0,1,1
TRBV19,TRBJ2-7,CASSEEQGLGPYEQYF,1,0,1,1
TRBV18,TRBJ2-2,CASSVTRASNTGELFF,1,0,1,1
TRBV18,TRBJ1-1,CASSPRTPGANTEAFF,1,0,1,1
TRBV6-2/3/5/6,TRBJ2-3,CASSFSVGTGTDTQYF,1,0,1,1
TRBV27,TRBJ1-4,CASSLSPSTGNEKLFF,1,0,1,1
TRBV28,TRBJ2-5,CASSLSGGSGEETQYF,2,2,2,4
TRBV2,TRBJ2-1,CASSEARASSYNEQFF,1,0,1,1
TRBV5-4,TRBJ2-1,CASSLGGATSYNEQFF,1,0,1,1
TRBV7-9,TRBJ2-1,CASSLEMTGSGNEQFF,1,0,1,1
TRBV4-2,TRBJ2-2,CASSQDLRANTGELFF,1,0,1,1
TRBV5-1,TRBJ2-3,CASSLGLAGVKDTQYF,1,0,1,1
TRBV5-1,TRBJ2-3,CASSSLTGLGTDTQYF,1,0,1,1
TRBV20-1,TRBJ2-1,CSARPFSGISYNEQFF,1,0,1,1
TRBV20-1,TRBJ2-1,CSARSPVGGSRNEQFF,2,0,1,2
TRBV20-1,TRBJ2-3,CSARGTTSASTDTQYF,2,0,1,2
TRBV29-1,TRBJ2-7,CSVEGIPGQGWYEQYF,1,1,2,2
TRBV30,TRBJ1-1,CAWSRARPPRPEAFF,1,0,1,1
TRBV10-3,TRBJ2-1,CAASFTGRAENEQFF,1,0,1,1
TRBV10-3,TRBJ2-3,CAIRGIAGGTDTQYF,1,0,1,1
TRBV24-1,TRBJ2-5,CATSEGDGTGETQYF,1,0,1,1
TRBV19,TRBJ1-1,CASSLAGHPDTEAFF,1,0,1,1
TRBV18,TRBJ1-1,CASSPGTGRNTEAYF,1,0,1,1
TRBV18,TRBJ1-4,CASSPMSGGSEKLFF,1,0,1,1
TRBV5-5,TRBJ2-1,CASTVQEGAYNEQFF,1,0,1,1
TRBV28,TRBJ2-1,CASSLSAGVYNEQFF,1,0,1,1
TRBV28,TRBJ2-3,CASSLMGPYTDTQYF,1,0,1,1
TRBV12-3/4,TRBJ2-2,CASSLRTGQTGELFF,1,1,2,2
TRBV27,TRBJ1-2,CASSSGTGTAYGYTF,1,0,1,1
TRBV28,TRBJ1-6,CASSLTPGQGAPLHF,1,0,1,1
TRBV25-1,TRBJ2-1,CASSESSGSGREQFF,1,0,1,1
TRBV5-4,TRBJ2-1,CASSLRGRASNEQFF,1,0,1,1
TRBV7-8,TRBJ2-7,CASSLDRTAIYEQYF,2,3,2,5
TRBV5-8,TRBJ2-2,CASSLTGANTGELFF,1,0,1,1
TRBV5-4,TRBJ2-1,CASSSRTSGSVEQFF,1,0,1,1
TRBV3-1,TRBJ2-1,CASSPRDRGRNEQFF,1,0,1,1
TRBV7-2,TRBJ1-5,CASSPGGASNQPQHF,1,0,1,1
TRBV11-3,TRBJ1-3,CASSPTGTAGNTIYF,1,0,1,1
TRBV3-1,TRBJ2-7,CASSQGLAGGDEQYF,1,1,2,2
TRBV3-1,TRBJ2-7,CASSQTGQFSYEQYF,1,0,1,1
TRBV11-3,TRBJ2-1,CASSMTSGPYNEQFF,1,1,2,2
TRBV7-9,TRBJ2-7,CASSKRPLYRDEQYF,1,0,1,1
TRBV2,TRBJ2-3,CASKTGHPSTDTQYF,1,0,1,1
TRBV5-1,TRBJ2-7,CASQPGQGSSYEQYF,1,0,1,1
TRBV5-1,TRBJ2-1,CASSFGQGGYNEQFF,2,0,1,2
TRBV5-1,TRBJ2-7,CASSLAGQEVYEQYF,1,0,1,1
TRBV5-1,TRBJ2-3,CASRGLATSTDTQYF,1,0,1,1
TRBV20-1,TRBJ2-3,CSAGNSGKPTDTQYF,1,0,1,1
TRBV20-1,TRBJ2-7,CSARERGLAVDEQYF,1,0,1,1
TRBV29-1,TRBJ2-3,CSVLFWAAGTDTQYF,1,0,1,1
TRBV15,TRBJ1-1,CATSRGGPTYEAFF,1,0,1,1
TRBV7-2,TRBJ2-3,CASCLGLRTDTQYF,1,0,1,1
TRBV6-2/3/5/6,TRBJ2-1,CASSLWTEGNEQFF,2,0,1,2
TRBV12-3/4,TRBJ2-5,CASSLSGGAKTQYF,1,0,1,1
TRBV2,TRBJ2-7,CASSSNRGSYEQYF,1,0,1,1
TRBV28,TRBJ2-5,CASSSPGTRETQYF,1,0,1,1
TRBV3-1,TRBJ2-5,CASSSSGRRETQYF,1,0,1,1
TRBV5-6,TRBJ2-3,CASSQEWVTDTQYF,1,0,1,1
TRBV19,TRBJ2-1,CASSIGLAGDEQFF,1,0,1,1
TRBV2,TRBJ2-5,CASSRLAGGETQYF,3,0,1,3
TRBV5-4,TRBJ2-5,CASSLPSTLETQYF,1,0,1,1
TRBV7-9,TRBJ2-5,CASSLHAGQETQYF,1,0,1,1
TRBV7-9,TRBJ2-7,CASSSGTGAYEQYF,1,2,2,3
TRBV7-2,TRBJ2-7,CASSSTSGRYEQYF,1,0,1,1
TRBV7-2,TRBJ2-3,CASSPRETTDTQYF,1,0,1,1
TRBV3-1,TRBJ1-5,CASSPASGNQPQHF,2,0,1,2
TRBV4-2,TRBJ2-7,CASSRGLATGEQYF,1,0,1,1
TRBV3-1,TRBJ2-3,CASSQGGGTDTQYF,1,0,1,1
TRBV28,TRBJ2-5,CASRGQHYQETQYF,3,0,1,3
TRBV12-3/4,TRBJ1-3,CASRRQGSGNTIYF,2,0,1,2
TRBV5-1,TRBJ2-1,CASSLSHGSNEQFF,1,0,1,1
TRBV5-1,TRBJ2-7,CASSPGTAYYEQYF,1,0,1,1
TRBV5-1,TRBJ2-5,CASSAPSGQETQYF,1,0,1,1
TRBV20-1,TRBJ2-3,CSAPRSPSTDTQYF,1,0,1,1
TRBV20-1,TRBJ1-5,CSATPSGGDQPQHF,1,0,1,1
TRBV20-1,TRBJ2-1,CSAATSGRVNEQFF,1,2,2,3
TRBV29-1,TRBJ2-5,CSVAGGGRQETQYF,1,0,1,1
TRBV12-5,TRBJ2-5,CASGPEVRETQYF,1,0,1,1
TRBV2,TRBJ2-3,CASGLISTDTQYF,1,0,1,1
TRBV19,TRBJ1-1,CASSITRDSEAFF,1,0,1,1
TRBV18,TRBJ1-1,CASSLRADTEAFF,1,0,1,1
TRBV6-2/3/5/6,TRBJ2-1,CASSRTGTNEQFF,1,0,1,1
TRBV12-3/4,TRBJ2-3,CASSISRGDTQYF,1,0,1,1
TRBV11-2,TRBJ2-1,CASSLWAYNEQFF,1,0,1,1
TRBV5-5,TRBJ1-1,CASSLASQGTAFF,1,0,1,1
TRBV7-9,TRBJ1-1,CASSSTWNTEAFF,1,0,1,1
TRBV11-2,TRBJ1-5,CASSQTGVQPQHF,1,0,1,1
TRBV3-1,TRBJ1-5,CASSQYSNQPQHF,1,0,1,1
TRBV3-1,TRBJ2-7,CASSQPHSYEQYF,2,0,1,2
TRBV10-1,TRBJ2-1,CASSESIYNEQFF,1,0,1,1
TRBV5-1,TRBJ1-1,CASSLERRNEAFF,1,0,1,1
TRBV5-1,TRBJ1-1,CASSLEMDTEAFF,1,0,1,1
TRBV5-1,TRBJ2-3,CASSWDSTDTQYF,1,0,1,1
TRBV5-1,TRBJ2-7,CASSTLGGHEQYF,1,0,1,1
TRBV20-1,TRBJ2-1,CSARDDSGPLQFF,2,0,1,2
TRBV20-1,TRBJ2-1,CSPGLAGYNEQFF,2,0,1,2
TRBV29-1,TRBJ2-7,CSVNRDNTYEQYF,3,0,1,3
TRBV29-1,TRBJ2-7,CSADSTSEGGKYF,1,0,1,1
TRBV28,TRBJ2-7,CASSFGAYEQYF,1,0,1,1
TRBV5-6,TRBJ1-2,CASSRQGYGYTF,1,0,1,1
TRBV7-9,TRBJ2-3,CASSPSGDTQYF,1,0,1,1
TRBV7-9,TRBJ2-1,CASSRDSNEQFF,1,0,1,1
TRBV2,TRBJ2-5,CASRGLQETQYF,1,0,1,1
TRBV5-1,TRBJ2-1,CASSPPGDEQFF,1,0,1,1
TRBV20-1,TRBJ2-5,CSAGLNQETQYF,1,0,1,1
TRBV29-1,TRBJ2-1,CSVRLSYNEQFF,1,0,1,1
TRBV29-1,TRBJ2-3,CSALGGADTQYF,1,0,1,1
TRBV28,TRBJ2-7,CASSLSREQYF,1,0,1,1
TRBV7-8,TRBJ2-5,CASSLIGTQYF,1,2,2,3
TRBV20-1,TRBJ1-1,CSARLSAEAFF,1,0,1,1
TRBV5-4,TRBJ2-3,CASSLSTGGREDTQYF,1,0,1,1
TRBV3-1,TRBJ2-2,CASTGSGSVTGELFF,1,0,1,1
TRBV2,TRBJ2-7,CAIRRLAGAYEQYF,1,0,1,1
TRBV19,TRBJ2-1,CASSPRSSYNEQFF,1,0,1,1
TRBV11-2,TRBJ2-1,CASSLLSGLGEQFF,1,0,1,1
TRBV11-2,TRBJ2-2,CASSLSLNTGELFF,2,1,2,3
TRBV20-1,TRBJ2-5,CSAPAQRRETQYF,2,0,1,2
TRBV18,TRBJ2-5,CASSPPVGGGKETQYF,1,0,1,1
TRBV29-1,TRBJ2-5,CSAREIQETQYF,1,0,1,1
TRBV2,TRBJ2-5,CASGVQETQYF,2,0,1,2
TRBV5-1,TRBJ2-7,CASSLATDAITYEQYF,1,0,1,1
TRBV18,TRBJ2-3,CASSPEAGSTDTQYF,2,0,1,2
TRBV2,TRBJ1-4,CASTPDSTREKLFS,1,0,1,1
TRBV11-2,TRBJ2-7,CASSPQGRGLEQYF,1,0,1,1
TRBV7-9,TRBJ1-5,CASSRDISNQPQHF,1,1,2,2
TRBV2,TRBJ1-5,CASRTGFSNQPQHF,2,0,1,2
TRBV7-2,TRBJ2-4,CASSLSGQNIQYF,2,5,2,7
TRBV11-2,TRBJ2-3,CASSLEVKDTQYF,2,0,1,2
TRBV29-1,TRBJ2-3,CSVNSGMTDTQYF,1,0,1,1
TRBV5-1,TRBJ2-5,CASGPYGETQHF,1,0,1,1
TRBV5-1,TRBJ2-3,CASSLSTDTQYF,1,1,2,2
TRBV29-1,TRBJ2-7,CSVLGSSYEQYL,1,0,1,1
TRBV11-2,TRBJ2-3,CASRTTWLAGGRTRSSTDTQYF,1,0,1,1
TRBV12-3/4,TRBJ2-1,CASSLILRGLAFRSSYNEQFF,1,0,1,1
TRBV27,TRBJ2-2,CASSLITSGRERRITGELFF,1,0,1,1
TRBV5-4,TRBJ2-1,CASSPGTGDSGRALGNEQFF,1,0,1,1
TRBV6-2/3/5/6,TRBJ2-3,CASSPGGGSYKRTDTQYF,1,0,1,1
TRBV5-4,TRBJ2-3,CASSFPIPLGGRSDTQYF,1,0,1,1
TRBV7-9,TRBJ2-2,CASSYTRYAQTNTGELFF,1,0,1,1
TRBV6-2/3/5/6,TRBJ2-1,CASRQGLAVLEVNNEQFF,1,0,1,1
TRBV4-1,TRBJ1-2,CASSQDSPGAQANYGYTF,1,0,1,1
TRBV20-1,TRBJ2-1,CSARPLLHWGVGYNEQFF,1,0,1,1
TRBV20-1,TRBJ2-6,CSAMIAGTVLSGANVLTF,1,0,1,1
TRBV12-5,TRBJ2-2,CASGAWGGDWNTGELFF,1,0,1,1
TRBV18,TRBJ1-1,CASSPRRIGTVNTEAFF,1,0,1,1
TRBV28,TRBJ2-1,CASSLVASGTRRHEQFF,1,0,1,1
TRBV28,TRBJ2-4,CASSSSGTGAKGNIQYF,1,0,1,1
TRBV6-4,TRBJ2-1,CASSDSPRSGRANEQFF,1,0,1,1
TRBV14,TRBJ2-3,CASSFGTSGGPYDTQYF,1,0,1,1
TRBV11-2,TRBJ1-5,CASSLDLDGGTNQPQHF,1,0,1,1
TRBV5-6,TRBJ2-3,CASSSILDGVGTDTQYF,1,0,1,1
TRBV14,TRBJ2-3,CASSWGVGRARTDTQYF,2,0,1,2
TRBV7-2,TRBJ2-1,CASSLVSGGSSYNEQFF,1,0,1,1
TRBV14,TRBJ1-6,CASSQRRRSSYNSPLHF,1,0,1,1
TRBV3-1,TRBJ2-5,CASSQEAHAGSEETQYF,1,0,1,1
TRBV2,TRBJ1-1,CASRPSTATIMNTEAFF,1,0,1,1
TRBV10-1,TRBJ2-1,CASSDPRGASPNNEQFF,1,0,1,1
TRBV30,TRBJ1-2,CAWSNLRDRGRVGYTF,1,0,1,1
TRBV19,TRBJ2-2,CASMRMQGANTGELFF,1,0,1,1
TRBV19,TRBJ2-1,CASSKDRGRGVNEQFF,1,0,1,1
TRBV12-3/4,TRBJ2-2,CASGVLAGGNTGELFF,1,0,1,1
TRBV6-2/3/5/6,TRBJ2-3,CASSLIGTGYPDTQYF,1,0,1,1
TRBV6-2/3/5/6,TRBJ2-7,CASSYSASGKPYEQYF,1,0,1,1
TRBV6-2/3/5/6,TRBJ2-3,CASSYRLVRFGDTQYF,1,0,1,1
TRBV6-2/3/5/6,TRBJ2-1,CASSLISGWSHNEQFF,1,0,1,1
TRBV2,TRBJ2-3,CASSVRLAGIADTQYF,1,0,1,1
TRBV25-1,TRBJ2-5,CASSETGQGLQETQYF,1,0,1,1
TRBV12-3/4,TRBJ2-1,CASSTNLNLLAIEQFF,1,0,1,1
TRBV13,TRBJ2-7,CASSFGVAARSYEQYF,1,0,1,1
TRBV5-6,TRBJ2-1,CASSLPSGGFYNEQFF,1,0,1,1
TRBV5-4,TRBJ2-1,CASSLVGSRAYNEQFF,1,0,1,1
TRBV5-6,TRBJ2-1,CASSLARRGPYNEQFF,1,0,1,1
TRBV7-2,TRBJ1-5,CASSLVAGQGNQPQHF,1,0,1,1
TRBV7-2,TRBJ2-7,CASSLRGGPTSYEQYF,1,0,1,1
TRBV7-9,TRBJ1-5,CASSSTIGGVNQPQHF,1,0,1,1
TRBV3-1,TRBJ2-1,CASSLEGGSSYNEQFF,2,0,1,2
TRBV3-1,TRBJ2-3,CASSLPGTGGTDTQYF,1,0,1,1
TRBV11-2,TRBJ2-3,CASSPRASGFTDTQYF,1,0,1,1
TRBV5-6,TRBJ2-7,CASSPLRQGAADEQYF,1,0,1,1
TRBV5-8,TRBJ2-3,CASSHGLAGSIDTQYF,1,0,1,1
TRBV3-1,TRBJ2-1,CASSQDSQAGNNEQFF,1,0,1,1
TRBV11-3,TRBJ2-1,CASSALSGSPYNEQFF,1,0,1,1
TRBV12-3/4,TRBJ2-1,CASRRTSGSSYNEQFF,1,0,1,1
TRBV5-1,TRBJ2-1,CASSLARASGRDEQFF,1,0,1,1
TRBV5-1,TRBJ2-1,CASSLAAAGDGDEQFF,1,0,1,1
TRBV5-1,TRBJ2-3,CASSLTSGVRTDTQYF,1,0,1,1
TRBV5-1,TRBJ1-1,CASSPEGGPRNTEAFF,1,0,1,1
TRBV5-1,TRBJ2-7,CASSHRMQGSSYEQYF,1,0,1,1
TRBV5-1,TRBJ2-7,CASSSSWEGLFDEQYF,1,0,1,1
TRBV20-1,TRBJ2-5,CSATPGRGSMVETQYF,2,0,1,2
TRBV29-1,TRBJ2-5,CSVVGMGLADQETQYF,1,0,1,1
TRBV29-1,TRBJ1-1,CSVGFLTGRQNTEAFF,1,1,2,2
TRBV29-1,TRBJ2-1,CSVEDRGTGGYNEQFF,1,0,1,1
TRBV12-3/4,TRBJ2-7,CAGSASGPGGVWQYF,1,0,1,1
TRBV10-3,TRBJ2-1,CAISESPSAHNEQFF,1,0,1,1
TRBV10-3,TRBJ2-2,CAISEADTGSGELFF,1,0,1,1
TRBV2,TRBJ2-3,CATQVAVVGTDTQYF,1,0,1,1
TRBV24-1,TRBJ2-5,CATSETGAGQETQYF,1,0,1,1
TRBV15,TRBJ2-1,CATSRPPPDRNEQFF,1,0,1,1
TRBV19,TRBJ1-1,CASSSVQGGHTEAFF,1,0,1,1
TRBV19,TRBJ1-5,CASSMGRSKVQPQHF,1,0,1,1
TRBV18,TRBJ2-3,CASSQGQGDTDTQYF,1,0,1,1
TRBV18,TRBJ2-1,CASSPLRTSGPEQFF,1,0,1,1
TRBV9,TRBJ2-2,CASTSGTANTGELFF,1,0,1,1
TRBV28,TRBJ2-7,CASTMETSGSYEQYF,1,0,1,1
TRBV28,TRBJ2-7,CASSFRDRPGYEQYF,1,1,2,2
TRBV6-2/3/5/6,TRBJ2-3,CASSSPAGGTDTQYF,1,0,1,1
TRBV2,TRBJ2-3,CASSSELETADTQYF,1,0,1,1
TRBV2,TRBJ2-1,CASSSTSGIGDEQFF,1,0,1,1
TRBV5-4,TRBJ2-1,CASSGGGGGFNEQFF,1,0,1,1
TRBV6-1,TRBJ2-7,CASSEFRGGSGEQYF,1,0,1,1
TRBV6-1,TRBJ2-1,CASSEGLAGSNEQFF,1,0,1,1
TRBV27,TRBJ2-1,CASSKTRRDGNEQFF,2,0,1,2
TRBV7-2,TRBJ1-4,CASSFFGRENEKLFF,1,0,1,1
TRBV7-9,TRBJ2-3,CASSFLAENTDTQYF,1,0,1,1
TRBV7-8,TRBJ2-3,CASSLLPTSTDTQYF,2,2,2,4
TRBV7-2,TRBJ2-3,CASSLDGGSTDTQYF,2,1,2,3
TRBV7-9,TRBJ2-3,CASSLTEGSGDTQYF,1,0,1,1
TRBV28,TRBJ2-1,CASSPARSSYNEQFF,1,0,1,1
TRBV5-5,TRBJ1-5,CASSPISNSNQPQHF,1,0,1,1
TRBV13,TRBJ2-7,CASSPSAGGIYEQYF,1,0,1,1
TRBV3-1,TRBJ2-3,CASSPWGAGFNTQYF,1,0,1,1
TRBV5-4,TRBJ2-1,CASSRGTSTYNEQFF,1,0,1,1
TRBV14,TRBJ2-1,CASSQQLAGSDEQFF,1,0,1,1
TRBV14,TRBJ2-1,CASSQDRTVYNEQSF,1,0,1,1
TRBV3-1,TRBJ2-7,CASSQDITTPYEQYF,1,0,1,1
TRBV7-9,TRBJ2-2,CASSQIGGGAGELFF,1,0,1,1
TRBV9,TRBJ2-1,CASSAMTSPYNEQFF,1,0,1,1
TRBV9,TRBJ2-3,CASSGRDRGWNTQYF,1,0,1,1
TRBV7-2,TRBJ2-3,CASSIDRGSTDTQYF,1,0,1,1
TRBV2,TRBJ2-1,CASRPTLAGDGEQFF,2,1,2,3
TRBV28,TRBJ2-3,CASNDGGRARDTQYF,1,0,1,1
TRBV5-1,TRBJ2-1,CASSFQGSTYNEQFF,1,0,1,1
TRBV5-1,TRBJ2-5,CASSLADSHKETQYF,1,0,1,1
TRBV5-1,TRBJ2-1,CASSLIRGSWDEQFF,1,0,1,1
TRBV5-1,TRBJ2-1,CASSSQAGVRNEQFF,1,0,1,1
TRBV5-1,TRBJ2-2,CASSLLIGSNGELFF,2,0,1,2
TRBV5-1,TRBJ1-1,CASSPERGLGTEAFF,1,0,1,1
TRBV4-1,TRBJ2-1,CASSHREDGYNEQFF,1,0,1,1
TRBV20-1,TRBJ2-2,CSASSSGTNTGELFF,1,0,1,1
TRBV20-1,TRBJ2-6,CSASGPLQGANVLTF,1,0,1,1
TRBV20-1,TRBJ2-1,CSARGGLPGDNEQFF,2,0,1,2
TRBV20-1,TRBJ2-5,CSAGGQGDPVGTQYF,1,0,1,1
TRBV29-1,TRBJ2-7,CSVEGSSGSGDEQYF,1,0,1,1
TRBV28,TRBJ2-7,SASSLSSGSPREQYF,1,0,1,1
TRBV12-5,TRBJ2-2,CASGVLPNTGELFF,1,0,1,1
TRBV19,TRBJ2-1,CASGEAGGIDEQFF,1,0,1,1
TRBV19,TRBJ2-7,CASSPADRTYEQYF,1,0,1,1
TRBV19,TRBJ2-1,CASSKQGGYNEQFF,1,0,1,1
TRBV19,TRBJ2-4,CASNSDRGKNIQYF,1,0,1,1
TRBV2,TRBJ2-2,CASRDKGYTGELFF,1,0,1,1
TRBV6-2/3/5/6,TRBJ2-7,CASTLQGATYEQYF,1,0,1,1
TRBV6-2/3/5/6,TRBJ1-5,CASSFTGGDQPQHF,1,0,1,1
TRBV28,TRBJ2-4,CASSLPSGQGIQYF,1,0,1,1
TRBV12-3/4,TRBJ2-7,CASSLAGVAYEQYF,1,0,1,1
TRBV2,TRBJ1-1,CASSYRLVNTEAFF,1,0,1,1
TRBV12-3/4,TRBJ2-1,CASSLSGIFNEQFF,1,0,1,1
TRBV2,TRBJ2-1,CASSAFLADNEQFF,1,0,1,1
TRBV28,TRBJ2-4,CASSTRRGKNIQYF,1,2,2,3
TRBV5-4,TRBJ2-5,CASSFDRGQETQYF,1,0,1,1
TRBV5-4,TRBJ1-1,CASSLDRGVTEAFF,1,0,1,1
TRBV7-9,TRBJ2-3,CASSLVGGADTQYF,1,0,1,1
TRBV7-3,TRBJ2-5,CASSLTSGGETQYF,1,0,1,1
TRBV11-2,TRBJ2-7,CASSLSRATYEQYF,1,0,1,1
TRBV5-6,TRBJ2-5,CASSYGTSGETQYF,1,0,1,1
TRBV7-9,TRBJ2-7,CASSLVGGDREQYF,1,0,1,1
TRBV13,TRBJ1-1,CASSPRRRNTEAFF,2,0,1,2
TRBV28,TRBJ2-7,CASSRPTSAYEQYF,1,0,1,1
TRBV7-2,TRBJ2-1,CASSQGLPGYTQFF,1,0,1,1
TRBV7-3,TRBJ2-1,CASSTTGTDNEQFF,1,0,1,1
TRBV6-4,TRBJ1-2,CASRTLGGTYGYTF,1,0,1,1
TRBV5-6,TRBJ2-2,CSSSYYGGTGELFF,1,0,1,1
TRBV5-1,TRBJ2-1,CASSLVISNNEQFF,2,0,1,2
TRBV5-1,TRBJ2-7,CASSSRDWGYEQYF,1,0,1,1
TRBV5-1,TRBJ2-5,CASSSQGIQETQYF,1,0,1,1
TRBV5-1,TRBJ1-2,CASSALQANYGYTF,1,0,1,1
TRBV5-1,TRBJ2-1,CASSSVSVANEQFF,1,0,1,1
TRBV20-1,TRBJ2-1,CSAEPSGRAHEQFF,1,0,1,1
TRBV20-1,TRBJ1-2,CSASKLGRDYGYTF,1,0,1,1
TRBV20-1,TRBJ2-5,CSARPGTGQETQYF,1,0,1,1
TRBV20-1,TRBJ1-5,CSGRWGGTDQPQHF,1,0,1,1
TRBV29-1,TRBJ2-3,CSVESQARHTAQYF,1,0,1,1
TRBV29-1,TRBJ2-1,CSVERVAGIVEQFF,1,0,1,1
TRBV29-1,TRBJ2-7,CSVWTSGGGYEQYF,1,0,1,1
TRBV29-1,TRBJ2-7,CSVLVGTAPYEQYF,1,0,1,1
TRBV15,TRBJ1-1,CATSRGGSTEAFF,1,0,1,1
TRBV7-9,TRBJ2-3,CATRAASTDTQYF,1,0,1,1
TRBV19,TRBJ1-5,CASKNWDNQPQHF,1,1,2,2
TRBV18,TRBJ1-5,CASSGGENQPQHF,1,0,1,1
TRBV18,TRBJ2-5,CASSPPGEETQYF,1,0,1,1
TRBV18,TRBJ1-1,CASSPDENTEAFF,1,0,1,1
TRBV19,TRBJ1-2,CASAQRANYGYTF,1,0,1,1
TRBV12-3/4,TRBJ1-2,CASSLVSGVGYTF,1,0,1,1
TRBV27,TRBJ1-1,CASSLSGAVEAFF,1,0,1,1
TRBV12-3/4,TRBJ1-2,CASSLMENYGYTF,1,0,1,1
TRBV2,TRBJ2-5,CASSEGRWETQYF,2,0,1,2
TRBV7-2,TRBJ2-1,CASSLPGYNEQFF,1,0,1,1
TRBV7-9,TRBJ2-2,CASSLAGSGELFF,1,0,1,1
TRBV3-1,TRBJ2-7,CASSSGTSGLRYF,1,0,1,1
TRBV12-3/4,TRBJ1-2,CASSYRGGSGYTF,1,0,1,1
TRBV3-1,TRBJ2-5,CASSLRGQETQYF,1,0,1,1
TRBV5-4,TRBJ2-1,CASSPDSSGVRFF,1,0,1,1
TRBV3-1,TRBJ2-7,CASSPQYEGEQYF,1,0,1,1
TRBV12-3/4,TRBJ2-7,CASSPQVFHGQYF,1,0,1,1
TRBV14,TRBJ1-2,CASSQTGLYGYTF,1,0,1,1
TRBV9,TRBJ2-2,CASSVGGPGELFF,1,0,1,1
TRBV2,TRBJ2-5,CASSGQGSETQYF,1,0,1,1
TRBV5-4,TRBJ1-2,CASSTFGVVGYTF,1,0,1,1
TRBV5-1,TRBJ1-1,CASGGQGNTEAFF,1,0,1,1
TRBV5-1,TRBJ2-4,CASSLGQENIQYF,1,0,1,1
TRBV5-1,TRBJ2-7,CASSLDQLYEQYF,1,0,1,1
TRBV5-1,TRBJ1-1,CASSQEMNTEAFF,1,0,1,1
TRBV29-1,TRBJ2-1,CSVSTSSYNEQFF,1,0,1,1
TRBV20-1,TRBJ1-1,CSVAERLNTEAFF,1,0,1,1
TRBV20-1,TRBJ2-7,CSAGTSGLGEQYF,1,0,1,1
TRBV20-1,TRBJ1-1,CSASLRTNTEAFF,1,0,1,1
TRBV20-1,TRBJ2-3,CSARSGRTDTQYF,1,0,1,1
TRBV20-1,TRBJ2-1,CSANRGLANEQFF,1,0,1,1
TRBV29-1,TRBJ1-1,CSVDTGLGTEAFF,2,0,1,2
TRBV29-1,TRBJ2-2,CSVDPWNTGELFF,1,0,1,1
TRBV29-1,TRBJ2-2,CSVEEGSPGELFF,1,0,1,1
TRBV29-1,TRBJ2-7,CSVGLAGVYEQYF,1,0,1,1
TRBV2,TRBJ1-4,CAAGTRSEKLFF,1,0,1,1
TRBV28,TRBJ2-7,CASSIKAGWQYF,1,0,1,1
TRBV7-2,TRBJ1-1,CASSSIPLEAFF,1,0,1,1
TRBV11-2,TRBJ2-1,CASSHPYNEQFL,1,0,1,1
TRBV12-3/4,TRBJ2-3,CASNLLSGTQYF,1,0,1,1
TRBV5-1,TRBJ2-1,CASSNPNNEQFF,1,0,1,1
TRBV20-1,TRBJ2-3,CSARPAQNTQYF,1,0,1,1
TRBV20-1,TRBJ2-1,CSAPSGSDEQFF,1,0,1,1
TRBV20-1,TRBJ2-5,CSAAWTSETQYF,1,0,1,1
TRBV29-1,TRBJ1-1,CSVNTGFAEAFF,1,0,1,1
TRBV29-1,TRBJ2-5,CSVYHRGETQYF,1,0,1,1
TRBV29-1,TRBJ2-1,CSAGRSYDEQFF,1,0,1,1
TRBV29-1,TRBJ2-1,CSGLSSYNEQFF,1,0,1,1
TRBV19,TRBJ2-2,CASRSTGELFF,1,1,2,2
TRBV25-1,TRBJ2-3,CASTSSSTQYF,1,0,1,1
TRBV7-9,TRBJ2-7,CASSYLGEQYF,2,0,1,2
TRBV3-1,TRBJ2-5,CASSGTGAQYF,2,0,1,2
TRBV29-1,TRBJ1-2,CSSGQGSGYTF,1,0,1,1
TRBV29-1,TRBJ2-7,CSVDAGTATLF,1,1,2,2
TRBV29-1,TRBJ2-7,CSALGGDEQYF,1,0,1,1
TRBV2,TRBJ2-7,CASRVGEQYF,1,0,1,1
TRBV5-6,TRBJ2-5,CASSLSGLAGVKETQYF,1,0,1,1
TRBV6-2/3/5/6,TRBJ1-2,CASSYATGFNYGYTF,2,0,1,2
TRBV5-4,TRBJ1-3,CASSFGGGSGNTIYF,1,0,1,1
TRBV11-2,TRBJ2-1,CASSFGGLVGNEQFF,1,0,1,1
TRBV6-2/3/5/6,TRBJ2-5,CASKPGLAGDGTQYF,2,0,1,2
TRBV7-4,TRBJ2-4,CASSKQGLKNIQYF,1,1,2,2
TRBV7-9,TRBJ2-1,CASRAGGASNEQFF,1,0,1,1
TRBV5-1,TRBJ1-6,CASRQGAENSPLHF,1,0,1,1
TRBV25-1,TRBJ2-7,CASRLAGGVEQYF,1,0,1,1
TRBV10-3,TRBJ2-3,CAIRAGTDTQYF,1,0,1,1
TRBV20-1,TRBJ2-3,CSARDRLKGQGYTDTQYF,1,0,1,1
TRBV19,TRBJ2-1,CASSFNPTSGSLGEQFF,1,0,1,1
TRBV12-3/4,TRBJ2-5,CASSFLTSGSGETQYF,1,0,1,1
TRBV6-2/3/5/6,TRBJ2-3,CASSYSRLAGTDTLYF,1,0,1,1
TRBV14,TRBJ1-2,CACSQELGAYYGYTF,2,0,1,2
TRBV19,TRBJ2-1,CASSITSGSYNEQFF,2,12,2,14
TRBV12-3/4,TRBJ2-7,CASRNTGTGTYEQYL,1,0,1,1
TRBV5-1,TRBJ2-1,CAGSLLTGVGNEQFF,1,0,1,1
TRBV9,TRBJ2-1,CASSARDSYNEQFF,1,0,1,1
TRBV20-1,TRBJ2-7,CSARGDRGYYEQYF,1,0,1,1
TRBV29-1,TRBJ2-4,CSVRTGGRGNIQYF,1,0,1,1
TRBV6-1,TRBJ1-1,CASSELPNTEAFF,1,0,1,1
TRBV25-1,TRBJ2-1,CASKRSGNNEQFF,1,0,1,1
TRBV20-1,TRBJ2-5,CSAKLGLRETQYF,2,0,1,2
TRBV5-1,TRBJ2-7,CASSLGSYERYF,2,0,1,2
TRBV18,TRBJ2-1,CASSGTVHQGDQKSRYEQFF,1,0,1,1
TRBV24-1,TRBJ2-6,CATSDLERQQGSGANVLTF,1,0,1,1
TRBV7-2,TRBJ2-5,CASSLVAGVGTLGRGTQYF,1,0,1,1
TRBV19,TRBJ2-1,CASVDRHPNYNDQFF,1,0,1,1
TRBV19,TRBJ1-4,CASRPEGAQEKLFF,1,0,1,1
TRBV5-8,TRBJ2-1,CASSLLAMGNEQFF,1,0,1,1
TRBV19,TRBJ2-5,CARGEWTEQETQYF,1,0,1,1
TRBV12-3/4,TRBJ2-1,CASRRREGSEQFF,1,0,1,1
TRBV10-3,TRBJ1-4,CAISDGEKLFF,1,0,1,1
TRBV9,TRBJ2-2,CASERTGELFF,1,0,1,1
TRBV12-5,TRBJ2-3,CASGLVGGVPGTGVNTDTQYF,1,0,1,1
TRBV12-3/4,TRBJ2-3,CASSLGWDRTSNGKTDTQYF,1,1,2,2
TRBV4-2,TRBJ2-7,CASSQDKSRWLTFGGREQYF,2,2,2,4
TRBV12-5,TRBJ1-1,CASGPWSAGYSGVNTEAFF,1,0,1,1
TRBV27,TRBJ2-5,CASSLRVGSGLAGKETQYF,1,0,1,1
TRBV11-2,TRBJ1-1,CASSSLDPASTLPNTEAFF,1,0,1,1
TRBV12-3/4,TRBJ2-1,CASSPRGAYSRSSRNEQFF,1,0,1,1
TRBV7-3,TRBJ2-3,CASSPGPTGTGDRTDTQYF,1,1,2,2
TRBV7-8,TRBJ2-2,CASSTRTGGTGVGTGELFF,1,0,1,1
TRBV4-1,TRBJ2-4,CASSQDPLRTPIAKNIQYF,1,0,1,1
TRBV20-1,TRBJ2-3,CSARVPVGPNSQPTDTQYF,1,0,1,1
TRBV19,TRBJ2-6,CASSPSGTETLGANVLTF,1,0,1,1
TRBV19,TRBJ1-2,CASSKWRPDRGHLYGYTF,1,0,1,1
TRBV18,TRBJ1-1,CASSLSGQGNWANTEAFF,1,0,1,1
TRBV9,TRBJ2-3,CASVARDRGISSTDTQYF,1,0,1,1
TRBV6-2/3/5/6,TRBJ2-3,CASSYLPTSGSKSDTQYF,1,0,1,1
TRBV6-1,TRBJ1-6,CASSERDRGSSYNSPLHF,1,0,1,1
TRBV28,TRBJ2-2,CASSIFTLERLNTGELFF,1,0,1,1
TRBV5-6,TRBJ2-5,CASSFVVGAGDSGETQYF,1,0,1,1
TRBV7-6,TRBJ2-7,CASSLAGGRLAGSYEQYF,1,0,1,1
TRBV11-3,TRBJ2-5,CASSLGHLPSGTQETQYF,1,0,1,1
TRBV30,TRBJ2-1,CAWSVRGLAGVNNEQFF,1,0,1,1
TRBV10-3,TRBJ2-3,CAISDPHSGRARDTQYF,1,0,1,1
TRBV18,TRBJ2-3,CASSSIGPSKGTDTQYF,1,0,1,1
TRBV27,TRBJ2-1,CASSLSAAASSYNEQFF,1,0,1,1
TRBV28,TRBJ2-3,CASSTRRGGGVPDTQYF,1,0,1,1
TRBV5-4,TRBJ2-2,CASSFLSGSRDTGELFF,1,0,1,1
TRBV5-5,TRBJ1-5,CASSLSPGQVLEQPQHF,1,0,1,1
TRBV5-1,TRBJ2-3,CASSSRPGGPSTDTQYF,1,0,1,1
TRBV7-2,TRBJ2-7,CASSSGGLAGVQYEQYF,1,0,1,1
TRBV12-3/4,TRBJ2-3,CASSLSGGSGSQDTQYF,1,0,1,1
TRBV14,TRBJ2-1,CASSPRQREGPHNEQFF,1,0,1,1
TRBV7-3,TRBJ2-3,CASSRGQGEYPTDTQYF,1,0,1,1
TRBV14,TRBJ2-1,CASSQESRLPLYNEQFS,1,0,1,1
TRBV2,TRBJ1-1,CASSRGGRTGLTSLAFF,2,0,1,2
TRBV27,TRBJ2-1,CASRPGSGRVWANEQFF,1,0,1,1
TRBV5-1,TRBJ2-1,CASSIRTSGSPYNEQFF,2,0,1,2
TRBV20-1,TRBJ2-1,CSCGTSGGQSSYNEQFF,1,0,1,1
TRBV20-1,TRBJ2-5,CSASWQETLSTLETQYF,1,0,1,1
TRBV12-5,TRBJ2-1,CASGGSGSGAHNEQFF,1,0,1,1
TRBV19,TRBJ2-1,CASSMGYSGRANEQFF,1,0,1,1
TRBV19,TRBJ2-5,CASSTTYRDREETQYF,1,0,1,1
TRBV19,TRBJ2-3,CASSKRSSGNSDTQYF,1,0,1,1
TRBV19,TRBJ2-3,CASKGPSGGGVDTQYF,1,0,1,1
TRBV2,TRBJ1-3,CASGTLFGSSGNTIYF,1,0,1,1
TRBV28,TRBJ2-7,CASSLSGGGPTYEQYF,1,0,1,1
TRBV12-3/4,TRBJ2-6,CASSSSTGGRSNVLTF,1,0,1,1
TRBV6-2/3/5/6,TRBJ2-7,CASSYSNRPLSYEQYF,1,0,1,1
TRBV28,TRBJ2-3,CASSPSLSWATDTQYF,1,0,1,1
TRBV27,TRBJ2-3,CASSPGTSGSVDTQYF,1,0,1,1
TRBV2,TRBJ2-7,CASSGPGQGALHEQYF,1,0,1,1
TRBV2,TRBJ2-7,CASSDSGNRNSYEQYF,1,1,2,2
TRBV6-1,TRBJ2-3,CASSDKRRVNTDTQYF,1,0,1,1
TRBV2,TRBJ2-5,CASSELGGRAEETQYF,1,0,1,1
TRBV6-1,TRBJ1-5,CASSEAWGSINQPQHF,1,0,1,1
TRBV7-3,TRBJ2-3,CASSFRTTLAHVTQYF,1,0,1,1
TRBV5-6,TRBJ2-3,CASSLLAGGGTDTQYF,1,0,1,1
TRBV7-6,TRBJ2-1,CASSLGGRGRFNEQFF,1,0,1,1
TRBV7-6,TRBJ2-1,CASSLGILIHNNEQFF,1,0,1,1
TRBV25-1,TRBJ2-3,CASSLSEGSWADTQYF,2,0,1,2
TRBV7-2,TRBJ2-1,CASSLNPGGSYNEQFF,1,1,2,2
TRBV7-9,TRBJ1-1,CASSLNGYGRNAEAFF,1,0,1,1
TRBV7-9,TRBJ2-3,CASSPWTSGDTDTQYF,1,0,1,1
TRBV7-9,TRBJ2-1,CASSPRRVSSYNEQFF,1,0,1,1
TRBV3-1,TRBJ1-1,CASSHSQGGRGTEAFF,1,0,1,1
TRBV4-2,TRBJ2-1,CASSQESSSSYNEQFF,1,0,1,1
TRBV9,TRBJ2-1,CASSVEASGRVYEQFF,1,0,1,1
TRBV9,TRBJ2-2,CASSVETSWGAGELFF,1,0,1,1
TRBV6-2/3/5/6,TRBJ1-1,CASRPGTGVMNTEAFF,1,0,1,1
TRBV7-2,TRBJ2-1,CASRPGLAGGRNEQFF,1,0,1,1
TRBV2,TRBJ2-2,CASRADRRLGAGELFF,1,0,1,1
TRBV6-2/3/5/6,TRBJ2-7,CASRRKGQGFKYEQYF,1,0,1,1
TRBV10-2,TRBJ2-7,CASSMNLAGELDEQYF,1,0,1,1
TRBV5-1,TRBJ2-6,CASSLAPYSGANVLTF,1,0,1,1
TRBV5-1,TRBJ1-6,CASSSDTGNFYSPLHF,1,2,2,3
TRBV4-1,TRBJ2-1,CASSQVLTSGRQEQFF,1,0,1,1
TRBV5-1,TRBJ2-3,CASSDGTSGSTDTQYF,2,0,1,2
TRBV20-1,TRBJ1-1,CSARDHSGGRRWEAFF,1,0,1,1
TRBV29-1,TRBJ2-3,CSVVLGLAGRTDTQYF,1,0,1,1
TRBV28,TRBJ2-1,CAIKGQGGIMDEQFF,1,0,1,1
TRBV15,TRBJ2-1,CATSTGTSIYNEQFF,1,0,1,1
TRBV15,TRBJ2-3,CATSRGLDRVDTQYF,1,0,1,1
TRBV15,TRBJ2-3,CATSRDSGGPDTQYF,1,0,1,1
TRBV19,TRBJ1-3,CASRPKTGSGNTIYF,1,0,1,1
TRBV19,TRBJ2-5,CASMGLAAGQETQYF,1,0,1,1
TRBV19,TRBJ1-2,CASTLVAIRNYGYTF,1,0,1,1
TRBV19,TRBJ2-7,CASSSGTLSSYEQYF,1,0,1,1
TRBV19,TRBJ1-5,CASSIAPYSNQPQHF,2,3,2,5
TRBV19,TRBJ2-3,CASKETVGVTDTQYF,1,0,1,1
TRBV18,TRBJ2-2,CASSPFQGNTGELFF,1,0,1,1
TRBV18,TRBJ2-1,CASSPDRVGGNEQFF,2,0,1,2
TRBV18,TRBJ2-5,CASSPSQGWEETQYF,1,0,1,1
TRBV18,TRBJ1-2,CASSRERTGGYGYTF,1,0,1,1
TRBV6-2/3/5/6,TRBJ1-2,CASTLRRDSYYGYTF,1,1,2,2
TRBV12-3/4,TRBJ2-5,CASSFSGVRQETQYF,1,0,1,1
TRBV6-2/3/5/6,TRBJ2-6,CASSFRSSGANVLTF,1,0,1,1
TRBV12-3/4,TRBJ1-3,CASSLAPPSGNTIYF,1,0,1,1
TRBV7-3,TRBJ2-3,CASSSQPGGTDTQYF,1,0,1,1
TRBV6-2/3/5/6,TRBJ2-7,CASSSPQVLVYEQYF,1,0,1,1
TRBV6-2/3/5/6,TRBJ2-1,CASSYSGQGYNEQFF,1,0,1,1
TRBV6-2/3/5/6,TRBJ2-3,CASSYPDRGTDTQYF,1,0,1,1
TRBV28,TRBJ2-7,CASSPQPGLAYEQYF,1,0,1,1
TRBV6-2/3/5/6,TRBJ2-5,CASSQLAAIQETQYF,1,0,1,1
TRBV12-3/4,TRBJ2-1,CASSGPLGTRNEQFF,1,0,1,1
TRBV6-1,TRBJ1-4,CASSDGQAPNEKLFF,1,0,1,1
TRBV25-1,TRBJ2-7,CASSESYRGDLEQYF,1,0,1,1
TRBV6-2/3/5/6,TRBJ1-1,CASSTWGTPATEAFF,1,0,1,1
TRBV28,TRBJ2-7,CASSTPGSAGHEQYF,1,0,1,1
TRBV2,TRBJ2-7,CASSKEGTGAYEQYF,1,0,1,1
TRBV7-9,TRBJ2-5,CASSLAGGERDDQYF,1,0,1,1
TRBV7-9,TRBJ2-7,CASSLADYFTSEQYF,1,0,1,1
TRBV11-2,TRBJ2-4,CASSLGAIAKNIQYF,1,0,1,1
TRBV5-5,TRBJ2-5,CASSSSRTGRETQYF,1,0,1,1
TRBV7-2,TRBJ2-3,CASSWQGYPLDTQYF,1,0,1,1
TRBV5-4,TRBJ2-5,CASSLSGSPQETQYF,1,0,1,1
TRBV7-8,TRBJ2-1,CASSLGAADYNEQFF,1,0,1,1
TRBV11-1,TRBJ2-5,CASSPLADYQETQYF,1,0,1,1
TRBV7-2,TRBJ2-3,CASSPDSLGTDTQYF,1,0,1,1
TRBV3-1,TRBJ2-1,CASSQLAGGSGEQFF,1,0,1,1
TRBV11-2,TRBJ1-4,CASSQGDRENEKLFF,1,0,1,1
TRBV4-2,TRBJ2-7,CASSQDLAGSYEQYF,2,0,1,2
TRBV11-2,TRBJ2-3,CASSEGLLITDTQYF,1,0,1,1
TRBV28,TRBJ2-3,CASSIRQGSTDTQYF,1,0,1,1
TRBV2,TRBJ2-5,CASRGGGPYQETQYF,1,0,1,1
TRBV11-2,TRBJ2-1,CASRKPGSSYNEQFF,1,0,1,1
TRBV11-2,TRBJ2-3,CASNRGSGRADTQYF,1,0,1,1
TRBV5-1,TRBJ2-5,CASSPDRAGEETQCF,1,0,1,1
TRBV4-1,TRBJ2-7,CASSQAFASGDEQYF,1,0,1,1
TRBV5-1,TRBJ1-4,CASSVDRVTNEKLFF,1,0,1,1
TRBV5-1,TRBJ1-2,CASSEGSGGYYGYTF,1,0,1,1
TRBV5-1,TRBJ2-3,CASRSSPVDTDTQYF,1,0,1,1
TRBV20-1,TRBJ2-7,CSASQGQRGSYEQYF,1,0,1,1
TRBV20-1,TRBJ2-5,CSAPSRGQLQETQYF,1,0,1,1
TRBV20-1,TRBJ2-1,CSARTSGRATDEQFF,1,0,1,1
TRBV20-1,TRBJ1-2,CSAIPFRQGPTGYTF,1,0,1,1
TRBV20-1,TRBJ2-1,CSATQRRSVINEQFF,1,0,1,1
TRBV20-1,TRBJ2-1,CSASIGTSSYNEQFF,1,0,1,1
TRBV20-1,TRBJ2-1,CSARLIAGDPNEQFF,1,0,1,1
TRBV20-1,TRBJ1-5,CSARDSGRGHQPQHF,1,0,1,1
TRBV20-1,TRBJ2-6,CSARDRITGANVLTF,1,0,1,1
TRBV29-1,TRBJ2-1,CSVTPGLAGGNEQFF,1,0,1,1
TRBV5-6,TRBJ2-5,RASSPGAGRRETQYF,1,0,1,1
TRBV7-6,TRBJ1-6,CASSLAGGNSPLHF,1,0,1,1
TRBV10-3,TRBJ2-3,CAISPGTDQDTQYF,1,0,1,1
TRBV24-1,TRBJ2-1,CATAGTRGNNEQFF,1,0,1,1
TRBV24-1,TRBJ2-1,CATRGRPGSGEQFF,1,0,1,1
TRBV19,TRBJ1-2,CASSEDRGWYGYTF,1,0,1,1
TRBV19,TRBJ2-1,CASRELAEHNEQFF,1,0,1,1
TRBV19,TRBJ2-7,CASRRTSGISEQYF,1,2,2,3
TRBV18,TRBJ2-5,CASSPPGLYQTQYF,2,0,1,2
TRBV18,TRBJ1-6,CASSQREGNSPLHF,1,0,1,1
TRBV28,TRBJ2-3,CASVPGTLPGTQYF,1,0,1,1
TRBV7-2,TRBJ1-4,CASGRVTPNEKLFF,1,0,1,1
TRBV7-9,TRBJ2-6,CASTSLSGANVLTF,1,0,1,1
TRBV12-3/4,TRBJ2-7,CASSFSGAKGEQYF,1,0,1,1
TRBV28,TRBJ2-5,CASSFLSTEETQYF,1,0,1,1
TRBV27,TRBJ1-4,CASSLFADNEKLFL,1,0,1,1
TRBV6-2/3/5/6,TRBJ1-5,CASSYRDRYQPQHF,1,0,1,1
TRBV12-3/4,TRBJ2-1,CASSRTEISNEQFF,1,0,1,1
TRBV6-1,TRBJ2-3,CASSVGPEGDTQYF,1,0,1,1
TRBV2,TRBJ2-4,CASSEEVGKNIQYF,1,1,2,2
TRBV2,TRBJ2-7,CASSENRGQGEQYF,1,0,1,1
TRBV5-4,TRBJ2-5,CASSLVSGGETQYF,1,0,1,1
TRBV7-2,TRBJ2-3,CASSLVSGPDTQYF,1,0,1,1
TRBV7-2,TRBJ2-1,CASSLAGSDNEQFF,1,0,1,1
TRBV11-2,TRBJ2-1,CASSLGQGYGEQFF,2,0,1,2
TRBV7-2,TRBJ2-5,CASSSSRPQGTQYF,2,0,1,2
TRBV5-4,TRBJ2-2,CASSSDRGTGELFF,1,0,1,1
TRBV28,TRBJ2-7,CASSLPPPPYEQYF,1,0,1,1
TRBV4-2,TRBJ2-5,CASSLDLGEETQYF,1,0,1,1
TRBV7-2,TRBJ2-7,CASSPTSGRLEQYF,1,0,1,1
TRBV5-4,TRBJ2-5,CASSRQGAGETQYF,1,0,1,1
TRBV7-2,TRBJ2-4,CASSREVVENIQYF,1,0,1,1
TRBV3-1,TRBJ2-6,CASSHPSGANVLTF,1,0,1,1
TRBV3-1,TRBJ2-5,CASSQRGARETQYF,1,0,1,1
TRBV3-1,TRBJ2-7,CASSQGISPGEQYF,1,0,1,1
TRBV3-1,TRBJ2-7,CASSQDWGGSEQYF,1,0,1,1
TRBV6-2/3/5/6,TRBJ1-6,CASSDWGGNSPLHF,1,0,1,1
TRBV12-3/4,TRBJ1-1,CASSSDRGGTEAFF,1,0,1,1
TRBV28,TRBJ2-7,CASRSRGPTYEQYF,1,0,1,1
TRBV6-2/3/5/6,TRBJ2-5,CASRGGGSVKTQYF,1,0,1,1
TRBV10-3,TRBJ2-2,CASRRHPNTGELFF,1,0,1,1
TRBV12-3/4,TRBJ2-1,CASNLGRSYNEQFF,1,0,1,1
TRBV2,TRBJ1-1,CASNKGLLNPEAFF,1,0,1,1
TRBV2,TRBJ2-7,CARGGPGQPYEQYF,1,1,2,2
TRBV19,TRBJ2-5,CDSRLRAGRETQYF,1,0,1,1
TRBV5-1,TRBJ2-7,CASARGVPAYEQHF,1,0,1,1
TRBV5-1,TRBJ2-1,CASAGTSGSNEQFF,1,0,1,1
TRBV10-2,TRBJ2-5,CASSRETGRETQYF,1,0,1,1
TRBV5-1,TRBJ2-3,CASSLYLSSGTQYF,1,0,1,1
TRBV5-1,TRBJ2-7,CASSSAGVANEQYF,1,0,1,1
TRBV5-1,TRBJ2-1,CASSPGTSANEQFF,1,0,1,1
TRBV4-1,TRBJ2-7,CASSQEGLVDEQYF,1,0,1,1
TRBV5-1,TRBJ2-2,CASRISGDTGELFF,1,0,1,1
TRBV20-1,TRBJ2-3,CSSRQAKMTDTQYF,1,0,1,1
TRBV20-1,TRBJ2-7,CSALRPSATYEQYF,1,0,1,1
TRBV20-1,TRBJ1-5,CSAGPDRGDQPQHF,1,0,1,1
TRBV20-1,TRBJ2-1,CSATGTTGGKGQFF,1,0,1,1
TRBV20-1,TRBJ2-7,CSASVSSGAYEQYF,1,0,1,1
TRBV20-1,TRBJ2-1,CSASPGLADNEQFF,1,0,1,1
TRBV20-1,TRBJ2-6,CSASGGSGANVLTF,1,0,1,1
TRBV20-1,TRBJ2-3,CSARGGVATDTQYF,1,1,2,2
TRBV20-1,TRBJ2-5,CSARLDRGRETQYF,2,1,2,3
TRBV20-1,TRBJ2-1,CSEVGGTELNEQFF,1,0,1,1
TRBV29-1,TRBJ2-1,CSVVRGWFYNEQFF,1,0,1,1
TRBV29-1,TRBJ2-1,CSVERLAGGNEQFF,1,0,1,1
TRBV29-1,TRBJ2-7,CSVESGQGTYEQYF,1,0,1,1
TRBV29-1,TRBJ2-2,CSVEGGNDTGELFS,1,0,1,1
TRBV29-1,TRBJ2-5,CSVGGQGGGETQYF,1,1,2,2
TRBV29-1,TRBJ2-1,CSVIQRSSYNEQFF,1,0,1,1
TRBV29-1,TRBJ2-1,CSAGQGASYNEQFF,1,0,1,1
TRBV12-5,TRBJ2-4,CASGSEPMDIQYF,1,0,1,1
TRBV7-9,TRBJ2-1,CAWGLAGGDEQFF,1,0,1,1
TRBV30,TRBJ2-7,CAWSLTRTYEQYF,1,0,1,1
TRBV28,TRBJ2-3,CATWTETTDTQYF,1,0,1,1
TRBV7-2,TRBJ2-5,CASNRDRQETQYF,1,0,1,1
TRBV18,TRBJ1-2,CASSPESNYGYTF,1,0,1,1
TRBV28,TRBJ2-3,CASWDSPSDTQYF,1,0,1,1
TRBV28,TRBJ2-3,CASSFRNADTQYF,1,0,1,1
TRBV12-3/4,TRBJ2-7,CASSFELAARQYF,1,0,1,1
TRBV12-3/4,TRBJ2-7,CASSFRELYEQYF,1,0,1,1
TRBV12-3/4,TRBJ2-1,CASSFGAIGEQFF,1,0,1,1
TRBV6-2/3/5/6,TRBJ2-1,CASSLSRYGEQFF,1,0,1,1
TRBV12-3/4,TRBJ1-1,CASSLGPNTEAFF,1,1,2,2
TRBV12-3/4,TRBJ2-7,CASSSSGSYEQYF,1,0,1,1
TRBV7-9,TRBJ1-1,CASSPNGNTEAFF,1,0,1,1
TRBV6-1,TRBJ2-3,CASSRAPLNTQYF,1,1,2,2
TRBV2,TRBJ2-1,CASSTSFEGEQFF,1,0,1,1
TRBV5-4,TRBJ1-2,CASSFGAGNGYTF,1,0,1,1
TRBV7-9,TRBJ1-2,CASSFDRGGGYTF,1,0,1,1
TRBV7-2,TRBJ1-5,CASSLWRDQPQHF,2,2,2,4
TRBV5-6,TRBJ2-1,CASSLGARNEQFF,1,0,1,1
TRBV7-2,TRBJ2-4,CASSLDRSNIQYF,1,0,1,1
TRBV7-2,TRBJ2-5,CASSLGSRTSQYF,1,0,1,1
TRBV11-2,TRBJ1-2,CASSLEANYGYTF,1,0,1,1
TRBV7-3,TRBJ2-7,CASSLNLAGEQYF,1,0,1,1
TRBV7-9,TRBJ1-5,CASSSHGNQPQHF,1,0,1,1
TRBV7-2,TRBJ2-1,CASSSHRAEEQFF,1,0,1,1
TRBV3-1,TRBJ2-1,CASSLRRGNEQFF,1,0,1,1
TRBV3-1,TRBJ2-1,CASSPQAFNEQFF,2,0,1,2
TRBV14,TRBJ1-4,CASSPRVDEKLFF,1,0,1,1
TRBV7-9,TRBJ1-2,CASSRGQNYGYTF,1,1,2,2
TRBV11-1,TRBJ2-3,CASSRTGTDTQYF,1,0,1,1
TRBV3-1,TRBJ2-7,CASSRLASYEQYF,1,0,1,1
TRBV5-4,TRBJ2-5,CASSVTSRETQYF,1,0,1,1
TRBV7-8,TRBJ2-5,CASSIGTSGTQYF,1,0,1,1
TRBV7-8,TRBJ2-3,CASSTTTVNPGYF,1,0,1,1
TRBV6-2/3/5/6,TRBJ2-7,CASRSTQANEQYF,1,0,1,1
TRBV2,TRBJ1-5,CASRLGEDQPQHF,1,0,1,1
TRBV6-2/3/5/6,TRBJ2-5,CASRRRVQETQYF,1,0,1,1
TRBV6-2/3/5/6,TRBJ2-2,CASRIQGTGELFF,1,0,1,1
TRBV5-1,TRBJ2-5,CASSFAGQETQYF,2,0,1,2
TRBV5-1,TRBJ2-1,CASSFLAGDEQFF,1,0,1,1
TRBV20-1,TRBJ2-3,CSAQTLLTDTQYF,1,0,1,1
TRBV20-1,TRBJ1-5,CSAAAIPNQPQHF,1,0,1,1
TRBV20-1,TRBJ2-5,CSASQAGRETQYF,1,0,1,1
TRBV20-1,TRBJ2-7,CSANSPVTYEQYF,1,0,1,1
TRBV29-1,TRBJ1-1,CSFVETVNTEAFF,1,0,1,1
TRBV29-1,TRBJ1-1,CSVSTGAGAEAFF,1,0,1,1
TRBV29-1,TRBJ2-6,CSVVQGGANVLTF,2,0,1,2
TRBV29-1,TRBJ1-5,CSVVTTLNQPQHF,1,0,1,1
TRBV29-1,TRBJ2-7,CSVARGDLPEQYF,1,0,1,1
TRBV29-1,TRBJ2-7,CSVEGGRNYEQYF,2,0,1,2
TRBV29-1,TRBJ2-7,CSVGVRVKDEQYF,1,0,1,1
TRBV20-1,TRBJ2-7,CSAIRDGSYEQYF,1,0,1,1
TRBV29-1,TRBJ2-5,CSAPRQGEETQYF,1,0,1,1
TRBV29-1,TRBJ2-7,CSAATAQPYEQYF,1,0,1,1
TRBV6-2/3/5/6,TRBJ2-5,YASSPGLSETQYF,1,0,1,1
TRBV12-3/4,TRBJ1-1,GASSFSANTEAFF,1,0,1,1
TRBV24-1,TRBJ2-1,CATSDRTSEQFF,1,0,1,1
TRBV18,TRBJ1-2,CASSSMGMGYTF,1,0,1,1
TRBV18,TRBJ2-1,CASSPRDREQFF,1,0,1,1
TRBV9,TRBJ2-7,CASIDRPYEQYF,1,0,1,1
TRBV6-2/3/5/6,TRBJ2-2,CASTAGAGELFF,1,0,1,1
TRBV28,TRBJ2-5,CASSLSQETQYF,1,0,1,1
TRBV28,TRBJ1-2,CASSYGEYGYTF,1,0,1,1
TRBV12-3/4,TRBJ2-5,CASSGAGETQYF,1,0,1,1
TRBV6-4,TRBJ2-3,CASSDSTDTQYF,1,0,1,1
TRBV6-4,TRBJ2-7,CASSDYLGVQYF,1,0,1,1
TRBV6-2/3/5/6,TRBJ2-5,CASSTTRETQYF,1,0,1,1
TRBV7-9,TRBJ2-7,CASSLAVGEQYF,2,3,2,5
TRBV3-1,TRBJ2-2,CASSYSVGELFF,1,0,1,1
TRBV12-3/4,TRBJ2-4,CASSHVENIQYF,1,0,1,1
TRBV5-4,TRBJ2-1,CASSVYHNEQFF,1,0,1,1
TRBV6-2/3/5/6,TRBJ2-1,CASNPGTNEQFF,1,0,1,1
TRBV20-1,TRBJ2-3,CAGAGNTDTQYF,1,2,2,3
TRBV20-1,TRBJ2-4,CSARTGENIQYF,1,0,1,1
TRBV29-1,TRBJ2-1,CSVTSGNNEQFF,1,0,1,1
TRBV29-1,TRBJ2-4,CSVAGQSNIQYF,1,0,1,1
TRBV29-1,TRBJ2-1,CSVGLADNEQFF,1,0,1,1
TRBV29-1,TRBJ2-5,CSATGDRETQYF,1,0,1,1
TRBV29-1,TRBJ1-5,CSARDSNQPQHF,1,0,1,1
TRBV7-9,TRBJ2-7,CASGGAHEQYF,1,0,1,1
TRBV14,TRBJ2-6,CASGGANVLTF,1,0,1,1
TRBV28,TRBJ2-5,CASTSGTWQYF,1,0,1,1
TRBV12-3/4,TRBJ1-2,CASTLQGGYTF,1,0,1,1
TRBV7-9,TRBJ2-5,CASSFRGTQYF,1,0,1,1
TRBV5-4,TRBJ2-1,CASSLSREQFF,1,0,1,1
TRBV11-2,TRBJ2-1,CASSLEGIQFF,1,0,1,1
TRBV7-9,TRBJ2-1,CASSNRDHPVI,1,0,1,1
TRBV29-1,TRBJ1-2,CSVVSFYGYTF,1,0,1,1
TRBV29-1,TRBJ2-5,CSVGEVRTQYF,1,0,1,1
TRBV7-3,TRBJ1-4,RASSYAEKLFF,1,0,1,1
TRBV28,TRBJ2-7,CASGQYEQYF,1,0,1,1
TRBV7-2,TRBJ2-1,CASSANEQFF,1,3,2,4
TRBV29-1,TRBJ2-5,CSVESETQYF,1,0,1,1
TRBV29-1,TRBJ1-1,CSVSGTKAFF,1,0,1,1
TRBV28,TRBJ2-7,CASRRAPGHRLWYERYF,1,0,1,1
TRBV14,TRBJ2-1,CAGSQGSWTSRFEQIF,2,0,1,2
TRBV5-6,TRBJ1-5,CASSFWGRSSNQPQHF,1,0,1,1
TRBV3-1,TRBJ2-7,CASSQVGDTSSYEQYF,1,0,1,1
TRBV19,TRBJ2-2,CASSQGGGSKGELFF,1,0,1,1
TRBV18,TRBJ2-7,CASSAMGTSSGEQYF,1,0,1,1
TRBV12-3/4,TRBJ2-7,CASSFGSGSSYEQYF,1,0,1,1
TRBV9,TRBJ2-7,CASSVEPARTYEQYF,1,0,1,1
TRBV20-1,TRBJ2-1,CSASAGTSINNERFF,1,0,1,1
TRBV6-2/3/5/6,TRBJ1-1,CASSYRLNTEAFF,1,0,1,1
TRBV28,TRBJ2-1,CASTRTTFEQFF,1,0,1,1
TRBV14,TRBJ2-2,CASSQPPGSERNTGELFF,1,0,1,1
TRBV6-2/3/5/6,TRBJ2-7,CASSPGRDRGIYEQYF,1,0,1,1
TRBV6-2/3/5/6,TRBJ2-3,CASSLTGTVSTDTQYF,1,0,1,1
TRBV6-1,TRBJ1-1,CASSELGEADTEAFF,1,0,1,1
TRBV6-2/3/5/6,TRBJ2-1,CASSPGLAGDHEQFF,2,0,1,2
TRBV7-9,TRBJ2-7,CASSQRQGLSYEQYF,1,0,1,1
TRBV9,TRBJ1-3,CASSARGSSGNTIYF,1,0,1,1
TRBV19,TRBJ2-7,CGSSPPLTGAGEQYF,1,0,1,1
TRBV7-9,TRBJ2-7,CASSLSASGFEQYF,1,0,1,1
TRBV7-9,TRBJ2-3,CASSLARLGDTQYF,2,0,1,2
TRBV5-5,TRBJ2-7,CASSSPGRGYEQYY,2,0,1,2
TRBV5-1,TRBJ2-3,CASSLETRADTQYF,1,0,1,1
TRBV11-2,TRBJ1-1,CASSLTGQSTEAFF,1,0,1,1
TRBV28,TRBJ2-4,CASGTSDKNIQYY,1,0,1,1
TRBV18,TRBJ2-7,CASSPGPIYEQYF,1,0,1,1
TRBV12-3/4,TRBJ2-7,CASSRGSSYEQYF,1,0,1,1
TRBV5-1,TRBJ2-1,CASGSGGRTEQFF,1,0,1,1
TRBV5-1,TRBJ2-1,CASSFEGGGEQFF,1,0,1,1
TRBV29-1,TRBJ2-7,CSVEDPGDYEQYF,1,0,1,1
TRBV19,TRBJ2-1,CASPREQGTSGKAYTYNEQFF,1,0,1,1
TRBV6-2/3/5/6,TRBJ2-1,CASSYLLAGTSGSRPYNEQFF,1,0,1,1
TRBV6-1,TRBJ2-1,CASSEREGQRSLVLRPGEQFY,1,0,1,1
TRBV19,TRBJ2-2,CASSRLQGWTSGNTGELVF,1,0,1,1
TRBV4-2,TRBJ2-2,CASSQAPGLAGPNTGELFF,1,0,1,1
TRBV12-5,TRBJ2-6,CASGIWGRTFSGANVLTF,1,0,1,1
TRBV19,TRBJ2-3,CASSIDPLRRISTDTQYF,1,0,1,1
TRBV7-9,TRBJ2-3,CASISQPIGTGRTDTQYF,1,0,1,1
TRBV28,TRBJ2-5,CASSLLTLRKQGRETQYF,1,0,1,1
TRBV27,TRBJ2-7,CASSLSESGTIVPYEQYF,1,0,1,1
TRBV28,TRBJ2-5,CASSLGTSLAGVGETQYF,1,1,2,2
TRBV7-2,TRBJ2-4,CASSSIPQGWGTKNIQYF,1,0,1,1
TRBV7-2,TRBJ2-7,CASSYRTSGPITSYEQYF,1,0,1,1
TRBV3-1,TRBJ2-5,CASSQDSALAGDQETQYL,1,0,1,1
TRBV20-1,TRBJ2-1,CSASLPGSGTFSYNEQFF,1,0,1,1
TRBV20-1,TRBJ2-3,CSARLLVVAARQRDTQYF,1,0,1,1
TRBV15,TRBJ2-7,CATSRDLRASGTHEQYF,1,0,1,1
TRBV19,TRBJ2-3,CASSYSGRATYVDTQYF,1,0,1,1
TRBV19,TRBJ1-1,CASSPQGQGFMNTEAFF,1,0,1,1
TRBV19,TRBJ1-5,CASSIGPQGASNQPQHF,1,0,1,1
TRBV19,TRBJ2-5,CASSMSLRERKGETQYF,1,0,1,1
TRBV18,TRBJ2-1,CASSPTVGIAGDNEQFF,1,0,1,1
TRBV28,TRBJ2-1,CASTSSGRIQSYNEQFF,1,0,1,1
TRBV12-3/4,TRBJ2-2,CASSSKLAGVMGGELFF,1,0,1,1
TRBV28,TRBJ2-1,CASSLHLGGPTNNEQFF,1,0,1,1
TRBV25-1,TRBJ2-1,CASSEWERPSSYNEQFF,1,0,1,1
TRBV6-1,TRBJ2-1,CASSEWERPSSYNEQSF,1,0,1,1
TRBV5-6,TRBJ2-7,CASSFRAAGTESYEQYF,1,0,1,1
TRBV11-1,TRBJ2-1,CASSFSSGGFEYNEQFF,1,0,1,1
TRBV13,TRBJ2-1,CASSFGLAGGSYNEQFF,1,0,1,1
TRBV7-2,TRBJ2-4,CASSLRQGLLAKNIQYF,1,0,1,1
TRBV7-9,TRBJ2-5,CASSLARFGTPGETQYF,1,0,1,1
TRBV7-9,TRBJ2-7,CASSLRLAGVRVYEQYF,1,0,1,1
TRBV7-6,TRBJ2-1,CASSLRTAVGPYNEQFF,1,0,1,1
TRBV7-2,TRBJ2-7,CASSSFRAGTPTYEQYF,1,0,1,1
TRBV7-6,TRBJ2-1,CASSPRRGGGLYNEQFF,1,1,2,2
TRBV7-6,TRBJ2-1,CASSPGVSGRAYNEQFF,1,0,1,1
TRBV7-9,TRBJ2-7,CASSPTGQGGKNYEQYF,1,0,1,1
TRBV14,TRBJ2-3,CASSQDLAGGSADTQYF,1,0,1,1
TRBV3-1,TRBJ2-5,CASSQDRDRGSQETQYF,1,0,1,1
TRBV9,TRBJ2-5,CASSVGLAGGGQETQYF,1,0,1,1
TRBV7-2,TRBJ2-1,CASSGRGVAGGGNEQFF,1,0,1,1
TRBV5-1,TRBJ2-7,CASGGLAGGPLDYEQYF,1,0,1,1
TRBV5-1,TRBJ2-3,CASSLATAGGPEDTQYF,1,0,1,1
TRBV5-1,TRBJ2-7,CASSLGLGRTSPIEQYF,1,0,1,1
TRBV5-1,TRBJ2-1,CASSPGRGQGSYNEQFF,1,0,1,1
TRBV20-1,TRBJ2-5,CSAPRTSGSFAGETQYF,1,0,1,1
TRBV29-1,TRBJ2-2,CSVVGGGTSEDTGELFF,1,0,1,1
TRBV29-1,TRBJ2-1,CSVEGPGTSLEYNEQFF,1,0,1,1
TRBV12-5,TRBJ2-3,CASGLASGRATDTQYF,1,0,1,1
TRBV10-3,TRBJ1-6,CAIRPGTGAYNSPLHF,1,1,2,2
TRBV24-1,TRBJ2-2,CATSDATSGWTGELFF,1,0,1,1
TRBV15,TRBJ2-3,CATSSGTSPSTDTQYF,1,0,1,1
TRBV15,TRBJ2-6,CATSRHFGAGANVLTF,1,0,1,1
TRBV19,TRBJ2-3,CASALGPGTGDWGQYF,1,0,1,1
TRBV19,TRBJ1-5,CASSPRQRTNNQPQHF,1,0,1,1
TRBV19,TRBJ2-5,CASSPSGLRGQETQYF,1,0,1,1
TRBV19,TRBJ2-1,CASSIVSAEPYNEQFF,1,3,2,4
TRBV19,TRBJ2-1,CASSIETTSGRGEQFF,1,0,1,1
TRBV19,TRBJ2-7,CASSTGLAGGTYEQYF,2,1,2,3
TRBV19,TRBJ2-1,CASSSSGSAPYNEQFF,1,0,1,1
TRBV19,TRBJ1-5,CASSRARTGDNQPQHF,1,0,1,1
TRBV18,TRBJ2-3,CASSPLNMGSTDTQYF,1,0,1,1
TRBV18,TRBJ1-1,CASSPLSEGVNTEAFF,1,0,1,1
TRBV18,TRBJ2-6,CASSPPGISGANVLTF,1,0,1,1
TRBV18,TRBJ1-3,CASSPPGESSGNTIYF,1,0,1,1
TRBV2,TRBJ2-1,CASTLEPGQGFVGLIF,1,0,1,1
TRBV6-2/3/5/6,TRBJ2-5,CASSFTSGSIRETQYF,1,0,1,1
TRBV28,TRBJ2-3,CASSLMGRASGSGTDF,1,0,1,1
TRBV6-2/3/5/6,TRBJ2-1,CASSSPLAGDLIEQFF,1,0,1,1
TRBV6-2/3/5/6,TRBJ2-1,CASSSQLADIYNEQFF,1,0,1,1
TRBV12-3/4,TRBJ1-6,CASSPKDRGRNSPLHF,1,0,1,1
TRBV25-1,TRBJ2-3,CASSAQGGLGTDTQYF,1,0,1,1
TRBV27,TRBJ2-2,CASSTYRGPVPGELFF,1,0,1,1
TRBV7-9,TRBJ2-3,CASSFTSRGEADTQYF,1,0,1,1
TRBV5-4,TRBJ2-1,CASSFRTSGSGNEQFF,1,0,1,1
TRBV5-4,TRBJ2-3,CASSLAGRGSTDTQYF,1,1,2,2
TRBV5-6,TRBJ2-2,CASSLATGVNTGELFF,1,0,1,1
TRBV11-2,TRBJ2-2,CASSLFGGEVTGELFF,1,0,1,1
TRBV11-2,TRBJ2-1,CASSLVGGGRGNEQFF,1,0,1,1
TRBV13,TRBJ2-7,CASSLGRDGSIFEQYF,1,0,1,1
TRBV11-2,TRBJ1-1,CASSLEWGASRTEAFF,1,0,1,1
TRBV9,TRBJ2-3,CASSLRRQGVTDTQYF,1,0,1,1
TRBV7-2,TRBJ2-3,CASSPLSGTVTDTRYF,1,0,1,1
TRBV5-6,TRBJ2-1,CASSPLSGSSYNEQFF,1,0,1,1
TRBV7-6,TRBJ2-3,CASSRRGQGAGNTQYF,1,0,1,1
TRBV7-9,TRBJ2-5,CASSRRLGNTKETQYF,1,0,1,1
TRBV14,TRBJ2-2,CASSHLQGASTGELFF,1,0,1,1
TRBV3-1,TRBJ2-1,CASSQGEGWKSDEQFF,1,0,1,1
TRBV4-2,TRBJ1-1,CASSQDYRQGNTEAFF,2,0,1,2
TRBV14,TRBJ2-1,CASSQDPREPRNEQFF,1,0,1,1
TRBV14,TRBJ2-2,CASSQERVKNTGELFF,1,1,2,2
TRBV5-6,TRBJ2-2,CASSKVAGEYTGELFF,1,0,1,1
TRBV2,TRBJ2-1,CASREGVWESGNEQFF,1,0,1,1
TRBV2,TRBJ2-1,CASRPGLDTGVGEQFF,1,0,1,1
TRBV10-2,TRBJ2-2,CASSRNGGTNTGELFF,1,0,1,1
TRBV5-1,TRBJ2-1,CASSFGGASSYNEQFF,1,0,1,1
TRBV5-1,TRBJ2-7,CASSLGSGGRGYEQYF,1,0,1,1
TRBV11-3,TRBJ2-1,CASSLGTSGGYNEQFF,1,1,2,2
TRBV5-1,TRBJ1-1,CASSLESGQGNTEAFF,1,0,1,1
TRBV5-1,TRBJ2-5,CASSLTSQPDRETQYF,1,0,1,1
TRBV5-1,TRBJ1-1,CASSLYLTGWNTEAFF,2,2,2,4
TRBV5-1,TRBJ2-1,CASSLQGGSSYNEQYF,1,0,1,1
TRBV4-1,TRBJ1-5,CASSRGGVPGGQPQHF,1,0,1,1
TRBV5-1,TRBJ2-5,CASSTGQGGLQETQYF,1,0,1,1
TRBV20-1,TRBJ2-7,CSALDGRGGVRDVQYF,1,0,1,1
TRBV20-1,TRBJ2-1,CSASDPAAGGYNEQFF,1,0,1,1
TRBV20-1,TRBJ2-1,CSARDSGRALYNEQFF,1,0,1,1
TRBV20-1,TRBJ2-5,CSARAQVSIYQETQYF,1,0,1,1
TRBV20-1,TRBJ2-2,CSARDGGRGYTGELFF,1,0,1,1
TRBV20-1,TRBJ2-1,CSAREIGGRSYNEQFF,2,0,1,2
TRBV20-1,TRBJ2-5,CSAQSAWGDRQETQYF,1,0,1,1
TRBV20-1,TRBJ2-1,CSATRTGSFVYNEQFF,1,0,1,1
TRBV29-1,TRBJ2-1,CSVEGVAGARGYEQFF,1,0,1,1
TRBV29-1,TRBJ2-6,CSVEEDGTAGANVLTF,1,1,2,2
TRBV29-1,TRBJ2-4,CSVSPWTGSPKNIQYF,2,2,2,4
TRBV7-3,TRBJ2-2,RASSPSGSMNTGELFF,1,0,1,1
TRBV11-2,TRBJ2-3,RASSSGTSQVTDTQYF,1,0,1,1
TRBV7-3,TRBJ2-7,RASSSGLAGGTYEQYF,1,0,1,1
TRBV10-3,TRBJ2-3,CAISAGTGDTDTQYF,1,0,1,1
TRBV15,TRBJ2-5,CATSRERAGQETQYF,1,0,1,1
TRBV19,TRBJ2-2,CASTPPGRNTGELFF,1,0,1,1
TRBV19,TRBJ1-1,CASTTRGFMNTEAFF,1,0,1,1
TRBV19,TRBJ2-6,CASSSGTSGANVLTF,1,0,1,1
TRBV19,TRBJ2-7,CASSSIEAGVFVQYF,1,0,1,1
TRBV19,TRBJ2-1,CASSTGTSGHNEQFF,1,0,1,1
TRBV19,TRBJ2-7,CASSNGDESSYEQYF,1,0,1,1
TRBV18,TRBJ1-6,CASSPGQGSNSPLHF,1,0,1,1
TRBV18,TRBJ2-5,CASSPPGQNKETQYF,1,1,2,2
TRBV18,TRBJ2-1,CASSPGLAVYNEQFF,1,0,1,1
TRBV18,TRBJ2-6,CASSPSWDSATPLTF,1,0,1,1
TRBV18,TRBJ2-7,CASSPRITDAYEQYF,1,0,1,1
TRBV18,TRBJ1-5,CASSPQGGGNQPQHF,1,0,1,1
TRBV5-4,TRBJ2-3,CASRRAGEKADTQYF,1,0,1,1
TRBV12-3/4,TRBJ2-1,CASIEGLAGANEQFF,1,0,1,1
TRBV7-9,TRBJ2-1,CASTSPGPKNNEQFF,1,1,2,2
TRBV7-8,TRBJ2-1,CASTLGRLSYNEQFF,1,0,1,1
TRBV12-3/4,TRBJ1-5,CASTRDRGSNQPQHF,1,0,1,1
TRBV2,TRBJ2-6,CASTDRDVGANVLTF,1,0,1,1
TRBV12-3/4,TRBJ1-3,CASSFGFDSGSTIYF,1,0,1,1
TRBV27,TRBJ1-5,CASSLSFRGVQPQHF,1,0,1,1
TRBV12-3/4,TRBJ2-1,CASSLGLAEGNEQFF,1,1,2,2
TRBV6-2/3/5/6,TRBJ2-5,CASSLGQGYQETQYF,1,0,1,1
TRBV27,TRBJ2-7,CASSLSSAGPYEQYF,1,0,1,1
TRBV6-2/3/5/6,TRBJ2-5,CASSLGGRAEETQYF,1,0,1,1
TRBV27,TRBJ2-1,CASSLEGTGVYEQFF,1,0,1,1
TRBV6-2/3/5/6,TRBJ2-1,CASSSLASGINEQFF,1,0,1,1
TRBV6-2/3/5/6,TRBJ2-1,CASSSSGTGGGEQFF,1,0,1,1
TRBV6-2/3/5/6,TRBJ2-3,CASSYWGDPSDTQYF,1,0,1,1
TRBV6-2/3/5/6,TRBJ1-4,CASSYRAAKIEKLFF,1,0,1,1
TRBV12-3/4,TRBJ1-5,CASSPSDRGNQPQHF,1,0,1,1
TRBV28,TRBJ2-1,CASSRTGGAHNEQFF,1,0,1,1
TRBV6-1,TRBJ1-5,CASSQDRGLGQPQHF,1,0,1,1
TRBV6-1,TRBJ2-5,CASSVGPPGWETQYF,1,0,1,1
TRBV2,TRBJ1-1,CASSAGRQMNTEAFF,1,0,1,1
TRBV6-1,TRBJ2-5,CASSADRARAETQYF,1,0,1,1
TRBV6-1,TRBJ2-3,CASSAGAHSTDTQYF,1,0,1,1
TRBV6-1,TRBJ1-2,CASSDGGAGSYGYTF,1,0,1,1
TRBV2,TRBJ2-7,CASSEVRHPLDEQYF,1,0,1,1
TRBV2,TRBJ2-7,CASSELGQGYYEQYF,1,0,1,1
TRBV28,TRBJ2-1,CASSIQTSGRRAQFF,1,1,2,2
TRBV28,TRBJ2-7,CASSIAGTGTYEQYF,1,0,1,1
TRBV7-9,TRBJ2-1,CASSFGLAVINEQFF,1,0,1,1
TRBV5-5,TRBJ2-1,CASSLLRLASHEQFF,1,0,1,1
TRBV7-2,TRBJ2-2,CASSLVRASTGELFF,1,0,1,1
TRBV7-2,TRBJ2-5,CASSLAPTGVETQYF,1,0,1,1
TRBV5-8,TRBJ2-7,CASSLGTLHSYEQYF,1,0,1,1
TRBV7-9,TRBJ2-7,CASSLQGDRVNEQYF,1,0,1,1
TRBV7-9,TRBJ2-1,CASSLGDRAKGEQFF,1,0,1,1
TRBV11-2,TRBJ2-3,CASSLDRAGTDTQYF,1,0,1,1
TRBV11-3,TRBJ2-1,CASSSSGKVWNELFF,1,0,1,1
TRBV7-2,TRBJ2-5,CASSSTAGVGETQYF,1,0,1,1
TRBV5-4,TRBJ2-1,CASSYWTSGRDEQFF,1,0,1,1
TRBV7-2,TRBJ2-7,CASSLTGLAGAEQYF,1,0,1,1
TRBV7-2,TRBJ2-1,CASSPGSHSYNEQFF,1,0,1,1
TRBV9,TRBJ2-1,CASSPGLAWYNEQFF,1,0,1,1
TRBV14,TRBJ2-1,CASSQGDRGNDEQFF,1,0,1,1
TRBV14,TRBJ2-1,CASSQMRGAGNEQFF,1,0,1,1
TRBV14,TRBJ2-5,CASSQQNGRQETQYF,1,0,1,1
TRBV3-1,TRBJ2-7,CASSQAVWTDYEQYF,1,0,1,1
TRBV3-1,TRBJ1-2,CASSQGVPPRSGYTF,1,0,1,1
TRBV3-1,TRBJ2-1,CASSQDAGRYNEQFF,1,1,2,2
TRBV3-1,TRBJ2-7,CASSQDLTGLGEQYF,1,0,1,1
TRBV3-1,TRBJ2-2,CASSQETLSTGELFF,1,0,1,1
TRBV9,TRBJ1-1,CASSVNTGVNTEAFF,1,0,1,1
TRBV9,TRBJ2-3,CASSASVGRADTQYF,1,0,1,1
TRBV5-4,TRBJ1-2,CASSAGPTGSGGYTF,1,0,1,1
TRBV7-9,TRBJ1-1,CASSGRADTGAEAFF,1,0,1,1
TRBV7-2,TRBJ2-5,CASSGGWRGGETQYF,1,0,1,1
TRBV7-9,TRBJ1-1,CASSKNQGGDTEAFF,1,0,1,1
TRBV12-3/4,TRBJ2-5,CASRRLAGGRETQYF,1,0,1,1
TRBV6-2/3/5/6,TRBJ2-7,CASRARDRGPYEQYF,1,0,1,1
TRBV6-2/3/5/6,TRBJ2-1,CASRLAGGPGNEQFF,1,0,1,1
TRBV5-1,TRBJ2-1,CASSGPGKAYNEQFF,1,2,2,3
TRBV5-1,TRBJ2-2,CASATLAPRTGELFF,1,0,1,1
TRBV10-2,TRBJ2-5,CASSESSRVQETQYF,1,0,1,1
TRBV5-1,TRBJ2-2,CASSFGGIDTGELFF,1,0,1,1
TRBV5-1,TRBJ2-1,CASSLVPSNENEQFF,1,0,1,1
TRBV5-1,TRBJ2-3,CASSLVAGRTDTQYF,1,0,1,1
TRBV5-1,TRBJ1-1,CASSWDTKMNTEAFF,1,0,1,1
TRBV20-1,TRBJ2-3,CSAMASGRGTDTQYF,1,0,1,1
TRBV20-1,TRBJ2-5,CSARRDRGSQETQYF,1,0,1,1
TRBV20-1,TRBJ2-1,CSARSGSGRASEQFF,1,0,1,1
TRBV20-1,TRBJ1-1,CSARPPGGKDLPGCF,1,0,1,1
TRBV20-1,TRBJ2-7,CSARAPQGATDEQYF,1,0,1,1
TRBV20-1,TRBJ2-7,CSARDLAGLLNEQYF,1,0,1,1
TRBV20-1,TRBJ2-7,CSARDLGTGVLEQYF,1,0,1,1
TRBV20-1,TRBJ2-5,CSARDPAGNQETQYF,1,0,1,1
TRBV20-1,TRBJ2-1,CSARDGAGDQNEQFF,1,0,1,1
TRBV20-1,TRBJ1-1,CSAKGQGGKSTEAFF,1,0,1,1
TRBV20-1,TRBJ1-5,CSAPQGGGSNQPQHF,1,0,1,1
TRBV29-1,TRBJ2-1,CSSGGPSGSYNEQFF,1,0,1,1
TRBV29-1,TRBJ2-1,CSVLPGLASLNEQFF,1,0,1,1
TRBV29-1,TRBJ1-5,CSVGDGLLGNQPQHF,1,0,1,1
TRBV29-1,TRBJ2-7,CSVEDLGTGGSEQYF,1,0,1,1
TRBV29-1,TRBJ2-7,CSVGGQGQGAGEQYF,1,0,1,1
TRBV29-1,TRBJ2-3,CSVIGGSGTGDTQYF,1,0,1,1
TRBV29-1,TRBJ2-1,CRLRRLAGSYNEQFF,1,0,1,1
TRBV5-5,TRBJ2-1,RASSLLPDSYNEQFF,1,0,1,1
TRBV15,TRBJ2-5,CATSFAGGQETQYF,1,0,1,1
TRBV24-1,TRBJ2-7,CATSGRGVYDEQYF,2,0,1,2
TRBV15,TRBJ2-3,CATSRGGGGNTQYF,1,1,2,2
TRBV28,TRBJ2-5,CATKRGGAKGTQYF,1,0,1,1
TRBV19,TRBJ2-1,CASSPGLVGNEQFF,1,0,1,1
TRBV19,TRBJ2-1,CASSIRAGKDEQFF,1,0,1,1
TRBV18,TRBJ2-1,CASSLGRLNNEQFF,1,0,1,1
TRBV18,TRBJ2-5,CASSPNGVSETQYF,1,0,1,1
TRBV18,TRBJ2-5,CASSPPFPKETQYF,1,0,1,1
TRBV18,TRBJ2-5,CASSPGKTEETQYF,1,0,1,1
TRBV18,TRBJ1-2,CASSQMNGPSDYTF,1,0,1,1
TRBV3-1,TRBJ2-1,CASRGLAGGNEQFF,2,1,2,3
TRBV28,TRBJ1-5,CASHFGGVNQPQHF,1,0,1,1
TRBV6-2/3/5/6,TRBJ2-7,CASTRTSGSGEQYF,1,0,1,1
TRBV7-2,TRBJ2-5,CASTLGDRGETQYF,1,0,1,1
TRBV7-6,TRBJ2-7,CASTPGASGYEQYF,1,0,1,1
TRBV7-2,TRBJ1-3,CASTGGSSGTTIYF,1,0,1,1
TRBV27,TRBJ2-7,CASSFTSGPSEQYF,1,0,1,1
TRBV5-6,TRBJ2-1,CASSFSGARNEQFF,1,0,1,1
TRBV12-3/4,TRBJ2-1,CASSFLTVGNEQFF,1,0,1,1
TRBV6-2/3/5/6,TRBJ2-4,CASSLWGVKNIQYF,1,0,1,1
TRBV6-2/3/5/6,TRBJ2-7,CASSLWGQYYEQYF,1,0,1,1
TRBV12-3/4,TRBJ2-7,CASSLLPGSYEQYF,1,0,1,1
TRBV28,TRBJ2-7,CASSLTGLSYEQYF,1,0,1,1
TRBV12-3/4,TRBJ1-1,CASSSHQANTEAFF,2,0,1,2
TRBV6-2/3/5/6,TRBJ2-1,CASSYSQRENEQFF,1,0,1,1
TRBV6-2/3/5/6,TRBJ2-5,CASSYSVGPRAQYF,1,0,1,1
TRBV6-2/3/5/6,TRBJ2-1,CASSLRLAGYEQFF,1,0,1,1
TRBV2,TRBJ2-7,CASSPGQGSYEQYF,1,0,1,1
TRBV28,TRBJ2-7,CASSRYRFYYEQYF,1,0,1,1
TRBV28,TRBJ2-7,CASSARQISYEQYF,1,0,1,1
TRBV2,TRBJ2-6,CASSGISGANVLTF,1,0,1,1
TRBV2,TRBJ2-1,CASSDQGVHNEQFF,2,0,1,2
TRBV10-3,TRBJ1-1,CASSESYRTVEAFF,1,0,1,1
TRBV12-3/4,TRBJ2-7,CASSTRRVPYEQYF,1,0,1,1
TRBV7-2,TRBJ2-7,CASSFRQGVYEQYF,1,0,1,1
TRBV5-5,TRBJ2-4,CASSLASLLDIQYF,1,0,1,1
TRBV5-6,TRBJ2-1,CASSLAGTGNEQFF,1,0,1,1
TRBV7-2,TRBJ2-5,CASSLLTREETQYF,2,0,1,2
TRBV7-9,TRBJ1-3,CASSLAVSGNTIYF,1,0,1,1
TRBV11-2,TRBJ2-7,CASSLGGPCTEQYF,1,0,1,1
TRBV11-2,TRBJ1-1,CASSLETRNTEAFF,1,0,1,1
TRBV7-9,TRBJ2-5,CASSLSQGERAQYF,1,0,1,1
TRBV5-5,TRBJ1-6,CASSSDRGNSPLHF,1,0,1,1
TRBV7-6,TRBJ1-1,CASSYFEADTEAFF,1,0,1,1
TRBV11-2,TRBJ2-2,CASSYSIGPGELFF,1,0,1,1
TRBV28,TRBJ2-7,CASSPSGRSYEQYF,1,0,1,1
TRBV3-1,TRBJ2-1,CASSPPGRANEQFF,1,0,1,1
TRBV11-2,TRBJ1-1,CASSPSGGRIEAFF,1,0,1,1
TRBV11-2,TRBJ1-1,CASSPGALNTEAFF,2,0,1,2
TRBV5-4,TRBJ2-5,CASSPPGMRETQYF,1,0,1,1
TRBV7-2,TRBJ2-7,CASSPQGASHEQYF,1,0,1,1
TRBV14,TRBJ2-1,CASSHLTSYNEQFF,1,0,1,1
TRBV3-1,TRBJ2-7,CASSHRHSPYEQYF,1,0,1,1
TRBV3-1,TRBJ1-3,CASSQYRDGNTIYF,1,0,1,1
TRBV3-1,TRBJ2-1,CASSQQTFSNEQFF,1,0,1,1
TRBV4-2,TRBJ2-7,CASSQGSSGYEQYF,1,0,1,1
TRBV3-1,TRBJ2-7,CASSQGTGNYEQYF,1,0,1,1
TRBV6-2/3/5/6,TRBJ1-2,CASSVLQGLYGYTF,1,0,1,1
TRBV9,TRBJ2-2,CASSVAGSPGELFF,1,0,1,1
TRBV5-4,TRBJ2-3,CASSERAGSDTQYF,1,0,1,1
TRBV7-6,TRBJ2-2,CASSTGTFTGELFF,1,0,1,1
TRBV2,TRBJ1-4,CASSNPLSLEKQFF,1,0,1,1
TRBV7-9,TRBJ2-1,CASRSGLAINEQFF,1,0,1,1
TRBV6-2/3/5/6,TRBJ2-7,CASRGTRSSYEQYF,1,0,1,1
TRBV2,TRBJ2-2,CASRETGASGELFF,1,0,1,1
TRBV7-2,TRBJ2-2,CASRNRVGTGELFF,1,0,1,1
TRBV28,TRBJ2-7,CASRSGQNTYEQYF,1,0,1,1
TRBV5-6,TRBJ2-5,CASRLTKYQETQYF,1,0,1,1
TRBV6-2/3/5/6,TRBJ1-5,CASRAGFSNQPQHF,1,0,1,1
TRBV27,TRBJ1-2,CASRGGGLGYGYTF,1,0,1,1
TRBV5-1,TRBJ2-1,CASYPGTSNNEQFF,1,0,1,1
TRBV5-1,TRBJ2-2,CASRLAGSTGELFF,1,0,1,1
TRBV5-1,TRBJ2-7,CASTPGGIFYEQYF,1,0,1,1
TRBV5-1,TRBJ2-7,CASSLSLAGREQYF,1,0,1,1
TRBV5-1,TRBJ2-3,CASSSQGADDTQYF,1,2,2,3
TRBV5-1,TRBJ2-5,CASSSGTPTETQYF,1,0,1,1
TRBV5-1,TRBJ2-1,CASSPGLAGGEQFF,1,0,1,1
TRBV3-1,TRBJ2-3,CASSPRLEENTQYF,1,0,1,1
TRBV5-1,TRBJ2-5,CASSARSGGETQYF,1,0,1,1
TRBV5-1,TRBJ1-4,CASRQGGEGEKLFF,1,0,1,1
TRBV20-1,TRBJ1-1,CSAPDPNGNTEAFF,1,0,1,1
TRBV20-1,TRBJ2-5,CSASLEGAGETQYF,1,0,1,1
TRBV20-1,TRBJ2-7,CSARAGTSSSEQYF,1,0,1,1
TRBV20-1,TRBJ2-2,CSAREMTAAGELFF,1,0,1,1
TRBV20-1,TRBJ2-3,CSAPKSRGADTQYF,1,0,1,1
TRBV20-1,TRBJ2-6,CSAPREPGANVLTF,1,0,1,1
TRBV20-1,TRBJ2-5,CSAPPGTIKETQYF,1,0,1,1
TRBV20-1,TRBJ2-5,CSTTQGAGEETQYF,1,0,1,1
TRBV29-1,TRBJ2-6,CSVVSGAGANVLTF,1,0,1,1
TRBV29-1,TRBJ2-3,CSVALAASTDTQYF,1,0,1,1
TRBV29-1,TRBJ2-3,CSVDVSPSADTQYF,1,0,1,1
TRBV29-1,TRBJ2-4,CSVDIAGGGNIQYF,1,0,1,1
TRBV29-1,TRBJ2-1,CSVEAPGGNNEQFF,1,0,1,1
TRBV29-1,TRBJ1-1,CSVEGGGPPFAAFF,1,0,1,1
TRBV29-1,TRBJ2-2,CSVRETSNTGELFF,1,0,1,1
TRBV29-1,TRBJ1-2,CSVTDRGAIYGYTF,1,1,2,2
TRBV29-1,TRBJ2-5,CSAEAGRGQETQYF,2,0,1,2
TRBV29-1,TRBJ2-1,CSGGQSLSYNEQFF,1,0,1,1
TRBV29-1,TRBJ2-7,CSDAPGTSKYEQYF,1,0,1,1
TRBV18,TRBJ1-5,CVSSQDRGEPQHF,1,0,1,1
TRBV7-9,TRBJ1-2,CASNEGGNYGYTF,1,0,1,1
TRBV30,TRBJ2-3,CAWSGDSTDTQYF,1,0,1,1
TRBV10-3,TRBJ2-2,CALRDTNTGELFF,1,0,1,1
TRBV12-3/4,TRBJ2-5,CAIRSSGQETQYF,1,0,1,1
TRBV24-1,TRBJ2-1,CATSSRYLVEQFF,1,0,1,1
TRBV19,TRBJ2-7,CASSPGTVYEQYF,1,0,1,1
TRBV19,TRBJ1-2,CASSEGFGYGYTF,1,0,1,1
TRBV19,TRBJ2-2,CASSRTPPGELFF,1,2,2,3
TRBV19,TRBJ2-3,CASSVSGAGTQYF,1,0,1,1
TRBV19,TRBJ1-1,CASNLGGRTEAFF,1,0,1,1
TRBV18,TRBJ2-5,CASSPGDQETQYF,1,0,1,1
TRBV18,TRBJ2-2,CASSPTTTGELFF,1,0,1,1
TRBV7-6,TRBJ2-7,CASGLAGTYEQYF,1,0,1,1
TRBV7-2,TRBJ2-5,CASGTGPQETQYF,1,0,1,1
TRBV12-3/4,TRBJ2-7,CASTFSGAHEQYF,1,0,1,1
TRBV5-6,TRBJ1-2,CASTLGRSYGYTF,1,0,1,1
TRBV2,TRBJ2-3,CASTREQGDTQYF,1,0,1,1
TRBV6-2/3/5/6,TRBJ1-5,CASTDRRDQLQHF,1,0,1,1
TRBV6-2/3/5/6,TRBJ2-3,CASSFRPHHTQYF,1,0,1,1
TRBV6-2/3/5/6,TRBJ2-5,CASSLDRGETQYF,1,0,1,1
TRBV6-2/3/5/6,TRBJ1-2,CASSSEGRGGYTF,1,0,1,1
TRBV28,TRBJ2-3,CASSHYRSDTQYF,1,0,1,1
TRBV6-1,TRBJ2-7,CASSVDASYEQYF,1,0,1,1
TRBV25-1,TRBJ2-1,CASSVSGRNEQFF,1,0,1,1
TRBV5-5,TRBJ1-5,CASSFQGNQPQHF,1,0,1,1
TRBV5-4,TRBJ2-1,CASSLVSGGGLFF,1,0,1,1
TRBV5-4,TRBJ2-5,CASSLIFEETQYF,1,0,1,1
TRBV7-9,TRBJ2-7,CASSLVGGNEQFF,1,0,1,1
TRBV7-6,TRBJ2-1,CASSLVADNEQFF,1,0,1,1
TRBV7-2,TRBJ1-1,CASSLALAVEAFF,1,0,1,1
TRBV7-8,TRBJ2-1,CASSLAHYNEQFF,1,0,1,1
TRBV7-2,TRBJ1-5,CASSLDYDQPQHF,1,0,1,1
TRBV5-6,TRBJ2-5,CASSLSDQETQYF,1,0,1,1
TRBV12-3/4,TRBJ2-7,CASSLRGPYEQYF,1,1,2,2
TRBV13,TRBJ2-7,CASSPRGAYEQYF,1,0,1,1
TRBV27,TRBJ1-3,CASSPSFGNTIYF,1,0,1,1
TRBV14,TRBJ2-3,CASSRGLTDTQCF,1,0,1,1
TRBV11-2,TRBJ2-1,CASSRTRYNEQFF,1,0,1,1
TRBV7-9,TRBJ2-3,CASSRPGPDTQYF,1,0,1,1
TRBV3-1,TRBJ2-5,CASSQPGTETQYF,1,0,1,1
TRBV11-2,TRBJ2-5,CASSQQGWQTQYF,1,0,1,1
TRBV3-1,TRBJ2-1,CASSQDRYNEQFF,1,0,1,1
TRBV7-2,TRBJ1-5,CASSDRGNQPQHF,1,0,1,1
TRBV7-2,TRBJ2-3,CASSTRGADTQYF,1,1,2,2
TRBV12-3/4,TRBJ1-1,CASRESGNTEAFF,1,0,1,1
TRBV2,TRBJ1-1,CASRAEMNTEAFF,1,0,1,1
TRBV6-2/3/5/6,TRBJ2-3,CASKASGTDTQYF,1,0,1,1
TRBV10-1,TRBJ2-7,CASSESGDYEQYF,1,0,1,1
TRBV5-1,TRBJ2-7,CASSLVQSYEQYF,1,0,1,1
TRBV20-1,TRBJ2-7,CSASEGQSYEQYF,1,0,1,1
TRBV20-1,TRBJ2-7,CSARPFTKYEQYF,1,1,2,2
TRBV20-1,TRBJ1-3,CSARVGGGNTIYF,1,0,1,1
TRBV20-1,TRBJ2-1,CSAKWSGSDEQFF,1,0,1,1
TRBV20-1,TRBJ2-5,CSAPGGGQETQYF,1,0,1,1
TRBV20-1,TRBJ1-1,CSPTQGRDTEAFF,1,0,1,1
TRBV29-1,TRBJ2-1,CSVPSISYNEQFF,1,0,1,1
TRBV29-1,TRBJ2-7,CSVEGSGGNEQYF,1,0,1,1
TRBV29-1,TRBJ2-5,CSVETNNQETQYF,1,0,1,1
TRBV29-1,TRBJ2-1,CSVAGTPYNEQFF,1,0,1,1
TRBV29-1,TRBJ1-1,CSVLTGMNTEAFF,1,0,1,1
TRBV29-1,TRBJ2-3,CSGAQGWTDTQYF,1,0,1,1
TRBV10-3,TRBJ2-1,CAISNTGDEQFF,1,0,1,1
TRBV18,TRBJ1-5,CATRGENQPQHF,1,0,1,1
TRBV19,TRBJ1-1,CASSVRQTEAFF,1,0,1,1
TRBV19,TRBJ2-1,CASSPARNEQFF,1,0,1,1
TRBV3-1,TRBJ2-7,CASSNRGYEQYF,1,0,1,1
TRBV18,TRBJ2-3,CASSPSRDTQYF,1,0,1,1
TRBV7-9,TRBJ1-1,CASQARNTEAFF,1,0,1,1
TRBV2,TRBJ1-5,CASTRGNQPQHF,1,0,1,1
TRBV27,TRBJ2-5,CASSFHNGLQYF,1,0,1,1
TRBV2,TRBJ1-1,CASSGDIRIVFF,1,0,1,1
TRBV5-5,TRBJ2-1,CASSLPSNEQFF,1,0,1,1
TRBV6-2/3/5/6,TRBJ1-1,CASSLVRRGAFF,1,0,1,1
TRBV7-2,TRBJ2-3,CASSLGTDTQYF,1,0,1,1
TRBV7-9,TRBJ2-7,CASSLGGGEQYF,1,0,1,1
TRBV7-2,TRBJ2-7,CASSLELSEQYF,1,0,1,1
TRBV5-4,TRBJ2-7,CASSSSFYEQYF,1,1,2,2
TRBV7-9,TRBJ1-5,CASSSPGQPQHF,1,0,1,1
TRBV7-9,TRBJ1-5,CASSYGNQPQHF,1,3,2,4
TRBV3-1,TRBJ2-1,CASSPRDNEQFF,1,0,1,1
TRBV14,TRBJ2-7,CASSQGRNEQYF,1,0,1,1
TRBV7-9,TRBJ2-5,CASSQEQETQYF,2,0,1,2
TRBV7-6,TRBJ2-3,CASSEDSKTQYF,1,3,2,4
TRBV6-2/3/5/6,TRBJ2-5,CASRAGAETQYF,1,0,1,1
TRBV5-1,TRBJ2-1,CASSLEGTEQFF,1,0,1,1
TRBV5-1,TRBJ2-7,CASSLNSYEQYF,1,0,1,1
TRBV5-1,TRBJ2-7,CASSSQGNEQYF,1,0,1,1
TRBV5-1,TRBJ2-1,CASSLAGNEQFF,2,0,1,2
TRBV29-1,TRBJ2-5,CIVDRDQETQYF,1,0,1,1
TRBV20-1,TRBJ1-1,CSARAGNTEAFF,1,0,1,1
TRBV20-1,TRBJ1-3,CSARAGGNTIYF,1,0,1,1
TRBV29-1,TRBJ2-5,CSVSLEIETQYF,1,0,1,1
TRBV29-1,TRBJ1-2,CSVEEGRGGYTF,1,3,2,4
TRBV29-1,TRBJ2-7,CSVRDRTYEQYF,1,0,1,1
TRBV29-1,TRBJ2-5,CSVYRGLETQYF,2,3,2,5
TRBV30,TRBJ1-1,CAWRSTGRAFF,1,0,1,1
TRBV19,TRBJ1-1,CASTLAFEAFF,1,0,1,1
TRBV19,TRBJ2-5,CASTWRETQYF,1,0,1,1
TRBV19,TRBJ2-5,CASSIRETQYF,1,0,1,1
TRBV12-3/4,TRBJ2-7,CASSLSYEQYF,1,0,1,1
TRBV11-2,TRBJ2-7,CASSLGTGQYF,1,1,2,2
TRBV19,TRBJ2-4,CAVSGSNIQYF,1,0,1,1
TRBV5-1,TRBJ2-3,CASSPGQVQYF,1,0,1,1
TRBV20-1,TRBJ2-1,CSAYSRNEQFF,1,0,1,1
TRBV20-1,TRBJ1-1,CSARENTEAFF,1,1,2,2
TRBV29-1,TRBJ1-1,CSVGLNTEAFF,1,0,1,1
TRBV29-1,TRBJ2-1,CSVGLAGEQFF,1,0,1,1
TRBV7-9,TRBJ2-1,CASSLETEFF,1,0,1,1
TRBV12-3/4,TRBJ2-7,CASSLALRVGTSPRGFSYEQYF,2,0,1,2
TRBV24-1,TRBJ1-5,CATSDLGRPGQGNYSNQPQHF,1,0,1,1
TRBV11-2,TRBJ2-1,CASSLGTGLAGGYTGRNEQFF,2,0,1,2
TRBV5-1,TRBJ2-3,CASSSIGSSGRNYLSTDTQYF,1,0,1,1
TRBV29-1,TRBJ2-6,CSVEDPGETQVTRSGANVLTF,1,0,1,1
TRBV9,TRBJ2-1,CASSPSGLAGGGGDYNEQFF,1,0,1,1
TRBV5-1,TRBJ1-2,CASSLAPGFGSVKLDYGYTF,1,0,1,1
TRBV6-2/3/5/6,TRBJ2-1,CASIRDPSGSLSSYNEQFF,1,0,1,1
TRBV12-3/4,TRBJ2-3,CASSAGFIAGEGDTDTQYF,1,0,1,1
TRBV25-1,TRBJ2-1,CASSDSGQISGREYNEQFF,1,0,1,1
TRBV7-9,TRBJ1-3,CASSLSARPSTRSGNTIYF,1,0,1,1
TRBV7-9,TRBJ2-2,CASSREPRDYRRNTGELFF,1,0,1,1
TRBV14,TRBJ2-3,CASSQGQGLRQARTDTQYF,1,0,1,1
TRBV5-1,TRBJ2-6,CASSLTGQGYLSGANVLTF,1,0,1,1
TRBV10-3,TRBJ2-1,CAISESKAGKATHNEQFF,1,0,1,1
TRBV15,TRBJ2-1,CATSRDLTSGRRVNEQFF,1,0,1,1
TRBV19,TRBJ2-7,CASSLYSTGTSGRYEQYF,1,0,1,1
TRBV12-3/4,TRBJ2-7,CASSFPPGLAGGSYEQYF,1,0,1,1
TRBV28,TRBJ1-2,CASSSARGRGKNNYGYTF,1,0,1,1
TRBV11-1,TRBJ2-6,CASSLRGLAGSGANVLTF,1,0,1,1
TRBV5-6,TRBJ2-2,CASSSRLGPVSNTGELFF,1,0,1,1
TRBV3-1,TRBJ2-7,CASSQVLAGGPPTYGQYF,1,0,1,1
TRBV14,TRBJ2-5,CASSQGRAGGPRIETQYY,1,0,1,1
TRBV9,TRBJ2-1,CASSVLAGSTPTYNEQFF,1,1,2,2
TRBV9,TRBJ2-1,CASSAIGSRDRGYNEQFF,1,0,1,1
TRBV7-2,TRBJ2-3,CASSIVGRRTSSTDTQYF,1,0,1,1
TRBV5-1,TRBJ2-6,CASSLVGLRSSGANVLTF,1,0,1,1
TRBV5-1,TRBJ2-1,CASSPQGGGTGRYNEQFF,1,0,1,1
TRBV4-1,TRBJ2-6,CASSQDPAGGSGANVLTF,1,0,1,1
TRBV20-1,TRBJ2-1,CSARTGTSGGPSYNEQFF,1,0,1,1
TRBV20-1,TRBJ2-3,CSARGPERGRATADTQYF,1,0,1,1
TRBV29-1,TRBJ2-1,CSVEGRMSGSMMGDEQFF,1,0,1,1
TRBV24-1,TRBJ2-2,CATSDSLAGPNTGELFF,1,0,1,1
TRBV15,TRBJ2-5,CATSRDIEATRGETQYF,1,0,1,1
TRBV19,TRBJ2-3,CASSVPGTSGMRDTQYF,1,0,1,1
TRBV19,TRBJ2-4,CASSIGSGRVAKNIQYF,1,0,1,1
TRBV19,TRBJ2-5,CASSITSGTGGGETQYF,1,0,1,1
TRBV18,TRBJ2-3,CASSRRQDRPDKDTQNF,1,0,1,1
TRBV27,TRBJ2-1,CASQGLAGGGGGNEQFF,1,0,1,1
TRBV5-6,TRBJ2-7,CASTAQLFRDRDNEQYF,1,0,1,1
TRBV28,TRBJ2-3,CASSFADRDYLTDTQYF,1,1,2,2
TRBV28,TRBJ2-7,CASSLCTSGRAICEQYF,1,1,2,2
TRBV6-2/3/5/6,TRBJ2-7,CASSYRGQNYISYEQYF,1,0,1,1
TRBV6-2/3/5/6,TRBJ1-5,CASSYGQSIHSNQPQHF,1,0,1,1
TRBV2,TRBJ2-5,CASSDRTSGRGRETQYF,1,0,1,1
TRBV6-1,TRBJ1-4,CASSESRAWATNEKLFF,1,0,1,1
TRBV5-4,TRBJ2-3,CASSLDSWGTSTDTQYF,1,0,1,1
TRBV7-2,TRBJ2-5,CASSSRAGGLHQETQYF,1,0,1,1
TRBV7-2,TRBJ2-1,CASSSPAGTSGYNEQFF,1,0,1,1
TRBV5-4,TRBJ2-5,CASSSGGTSGSRETQYF,1,0,1,1
TRBV14,TRBJ2-2,CASSPSVAGAATGELFF,1,0,1,1
TRBV28,TRBJ2-3,CASSPVRTSGRTDTQYF,1,0,1,1
TRBV3-1,TRBJ2-7,CASSQTSGRPGAYEQYF,1,0,1,1
TRBV14,TRBJ2-5,CASSQQLGGSLQETQYF,1,0,1,1
TRBV4-2,TRBJ1-3,CASSQVDGSGTGNTIYF,1,0,1,1
TRBV14,TRBJ1-1,CASSQGIWGRVNTEAFF,1,0,1,1
TRBV4-2,TRBJ2-7,CASSQESGTGRLYEQYF,1,0,1,1
TRBV7-9,TRBJ2-1,CASSDLAGGVYYNEQFF,1,0,1,1
TRBV11-1,TRBJ2-1,CASSKGGFVGGPKFQFF,1,0,1,1
TRBV7-2,TRBJ2-1,CASRSSGYYLSYNEQFF,1,0,1,1
TRBV4-1,TRBJ2-7,CASSHPSGRGTSYEQYF,1,0,1,1
TRBV4-1,TRBJ2-1,CASSQAGTSGIAGEQFF,1,0,1,1
TRBV5-1,TRBJ2-3,CASSQGEEWEGTDTQYF,2,0,1,2
TRBV4-1,TRBJ2-3,CASSQDPAGASTDTQYF,1,0,1,1
TRBV5-1,TRBJ2-3,CASSRYGLAGETDTQYF,1,0,1,1
TRBV20-1,TRBJ2-1,CSALRVAGHSSYNEQFF,1,0,1,1
TRBV20-1,TRBJ2-3,CSASPLPGNTGTDTQYF,1,0,1,1
TRBV20-1,TRBJ2-5,CSARTGTGGLREETQYF,1,0,1,1
TRBV20-1,TRBJ2-1,CSARDASGTNGKNEQFF,1,0,1,1
TRBV20-1,TRBJ1-2,CSARRIPGGMPNYGYTF,1,0,1,1
TRBV29-1,TRBJ2-5,CSSSKPGGGDSRETQYF,1,0,1,1
TRBV29-1,TRBJ2-3,CSVRLFVGQGFPDTQYF,1,0,1,1
TRBV12-5,TRBJ2-3,CASGLGLAVGADTQYF,1,0,1,1
TRBV25-1,TRBJ2-3,CASSPPPDRGADTQYF,1,0,1,1
TRBV30,TRBJ1-5,CAWSVQGPYSNQPQHF,1,0,1,1
TRBV10-3,TRBJ2-3,CAITPGSGRVTDTQYF,1,0,1,1
TRBV2,TRBJ2-7,CATFLSPEQGSYEQYF,1,0,1,1
TRBV24-1,TRBJ2-2,CATSRGKRDDPGELFF,1,0,1,1
TRBV19,TRBJ2-3,CASSLGNPPSTDTQYF,1,1,2,2
TRBV19,TRBJ1-1,CASSPSGGTARTEAFF,1,0,1,1
TRBV19,TRBJ1-2,CASSIDGSAARYSYTF,1,0,1,1
TRBV19,TRBJ2-3,CASSPLSGYSTDTQYF,1,0,1,1
TRBV18,TRBJ2-5,CASSPLTGTGKETQYF,1,0,1,1
TRBV18,TRBJ2-1,CASSPFSGSLDNEQFF,1,0,1,1
TRBV18,TRBJ2-5,CASSPPPWRSQETQYF,1,0,1,1
TRBV18,TRBJ2-1,CASSPPGTSGRIPQFF,1,0,1,1
TRBV6-2/3/5/6,TRBJ2-2,CASCYFGGANTGELFF,1,0,1,1
TRBV12-3/4,TRBJ2-3,CASLRTSGSGTDTQYF,1,0,1,1
TRBV2,TRBJ1-5,CASMWGKSNSNQPQHF,1,0,1,1
TRBV2,TRBJ2-3,CASMGGLALTGDTQYF,1,0,1,1
TRBV7-3,TRBJ2-3,CASTISGGQGWGTQYF,1,0,1,1
TRBV6-2/3/5/6,TRBJ2-3,CASSFLIASGTDTQYF,1,0,1,1
TRBV28,TRBJ1-1,CASSFAPGLINTEAFF,1,0,1,1
TRBV12-3/4,TRBJ2-3,CASSLSSGVQGDTQYF,1,0,1,1
TRBV12-3/4,TRBJ1-5,CASSLARSGVNQPQHF,1,0,1,1
TRBV27,TRBJ2-2,CASSLEGTPNTGELFF,1,0,1,1
TRBV6-2/3/5/6,TRBJ2-3,CASSLSLGRAPDTQYF,1,0,1,1
TRBV28,TRBJ2-7,CASSSPLGQGRLEQYF,1,0,1,1
TRBV28,TRBJ1-1,CASSYEWGILNTEAFF,1,0,1,1
TRBV12-3/4,TRBJ2-5,CASSPRTSGVGETQYF,1,0,1,1
TRBV6-1,TRBJ2-4,CASSEVDTGGKNIQYF,1,0,1,1
TRBV6-1,TRBJ2-2,CASSEELAGVTGELFF,2,0,1,2
TRBV7-9,TRBJ2-3,CASSKLWTGAEDTQYF,1,0,1,1
TRBV5-6,TRBJ2-7,CASSLFGVGASYEQYF,1,0,1,1
TRBV5-5,TRBJ2-7,CASSLGTSGHHYEPYF,1,0,1,1
TRBV5-4,TRBJ2-7,CASSLMTSGSDYEQYF,1,0,1,1
TRBV11-3,TRBJ2-1,CASSLLGTRPYNEQFF,1,0,1,1
TRBV7-9,TRBJ1-2,CASSLATGESIYGYTF,1,0,1,1
TRBV3-1,TRBJ2-2,CASSLGAGVRTGELFF,1,0,1,1
TRBV7-3,TRBJ2-5,CASSLTAGQGGETQYF,1,0,1,1
TRBV7-2,TRBJ2-7,CASSSSGTSFLYEQYF,1,0,1,1
TRBV13,TRBJ2-1,CASSSPQGRTHHEQFF,1,0,1,1
TRBV7-9,TRBJ2-2,CASSSTNRGNTGELFF,1,0,1,1
TRBV7-2,TRBJ2-3,CASSPLRFAVTDTQYF,1,0,1,1
TRBV7-2,TRBJ2-7,CASSPRSGRSSYEQYF,1,0,1,1
TRBV9,TRBJ1-2,CASSPQSRGPFYGYTF,1,0,1,1
TRBV11-2,TRBJ1-2,CASSPVRGRGNYGYTF,1,0,1,1
TRBV7-9,TRBJ2-3,CASSPLIGPTTDTQYF,1,0,1,1
TRBV7-2,TRBJ2-1,CASSPGTSGTYNEQFF,1,1,2,2
TRBV12-3/4,TRBJ2-5,CASSPTSGSGQETQYF,1,0,1,1
TRBV7-6,TRBJ2-1,CASSPRASGALTEQFF,1,0,1,1
TRBV9,TRBJ2-1,CASSPRTSGFNNEQFF,1,0,1,1
TRBV7-9,TRBJ2-3,CASSRRGGRSTDTQYF,2,0,1,2
TRBV5-6,TRBJ2-5,CASSQWGSGILETQYF,1,0,1,1
TRBV3-1,TRBJ2-3,CASSQVWTQNRDTQYF,1,0,1,1
TRBV4-2,TRBJ2-6,CASSQDEGSGANVLTF,1,0,1,1
TRBV3-1,TRBJ2-2,CASSQDRGARTGELFF,1,0,1,1
TRBV7-6,TRBJ2-1,CASSARLAGGPNEQFF,1,0,1,1
TRBV3-1,TRBJ2-1,CASSATGGIVVNEQFF,1,0,1,1
TRBV14,TRBJ2-7,CASSGPSGRALREQYF,1,0,1,1
TRBV6-1,TRBJ2-2,CASSDTGLGGTGELFF,1,0,1,1
TRBV7-6,TRBJ2-3,CASSDRLAGVTDTQYF,1,0,1,1
TRBV5-4,TRBJ2-1,CASRDRHTSGNNEQFF,1,0,1,1
TRBV6-4,TRBJ1-5,CASRNTGQGSNQPQHF,1,0,1,1
TRBV6-2/3/5/6,TRBJ2-5,CASNPRQGGGAETQYF,1,0,1,1
TRBV4-1,TRBJ1-5,CASSVYQGNSNQPQHF,1,0,1,1
TRBV10-2,TRBJ1-2,CASSATREGRSLGYTF,1,0,1,1
TRBV10-2,TRBJ2-7,CASSGTGTGTYNEQYF,1,0,1,1
TRBV10-1,TRBJ2-3,CASSDGLAGVTDTQYF,1,0,1,1
TRBV5-5,TRBJ2-7,CASSLPLPGIGYEQYF,1,0,1,1
TRBV5-1,TRBJ2-2,CASSLMTSGNTGELLF,1,0,1,1
TRBV5-1,TRBJ1-2,CASSLNPFGQGYGYTF,1,0,1,1
TRBV13,TRBJ2-3,CASSLNLGPGADTQYF,1,0,1,1
TRBV5-1,TRBJ2-1,CASSLVRLARYNEQFF,1,0,1,1
TRBV4-1,TRBJ2-3,CASSQEGGYAPGTQCF,1,0,1,1
TRBV5-1,TRBJ2-7,CASSVGHLGSSYEQYF,1,0,1,1
TRBV5-1,TRBJ2-3,CASSIVAGQGTDTQYF,1,0,1,1
TRBV5-1,TRBJ2-3,CASRGLAGESTDTQYF,1,0,1,1
TRBV5-1,TRBJ2-1,CASKAGGSLSYNEQFF,1,0,1,1
TRBV20-1,TRBJ2-5,CSAPISGLAGVETQYF,1,0,1,1
TRBV20-1,TRBJ2-5,CSATSGREGIQETQYF,1,0,1,1
TRBV20-1,TRBJ2-5,CSARAFLAGVKETQYF,1,0,1,1
TRBV29-1,TRBJ2-7,CSVVPAVPPSSYEQYF,1,0,1,1
TRBV29-1,TRBJ2-1,CSVAVGGTGGYNEQFF,1,0,1,1
TRBV29-1,TRBJ2-1,CSVDPRGDRSSNEQFF,1,0,1,1
TRBV29-1,TRBJ2-3,CSVEDYLAGKTDTQYF,1,0,1,1
TRBV27,TRBJ2-5,YASRPPTSGSRETQYF,1,0,1,1
TRBV30,TRBJ1-1,CAWSFLGQANTEAFF,1,0,1,1
TRBV10-3,TRBJ2-5,CAISANSFPEETQYF,1,0,1,1
TRBV24-1,TRBJ2-5,CATSLGGTGGETQYF,1,0,1,1
TRBV24-1,TRBJ2-5,CATSDGREFGETQYF,1,1,2,2
TRBV27,TRBJ2-7,CATLPTGTGTYEQYF,1,1,2,2
TRBV19,TRBJ1-1,CASSYAPVPNTEAFF,2,1,2,3
TRBV19,TRBJ2-3,CASSPGRDYTDTQYF,1,0,1,1
TRBV19,TRBJ2-3,CASSQTFTLTDTQYF,1,0,1,1
TRBV19,TRBJ1-3,CASSGGHNSGNTIYF,1,0,1,1
TRBV19,TRBJ2-1,CASSISSGSVDEQFF,2,2,2,4
TRBV19,TRBJ2-1,CASSISSGSLNEQFF,1,0,1,1
TRBV19,TRBJ2-1,CASSIGGYSYNGQFF,1,0,1,1
TRBV19,TRBJ2-1,CASSITSGRLNEQFF,1,0,1,1
TRBV19,TRBJ1-6,CASSTRPRGPSPLHF,1,0,1,1
TRBV19,TRBJ1-1,CASSKRTPVSTEAFF,1,0,1,1
TRBV19,TRBJ2-7,CASSPGLAGLDEQYF,1,0,1,1
TRBV19,TRBJ2-4,CASSDGQGGKNIQYF,1,0,1,1
TRBV18,TRBJ1-2,CASSPTGQSNYGYTF,1,0,1,1
TRBV18,TRBJ2-3,CASSRLVDSTDTQYF,1,0,1,1
TRBV7-2,TRBJ1-1,CASSWTGGMNTEAFF,1,0,1,1
TRBV18,TRBJ2-7,CASSTGGTGNYEQYF,1,0,1,1
TRBV18,TRBJ2-4,CASSSFDRGGNIQYF,1,0,1,1
TRBV18,TRBJ1-1,CASSPLEIGQNEAFF,1,0,1,1
TRBV18,TRBJ2-7,CASSPGSGSSYEQYF,1,0,1,1
TRBV18,TRBJ1-1,CASSPEDRTNTEAFF,1,0,1,1
TRBV18,TRBJ1-1,CASSASQGAPAEAFF,1,0,1,1
TRBV7-2,TRBJ2-3,CASLDRGRSTDTQYF,1,0,1,1
TRBV4-2,TRBJ2-2,CASARGGQGAGELFF,1,0,1,1
TRBV6-4,TRBJ2-4,CASEERELAKNIQYF,1,0,1,1
TRBV6-2/3/5/6,TRBJ2-7,CASTPLAGVIYEQYF,1,0,1,1
TRBV4-2,TRBJ2-1,CASTPGGSAYNGQFF,1,0,1,1
TRBV12-3/4,TRBJ2-5,CASTRGPGGQETQYF,1,0,1,1
TRBV6-2/3/5/6,TRBJ2-2,CASTMGQGYTGELFF,1,0,1,1
TRBV6-2/3/5/6,TRBJ1-3,CASSFGFDSGNTIYF,1,0,1,1
TRBV6-2/3/5/6,TRBJ2-1,CASSFLAGGFNEQFF,1,0,1,1
TRBV12-3/4,TRBJ1-4,CASSFGGTGSEKLFF,1,0,1,1
TRBV6-2/3/5/6,TRBJ1-1,CASSLFGLRNTEAFF,1,0,1,1
TRBV12-3/4,TRBJ2-1,CASSLALAGANEQFF,1,0,1,1
TRBV12-3/4,TRBJ2-7,CASSLGQGSSYEQYF,1,1,2,2
TRBV12-3/4,TRBJ2-7,CASSLGRGRSHEQYF,1,0,1,1
TRBV27,TRBJ2-7,CASSSPNRGPYEQYF,1,0,1,1
TRBV28,TRBJ2-1,CASSSAGGPDDEQFF,1,0,1,1
TRBV6-2/3/5/6,TRBJ2-3,CASSSSTGGTDTQYF,1,0,1,1
TRBV12-3/4,TRBJ2-2,CASSSGTGATGELFF,1,0,1,1
TRBV7-9,TRBJ2-3,CASSSGLAGWGTQYF,1,0,1,1
TRBV6-2/3/5/6,TRBJ2-4,CASSSTGSRKNIQYF,1,0,1,1
TRBV6-2/3/5/6,TRBJ2-1,CASSYAGTGVDEQFF,1,0,1,1
TRBV6-2/3/5/6,TRBJ2-6,CASSYGKTGANVLTF,1,0,1,1
TRBV5-6,TRBJ2-1,CASSLEGAGKNEQFF,1,0,1,1
TRBV12-3/4,TRBJ2-1,CASSLRAGSGNEQFF,1,0,1,1
TRBV6-2/3/5/6,TRBJ2-1,CASSRTSPTYNEQFF,1,0,1,1
TRBV28,TRBJ2-1,CASSRSGSSYNEQFF,1,0,1,1
TRBV6-2/3/5/6,TRBJ2-1,CASSHRLTGGNEQFF,1,0,1,1
TRBV2,TRBJ2-5,CASSGSGQPQETQYF,1,0,1,1
TRBV6-4,TRBJ2-3,CASSDPAGGTDTQYF,1,0,1,1
TRBV2,TRBJ2-7,CASSDGTSGTYEQYF,1,0,1,1
TRBV6-1,TRBJ2-7,CASSEPQGPGYEQYF,1,0,1,1
TRBV6-1,TRBJ2-1,CASSESTSLGNEQFF,1,0,1,1
TRBV6-1,TRBJ2-1,CASSEGQGRYNEQFF,1,0,1,1
TRBV2,TRBJ2-1,CASSESLAGANEQFF,1,0,1,1
TRBV5-4,TRBJ2-7,CASSSGPRKPYEQYF,1,0,1,1
TRBV7-9,TRBJ1-4,CASSFSVRTNEKLSF,1,0,1,1
TRBV6-2/3/5/6,TRBJ2-1,CASSFWASGSNEQFF,1,0,1,1
TRBV7-6,TRBJ2-5,CASSFPAVVGETQYF,1,0,1,1
TRBV7-9,TRBJ2-1,CASSFGTSGSNEQFF,1,0,1,1
TRBV6-2/3/5/6,TRBJ2-7,CASSFRGQGSYEQYF,1,0,1,1
TRBV7-2,TRBJ2-7,CASSFPAGGHYEQYF,1,0,1,1
TRBV7-2,TRBJ2-7,CASSFRASESYEQYF,1,0,1,1
TRBV7-2,TRBJ2-6,CASSFDRTGANVLTF,1,0,1,1
TRBV7-2,TRBJ2-3,CASSFTRGRPDTQYF,1,0,1,1
TRBV5-5,TRBJ1-1,CASSLLGSLNTEAFF,1,0,1,1
TRBV7-9,TRBJ2-2,CASSLASIDTGELFF,1,0,1,1
TRBV7-9,TRBJ1-2,CASSLGQALNYGYTF,1,0,1,1
TRBV11-2,TRBJ1-1,CASSLTGTGATEAFF,1,0,1,1
TRBV7-9,TRBJ2-7,CASSLYGGGSYEQYF,1,0,1,1
TRBV7-9,TRBJ2-5,CASSLASSRKETQYF,1,0,1,1
TRBV6-2/3/5/6,TRBJ2-3,CASSLGGRATDTQYF,1,0,1,1
TRBV7-9,TRBJ2-1,CASSLGTGPYNEQFF,1,0,1,1
TRBV7-9,TRBJ1-1,CASSLEARGLTEAFF,1,0,1,1
TRBV7-6,TRBJ2-1,CASSLTEGRHNEQFF,1,0,1,1
TRBV11-2,TRBJ1-2,CASSLKQGANYGYTF,1,0,1,1
TRBV7-9,TRBJ2-1,CASSSRGNAYNEQFF,1,0,1,1
TRBV7-9,TRBJ1-2,CASSSRTGGPHGYTF,1,0,1,1
TRBV12-3/4,TRBJ2-7,CASSSLGGFSYEQYF,1,0,1,1
TRBV7-9,TRBJ1-1,CASSSRHSMNTEAFF,1,0,1,1
TRBV7-9,TRBJ2-2,CASSSGGRNTGELFF,1,0,1,1
TRBV7-9,TRBJ2-2,CASSSPLANTGELFF,1,1,2,2
TRBV5-4,TRBJ1-1,CASSYFGTGYTEAFF,1,0,1,1
TRBV5-4,TRBJ2-1,CASSLRGTSPYEQFF,1,0,1,1
TRBV5-4,TRBJ2-1,CASSLTGRSYNEQFF,1,0,1,1
TRBV7-9,TRBJ1-1,CASSLSGTMNTEAFF,1,0,1,1
TRBV3-1,TRBJ2-1,CASSLQGQTYNEQFF,1,0,1,1
TRBV7-3,TRBJ2-1,CASSLGLAGGNEQFF,1,0,1,1
TRBV7-9,TRBJ1-1,CASSLIGGVDTEAFF,1,0,1,1
TRBV3-1,TRBJ2-1,CASSPWTSGGDEQFF,1,0,1,1
TRBV7-2,TRBJ2-3,CASSPPGLATDTQYF,1,0,1,1
TRBV9,TRBJ2-4,CASSPRGESGDIQYF,1,0,1,1
TRBV7-9,TRBJ1-5,CASSPSGTSNQPQHF,1,0,1,1
TRBV7-2,TRBJ2-1,CASSRTTSSYNEQFF,1,0,1,1
TRBV6-2/3/5/6,TRBJ1-1,CASSRIDTGGTGAFF,1,0,1,1
TRBV14,TRBJ2-4,CASSHWGMDKNIQYF,1,0,1,1
TRBV7-2,TRBJ1-4,CASSHQTGEGEKLFF,1,0,1,1
TRBV5-4,TRBJ2-1,CASSQTGGFWDEQFF,1,0,1,1
TRBV3-1,TRBJ2-7,CASSQDGVAHYEQYS,1,0,1,1
TRBV9,TRBJ2-7,CASSVAGTSSYEQYF,1,0,1,1
TRBV6-2/3/5/6,TRBJ2-3,CASSVGSGRADTQYF,1,0,1,1
TRBV9,TRBJ2-7,CASSVGLAGAYEQYF,1,0,1,1
TRBV9,TRBJ2-1,CASSAETSLYNEQFF,1,0,1,1
TRBV9,TRBJ2-7,CASSAGDSGSHEQYF,1,2,2,3
TRBV7-2,TRBJ2-7,CASSGSSGRGDEQYF,1,0,1,1
TRBV7-2,TRBJ2-5,CASSTKGWAQETQYF,1,0,1,1
TRBV11-2,TRBJ2-1,CASSTGLAGGDEQFF,1,1,2,2
TRBV6-2/3/5/6,TRBJ1-1,CASRSPGGSNTEAFF,1,0,1,1
TRBV12-3/4,TRBJ2-1,CASRLAGRSYNEQFF,1,0,1,1
TRBV6-2/3/5/6,TRBJ2-1,CASRAGTRPYNEQFF,1,0,1,1
TRBV12-3/4,TRBJ2-1,CASRFGGRGLNEQFF,1,0,1,1
TRBV5-1,TRBJ2-1,CASVPGPSPRDEQFF,1,0,1,1
TRBV5-1,TRBJ2-5,CASSFQGGGQETQYF,1,0,1,1
TRBV5-1,TRBJ2-7,CASSPVGGSTYEQYF,1,0,1,1
TRBV5-1,TRBJ1-1,CASSFDGQPNTEAFF,1,0,1,1
TRBV5-1,TRBJ2-5,CASSLSGGLQETQYS,1,0,1,1
TRBV5-1,TRBJ2-7,CASSLLPGGSYEQYF,1,0,1,1
TRBV5-1,TRBJ2-1,CASSLLPDSYNEQFF,1,0,1,1
TRBV5-1,TRBJ2-3,CASSLDGGQTDTQYF,1,0,1,1
TRBV5-1,TRBJ2-7,CASSLVAGEGLEQYF,1,0,1,1
TRBV5-1,TRBJ2-1,CASSSWGDLANEQFF,1,0,1,1
TRBV5-1,TRBJ2-3,CASSSGLADTDTQYF,2,0,1,2
TRBV4-1,TRBJ2-5,CASSSPGHRQETQYF,1,0,1,1
TRBV5-1,TRBJ2-7,CASSLLGGALYEQYF,1,0,1,1
TRBV5-1,TRBJ2-7,CASSLDRGASYEQYF,1,0,1,1
TRBV5-1,TRBJ2-3,CASSPDRLRTDTQYF,1,0,1,1
TRBV5-1,TRBJ2-1,CASSRELESNNEQFF,1,0,1,1
TRBV4-1,TRBJ2-1,CASSHTGTRSNEQFF,1,0,1,1
TRBV4-1,TRBJ2-7,CASSQVASGKYEQYF,1,0,1,1
TRBV4-1,TRBJ2-1,CASSQWSGTVNEQFF,1,0,1,1
TRBV4-1,TRBJ1-2,CASSQDYRQGYGYTF,1,0,1,1
TRBV5-1,TRBJ2-3,CASRPGTSGRDTQYF,1,0,1,1
TRBV5-1,TRBJ2-3,CASRTGLERSDTQYF,1,0,1,1
TRBV5-1,TRBJ2-5,CASNPSLGERETQYF,1,0,1,1
TRBV10-2,TRBJ2-3,CASKRQGGYSDTQYF,1,1,2,2
TRBV20-1,TRBJ2-7,CSVPQTGTGGGEQYF,1,0,1,1
TRBV20-1,TRBJ2-1,CSASTSGRGVNEQFF,1,0,1,1
TRBV20-1,TRBJ2-3,CSAGQTGTSADTQYF,1,0,1,1
TRBV20-1,TRBJ2-3,CSASLAGGWTDTQYF,1,0,1,1
TRBV20-1,TRBJ1-5,CSASGDQDSNQPQHF,1,0,1,1
TRBV20-1,TRBJ2-5,CSARDASGSDGTQYF,1,0,1,1
TRBV20-1,TRBJ2-7,CSARDGPADSYEQYF,1,0,1,1
TRBV29-1,TRBJ1-1,CSVVSQGQHGGEAFF,1,0,1,1
TRBV29-1,TRBJ2-3,CSVGDSGTVTDTEYF,1,0,1,1
TRBV29-1,TRBJ2-7,CSVGNFGTGNYEQYF,1,0,1,1
TRBV29-1,TRBJ2-3,CSVEDLAGSPDTQYF,1,0,1,1
TRBV29-1,TRBJ2-7,CSARGPGQGDWEQYF,1,0,1,1
TRBV7-3,TRBJ1-4,RASKILWERDEKLFF,1,0,1,1
TRBV30,TRBJ2-2,CAWSRDPQAGELFF,1,0,1,1
TRBV19,TRBJ2-1,CATTPGLPNNEQFF,1,0,1,1
TRBV24-1,TRBJ2-5,CATSDLTQKETQYF,1,0,1,1
TRBV24-1,TRBJ2-2,CATSDDRARGELFF,1,0,1,1
TRBV24-1,TRBJ2-3,CATRQGAGTDTQYF,1,0,1,1
TRBV19,TRBJ1-5,CASSVTGAHQPQHF,1,0,1,1
TRBV19,TRBJ1-5,CASSEQGLGQPQHF,1,0,1,1
TRBV19,TRBJ2-1,CASSIAGWGNEQFF,1,0,1,1
TRBV19,TRBJ2-7,CASSIEGRNYEQYF,1,0,1,1
TRBV19,TRBJ1-5,CASSTRGAWQPQHF,1,0,1,1
TRBV19,TRBJ2-1,CASSSGQKINERFF,1,0,1,1
TRBV19,TRBJ2-4,CASSKRGTKNIQYF,1,0,1,1
TRBV19,TRBJ2-5,CASSEAGGRETQYF,1,0,1,1
TRBV19,TRBJ2-3,CASRRQVGTDTQYF,1,0,1,1
TRBV6-2/3/5/6,TRBJ2-1,CASSVTGGYNEQFF,1,0,1,1
TRBV18,TRBJ2-5,CASSPPSRQETQYF,1,0,1,1
TRBV18,TRBJ2-7,CASSPANSGGEQYF,1,0,1,1
TRBV27,TRBJ1-1,CASSITGANTEAFF,1,0,1,1
TRBV12-3/4,TRBJ2-7,CASPKVGTAYEQYF,1,0,1,1
TRBV28,TRBJ2-1,CASASGGAYNEQFF,1,0,1,1
TRBV12-3/4,TRBJ2-7,CASGLGGDLYEQYF,1,0,1,1
TRBV2,TRBJ2-5,CASELAGGQETQYF,1,0,1,1
TRBV6-2/3/5/6,TRBJ2-7,CASIGTVSSYEQYF,1,0,1,1
TRBV12-3/4,TRBJ2-5,CASSFGTWGETQYF,1,0,1,1
TRBV12-3/4,TRBJ2-7,CASSLGPVIYEQYF,1,0,1,1
TRBV12-3/4,TRBJ1-4,CASSLTGGDEKLFF,1,0,1,1
TRBV12-3/4,TRBJ2-7,CASSSLSYPGEQYF,1,0,1,1
TRBV12-3/4,TRBJ1-1,CASSSIDSLTEAFF,1,0,1,1
TRBV6-2/3/5/6,TRBJ1-2,CASSSGGGSVGYTF,1,0,1,1
TRBV6-2/3/5/6,TRBJ2-2,CASSPSGPTGELFF,1,0,1,1
TRBV28,TRBJ2-5,CASSPASRVETQYF,1,0,1,1
TRBV27,TRBJ2-1,CASSPGRGGNEQFF,1,0,1,1
TRBV11-1,TRBJ1-1,CASSPDGMNTEAFF,1,0,1,1
TRBV7-6,TRBJ2-3,CASSPNRGADTQYF,1,0,1,1
TRBV11-3,TRBJ2-1,CASSRGGGVYEQFF,1,0,1,1
TRBV7-2,TRBJ2-3,CASSGVSSTDTQYF,1,0,1,1
TRBV2,TRBJ2-3,CASSGSPRADTQYF,1,0,1,1
TRBV2,TRBJ2-3,CASSGQTPTDTQYF,1,0,1,1
TRBV6-1,TRBJ1-2,CASSEQTGRYGYTF,1,0,1,1
TRBV6-1,TRBJ1-2,CASSETGGSGRNTF,1,0,1,1
TRBV6-2/3/5/6,TRBJ2-5,CASSTWGSQETQYF,1,0,1,1
TRBV7-9,TRBJ2-1,CASSFQGRYNEQFF,1,1,2,2
TRBV7-9,TRBJ2-7,CASSFRGRAEEQYF,1,0,1,1
TRBV5-4,TRBJ2-1,CASSFPGKQSEQFF,1,0,1,1
TRBV5-6,TRBJ2-2,CASSLLGNTGELFF,1,1,2,2
TRBV5-5,TRBJ2-7,CASSLLDITYEQYF,1,0,1,1
TRBV5-6,TRBJ2-5,CASSLRGQGETQYF,1,0,1,1
TRBV5-6,TRBJ1-1,CASSLKGTAAEAFF,1,0,1,1
TRBV11-1,TRBJ2-1,CASSLVAGTGVPFF,1,3,2,4
TRBV7-2,TRBJ2-7,CASSLGAGGSEQYF,1,0,1,1
TRBV7-6,TRBJ1-2,CASSLGGFMDGYTF,1,0,1,1
TRBV7-9,TRBJ1-4,CASSLGGYGEKLFF,1,1,2,2
TRBV14,TRBJ1-1,CASSSDRGQGEAFF,1,0,1,1
TRBV7-9,TRBJ2-1,CASSSRILYNEQFF,1,0,1,1
TRBV7-3,TRBJ2-2,CASSSQGGAGELFF,1,0,1,1
TRBV11-2,TRBJ2-7,CASSSPGSPVGQYF,1,0,1,1
TRBV7-3,TRBJ2-7,CASSSGQINYEQYF,1,0,1,1
TRBV7-6,TRBJ1-1,CASSSAPRDTEAFF,1,0,1,1
TRBV11-2,TRBJ2-1,CASSWDWGDNEQFF,1,0,1,1
TRBV7-8,TRBJ2-7,CASSYRQGTYEQYF,1,0,1,1
TRBV9,TRBJ2-3,CASSPIPSTDTQYF,1,1,2,2
TRBV3-1,TRBJ1-3,CASSPGTAGNTIYF,1,0,1,1
TRBV7-9,TRBJ2-7,CASSPGLAGDEQYF,1,0,1,1
TRBV7-3,TRBJ2-5,CASSPTGLQETQYF,1,0,1,1
TRBV11-2,TRBJ2-5,CASSPGTGSETQYF,1,0,1,1
TRBV7-8,TRBJ2-1,CASSPRTSGHEQFF,1,0,1,1
TRBV5-4,TRBJ2-1,CASSRAGTFNEQFF,1,0,1,1
TRBV12-3/4,TRBJ2-3,CASSRPTSTDTQYF,1,0,1,1
TRBV14,TRBJ2-7,CASSHTTLSYEQYF,1,1,2,2
TRBV3-1,TRBJ2-7,CASSQAPTGNEQYF,1,0,1,1
TRBV6-4,TRBJ2-1,CASSQDRSYNEQFF,1,0,1,1
TRBV14,TRBJ2-1,CASSQDQLYNEQFF,1,1,2,2
TRBV9,TRBJ2-7,CASSVEPVTSEQYF,1,0,1,1
TRBV7-2,TRBJ1-2,CASSAPDVGYGYTF,1,0,1,1
TRBV9,TRBJ2-1,CASSADWGPNEQFF,1,0,1,1
TRBV2,TRBJ2-2,CASSGLAGVGELFF,1,0,1,1
TRBV7-8,TRBJ2-3,CASSGALSTDTQYF,1,0,1,1
TRBV2,TRBJ2-3,CASSGGVTTDTQYF,1,0,1,1
TRBV3-1,TRBJ2-3,CASSDGLHTDTQYF,1,0,1,1
TRBV3-1,TRBJ2-7,CASSTGTSAYEQYF,1,0,1,1
TRBV7-6,TRBJ1-4,CASSNSISNEKLFF,1,0,1,1
TRBV12-3/4,TRBJ2-1,CASREGLAGNEQFF,1,0,1,1
TRBV7-2,TRBJ2-7,CASRLAVSSYEQYF,1,0,1,1
TRBV11-2,TRBJ2-3,CASRRTQSGDTQYF,1,0,1,1
TRBV2,TRBJ1-3,CASRAPPTGNTIYF,1,0,1,1
TRBV7-9,TRBJ2-1,CASREIGPFNEQFF,1,0,1,1
TRBV11-2,TRBJ1-2,CASNIQGGTCGYTF,1,0,1,1
TRBV12-3/4,TRBJ1-1,CASKERNQPTEAFF,1,0,1,1
TRBV10-3,TRBJ2-3,CANSAGGLADTQYF,1,0,1,1
TRBV5-1,TRBJ2-3,CASMRADPTDTQYF,1,0,1,1
TRBV5-1,TRBJ2-2,CASSLALFPGELFF,1,0,1,1
TRBV5-1,TRBJ2-1,CASSLGVYANEQFF,1,0,1,1
TRBV5-1,TRBJ2-5,CASSLGQGVKTQYF,1,0,1,1
TRBV5-1,TRBJ2-7,CASSLGTEGYEQYF,1,0,1,1
TRBV5-1,TRBJ2-7,CASSLDQGGREQYF,1,0,1,1
TRBV5-1,TRBJ2-1,CASSLDEGYNEQFF,1,0,1,1
TRBV5-1,TRBJ2-1,CASSLEGTPNEQFF,1,0,1,1
TRBV5-1,TRBJ2-3,CASSLDGGQDTQYF,1,0,1,1
TRBV5-1,TRBJ2-1,CASSSTSSYNEQFF,1,1,2,2
TRBV5-1,TRBJ1-4,CASSWGAGKEKLFF,1,0,1,1
TRBV5-1,TRBJ2-1,CASSLITGGNEQFF,1,0,1,1
TRBV5-1,TRBJ2-7,CASSPGQGTYEQYF,1,0,1,1
TRBV5-1,TRBJ1-2,CASSPDGLKDGYTF,1,0,1,1
TRBV4-1,TRBJ1-1,CASSQREVGTEAFF,1,0,1,1
TRBV5-1,TRBJ2-1,CASSGDGGSGEQFF,1,0,1,1
TRBV5-1,TRBJ1-1,CASSMGRTDDKAFF,1,0,1,1
TRBV20-1,TRBJ2-5,CSVLAGQGRETQYF,1,0,1,1
TRBV20-1,TRBJ2-1,CSASRGPTYNEQFF,1,0,1,1
TRBV20-1,TRBJ2-7,CSALLAGGRYEQYF,1,0,1,1
TRBV20-1,TRBJ2-1,CSAVRPIATNEQFF,1,0,1,1
TRBV20-1,TRBJ2-1,CSASRLAVYNEQFF,1,0,1,1
TRBV20-1,TRBJ2-3,CSARTSGRADTQYF,1,0,1,1
TRBV20-1,TRBJ1-2,CSAREGSEDYGYTF,1,0,1,1
TRBV20-1,TRBJ2-7,CSAEAGTGTYEQYF,1,0,1,1
TRBV20-1,TRBJ2-3,CSAISGRVEDTQYF,1,0,1,1
TRBV20-1,TRBJ2-5,CSGSGAPKRETQYF,1,0,1,1
TRBV29-1,TRBJ2-1,CSVSPSGRYNEQFF,1,0,1,1
TRBV29-1,TRBJ2-1,CSVRVPNNPNEQFF,1,0,1,1
TRBV29-1,TRBJ2-2,CSVQGASNTGELFF,1,0,1,1
TRBV29-1,TRBJ2-5,CSVVSDTGQVTQYF,1,0,1,1
TRBV29-1,TRBJ2-5,CSVVLQGGRETQYF,1,0,1,1
TRBV29-1,TRBJ2-3,CSVELRGPTDTQYF,1,0,1,1
TRBV29-1,TRBJ1-5,CSVASGNSNQPQHF,1,0,1,1
TRBV29-1,TRBJ2-7,CSVTTTGSVYEQYF,1,0,1,1
TRBV29-1,TRBJ2-5,CSASVGSRTSAQYF,1,0,1,1
TRBV12-5,TRBJ2-3,CASRREDTDTQYF,1,0,1,1
TRBV7-3,TRBJ2-3,CASGPGSTDTQYF,1,3,2,4
TRBV28,TRBJ2-7,CASGRASPYEQYF,1,0,1,1
TRBV2,TRBJ1-5,CATRVMGNQPQHF,1,0,1,1
TRBV19,TRBJ2-2,CASADSNTGELFF,1,0,1,1
TRBV19,TRBJ1-6,CASTRDTNSPLHF,1,0,1,1
TRBV19,TRBJ1-2,CASTVGQLYGYTF,1,0,1,1
TRBV19,TRBJ1-1,CASSSRANTEAFF,1,0,1,1
TRBV19,TRBJ2-7,CASSKEGSYEQYF,1,0,1,1
TRBV19,TRBJ2-1,CASRRAGMTEQFF,1,0,1,1
TRBV19,TRBJ2-2,CASNNIRGIGLFF,1,0,1,1
TRBV18,TRBJ1-1,CASSRNRDLEAFF,2,0,1,2
TRBV18,TRBJ2-7,CASSLGTSGEQYF,1,0,1,1
TRBV18,TRBJ1-1,CASSPDRNTEAFF,1,0,1,1
TRBV7-9,TRBJ2-7,CASRGQGTYEQYF,1,0,1,1
TRBV28,TRBJ2-1,CASRQGINNEQFF,1,0,1,1
TRBV2,TRBJ2-4,CASATSGENIQHF,1,0,1,1
TRBV27,TRBJ2-7,CASTFGGTYEQYF,1,0,1,1
TRBV12-3/4,TRBJ2-3,CASTAGSTDTQYF,1,0,1,1
TRBV12-3/4,TRBJ1-2,CASTRTGGSGYTF,1,0,1,1
TRBV12-3/4,TRBJ2-7,CASSLRGPGFQYF,1,0,1,1
TRBV6-2/3/5/6,TRBJ2-5,CASSSLRGETQYF,1,0,1,1
TRBV6-2/3/5/6,TRBJ2-1,CASSYPGAEEQFF,1,0,1,1
TRBV6-2/3/5/6,TRBJ1-1,CASSYARNTEAFF,1,0,1,1
TRBV6-2/3/5/6,TRBJ2-3,CASSYKHTDTQYF,1,0,1,1
TRBV13,TRBJ2-1,CASSLRLVNEQFF,1,1,2,2
TRBV28,TRBJ2-2,CASSLSGARELFF,1,0,1,1
TRBV25-1,TRBJ2-7,CASSAPGAYEQYF,1,0,1,1
TRBV2,TRBJ1-4,CASSARGNEKLFF,1,0,1,1
TRBV2,TRBJ2-3,CASSEGSQDTQYF,1,0,1,1
TRBV2,TRBJ1-1,CASSENGNTEAFF,1,0,1,1
TRBV2,TRBJ2-3,CASSEEARNTQYF,1,0,1,1
TRBV7-2,TRBJ2-1,CASSFDRADEQFF,1,0,1,1
TRBV5-6,TRBJ2-5,CASSFEGSETQYF,1,0,1,1
TRBV7-6,TRBJ1-2,CASSFPGGYGYTF,1,0,1,1
TRBV11-2,TRBJ2-7,CASSLGELYEQYF,1,0,1,1
TRBV7-2,TRBJ2-5,CASSLSRLETQYF,1,0,1,1
TRBV7-2,TRBJ2-1,CASSLQSYNEQFF,1,0,1,1
TRBV11-2,TRBJ1-5,CASSLGGPRPQHF,1,0,1,1
TRBV7-2,TRBJ2-1,CASSLEGYNEQFF,1,0,1,1
TRBV7-6,TRBJ2-6,CASSSGQGTVLTL,1,0,1,1
TRBV7-2,TRBJ1-1,CASSLSVNTEAFF,1,0,1,1
TRBV6-2/3/5/6,TRBJ2-5,CASSLGEPRAQYF,1,0,1,1
TRBV28,TRBJ1-2,CASSPQDLYGYTF,1,0,1,1
TRBV7-8,TRBJ2-1,CASSPPRGDEQFF,1,0,1,1
TRBV14,TRBJ2-2,CASSPRTVGELFF,1,0,1,1
TRBV7-2,TRBJ2-5,CASSPRVQETQYF,1,0,1,1
TRBV7-9,TRBJ2-1,CASSPGQPNEQFF,1,0,1,1
TRBV11-2,TRBJ2-3,CASSRQGTDTQYF,1,0,1,1
TRBV7-6,TRBJ2-3,CASSHRSTDTQYF,1,0,1,1
TRBV16,TRBJ2-1,CASSQPSSGEQFF,1,0,1,1
TRBV14,TRBJ2-7,CASSQGLAYEQYF,1,0,1,1
TRBV3-1,TRBJ1-2,CASSQGQLYGYTF,1,0,1,1
TRBV7-3,TRBJ2-1,CASSQGGHNEQFF,1,0,1,1
TRBV7-2,TRBJ1-6,CASSALREGQNHF,1,0,1,1
TRBV9,TRBJ2-7,CASSAGLSYEQYF,1,0,1,1
TRBV11-1,TRBJ1-1,CASSAEMNSEAFF,1,0,1,1
TRBV7-3,TRBJ2-1,CASSARGGNEQFF,1,0,1,1
TRBV7-9,TRBJ2-5,CASSIGSEETQYF,1,0,1,1
TRBV7-2,TRBJ2-1,CASSKPGTLQQFF,1,0,1,1
TRBV7-2,TRBJ2-7,CASRRGGSYEQYF,1,0,1,1
TRBV28,TRBJ2-3,CASRRDSTDTQYF,1,0,1,1
TRBV2,TRBJ2-7,CASKFGEDYEQYF,1,0,1,1
TRBV27,TRBJ2-7,CASKRTGINEKYF,1,0,1,1
TRBV5-1,TRBJ1-2,CASSLVAGDGYTF,1,0,1,1
TRBV5-1,TRBJ2-3,CASSLASTDTQYF,1,0,1,1
TRBV5-1,TRBJ2-7,CASSLGQPWEQYF,1,0,1,1
TRBV5-1,TRBJ2-7,CASSLGGSDEQYF,1,0,1,1
TRBV4-1,TRBJ1-5,CASSSGANQPQHF,1,0,1,1
TRBV5-1,TRBJ2-7,CASSPATNYEQYF,1,0,1,1
TRBV5-1,TRBJ2-3,CASSVTGSDTQYF,1,0,1,1
TRBV5-1,TRBJ1-2,CASSIQGARGYTF,1,0,1,1
TRBV5-1,TRBJ2-7,CASKTSGFDEQYF,1,0,1,1
TRBV20-1,TRBJ2-7,CSASGTAGYEQYF,1,0,1,1
TRBV20-1,TRBJ2-7,CSAWTSGIYEQYF,1,0,1,1
TRBV20-1,TRBJ2-5,CSASWGYAETQYF,2,0,1,2
TRBV20-1,TRBJ2-3,CSARWLAQDTQYF,1,0,1,1
TRBV20-1,TRBJ1-1,CSAPQGAIAEAFF,1,0,1,1
TRBV20-1,TRBJ1-2,CSARTVSNYGYTF,1,1,2,2
TRBV29-1,TRBJ1-3,CSVPGNSGNTIYF,1,0,1,1
TRBV29-1,TRBJ1-1,CSVEREAGIEAFF,1,0,1,1
TRBV29-1,TRBJ2-1,CSVTRDSNNEQFF,1,0,1,1
TRBV7-9,TRBJ2-7,YASSLGRGYEQCL,1,0,1,1
TRBV12-5,TRBJ2-1,CASGLLSNEQFF,1,1,2,2
TRBV10-3,TRBJ2-5,CAISARGETQYF,1,0,1,1
TRBV19,TRBJ1-1,CATQTGNTEAFF,1,0,1,1
TRBV15,TRBJ2-1,CATSNRVNEQFF,1,0,1,1
TRBV19,TRBJ2-3,CASSIDLQTQYF,1,0,1,1
TRBV19,TRBJ1-1,CASSTVNTEAFF,1,0,1,1
TRBV19,TRBJ2-1,CASKGSSNEQLF,1,0,1,1
TRBV12-3/4,TRBJ2-3,CASGRGSDTQYF,1,0,1,1
TRBV2,TRBJ2-3,CASTKSGDTQYF,1,0,1,1
TRBV12-3/4,TRBJ2-7,CASSFQTYEQYF,1,0,1,1
TRBV28,TRBJ2-1,CASSPGVDQQFF,1,0,1,1
TRBV2,TRBJ1-2,CASSAQGNGYTF,1,0,1,1
TRBV2,TRBJ2-3,CASSGLADTQYF,2,0,1,2
TRBV7-9,TRBJ2-7,CASSLSGYEQYF,1,0,1,1
TRBV7-8,TRBJ2-5,CASSLGLETQYF,1,1,2,2
TRBV7-9,TRBJ2-1,CASSSTGNEQFF,1,0,1,1
TRBV7-8,TRBJ2-2,CASSPTTGELFF,1,0,1,1
TRBV7-9,TRBJ1-1,CASSPQNTEAFF,1,0,1,1
TRBV9,TRBJ2-7,CASSPGIYEQYF,1,0,1,1
TRBV7-8,TRBJ1-2,CASSRSGDGYTF,1,0,1,1
TRBV11-2,TRBJ2-5,CASSRGLETQYF,1,0,1,1
TRBV4-2,TRBJ2-2,CASSQASGELFF,1,0,1,1
TRBV3-1,TRBJ1-2,CASSQGREGYTF,1,0,1,1
TRBV2,TRBJ2-2,CASSVGNGELFF,1,0,1,1
TRBV7-2,TRBJ2-1,CASSASPNEQFF,1,0,1,1
TRBV7-9,TRBJ2-7,CASSISSYEQCF,1,0,1,1
TRBV6-4,TRBJ1-2,CASRSGGIGYTF,1,0,1,1
TRBV7-2,TRBJ2-3,CASRLDIDTQYF,1,0,1,1
TRBV28,TRBJ2-3,CASNEGTDTQYF,1,0,1,1
TRBV5-1,TRBJ2-5,CASSSEEETQYF,1,0,1,1
TRBV5-1,TRBJ1-2,CASSPDSRGYTF,2,0,1,2
TRBV20-1,TRBJ1-2,CSARDLDYGYTF,1,0,1,1
TRBV20-1,TRBJ2-5,CSAKDGRETQYF,1,0,1,1
TRBV20-1,TRBJ2-5,CSAASGQETQYF,1,0,1,1
TRBV20-1,TRBJ2-3,CSANGQADTQYF,1,0,1,1
TRBV29-1,TRBJ2-7,CSVEGDRASQYF,1,0,1,1
TRBV29-1,TRBJ2-4,CSVTVGGNIQYF,1,0,1,1
TRBV29-1,TRBJ2-7,CSVAIGPLEQYS,1,0,1,1
TRBV29-1,TRBJ2-7,CSVEDSSYEQYF,1,0,1,1
TRBV29-1,TRBJ2-7,CSAQRSSYEQYF,1,0,1,1
TRBV12-3/4,TRBJ1-2,RASSSPQGGYTF,1,0,1,1
TRBV30,TRBJ1-1,CAGRDVIEAFF,1,0,1,1
TRBV3-1,TRBJ1-1,CASLGTAEAFF,1,0,1,1
TRBV28,TRBJ2-5,CASSLGETQYF,1,0,1,1
TRBV6-2/3/5/6,TRBJ2-7,CASSSFFEQYF,1,0,1,1
TRBV6-2/3/5/6,TRBJ2-5,CASSYSGTQYF,1,0,1,1
TRBV5-4,TRBJ2-5,CASSFQETQYF,1,0,1,1
TRBV7-9,TRBJ2-1,CASSLYNEQFF,1,1,2,2
TRBV7-2,TRBJ2-1,CASSPLNEQFF,1,0,1,1
TRBV3-1,TRBJ2-1,CASSQVSEQFF,1,0,1,1
TRBV6-2/3/5/6,TRBJ2-1,CASRGSNEQFF,1,0,1,1
TRBV6-2/3/5/6,TRBJ2-3,CASRTENTQYF,1,0,1,1
TRBV20-1,TRBJ2-7,CSARRSYEQYF,1,0,1,1
TRBV29-1,TRBJ2-1,CSVDLGGEQFF,1,0,1,1
TRBV29-1,TRBJ1-2,CSASRGGGYTF,1,0,1,1
TRBV29-1,TRBJ2-7,CSARAGSEQYF,1,0,1,1
TRBV20-1,TRBJ2-7,CSISTSYEQYF,1,0,1,1
TRBV6-2/3/5/6,TRBJ2-1,WASSWDREQFF,1,0,1,1
TRBV6-2/3/5/6,TRBJ2-7,CASNPYEQYF,1,0,1,1
TRBV11-2,TRBJ2-1,CASSLEVSGGLAGYNEQSF,2,0,1,2
TRBV6-2/3/5/6,TRBJ1-5,CASRLFGGGRFYNQPQHF,2,1,2,3
TRBV5-1,TRBJ2-1,CASSTGQGSSYNEQFF,1,0,1,1
TRBV19,TRBJ2-1,CASSTTSGALNDQFF,2,0,1,2
TRBV5-6,TRBJ2-5,CASIRQDRVQETQYF,1,1,2,2
TRBV12-3/4,TRBJ1-1,CASTKAGIMNTEAFF,1,0,1,1
TRBV7-2,TRBJ2-3,CASSLDNPGADTQYF,1,0,1,1
TRBV5-1,TRBJ2-7,CASSFSGQGAGEQYF,1,1,2,2
TRBV29-1,TRBJ2-3,CSVRGGGTGQTTQYL,1,0,1,1
TRBV19,TRBJ1-2,CASSRTGLGYGYTF,2,0,1,2
TRBV11-2,TRBJ1-1,CASSLGAANTEAFF,1,0,1,1
TRBV7-9,TRBJ2-3,CASSQGLYTDTQYF,1,0,1,1
TRBV14,TRBJ2-3,CASSKNNYGTTQYF,1,0,1,1
TRBV9,TRBJ2-3,CASSALNTDTQYF,1,0,1,1
TRBV5-1,TRBJ2-1,CASSLSSYNEQFF,2,0,1,2
TRBV7-9,TRBJ2-1,CASPNEQFF,1,0,1,1
TRBV7-9,TRBJ2-6,CASSLARAQTGTGRQPSGANVLAF,1,0,1,1
TRBV15,TRBJ2-4,CATSRDRPTGLAGLAKNIQYF,1,0,1,1
TRBV15,TRBJ2-5,CATSRDSRWGGREEETQYF,1,0,1,1
TRBV6-2/3/5/6,TRBJ2-1,CASSFGLAGGKGGYNEQFF,1,0,1,1
TRBV28,TRBJ2-3,CASSLSGPGGNSGGDTQYF,1,0,1,1
TRBV28,TRBJ2-7,CASSLSGGAVWGSLYEQYF,1,0,1,1
TRBV7-2,TRBJ2-3,CASSLAPGLAGGSKTTQYF,1,0,1,1
TRBV7-9,TRBJ1-5,CASSLKGEGGGGGGQPQHF,1,0,1,1
TRBV9,TRBJ2-6,CASSVALRGRGSGANVLTF,1,0,1,1
TRBV5-1,TRBJ2-1,CASSLGSGTSGSSYNEQFF,1,1,2,2
TRBV5-1,TRBJ2-6,CASSPRSGSRGSGANVLTF,1,0,1,1
TRBV4-1,TRBJ2-5,CASSHTAGTGFGSQETQYF,1,0,1,1
TRBV5-1,TRBJ2-1,CASSTTSGSLRDTSDEQFF,1,0,1,1
TRBV5-1,TRBJ2-3,CASSKGLAGGGGGTDTQYF,1,0,1,1
TRBV20-1,TRBJ2-1,CSARAFQGLAGRTYNEQFF,1,1,2,2
TRBV30,TRBJ1-5,CAWRATQGYAFGNQPQHF,1,0,1,1
TRBV19,TRBJ2-1,CASSKFSTSGKFINEQFF,1,0,1,1
TRBV19,TRBJ2-1,CASSRLAGGRGLGNEQFF,1,0,1,1
TRBV18,TRBJ2-7,CASSPRSGGRTPSYEQYF,1,0,1,1
TRBV7-9,TRBJ2-7,CASTYSGTGRNAAYEQYF,1,0,1,1
TRBV12-3/4,TRBJ2-6,CASTTYDLGGAGANVLTF,1,0,1,1
TRBV6-1,TRBJ2-3,CASSAGLSNPISTDTQYF,1,0,1,1
TRBV6-1,TRBJ2-3,CASSEALSGRGGTDTQYF,1,0,1,1
TRBV7-8,TRBJ2-5,CASSFPGTSGNEGETQYF,1,0,1,1
TRBV11-2,TRBJ2-3,CASSSFGTSGRSTDTQYF,1,0,1,1
TRBV2,TRBJ2-7,CASSLQGGRPTHIYEQYF,1,0,1,1
TRBV3-1,TRBJ2-6,CASSLRTGQGAGANVLTF,1,0,1,1
TRBV3-1,TRBJ2-6,CASSQSEGPLLGANVLTF,1,0,1,1
TRBV4-2,TRBJ2-7,CASSQDRQIGGAAYEQYF,1,0,1,1
TRBV7-2,TRBJ2-5,CASSISWTSGDTAETQYF,1,0,1,1
TRBV2,TRBJ1-6,CASNIPAGTADVNSPLHF,1,0,1,1
TRBV4-1,TRBJ1-2,CASSQAGGRDTLGYGYTF,1,0,1,1
TRBV4-1,TRBJ2-4,CASSQGTGVTKAKNIQYF,1,0,1,1
TRBV4-1,TRBJ1-1,CASSQGFGQGVWGTEAFF,1,0,1,1
TRBV4-1,TRBJ2-1,CASSQDTVRQGAYNEQFF,1,0,1,1
TRBV5-1,TRBJ2-1,CASSIGVSSGRAGNEQFF,1,0,1,1
TRBV5-1,TRBJ2-5,CASSTGTSGSPNQETQYF,1,0,1,1
TRBV4-1,TRBJ2-1,CASSRLGLAGPMGNEQFF,1,0,1,1
TRBV20-1,TRBJ2-1,CSAGGRGASGSSYNEQFF,1,0,1,1
TRBV20-1,TRBJ2-3,CSARGTRSSGVGTDTQYF,1,0,1,1
TRBV20-1,TRBJ2-5,CSARDPGGLALYQETQYF,1,0,1,1
TRBV29-1,TRBJ2-1,CSVPLPLFEVRAYNEQFF,1,0,1,1
TRBV10-3,TRBJ2-6,CAISESIARAGANVLTF,1,0,1,1
TRBV10-3,TRBJ2-2,CATTGTSGRRNTGELFF,1,0,1,1
TRBV24-1,TRBJ2-1,CATSGRRLAASYNEQFF,1,0,1,1
TRBV12-3/4,TRBJ2-3,CASSFWRREVFTDTQYF,1,1,2,2
TRBV27,TRBJ2-3,CASSFRPSGQGTDTQYF,1,0,1,1
TRBV27,TRBJ2-3,CASSLPLVGGVTDTQYF,1,0,1,1
TRBV5-8,TRBJ2-1,CASSSGTSAGLENEQFF,1,0,1,1
TRBV27,TRBJ2-1,CASSSVSGTSRTMKQFF,1,0,1,1
TRBV6-2/3/5/6,TRBJ2-3,CASSPPRSWEGTDTLYF,1,0,1,1
TRBV6-1,TRBJ2-2,CASSEAFMAGGTGELFF,1,0,1,1
TRBV7-9,TRBJ2-5,CASSFETGTSGRETQYF,1,0,1,1
TRBV7-9,TRBJ2-2,CASSLPRAGVRGGELFF,1,0,1,1
TRBV11-2,TRBJ2-3,CASSLVGLADYTDAQYF,1,0,1,1
TRBV7-9,TRBJ1-1,CASSLGARDRGNTEAFF,1,0,1,1
TRBV13,TRBJ2-3,CASSWRGGGSPTDTQYF,1,0,1,1
TRBV9,TRBJ2-1,CASSLTPGTDSYNEQFF,1,0,1,1
TRBV7-9,TRBJ1-3,CASSLTTGTGGMDTIYF,1,0,1,1
TRBV7-2,TRBJ2-5,CASSPPGGIAGVETQYF,1,0,1,1
TRBV3-1,TRBJ2-6,CASSPTGGGSGANVLTF,1,0,1,1
TRBV7-6,TRBJ1-6,CASSPDGMSSYNSPLHF,1,0,1,1
TRBV4-2,TRBJ2-2,CASSQLEGAGGGGELFF,1,0,1,1
TRBV3-1,TRBJ2-5,CASSQRTSGSFQETQYF,1,0,1,1
TRBV3-1,TRBJ1-6,CASSQDGGGSLNSPLHF,1,0,1,1
TRBV9,TRBJ2-2,CASSVGLAGGSTGELFF,1,0,1,1
TRBV6-2/3/5/6,TRBJ2-3,CASSISGRVRGTDTQYF,1,0,1,1
TRBV7-2,TRBJ2-1,CASSTWDRDRGHNEQFF,1,0,1,1
TRBV7-9,TRBJ1-3,CASSTYRDAGSGNTIYF,1,0,1,1
TRBV7-6,TRBJ1-1,CASSRMPGQSLGTEAFF,1,1,2,2
TRBV7-9,TRBJ2-1,CASSKEALAGGNNEQFF,1,1,2,2
TRBV5-6,TRBJ1-1,CASRRGTGLGVDTEAFF,1,0,1,1
TRBV5-6,TRBJ1-2,CASRVKSLEEANYGYTF,1,0,1,1
TRBV5-1,TRBJ2-1,CASAFGTLAGGYNEQFF,1,0,1,1
TRBV5-1,TRBJ2-3,CASGSGRRSSPTDTQYF,1,0,1,1
TRBV10-2,TRBJ2-7,CASSESGPSGISYEQYY,1,0,1,1
TRBV5-1,TRBJ2-1,CASSLGSGTSGPNEQFF,1,0,1,1
TRBV5-1,TRBJ2-5,CASSLGPGTSALETQYF,1,0,1,1
TRBV5-1,TRBJ1-1,CASSLVRGMTPDTEAFF,1,0,1,1
TRBV4-1,TRBJ2-3,CASSPRFEGLEKDTQYF,1,0,1,1
TRBV4-1,TRBJ2-6,CASSPHYRSSGANVLTF,1,0,1,1
TRBV4-1,TRBJ1-2,CASSQLLRTRANYGYTF,1,0,1,1
TRBV4-1,TRBJ2-5,CASSQGRITGGSETQYF,1,0,1,1
TRBV4-1,TRBJ2-7,CASSQDSPGQGRDEQYF,1,0,1,1
TRBV4-1,TRBJ2-2,CASSQETGLAGTGELFF,1,1,2,2
TRBV4-1,TRBJ2-7,CASSQEGTGGTGYEQYF,1,0,1,1
TRBV29-1,TRBJ2-3,CSVEAWTSGRATDTQYF,1,0,1,1
TRBV29-1,TRBJ2-1,CSVEATSGGSSYNEQFF,1,0,1,1
TRBV28,TRBJ2-4,CVSSLLAGLAENIQYF,1,0,1,1
TRBV30,TRBJ1-1,CAWSAPGGSGITEAFF,1,0,1,1
TRBV30,TRBJ2-5,CAWSSLAGEYQETQYF,1,0,1,1
TRBV7-9,TRBJ2-5,CAISHPRLALRETQYF,1,0,1,1
TRBV19,TRBJ2-1,CATTKSRAISYNEQFF,1,0,1,1
TRBV15,TRBJ2-2,CATSRDRGWGGGELFF,1,0,1,1
TRBV19,TRBJ2-1,CASESRVGAAYNEQFF,1,0,1,1
TRBV19,TRBJ2-1,CASSTLLAGGYNEQFF,1,0,1,1
TRBV19,TRBJ2-1,CASSNRIIGGRDEQFF,1,0,1,1
TRBV19,TRBJ1-5,CASRGTGLGFNQPQHF,1,0,1,1
TRBV18,TRBJ2-1,CASSPAFGVSYNEQFF,1,0,1,1
TRBV18,TRBJ2-1,CASSRASGQIYNEQFF,1,0,1,1
TRBV18,TRBJ2-7,CASSSSPSGRGHEQYF,1,0,1,1
TRBV12-3/4,TRBJ2-3,CASTPPGTGVKGTQYF,1,0,1,1
TRBV2,TRBJ2-3,CASTQIKAGGQDTQYF,1,0,1,1
TRBV2,TRBJ2-3,CASTIRASGRSDTQYF,1,0,1,1
TRBV28,TRBJ2-1,CASSLGGGQGHNEQFF,1,0,1,1
TRBV6-2/3/5/6,TRBJ2-7,CASSLRGASGNYEQYF,1,0,1,1
TRBV6-2/3/5/6,TRBJ1-5,CASSSPGGYSNQPQHF,1,0,1,1
TRBV12-3/4,TRBJ2-1,CASSSTGSERRNGQFF,1,0,1,1
TRBV6-2/3/5/6,TRBJ2-1,CASSSLAAPSYNEQFF,1,0,1,1
TRBV12-3/4,TRBJ1-2,CASSPPSLGGLWGYTF,1,0,1,1
TRBV6-2/3/5/6,TRBJ2-6,CASSHAGTGARGVLTF,1,0,1,1
TRBV6-1,TRBJ2-1,CASSGGAGGEGNEQFF,1,0,1,1
TRBV6-1,TRBJ2-7,CASSGITRGTAYEQYF,1,1,2,2
TRBV25-1,TRBJ2-5,CASSESGRGGQETQYF,1,0,1,1
TRBV2,TRBJ2-1,CASSERFLALYKEQFF,1,0,1,1
TRBV6-2/3/5/6,TRBJ1-6,CASSTYRGQYNSPLHF,1,0,1,1
TRBV5-6,TRBJ2-3,CASSFFSGRAADTQYF,1,0,1,1
TRBV9,TRBJ2-1,CASSFSSGISTDEQFF,1,0,1,1
TRBV5-5,TRBJ1-5,CASSLRQGYSNQPQHF,1,0,1,1
TRBV5-5,TRBJ2-1,CASSLASGKSYNEQFF,1,0,1,1
TRBV11-2,TRBJ2-3,CASSLRVGGATDTQYF,1,0,1,1
TRBV7-9,TRBJ2-1,CASSLRASGGYNEQFF,1,0,1,1
TRBV11-2,TRBJ1-1,CASSLVMGQPNTEAFF,1,0,1,1
TRBV7-2,TRBJ1-1,CASSLAMGQGGTEAFS,1,0,1,1
TRBV7-2,TRBJ2-7,CASSLAAELRSYEQYF,1,0,1,1
TRBV11-2,TRBJ1-1,CASSLAGGAGNTEAFF,1,0,1,1
TRBV7-2,TRBJ2-1,CASSLGRTSGRPEQFF,1,0,1,1
TRBV7-9,TRBJ2-2,CASSLGSERWTGELFF,1,0,1,1
TRBV11-2,TRBJ1-1,CASSLDGQGGSTEAFF,1,0,1,1
TRBV11-2,TRBJ2-1,CASSLDTAGAYNEQFF,1,0,1,1
TRBV7-2,TRBJ2-1,CASSLDRVGSYNEQFF,1,0,1,1
TRBV7-9,TRBJ2-3,CASSLTQDWDKDTQYF,1,0,1,1
TRBV11-2,TRBJ2-7,CASSLTGGHVTYEQYF,1,0,1,1
TRBV7-9,TRBJ2-7,CASSSRADGSSYEQYF,1,0,1,1
TRBV7-2,TRBJ1-4,CASSSRQGGTNEKLFF,1,0,1,1
TRBV5-4,TRBJ2-3,CASSSGRAPYTDTQYF,1,0,1,1
TRBV7-2,TRBJ2-1,CASSYQGAGGRDEQFF,1,0,1,1
TRBV5-4,TRBJ2-1,CASSYRQSGLYNEQFF,1,0,1,1
TRBV11-2,TRBJ2-1,CASSLRGSDTKNEQFF,1,1,2,2
TRBV3-1,TRBJ2-6,CASSPQGTLGANVLTF,1,0,1,1
TRBV5-4,TRBJ2-7,CASSPSGVAGPYEQYF,1,0,1,1
TRBV7-2,TRBJ2-7,CASSPRGGGPAYEQYF,1,0,1,1
TRBV7-3,TRBJ2-2,CASSPALAANTGELFF,1,0,1,1
TRBV7-2,TRBJ1-1,CASSPALGGRSTEAFF,1,0,1,1
TRBV6-2/3/5/6,TRBJ2-1,CASSPKTDGSYNEQFF,1,0,1,1
TRBV5-4,TRBJ2-3,CASSPGAGSSTDTQYF,1,0,1,1
TRBV11-3,TRBJ2-1,CASSRGTPLDYNEQFF,1,0,1,1
TRBV9,TRBJ2-3,CASSRSWGGAHDTQYF,1,0,1,1
TRBV14,TRBJ2-5,CASSHSRDSLAETQYF,1,0,1,1
TRBV12-3/4,TRBJ1-1,CASSHDSLRWDTEAFF,1,0,1,1
TRBV14,TRBJ2-1,CASSQASGSTYNEQFF,1,0,1,1
TRBV11-3,TRBJ2-2,CASSTRQPVNTGELFF,1,0,1,1
TRBV28,TRBJ2-2,CASSSLAGSETGELFF,1,0,1,1
TRBV12-3/4,TRBJ2-1,CASRRRGQGAVNEQFF,1,0,1,1
TRBV6-2/3/5/6,TRBJ2-1,CASRPPLSLSYNEQFF,1,0,1,1
TRBV7-9,TRBJ1-4,CASRDPRDLANEKLFF,1,0,1,1
TRBV10-1,TRBJ2-1,CASSGGLAGDRNEQFF,1,0,1,1
TRBV5-1,TRBJ2-4,CASSLASGVAKNIQYF,1,0,1,1
TRBV5-1,TRBJ2-1,CASSLGSSGSGNEQFF,1,0,1,1
TRBV5-1,TRBJ2-1,CASSLDVGGAYNEQFF,1,0,1,1
TRBV5-1,TRBJ2-3,CASSLEWATITDTQYF,1,0,1,1
TRBV5-1,TRBJ2-2,CASSLETGQATGELFF,1,0,1,1
TRBV5-1,TRBJ1-4,CASSLRPDSSSAKLFF,1,0,1,1
TRBV5-1,TRBJ1-1,CASSYGDREFNTEAFF,1,0,1,1
TRBV5-1,TRBJ2-3,CASSPIGSGSTDTQYF,1,0,1,1
TRBV5-1,TRBJ2-7,CASSPGLAGSFYEQYF,1,0,1,1
TRBV5-1,TRBJ2-1,CASSRTSGGIYNEQFF,1,0,1,1
TRBV5-1,TRBJ2-2,CASSVETIANTGELFF,1,0,1,1
TRBV20-1,TRBJ2-1,CSATPGTSGSHNEQFF,1,0,1,1
TRBV20-1,TRBJ2-7,CSASEPLAGASGEQYF,1,2,2,3
TRBV20-1,TRBJ2-5,CSARRQGRRYQETQYF,1,0,1,1
TRBV20-1,TRBJ2-5,CSAREVGQGLQETQYF,1,0,1,1
TRBV29-1,TRBJ2-1,CSVVSPGTSRYNEQFF,1,0,1,1
TRBV29-1,TRBJ2-2,CSVERGQSANTGELFF,1,0,1,1
TRBV29-1,TRBJ2-3,CSVEVLGTGASDTQYF,1,0,1,1
TRBV29-1,TRBJ2-7,CSASGPSGQVNNEQYF,1,0,1,1
TRBV29-1,TRBJ2-5,CSATTGLGAGLGTQYF,1,0,1,1
TRBV10-3,TRBJ2-3,RAISEREGRGTDTQYF,1,0,1,1
TRBV12-3/4,TRBJ2-3,RASSFPGQGGLDTQYF,1,0,1,1
TRBV12-5,TRBJ2-3,CASGPAGGRVDTQYF,1,0,1,1
TRBV12-5,TRBJ2-1,CASGVGSGGFNEQFF,1,0,1,1
TRBV30,TRBJ2-7,CAWSPWEGESYEQYF,1,0,1,1
TRBV30,TRBJ2-7,CAWSVGAGVIYEQYF,1,0,1,1
TRBV30,TRBJ2-5,CAWSGGTLGGETQYF,1,0,1,1
TRBV30,TRBJ2-7,CAWRAFAGASYEQYF,1,0,1,1
TRBV10-3,TRBJ1-1,CAISDPVLMNTEAFF,1,0,1,1
TRBV10-3,TRBJ2-7,CAISEFTGPTYEQYF,1,0,1,1
TRBV10-3,TRBJ2-1,CAISDNRDPNNEQFF,1,0,1,1
TRBV24-1,TRBJ2-1,CATSDFFAREGEQFF,1,0,1,1
TRBV24-1,TRBJ2-5,CATSDSGTSVETQYF,1,0,1,1
TRBV15,TRBJ2-7,CATSPRLAGGPEQYF,1,0,1,1
TRBV15,TRBJ2-1,CATSRTSESYNEQFF,1,0,1,1
TRBV15,TRBJ2-1,CATSRSLAGVKEQFF,1,0,1,1
TRBV15,TRBJ2-7,CATSRDPLSVYEQYF,1,0,1,1
TRBV19,TRBJ1-3,CASAQDRSSGNTIYF,1,0,1,1
TRBV19,TRBJ2-5,CASSRTSGNQETQYF,1,0,1,1
TRBV19,TRBJ1-1,CASSASSRGSTEAFF,1,0,1,1
TRBV19,TRBJ2-7,CASSMTSSGAYEQYF,1,1,2,2
TRBV19,TRBJ2-1,CASSKSPSGSYEQFF,1,0,1,1
TRBV18,TRBJ1-5,CASSSGTGIDQPQHF,1,0,1,1
TRBV18,TRBJ2-1,CASSPGVGDYNEQFF,1,0,1,1
TRBV18,TRBJ2-1,CASSPITGGPSEQFF,1,0,1,1
TRBV18,TRBJ1-1,CASSPVPGANTEAFF,1,0,1,1
TRBV18,TRBJ2-1,CASSPEFDAYNEQFF,1,0,1,1
TRBV18,TRBJ2-3,CASSTKQGITDTQYF,1,0,1,1
TRBV28,TRBJ2-3,CASQQEGASTDTQYF,1,0,1,1
TRBV2,TRBJ2-2,CASGDLAGGSGELFF,1,0,1,1
TRBV6-2/3/5/6,TRBJ2-2,CASIRGFQNTGGLFF,1,0,1,1
TRBV2,TRBJ2-1,CASTKLAGGFDEQFF,1,1,2,2
TRBV27,TRBJ2-6,CASTRQWAGANVLTF,1,0,1,1
TRBV28,TRBJ2-1,CASSFRGRLYNEQFF,1,0,1,1
TRBV6-2/3/5/6,TRBJ2-4,CASSLYRGFGNIQYF,1,0,1,1
TRBV6-2/3/5/6,TRBJ2-1,CASSLRGSSYNEQFF,1,0,1,1
TRBV12-3/4,TRBJ2-7,CASSLTAGGSYEQYF,1,0,1,1
TRBV28,TRBJ1-2,CASSSPTGGHYGYAF,1,0,1,1
TRBV27,TRBJ2-3,CASSSGPSPSDTQYF,1,0,1,1
TRBV28,TRBJ2-7,CASSSPGTGPHEQYF,1,0,1,1
TRBV28,TRBJ2-1,CASSSTRGGINEQFF,1,0,1,1
TRBV28,TRBJ2-1,CASSSSGAGHNEQFF,1,0,1,1
TRBV6-2/3/5/6,TRBJ2-5,CASSSREAGQETQYF,1,0,1,1
TRBV6-2/3/5/6,TRBJ2-4,CASSSVELAKNIQYF,1,0,1,1
TRBV6-2/3/5/6,TRBJ2-2,CASSYLAANTGELFF,1,0,1,1
TRBV6-2/3/5/6,TRBJ2-4,CASSYRSGENNIQYF,1,0,1,1
TRBV6-2/3/5/6,TRBJ2-7,CASSYRWGRPYEQYF,1,0,1,1
TRBV6-2/3/5/6,TRBJ2-2,CASSYARGGTGELFF,1,0,1,1
TRBV4-2,TRBJ1-2,CASSLTQGGGYGYTF,1,0,1,1
TRBV9,TRBJ2-1,CASSLSFSSYNEQFF,1,0,1,1
TRBV6-2/3/5/6,TRBJ2-1,CASSLQGTGRNEQFF,1,0,1,1
TRBV12-3/4,TRBJ2-5,CASSPRGGRGETQYF,1,0,1,1
TRBV7-3,TRBJ2-1,CASSPSGKALSEQFF,1,0,1,1
TRBV6-2/3/5/6,TRBJ1-5,CASSPETVPHQPQHF,1,0,1,1
TRBV12-3/4,TRBJ2-7,CASSQRQGISYEQYF,1,0,1,1
TRBV2,TRBJ2-1,CASSVGGSAYNEQFF,1,1,2,2
TRBV2,TRBJ1-5,CASSAASFSNQPQHF,1,0,1,1
TRBV27,TRBJ2-7,CASSDGQGLKGEQYF,1,0,1,1
TRBV12-3/4,TRBJ2-1,CASSESGAFYNEQFL,1,0,1,1
TRBV6-1,TRBJ2-3,CASSEGILRTDTQYF,1,0,1,1
TRBV6-1,TRBJ1-5,CASSELGQGVQPQHF,1,0,1,1
TRBV6-1,TRBJ2-3,CASSEEGRGEGTQYF,1,0,1,1
TRBV6-2/3/5/6,TRBJ2-7,CASSSRLAGDYEQYF,1,0,1,1
TRBV7-2,TRBJ2-7,CASSFNPSGIYEQYF,1,0,1,1
TRBV7-9,TRBJ1-1,CASSFLTGRETEAFF,1,0,1,1
TRBV5-5,TRBJ2-7,CASSFLRTGSYEQYF,1,0,1,1
TRBV5-6,TRBJ2-6,CASSLPVSGANVLTF,1,0,1,1
TRBV11-2,TRBJ2-7,CASSLSAPGPYEQYF,1,0,1,1
TRBV7-2,TRBJ2-7,CASSLPGQGTYEQYF,1,0,1,1
TRBV7-2,TRBJ2-6,CASSLRGSGANVLTF,1,0,1,1
TRBV11-2,TRBJ2-5,CASSLVGGRGETQYF,1,0,1,1
TRBV5-4,TRBJ2-7,CASSLGASLIYEQYF,1,0,1,1
TRBV11-2,TRBJ2-1,CASSLEGFSYNEQFF,1,0,1,1
TRBV7-3,TRBJ2-1,CASSLTPSGFNEQFF,1,0,1,1
TRBV11-2,TRBJ2-2,CASSLSVRNTGEQFF,1,0,1,1
TRBV7-9,TRBJ2-3,CASSSRAALADTQYF,1,0,1,1
TRBV7-9,TRBJ1-1,CASSSMWSRNTEAFF,1,0,1,1
TRBV7-9,TRBJ2-3,CASSSTISATDTQYF,1,0,1,1
TRBV5-8,TRBJ2-1,CASSWAGTSLIEQFF,1,0,1,1
TRBV5-4,TRBJ2-1,CASSLRGGSYNEQFF,1,0,1,1
TRBV7-9,TRBJ2-1,CASSLQGTVGNEQFF,1,0,1,1
TRBV7-2,TRBJ2-4,CASSLGGAAKNIQYF,1,0,1,1
TRBV27,TRBJ2-1,CASSLDRDSYNEQFF,1,0,1,1
TRBV14,TRBJ2-1,CASSPLAGAYNEQFF,1,0,1,1
TRBV27,TRBJ2-7,CASSPLAGGGYEQYF,1,0,1,1
TRBV7-9,TRBJ2-1,CASSPPGLAGNEQFF,1,0,1,1
TRBV5-4,TRBJ2-1,CASSPQGAHYNEQFF,1,0,1,1
TRBV7-9,TRBJ2-7,CASSPGLADYYEQYF,1,0,1,1
TRBV7-6,TRBJ2-2,CASSRWAGGSGELFF,1,0,1,1
TRBV3-1,TRBJ2-1,CASSRGQGGYNEQFF,1,0,1,1
TRBV11-2,TRBJ2-7,CASSRGTSGPYEQYF,1,0,1,1
TRBV6-2/3/5/6,TRBJ2-3,CASSRDRGITDTQYF,1,0,1,1
TRBV3-1,TRBJ1-2,CASSHFRPKTYGYTF,1,0,1,1
TRBV7-9,TRBJ2-7,CASSHFRDRNYEQYF,1,0,1,1
TRBV12-3/4,TRBJ2-2,CASSHPTGKAGELVF,1,0,1,1
TRBV11-2,TRBJ1-4,CASSHGQGGNEKLFF,1,0,1,1
TRBV7-8,TRBJ2-1,CASSQRSVQSNEQFF,1,0,1,1
TRBV27,TRBJ2-1,CASSQGGNLYNEQFF,1,0,1,1
TRBV14,TRBJ2-1,CASSQDWIGDREQFF,1,0,1,1
TRBV3-1,TRBJ1-2,CASSQDPVNNYGYTF,1,0,1,1
TRBV28,TRBJ2-4,CASSVTSGRGDIQYF,1,0,1,1
TRBV9,TRBJ1-1,CASSVLGAGDTEAFF,1,0,1,1
TRBV2,TRBJ1-1,CASSVQGARDTEAFF,1,0,1,1
TRBV9,TRBJ2-1,CASSVGDPPRGEQFF,1,0,1,1
TRBV9,TRBJ2-7,CASSASGTAAYEQYF,1,0,1,1
TRBV14,TRBJ2-2,CASSGQGANTGELFF,1,1,2,2
TRBV5-6,TRBJ2-7,CASSGARDFSYEQYF,1,0,1,1
TRBV9,TRBJ2-1,CASSEMGELHNEQFF,1,0,1,1
TRBV11-2,TRBJ2-1,CASSTQGQGRNEQFF,1,0,1,1
TRBV28,TRBJ2-6,CASRLLGSGANVLTF,1,0,1,1
TRBV27,TRBJ2-1,CASRGSSGSDNEQFF,1,0,1,1
TRBV6-2/3/5/6,TRBJ1-1,CASRYRRGENTEAFF,1,0,1,1
TRBV12-3/4,TRBJ2-1,CASRPRLAGVGEQFF,1,0,1,1
TRBV2,TRBJ2-7,CASRGGGVNTYEQYF,1,0,1,1
TRBV6-4,TRBJ2-2,CASRMQGGLPGEPFF,1,0,1,1
TRBV5-1,TRBJ1-4,CASSSEGQADEKLFF,1,0,1,1
TRBV5-1,TRBJ2-6,CASGSPGSGANVLTF,1,0,1,1
TRBV10-2,TRBJ2-7,CASSDHDREPYEQYF,1,0,1,1
TRBV10-1,TRBJ2-3,CASSEASVRTDTQYF,1,0,1,1
TRBV10-2,TRBJ2-3,CASSSAGVGTDTQYF,1,0,1,1
TRBV5-1,TRBJ2-7,CASSFAGTTAYEQYF,1,0,1,1
TRBV5-1,TRBJ1-1,CASSLGFRGRTEAFF,1,0,1,1
TRBV5-1,TRBJ2-3,CASSLESASADTQYF,1,0,1,1
TRBV5-1,TRBJ2-7,CASSLTSRENYEQYF,1,0,1,1
TRBV5-1,TRBJ2-3,CASSLTGDATDTQYF,1,0,1,1
TRBV5-1,TRBJ2-7,CASSLDLAGVNEQYF,1,0,1,1
TRBV5-1,TRBJ2-7,CASSSLPDVFYEQYF,1,1,2,2
TRBV5-1,TRBJ2-1,CASSSPGLASNEQFF,1,0,1,1
TRBV5-1,TRBJ2-1,CASSSALAGLNEQFF,1,0,1,1
TRBV5-1,TRBJ2-1,CASSSGLAIDNEQFF,1,0,1,1
TRBV5-1,TRBJ1-5,CASSSEGVRGQPQHF,1,0,1,1
TRBV5-1,TRBJ1-6,CASSWAPGGDSPLHF,1,0,1,1
TRBV5-1,TRBJ1-1,CASSPLQGRGTEAFF,1,0,1,1
TRBV5-4,TRBJ2-1,CASSPGTSGYNEQFF,1,2,2,3
TRBV5-1,TRBJ2-3,CASSPGGAGTDTQYF,1,0,1,1
TRBV5-1,TRBJ2-1,CASSVDPSPYNEQFF,1,0,1,1
TRBV5-1,TRBJ2-1,CASRLSSEAYNEQFF,1,0,1,1
TRBV20-1,TRBJ2-6,CSVPGQSSGANVLTF,1,0,1,1
TRBV20-1,TRBJ2-3,CSAWDRGQGTDTQYF,1,0,1,1
TRBV20-1,TRBJ2-3,CSAGGGTGGTDTQYF,1,0,1,1
TRBV20-1,TRBJ2-3,CSAELASGSTDTQYF,1,0,1,1
TRBV20-1,TRBJ2-1,CSASPSGSSYNEQFF,1,0,1,1
TRBV20-1,TRBJ2-3,CSARPMGGWADTQYF,1,0,1,1
TRBV20-1,TRBJ2-3,CSARGWNPRADTQYF,1,0,1,1
TRBV20-1,TRBJ2-1,CSARYPGQGYNEQFF,1,0,1,1
TRBV20-1,TRBJ2-6,CSARQGGSGANVLTF,1,0,1,1
TRBV20-1,TRBJ1-2,CSARALDRGDYGYTF,1,0,1,1
TRBV20-1,TRBJ2-7,CSALLEGGTAYEQYF,1,0,1,1
TRBV29-1,TRBJ2-1,CSVSSGDPKYNEQFF,1,0,1,1
TRBV29-1,TRBJ2-2,CSVAQGNPNTGELSF,1,0,1,1
TRBV29-1,TRBJ2-5,CSVGSQGNPSDAQYF,1,0,1,1
TRBV29-1,TRBJ2-1,CSVGRASGSFNEQFF,1,0,1,1
TRBV29-1,TRBJ2-1,CSVGDGEGVRDEQFF,1,0,1,1
TRBV29-1,TRBJ1-2,CSVESRRARGNGYTF,1,0,1,1
TRBV29-1,TRBJ2-3,CSVEGTSGGTDTQYF,1,0,1,1
TRBV29-1,TRBJ2-3,CSVILLLGATDTQYF,1,0,1,1
TRBV29-1,TRBJ2-2,CSVGTAPLGTGELFF,1,0,1,1
TRBV29-1,TRBJ2-1,CSVPPTSGSYNEQFF,1,0,1,1
TRBV7-3,TRBJ1-6,RASRKPGQEPSPLHF,1,0,1,1
TRBV5-1,TRBJ2-2,RASSWTGLESGELFF,1,0,1,1
TRBV29-1,TRBJ2-1,RSVDRDQAQFDERFF,1,0,1,1
TRBV7-2,TRBJ2-3,RASSLAPSGTDTQYF,1,0,1,1
TRBV6-1,TRBJ2-1,FASSERGTSFEQFF,1,0,1,1
TRBV30,TRBJ1-1,CAWVKLQGETEAFF,1,0,1,1
TRBV30,TRBJ2-7,CAWSPRDTLGEQYF,1,0,1,1
TRBV5-4,TRBJ2-7,CAGSPGPGAYELYF,1,0,1,1
TRBV7-9,TRBJ2-1,CAGTSGGTYNEQFF,1,0,1,1
TRBV10-3,TRBJ2-7,CAISDWQGVNEQYF,1,1,2,2
TRBV24-1,TRBJ2-7,CATSDGDRGYEQYF,1,0,1,1
TRBV3-1,TRBJ2-2,CASVMGEGLGELFF,1,0,1,1
TRBV19,TRBJ2-1,CASSGRTFYSEQFF,1,0,1,1
TRBV19,TRBJ2-2,CASSITGSGGELFF,1,0,1,1
TRBV19,TRBJ1-2,CASSMAGGPARYTF,1,0,1,1
TRBV19,TRBJ1-2,CASSTQSITRGYTF,1,0,1,1
TRBV19,TRBJ2-2,CASSTSQGTGELFF,1,0,1,1
TRBV19,TRBJ2-1,CASSRGVDLNEQFF,1,0,1,1
TRBV19,TRBJ1-1,CASRGDRGYTEAFF,1,0,1,1
TRBV19,TRBJ2-3,CASRLGTGRDTQYF,1,0,1,1
TRBV18,TRBJ2-1,CASSPPTRSDEQFF,1,0,1,1
TRBV18,TRBJ2-7,CASSPPGETSEQYF,1,0,1,1
TRBV18,TRBJ2-1,CASSPHRDGYEQFF,1,0,1,1
TRBV18,TRBJ1-1,CASSPGRGHREAFF,1,0,1,1
TRBV19,TRBJ2-7,CASLPGSSPYEQYF,1,0,1,1
TRBV2,TRBJ2-1,CASRVAQANDEQFF,1,0,1,1
TRBV5-6,TRBJ1-1,CASRRGTANTEAFF,1,0,1,1
TRBV12-3/4,TRBJ1-1,CASRRRPRNTEAFF,1,0,1,1
TRBV27,TRBJ1-6,CASAKEAYNSPLHF,1,0,1,1
TRBV2,TRBJ2-4,CASGDSLAKNIQYF,1,0,1,1
TRBV12-3/4,TRBJ2-2,CASDAGGNTGELFF,1,0,1,1
TRBV28,TRBJ2-1,CASTTGGGSGEQFF,1,0,1,1
TRBV28,TRBJ2-3,CASSFGRGTDTQYF,1,0,1,1
TRBV27,TRBJ1-1,CASSFTGRPTEAFF,1,0,1,1
TRBV12-3/4,TRBJ2-3,CASSFLRAGDTQYF,1,0,1,1
TRBV6-2/3/5/6,TRBJ1-1,CASSLWQGRNEAFF,1,0,1,1
TRBV12-3/4,TRBJ2-3,CASSLGQDTDTQYF,1,0,1,1
TRBV27,TRBJ2-2,CASSLSRGLGELFF,1,0,1,1
TRBV27,TRBJ2-7,CASSLWRQGDEQYF,1,0,1,1
TRBV6-2/3/5/6,TRBJ1-1,CASSLVAGNTEAFF,1,0,1,1
TRBV12-3/4,TRBJ1-5,CASSLATRGQPQHF,1,0,1,1
TRBV6-2/3/5/6,TRBJ2-7,CASSLDGGSYEQYF,1,0,1,1
TRBV6-2/3/5/6,TRBJ2-7,CASSSQIAGYEQYF,1,0,1,1
TRBV2,TRBJ2-2,CASSWTGVTGELFF,1,0,1,1
TRBV6-2/3/5/6,TRBJ2-3,CASSYPDRVDTQYF,1,0,1,1
TRBV6-2/3/5/6,TRBJ1-6,CASSYDRYNSPLHF,1,0,1,1
TRBV7-9,TRBJ1-5,CASSHKDGLQPQHF,1,0,1,1
TRBV27,TRBJ2-3,CASSHGPSTDTQYF,1,0,1,1
TRBV28,TRBJ2-1,CASSHDRAYNEQFF,1,0,1,1
TRBV2,TRBJ1-2,CASSVDRGWHGYTF,1,0,1,1
TRBV2,TRBJ1-1,CASSADSKNTEAFF,1,0,1,1
TRBV2,TRBJ1-1,CASSEAGGDTEAFF,1,0,1,1
TRBV2,TRBJ1-2,CASSREMAGYGYTF,1,0,1,1
TRBV5-4,TRBJ2-5,CASSFGTAQETQYF,1,0,1,1
TRBV11-2,TRBJ2-1,CASSLASGANEQFF,1,0,1,1
TRBV5-4,TRBJ2-1,CASSLGQGVNKQFF,1,0,1,1
TRBV9,TRBJ2-5,CASSLGQTQETQYF,1,0,1,1
TRBV7-2,TRBJ2-1,CASSLAGSYNEQFF,1,0,1,1
TRBV7-2,TRBJ2-3,CASSLGFLGNTQYF,1,0,1,1
TRBV7-3,TRBJ2-5,CASSLGPSQETQYF,1,2,2,3
TRBV7-9,TRBJ1-1,CASSLGGTGTEAFF,1,0,1,1
TRBV7-9,TRBJ2-7,CASSLGTRFYEQYF,1,1,2,2
TRBV7-2,TRBJ2-3,CASSLGGGKDTQYF,1,0,1,1
TRBV11-2,TRBJ1-5,CASSLDFANQPQHF,1,0,1,1
TRBV7-2,TRBJ2-7,CASSLEPSSYEQYF,1,0,1,1
TRBV7-9,TRBJ2-3,CASSLSTPTDTQYF,1,0,1,1
TRBV7-2,TRBJ2-7,CASSSRIGGYEQYF,1,0,1,1
TRBV11-2,TRBJ2-7,CASSSNYGIYEQYF,1,0,1,1
TRBV11-2,TRBJ1-1,CASSSQGGQTEASF,1,0,1,1
TRBV5-4,TRBJ2-5,CASSSGLAQETQYF,1,0,1,1
TRBV7-6,TRBJ1-3,CASSSTNSGNTIYF,1,0,1,1
TRBV12-3/4,TRBJ1-5,CASSLRQGGQPQHF,1,0,1,1
TRBV3-1,TRBJ2-5,CASSLSGAQETQYF,1,0,1,1
TRBV11-2,TRBJ2-5,CASSLPRGEETQYF,1,0,1,1
TRBV27,TRBJ2-7,CASSPRWGLYEQYF,1,0,1,1
TRBV7-6,TRBJ2-5,CASSPSRGGETQYF,1,0,1,1
TRBV14,TRBJ1-1,CASSPLGGDTEAFF,1,0,1,1
TRBV7-2,TRBJ2-7,CASSPPGLPYEQYF,1,0,1,1
TRBV11-2,TRBJ2-5,CASSPGRGGETQYL,1,0,1,1
TRBV11-2,TRBJ2-6,CASSPTSGANVLTF,1,0,1,1
TRBV5-5,TRBJ2-1,CASSPRGQYNEQFF,1,0,1,1
TRBV12-3/4,TRBJ2-7,CASSPLSAGNEQYF,1,0,1,1
TRBV7-6,TRBJ1-1,CASSPTGRNTEAFF,1,0,1,1
TRBV7-9,TRBJ1-5,CASSPSYSNQPQHF,1,0,1,1
TRBV12-3/4,TRBJ2-1,CASSPRENYNEQFF,1,0,1,1
TRBV7-2,TRBJ2-2,CASSRRVSTGEQFF,1,0,1,1
TRBV7-6,TRBJ2-5,CASSHSGVQETQYF,1,0,1,1
TRBV14,TRBJ2-1,CASSQVGLALEQFF,1,0,1,1
TRBV9,TRBJ2-5,CASSQTGSGETQYF,1,0,1,1
TRBV7-6,TRBJ2-3,CASSQGPVADTQYF,1,0,1,1
TRBV3-1,TRBJ2-4,CASSQGQGTNIQYF,1,0,1,1
TRBV9,TRBJ2-5,CASSVSSGKETQYF,1,0,1,1
TRBV9,TRBJ2-3,CASSVGPGTDTQYF,1,0,1,1
TRBV9,TRBJ2-3,CASSVGVGQDTQYF,1,0,1,1
TRBV5-4,TRBJ2-1,CASSARDSNNEQFF,1,1,2,2
TRBV9,TRBJ2-7,CASSGGAGHEEQYF,1,0,1,1
TRBV7-2,TRBJ2-2,CASSGEGFTGELFF,1,0,1,1
TRBV7-6,TRBJ2-2,CASSEGPNTGELFF,1,0,1,1
TRBV7-9,TRBJ1-2,CASSTAGHSYGYTF,1,0,1,1
TRBV7-8,TRBJ2-7,CASSTSGSFYEQYF,1,0,1,1
TRBV25-1,TRBJ2-7,CASSTSGRIYEQYF,1,1,2,2
TRBV4-2,TRBJ1-3,CASSTRVSGNTIYF,1,0,1,1
TRBV5-8,TRBJ2-1,CASRFGTSRYEQFF,1,0,1,1
TRBV6-2/3/5/6,TRBJ2-7,CASRPTGTVGEQYF,1,0,1,1
TRBV5-6,TRBJ1-1,CASRLGQLNTEAFF,1,0,1,1
TRBV6-2/3/5/6,TRBJ2-7,CASRVQATSYEQYF,1,0,1,1
TRBV5-1,TRBJ2-1,CASSRTGQNNEQFF,1,1,2,2
TRBV5-1,TRBJ2-7,CASSFAGARYEQYF,1,0,1,1
TRBV5-1,TRBJ2-1,CASSFVAGGDEQFF,1,0,1,1
TRBV5-1,TRBJ1-1,CASSFTGANTEAFF,1,0,1,1
TRBV5-1,TRBJ2-3,CASSLALAGDTQYF,1,0,1,1
TRBV5-1,TRBJ2-3,CASSLDSGTDTQYF,1,0,1,1
TRBV5-1,TRBJ2-5,CASSLEQGSETQYF,1,0,1,1
TRBV5-1,TRBJ2-7,CASSLEANSYEQYL,1,0,1,1
TRBV5-1,TRBJ2-1,CASSLQGFDNEQFF,1,0,1,1
TRBV5-1,TRBJ2-1,CASSWGGGVNEQFF,1,0,1,1
TRBV5-1,TRBJ2-5,CASSLPGGGETQYF,1,0,1,1
TRBV5-1,TRBJ2-7,CASSLGAGPFEQYF,1,0,1,1
TRBV5-1,TRBJ1-5,CASSLGQGGEPQHF,1,0,1,1
TRBV5-1,TRBJ2-3,CASSPFSATDTQYF,1,0,1,1
TRBV5-1,TRBJ2-5,CASSPRTGQETQYF,1,0,1,1
TRBV5-1,TRBJ2-5,CASSPDRGRETQYF,1,0,1,1
TRBV5-1,TRBJ2-7,CASSREAGPHEQYF,1,0,1,1
TRBV5-1,TRBJ2-5,CASSQGRYGETQYF,1,0,1,1
TRBV4-1,TRBJ2-1,CASSQGTRGPEQFF,1,0,1,1
TRBV4-1,TRBJ2-3,CASSQGTGVDTQYF,1,0,1,1
TRBV5-1,TRBJ2-1,CASSIQAGGDEQFF,1,0,1,1
TRBV5-1,TRBJ2-1,CASRPVGPDNEQFF,1,0,1,1
TRBV20-1,TRBJ2-7,CSASKGGSSYEQYF,1,0,1,1
TRBV20-1,TRBJ2-1,CSASVWRGYNEQFF,1,0,1,1
TRBV20-1,TRBJ2-3,CSAPQRVQSDTQYF,1,0,1,1
TRBV20-1,TRBJ2-1,CSAISGSIRNEQFF,1,0,1,1
TRBV20-1,TRBJ2-5,CSASRVGLEGTQYF,1,0,1,1
TRBV20-1,TRBJ2-1,CSASGLAGYNEQFF,1,1,2,2
TRBV20-1,TRBJ2-2,CSARVGGATGELFF,1,0,1,1
TRBV20-1,TRBJ1-2,CSARATGGNYGYTF,1,0,1,1
TRBV20-1,TRBJ2-7,CSARDPYRAYEQYF,1,0,1,1
TRBV20-1,TRBJ1-1,CSARDQKGHTEAFF,1,0,1,1
TRBV20-1,TRBJ2-1,CSARDGSGYNEQFF,1,0,1,1
TRBV20-1,TRBJ2-5,CSARDKAGGETQYF,1,0,1,1
TRBV20-1,TRBJ2-1,CSARGLAVNNEQFF,1,0,1,1
TRBV20-1,TRBJ2-3,CSAQTSGYTDTQYF,1,1,2,2
TRBV20-1,TRBJ2-3,CSAVRVAGKDTQYF,1,0,1,1
TRBV20-1,TRBJ2-1,CSAPGPVRYNEQFF,1,0,1,1
TRBV20-1,TRBJ2-2,CSAGLAENTGELFF,1,0,1,1
TRBV20-1,TRBJ2-1,CSGLPGVSWNEQFF,1,0,1,1
TRBV29-1,TRBJ2-5,CSVSSGLNAQTQYF,1,0,1,1
TRBV29-1,TRBJ1-2,CSVAGAGGVYGYTF,1,0,1,1
TRBV29-1,TRBJ2-5,CSVASAGGGETQYF,1,1,2,2
TRBV29-1,TRBJ2-2,CSVEPGGRTGELFF,1,0,1,1
TRBV29-1,TRBJ2-3,CSVEGTGGSDTQYF,1,1,2,2
TRBV29-1,TRBJ1-1,CSVEFRRVRPEAFF,1,0,1,1
TRBV29-1,TRBJ2-6,CSVEGGSGANVLTF,1,0,1,1
TRBV29-1,TRBJ2-7,CSVFQTGTSYEQYF,1,0,1,1
TRBV29-1,TRBJ2-1,CSVEGPNSYNEQFF,1,0,1,1
TRBV29-1,TRBJ2-3,CSVIPGTVTDTQYF,1,0,1,1
TRBV29-1,TRBJ2-5,CSALIPGRVQTQYF,1,0,1,1
TRBV29-1,TRBJ2-5,CSGLGQGAGETQYF,1,0,1,1
TRBV20-1,TRBJ2-2,CRARSGSVTGELFF,1,0,1,1
TRBV12-5,TRBJ2-5,CASGLSYEETQYF,1,0,1,1
TRBV28,TRBJ1-5,CASRAPSNQPQHF,1,1,2,2
TRBV30,TRBJ1-2,CAWSRASVDGYTF,1,0,1,1
TRBV30,TRBJ1-5,CAWSVRSNRPQHF,1,0,1,1
TRBV30,TRBJ2-3,CAWSGGNDDTQYF,1,0,1,1
TRBV30,TRBJ1-1,CAWSTATNTEAFF,1,0,1,1
TRBV30,TRBJ1-2,CAWKRVDFDGYTF,1,1,2,2
TRBV12-3/4,TRBJ2-1,CAVQFVMEDEQFF,1,0,1,1
TRBV5-4,TRBJ2-5,CAAQEGPVETQYF,1,0,1,1
TRBV2,TRBJ2-1,CAISDRRNNEQFF,1,0,1,1
TRBV10-3,TRBJ1-5,CAIQADSNQPQRF,1,0,1,1
TRBV10-3,TRBJ2-2,CAISDLGDGELFF,1,0,1,1
TRBV27,TRBJ2-7,CATSRGNLYEQYF,1,0,1,1
TRBV15,TRBJ1-1,CATSRGGSTEAFL,1,0,1,1
TRBV19,TRBJ2-1,CATSGRFDNEQFF,1,0,1,1
TRBV19,TRBJ2-2,CATRQGATGELFF,1,1,2,2
TRBV19,TRBJ1-5,CASARVPNQPQHF,1,0,1,1
TRBV19,TRBJ1-5,CASGRGGNQPQHF,1,0,1,1
TRBV19,TRBJ2-1,CASSQERNNEQFF,1,0,1,1
TRBV19,TRBJ2-5,CASSIGLQETQYF,1,0,1,1
TRBV18,TRBJ2-1,CASSWTSENEQFF,1,0,1,1
TRBV18,TRBJ2-5,CASSPTREETQYF,1,0,1,1
TRBV18,TRBJ1-1,CASSGEQGTEAFF,1,0,1,1
TRBV2,TRBJ1-1,CASQGQQYTEAFF,1,0,1,1
TRBV25-1,TRBJ2-6,CASQGAGANVLTF,1,0,1,1
TRBV14,TRBJ2-2,CASAGRELGELFF,1,0,1,1
TRBV7-9,TRBJ1-4,CASGVEIIEKLFF,1,0,1,1
TRBV11-2,TRBJ1-5,CASGQASNQPQHF,1,0,1,1
TRBV5-6,TRBJ2-7,CASTRTGGYEQYF,1,0,1,1
TRBV28,TRBJ2-2,CASTHRGTGELFF,1,0,1,1
TRBV6-1,TRBJ2-7,CASTEAGGDEQYF,1,0,1,1
TRBV12-3/4,TRBJ1-1,CASSLAANTEAFF,1,0,1,1
TRBV12-3/4,TRBJ1-1,CASSSGEGTKAFF,1,0,1,1
TRBV6-2/3/5/6,TRBJ2-3,CASSYPGADTQYF,1,0,1,1
TRBV12-3/4,TRBJ1-1,CASSLSQNTEAFF,1,0,1,1
TRBV27,TRBJ2-1,CASSPLPGTQQFF,1,0,1,1
TRBV14,TRBJ2-7,CASSRGTSYEQYF,1,0,1,1
TRBV6-2/3/5/6,TRBJ1-1,CASSRTGGGWAFF,1,0,1,1
TRBV2,TRBJ2-7,CASSVGTVGRQYF,1,0,1,1
TRBV2,TRBJ2-5,CASSVRYQETQYF,1,0,1,1
TRBV6-1,TRBJ2-1,CASSADPFNEQFF,1,0,1,1
TRBV25-1,TRBJ2-7,CASSGTTDYEQYF,1,1,2,2
TRBV25-1,TRBJ2-3,CASSDARGDTQYF,1,0,1,1
TRBV6-1,TRBJ2-7,CASSEDGRSEQYF,1,0,1,1
TRBV2,TRBJ1-6,CASSEDSGSPLHF,1,0,1,1
TRBV2,TRBJ2-1,CASSEEHANEQFF,1,0,1,1
TRBV25-1,TRBJ2-1,CASSEWGPGEQFF,1,0,1,1
TRBV6-1,TRBJ2-7,CASSEGGQGEQYF,1,0,1,1
TRBV2,TRBJ2-1,CASSEGTSGRVLF,1,0,1,1
TRBV28,TRBJ2-3,CASSTPITDTQYF,1,0,1,1
TRBV7-2,TRBJ2-1,CASSLQLYNVQFF,1,0,1,1
TRBV7-9,TRBJ2-5,CASSLGTGETQYF,1,0,1,1
TRBV7-9,TRBJ2-6,CASSLDRANVLTF,1,0,1,1
TRBV5-6,TRBJ2-7,CASSLKGSYEQYF,1,0,1,1
TRBV7-2,TRBJ2-1,CASSLSQGFEQFF,1,0,1,1
TRBV7-6,TRBJ1-1,CASSLSIGAEAFF,1,0,1,1
TRBV5-5,TRBJ1-5,CASSLWQNQPQHF,1,0,1,1
TRBV7-8,TRBJ2-7,CASSLVFQYEQYF,1,3,2,4
TRBV11-2,TRBJ1-6,CASSLAVYSPLHF,1,0,1,1
TRBV7-9,TRBJ2-1,CASSLGFGDEQFF,1,1,2,2
TRBV11-2,TRBJ1-5,CASSLDRNQPQHF,1,0,1,1
TRBV11-2,TRBJ1-1,CASSLEGFTEAFF,1,0,1,1
TRBV7-9,TRBJ2-3,CASSLRGTDTQYF,1,0,1,1
TRBV7-2,TRBJ1-3,CASSSSYGNTIYF,1,0,1,1
TRBV13,TRBJ2-7,CASSPQGGHEQYF,1,0,1,1
TRBV5-6,TRBJ2-5,CASSPQGQETQYF,1,0,1,1
TRBV11-1,TRBJ2-2,CASSRQGPGELFF,1,0,1,1
TRBV3-1,TRBJ1-1,CASSRRATAEAFF,1,0,1,1
TRBV7-9,TRBJ1-2,CASSHGQNYGYTF,1,0,1,1
TRBV7-3,TRBJ2-7,CASSQREGYEQYF,1,0,1,1
TRBV14,TRBJ2-6,CASSQTGPNVLTF,1,0,1,1
TRBV14,TRBJ2-3,CASSQDSLDTQYF,1,0,1,1
TRBV6-2/3/5/6,TRBJ2-1,CASSIEGYNEQFF,1,0,1,1
TRBV12-3/4,TRBJ1-1,CASSTSTGAEAFF,1,0,1,1
TRBV11-3,TRBJ2-7,CASSTSRGHEQYF,1,0,1,1
TRBV6-2/3/5/6,TRBJ1-1,CASRYPGNTEAFF,1,0,1,1
TRBV7-2,TRBJ2-3,CASRGGSTDTQYF,1,0,1,1
TRBV6-2/3/5/6,TRBJ1-1,CASRRQGPTEAFF,1,0,1,1
TRBV6-2/3/5/6,TRBJ1-1,CASRSGTHTEAFF,1,0,1,1
TRBV7-6,TRBJ2-1,CTSSLGPTMEQFF,1,0,1,1
TRBV20-1,TRBJ2-3,CCASYGYTDTQYF,1,0,1,1
TRBV10-1,TRBJ2-3,CASTGTPTDTQYF,1,0,1,1
TRBV5-1,TRBJ2-3,CASTPGGTDTQYF,1,0,1,1
TRBV5-1,TRBJ2-7,CASTGGAGDEQYF,1,0,1,1
TRBV5-1,TRBJ2-7,CASSLVGGDEQYF,1,0,1,1
TRBV5-1,TRBJ2-1,CASSLSPGPEQFF,1,0,1,1
TRBV10-1,TRBJ1-5,CASSRDGNQPQHF,1,0,1,1
TRBV4-1,TRBJ1-1,CASSQGRDTEAFF,1,0,1,1
TRBV4-1,TRBJ1-5,CASSGTVAQPQHF,1,0,1,1
TRBV10-1,TRBJ2-4,CASSRQGENIQYF,1,0,1,1
TRBV5-1,TRBJ2-3,CASRRTGSDTQYF,1,0,1,1
TRBV20-1,TRBJ2-1,CSATGTGYNEQFF,1,0,1,1
TRBV20-1,TRBJ2-5,CSASTGVQETQYF,1,0,1,1
TRBV20-1,TRBJ2-3,CSARAPSADTQYF,1,0,1,1
TRBV29-1,TRBJ1-1,CSVLGGTDTEASF,1,0,1,1
TRBV29-1,TRBJ1-3,CSVRDRGGNTIYF,1,2,2,3
TRBV29-1,TRBJ2-1,CSVRLLGHNEQFF,1,0,1,1
TRBV29-1,TRBJ2-7,CSVVWAGLYEQYF,1,0,1,1
TRBV29-1,TRBJ2-3,CSVVPGITDTQYF,1,0,1,1
TRBV29-1,TRBJ1-5,CSVAEGRNQPQHF,1,0,1,1
TRBV29-1,TRBJ2-7,CSVGRGTDYEQYL,1,0,1,1
TRBV29-1,TRBJ2-5,CSVDSGQRESQYF,1,0,1,1
TRBV29-1,TRBJ2-3,CSVEGQGSDTQYF,1,0,1,1
TRBV29-1,TRBJ2-7,CSVEIAGVYEQYF,1,0,1,1
TRBV29-1,TRBJ2-5,CSVEVGRGETQYF,1,0,1,1
TRBV29-1,TRBJ2-3,CSVEVANTDTQYF,1,0,1,1
TRBV29-1,TRBJ2-5,CSVEDAGAETQYF,1,0,1,1
TRBV29-1,TRBJ2-2,CSVERGVFGELFF,1,0,1,1
TRBV29-1,TRBJ2-7,CSVRDVRSYEQYF,1,0,1,1
TRBV29-1,TRBJ2-2,CSVGDKNTGELFF,1,0,1,1
TRBV29-1,TRBJ2-1,CSAIAGGPYEQFF,1,0,1,1
TRBV29-1,TRBJ2-1,CSAQRAVGNEQFF,1,0,1,1
TRBV29-1,TRBJ2-7,CSAGTGGSYEQYF,1,0,1,1
TRBV12-5,TRBJ1-1,CASGRESTEAFF,1,0,1,1
TRBV24-1,TRBJ2-3,CATSGDTDTQYF,1,0,1,1
TRBV19,TRBJ2-4,CATGHDKNIQYF,1,0,1,1
TRBV28,TRBJ2-2,CASLGILGELFF,1,0,1,1
TRBV10-3,TRBJ2-2,CASGQGPGELFF,1,1,2,2
TRBV19,TRBJ2-1,CASTGAHNEQFF,1,0,1,1
TRBV19,TRBJ1-1,CASTRMNTEAFF,1,0,1,1
TRBV19,TRBJ1-5,CASTTLDQPQHF,1,0,1,1
TRBV19,TRBJ2-7,CASSSGSYEQYF,1,0,1,1
TRBV18,TRBJ2-7,CASSPGASEQYF,1,0,1,1
TRBV6-2/3/5/6,TRBJ2-1,CASTDRGPEQFF,1,0,1,1
TRBV27,TRBJ2-7,CASSFGSGGQYF,1,0,1,1
TRBV28,TRBJ2-1,CASSFEKIEQFF,1,0,1,1
TRBV12-3/4,TRBJ1-2,CASSLGVIGYTF,1,0,1,1
TRBV28,TRBJ2-7,CASSLAPYEQYF,1,0,1,1
TRBV12-3/4,TRBJ1-1,CASSLRRTEAFF,1,0,1,1
TRBV12-3/4,TRBJ2-1,CASSYFFNEQFF,1,0,1,1
TRBV6-2/3/5/6,TRBJ2-7,CASSPTSYEQYF,1,0,1,1
TRBV2,TRBJ2-7,CASSRLAYEQYF,1,0,1,1
TRBV12-3/4,TRBJ1-4,CASSHYNEKLFF,1,0,1,1
TRBV6-1,TRBJ2-7,CASSVTSYEQYF,1,0,1,1
TRBV2,TRBJ2-7,CASSENGYEQYF,1,1,2,2
TRBV6-1,TRBJ2-1,CASSELQGYRFF,1,0,1,1
TRBV5-4,TRBJ2-5,CASSLPRETQYF,1,0,1,1
TRBV5-4,TRBJ1-3,CASSLDGNTIYF,1,0,1,1
TRBV7-4,TRBJ2-7,CASSSDSYEQYF,1,0,1,1
TRBV3-1,TRBJ2-1,CASSLTSDEQFF,1,0,1,1
TRBV11-2,TRBJ2-1,CASSPQGDEQFF,1,0,1,1
TRBV3-1,TRBJ2-7,CASSRGTYEQYF,1,0,1,1
TRBV3-1,TRBJ2-1,CASSQEYNEQFF,1,0,1,1
TRBV9,TRBJ2-1,CASSVVAGAPFF,1,0,1,1
TRBV12-3/4,TRBJ2-1,CASRSRDNEQFF,1,0,1,1
TRBV5-5,TRBJ2-7,CASRPDSYEQYF,1,0,1,1
TRBV2,TRBJ2-5,CASRQGEETQYF,1,0,1,1
TRBV2,TRBJ2-7,CASRADLYEQYF,1,0,1,1
TRBV5-5,TRBJ2-5,CASRRGEETQYF,1,0,1,1
TRBV19,TRBJ2-5,CASKGLEETQYF,1,5,2,6
TRBV5-8,TRBJ1-1,CASKATPAEAFF,1,0,1,1
TRBV4-1,TRBJ2-1,CASSRSANEQFF,1,0,1,1
TRBV10-2,TRBJ1-5,CASSEGGQPQHF,1,0,1,1
TRBV5-1,TRBJ2-7,CASSLVSYEQYF,1,0,1,1
TRBV5-1,TRBJ2-1,CASSLVANEQFF,1,0,1,1
TRBV5-1,TRBJ2-1,CASSLKPHEQFF,1,0,1,1
TRBV5-1,TRBJ2-3,CASSLFQDTQYF,1,0,1,1
TRBV5-1,TRBJ2-5,CASRSGSETQYF,1,0,1,1
TRBV20-1,TRBJ1-5,CSVGISNQPQHF,1,0,1,1
TRBV20-1,TRBJ2-7,CSAISGAYEQYF,1,0,1,1
TRBV20-1,TRBJ2-7,CSASGGNGKQYF,1,0,1,1
TRBV20-1,TRBJ2-4,CSARGLFMIQYF,1,0,1,1
TRBV20-1,TRBJ1-5,CSAVTGDQPQHF,1,0,1,1
TRBV20-1,TRBJ2-7,CSAGQGSYEQYF,1,0,1,1
TRBV29-1,TRBJ2-3,CSVRQGADTQYF,1,0,1,1
TRBV29-1,TRBJ2-2,CSVVGAGGELLF,1,0,1,1
TRBV29-1,TRBJ1-3,CSVGETGNTIYF,1,0,1,1
TRBV29-1,TRBJ2-1,CSVEPLYWEQFF,1,0,1,1
TRBV29-1,TRBJ2-7,CSVGGNANEQYF,1,0,1,1
TRBV29-1,TRBJ2-3,CSAGDIGDTQYF,1,0,1,1
TRBV29-1,TRBJ2-5,CSAGHSKETQYF,1,0,1,1
TRBV30,TRBJ1-2,CAWSPRQGYTF,1,0,1,1
TRBV10-3,TRBJ1-2,CAIQGAGGYTF,1,0,1,1
TRBV27,TRBJ2-3,CATQNTDTQYF,1,0,1,1
TRBV6-1,TRBJ1-2,CATGEGAGYTF,1,0,1,1
TRBV19,TRBJ1-2,CASGRSYGYTF,1,0,1,1
TRBV27,TRBJ2-3,CASRRGYTQYF,1,0,1,1
TRBV7-9,TRBJ2-4,CASGQTGLQYF,1,0,1,1
TRBV6-1,TRBJ1-3,CASSAGNTIYF,1,0,1,1
TRBV6-1,TRBJ2-5,CASSERETQYF,1,0,1,1
TRBV7-9,TRBJ2-5,CASSFGEPQYF,1,0,1,1
TRBV7-9,TRBJ2-1,CASSSYNEQFF,1,0,1,1
TRBV7-6,TRBJ1-1,CASSSDRVAFS,1,0,1,1
TRBV7-6,TRBJ2-3,CASSSQLTQYF,1,0,1,1
TRBV7-9,TRBJ2-4,CASSLSVIKYF,1,0,1,1
TRBV6-2/3/5/6,TRBJ2-1,CASKRGGEQFF,1,0,1,1
TRBV5-1,TRBJ2-7,CASSQEYEQYF,1,0,1,1
TRBV20-1,TRBJ1-4,CSARKNEKLFF,1,0,1,1
TRBV20-1,TRBJ2-7,CSADHDYEQYF,1,0,1,1
TRBV20-1,TRBJ2-1,CSATENNEQFF,1,0,1,1
TRBV20-1,TRBJ2-5,CSANQQETQYF,1,0,1,1
TRBV20-1,TRBJ1-1,CSARGGDGAFF,1,0,1,1
TRBV29-1,TRBJ2-3,CSVEPRDTQYF,1,0,1,1
TRBV29-1,TRBJ1-2,CSVENQGSYTF,1,0,1,1
TRBV29-1,TRBJ1-4,CSVSQEEKLFF,1,0,1,1
TRBV2,TRBJ2-5,CASHGETQYF,1,0,1,1
TRBV29-1,TRBJ2-3,CSVVTDTQYF,1,0,1,1
TRBV29-1,TRBJ2-5,CSAGQGWVLF,1,0,1,1
TRBV12-3/4,TRBJ1-2,CASSPGYTF,1,0,1,1
TRBV24-1,TRBJ2-1,CATSDSPGRAGIWESSYNEQFF,1,0,1,1
TRBV12-3/4,TRBJ2-1,CASSAVLLAGAIRKGLNEQFF,1,0,1,1
TRBV27,TRBJ2-1,CASSPQLSVARTTFYNEQFF,1,1,2,2
TRBV7-2,TRBJ2-1,CASSSLWGLAGVSSVNEQFF,1,0,1,1
TRBV19,TRBJ2-1,CASSPRTSGVHSSYNEQFF,1,0,1,1
TRBV28,TRBJ2-3,CASSQGWVLAGIITDTQYF,1,0,1,1
TRBV2,TRBJ2-1,CASSEAHSSGPGSYNEQFF,1,0,1,1
TRBV7-9,TRBJ1-4,CASSLDPPAGLSTNEKLFF,1,0,1,1
TRBV4-2,TRBJ2-1,CASSQDPPKLAGGTNEQFF,1,0,1,1
TRBV12-3/4,TRBJ1-5,CASRSGQWGGSGGNQPQHF,1,0,1,1
TRBV5-1,TRBJ2-1,CASSLGSGRAFRSYNEQFF,1,0,1,1
TRBV4-1,TRBJ1-3,CASSPTSGEMIFSGNTIYF,1,0,1,1
TRBV4-1,TRBJ2-7,CASSQIAGEGDEGNYEQYF,1,0,1,1
TRBV5-4,TRBJ2-7,RASSSYLGQGTSFYYEQYF,1,0,1,1
TRBV10-3,TRBJ1-4,CAISEVLSGTATNEKLFF,1,0,1,1
TRBV24-1,TRBJ2-1,CATSDFSPSGSDYNEQFF,1,0,1,1
TRBV15,TRBJ2-1,CATSRDYSGDTSYNEQFF,1,0,1,1
TRBV19,TRBJ2-1,CASSQGLAGVLYYNEQFF,1,0,1,1
TRBV19,TRBJ1-2,CASSIPSSRDRKRYGYTF,1,0,1,1
TRBV27,TRBJ2-3,CASSFLPPTATSTDTQYF,1,0,1,1
TRBV6-2/3/5/6,TRBJ2-6,CASSLFGTGGSGANVLTF,1,0,1,1
TRBV6-2/3/5/6,TRBJ2-7,CASSLRGLAETLLFEQYF,1,0,1,1
TRBV5-5,TRBJ2-1,CASSLEVAGAVFGDEQFF,1,0,1,1
TRBV3-1,TRBJ2-3,CASSSRLAGGLSTDTQYF,1,0,1,1
TRBV5-4,TRBJ2-1,CASSYTASSGGFYNEQFF,1,0,1,1
TRBV11-2,TRBJ1-2,CASSPNLGQGVANYGYTF,1,0,1,1
TRBV4-2,TRBJ2-2,CASSQERNQGLAPGELFF,1,0,1,1
TRBV3-1,TRBJ2-1,CASSQDPRTSGYYNEQFF,1,0,1,1
TRBV14,TRBJ2-3,CASSQEGRGGPSADTQYF,1,0,1,1
TRBV7-9,TRBJ2-3,CASSATSGPLHSTDTQYF,1,0,1,1
TRBV5-1,TRBJ2-2,CASSLPVHRPRGTGELFF,1,0,1,1
TRBV4-1,TRBJ2-4,CASSQSPPAGVAKNIQYF,1,0,1,1
TRBV10-1,TRBJ2-2,CASSERLAGGPNTGELFF,1,0,1,1
TRBV20-1,TRBJ2-5,CSASGGLGLAGTKETQYF,1,0,1,1
TRBV20-1,TRBJ2-7,CSARVQRGGTSDSYEQYF,1,0,1,1
TRBV29-1,TRBJ2-1,CSAGVASGSPSPYNEQFF,1,0,1,1
TRBV12-3/4,TRBJ2-1,YASSRRPGLAGGRYEQFF,1,0,1,1
TRBV4-2,TRBJ2-7,YASSHQGTSGSNFHEQYF,1,0,1,1
TRBV12-5,TRBJ2-5,CASGWGSGQVNQETQYF,1,0,1,1
TRBV10-3,TRBJ2-5,CAISDSGGGVVRETQYF,1,0,1,1
TRBV15,TRBJ2-3,CATSRPTSALATDTQYF,1,0,1,1
TRBV15,TRBJ2-7,CATSRDQGTGGTYEQYF,1,3,2,4
TRBV19,TRBJ2-6,CASSTKGRFSGANVLTF,1,0,1,1
TRBV19,TRBJ2-1,CASSKDRAGGPFDEQFF,1,0,1,1
TRBV7-3,TRBJ2-2,CASTEPGQGKKGGELFS,1,0,1,1
TRBV28,TRBJ2-4,CASSLDPPYRGKNIQYF,1,0,1,1
TRBV6-2/3/5/6,TRBJ2-6,CASSYSPDRAGANVLTF,1,0,1,1
TRBV28,TRBJ2-1,CASSPPPRTTLRNEQFF,1,0,1,1
TRBV6-1,TRBJ2-1,CASSQNRPGISANEQFF,1,0,1,1
TRBV6-1,TRBJ2-3,CASSVGPLAGNLDAQYF,1,0,1,1
TRBV6-1,TRBJ2-6,CASSEITSFSGANVLTF,1,0,1,1
TRBV2,TRBJ2-1,CASSEAGLAGGPHEQFF,1,0,1,1
TRBV25-1,TRBJ2-1,CASSETRSQGSYNEQFF,1,1,2,2
TRBV2,TRBJ2-3,CASSESSSLDPSDTQYF,1,0,1,1
TRBV11-1,TRBJ2-3,CASSFRLAGDRADTQYF,1,0,1,1
TRBV5-8,TRBJ2-2,CASSFTGTSGSIGELFF,1,0,1,1
TRBV5-4,TRBJ2-1,CASSLGGLAGVVNEQFF,1,0,1,1
TRBV7-8,TRBJ1-1,CASSLGGTAHMNTEAFF,1,0,1,1
TRBV7-9,TRBJ2-7,CASSLGDSRTGAGEQYF,1,0,1,1
TRBV7-2,TRBJ2-2,CASSLTRDRVDTGELFF,1,0,1,1
TRBV7-3,TRBJ2-5,CASSLTRASGRSETQYF,1,0,1,1
TRBV7-9,TRBJ1-1,CASSLTRGPDLNTEAFF,1,0,1,1
TRBV5-4,TRBJ2-3,CASSLRAGGPTADTQYF,1,0,1,1
TRBV11-2,TRBJ2-4,CASSPRTGGVAKNIQYF,1,0,1,1
TRBV5-6,TRBJ2-2,CASSPGTSGMNTGELLL,1,0,1,1
TRBV7-6,TRBJ2-3,CASSPGIAGGRADTQYF,1,0,1,1
TRBV5-6,TRBJ2-1,CASSPMAGTVYYNEQFF,1,0,1,1
TRBV3-1,TRBJ2-1,CASSQGLAGEFYNEQFF,1,0,1,1
TRBV3-1,TRBJ2-5,CASSQDLGVGYQETQYF,1,0,1,1
TRBV9,TRBJ2-1,CASSQTPSRSSYNEQFF,1,0,1,1
TRBV7-9,TRBJ2-3,CASSVLAGGLVADTQNF,1,0,1,1
TRBV28,TRBJ2-3,CASRPPTSGASTDTQYF,1,0,1,1
TRBV6-1,TRBJ2-1,CASRENSGTPANNEQFF,1,0,1,1
TRBV6-2/3/5/6,TRBJ2-3,CASRRTSGMTSTDTQYF,1,0,1,1
TRBV5-1,TRBJ2-1,CASSLAPSGTTYNEQFF,1,0,1,1
TRBV5-1,TRBJ2-1,CASSLDLGQRSYNEQFF,1,0,1,1
TRBV5-1,TRBJ2-7,CASSYTPGTFGSYEQYF,1,0,1,1
TRBV5-1,TRBJ2-2,CASSPRLAGGSAGELFF,1,0,1,1
TRBV4-1,TRBJ2-1,CASSPSPSESTYNEQFF,1,0,1,1
TRBV4-1,TRBJ2-1,CASSQDWGLAGVNEQFF,1,0,1,1
TRBV4-1,TRBJ2-5,CASSQDRGGRGQETQYF,1,0,1,1
TRBV20-1,TRBJ2-1,CSVGGASGGTVYNEQVF,1,0,1,1
TRBV20-1,TRBJ2-3,CSASLLAGGAPPDTQYF,1,0,1,1
TRBV20-1,TRBJ2-3,CSASGGSRPMGADTQYF,1,0,1,1
TRBV20-1,TRBJ2-4,CSARALSAGQGNSVQYF,1,0,1,1
TRBV20-1,TRBJ2-7,CSAPKGLLGGTSYEQYF,1,0,1,1
TRBV29-1,TRBJ2-6,CSVLTGTASSGANVLTL,1,0,1,1
TRBV29-1,TRBJ2-7,CSVQLPLAGARGYEQYF,1,0,1,1
TRBV29-1,TRBJ2-1,CSVDGSAGTRVHNEQFF,1,0,1,1
TRBV29-1,TRBJ2-3,CSVEGQGDQLRPDTQYF,1,0,1,1
TRBV29-1,TRBJ2-3,CSVEGLVTGDDPDTQYF,1,0,1,1
TRBV28,TRBJ2-1,CVSSSFGGRAYNEQFF,1,0,1,1
TRBV16,TRBJ1-6,CALSESWNTNAGKSTF,1,0,1,1
TRBV12-5,TRBJ2-1,CARGLIPGQNYNEQFF,1,0,1,1
TRBV30,TRBJ2-5,CAWSVLGQGHQETQYF,1,0,1,1
TRBV10-3,TRBJ2-2,CAIMGLAGAGGGELFF,1,0,1,1
TRBV3-1,TRBJ2-7,CATSQDFRRETYEQYF,1,0,1,1
TRBV19,TRBJ2-6,CASGPGDLSGANVLTF,1,0,1,1
TRBV19,TRBJ1-2,CASTPGPLGNNYGYTF,1,0,1,1
TRBV19,TRBJ2-1,CASSLQGREPYNEQFF,1,0,1,1
TRBV19,TRBJ2-1,CASSISSGSEANEQFF,1,0,1,1
TRBV19,TRBJ2-1,CASSSRGLADYNEQFF,1,0,1,1
TRBV19,TRBJ1-1,CASSKPSTGTPTGAFF,1,0,1,1
TRBV18,TRBJ2-4,CASSPPGSPVGNIQYF,1,0,1,1
TRBV18,TRBJ2-3,CASSPPSGRAADTQYF,1,0,1,1
TRBV18,TRBJ2-7,CASSPAGRDRGREQYF,1,0,1,1
TRBV28,TRBJ2-2,CASTPSGRGDTGELFF,1,0,1,1
TRBV28,TRBJ2-7,CASSFHLAVLSYEQYF,1,0,1,1
TRBV27,TRBJ2-3,CASSSHGTGGTDTQYF,1,0,1,1
TRBV6-2/3/5/6,TRBJ2-1,CASSYELAGVRDEQFF,1,0,1,1
TRBV6-2/3/5/6,TRBJ2-3,CASSYSLADSTDTQYF,1,0,1,1
TRBV6-2/3/5/6,TRBJ2-6,CASSYSRAPGANVLTF,1,0,1,1
TRBV28,TRBJ2-3,CASSLGRFKGADTQYF,1,0,1,1
TRBV6-2/3/5/6,TRBJ2-6,CASSPTGGSGANVLTF,1,1,2,2
TRBV6-1,TRBJ2-2,CASSGLAPTNTGELFF,1,0,1,1
TRBV6-4,TRBJ2-7,CASSDGTSGSRHEQYF,1,0,1,1
TRBV6-1,TRBJ1-5,CASSEGTGNAYQPQHF,1,1,2,2
TRBV6-1,TRBJ1-5,CASSEAVDRNNQPQHF,1,0,1,1
TRBV27,TRBJ2-3,CASSTRLAGYTDTQYF,1,0,1,1
TRBV25-1,TRBJ1-5,CASSSAGGVGNQPQHF,1,0,1,1
TRBV7-2,TRBJ2-5,CASSFPFGQGEETQYF,1,0,1,1
TRBV13,TRBJ2-7,CASSFGHGQGVYEQYF,1,0,1,1
TRBV7-3,TRBJ2-3,CASSLQGGPTSDTQYF,1,0,1,1
TRBV5-5,TRBJ2-7,CASSLVRTRSSYEQYF,1,0,1,1
TRBV5-4,TRBJ2-7,CASSLGTSGRSYEQYF,1,0,1,1
TRBV5-4,TRBJ2-3,CASSLELAGGMNTQYF,1,0,1,1
TRBV5-6,TRBJ2-3,CASSLRPSGLTDTQYF,1,0,1,1
TRBV11-2,TRBJ2-2,CASSLFWTEDTGELFF,1,0,1,1
TRBV7-9,TRBJ2-2,CASSLLGTSNTGELFF,1,0,1,1
TRBV7-2,TRBJ2-1,CASSLSAGGIDNEQFF,1,0,1,1
TRBV7-2,TRBJ2-7,CASSLRGSPFSYEQYF,1,0,1,1
TRBV7-6,TRBJ2-1,CASSLVGTRDGGEQFF,1,0,1,1
TRBV7-2,TRBJ2-1,CASSLAPTSGNNEQFF,1,0,1,1
TRBV7-6,TRBJ2-1,CASSLGSGNSYNEQFL,1,0,1,1
TRBV7-6,TRBJ2-1,CASSLGGIAPPNEQFF,1,0,1,1
TRBV7-9,TRBJ2-4,CASSLGALQPKNIQYF,1,0,1,1
TRBV11-2,TRBJ2-1,CASSLEGFRSYNEQFF,1,0,1,1
TRBV7-2,TRBJ2-1,CASSLKRLLSGGEQFF,1,0,1,1
TRBV5-4,TRBJ2-7,CASSSSGTSGTYEQYF,1,0,1,1
TRBV7-8,TRBJ2-1,CASSSAGTSGYNEQFF,1,0,1,1
TRBV5-6,TRBJ2-5,CASSSRTQGAGETQYF,1,0,1,1
TRBV5-4,TRBJ2-2,CASSSPSSANTGELFF,1,0,1,1
TRBV7-2,TRBJ2-2,CASSSRVGGNTGELFF,1,0,1,1
TRBV7-9,TRBJ2-4,CASSSGTAIAKNIQYF,1,0,1,1
TRBV7-9,TRBJ2-3,CASSSSRGGRTDTQYF,1,0,1,1
TRBV5-8,TRBJ2-7,CASSSNRLAGVSEQYF,1,0,1,1
TRBV11-3,TRBJ2-3,CASSSPWTIPPDTQYF,1,0,1,1
TRBV7-9,TRBJ2-5,CASSSEGGLPQETQYF,1,0,1,1
TRBV11-1,TRBJ2-2,CASSYQAGSGTGELFF,1,0,1,1
TRBV7-6,TRBJ2-3,CASSLGGLAGTDTQYF,1,0,1,1
TRBV12-3/4,TRBJ1-2,CASSPSWEGATYGYTF,1,0,1,1
TRBV7-2,TRBJ2-7,CASSPSSGRVPYEQYF,1,0,1,1
TRBV7-9,TRBJ2-3,CASSPRPRGGPDTQYF,1,1,2,2
TRBV7-9,TRBJ1-3,CASSPDGTATGNTIYF,1,0,1,1
TRBV5-4,TRBJ2-1,CASSRGGSSSYNEQFF,1,0,1,1
TRBV4-2,TRBJ2-6,CASSHQTGSGANVLTF,1,0,1,1
TRBV7-2,TRBJ2-3,CASSQSSGIRSDTQYF,1,0,1,1
TRBV7-6,TRBJ2-5,CASSQIAGGGQETQYF,1,0,1,1
TRBV6-2/3/5/6,TRBJ2-7,CASSQGQQARFYEQYF,1,0,1,1
TRBV14,TRBJ1-4,CASSQGGRWSNEKLFF,1,0,1,1
TRBV4-2,TRBJ2-1,CASSQDSSFPYNEQFF,1,0,1,1
TRBV4-2,TRBJ2-3,CASSQDGRGGGDTQYF,1,0,1,1
TRBV3-1,TRBJ1-1,CASSQDNWGTITRAFF,1,0,1,1
TRBV3-1,TRBJ2-7,CASSQEGRAPEYEQYF,1,0,1,1
TRBV3-1,TRBJ1-1,CASSQEVEGQNTEAFF,1,0,1,1
TRBV3-1,TRBJ2-7,CASSQSLLAGVHEQYF,1,0,1,1
TRBV11-1,TRBJ2-5,CASSVLAGATQETQYF,1,0,1,1
TRBV9,TRBJ2-1,CASSVDSGQPYNEQFF,1,0,1,1
TRBV4-2,TRBJ2-1,CASSAPSGGDRNEQFF,1,0,1,1
TRBV5-6,TRBJ2-1,CASSGRRAPPYNEQFF,1,0,1,1
TRBV7-8,TRBJ2-7,CASSGAFTGGGYEQYF,1,0,1,1
TRBV5-8,TRBJ2-7,CASSRTGTATPYEQCF,1,0,1,1
TRBV7-2,TRBJ2-7,CASSKYRLAGVYEQYF,1,0,1,1
TRBV2,TRBJ2-1,CASRLGQVISYNEQFF,1,0,1,1
TRBV2,TRBJ1-4,CASNSGQGATNEKLFF,1,0,1,1
TRBV4-1,TRBJ2-4,CASGLPGQIAKNIQYF,1,0,1,1
TRBV10-1,TRBJ1-4,CASSRDRGATNEKLFF,1,0,1,1
TRBV5-1,TRBJ2-1,CASSLRGPLEGNEQFF,1,0,1,1
TRBV5-1,TRBJ2-3,CASSLASRRGTDTQCF,1,0,1,1
TRBV5-1,TRBJ2-2,CASSLAGGEYTGELFF,1,0,1,1
TRBV5-1,TRBJ2-3,CASSLAAQGDADTQYF,1,0,1,1
TRBV5-1,TRBJ2-3,CASSLGPSESTDTQYF,1,0,1,1
TRBV5-1,TRBJ2-1,CASSLGRPLGSNEQFF,1,0,1,1
TRBV5-1,TRBJ2-3,CASSWQGRFSTDTQYF,1,0,1,1
TRBV5-1,TRBJ1-2,CASSWGVGPQSYGYTF,1,0,1,1
TRBV5-1,TRBJ2-2,CASSWDGRQGAGELFF,1,0,1,1
TRBV5-1,TRBJ2-3,CASSPLGQGGTDTQYF,1,0,1,1
TRBV4-1,TRBJ1-3,CASSPRSIIPGNTIYF,1,0,1,1
TRBV4-1,TRBJ2-1,CASSHKLAGGSNEQFF,1,0,1,1
TRBV4-1,TRBJ2-7,CASSQSGGLAIHEQYF,1,0,1,1
TRBV4-1,TRBJ2-3,CASSQAYGSTTDTQYF,1,0,1,1
TRBV4-1,TRBJ2-1,CASSQTGTSGNNEQVF,1,0,1,1
TRBV4-1,TRBJ2-7,CASSQKRSSDPYEQYF,1,0,1,1
TRBV5-1,TRBJ2-2,CASSERVAANTGELFF,1,0,1,1
TRBV5-1,TRBJ2-7,CASSTRTSGRPYEQYF,1,0,1,1
TRBV5-1,TRBJ2-5,CASNSYGTSRGGTQYF,1,0,1,1
TRBV20-1,TRBJ2-1,CSATAAGGLGYNEQFF,1,0,1,1
TRBV20-1,TRBJ2-1,CSASQQGTSGTVGEFF,1,0,1,1
TRBV20-1,TRBJ2-1,CSARPSGSMFYNEQFF,1,0,1,1
TRBV20-1,TRBJ1-5,CSARQGGGGSNQPQHF,1,0,1,1
TRBV20-1,TRBJ2-1,CSARDPREGPSDEQFF,1,0,1,1
TRBV20-1,TRBJ2-4,CSSPPEASLAKNIQYF,1,0,1,1
TRBV29-1,TRBJ2-5,CSVEGRNGILQETQYF,1,0,1,1
TRBV29-1,TRBJ1-2,CSVEDRGTGAYYGYTF,1,0,1,1
TRBV29-1,TRBJ2-3,CSVNAQGPETADAQYF,1,0,1,1
TRBV29-1,TRBJ2-1,CSAPGLAGGRYNEQFF,1,0,1,1
TRBV6-2/3/5/6,TRBJ2-7,RASSPQTSGSSYEQYF,1,0,1,1
TRBV12-5,TRBJ2-4,CASGTRQLAKNIQYF,1,0,1,1
TRBV30,TRBJ1-2,CAWSDQQGANYGYTF,1,0,1,1
TRBV10-3,TRBJ2-5,CAISLGHARGETQYF,1,0,1,1
TRBV10-3,TRBJ2-3,CAIKGQGGSTDTRYF,1,0,1,1
TRBV28,TRBJ2-3,CATLRGGGSIDTQYF,1,1,2,2
TRBV15,TRBJ2-5,CATSPWGEAQETQYF,1,0,1,1
TRBV27,TRBJ2-7,CASSNGQGPPYEQYF,1,0,1,1
TRBV19,TRBJ2-1,CASTRTLGDYNEHFF,1,0,1,1
TRBV19,TRBJ2-7,CASSIFGGSSYEQYF,1,0,1,1
TRBV19,TRBJ2-3,CASSILRSRTDTQYF,1,0,1,1
TRBV19,TRBJ2-7,CASSIGTGTTYEQYF,1,0,1,1
TRBV19,TRBJ1-1,CASSRTVARNTEAFF,1,0,1,1
TRBV19,TRBJ2-7,CASSLPGTSGGKQYF,1,0,1,1
TRBV18,TRBJ2-5,CASSPGTGSQETQHF,1,0,1,1
TRBV18,TRBJ2-3,CASSPKDRSTDTQYF,1,0,1,1
TRBV18,TRBJ2-1,CASSPLTGSGNEQFF,1,0,1,1
TRBV18,TRBJ1-1,CASSPTTGTNAEAFF,1,0,1,1
TRBV18,TRBJ2-1,CASSPSVAGYNEQFF,1,0,1,1
TRBV7-2,TRBJ2-1,CASLQTSYAYNEQFF,1,0,1,1
TRBV12-3/4,TRBJ2-3,CASHRGARSTDTQYF,1,0,1,1
TRBV6-2/3/5/6,TRBJ2-1,CASASGTSGYNEQFF,1,0,1,1
TRBV2,TRBJ2-1,CASTSLAGGGNEQFF,1,0,1,1
TRBV5-4,TRBJ2-1,CASTSGVAIYNEQFF,1,0,1,1
TRBV3-1,TRBJ2-1,CASTHSASGRNEQFF,1,0,1,1
TRBV6-2/3/5/6,TRBJ2-1,CASSFLGGFYNEQFF,1,0,1,1
TRBV6-2/3/5/6,TRBJ2-1,CASSFASGRYNEQFF,1,0,1,1
TRBV28,TRBJ2-1,CASSFAGAGYNERFF,1,0,1,1
TRBV12-3/4,TRBJ2-3,CASSFGGMVGDTQYF,1,0,1,1
TRBV28,TRBJ2-2,CASSLLGLNTGELFF,1,0,1,1
TRBV27,TRBJ2-3,CASSLARGLRDTQYF,1,0,1,1
TRBV12-3/4,TRBJ1-3,CASSLRRTGAHTIYF,1,0,1,1
TRBV12-3/4,TRBJ2-3,CASSSREREWNTQYF,1,0,1,1
TRBV28,TRBJ2-2,CASSSPSAYTGELFF,1,0,1,1
TRBV7-9,TRBJ2-5,CASSSGTSVPETQYF,1,0,1,1
TRBV6-2/3/5/6,TRBJ2-3,CASSSLAGGPNTQYF,1,0,1,1
TRBV6-2/3/5/6,TRBJ1-2,CASSYSLVANYGYTF,1,0,1,1
TRBV6-2/3/5/6,TRBJ1-1,CASSYSGTIGTEAFF,1,0,1,1
TRBV6-2/3/5/6,TRBJ2-7,CASSYAGASSYEQYF,1,0,1,1
TRBV6-2/3/5/6,TRBJ1-6,CASSYGTPDNSPLHF,1,0,1,1
TRBV7-2,TRBJ2-2,CASSLLGGGSGELFF,1,0,1,1
TRBV3-1,TRBJ1-2,CASSPPHRGDGGYAF,1,0,1,1
TRBV27,TRBJ2-1,CASSPSGYLTSEQFF,1,0,1,1
TRBV11-3,TRBJ2-1,CASSQGTSAYNEQFF,1,0,1,1
TRBV2,TRBJ2-1,CASSASGTSVNEQFF,1,0,1,1
TRBV2,TRBJ2-3,CASSAYRDRGSAQYF,1,0,1,1
TRBV6-1,TRBJ2-5,CASSASGQAQETQYF,1,0,1,1
TRBV2,TRBJ2-5,CASSATGDREETQYF,1,0,1,1
TRBV2,TRBJ2-3,CASSGRLAAQDTQYF,1,0,1,1
TRBV6-1,TRBJ2-1,CASSDVGATGEEQFF,1,0,1,1
TRBV6-1,TRBJ2-7,CASSESDGNPYEQYF,1,0,1,1
TRBV7-6,TRBJ2-1,CASSFAVGSYNEQFF,1,0,1,1
TRBV11-2,TRBJ2-1,CASSFMASGDSEQFF,1,0,1,1
TRBV7-2,TRBJ2-1,CASSFIIAGEGEQFF,1,0,1,1
TRBV7-9,TRBJ2-6,CASSFVGSGANVQTF,1,0,1,1
TRBV5-6,TRBJ1-5,CASSLYRGPGQPQHF,1,0,1,1
TRBV5-4,TRBJ2-7,CASSLASGFKYEQYF,1,0,1,1
TRBV5-6,TRBJ1-2,CASSLGFSREDGYTF,1,0,1,1
TRBV5-6,TRBJ1-2,CASSLESSNNYGYTF,1,0,1,1
TRBV7-9,TRBJ2-5,CASSLSRGYQETQYF,1,0,1,1
TRBV7-3,TRBJ2-1,CASSLWTSSYNEQLF,1,0,1,1
TRBV7-3,TRBJ2-6,CASSLLREGANVLTF,1,1,2,2
TRBV7-2,TRBJ2-7,CASSLPLGPFNEQYF,1,0,1,1
TRBV7-9,TRBJ2-7,CASSLVSGRSYEQYF,1,0,1,1
TRBV7-2,TRBJ2-3,CASSLVSATTDTQYF,1,0,1,1
TRBV7-9,TRBJ1-4,CASSLVRQGNEKLFF,1,0,1,1
TRBV7-2,TRBJ2-3,CASSLVRGRAETQYF,1,0,1,1
TRBV7-6,TRBJ2-3,CASSLAGDRIDTQYF,1,0,1,1
TRBV7-9,TRBJ2-7,CASSLAGVVSYEQYF,1,0,1,1
TRBV11-2,TRBJ2-2,CASSLGSVNTGELFF,1,0,1,1
TRBV7-2,TRBJ2-1,CASSLGGLAYNEQFF,1,0,1,1
TRBV7-9,TRBJ2-7,CASSLDGRAVDEQYF,1,0,1,1
TRBV7-9,TRBJ2-5,CASSLTTTLQETQYF,1,0,1,1
TRBV7-6,TRBJ2-7,CASSLSGTGTGEQYF,1,0,1,1
TRBV7-2,TRBJ2-3,CASSLRDRGADTQYF,1,0,1,1
TRBV5-6,TRBJ2-3,CASSSRGGLTDTQYF,1,0,1,1
TRBV7-9,TRBJ2-3,CASSSGTGAADTQYF,1,0,1,1
TRBV11-2,TRBJ1-2,CASSLYRAGNYGYTF,1,0,1,1
TRBV7-2,TRBJ2-7,CASSLVAGALYEQYF,1,0,1,1
TRBV6-2/3/5/6,TRBJ1-3,CASSLQGETGNTIYF,1,0,1,1
TRBV6-2/3/5/6,TRBJ2-7,CASSPLLGGGGEQYF,1,0,1,1
TRBV5-4,TRBJ2-5,CASSPPGSGRETQYF,1,0,1,1
TRBV12-3/4,TRBJ2-1,CASSPPDGGYNEQFF,1,0,1,1
TRBV6-2/3/5/6,TRBJ2-7,CASSPGTTRAYEQYF,1,0,1,1
TRBV7-6,TRBJ2-7,CASSPGQEGIYEQYF,1,0,1,1
TRBV5-6,TRBJ2-7,CASSPGGGALDEQYF,1,0,1,1
TRBV28,TRBJ2-3,CASSRRGYGSDTQYF,1,0,1,1
TRBV7-2,TRBJ2-5,CASSRASGAQETQYF,1,0,1,1
TRBV4-2,TRBJ2-7,CASSQVRAESYEQYF,1,0,1,1
TRBV3-1,TRBJ2-7,CASSQVASGFYEQYF,1,0,1,1
TRBV3-1,TRBJ2-3,CASSQVNRVTDTQYF,1,0,1,1
TRBV3-1,TRBJ2-5,CASSQGTGGYETQYF,1,0,1,1
TRBV3-1,TRBJ2-1,CASSQGSGPRNEQFF,1,0,1,1
TRBV4-2,TRBJ2-5,CASSQDPTGEETQYF,1,0,1,1
TRBV4-2,TRBJ2-1,CASSQDDAAYNEQFF,1,0,1,1
TRBV3-1,TRBJ2-1,CASSQDSAGGREQFF,1,0,1,1
TRBV6-2/3/5/6,TRBJ2-7,CASSQKQGPSYVQYF,1,0,1,1
TRBV9,TRBJ2-3,CASSVSLAGADTQYF,1,0,1,1
TRBV7-2,TRBJ2-3,CASSVVRNSWDTQYF,1,0,1,1
TRBV9,TRBJ2-7,CASSVNRLADYEQYF,1,0,1,1
TRBV9,TRBJ2-3,CASSVKLNSADTQYF,1,0,1,1
TRBV7-9,TRBJ2-1,CASSGGLAGDHEQFF,1,0,1,1
TRBV7-2,TRBJ2-1,CASSGDRSSYNEQFF,1,0,1,1
TRBV11-2,TRBJ2-1,CASSDRDVVYNEQFF,1,0,1,1
TRBV7-9,TRBJ2-3,CASSEGATLQRTQYF,1,0,1,1
TRBV5-5,TRBJ2-5,CASSIRTGGLETQYF,1,0,1,1
TRBV7-9,TRBJ2-7,CASSRGQGSVYEQYF,1,0,1,1
TRBV12-3/4,TRBJ2-5,CASRPSGGARETQYF,1,0,1,1
TRBV2,TRBJ2-1,CASRVLAGGDQQQFF,1,0,1,1
TRBV27,TRBJ1-1,CASRASYQGRTEAFF,1,0,1,1
TRBV2,TRBJ1-5,CASRGSWQRNQPQHF,1,0,1,1
TRBV6-4,TRBJ2-6,CASRDDASGANVLTF,1,0,1,1
TRBV2,TRBJ2-7,CASRTPLGAPYEQYF,1,0,1,1
TRBV3-1,TRBJ2-2,CASRPSVSNTGELFF,1,0,1,1
TRBV10-1,TRBJ2-2,CASADAGPNTGELFF,1,0,1,1
TRBV5-1,TRBJ2-7,CASCRQLDRPHEQYF,1,0,1,1
TRBV5-1,TRBJ2-5,CASYTSGSGQETQYF,1,0,1,1
TRBV5-1,TRBJ2-1,CASRTGTSGYNEQFF,1,0,1,1
TRBV5-1,TRBJ2-2,CASTGTGGYTGELFF,1,0,1,1
TRBV5-1,TRBJ2-1,CASSFLQGAGNEQFF,1,0,1,1
TRBV5-1,TRBJ2-3,CASSFPRGQADTQYF,1,0,1,1
TRBV5-1,TRBJ1-2,CASSFRRPLNYGYTF,1,0,1,1
TRBV5-1,TRBJ1-4,CASSLLHSGSEKLFF,1,0,1,1
TRBV5-1,TRBJ2-1,CASSLVLAEGDEQFF,1,0,1,1
TRBV5-1,TRBJ2-2,CASSLAAINTGELFF,1,0,1,1
TRBV5-1,TRBJ2-1,CASSLAGASYNEQFF,1,0,1,1
TRBV5-1,TRBJ2-6,CASSLAHSGANVLTF,1,0,1,1
TRBV5-1,TRBJ2-6,CASSLGVSGANVLTF,1,0,1,1
TRBV5-1,TRBJ1-4,CASSLDGNNPGKLFF,1,0,1,1
TRBV5-1,TRBJ2-7,CASSLDGDGFYEQYF,1,0,1,1
TRBV5-1,TRBJ1-5,CASSLDGQINQPQHF,1,0,1,1
TRBV5-1,TRBJ2-3,CASSLTPGGLDTQYF,1,0,1,1
TRBV5-1,TRBJ2-2,CASSLTGDSTGELFF,1,0,1,1
TRBV5-1,TRBJ2-1,CASSLQGGTYNEQFF,1,0,1,1
TRBV5-1,TRBJ1-3,CASSSDIGSGNTIYF,1,0,1,1
TRBV5-1,TRBJ2-1,CASSSRLAAYNEQFF,1,0,1,1
TRBV5-1,TRBJ2-1,CASSLSGSSYNEQFF,1,1,2,2
TRBV5-1,TRBJ2-3,CASSLWGPSTDTQYF,1,0,1,1
TRBV5-1,TRBJ2-7,CASSPLAGAFYEQYF,1,0,1,1
TRBV5-1,TRBJ2-5,CASSPRLAGAETQSF,1,0,1,1
TRBV4-1,TRBJ2-3,CASSHPASGQDTQYF,1,0,1,1
TRBV5-1,TRBJ2-1,CASSVGGDSYNEQFF,1,0,1,1
TRBV5-1,TRBJ2-1,CASSARWGSYNEQFF,1,0,1,1
TRBV20-1,TRBJ2-1,CSATSGLEGHNEQFF,1,0,1,1
TRBV20-1,TRBJ2-1,CSASSSGRSRNEQFF,1,0,1,1
TRBV20-1,TRBJ2-1,CSASKRGSGSFEQFF,1,0,1,1
TRBV20-1,TRBJ2-3,CSARSETGFSDTQYF,1,0,1,1
TRBV20-1,TRBJ2-3,CSARTGLGFTDTQYF,1,0,1,1
TRBV20-1,TRBJ2-7,CSARRTSGIVHEQYF,1,0,1,1
TRBV20-1,TRBJ2-5,CSARVAGGPRETQYF,1,0,1,1
TRBV20-1,TRBJ1-4,CSARDLGTGGEELFF,1,0,1,1
TRBV20-1,TRBJ2-5,CSARDGQGARETQYF,1,0,1,1
TRBV20-1,TRBJ2-7,CSARDRTSGKYEQYF,1,0,1,1
TRBV20-1,TRBJ2-7,CSASPTSGSIYEQYF,1,0,1,1
TRBV29-1,TRBJ2-3,CSVFGLAGARDTQYF,1,0,1,1
TRBV29-1,TRBJ2-5,CSVPYRESPQETQYF,1,0,1,1
TRBV29-1,TRBJ1-5,CSVGQGAGGNQPQHF,1,0,1,1
TRBV29-1,TRBJ2-7,CSVEWTGGSEYEQYF,1,0,1,1
TRBV29-1,TRBJ1-1,CSVEVGDRADTEAFF,1,0,1,1
TRBV29-1,TRBJ2-7,CSVEGGTGAAYEQYF,1,0,1,1
TRBV29-1,TRBJ2-1,CSVEGTSAFYNEQFF,1,0,1,1
TRBV29-1,TRBJ2-3,CSVEDWGQGPDAQYF,1,0,1,1
TRBV29-1,TRBJ2-5,CSVEELASGRETQYF,1,0,1,1
TRBV29-1,TRBJ2-7,CSVESRGAGGREQYF,1,0,1,1
TRBV29-1,TRBJ1-1,CSVGTGAHPGTEAFF,1,0,1,1
TRBV29-1,TRBJ2-3,CSVDLMGQSTDTQYF,1,0,1,1
TRBV7-9,TRBJ2-7,RASSLSGTSDYEQYF,1,0,1,1
TRBV14,TRBJ2-7,CACSQEGGPYEQYF,1,0,1,1
TRBV30,TRBJ2-3,CAWSHRTGSDTQYF,1,0,1,1
TRBV30,TRBJ2-1,CAWSGGQGSNEQFF,1,0,1,1
TRBV30,TRBJ2-1,CAWSAGLEDNEQFF,1,0,1,1
TRBV10-3,TRBJ2-7,CAISFETGVHEQYF,1,0,1,1
TRBV12-3/4,TRBJ1-3,CATGMAASGNTIYF,1,0,1,1
TRBV19,TRBJ2-1,CATGPIDSYNEQSF,1,0,1,1
TRBV24-1,TRBJ2-3,CATSARGGTDTQYF,1,0,1,1
TRBV24-1,TRBJ2-3,CATSDRTGPDTQYF,1,0,1,1
TRBV7-9,TRBJ2-5,CATSTTTGGETQYF,1,1,2,2
TRBV19,TRBJ1-2,CASTLRGDLYGYSF,1,0,1,1
TRBV19,TRBJ2-3,CASSAGLGTDTQYF,1,0,1,1
TRBV19,TRBJ2-1,CASSADLRLNEQFF,1,0,1,1
TRBV19,TRBJ2-7,CASSIVSGSYEQYF,1,0,1,1
TRBV19,TRBJ1-1,CASSMGQSNTEAFF,1,0,1,1
TRBV19,TRBJ1-1,CASSKELMNTEAFF,1,0,1,1
TRBV19,TRBJ1-5,CASSFREAHQPQHF,1,0,1,1
TRBV19,TRBJ1-1,CASSSGGAQLGAFF,1,0,1,1
TRBV19,TRBJ2-3,CASSPPGSTDTQYF,1,0,1,1
TRBV18,TRBJ2-5,CASSPGTEQETQYF,1,0,1,1
TRBV18,TRBJ2-5,CASSPPSGGETQYF,1,0,1,1
TRBV18,TRBJ2-3,CASSPNPDRDTQYF,1,0,1,1
TRBV18,TRBJ2-3,CASSPGQGADTQYF,1,0,1,1
TRBV18,TRBJ2-5,CASSPRGLQETQYF,1,0,1,1
TRBV12-3/4,TRBJ2-2,CASTFSGNTGELFF,1,0,1,1
TRBV12-3/4,TRBJ2-7,CASTSSGSSYEQYF,1,0,1,1
TRBV3-1,TRBJ2-2,CASTAGQGTGELFF,1,0,1,1
TRBV2,TRBJ2-1,CASTTSGSFNEQFF,1,0,1,1
TRBV12-3/4,TRBJ1-1,CASSFGQGGTEAFF,1,0,1,1
TRBV12-3/4,TRBJ1-2,CASSFRGVGYGYPF,1,0,1,1
TRBV28,TRBJ2-7,CASSLWGRTYEQYF,1,0,1,1
TRBV6-2/3/5/6,TRBJ2-3,CASSLGLAGVTQYF,1,0,1,1
TRBV7-9,TRBJ1-1,CASSLTGAYTEAFF,1,0,1,1
TRBV12-3/4,TRBJ1-1,CASSLFLENTEAFF,1,0,1,1
TRBV28,TRBJ2-2,CASSLWGQAGELFF,1,0,1,1
TRBV6-2/3/5/6,TRBJ2-7,CASSLGQENYEQYF,1,0,1,1
TRBV12-3/4,TRBJ1-5,CASSLGSRGQPKHF,1,0,1,1
TRBV6-2/3/5/6,TRBJ2-7,CASSLGVSPPEQYF,1,0,1,1
TRBV12-3/4,TRBJ2-7,CASSLEEFGYEQYF,1,0,1,1
TRBV6-2/3/5/6,TRBJ2-1,CASSLNLWGNEQFF,1,0,1,1
TRBV28,TRBJ1-2,CASSSNPGVYGYTF,1,0,1,1
TRBV27,TRBJ1-5,CASSSQVQNQPQHF,1,0,1,1
TRBV6-2/3/5/6,TRBJ2-7,CASSYSVTGNEQYF,1,0,1,1
TRBV6-2/3/5/6,TRBJ2-1,CASSYSGGWNEQFF,1,0,1,1
TRBV6-2/3/5/6,TRBJ2-3,CASSYNTRTDTQYF,1,0,1,1
TRBV7-2,TRBJ2-1,CASSLMGTSNEQFF,1,0,1,1
TRBV7-3,TRBJ2-3,CASSPLSGSPTQYF,1,0,1,1
TRBV6-2/3/5/6,TRBJ2-1,CASSPGQGANEQFF,1,0,1,1
TRBV7-9,TRBJ2-4,CASSPTGGRNIQYF,1,0,1,1
TRBV28,TRBJ2-5,CASSPPLGLRTQYF,1,0,1,1
TRBV6-2/3/5/6,TRBJ1-1,CASSRRQGNTEAFF,1,0,1,1
TRBV7-9,TRBJ2-1,CASSRLAGVNEQFY,1,0,1,1
TRBV11-3,TRBJ2-2,CASSRAGSTGELVF,1,0,1,1
TRBV25-1,TRBJ2-2,CASSVPGFAGELFF,1,0,1,1
TRBV6-1,TRBJ1-2,CASSVGRGVRSYTF,1,0,1,1
TRBV6-1,TRBJ2-1,CASSGDTIYNEQFF,1,0,1,1
TRBV6-4,TRBJ1-4,CASSDVRFNEKLFF,1,0,1,1
TRBV2,TRBJ2-1,CASSEQGAGNEQFF,1,0,1,1
TRBV2,TRBJ2-2,CASSEGNLPPELFF,1,0,1,1
TRBV6-2/3/5/6,TRBJ2-2,CASSITRNTGELFF,1,0,1,1
TRBV6-2/3/5/6,TRBJ1-1,CASSTFDRVAEAFF,1,0,1,1
TRBV12-3/4,TRBJ2-2,CASSKAVGTGELFF,1,0,1,1
TRBV7-3,TRBJ2-5,CASSFYRYQETQYF,1,0,1,1
TRBV5-5,TRBJ1-3,CASSFRDSGNTIYF,1,0,1,1
TRBV7-9,TRBJ2-3,CASSFVDSADTQYF,1,0,1,1
TRBV7-9,TRBJ2-2,CASSFVQNTGELFF,1,0,1,1
TRBV5-4,TRBJ2-3,CASSFGSDPDTQYF,1,0,1,1
TRBV11-1,TRBJ1-1,CASSLLFGNTEAFF,1,0,1,1
TRBV7-6,TRBJ2-2,CASSLVLDTGELFF,1,0,1,1
TRBV5-4,TRBJ2-1,CASSLVTLYNEQFF,1,0,1,1
TRBV5-4,TRBJ2-7,CASSLAQGSYEQYF,1,0,1,1
TRBV5-4,TRBJ2-2,CASSLADLAGELFF,1,0,1,1
TRBV5-6,TRBJ2-1,CASSLGGLAEEQFF,1,0,1,1
TRBV5-8,TRBJ1-5,CASSLIRGQEPQHF,1,0,1,1
TRBV11-1,TRBJ2-7,CASSLSGFSYEQYF,1,0,1,1
TRBV5-4,TRBJ2-5,CASSLPQGARTQYF,1,0,1,1
TRBV7-2,TRBJ2-7,CASSLRFRNYEQYF,1,0,1,1
TRBV7-6,TRBJ2-3,CASSLQVQADTQYF,1,0,1,1
TRBV11-2,TRBJ2-1,CASSLVRKFGEQFF,1,0,1,1
TRBV11-2,TRBJ2-4,CASSLAGGLDIQYF,1,0,1,1
TRBV11-2,TRBJ2-5,CASSLGTVQETQYF,1,0,1,1
TRBV11-2,TRBJ1-4,CASSLDWANEKLFF,1,0,1,1
TRBV7-6,TRBJ2-5,CASSLTGGDETQYF,1,0,1,1
TRBV11-2,TRBJ2-3,CASSLTQAVRTQYF,1,0,1,1
TRBV5-6,TRBJ2-1,CASSSLAGVNEQFF,1,0,1,1
TRBV11-2,TRBJ2-1,CASSSEVGHNEQFF,1,0,1,1
TRBV5-6,TRBJ1-1,CASSSLGGSTEAFF,1,0,1,1
TRBV7-6,TRBJ2-7,CASSSRDGQYEQYF,1,0,1,1
TRBV3-1,TRBJ1-4,CASSSGTGNEKLFF,1,0,1,1
TRBV7-2,TRBJ2-5,CASSSGLVKETQYF,1,1,2,2
TRBV7-6,TRBJ2-1,CASSLDREINEQFF,1,0,1,1
TRBV6-2/3/5/6,TRBJ2-7,CASSPLGQNYEQYF,1,0,1,1
TRBV7-9,TRBJ2-7,CASSPVGGAYEQYF,1,0,1,1
TRBV7-6,TRBJ1-4,CASSPTGRDEKLFF,1,0,1,1
TRBV11-2,TRBJ2-3,CASSPSGRSDTQYF,1,0,1,1
TRBV9,TRBJ2-1,CASSPPGWGNEQFF,1,0,1,1
TRBV12-3/4,TRBJ2-7,CASSPSATVSEQYF,1,0,1,1
TRBV9,TRBJ2-7,CASSPGQGAYEQYF,1,0,1,1
TRBV7-2,TRBJ2-3,CASSPSVGTDTQYF,1,0,1,1
TRBV4-2,TRBJ2-7,CASSPGLVLDEQYF,1,0,1,1
TRBV12-3/4,TRBJ1-5,CASSRMGPNQPQHF,1,0,1,1
TRBV14,TRBJ1-2,CASSQQKQLYGYTF,1,0,1,1
TRBV3-1,TRBJ2-4,CASSQVGQGNIQYF,1,0,1,1
TRBV3-1,TRBJ2-7,CASSQAGVTYEQYF,1,0,1,1
TRBV4-2,TRBJ1-1,CASSQGYRFTEAFF,1,0,1,1
TRBV3-1,TRBJ1-2,CASSQGEGARGYTF,1,0,1,1
TRBV14,TRBJ1-1,CASSQGTRGTEAFF,1,0,1,1
TRBV5-5,TRBJ2-3,CASSQTDRANTQYF,1,0,1,1
TRBV7-2,TRBJ1-6,CASSVERGSRPLHF,1,0,1,1
TRBV13,TRBJ2-1,CASSARTGGYEQFF,1,0,1,1
TRBV7-2,TRBJ2-3,CASSAEGGTDTQYF,1,0,1,1
TRBV3-1,TRBJ2-7,CASSGGGRRYEQYF,1,0,1,1
TRBV7-9,TRBJ2-7,CASSEAGVVYEQYF,1,0,1,1
TRBV11-2,TRBJ2-1,CASSTYRWESEQFF,1,0,1,1
TRBV5-4,TRBJ2-3,CASSTPDSTDTQYF,1,0,1,1
TRBV5-4,TRBJ2-3,CASSTQQGSDTQYF,1,0,1,1
TRBV2,TRBJ2-5,CASREQGVSETQYF,1,0,1,1
TRBV27,TRBJ1-5,CASREGYSNQPQHF,1,0,1,1
TRBV28,TRBJ2-7,CASRSLAGVYEQYF,1,0,1,1
TRBV2,TRBJ2-5,CASRPGTGGETQYF,1,0,1,1
TRBV7-9,TRBJ2-7,CASRRGGSADEQYF,1,0,1,1
TRBV12-3/4,TRBJ2-5,CASNDLAGLGAQYF,1,0,1,1
TRBV27,TRBJ2-3,CASKLAAGADTQYF,1,1,2,2
TRBV12-3/4,TRBJ2-2,CANRGELNTGELFF,1,0,1,1
TRBV20-1,TRBJ2-1,CRARDLRERYEQFF,1,0,1,1
TRBV10-3,TRBJ2-7,CAIADRRFRVEQYF,1,0,1,1
TRBV5-1,TRBJ1-1,CASSPQGGDTEAFF,1,0,1,1
TRBV2,TRBJ1-6,CASSEEQGDSPLHF,1,0,1,1
TRBV5-1,TRBJ2-7,CASSLDSGRGEQYF,1,0,1,1
TRBV5-1,TRBJ1-2,CASSLDRVLKGYTF,1,0,1,1
TRBV5-1,TRBJ1-1,CASSLEGQGTEAFF,1,0,1,1
TRBV5-1,TRBJ2-1,CASSLRDRHNEQFF,1,0,1,1
TRBV4-1,TRBJ1-1,CASSPSWGTTEAFF,1,0,1,1
TRBV4-1,TRBJ2-7,CASSRRGDAYEQYF,1,0,1,1
TRBV4-1,TRBJ2-1,CASSQGLFSNEQFF,1,0,1,1
TRBV4-1,TRBJ2-3,CASSQDKYRVTQYF,1,0,1,1
TRBV4-1,TRBJ2-5,CASSQEDPSGDQYF,1,0,1,1
TRBV5-1,TRBJ1-1,CASSGQGANTEAFF,1,0,1,1
TRBV5-1,TRBJ1-4,CASSIDTFNEKLFF,1,0,1,1
TRBV5-1,TRBJ1-1,CASSTQGADTEAFF,1,0,1,1
TRBV5-1,TRBJ2-7,CASSTNRELYEQYF,1,0,1,1
TRBV5-1,TRBJ2-1,CASRPGTQDNEQFF,1,0,1,1
TRBV20-1,TRBJ1-5,CSALEFIGPQPQHF,1,2,2,3
TRBV20-1,TRBJ2-7,CSAHTTTGDYELYF,1,0,1,1
TRBV20-1,TRBJ2-3,CSAQQAGGPGTQYF,1,0,1,1
TRBV20-1,TRBJ2-1,CSATGGLADNEQFF,1,0,1,1
TRBV20-1,TRBJ2-1,CSASSSGRYNEQFF,1,0,1,1
TRBV20-1,TRBJ2-3,CSASQGAETDTQYF,1,0,1,1
TRBV20-1,TRBJ1-1,CSARDFRGLAEAFF,1,0,1,1
TRBV20-1,TRBJ2-1,CSARDQGHYNEQFF,1,0,1,1
TRBV20-1,TRBJ2-7,CSAKGRPLSYEQYF,1,0,1,1
TRBV20-1,TRBJ2-1,CSALSGRAGNEQFF,1,0,1,1
TRBV20-1,TRBJ2-1,CSAGGTPSYNEQFF,1,0,1,1
TRBV20-1,TRBJ2-6,CSAMRTAGANVLTF,1,0,1,1
TRBV20-1,TRBJ2-3,CSAPLTHFTDTQYL,1,0,1,1
TRBV20-1,TRBJ2-1,CSAVSGSSYNEQFF,1,0,1,1
TRBV29-1,TRBJ2-7,CSVVGPRGYREQCF,1,0,1,1
TRBV29-1,TRBJ2-5,CSVALTGGLETQYF,1,0,1,1
TRBV29-1,TRBJ2-6,CSVALGPGANVLTF,1,0,1,1
TRBV29-1,TRBJ2-1,CSVAAGTGNNEQFF,1,0,1,1
TRBV29-1,TRBJ2-1,CSVGNLDSYNEQFF,1,0,1,1
TRBV29-1,TRBJ2-1,CSVEGIATYNEQFF,1,0,1,1
TRBV29-1,TRBJ2-3,CSVEVAIAADTQYF,1,0,1,1
TRBV29-1,TRBJ2-1,CSVQRELTYNEQFF,1,0,1,1
TRBV29-1,TRBJ2-7,CSVAAAGPGEVQYF,1,0,1,1
TRBV29-1,TRBJ1-2,CSAEGQGAGYGYTF,1,0,1,1
TRBV7-3,TRBJ2-7,RASSLVGLDGEQYF,1,1,2,2
TRBV5-4,TRBJ2-1,CVPGKEDYNEQFF,1,0,1,1
TRBV28,TRBJ2-7,CVSRSQGAGEQYF,1,0,1,1
TRBV7-7,TRBJ2-5,CASSLALVETEYY,1,0,1,1
TRBV10-3,TRBJ2-2,CASGPRETGELFF,1,0,1,1
TRBV28,TRBJ2-1,CACSSGAYNELFF,1,0,1,1
TRBV30,TRBJ2-7,CAWSRDPPHEQYF,1,0,1,1
TRBV30,TRBJ2-7,CAWSVIWGNEQYF,1,0,1,1
TRBV30,TRBJ2-5,CAWSAGHKETQYF,1,0,1,1
TRBV30,TRBJ2-5,CAWSIAGWETQYF,1,0,1,1
TRBV10-3,TRBJ2-7,CAISDRFLYEQYF,1,0,1,1
TRBV2,TRBJ2-5,CAISTGLGETQYF,1,0,1,1
TRBV10-3,TRBJ2-5,CAISDSNEETQYF,1,0,1,1
TRBV10-3,TRBJ2-5,CAISESNEETQYF,1,0,1,1
TRBV10-3,TRBJ2-5,CAIRGQGEETQYF,1,0,1,1
TRBV10-3,TRBJ1-2,CAMRQDLFYGYTF,1,0,1,1
TRBV7-9,TRBJ2-1,CATDRVSYNEQFF,1,0,1,1
TRBV19,TRBJ2-7,CATSSAGVSEQYF,1,0,1,1
TRBV2,TRBJ1-1,CATDIQVGTEAFF,1,0,1,1
TRBV24-1,TRBJ2-1,CATSDTDRDRQFF,1,0,1,1
TRBV28,TRBJ2-2,CASSTSNTGELFF,1,0,1,1
TRBV19,TRBJ2-2,CASTAANTGELFF,1,0,1,1
TRBV19,TRBJ2-1,CASSFGLQTGQFF,1,0,1,1
TRBV19,TRBJ1-1,CASRSGQNTEAFF,1,0,1,1
TRBV19,TRBJ2-1,CASRNSGSNEQFF,1,0,1,1
TRBV18,TRBJ2-5,CASSPGREETQYF,1,0,1,1
TRBV18,TRBJ1-5,CASSPTGDQPQHF,1,0,1,1
TRBV18,TRBJ2-7,CASSPLREIEQYF,1,0,1,1
TRBV18,TRBJ1-5,CASSPAGGQPQHF,1,0,1,1
TRBV6-1,TRBJ2-3,CASISSAGDTQYF,1,0,1,1
TRBV6-2/3/5/6,TRBJ1-1,CASTRGRNTEAYF,1,0,1,1
TRBV5-4,TRBJ2-1,CASTTGVHNEQFF,1,0,1,1
TRBV28,TRBJ1-6,CASSFNREGPLHF,1,0,1,1
TRBV28,TRBJ2-1,CASSLITSGEQFF,1,0,1,1
TRBV28,TRBJ2-1,CASSSGAYNEQFF,1,0,1,1
TRBV7-9,TRBJ2-3,CASSSTLTDTQYF,1,0,1,1
TRBV6-2/3/5/6,TRBJ1-1,CASSYDPGTEAFF,1,0,1,1
TRBV12-3/4,TRBJ2-7,CASSYGTADEQYF,1,0,1,1
TRBV12-3/4,TRBJ2-7,CASSYGLADEQYF,1,0,1,1
TRBV12-3/4,TRBJ2-5,CASSYEGGETQYF,1,0,1,1
TRBV12-3/4,TRBJ2-1,CASSRGQGREQFF,1,0,1,1
TRBV12-3/4,TRBJ2-5,CASSQASSQAQYF,1,0,1,1
TRBV12-3/4,TRBJ2-2,CASSQGRTGELFF,1,0,1,1
TRBV2,TRBJ2-1,CASSVGGGDEQFF,1,0,1,1
TRBV28,TRBJ2-5,CASSGGKRETQYF,1,0,1,1
TRBV2,TRBJ1-5,CASSERSAQPQHF,1,1,2,2
TRBV2,TRBJ2-7,CASSEVISYEQYF,1,0,1,1
TRBV12-3/4,TRBJ2-1,CASSTGPWGEQFF,1,0,1,1
TRBV12-3/4,TRBJ2-7,CASSRRGSYEQYF,1,0,1,1
TRBV11-1,TRBJ2-7,CASSFSRSYEQYF,1,0,1,1
TRBV7-6,TRBJ2-1,CASSFNPYNEQFF,1,1,2,2
TRBV7-2,TRBJ1-2,CASSLSGNYGYTF,1,0,1,1
TRBV7-2,TRBJ2-6,CASSLPGANVLTF,1,1,2,2
TRBV11-2,TRBJ1-5,CASSLVYNQPQHF,1,0,1,1
TRBV11-3,TRBJ2-1,CASSLVPSVEQFF,1,0,1,1
TRBV7-2,TRBJ2-5,CASSLVERETQYF,1,0,1,1
TRBV7-9,TRBJ1-1,CASSLGQVTEAFF,1,0,1,1
TRBV7-2,TRBJ2-7,CASSLDTLYEQYF,1,0,1,1
TRBV7-9,TRBJ2-7,CASSLEPISEQYF,1,0,1,1
TRBV7-6,TRBJ1-2,CASSLEGINGYTF,1,0,1,1
TRBV5-6,TRBJ2-1,CASSLELDNEQFF,1,0,1,1
TRBV11-2,TRBJ2-5,CASSLRRDGAQYF,1,1,2,2
TRBV7-3,TRBJ2-3,CASSSPGTDTQYF,1,0,1,1
TRBV7-9,TRBJ2-1,CASSSGRAHEQFF,1,0,1,1
TRBV7-8,TRBJ1-1,CASSWAGVTEAFF,1,0,1,1
TRBV5-6,TRBJ1-2,CASSYPGNYGYTF,1,0,1,1
TRBV7-6,TRBJ2-1,CASSYQGGNEQFF,1,0,1,1
TRBV5-6,TRBJ2-7,CASSYGGGYEQYF,1,0,1,1
TRBV2,TRBJ1-6,CASSLQGGSPLHF,1,0,1,1
TRBV7-2,TRBJ2-4,CASSLTSGDIQYF,1,0,1,1
TRBV7-2,TRBJ2-7,CASSLSSTVEQYF,1,0,1,1
TRBV27,TRBJ2-1,CASSLSVNHEQFF,1,0,1,1
TRBV3-1,TRBJ2-7,CASSPPFDGEQYF,1,0,1,1
TRBV11-2,TRBJ2-1,CASSPKMAQREFF,1,0,1,1
TRBV7-9,TRBJ2-1,CASSPRSYNEQFF,1,0,1,1
TRBV11-2,TRBJ2-5,CASSPIERETQYF,1,0,1,1
TRBV27,TRBJ2-2,CASSPWDRGWLFF,1,0,1,1
TRBV7-9,TRBJ2-3,CASSPIPADTQYF,1,0,1,1
TRBV14,TRBJ2-2,CASSRFNTGELFF,1,0,1,1
TRBV3-1,TRBJ2-1,CASSQLAGNEQFF,1,0,1,1
TRBV6-2/3/5/6,TRBJ2-1,CASSQDREAIQFF,1,0,1,1
TRBV14,TRBJ2-3,CASSQTEQSLQYF,1,0,1,1
TRBV14,TRBJ1-1,CASSQVGGFEAFF,1,0,1,1
TRBV3-1,TRBJ2-1,CASSQSGSNEQFF,1,0,1,1
TRBV2,TRBJ2-1,CASSVANNNEQFF,1,0,1,1
TRBV5-4,TRBJ1-1,CASSGGRNTEAFF,1,0,1,1
TRBV11-2,TRBJ1-1,CASSGRRNTEAFF,1,0,1,1
TRBV7-9,TRBJ2-3,CASSGAGTDTQYF,1,0,1,1
TRBV6-1,TRBJ2-2,CASSETRTGELFF,1,0,1,1
TRBV27,TRBJ2-5,CASRLAGEGTQYF,1,0,1,1
TRBV9,TRBJ2-7,CASRPGQRHEQYF,1,0,1,1
TRBV12-3/4,TRBJ2-4,CASRHGPGNFQYF,1,0,1,1
TRBV2,TRBJ2-7,CASRAAGGDEQYF,1,0,1,1
TRBV6-4,TRBJ1-2,CASRTDRNYGYTF,1,0,1,1
TRBV6-2/3/5/6,TRBJ2-5,CASRRGHQETQYF,1,0,1,1
TRBV2,TRBJ2-1,CASRRLADNEQFF,1,0,1,1
TRBV28,TRBJ2-3,CASRRQGTDTQYF,1,1,2,2
TRBV3-1,TRBJ2-5,CASRNQGGETQYF,1,0,1,1
TRBV5-6,TRBJ2-1,CASNQGAINEQFF,1,0,1,1
TRBV11-2,TRBJ2-3,CASNGGSTDTQYF,1,0,1,1
TRBV6-2/3/5/6,TRBJ2-4,CASKGPLKNIQYF,1,0,1,1
TRBV2,TRBJ1-5,CAGARGNNQPQHF,1,0,1,1
TRBV20-1,TRBJ2-7,CCASEGSSYEQYF,1,0,1,1
TRBV5-1,TRBJ2-5,CASRLGQGETQYF,1,0,1,1
TRBV5-1,TRBJ2-7,CASGTGTTYEQYF,1,0,1,1
TRBV5-1,TRBJ2-1,CASTRASYNEQFF,1,0,1,1
TRBV5-1,TRBJ2-7,CASSPEGGYEQYF,1,0,1,1
TRBV10-1,TRBJ1-1,CASSELDRGPAFF,1,0,1,1
TRBV5-1,TRBJ2-3,CASSFSGTDTQYF,1,0,1,1
TRBV5-1,TRBJ2-7,CASSLGRVNEQYF,1,0,1,1
TRBV5-1,TRBJ2-7,CASSLSSGLEQYF,1,0,1,1
TRBV5-1,TRBJ1-1,CASSLGGSPEAFF,1,0,1,1
TRBV5-1,TRBJ2-7,CASSLGQGGEQYF,1,0,1,1
TRBV4-1,TRBJ2-3,CASSQDGDDTQYF,1,0,1,1
TRBV20-1,TRBJ2-4,CSVLAGSKNIQYF,1,0,1,1
TRBV20-1,TRBJ2-5,CSVVGEGQETQYF,1,0,1,1
TRBV20-1,TRBJ2-1,CSALWTADNEQFF,1,0,1,1
TRBV20-1,TRBJ2-7,CSAPDLRRREQYF,1,0,1,1
TRBV20-1,TRBJ2-1,CSAGFIQGNEQFF,1,0,1,1
TRBV20-1,TRBJ2-2,CSATPPWNGELFF,1,0,1,1
TRBV20-1,TRBJ1-1,CSARVMGGPEAFF,1,0,1,1
TRBV20-1,TRBJ2-5,CSAKRTGQETQYF,1,1,2,2
TRBV20-1,TRBJ1-1,CSAPGGGRTEAFF,1,0,1,1
TRBV20-1,TRBJ2-7,CSAGGREGLEQYF,1,0,1,1
TRBV20-1,TRBJ2-1,CSAPATPPDEQFF,1,0,1,1
TRBV29-1,TRBJ2-5,CSVSMDRQETQYF,1,0,1,1
TRBV29-1,TRBJ2-5,CSVLQGGQETQYF,1,0,1,1
TRBV29-1,TRBJ1-1,CSVASGSSTEAFF,1,0,1,1
TRBV29-1,TRBJ2-3,CSVESGGADTQYF,1,0,1,1
TRBV29-1,TRBJ2-3,CSVEPARTDTQYF,1,0,1,1
TRBV29-1,TRBJ2-1,CSVESGSMDEQFF,1,0,1,1
TRBV29-1,TRBJ2-1,CSVEGQGYNEQFF,1,0,1,1
TRBV29-1,TRBJ2-7,CSVEGADSYEQYF,1,1,2,2
TRBV29-1,TRBJ2-7,CSGGPGPSYEQYF,1,1,2,2
TRBV20-1,TRBJ2-3,YSVLNGLTDTQYF,1,0,1,1
TRBV30,TRBJ1-2,CAWQEANYGYTF,1,0,1,1
TRBV30,TRBJ2-2,CAWSVGAGELFF,1,0,1,1
TRBV24-1,TRBJ2-1,CATQTSNNEQFF,1,0,1,1
TRBV3-1,TRBJ2-7,CATGQGGYEQYF,1,0,1,1
TRBV24-1,TRBJ1-5,CATSRYNQPQHF,1,0,1,1
TRBV24-1,TRBJ2-2,CATRSSIGELFF,1,0,1,1
TRBV7-9,TRBJ2-7,CATGGGAGEQYF,1,0,1,1
TRBV2,TRBJ1-2,CASRGPPKGYTF,1,0,1,1
TRBV18,TRBJ2-3,CASSELTDTQYF,1,0,1,1
TRBV28,TRBJ2-7,CASQRGNYEQYF,1,0,1,1
TRBV6-2/3/5/6,TRBJ2-1,CASSLPRQKQSS,1,0,1,1
TRBV28,TRBJ2-2,CASSLRTGELFF,1,0,1,1
TRBV6-2/3/5/6,TRBJ2-1,CASSLRAGATFF,1,0,1,1
TRBV27,TRBJ2-7,CASSLRGVEQYF,1,0,1,1
TRBV6-2/3/5/6,TRBJ2-1,CASSSGGNEQFF,1,0,1,1
TRBV28,TRBJ2-7,CASSSTGDEQYF,1,0,1,1
TRBV12-3/4,TRBJ2-3,CASSSRTSRRHF,1,0,1,1
TRBV6-2/3/5/6,TRBJ2-7,CASSYGSYEQYF,1,1,2,2
TRBV6-2/3/5/6,TRBJ2-1,CASSYGSNEQFF,1,0,1,1
TRBV12-3/4,TRBJ2-7,CASSAQGYEQYF,1,0,1,1
TRBV6-2/3/5/6,TRBJ1-1,CASSTGPTEAFF,1,0,1,1
TRBV7-9,TRBJ2-3,CASSFSWDTQYF,1,0,1,1
TRBV11-2,TRBJ2-2,CASSFHLGELFF,1,0,1,1
TRBV7-2,TRBJ2-3,CASSFNGDTQYF,1,0,1,1
TRBV7-9,TRBJ2-5,CASSFWDGAQYF,1,0,1,1
TRBV7-2,TRBJ2-3,CASSLTPPFPYF,1,0,1,1
TRBV7-9,TRBJ2-7,CASSLFGYEQYF,1,0,1,1
TRBV7-3,TRBJ2-2,CASSLQAGELFF,1,0,1,1
TRBV28,TRBJ2-1,CASSLKFRGQFF,1,0,1,1
TRBV7-9,TRBJ2-2,CASSSYTGELFF,1,0,1,1
TRBV11-2,TRBJ2-7,CASSSSGVLAGF,1,0,1,1
TRBV7-9,TRBJ2-1,CASSSPRVEQFF,1,0,1,1
TRBV7-9,TRBJ2-5,CASSSGSGTQYF,1,0,1,1
TRBV7-9,TRBJ1-2,CASSLTGGGYTF,1,0,1,1
TRBV7-9,TRBJ2-1,CASSLELNGQFF,1,0,1,1
TRBV7-9,TRBJ2-1,CASSPAPDEQFF,1,0,1,1
TRBV11-2,TRBJ2-3,CASSPELVSQYF,1,0,1,1
TRBV7-3,TRBJ2-3,CASSPTGETQYF,1,0,1,1
TRBV5-6,TRBJ2-1,CASSPRGQTAFF,1,0,1,1
TRBV12-3/4,TRBJ2-7,CASSRSGYEQYF,1,0,1,1
TRBV4-2,TRBJ2-7,CASSQDLIEQYF,1,5,2,6
TRBV14,TRBJ2-7,CASSQDRQREYF,1,0,1,1
TRBV5-4,TRBJ2-3,CASSRAGGQEYF,1,0,1,1
TRBV3-1,TRBJ2-7,CASRHTGGEQYF,1,0,1,1
TRBV14,TRBJ2-3,CASNPGGDTQYF,1,0,1,1
TRBV14,TRBJ2-1,CASNQADRGRLF,1,0,1,1
TRBV5-1,TRBJ2-5,CASSLGEETQYF,1,0,1,1
TRBV5-1,TRBJ2-7,CASSSDSGEQYF,1,0,1,1
TRBV4-1,TRBJ1-4,CASSQAYGKLFF,1,0,1,1
TRBV29-1,TRBJ1-2,CSLGQEGYGYTF,1,0,1,1
TRBV20-1,TRBJ2-7,CSARGVYYEQYY,1,0,1,1
TRBV20-1,TRBJ2-1,CSASRSGNEQFF,1,0,1,1
TRBV20-1,TRBJ2-7,CSARDLVNEQYF,1,0,1,1
TRBV20-1,TRBJ2-3,CSARDGRDTQYF,1,0,1,1
TRBV20-1,TRBJ2-7,CSAPGQLYEQYF,1,0,1,1
TRBV29-1,TRBJ2-4,CSVGLAKNIQYF,1,0,1,1
TRBV29-1,TRBJ2-5,CSVDGEQETQYF,1,0,1,1
TRBV29-1,TRBJ2-1,CSVTLTSGSVFF,1,0,1,1
TRBV29-1,TRBJ2-7,CSVKDTSYEQYF,1,1,2,2
TRBV29-1,TRBJ2-3,CSAITSSDTQYF,1,0,1,1
TRBV29-1,TRBJ2-5,CSGRQGGETQYF,1,0,1,1
TRBV28,TRBJ2-7,CVSSQSIGQYF,1,0,1,1
TRBV30,TRBJ2-7,CAYGRGYEQYF,1,0,1,1
TRBV27,TRBJ2-3,CASTWGSTQYF,1,0,1,1
TRBV6-2/3/5/6,TRBJ2-7,CASSWGYEQYF,1,0,1,1
TRBV2,TRBJ2-3,CASSKPDTQYF,1,0,1,1
TRBV5-6,TRBJ2-1,CASSLFGEQFF,1,0,1,1
TRBV5-6,TRBJ2-5,CASSLRQTQYF,1,0,1,1
TRBV7-9,TRBJ2-7,CASSLEGRQYF,1,0,1,1
TRBV7-6,TRBJ2-1,CASSSWDEQFF,1,0,1,1
TRBV5-1,TRBJ2-5,CASSSEETQYF,1,2,2,3
TRBV5-4,TRBJ2-4,CASSYKNIQYF,1,0,1,1
TRBV7-6,TRBJ2-5,CASSPGETQYF,1,0,1,1
TRBV7-9,TRBJ2-5,CASSPLQTQYF,1,0,1,1
TRBV6-4,TRBJ1-1,CASSDRGLAFF,1,0,1,1
TRBV20-1,TRBJ2-3,CSASLGDTQYF,1,0,1,1
TRBV20-1,TRBJ2-1,CSARLGVEQFF,1,0,1,1
TRBV29-1,TRBJ2-7,CSYLGTYEQYF,1,0,1,1
TRBV29-1,TRBJ2-5,CSVGLQETQYF,1,0,1,1
TRBV29-1,TRBJ2-7,CSVEGEGEQYF,1,0,1,1
TRBV29-1,TRBJ2-1,CSVLTGVVQFF,1,0,1,1
TRBV29-1,TRBJ2-5,CSARDVQTQYF,1,0,1,1
TRBV19,TRBJ2-3,CAAEGDTQYF,1,3,2,4
TRBV6-2/3/5/6,TRBJ2-3,CASRGHTQYF,1,0,1,1
TRBV20-1,TRBJ2-7,CSTLAYEQYF,1,0,1,1
TRBV29-1,TRBJ2-1,CSAHWNEQFF,1,0,1,1
TRBV20-1,TRBJ2-3,CSPGPQRHF,1,0,1,1
TRBV29-1,TRBJ2-5,CSVGIQYF,1,0,1,1
TRBV19,TRBJ2-1,CASSQTSGNYNEQFF,0,32,1,32
TRBV19,TRBJ2-1,CASSLTSGSYNEQFF,0,22,1,22
TRBV19,TRBJ2-1,CASSRTSGTYNEQFF,0,26,1,26
TRBV7-8,TRBJ2-1,CASSSDRYNEQFF,0,1,1,1
TRBV3-1,TRBJ1-4,CASSQEGRTGLFF,0,2,1,2
TRBV20-1,TRBJ2-7,CSARVTGGTYEQYF,0,1,1,1
TRBV4-1,TRBJ2-2,CASRPNSGVNTGELFF,0,4,1,4
TRBV7-2,TRBJ2-3,CASSPGRPADTQYF,0,1,1,1
TRBV2,TRBJ2-1,CAGTAEGFYNEQFF,0,1,1,1
TRBV19,TRBJ1-5,CASSFSTTPYQPQHF,0,8,1,8
TRBV19,TRBJ2-2,CATEGGLRNTGELFF,0,1,1,1
TRBV3-1,TRBJ2-1,CASSTGLAGGEQFF,0,1,1,1
TRBV7-2,TRBJ2-3,CASSPLQGLKDTQYF,0,1,1,1
TRBV9,TRBJ1-1,CASSVKGGTEAFF,0,1,1,1
TRBV3-1,TRBJ2-1,CASSQGGNEQFF,0,1,1,1
TRBV12-3/4,TRBJ1-1,CASSAQGEGTEAFF,0,1,1,1
TRBV12-3/4,TRBJ2-1,CASSPRLAGAGEQFF,0,1,1,1
TRBV19,TRBJ2-7,CASSIGGYEQYF,0,3,1,3
TRBV5-4,TRBJ2-2,CASSPQRSSGIIGELFF,0,1,1,1
TRBV19,TRBJ2-7,CASSLLTDRDYEQYF,0,2,1,2
TRBV10-2,TRBJ1-6,CASSAQSLRLGFNSPLHF,0,1,1,1
TRBV7-9,TRBJ1-1,CASRYVQQNTEAFF,0,4,1,4
TRBV10-3,TRBJ2-5,CAISESKGLLQETQYF,0,1,1,1
TRBV12-3/4,TRBJ1-1,CASSLGAGMNTEAFF,0,3,1,3
TRBV20-1,TRBJ2-5,CSARPSTGNGETQYF,0,1,1,1
TRBV14,TRBJ2-7,CASSPFRQSQQYF,0,1,1,1
TRBV29-1,TRBJ2-1,CSVDADRVSYNEQFF,0,3,1,3
TRBV18,TRBJ2-3,CASSPPASNAQYF,0,2,1,2
TRBV2,TRBJ2-7,CASSEWAEQYF,0,3,1,3
TRBV19,TRBJ2-1,CASSLTSGDYNEQFF,0,5,1,5
TRBV19,TRBJ2-7,CASAVGHGGSYEQYF,0,3,1,3
TRBV3-1,TRBJ2-1,CASSQERSNKQFF,0,3,1,3
TRBV29-1,TRBJ1-2,CSVVAGGDYGYTF,0,1,1,1
TRBV19,TRBJ1-1,CASSMGNTEAFF,0,2,1,2
TRBV28,TRBJ2-7,CASIPGQGKTYEQYF,0,2,1,2
TRBV19,TRBJ2-1,CASRKNSGNEQFF,0,2,1,2
TRBV2,TRBJ2-1,CASSEDRGSGLAVINEQFF,0,1,1,1
TRBV2,TRBJ1-2,CASRDGQGAGSNYGYTF,0,1,1,1
TRBV18,TRBJ2-6,CASSPPWDSGANVLTF,0,1,1,1
TRBV9,TRBJ2-1,CASDRGNFNNEQFF,0,1,1,1
TRBV20-1,TRBJ2-1,CSATTSWRPHEQFF,0,1,1,1
TRBV20-1,TRBJ2-1,CSATTWQGGEQFF,0,5,1,5
TRBV29-1,TRBJ2-1,CSVDEGRVGFF,0,4,1,4
TRBV3-1,TRBJ1-1,CASSGYGNTEAFF,0,1,1,1
TRBV11-2,TRBJ2-2,CASSQGPGELFF,0,1,1,1
TRBV3-1,TRBJ1-5,CASSQASGNQPQHF,0,4,1,4
TRBV18,TRBJ2-6,CASSRSGPTPISGANVLTF,0,2,1,2
TRBV20-1,TRBJ2-3,CSAGLAGGSTDTQYF,0,2,1,2
TRBV29-1,TRBJ2-5,CSVVRTTQETQYF,0,1,1,1
TRBV19,TRBJ2-1,CASSSSGGGFSSYNEQFF,0,1,1,1
TRBV14,TRBJ2-2,CASSLGTGASRRELFF,0,1,1,1
TRBV20-1,TRBJ2-3,CSARDPVAGDPDTQYF,0,3,1,3
TRBV6-1,TRBJ2-3,CASSESAGAPDTQYF,0,2,1,2
TRBV19,TRBJ2-7,CASSIGEGFYEQYF,0,1,1,1
TRBV3-1,TRBJ2-4,CASSQDVTKNIQYF,0,2,1,2
TRBV30,TRBJ1-2,CAWAPGGPYGYTF,0,2,1,2
TRBV7-2,TRBJ1-6,CASSLDRNSPLHF,0,1,1,1
TRBV7-2,TRBJ2-3,CASSLVGRRTSSTDTQYF,0,3,1,3
TRBV20-1,TRBJ2-5,CSATTGTSGGHQETQYF,0,1,1,1
TRBV19,TRBJ1-1,CASKSQGLVTEAFF,0,2,1,2
TRBV2,TRBJ2-3,CASSEGGGDTQYF,0,2,1,2
TRBV2,TRBJ2-7,CASSRGEQYF,0,1,1,1
TRBV19,TRBJ2-1,CASSIPWGSPSGRLQFF,0,1,1,1
TRBV20-1,TRBJ2-3,CSARPSGLAGFTDTQYF,0,1,1,1
TRBV5-1,TRBJ2-5,CASSLGRTQETQYL,0,3,1,3
TRBV14,TRBJ2-6,CASSQFVQGAGGANVLTF,0,1,1,1
TRBV11-3,TRBJ2-1,CASSSRGTSGRDEQFF,0,1,1,1
TRBV12-3/4,TRBJ2-3,CASSFFASATDTQYF,0,1,1,1
TRBV5-4,TRBJ2-7,CASSLDSPASYEQYF,0,1,1,1
TRBV12-3/4,TRBJ2-7,CASSSGLAGVYEQYF,0,1,1,1
TRBV5-6,TRBJ2-3,CASSPTRGFTDTQYF,0,1,1,1
TRBV12-3/4,TRBJ1-4,CASTTGVTNEKLFF,0,1,1,1
TRBV2,TRBJ2-7,CASSAGWGGSGEYF,0,1,1,1
TRBV6-1,TRBJ2-4,CASSEQAKNIQYF,0,2,1,2
TRBV7-2,TRBJ2-7,CASSLGHRTEQYF,0,2,1,2
TRBV29-1,TRBJ2-7,CSVEDGQDYEQYF,0,2,1,2
TRBV12-3/4,TRBJ1-1,CASTLRNTEAFF,0,1,1,1
TRBV30,TRBJ1-2,CAWEGEGQAF,0,1,1,1
TRBV20-1,TRBJ2-1,CSASGELAGVLSYEQFF,0,2,1,2
TRBV12-3/4,TRBJ2-7,CASSFQRNYEQYF,0,1,1,1
TRBV20-1,TRBJ2-3,CSARDRSGVSADTQYF,0,2,1,2
TRBV19,TRBJ2-6,CASSSGNSGANVLTF,0,2,1,2
TRBV12-3/4,TRBJ2-3,CASSLGRMRDTQYF,0,1,1,1
TRBV19,TRBJ2-1,CASKSPYGSLSDNEQFF,0,1,1,1
TRBV3-1,TRBJ2-1,CASSQQGQYHNEQFF,0,3,1,3
TRBV11-2,TRBJ2-7,CASSLQRALLPNSYEQYF,0,2,1,2
TRBV6-2/3/5/6,TRBJ2-1,CASSYSKTWGAFEQFF,0,1,1,1
TRBV19,TRBJ2-2,CASGPGTGNTGELFF,0,1,1,1
TRBV6-2/3/5/6,TRBJ1-6,CASSLGGLLNSPLHF,0,1,1,1
TRBV5-1,TRBJ1-4,CASSLGSPTNEKLFF,0,1,1,1
TRBV5-1,TRBJ2-1,CASSPGTTSYNEQFF,0,1,1,1
TRBV29-1,TRBJ2-1,CSVALGGGRINEQFF,0,1,1,1
TRBV18,TRBJ2-3,CASSPWDREDTQYF,0,1,1,1
TRBV7-9,TRBJ2-2,CASSIQDTGELFF,0,1,1,1
TRBV28,TRBJ2-4,CASNMGAKNIQYF,0,1,1,1
TRBV12-3/4,TRBJ2-1,CASSSSANEQFF,0,2,1,2
TRBV3-1,TRBJ1-3,CASSPQLSSSGNTIYF,0,1,1,1
TRBV12-3/4,TRBJ2-4,CASSFRLMAKNIQYF,0,1,1,1
TRBV6-2/3/5/6,TRBJ2-3,CASSYRREADTQYF,0,3,1,3
TRBV11-3,TRBJ2-1,CASSLAPNEQFF,0,1,1,1
TRBV5-4,TRBJ2-2,CASSFLGVRTELFF,0,1,1,1
TRBV20-1,TRBJ2-7,CSASTTLREGYEQYF,0,2,1,2
TRBV6-2/3/5/6,TRBJ2-7,CASSYGGSSYEQYF,0,2,1,2
TRBV24-1,TRBJ1-3,CATSDAGGTIYF,0,1,1,1
TRBV7-9,TRBJ2-2,CASSDRTGGPNTGELFF,0,1,1,1
TRBV28,TRBJ2-6,CASSHWGQGANVLTF,0,1,1,1
TRBV19,TRBJ1-5,CASSIQGTDQPQHF,0,2,1,2
TRBV5-5,TRBJ2-3,CASLGLAGTTDTQYF,0,3,1,3
TRBV6-2/3/5/6,TRBJ2-1,CASSYSPSGSSYNEQFF,0,1,1,1
TRBV19,TRBJ2-6,CASSIAGQAYSGANVLTF,0,1,1,1
TRBV12-3/4,TRBJ1-6,CASASLLGRSSYNSPLHF,0,2,1,2
TRBV18,TRBJ1-3,CASSPFSVGAGRNTIYF,0,1,1,1
TRBV5-1,TRBJ2-5,CASSFQATSGVQTQYF,0,1,1,1
TRBV5-1,TRBJ2-7,CASSLSGGTRSDEQYF,0,1,1,1
TRBV20-1,TRBJ2-3,CSAGHVTGRETDTQYF,0,1,1,1
TRBV29-1,TRBJ2-3,CSVATSGTSMPDTQYF,0,1,1,1
TRBV5-6,TRBJ2-7,CASGGPGQGYSEQYF,0,1,1,1
TRBV12-3/4,TRBJ2-5,CASRTSGRASETQYF,0,1,1,1
TRBV3-1,TRBJ2-2,CASRQDVQNGELFF,0,2,1,2
TRBV6-1,TRBJ1-2,CASSEALQGQGYTF,0,2,1,2
TRBV20-1,TRBJ2-3,CSASLRTSTDTQYF,0,1,1,1
TRBV29-1,TRBJ2-7,CSVASRDPPYEQYF,0,1,1,1
TRBV29-1,TRBJ2-3,CSVDRPQGTDTQYF,0,4,1,4
TRBV12-5,TRBJ2-4,CASGLVSSGPQYF,0,3,1,3
TRBV12-5,TRBJ1-5,CASGLVGGQPQHF,0,1,1,1
TRBV12-3/4,TRBJ1-5,CASSSAVNQPQHF,0,1,1,1
TRBV12-3/4,TRBJ1-2,CASSPKTGYGYTF,0,1,1,1
TRBV7-2,TRBJ2-3,CASSPHSTDTQYF,0,1,1,1
TRBV12-3/4,TRBJ2-7,CASSLGREQYF,0,1,1,1
TRBV18,TRBJ2-3,CASSPRATSTDTQYF,0,2,1,2
TRBV20-1,TRBJ2-4,CSARSAGAEAGIQYF,0,1,1,1
TRBV27,TRBJ2-6,CASSPLGTGAAPGANVLTF,0,3,1,3
TRBV11-2,TRBJ1-2,CASSLKFGTGAWFNGYTF,0,3,1,3
TRBV28,TRBJ1-5,RASSSGGALSSNQPQHF,0,1,1,1
TRBV5-1,TRBJ1-5,CASSLGQGWSNQPQHF,0,2,1,2
TRBV5-1,TRBJ2-3,CASSPGTSGYTDTQYF,0,2,1,2
TRBV4-1,TRBJ2-1,CASSQGPSGRYNEQFF,0,2,1,2
TRBV19,TRBJ2-3,CASSSSGTLTDTQYF,0,1,1,1
TRBV12-3/4,TRBJ1-4,CASSFFAVEGGKLFF,0,1,1,1
TRBV6-2/3/5/6,TRBJ1-5,CASSLGTGPGQPQHF,0,1,1,1
TRBV7-2,TRBJ2-3,CASSFRGQSTDTQYF,0,2,1,2
TRBV3-1,TRBJ2-1,CASSQAGGPHNEQFF,0,1,1,1
TRBV20-1,TRBJ2-3,CSASEGEGGTDTQYF,0,1,1,1
TRBV7-2,TRBJ2-4,CASSRGTSANIQYF,0,1,1,1
TRBV5-1,TRBJ2-1,CASSLGRGHNEQFF,0,2,1,2
TRBV20-1,TRBJ2-5,CSAPLILGGETQYF,0,1,1,1
TRBV20-1,TRBJ1-1,CSARGGHSNTEAFF,0,1,1,1
TRBV29-1,TRBJ1-5,CSVSGTGGNQPQHF,0,2,1,2
TRBV18,TRBJ1-5,CASSPAGNQPQHF,0,1,1,1
TRBV13,TRBJ2-1,CASSLGRGDEQFF,0,2,1,2
TRBV7-9,TRBJ1-6,CASSVRGGLPLHF,0,1,1,1
TRBV5-1,TRBJ2-1,CASSWTSGNEQFF,0,1,1,1
TRBV5-1,TRBJ2-7,CASSIGQTYEQYF,0,1,1,1
TRBV20-1,TRBJ1-3,CSARSQVGNTIYF,0,2,1,2
TRBV29-1,TRBJ2-5,CSVGGQHQETQYF,0,1,1,1
TRBV29-1,TRBJ2-1,CSVEGTGSDEQFF,0,1,1,1
TRBV29-1,TRBJ2-7,CSVTRDLTYEQYF,0,2,1,2
TRBV14,TRBJ2-7,CATLGGSEQYF,0,1,1,1
TRBV20-1,TRBJ2-5,CSVQAGETQYF,0,1,1,1
TRBV12-3/4,TRBJ2-4,CASSRTGSLAKNIQYF,0,1,1,1
TRBV29-1,TRBJ2-7,CSAKLRWGASYEQYF,0,3,1,3
TRBV11-2,TRBJ1-2,CASNIQGGTYGYTF,0,1,1,1
TRBV12-3/4,TRBJ1-2,CASSLLGFGYTF,0,1,1,1
TRBV9,TRBJ2-3,CASSERTGGPGDTQYF,0,1,1,1
TRBV24-1,TRBJ2-3,CATSDERDSTDTQYF,0,2,1,2
TRBV5-1,TRBJ2-2,CASSLNQADTGELFF,0,1,1,1
TRBV30,TRBJ2-3,CAWRQASTDTQYF,0,1,1,1
TRBV20-1,TRBJ2-1,CSARVGSSYNEQFF,0,2,1,2
TRBV12-3/4,TRBJ2-2,CASSSWGTGELFF,0,1,1,1
TRBV28,TRBJ2-3,CASSRSGSWTFTGNTDTQYF,0,1,1,1
TRBV3-1,TRBJ2-7,CASSQGRPSGTTSYEQYF,0,1,1,1
TRBV3-1,TRBJ1-3,CASSQVGTGTAGNTIYF,0,1,1,1
TRBV6-1,TRBJ1-1,CASSEETGTTYTEAFF,0,3,1,3
TRBV13,TRBJ2-1,CASSLGTLGYGNEQFF,0,4,1,4
TRBV18,TRBJ1-5,CASSLSYTSNQPQHF,0,1,1,1
TRBV5-4,TRBJ2-1,CASRGTSGSLNEQFF,0,1,1,1
TRBV6-1,TRBJ2-1,CASREEGSGMNEQFF,0,1,1,1
TRBV5-1,TRBJ1-1,CASSGGDRVGTEAFF,0,1,1,1
TRBV12-5,TRBJ2-5,CASGPGQGKETQYF,0,1,1,1
TRBV18,TRBJ2-5,CASSPPGSSETQYF,0,2,1,2
TRBV5-5,TRBJ2-7,CASSSPGRGYEQYF,0,1,1,1
TRBV3-1,TRBJ2-7,CASSQDGGSRMQYF,0,1,1,1
TRBV2,TRBJ2-5,CASRGTGLQETQYF,0,2,1,2
TRBV28,TRBJ2-7,CASNRASGSYEQYF,0,1,1,1
TRBV5-1,TRBJ2-2,CASREPARGGELFF,0,1,1,1
TRBV20-1,TRBJ2-1,CSASSPGAYNEQFF,0,1,1,1
TRBV20-1,TRBJ1-1,CSARPGPMNTEAFF,0,1,1,1
TRBV19,TRBJ1-1,CASSTQPNTEAFF,0,1,1,1
TRBV18,TRBJ2-1,CASSPPASNEQFF,0,1,1,1
TRBV18,TRBJ1-1,CASSTGANTEAFF,0,1,1,1
TRBV25-1,TRBJ1-2,CASSESANYGYTF,0,1,1,1
TRBV2,TRBJ2-1,CASSEALRTEQFF,0,1,1,1
TRBV11-2,TRBJ2-1,CASSLGAGSEQFF,0,1,1,1
TRBV7-3,TRBJ2-6,CASSSSGANVLTF,0,2,1,2
TRBV3-1,TRBJ2-5,CASSRWGGETQYF,0,1,1,1
TRBV14,TRBJ2-1,CASSQARQTRSFF,0,1,1,1
TRBV29-1,TRBJ2-1,CSVESGLRVDQFF,0,2,1,2
TRBV9,TRBJ2-1,CASSVGGNEQFF,0,2,1,2
TRBV5-4,TRBJ2-1,CASSTEDNEQFF,0,1,1,1
TRBV5-1,TRBJ2-1,CASSLGGDEQFF,0,1,1,1
TRBV20-1,TRBJ2-7,CSADDPSYEQYF,0,1,1,1
TRBV2,TRBJ2-1,CASRQGGQFF,0,1,1,1
TRBV11-2,TRBJ2-3,CASSLGRPNTQYF,0,1,1,1
TRBV12-3/4,TRBJ2-1,CACNLGRSYNEQFF,0,1,1,1
TRBV20-1,TRBJ2-3,CSAEGGGVDTQYF,0,1,1,1
TRBV24-1,TRBJ2-5,CATSDPGGGEETQYF,0,1,1,1
TRBV5-5,TRBJ1-1,CASSLVQSNTEAFF,0,2,1,2
TRBV20-1,TRBJ1-6,CSATGQIQGSPLHF,0,1,1,1
TRBV20-1,TRBJ1-1,CSGGSVRAKNTEAFF,0,1,1,1
TRBV11-2,TRBJ2-3,CASSLAVFPDTQYF,0,2,1,2
TRBV4-2,TRBJ2-1,CASSQVVLTGDGYEQFF,0,2,1,2
TRBV5-1,TRBJ2-1,CASSLEGGVSYNEQFF,0,1,1,1
TRBV12-3/4,TRBJ2-3,CASSLGFTDTQYF,0,1,1,1
TRBV10-1,TRBJ2-7,CASSGDKDEQYF,0,1,1,1
TRBV20-1,TRBJ2-5,CSAPGDTLQETQYF,0,1,1,1
TRBV19,TRBJ2-1,CASSPIGWGSSYNEQFF,0,1,1,1
TRBV6-4,TRBJ2-1,CASSTINRGARFSEQFF,0,1,1,1
TRBV27,TRBJ1-5,CASSFSSTGSNQPQHF,0,1,1,1
TRBV11-2,TRBJ2-1,CASSLSRGSSYNEQFF,0,1,1,1
TRBV7-6,TRBJ2-1,CASSPWTSGRGNEQFF,0,1,1,1
TRBV3-1,TRBJ2-2,CASSRRDWGTTGELFF,0,1,1,1
TRBV19,TRBJ2-1,CASISSGRADNEQFF,0,2,1,2
TRBV12-3/4,TRBJ2-1,CASSFLAGGPGEQFF,0,2,1,2
TRBV12-3/4,TRBJ2-1,CASSSPTDRGDEQFF,0,1,1,1
TRBV6-2/3/5/6,TRBJ1-5,CASSSEGLESQPQHF,0,1,1,1
TRBV2,TRBJ2-7,CASSENRDRGYEQYF,0,2,1,2
TRBV11-2,TRBJ2-7,CASSLVGGVSSEQYF,0,1,1,1
TRBV7-2,TRBJ2-3,CASSLASYSTDTQYF,0,1,1,1
TRBV3-1,TRBJ2-2,CASSPFSGAAGELFF,0,1,1,1
TRBV27,TRBJ1-2,CASSHTGGSNYGYTF,0,1,1,1
TRBV5-1,TRBJ2-2,CASSLAGLNTGELFF,0,1,1,1
TRBV5-1,TRBJ2-6,CASRVQGSGANVLTF,0,1,1,1
TRBV20-1,TRBJ2-5,CSARPGLAGVQTQYF,0,2,1,2
TRBV20-1,TRBJ2-5,CSARPGGGGSETQYF,0,1,1,1
TRBV29-1,TRBJ2-3,CSVGGRAPSTDTQYF,0,1,1,1
TRBV29-1,TRBJ2-1,CSAKVRLGAYNEQFF,0,1,1,1
TRBV19,TRBJ1-1,CASSVGGMNTEAFF,0,2,1,2
TRBV18,TRBJ1-1,CASSERTGGTEAFF,0,1,1,1
TRBV28,TRBJ2-3,CASGKREVTDTQYF,0,2,1,2
TRBV2,TRBJ2-5,CASSEIRVRETQYF,0,1,1,1
TRBV3-1,TRBJ2-7,CASSQTARGYEQYF,0,2,1,2
TRBV5-6,TRBJ2-7,CASNPGLGAYEQYF,0,1,1,1
TRBV5-1,TRBJ2-1,CASQAGGPYNEQFF,0,1,1,1
TRBV5-1,TRBJ1-2,CASSVAGQGIGYTF,0,1,1,1
TRBV29-1,TRBJ2-4,CSVGLAVGRDIQYF,0,1,1,1
TRBV29-1,TRBJ2-5,CSVEAPTGGETQYF,0,1,1,1
TRBV29-1,TRBJ2-3,CSASAGELADTQYF,0,1,1,1
TRBV10-3,TRBJ1-5,CAIQADSNQPQHF,0,1,1,1
TRBV19,TRBJ1-1,CASSRGSYTEAFF,0,1,1,1
TRBV12-3/4,TRBJ2-1,CASSLTSYNEQFF,0,1,1,1
TRBV6-1,TRBJ2-1,CASSVEGYNEQFF,0,1,1,1
TRBV2,TRBJ1-1,CASSESPDRVAFF,0,1,1,1
TRBV7-6,TRBJ2-7,CASSLGGSGEQYF,0,1,1,1
TRBV5-4,TRBJ2-3,CASSLVGSDTQYF,0,1,1,1
TRBV7-9,TRBJ1-1,CASSGTENTEAFF,0,1,1,1
TRBV5-1,TRBJ2-1,CASSPQGYNEQFF,0,1,1,1
TRBV20-1,TRBJ2-5,CSAWDSSSETQYF,0,1,1,1
TRBV7-9,TRBJ2-7,CATGDPAYEQYF,0,1,1,1
TRBV28,TRBJ2-1,CASSSRNNEQFF,0,1,1,1
TRBV5-1,TRBJ2-1,CASRRGNEQFF,0,1,1,1
TRBV29-1,TRBJ2-1,CSARVYNEQFF,0,1,1,1
TRBV29-1,TRBJ1-1,CSVEKGGAFF,0,1,1,1
TRBV19,TRBJ1-4,CASSRTGGHPNEKLFF,0,1,1,1
TRBV12-3/4,TRBJ2-7,CASSFFGGYEQYF,0,1,1,1
TRBV2,TRBJ2-3,CASNDISTDTQYF,0,1,1,1
TRBV7-3,TRBJ2-1,CASSPPGGEQFF,0,1,1,1
TRBV6-2/3/5/6,TRBJ1-5,CASSPGGLSFPHQPQHF,0,1,1,1
TRBV30,TRBJ1-2,CAWSRPPRSYGYTF,0,1,1,1
TRBV7-2,TRBJ1-2,CASSPSFYPGGYTF,0,1,1,1
TRBV6-2/3/5/6,TRBJ2-1,CASRYKEPYNEQFF,0,2,1,2
TRBV7-2,TRBJ2-3,CASSLKLAGGGDTQYF,0,1,1,1
TRBV29-1,TRBJ2-1,CSVPPGGTGGYNEQFF,0,1,1,1
TRBV7-3,TRBJ2-3,CASSPSGTSGATQYF,0,1,1,1
TRBV5-1,TRBJ2-3,CASSRRVSTDTQYF,0,4,1,4
TRBV29-1,TRBJ1-1,CSVRPTGLNTEAFF,0,1,1,1
TRBV5-6,TRBJ2-7,CASRPGGRSEQYF,0,1,1,1
TRBV19,TRBJ2-3,CASSIGWTGGDFKSTDTQYF,0,2,1,2
TRBV12-3/4,TRBJ2-2,CASSRQAGTSSTGELFF,0,1,1,1
TRBV20-1,TRBJ2-1,CSAQGLAGERGGGEQFF,0,1,1,1
TRBV20-1,TRBJ2-2,CSARSFRSGANTGELFF,0,1,1,1
TRBV20-1,TRBJ2-3,CSATRGSGSGRTDTQYF,0,1,1,1
TRBV28,TRBJ2-1,CASSLPPGLAGLEQFF,0,1,1,1
TRBV28,TRBJ2-1,CASSLGGLATYNEQFF,0,2,1,2
TRBV3-1,TRBJ2-5,CASSQSGTGEWETQYF,0,1,1,1
TRBV3-1,TRBJ2-4,CASSQGWVLAKNIQYF,0,1,1,1
TRBV5-1,TRBJ2-3,CASSLRGTSGAYTQYF,0,1,1,1
TRBV5-1,TRBJ2-1,CASSLEGQGSYNEQFF,0,1,1,1
TRBV20-1,TRBJ2-5,CSARDKEGDHQETQYF,0,1,1,1
TRBV19,TRBJ2-1,CASSSGTGEIHEQFF,0,1,1,1
TRBV28,TRBJ2-1,CASSPLAGLSHEQFF,0,1,1,1
TRBV2,TRBJ2-3,CASSRGTAATDTQYF,0,2,1,2
TRBV5-6,TRBJ2-4,CASSSSTPPRNIQYF,0,2,1,2
TRBV3-1,TRBJ2-3,CASSPSGSDTDTQYF,0,1,1,1
TRBV3-1,TRBJ1-5,CASSQGPGYDQPQHF,0,1,1,1
TRBV4-2,TRBJ1-1,CASSQGDRGRTEAFF,0,1,1,1
TRBV4-1,TRBJ2-7,CASSQGRAYSYEQYF,0,1,1,1
TRBV28,TRBJ2-7,CASSLYRGSYEQYF,0,1,1,1
TRBV6-2/3/5/6,TRBJ2-7,CASSYSVSSYEQYF,0,2,1,2
TRBV6-2/3/5/6,TRBJ1-2,CASSYSGGKYGYTF,0,1,1,1
TRBV6-2/3/5/6,TRBJ2-1,CASSYGGRYNEQFF,0,2,1,2
TRBV12-3/4,TRBJ2-5,CASSPRGLDGDQYF,0,1,1,1
TRBV5-6,TRBJ1-2,CASSLRPGTYGYTF,0,1,1,1
TRBV5-1,TRBJ2-7,CASSFASDSYEQYF,0,2,1,2
TRBV5-1,TRBJ2-7,CASSSADSSYEQYF,0,1,1,1
TRBV20-1,TRBJ1-1,CSAPHPGSNTEAFF,0,1,1,1
TRBV29-1,TRBJ1-1,CSVEQGARNTEAFF,0,1,1,1
TRBV29-1,TRBJ2-3,CSVEVGRGGDTQYF,0,1,1,1
TRBV30,TRBJ1-5,CAWSRQGPQPQHF,0,1,1,1
TRBV19,TRBJ2-5,CASNSLFQETQYF,0,1,1,1
TRBV12-3/4,TRBJ1-1,CASSLGGATEAFF,0,1,1,1
TRBV7-9,TRBJ2-7,CASSLGSGYEQYF,0,1,1,1
TRBV7-8,TRBJ1-1,CASSLGGNTEAFF,0,2,1,2
TRBV11-1,TRBJ2-1,CASSLIGANEQFF,0,1,1,1
TRBV5-6,TRBJ2-1,CASSWDGSNEQFF,0,1,1,1
TRBV7-2,TRBJ2-3,CASSPRLKDTQYF,0,1,1,1
TRBV7-9,TRBJ2-3,CASSPKWADTQYF,0,3,1,3
TRBV10-1,TRBJ1-1,CASSESTGKGAFF,0,1,1,1
TRBV20-1,TRBJ2-1,CSAPLAGLNEQFF,0,1,1,1
TRBV29-1,TRBJ2-7,CSVAGTGMGEQYF,0,1,1,1
TRBV29-1,TRBJ2-1,CSVRTSGRDEQFF,0,1,1,1
TRBV19,TRBJ2-1,CASSPRRNEQFF,0,1,1,1
TRBV29-1,TRBJ2-7,CSVGEGQYEQYF,0,1,1,1
TRBV29-1,TRBJ1-4,CSATGGYEKLFF,0,1,1,1
TRBV19,TRBJ1-1,CASWQNTEAFF,0,2,1,2
TRBV2,TRBJ2-7,CASRGAYEQYF,0,1,1,1
TRBV20-1,TRBJ2-1,CSASGGNEQFF,0,1,1,1
TRBV29-1,TRBJ2-1,CSVVGNNEQFF,0,1,1,1
TRBV5-1,TRBJ2-2,CASSLRQLTNTGELFF,0,1,1,1
TRBV12-3/4,TRBJ2-6,CARVLAGSGANVLTF,0,1,1,1
TRBV12-3/4,TRBJ1-5,CASSLGPGPNQPQHF,0,3,1,3
TRBV5-4,TRBJ2-3,CASSLGPGYTDTQYF,0,1,1,1
TRBV29-1,TRBJ2-2,CSATGTASNTGELFF,0,1,1,1
TRBV12-3/4,TRBJ2-3,CASLRSPDDTQYF,0,1,1,1
TRBV20-1,TRBJ2-4,CSAMARQGNIQYF,0,3,1,3
TRBV6-2/3/5/6,TRBJ1-3,CASSYDGDTIYF,0,1,1,1
TRBV5-6,TRBJ2-5,CASSFSGGYFGQQETQYF,0,1,1,1
TRBV11-2,TRBJ2-7,CASSLPKTSGKSYEQYF,0,1,1,1
TRBV18,TRBJ1-1,CASSPPVGRGMTEAFF,0,1,1,1
TRBV18,TRBJ1-1,CASSPSTGGDTEAFF,0,3,1,3
TRBV11-2,TRBJ1-1,CASSLQLRLNTEAFF,0,1,1,1
TRBV5-4,TRBJ2-2,CASSRGQGAGELFF,0,1,1,1
TRBV27,TRBJ2-1,CASEGGGYNEQFF,0,1,1,1
TRBV12-3/4,TRBJ1-2,CASSFQGANYGYTF,0,1,1,1
TRBV19,TRBJ2-3,CASSGTSGTVDTQYF,0,1,1,1
TRBV5-1,TRBJ2-7,CASSYGTSGPYEQYF,0,3,1,3
TRBV2,TRBJ2-1,CASGLGQGNVQFF,0,1,1,1
TRBV3-1,TRBJ1-5,CASSSWIDQPQHL,0,1,1,1
TRBV20-1,TRBJ1-4,CSASKGSGEKLFF,0,1,1,1
TRBV19,TRBJ2-1,CASSTYPQRLSSYNEQFF,0,2,1,2
TRBV19,TRBJ1-5,CASSPQLGASNQPQHF,0,1,1,1
TRBV3-1,TRBJ1-1,CASSPRGAVDTEAFF,0,1,1,1
TRBV12-3/4,TRBJ1-5,CASTSSSNQPQHF,0,1,1,1
TRBV7-9,TRBJ1-6,CASKEAASPLHF,0,1,1,1
TRBV20-1,TRBJ2-1,CSARLPGQLEFF,0,1,1,1
TRBV18,TRBJ2-1,RASSPSSGAYNEQFF,0,1,1,1
TRBV3-1,TRBJ2-1,CASSQRLGLEANEQFF,0,1,1,1
TRBV20-1,TRBJ2-7,CSADGGVLRSSYEQYF,0,1,1,1
TRBV19,TRBJ2-7,CASSDSGRIDEQYF,0,1,1,1
TRBV7-2,TRBJ2-1,CASGSRSSYNEQFF,0,1,1,1
TRBV9,TRBJ2-1,CASSQSPRYNEQFF,0,1,1,1
TRBV5-1,TRBJ1-1,CASSRYMNTEAFF,0,2,1,2
TRBV25-1,TRBJ2-1,CASSGRGEQFF,0,1,1,1
TRBV20-1,TRBJ2-3,CSASGVDTQYF,0,2,1,2
TRBV5-6,TRBJ2-1,CASSFRTSGSKGYNEQFF,0,1,1,1
TRBV5-1,TRBJ2-3,CASSFRTGGGTDTQYF,0,1,1,1
TRBV19,TRBJ2-1,CASTDTGGSYNEQSF,0,1,1,1
TRBV7-2,TRBJ2-5,CASSLTLQGRETQYF,0,2,1,2
TRBV7-9,TRBJ1-1,CASSWSGTLNTEAFF,0,2,1,2
TRBV19,TRBJ2-1,WASSISWDPYNEQFF,0,1,1,1
TRBV5-6,TRBJ2-3,CASCYDGGGDTQYF,0,1,1,1
TRBV7-9,TRBJ2-3,CAGGRDARSDTQYF,0,1,1,1
TRBV5-1,TRBJ2-7,CASSPQTSSYEQYF,0,1,1,1
TRBV30,TRBJ1-5,CAWGRGLSNQPQHF,0,1,1,1
TRBV18,TRBJ2-2,CASSPSEDCGELFF,0,1,1,1
TRBV5-1,TRBJ1-1,CASSRPPAGSREFGFGNTEAFF,0,1,1,1
TRBV2,TRBJ2-3,CASTLWGWGASTDTQYF,0,1,1,1
TRBV2,TRBJ2-3,CASSPTSGGMTTDTQYF,0,1,1,1
TRBV29-1,TRBJ2-3,CSVEGGLAGGSTDTQYF,0,1,1,1
TRBV12-5,TRBJ1-6,CASGSTGSSYNSPLHF,0,1,1,1
TRBV19,TRBJ1-1,CASTSDSIVGNTEAFF,0,1,1,1
TRBV27,TRBJ1-3,CASSLTAGFSGNTIYF,0,1,1,1
TRBV5-5,TRBJ2-1,CASSFRLPSSYNEQFF,0,1,1,1
TRBV5-1,TRBJ2-7,CASSPRTSGGEHEQYF,0,2,1,2
TRBV20-1,TRBJ1-5,CSATRDKPNSNQPQHF,0,1,1,1
TRBV29-1,TRBJ2-2,CSVSGRSQGATGELFF,0,2,1,2
TRBV10-3,TRBJ2-5,CAISESAGEGETQYF,0,1,1,1
TRBV10-3,TRBJ2-7,CAISESGGEVDEQYF,0,1,1,1
TRBV24-1,TRBJ2-7,CATSDPRQASYEQYF,0,2,1,2
TRBV12-3/4,TRBJ2-7,CASSFRRTGVPQQYF,0,1,1,1
TRBV12-3/4,TRBJ1-5,CASSLGAVSNQPQHF,0,1,1,1
TRBV7-2,TRBJ2-1,CASSFDLQVLNEQFF,0,1,1,1
TRBV3-1,TRBJ2-1,CASSSRLAVVDEQFF,0,1,1,1
TRBV7-2,TRBJ2-1,CASSSGLASNNEQFF,0,1,1,1
TRBV7-4,TRBJ2-3,CASSRDGLSTDTQYF,0,2,1,2
TRBV3-1,TRBJ2-7,CASSHEATSPYEQYF,0,1,1,1
TRBV9,TRBJ2-5,CASSVGRGSQETQYF,0,1,1,1
TRBV6-2/3/5/6,TRBJ2-3,CASNRASGSTDTQYF,0,1,1,1
TRBV27,TRBJ1-3,CASKRQGTSGNTIYF,0,1,1,1
TRBV5-1,TRBJ2-7,CASSFAGTNAYEQYF,0,1,1,1
TRBV5-1,TRBJ1-1,CASSYIKPRGPEAFF,0,1,1,1
TRBV29-1,TRBJ2-3,CSVVGTSGITDTQYF,0,1,1,1
TRBV29-1,TRBJ2-2,CSVGSGPKNTGELFF,0,1,1,1
TRBV19,TRBJ2-7,CASSFKAGPYEQYF,0,1,1,1
TRBV19,TRBJ2-2,CASSALGGTGELFF,0,1,1,1
TRBV19,TRBJ1-1,CASSIEGTNTEAFF,0,1,1,1
TRBV27,TRBJ2-3,CASSLEDDTDTQYF,0,2,1,2
TRBV27,TRBJ2-5,CASSYRERKETQYF,0,1,1,1
TRBV12-3/4,TRBJ1-5,CASSGVTANQPQHF,0,1,1,1
TRBV7-2,TRBJ2-1,CASSFGGSVNEQFF,0,2,1,2
TRBV7-9,TRBJ2-5,CASSLVGGRETQYF,0,1,1,1
TRBV5-4,TRBJ1-1,CASSSPGTRIQAFF,0,2,1,2
TRBV3-1,TRBJ2-1,CASSLSGVANEQFF,0,2,1,2
TRBV3-1,TRBJ2-7,CASSPGSGAYEQYF,0,1,1,1
TRBV3-1,TRBJ2-2,CASSRLADTGELFF,0,1,1,1
TRBV7-9,TRBJ1-2,CASSTLDGLGGYTF,0,2,1,2
TRBV12-3/4,TRBJ2-1,CASKSGSIYNEQFF,0,1,1,1
TRBV20-1,TRBJ2-5,CSAIQHIDQETQYF,0,1,1,1
TRBV20-1,TRBJ2-3,CSARTGLATDTQYF,0,1,1,1
TRBV20-1,TRBJ2-3,CSARGAGYTDTQYF,0,1,1,1
TRBV20-1,TRBJ2-5,CSARDLGHKETQYF,0,1,1,1
TRBV20-1,TRBJ1-5,CSARDEEGNQPQHF,0,2,1,2
TRBV20-1,TRBJ2-2,CSARSPSNTGELFF,0,1,1,1
TRBV29-1,TRBJ2-3,CSVETRASTDTQYF,0,1,1,1
TRBV18,TRBJ1-1,CASSQTVSTEAFF,0,2,1,2
TRBV7-6,TRBJ2-2,CASGQGSTGELFF,0,2,1,2
TRBV28,TRBJ2-3,CASSSLMTDTQYF,0,1,1,1
TRBV12-3/4,TRBJ2-7,CASSPGLGDEQYF,0,1,1,1
TRBV2,TRBJ2-5,CASSATLEETQYF,0,1,1,1
TRBV5-5,TRBJ2-5,CASSLPGKETQYF,0,1,1,1
TRBV7-9,TRBJ1-4,CASSSGGGEKLFF,0,1,1,1
TRBV14,TRBJ2-7,CASSRGLAEEQYF,0,1,1,1
TRBV5-4,TRBJ2-7,CASSRDYLYEQYF,0,1,1,1
TRBV5-1,TRBJ1-1,CASSSQEGTEAFF,0,2,1,2
TRBV4-1,TRBJ2-4,CASSQGVSDIQYF,0,1,1,1
TRBV5-1,TRBJ2-3,CASSGRQGGTQYF,0,1,1,1
TRBV5-1,TRBJ2-3,CASRPPGYGTQYF,0,1,1,1
TRBV20-1,TRBJ2-3,CSASGLRTDTQYF,0,1,1,1
TRBV20-1,TRBJ2-7,CSARSRGGYEQYF,0,1,1,1
TRBV20-1,TRBJ2-5,CSATILARKTQYF,0,1,1,1
TRBV29-1,TRBJ2-7,CSVEDRAGYEQYF,0,1,1,1
TRBV29-1,TRBJ2-5,CSVTTSAQETQYF,0,1,1,1
TRBV6-2/3/5/6,TRBJ2-1,CASSRPYNEQFF,0,2,1,2
TRBV7-9,TRBJ2-1,CASSLVSGGHSF,0,1,1,1
TRBV7-2,TRBJ2-3,CASSSGVDTQYF,0,1,1,1
TRBV5-5,TRBJ2-1,CASSPKTLEQFF,0,1,1,1
TRBV5-4,TRBJ2-5,CASSTDEETQYF,0,1,1,1
TRBV7-2,TRBJ2-3,CASSEGTDTQYF,0,2,1,2
TRBV4-1,TRBJ2-5,CASSQEDGTQYF,0,1,1,1
TRBV29-1,TRBJ1-2,CSVERGYYGYTF,0,1,1,1
TRBV6-4,TRBJ2-3,CASSATSPGLAGTGTDTQYF,0,1,1,1
TRBV14,TRBJ1-4,CASSQEGEGIDATNEKLFF,0,1,1,1
TRBV18,TRBJ2-7,CASSPFQGDRVASYEQYF,0,1,1,1
TRBV28,TRBJ2-5,CASSLSPGLGTTEETQYF,0,1,1,1
TRBV13,TRBJ2-1,CASSFPSGIGFRDNEQFF,0,1,1,1
TRBV10-3,TRBJ2-4,CAISGDGRSGAKNIQYF,0,1,1,1
TRBV19,TRBJ2-4,CASSMEARSGLGNIQYF,0,1,1,1
TRBV19,TRBJ2-7,CASSTPGLAGVNHEQYF,0,2,1,2
TRBV2,TRBJ2-4,CASSDGTTAIAKNIQYF,0,1,1,1
TRBV4-1,TRBJ1-5,CASSQDPGVRRNQPQHF,0,1,1,1
TRBV20-1,TRBJ1-1,CSARDHSSGTVNTEAFF,0,2,1,2
TRBV30,TRBJ2-6,CAWTDRLYSGANVLTF,0,1,1,1
TRBV30,TRBJ2-3,CAWSAARAVRTDTQYF,0,1,1,1
TRBV19,TRBJ2-1,CASSLQTGGIGNEQFF,0,1,1,1
TRBV18,TRBJ1-1,CASSPPLQGMNTEAFF,0,1,1,1
TRBV12-3/4,TRBJ2-3,CASSPGLNPGTDTQYF,0,2,1,2
TRBV6-1,TRBJ2-1,CASSDQVAGEYNEQFF,0,1,1,1
TRBV5-4,TRBJ2-3,CASSLRAGRGTDTQYF,0,1,1,1
TRBV7-9,TRBJ2-2,CASSLLAGQNTGELFF,0,1,1,1
TRBV11-1,TRBJ2-1,CASSPLLAGSFGEQFF,0,1,1,1
TRBV3-1,TRBJ2-2,CASSQLRGVSTGELFF,0,1,1,1
TRBV3-1,TRBJ2-7,CASSQYPRRSVYEQYF,0,1,1,1
TRBV9,TRBJ2-3,CASSVAGGLSTDTQYF,0,1,1,1
TRBV2,TRBJ2-2,CASSEPQGADTGELFF,0,1,1,1
TRBV5-1,TRBJ2-7,CASSLRLPGRPLEQYF,0,2,1,2
TRBV20-1,TRBJ2-3,CSARASGSGWRDTQCF,0,1,1,1
TRBV20-1,TRBJ2-3,CSARDTQATSTDTQYF,0,2,1,2
TRBV19,TRBJ1-1,CASGIDEGWDTEAFF,0,1,1,1
TRBV7-9,TRBJ1-2,CASLATGAKDYGYTF,0,1,1,1
TRBV6-2/3/5/6,TRBJ2-7,CASTKTSGSSYEQYF,0,2,1,2
TRBV6-2/3/5/6,TRBJ1-1,CASSYGTPMNTEAFF,0,1,1,1
TRBV12-3/4,TRBJ2-3,CASSPRALGTDTQYF,0,1,1,1
TRBV6-2/3/5/6,TRBJ2-7,CASSRGGGTYYEQYF,0,2,1,2
TRBV6-2/3/5/6,TRBJ1-4,CASSSRLQRGEKLFF,0,2,1,2
TRBV3-1,TRBJ1-1,CASSLYGGPNTEAFF,0,1,1,1
TRBV5-6,TRBJ2-5,CASSLSAGARETQYF,0,1,1,1
TRBV11-2,TRBJ2-7,CASSLQEWTGREQYF,0,1,1,1
TRBV7-9,TRBJ2-5,CASSLVGGRSETQYF,0,1,1,1
TRBV7-9,TRBJ2-7,CASSSPFAGSYEQYF,0,1,1,1
TRBV7-2,TRBJ2-7,CASSSQGSVTYEQYF,0,1,1,1
TRBV5-4,TRBJ2-1,CASSPPAARGTGLFF,0,1,1,1
TRBV3-1,TRBJ2-1,CASSPEGLATNEQFF,0,1,1,1
TRBV3-1,TRBJ1-1,CASSQASGLLTEAFF,0,1,1,1
TRBV3-1,TRBJ2-7,CASSQELAGRGEQYF,0,1,1,1
TRBV7-9,TRBJ2-1,CASSRTGVGYNEQFF,0,1,1,1
TRBV12-3/4,TRBJ1-1,CASRPGVSMNTEAFF,0,1,1,1
TRBV2,TRBJ2-3,CASNEASGTMELQYF,0,1,1,1
TRBV10-2,TRBJ2-7,CASSEGHLKTYEQYF,0,1,1,1
TRBV5-1,TRBJ1-3,CASSLVAVPGNTIYF,0,1,1,1
TRBV5-1,TRBJ2-7,CASSLASGRTDEQYF,0,1,1,1
TRBV5-1,TRBJ2-1,CASSLLAGGGNEQFF,0,1,1,1
TRBV20-1,TRBJ2-1,CSAGGAGGLDNEQFF,0,1,1,1
TRBV20-1,TRBJ2-7,CSARDPSGPNYEQYF,0,1,1,1
TRBV20-1,TRBJ2-1,CSAEILQSSYNEQFF,0,1,1,1
TRBV29-1,TRBJ2-3,CSAGTSGIRTDTQYF,0,1,1,1
TRBV12-5,TRBJ1-5,CASGPGRSDQPQHF,0,2,1,2
TRBV12-5,TRBJ1-2,CASGDVRGANGYTF,0,1,1,1
TRBV30,TRBJ1-5,CASAYRGRNQPQHF,0,2,1,2
TRBV19,TRBJ2-7,CASSPWGLYYEQYF,0,1,1,1
TRBV18,TRBJ1-4,CASSPSGTVEKLFF,0,1,1,1
TRBV28,TRBJ2-1,CASMTPSSYNEQFF,0,1,1,1
TRBV7-2,TRBJ2-3,CASTPELAGDTQYF,0,1,1,1
TRBV2,TRBJ1-4,CASTTGGNNEKLFF,0,1,1,1
TRBV6-4,TRBJ2-3,CASSLTPVGDTQYF,0,1,1,1
TRBV12-3/4,TRBJ1-6,CASSLALGRSPLHF,0,1,1,1
TRBV5-4,TRBJ2-1,CASSLAGVNNEQFF,0,1,1,1
TRBV7-9,TRBJ2-7,CASSLIGDTYEQYF,0,1,1,1
TRBV5-4,TRBJ2-3,CASSLGQSTDTQYF,0,2,1,2
TRBV11-2,TRBJ2-5,CASSPRRAQETQYF,0,1,1,1
TRBV7-6,TRBJ2-1,CASSPRAKYNEQFF,0,3,1,3
TRBV28,TRBJ2-2,CASSRGTPTGELFF,0,2,1,2
TRBV3-1,TRBJ2-1,CASSHRQGWNEEFF,0,1,1,1
TRBV3-1,TRBJ2-3,CASSQVGTTDTQYF,0,1,1,1
TRBV12-3/4,TRBJ1-1,CASSARTFNTEAFF,0,2,1,2
TRBV5-6,TRBJ2-7,CASSTGTSGYEQYF,0,1,1,1
TRBV12-3/4,TRBJ2-3,CASRALGATDTQYF,0,1,1,1
TRBV16,TRBJ2-1,CASRRTSGYNEQFF,0,1,1,1
TRBV11-1,TRBJ2-1,CASKGTLSYNEQFF,0,1,1,1
TRBV5-1,TRBJ2-3,CASTEGGFGDTQYF,0,1,1,1
TRBV5-1,TRBJ1-1,CASSLGPGRAGTFF,0,1,1,1
TRBV20-1,TRBJ2-7,CSVPKAGVTYEQYF,0,1,1,1
TRBV20-1,TRBJ1-1,CSASALTVWTEAFF,0,1,1,1
TRBV20-1,TRBJ2-7,CSARRGTGGYEQYF,0,1,1,1
TRBV20-1,TRBJ2-1,CSAYSGRENNEQFF,0,1,1,1
TRBV29-1,TRBJ2-3,CSVLPGPSTDTQYF,0,1,1,1
TRBV29-1,TRBJ2-7,CSVSQGNSLYEQYF,0,1,1,1
TRBV12-5,TRBJ2-1,CASGLAGTRKQFF,0,1,1,1
TRBV19,TRBJ1-5,CATALYSNQPQHF,0,1,1,1
TRBV19,TRBJ1-1,CASSATLGQEAFF,0,1,1,1
TRBV7-3,TRBJ1-1,CASRQDLNTEAFF,0,1,1,1
TRBV28,TRBJ2-7,CASIGTFSYEQYF,0,1,1,1
TRBV7-2,TRBJ2-7,CASTVRGPGEQYF,0,1,1,1
TRBV12-3/4,TRBJ2-5,CASSLMVQETQYF,0,2,1,2
TRBV6-2/3/5/6,TRBJ2-1,CASSLIQGNEQFF,0,2,1,2
TRBV6-1,TRBJ2-1,CASSEVGDSHQFF,0,2,1,2
TRBV5-5,TRBJ1-1,CASSLEPGLGAFF,0,1,1,1
TRBV2,TRBJ2-3,CASSRGSGDTQYF,0,1,1,1
TRBV3-1,TRBJ2-3,CASSQRDRVTQYF,0,1,1,1
TRBV5-4,TRBJ2-5,CASSAERERVQYF,0,1,1,1
TRBV6-2/3/5/6,TRBJ1-2,CASRLTENYGYTF,0,1,1,1
TRBV5-1,TRBJ2-7,CASSFWGSYEQYF,0,1,1,1
TRBV5-1,TRBJ2-1,CASSLGTYNEQFF,0,2,1,2
TRBV5-1,TRBJ2-4,CASSLDILNIQYF,0,1,1,1
TRBV5-1,TRBJ1-1,CASSSGSNTEAFF,0,1,1,1
TRBV5-1,TRBJ2-1,CASSSGQTNEQFF,0,1,1,1
TRBV5-1,TRBJ1-1,CASSYTGDTEAFF,0,1,1,1
TRBV20-1,TRBJ2-1,CSAETGAYNEQFF,0,1,1,1
TRBV6-1,TRBJ1-5,RASRKDSNQPQHF,0,1,1,1
TRBV10-3,TRBJ2-7,CADGNGGCEQYF,0,1,1,1
TRBV10-3,TRBJ2-1,CAITPGATEQFF,0,1,1,1
TRBV6-2/3/5/6,TRBJ1-1,CASSLHSGEAFF,0,1,1,1
TRBV12-3/4,TRBJ2-1,CASSYANNEQFF,0,1,1,1
TRBV5-6,TRBJ2-7,CASSLGSYEQYF,0,1,1,1
TRBV5-6,TRBJ2-5,CASSRIEETQYF,0,1,1,1
TRBV12-3/4,TRBJ2-3,CASRQGTSAQYF,0,2,1,2
TRBV5-1,TRBJ2-1,CASSLASDEQFF,0,1,1,1
TRBV10-2,TRBJ1-1,CASRFPDTEAFF,0,1,1,1
TRBV29-1,TRBJ2-5,CSVEPSQETQYF,0,1,1,1
TRBV10-3,TRBJ1-1,CAIRKTDEAFF,0,1,1,1
TRBV12-3/4,TRBJ2-1,CASSSLYEQFF,0,2,1,2
TRBV13,TRBJ2-1,CASSLYDEQFF,0,1,1,1
TRBV29-1,TRBJ2-7,CSVLTQGFFVF,0,1,1,1
TRBV7-9,TRBJ2-1,CAWDGNEQFF,0,1,1,1
TRBV2,TRBJ2-5,CATTLMDQYF,0,3,1,3
TRBV20-1,TRBJ2-5,CSASWETQYF,0,1,1,1
TRBV29-1,TRBJ2-1,CAADEQFF,0,1,1,1
TRBV20-1,TRBJ1-1,CTEEVRNQGGTMNTEAFF,0,1,1,1
TRBV11-2,TRBJ2-5,CASSFGTTSREGTQYF,0,1,1,1
TRBV19,TRBJ2-6,CASSPTGSGANVLTF,0,1,1,1
TRBV20-1,TRBJ1-1,CSARGNYRVGEAFF,0,1,1,1
TRBV20-1,TRBJ2-7,CSAREYSSFYEQYF,0,1,1,1
TRBV12-3/4,TRBJ1-2,CASSLTSGYGYTF,0,2,1,2
TRBV3-1,TRBJ2-7,CASSLGSHYEQYF,0,1,1,1
TRBV11-2,TRBJ1-2,CASTHRRTGITF,0,1,1,1
TRBV20-1,TRBJ2-1,CSAITGLAGGPWGEQFF,0,2,1,2
TRBV3-1,TRBJ2-3,CASSQGGGQGPDTQYF,0,1,1,1
TRBV5-6,TRBJ2-1,CASSLSLAGLYEQFF,0,1,1,1
TRBV5-1,TRBJ2-1,CASSFSQGSYNEQFF,0,1,1,1
TRBV5-1,TRBJ2-1,CASSSGLAVYNEQFF,0,2,1,2
TRBV18,TRBJ2-4,CASSPVREKNIQYF,0,1,1,1
TRBV18,TRBJ2-3,CASSRPAATDTQYF,0,1,1,1
TRBV28,TRBJ2-7,CASSPYRETYEQYF,0,1,1,1
TRBV5-1,TRBJ2-7,CASSLGDESRDPYF,0,1,1,1
TRBV28,TRBJ2-7,CASTTGDRYEQHF,0,1,1,1
TRBV7-9,TRBJ1-2,CASSFGGSGGYTF,0,1,1,1
TRBV7-2,TRBJ2-1,CASSLTVGDEQFF,0,2,1,2
TRBV19,TRBJ1-2,CASSTGPYGYTF,0,2,1,2
TRBV7-9,TRBJ1-1,CASSLESTEAFF,0,1,1,1
TRBV19,TRBJ2-2,CASSMTLAGGTGELFF,0,1,1,1
TRBV6-1,TRBJ2-3,CASSEDGASATDTQYF,0,1,1,1
TRBV19,TRBJ2-1,CASSAYVGSYNEQFF,0,1,1,1
TRBV18,TRBJ1-1,CASSPGRNGGTEAFF,0,1,1,1
TRBV6-2/3/5/6,TRBJ2-1,CASSYGGPAYNEQFF,0,1,1,1
TRBV2,TRBJ2-7,CASSLDRTGVHEQYF,0,1,1,1
TRBV5-6,TRBJ2-7,CASSMTGPSLNEQYF,0,1,1,1
TRBV5-1,TRBJ2-6,CASSPGSGANVLTF,0,4,1,4
TRBV3-1,TRBJ1-5,CASSHLNQPQHF,0,2,1,2
TRBV5-8,TRBJ2-5,CASSLVGTQYF,0,1,1,1
TRBV11-2,TRBJ2-3,CASSSGLTTDTQYF,0,1,1,1
TRBV5-5,TRBJ2-1,CASSLEASGRPYISYNEQFF,0,1,1,1
TRBV6-2/3/5/6,TRBJ2-3,CASSLFSGTSGLTDTQYF,0,1,1,1
TRBV13,TRBJ1-2,CASSLASGTGGPGGGYTF,0,1,1,1
TRBV7-9,TRBJ2-2,CASRIKAGGSVNTGELFF,0,1,1,1
TRBV20-1,TRBJ2-1,CSARDRGRRRAGYNEQFF,0,1,1,1
TRBV20-1,TRBJ2-5,CSAREQTGGLAGKETQYF,0,1,1,1
TRBV5-6,TRBJ1-5,CASSLYGTGSSNQPQHF,0,1,1,1
TRBV7-8,TRBJ1-4,CASSLQGATLTMGELFF,0,1,1,1
TRBV13,TRBJ2-6,CASSLQGAFSGANVLTF,0,1,1,1
TRBV9,TRBJ2-3,CASSVGIRDSSPDTQYF,0,2,1,2
TRBV5-1,TRBJ2-1,CASSLNGPGAGPPEQFF,0,1,1,1
TRBV20-1,TRBJ2-1,CSARDASGTSGKNEQFF,0,1,1,1
TRBV24-1,TRBJ2-2,CATSDPVDRDTGELFF,0,1,1,1
TRBV24-1,TRBJ2-7,CATSDPPSQSSYEQYF,0,1,1,1
TRBV18,TRBJ2-3,CASSPTGTPFTDTQYF,0,2,1,2
TRBV6-2/3/5/6,TRBJ2-5,CASTLGTSGYQETQYF,0,1,1,1
TRBV12-3/4,TRBJ1-1,CASTITLGQANTEAFF,0,1,1,1
TRBV6-2/3/5/6,TRBJ2-2,CASSFQLAGNTGELFF,0,1,1,1
TRBV12-3/4,TRBJ2-2,CASSLAQGVWTGELFF,0,1,1,1
TRBV6-2/3/5/6,TRBJ2-4,CASSYNRRSAKNIQYF,0,1,1,1
TRBV6-4,TRBJ2-5,CASSDLRTGTQETQYF,0,1,1,1
TRBV7-9,TRBJ2-3,CASSLAGTRWIDTQYF,0,1,1,1
TRBV5-6,TRBJ1-6,CASSSGVRRAGSPLHF,0,2,1,2
TRBV3-1,TRBJ2-3,CASSPTLDVGPDTQYF,0,1,1,1
TRBV5-6,TRBJ1-5,CASSRRTDLANQPQHF,0,1,1,1
TRBV7-2,TRBJ2-4,CASSQGAGGAKNIQYF,0,1,1,1
TRBV11-2,TRBJ2-4,CASSASGGGAKNIQYF,0,1,1,1
TRBV5-1,TRBJ2-1,CASSSGELAGVHEQFF,0,2,1,2
TRBV20-1,TRBJ2-3,CSASRGAPAPGDTQYF,0,1,1,1
TRBV20-1,TRBJ2-5,CSARVQGMGFQETQYF,0,1,1,1
TRBV29-1,TRBJ2-1,CSVLRAHSGRGDEQFF,0,1,1,1
TRBV29-1,TRBJ2-3,CSVQGQLAGVTDTQYF,0,1,1,1
TRBV12-5,TRBJ2-6,CASGLLTSGANVLTF,0,1,1,1
TRBV10-3,TRBJ2-1,CAISEGGRADNEQFF,0,1,1,1
TRBV2,TRBJ1-5,CATKRGSSGNQPQHF,0,1,1,1
TRBV19,TRBJ2-1,CASSMRALNYNEQFF,0,1,1,1
TRBV19,TRBJ2-5,CASSIGSQLKETQYF,0,1,1,1
TRBV19,TRBJ1-6,CASSLTGKENSPLHF,0,1,1,1
TRBV18,TRBJ2-1,CASSPRTSVHNEQFF,0,1,1,1
TRBV18,TRBJ2-7,CASSNPGQGTYEQYF,0,1,1,1
TRBV28,TRBJ2-2,CASQTSGSTTGELFF,0,1,1,1
TRBV2,TRBJ2-1,CASGAPLRARNEQFF,0,1,1,1
TRBV28,TRBJ2-7,CASIPGQGRSYEQYF,0,3,1,3
TRBV5-6,TRBJ1-4,CASTLWPSSNEKLFF,0,1,1,1
TRBV12-3/4,TRBJ1-1,CASSFSSTGNTEAFF,0,2,1,2
TRBV28,TRBJ2-1,CASSLPTGAHNEQFF,0,1,1,1
TRBV12-3/4,TRBJ1-4,CASSLGRGVNEKLFF,0,1,1,1
TRBV27,TRBJ2-2,CASSSGTANTGELFF,0,1,1,1
TRBV28,TRBJ2-7,CASSSRLAGGYEQYF,0,1,1,1
TRBV6-2/3/5/6,TRBJ1-5,CASSYATSGNQPQHF,0,1,1,1
TRBV27,TRBJ2-3,CASSYGWGGTDTQYF,0,1,1,1
TRBV6-2/3/5/6,TRBJ2-1,CASSYRTGKNNEQFF,0,1,1,1
TRBV7-3,TRBJ2-1,CASSLTSTSENEQFF,0,1,1,1
TRBV5-6,TRBJ2-1,CASSSTVSSYNEQFF,0,1,1,1
TRBV13,TRBJ2-5,CASSLSGTRKETQYF,0,1,1,1
TRBV14,TRBJ2-1,CASSLSGDSYNEQFF,0,1,1,1
TRBV14,TRBJ2-7,CASSLLAGGKNEQYF,0,1,1,1
TRBV3-1,TRBJ1-1,CASSQRQGAGTEAFF,0,1,1,1
TRBV4-2,TRBJ2-1,CASSQEAGGHNEQFF,0,1,1,1
TRBV6-2/3/5/6,TRBJ2-7,CASSVPSVATYEQYF,0,2,1,2
TRBV6-2/3/5/6,TRBJ2-5,CASRSPTGGQETQYF,0,1,1,1
TRBV6-4,TRBJ2-3,CASRTKGQAADTQYF,0,1,1,1
TRBV2,TRBJ2-2,CASNKALLNTGELFF,0,1,1,1
TRBV6-2/3/5/6,TRBJ1-5,CASKDRGVVNQPQHF,0,1,1,1
TRBV19,TRBJ2-1,CANSIVPSGIFEQFF,0,1,1,1
TRBV5-1,TRBJ2-3,CASSLAGSASDTQYF,0,1,1,1
TRBV5-1,TRBJ2-5,CASSLAGTAQETQYF,0,1,1,1
TRBV5-1,TRBJ1-1,CASSLPRQGGTEAFF,0,1,1,1
TRBV5-1,TRBJ2-3,CASSTTSVPGDTQYF,0,1,1,1
TRBV20-1,TRBJ1-5,CSARVGQASNQPQHF,0,2,1,2
TRBV20-1,TRBJ2-3,CSAPKRSGSTDTQYF,0,2,1,2
TRBV29-1,TRBJ2-7,CSVSPPRGGLGEQYF,0,1,1,1
TRBV29-1,TRBJ2-5,CSVVYDRGSQETQYF,0,1,1,1
TRBV29-1,TRBJ2-3,CSAKREGRLTDTQYF,0,1,1,1
TRBV29-1,TRBJ2-3,CSGLPAGGPGDTQYF,0,1,1,1
TRBV7-9,TRBJ2-1,CAFQGASAHNEQFF,0,2,1,2
TRBV30,TRBJ2-3,CAWSVLSGADTQYF,0,1,1,1
TRBV24-1,TRBJ2-1,CATSGGDSRNEQFF,0,1,1,1
TRBV19,TRBJ1-4,CASTSRATNEKLFF,0,1,1,1
TRBV28,TRBJ2-1,CASIGAGVLNEQFF,0,2,1,2
TRBV28,TRBJ2-2,CASMGQPNTGELFF,0,1,1,1
TRBV2,TRBJ2-7,CASTEDRVFYEQYF,0,1,1,1
TRBV28,TRBJ2-7,CASSFSPALTEQYF,0,1,1,1
TRBV28,TRBJ2-7,CASSLVQGHREQYF,0,1,1,1
TRBV5-4,TRBJ2-2,CASSSGFNTGELFF,0,1,1,1
TRBV27,TRBJ2-3,CASSSPKRTDTQYF,0,1,1,1
TRBV5-5,TRBJ2-1,CASSPGQVNNEQFF,0,1,1,1
TRBV6-1,TRBJ1-5,CASSKAGSNQPQHF,0,1,1,1
TRBV5-6,TRBJ2-4,CASSFRAAKNIQYF,0,2,1,2
TRBV5-4,TRBJ2-3,CASSLRGRTDTQYF,0,1,1,1
TRBV7-9,TRBJ2-1,CASSLRLVGNELFF,0,1,1,1
TRBV7-9,TRBJ1-5,CASSLMGVNQPQHF,0,1,1,1
TRBV9,TRBJ2-5,CASSSRDRGGTQYF,0,1,1,1
TRBV7-9,TRBJ1-1,CASSLHTMNTEAFF,0,1,1,1
TRBV11-2,TRBJ2-5,CASSLGQRQETQYF,0,2,1,2
TRBV7-2,TRBJ2-1,CASSRSSSYNEQFS,0,1,1,1
TRBV3-1,TRBJ2-7,CASSQGGQSYEQYF,0,1,1,1
TRBV3-1,TRBJ1-6,CASSQGTGESPLHF,0,1,1,1
TRBV2,TRBJ2-3,CASSGEGGSDTQYF,0,1,1,1
TRBV2,TRBJ2-3,CASRETGAADTQYF,0,1,1,1
TRBV6-2/3/5/6,TRBJ2-5,CASRPGTDIRAQYF,0,1,1,1
TRBV7-9,TRBJ2-5,CASRKADRVETQYF,0,1,1,1
TRBV6-2/3/5/6,TRBJ2-7,CASKPRDRPYEQYF,0,1,1,1
TRBV5-1,TRBJ2-2,CASHPAANTGELFF,0,1,1,1
TRBV5-1,TRBJ2-7,CASSLATGGNGQYF,0,1,1,1
TRBV4-1,TRBJ2-1,CASSPGTNYNEQFF,0,1,1,1
TRBV20-1,TRBJ2-1,CSATDRRKYNEQFF,0,1,1,1
TRBV20-1,TRBJ2-2,CSASRGANTGELFF,0,1,1,1
TRBV20-1,TRBJ2-3,CSARAGGPTDTQYF,0,1,1,1
TRBV20-1,TRBJ1-4,CSARDEGLGEKLFF,0,1,1,1
TRBV20-1,TRBJ2-1,CSAPNSYGRNEQFF,0,1,1,1
TRBV29-1,TRBJ2-1,CSVESGGAYNEQFF,0,1,1,1
TRBV29-1,TRBJ2-7,CSVIGQGSSYEQYF,0,1,1,1
TRBV29-1,TRBJ1-1,CSVRVLTTGTEAFF,0,1,1,1
TRBV29-1,TRBJ1-4,CSVGGGATNEKLFF,0,1,1,1
TRBV29-1,TRBJ2-1,CSASVARGYNEQFF,0,1,1,1
TRBV24-1,TRBJ2-3,CATTTGSTDTQYF,0,1,1,1
TRBV19,TRBJ2-3,CASSTTGSDTQYF,0,1,1,1
TRBV18,TRBJ2-3,CASSPPSEDTQYF,0,1,1,1
TRBV3-1,TRBJ2-1,CASLSGGRNEQFF,0,1,1,1
TRBV7-9,TRBJ1-1,CASTRVGDTEAFF,0,1,1,1
TRBV27,TRBJ1-1,CASSFGSNTEAFF,0,1,1,1
TRBV11-1,TRBJ2-7,CASSLLSSYEQYF,0,1,1,1
TRBV12-3/4,TRBJ1-2,CASSLGARYGYTF,0,3,1,3
TRBV12-3/4,TRBJ2-7,CASSPRTGQRQYF,0,2,1,2
TRBV7-9,TRBJ2-5,CASSFWGEETQYF,0,1,1,1
TRBV5-6,TRBJ2-3,CASSLGWADTQYF,0,1,1,1
TRBV5-4,TRBJ2-3,CASSLGGGDTQYF,0,2,1,2
TRBV7-9,TRBJ2-1,CASSLDLYNEQFF,0,1,1,1
TRBV12-3/4,TRBJ2-7,CASSLLETYEQYF,0,1,1,1
TRBV7-7,TRBJ2-3,CASSLAEADTQYF,0,1,1,1
TRBV6-2/3/5/6,TRBJ2-7,CASSPGTLPEQYF,0,1,1,1
TRBV7-3,TRBJ2-3,CASSPAATDTQYF,0,1,1,1
TRBV7-6,TRBJ1-2,CASSQGGSYGYTF,0,1,1,1
TRBV5-1,TRBJ2-3,CASSLPPADTQYF,0,1,1,1
TRBV5-1,TRBJ2-7,CASSFDPGNEQYF,0,1,1,1
TRBV20-1,TRBJ1-5,CSALGAVGQPQHF,0,2,1,2
TRBV29-1,TRBJ2-7,CSVGQEKIYEQYF,0,1,1,1
TRBV29-1,TRBJ2-5,CSVEQAGGETQYF,0,1,1,1
TRBV29-1,TRBJ2-3,CSVLDRDGDTQYF,0,1,1,1
TRBV19,TRBJ2-5,CASSITQETQYF,0,1,1,1
TRBV18,TRBJ2-7,CASSPQGGEQYF,0,1,1,1
TRBV18,TRBJ2-5,CASSPSRETQYF,0,1,1,1
TRBV28,TRBJ1-5,CASEEVDQPQHF,0,1,1,1
TRBV6-1,TRBJ1-5,CASSESNQPQHF,0,1,1,1
TRBV7-2,TRBJ2-3,CASSFLPDTQYF,0,1,1,1
TRBV5-6,TRBJ2-1,CASSLGAYEQFF,0,1,1,1
TRBV7-6,TRBJ2-1,CASSLVPDEQFF,0,1,1,1
TRBV11-1,TRBJ2-1,CASSSGGQEQFF,0,2,1,2
TRBV7-2,TRBJ2-3,CASSLSRDTQYF,0,1,1,1
TRBV7-9,TRBJ2-4,CASSPTGGPQYF,0,1,1,1
TRBV3-1,TRBJ2-7,CASSQTGDEQYF,0,1,1,1
TRBV7-9,TRBJ2-7,CASSGGLREQYF,0,2,1,2
TRBV12-3/4,TRBJ2-5,CASRGRVETQYF,0,1,1,1
TRBV6-2/3/5/6,TRBJ2-7,CASRGNGYEQYF,0,1,1,1
TRBV5-1,TRBJ2-7,CASSSSDSEQYF,0,1,1,1
TRBV20-1,TRBJ2-3,CSARVFGDTQYF,0,1,1,1
TRBV20-1,TRBJ1-1,CSARGQLTEAFF,0,1,1,1
TRBV6-2/3/5/6,TRBJ1-2,RASRLSKGGYTF,0,1,1,1
TRBV12-5,TRBJ1-5,CASGLVQPQHF,0,2,1,2
TRBV7-9,TRBJ2-7,CASSQGYEQYF,0,2,1,2
TRBV5-6,TRBJ1-2,CASKREEGYTF,0,2,1,2
TRBV4-1,TRBJ1-4,CASSLEQKLFF,0,2,1,2
TRBV29-1,TRBJ2-1,CSVGTEYEQFF,0,1,1,1
TRBV4-1,TRBJ2-3,CASSQTGGGTSGPTDTQYF,0,1,1,1
TRBV19,TRBJ2-1,CASCSGDAAESSYKEQFF,0,2,1,2
TRBV12-3/4,TRBJ2-1,CAISRDTLWDEPFF,0,1,1,1
TRBV18,TRBJ2-1,CASSPDRGRNEQFF,0,2,1,2
TRBV29-1,TRBJ2-3,CSVGTQGDTQYF,0,2,1,2
TRBV29-1,TRBJ2-2,CSVSSYTGELFF,0,1,1,1
TRBV19,TRBJ2-1,CASSIRGRYCNEQFF,0,2,1,2
TRBV6-2/3/5/6,TRBJ2-1,CASSPGLALNREQFF,0,1,1,1
TRBV29-1,TRBJ1-2,CSAEDSRDRGGGYTL,0,2,1,2
TRBV7-2,TRBJ2-3,CASSLAGDTDTQYF,0,2,1,2
TRBV4-1,TRBJ2-2,CASRLTRGTGELFF,0,1,1,1
TRBV19,TRBJ2-3,CASSVQGTDTQYF,0,1,1,1
TRBV7-2,TRBJ2-1,CASSLIANEQFF,0,1,1,1
TRBV7-9,TRBJ1-1,CASSAGTGQAFF,0,1,1,1
TRBV5-1,TRBJ1-3,CASSFENTIYF,0,1,1,1
TRBV19,TRBJ2-1,CASSGSGTAFSNGQFF,0,1,1,1
TRBV18,TRBJ2-3,CASSPLRTLSRVTDTQYF,0,1,1,1
TRBV5-1,TRBJ2-5,CASSLAYLGGGQETQYF,0,1,1,1
TRBV7-3,TRBJ2-3,CASSLNPSGSTDTQYF,0,1,1,1
TRBV7-3,TRBJ2-1,CASSYTGTPWGNEQFF,0,2,1,2
TRBV5-5,TRBJ2-3,CASSVTSGSSADTQYF,0,1,1,1
TRBV20-1,TRBJ1-2,CSARPRDSPPPFGYTF,0,1,1,1
TRBV12-3/4,TRBJ1-5,CASSLHGASNQPQHF,0,1,1,1
TRBV7-9,TRBJ2-1,CASSLPGQGLNEQFF,0,1,1,1
TRBV7-9,TRBJ2-5,CASKVGRGRQETQYF,0,1,1,1
TRBV18,TRBJ1-5,CASSPSTGDQPQHF,0,1,1,1
TRBV18,TRBJ2-3,CASSPGENRDTQYF,0,2,1,2
TRBV11-2,TRBJ2-1,CASRDSSFYNEQFF,0,1,1,1
TRBV7-9,TRBJ1-1,CASGQTDTEAFF,0,1,1,1
TRBV7-8,TRBJ2-3,CASSLEGVRLGGAFTDTQYF,0,1,1,1
TRBV10-1,TRBJ2-2,CASSESLSAGSSNTGELFF,0,1,1,1
TRBV19,TRBJ2-1,CASIGPTQAGQSYNEQFF,0,1,1,1
TRBV5-8,TRBJ2-1,CASSLATLAGGVYNEQFF,0,2,1,2
TRBV4-1,TRBJ2-2,CASSHAGLAGAVAGELFF,0,2,1,2
TRBV5-1,TRBJ1-2,CASSFHPGSDRLAYGYTF,0,1,1,1
TRBV29-1,TRBJ2-1,CSVEERFGDILSYNEQFF,0,1,1,1
TRBV10-3,TRBJ2-1,CAISESIAGGKYNEQFF,0,1,1,1
TRBV6-1,TRBJ2-1,CASSASRGGRANYEQFF,0,1,1,1
TRBV28,TRBJ2-3,CASSGSQGTGQTDTQYF,0,1,1,1
TRBV7-8,TRBJ2-3,CASSLIGGLAGTDTQYF,0,1,1,1
TRBV11-3,TRBJ2-6,CASSSGTGMTGANVLTF,0,1,1,1
TRBV7-2,TRBJ2-3,CASSPREPGLPPDTQYF,0,1,1,1
TRBV7-3,TRBJ2-7,CASSPGLGLAGVHEQYF,0,1,1,1
TRBV4-2,TRBJ2-7,CASSPAGLGGSSYEQYF,0,2,1,2
TRBV3-1,TRBJ2-3,CASSHGLAGLGTDTQYF,0,1,1,1
TRBV5-4,TRBJ2-1,CASSGPNGGIRQDEQFF,0,1,1,1
TRBV4-2,TRBJ2-1,CASSTRTSGNPYNEQFF,0,3,1,3
TRBV10-1,TRBJ2-1,CASSESLGTGMGWEQFF,0,1,1,1
TRBV5-1,TRBJ2-2,CASSFAPTGANTGELFF,0,1,1,1
TRBV5-1,TRBJ2-1,CASSLAGLAGTYNEQSF,0,1,1,1
TRBV29-1,TRBJ2-7,CSVEAPKGSGGTYEQYF,0,1,1,1
TRBV29-1,TRBJ2-1,CSAEEGTGGRSYNEQFF,0,1,1,1
TRBV12-5,TRBJ1-1,CASGSTTGAGDTEAFF,0,2,1,2
TRBV27,TRBJ2-7,CAGRPGQGSLWVEQYF,0,1,1,1
TRBV15,TRBJ2-1,CATMESAGSSYNEQFF,0,1,1,1
TRBV19,TRBJ1-5,CASRTEGSGSNQPQHF,0,1,1,1
TRBV18,TRBJ2-1,CASSPPLGLNTDEQFF,0,1,1,1
TRBV28,TRBJ2-1,CASITPGLAGHNEQFF,0,1,1,1
TRBV12-3/4,TRBJ2-2,CASSLRPGTNTGELFF,0,1,1,1
TRBV12-3/4,TRBJ1-1,CASSLVRGREDTEAFF,0,1,1,1
TRBV6-2/3/5/6,TRBJ1-1,CASSRDRGPLNTEAFF,0,1,1,1
TRBV6-2/3/5/6,TRBJ2-5,CASSRETGTSSSAQYF,0,1,1,1
TRBV28,TRBJ2-5,CASSHPTGKEVETQYF,0,1,1,1
TRBV6-1,TRBJ2-7,CASSESEGRGSYEQYF,0,1,1,1
TRBV2,TRBJ2-1,CASSEGSSSSYNEQFF,0,1,1,1
TRBV11-3,TRBJ2-3,CASSFLTPGGTDTQYF,0,1,1,1
TRBV5-4,TRBJ2-1,CASSFPGTRSLDEQFF,0,1,1,1
TRBV11-2,TRBJ1-1,CASSSSQGQGYTEAFF,0,1,1,1
TRBV7-9,TRBJ1-2,CASSWLLYNPNYGYTF,0,1,1,1
TRBV7-9,TRBJ2-3,CASSLVGAGGRDTQYF,0,1,1,1
TRBV6-2/3/5/6,TRBJ2-7,CASSPGLAQLSYEQYF,0,1,1,1
TRBV5-5,TRBJ2-5,CASSRAWQSIRETQYF,0,1,1,1
TRBV4-2,TRBJ2-7,CASSQEASGRGYEQYF,0,1,1,1
TRBV9,TRBJ2-1,CASSGAAGGDNNEQFF,0,2,1,2
TRBV5-1,TRBJ2-3,CASSFLAGGNTDTQYF,0,1,1,1
TRBV5-1,TRBJ2-3,CASSFRLASNTDTQYF,0,1,1,1
TRBV5-1,TRBJ2-3,CASSLQGGSSTDTQYF,0,1,1,1
TRBV5-1,TRBJ2-3,CASSYNRGQRIDTQYF,0,1,1,1
TRBV4-1,TRBJ2-5,CASSQDRDTDRETQYF,0,1,1,1
TRBV4-1,TRBJ1-4,CASRTGTGGNNEKLFF,0,1,1,1
TRBV5-1,TRBJ2-3,CASRGLAGDRTDTQYF,0,1,1,1
TRBV20-1,TRBJ2-4,CSASLAGQLAKNIQYF,0,1,1,1
TRBV20-1,TRBJ2-5,CSARGDRGLGQETQYF,0,1,1,1
TRBV20-1,TRBJ1-5,CSARDRSPFRGQPQHF,0,1,1,1
TRBV29-1,TRBJ2-2,CSVGRGSPGGTGELFF,0,1,1,1
TRBV29-1,TRBJ1-5,CSVILQGRGISQPQHF,0,1,1,1
TRBV10-3,TRBJ2-1,CAISPGTGRINEQFF,0,1,1,1
TRBV24-1,TRBJ2-1,CATSDSRGLGNEQFF,0,1,1,1
TRBV28,TRBJ2-2,CASRPGQGRTGELFF,0,1,1,1
TRBV19,TRBJ2-1,CASSSSGQGANEQFF,0,1,1,1
TRBV19,TRBJ1-1,CASSLPTGQNTEAFF,0,1,1,1
TRBV19,TRBJ2-2,CASSMAGPNTGELFF,0,1,1,1
TRBV19,TRBJ2-1,CASSIGGQYIYEQFF,0,1,1,1
TRBV19,TRBJ1-5,CASSRQSRSNQPQHF,0,1,1,1
TRBV18,TRBJ2-2,CASSPGTANTGELFF,0,1,1,1
TRBV7-9,TRBJ1-2,CASTMGGLAGYGYTF,0,1,1,1
TRBV6-2/3/5/6,TRBJ1-3,CASSSGQGAGNTIYF,0,1,1,1
TRBV25-1,TRBJ2-5,CASSDPGRFQETQYF,0,1,1,1
TRBV6-1,TRBJ1-5,CASSELSQAGQPQHF,0,1,1,1
TRBV6-4,TRBJ1-5,CASSEWASYNQPQHF,0,1,1,1
TRBV2,TRBJ2-7,CASSEGVGNSYEQYF,0,1,1,1
TRBV7-9,TRBJ2-5,CASSFSPTGEETQYF,0,1,1,1
TRBV11-2,TRBJ2-3,CASSLFLAGTDTQYF,0,2,1,2
TRBV11-2,TRBJ2-4,CASSLSLVAGGIQYF,0,1,1,1
TRBV7-2,TRBJ2-2,CASSLVVLNTGELFF,0,1,1,1
TRBV7-2,TRBJ1-1,CASSLVGGLNTEAFF,0,1,1,1
TRBV7-2,TRBJ2-1,CASSLASGIYNEQFF,0,1,1,1
TRBV7-2,TRBJ2-1,CASSLGAGTYNEQFF,0,1,1,1
TRBV5-4,TRBJ2-1,CASSLGASGYNEQFF,0,1,1,1
TRBV7-2,TRBJ2-3,CASSLNGHNTDTQYF,0,1,1,1
TRBV11-3,TRBJ2-1,CASSSRLAVYNEQFF,0,1,1,1
TRBV7-9,TRBJ2-1,CASSSGTNPYNEQFF,0,1,1,1
TRBV11-2,TRBJ1-2,CASSSIHRDNYGYTF,0,1,1,1
TRBV3-1,TRBJ2-1,CASSLAGGTYNEQFF,0,1,1,1
TRBV11-2,TRBJ2-3,CASSPLRRGLDTQYF,0,1,1,1
TRBV27,TRBJ2-1,CASSRAIGTYNEQFF,0,1,1,1
TRBV12-3/4,TRBJ2-2,CASSRTGRNTGELFF,0,1,1,1
TRBV4-2,TRBJ2-7,CASSQGPRPLHEQYF,0,1,1,1
TRBV3-1,TRBJ1-3,CASSQISNSGNTIYF,0,1,1,1
TRBV3-1,TRBJ2-1,CASSQISSGQREQFF,0,1,1,1
TRBV9,TRBJ2-5,CASSVGGLAEETQYF,0,1,1,1
TRBV7-2,TRBJ2-1,CASSIRTSGENEQFF,0,1,1,1
TRBV9,TRBJ2-1,CASSTGTGGYNEQFF,0,1,1,1
TRBV7-6,TRBJ2-7,CASSTGLAGAREQYF,0,1,1,1
TRBV2,TRBJ2-5,CASRPRGQYQETQYF,0,1,1,1
TRBV5-6,TRBJ2-1,CASRVRGSSYNEQFF,0,1,1,1
TRBV2,TRBJ2-1,CASRPGTSGTNEQFF,0,1,1,1
TRBV18,TRBJ2-7,CASNTGGTSGYEQYF,0,1,1,1
TRBV7-6,TRBJ1-4,CTSSLSTGTNEKLFF,0,1,1,1
TRBV5-1,TRBJ2-5,CASSLALGARETQYF,0,1,1,1
TRBV5-1,TRBJ2-7,CASSLAMTGGDEQYF,0,1,1,1
TRBV5-1,TRBJ2-5,CASSLGGAIQETQYF,0,1,1,1
TRBV5-1,TRBJ2-3,CASSLISETWDTQYF,0,1,1,1
TRBV5-1,TRBJ1-1,CASSSGQGSNTEAFF,0,1,1,1
TRBV5-1,TRBJ2-1,CASRATSGRWNEQFF,0,1,1,1
TRBV5-1,TRBJ2-7,CASRTTGTEIYEQYF,0,1,1,1
TRBV20-1,TRBJ2-3,CSAQSGLAVTDTQYF,0,1,1,1
TRBV20-1,TRBJ2-3,CSAALAGGSTDTQYF,0,1,1,1
TRBV20-1,TRBJ2-1,CSAAHPSGPYNEQFF,0,1,1,1
TRBV20-1,TRBJ2-7,CSATDGTSGTYEQYF,0,1,1,1
TRBV20-1,TRBJ1-1,CSAREAGTENTEAFF,0,1,1,1
TRBV20-1,TRBJ2-7,CSAKGLTGAVYEQYF,0,1,1,1
TRBV30,TRBJ1-2,CAWSAGQGLYGYTF,0,1,1,1
TRBV24-1,TRBJ2-7,CATSDLAGRTGQYF,0,1,1,1
TRBV2,TRBJ1-3,CASFRDSSGNTIYF,0,1,1,1
TRBV19,TRBJ2-7,CASSRTGGWYEQYF,0,1,1,1
TRBV19,TRBJ2-7,CASSPLAGSHEQYF,0,1,1,1
TRBV19,TRBJ2-7,CASRPAGSPHEQYF,0,1,1,1
TRBV27,TRBJ2-7,CASSPSPSPYEQYF,0,1,1,1
TRBV18,TRBJ2-1,CASSPPSSGGEQFF,0,1,1,1
TRBV25-1,TRBJ1-1,CASLRQGRNTEAFF,0,1,1,1
TRBV12-3/4,TRBJ2-1,CASRKSGKITEQFF,0,1,1,1
TRBV12-3/4,TRBJ2-7,CASSLGTSGNRQYF,0,1,1,1
TRBV6-2/3/5/6,TRBJ2-2,CASSYHSDTGELFF,0,1,1,1
TRBV27,TRBJ2-2,CASSPSRATGELFF,0,1,1,1
TRBV12-3/4,TRBJ2-5,CASSPGGGSETQYF,0,1,1,1
TRBV6-1,TRBJ1-4,CASSDQSTNEKLFF,0,1,1,1
TRBV5-4,TRBJ2-3,CASSFSGITDTQYF,0,1,1,1
TRBV5-4,TRBJ1-2,CASSLATGGVGYTF,0,1,1,1
TRBV5-6,TRBJ2-1,CASSLGDGRGEQFF,0,2,1,2
TRBV5-6,TRBJ2-4,CASSLGSQGNIQYF,0,1,1,1
TRBV7-6,TRBJ2-1,CASSLAGTNNEQFF,0,1,1,1
TRBV7-9,TRBJ1-5,CASSLGSGNQPQHF,0,1,1,1
TRBV6-2/3/5/6,TRBJ2-2,CASSSYGVTGELFF,0,1,1,1
TRBV7-7,TRBJ2-7,CASSSSDYSYEQYF,0,1,1,1
TRBV3-1,TRBJ1-5,CASSLGQLNQPQHF,0,1,1,1
TRBV11-2,TRBJ1-1,CASSPSGGRSEAFF,0,1,1,1
TRBV3-1,TRBJ1-2,CASSPLERSYGYTF,0,1,1,1
TRBV11-2,TRBJ1-4,CASSPGQTNEKLFF,0,1,1,1
TRBV5-4,TRBJ2-5,CASSPTGGGETQYF,0,1,1,1
TRBV4-2,TRBJ2-5,CASSQAGGAETQYF,0,1,1,1
TRBV5-5,TRBJ2-7,CASSQGQGYYEQYF,0,1,1,1
TRBV3-1,TRBJ1-2,CASSQEGRIGGYTF,0,2,1,2
TRBV6-2/3/5/6,TRBJ2-5,CASRPDRFQETQYF,0,1,1,1
TRBV5-1,TRBJ2-3,CASSLGTSTDTQYF,0,1,1,1
TRBV5-1,TRBJ2-1,CASSLSSAGNEQFF,0,1,1,1
TRBV5-1,TRBJ2-3,CASSLAASTDTQYF,0,1,1,1
TRBV4-1,TRBJ2-5,CASSQAQRQETQYF,0,1,1,1
TRBV10-1,TRBJ2-2,CASSATGVPGELFF,0,1,1,1
TRBV29-1,TRBJ2-3,CSALTSGSTDTQYF,0,3,1,3
TRBV20-1,TRBJ2-2,CSAWTEPNTGELFF,0,1,1,1
TRBV20-1,TRBJ2-7,CSAMTDYHDDEQYF,0,1,1,1
TRBV20-1,TRBJ2-7,CSARAVVQGYEQYF,0,1,1,1
TRBV20-1,TRBJ2-7,CSALGTSGSYEQYF,0,1,1,1
TRBV29-1,TRBJ2-3,CSVRTSGITDTQYF,0,1,1,1
TRBV29-1,TRBJ2-7,CSVVVTGNSYEQYF,0,1,1,1
TRBV29-1,TRBJ1-5,CSVAGGTSNQPQHF,0,1,1,1
TRBV29-1,TRBJ2-7,CSVTGGQGAGEQYF,0,1,1,1
TRBV29-1,TRBJ2-5,CSVRGQGGKETQYF,0,1,1,1
TRBV29-1,TRBJ2-6,CSAGADAGANVLTF,0,1,1,1
TRBV29-1,TRBJ2-3,CSGVGPAGGDTQYF,0,2,1,2
TRBV2,TRBJ2-3,CAGGTGVTDTQYF,0,1,1,1
TRBV10-3,TRBJ2-2,CAISNRDTGELFF,0,1,1,1
TRBV24-1,TRBJ2-1,CATSDFGAYEQFF,0,1,1,1
TRBV19,TRBJ2-5,CASSIIPQETQYF,0,1,1,1
TRBV19,TRBJ1-1,CASSISPNSEAFF,0,1,1,1
TRBV19,TRBJ1-1,CASSISGARQAFF,0,1,1,1
TRBV18,TRBJ2-7,CASSPPAGYEQYF,0,1,1,1
TRBV12-3/4,TRBJ1-2,CASGAGQGYGYTF,0,2,1,2
TRBV2,TRBJ2-2,CASTWTSGRELFF,0,1,1,1
TRBV11-3,TRBJ2-1,CASTDGNGNEQFF,0,2,1,2
TRBV12-3/4,TRBJ1-2,CASSLRQGNGYTF,0,1,1,1
TRBV12-3/4,TRBJ1-6,CASSWGILGSLHF,0,1,1,1
TRBV28,TRBJ2-6,CASSLPPANVLTF,0,1,1,1
TRBV2,TRBJ2-5,CASSEGPQETQYF,0,1,1,1
TRBV7-2,TRBJ2-2,CASSSGNTGELFF,0,1,1,1
TRBV7-3,TRBJ2-3,CASSFDSADTQYF,0,1,1,1
TRBV11-2,TRBJ2-3,CASSLARTDTQYF,0,1,1,1
TRBV7-6,TRBJ2-4,CASSLDGGSPQYF,0,1,1,1
TRBV5-4,TRBJ1-2,CASSSGQGYGYTF,0,1,1,1
TRBV3-1,TRBJ2-7,CASSRLGQYEQYF,0,1,1,1
TRBV3-1,TRBJ2-1,CASSQSLPNEQFF,0,1,1,1
TRBV7-9,TRBJ2-7,CASRQGTGYEQYF,0,1,1,1
TRBV5-1,TRBJ2-7,CASSLTDSYEQYF,0,2,1,2
TRBV5-1,TRBJ1-4,CASSRDTNEKLFF,0,1,1,1
TRBV20-1,TRBJ2-7,CSAPGTGGYEQYF,0,1,1,1
TRBV20-1,TRBJ2-3,CSAGTSGRGTQYF,0,1,1,1
TRBV20-1,TRBJ1-6,CSATGTGSSPLHF,0,1,1,1
TRBV29-1,TRBJ2-3,CSVDRAGVDTQYF,0,1,1,1
TRBV29-1,TRBJ2-3,CSVEQEITDTQYF,0,1,1,1
TRBV29-1,TRBJ1-1,CSVAQTGNTEAFF,0,1,1,1
TRBV29-1,TRBJ2-1,CSALPYVYNEQFF,0,1,1,1
TRBV30,TRBJ2-7,CAFSGPYYEQYF,0,2,1,2
TRBV18,TRBJ1-2,CASSVTNYGYTF,0,1,1,1
TRBV7-9,TRBJ1-1,CASRNGNTEAFF,0,1,1,1
TRBV2,TRBJ2-1,CASSEVGDEQFF,0,1,1,1
TRBV6-1,TRBJ2-7,CASSEIQNEQYF,0,1,1,1
TRBV7-9,TRBJ2-7,CASSLAGHEQYF,0,1,1,1
TRBV12-3/4,TRBJ2-4,CASSQVENIQYF,0,1,1,1
TRBV13,TRBJ2-1,CASSGDANEQFF,0,1,1,1
TRBV5-1,TRBJ2-7,CASSLNTYEQYF,0,1,1,1
TRBV5-1,TRBJ2-1,CASSSTLNEQFF,0,1,1,1
TRBV20-1,TRBJ1-1,CSARGQGTEAFF,0,1,1,1
TRBV29-1,TRBJ2-5,CSVVLASETQYF,0,1,1,1
TRBV29-1,TRBJ2-7,CSVGTGLGEQYF,0,1,1,1
TRBV30,TRBJ2-2,CAWSRTGELFF,0,1,1,1
TRBV11-2,TRBJ1-1,CAISFHWAAFF,0,1,1,1
TRBV19,TRBJ2-1,CASSMGDEQFF,0,1,1,1
TRBV2,TRBJ2-1,CASSDGAEQFF,0,1,1,1
TRBV7-9,TRBJ2-7,CASSSFYEQYF,0,1,1,1
TRBV9,TRBJ2-7,CASSDSYEQYF,0,1,1,1
TRBV7-9,TRBJ2-2,CASNSAGELFF,0,1,1,1
TRBV29-1,TRBJ2-1,CTGQIFNEQFF,0,1,1,1
TRBV29-1,TRBJ2-3,CSVDRGDTQYF,0,1,1,1
TRBV29-1,TRBJ2-5,CSVGLAATQYF,0,1,1,1
TRBV19,TRBJ2-1,CASSLLGETGGPYNEQFF,0,2,1,2
TRBV6-2/3/5/6,TRBJ2-3,CASSPGKGLAATDTQYF,0,1,1,1
TRBV20-1,TRBJ2-1,CSAIHLAGGSLNEQFF,0,1,1,1
TRBV12-3/4,TRBJ2-1,CASTPRTSGNNEQFF,0,1,1,1
TRBV5-5,TRBJ2-1,CASSSLGDSYNEQFF,0,3,1,3
TRBV5-1,TRBJ1-6,CASSLESSYNSPLHF,0,1,1,1
TRBV20-1,TRBJ2-1,CSARDLREGRNKQFF,0,1,1,1
TRBV30,TRBJ2-5,CAWSVGGPQETQYF,0,1,1,1
TRBV12-3/4,TRBJ2-3,CASWSGKPTDTQYF,0,1,1,1
TRBV7-9,TRBJ2-3,CASSLGGTTDTQYF,0,1,1,1
TRBV12-3/4,TRBJ2-7,CASSPGGSSYEQYF,0,2,1,2
TRBV5-1,TRBJ2-1,CASSWTSQGNEQFF,0,1,1,1
TRBV7-7,TRBJ2-5,CASSQGVQETQYF,0,1,1,1
TRBV24-1,TRBJ1-1,CATSDSTGAEAFI,0,1,1,1
TRBV5-4,TRBJ2-3,RASSLRRSDTQYF,0,1,1,1
TRBV29-1,TRBJ2-3,SSAGDIGDTQYF,0,1,1,1
TRBV6-2/3/5/6,TRBJ2-7,CASSSPGYEQYF,0,1,1,1
TRBV29-1,TRBJ1-1,CSVEVWYTEAFF,0,1,1,1
TRBV5-1,TRBJ2-1,CASSLRNEQFF,0,2,1,2
TRBV6-2/3/5/6,TRBJ2-6,CASIAGQGRAGANVLTF,0,1,1,1
TRBV6-2/3/5/6,TRBJ2-1,CASSSRPGGGAYNEQFF,0,1,1,1
TRBV20-1,TRBJ2-7,CSARDLLAGGQSREQYF,0,1,1,1
TRBV29-1,TRBJ2-7,CSVRGLAGATRAYEQYF,0,1,1,1
TRBV12-3/4,TRBJ2-3,FATSLASGTRPDTQYF,0,1,1,1
TRBV11-2,TRBJ2-1,CASSFGESGPYNEQFF,0,1,1,1
TRBV9,TRBJ2-2,CASSSTLLANTGELFF,0,1,1,1
TRBV12-3/4,TRBJ1-1,CASSFRLGRDTEAFF,0,1,1,1
TRBV6-1,TRBJ1-1,CASSEVGSWRIEAFF,0,1,1,1
TRBV28,TRBJ2-7,CASSSPRTSRYEQYF,0,1,1,1
TRBV3-1,TRBJ2-3,CASSPRGRPFDTQYF,0,1,1,1
TRBV7-3,TRBJ2-2,CASSPQQSNTGELFF,0,2,1,2
TRBV20-1,TRBJ2-7,CSARDPGGVSYEQYF,0,1,1,1
TRBV29-1,TRBJ1-1,CSVGDRYTEGGEAFF,0,1,1,1
TRBV15,TRBJ2-7,CATSRDLKRYEQYF,0,1,1,1
TRBV6-4,TRBJ2-7,CASSRLKGSYEQYF,0,1,1,1
TRBV6-4,TRBJ1-1,CASRDLSANTEAFF,0,1,1,1
TRBV2,TRBJ2-2,CASSRENTGELFF,0,1,1,1
TRBV5-4,TRBJ2-1,CASSLREPGEQFF,0,1,1,1
TRBV12-3/4,TRBJ2-5,CASRRTGEETQYF,0,3,1,3
TRBV5-1,TRBJ2-1,CASSLWTSNEQFF,0,1,1,1
TRBV12-3/4,TRBJ2-1,CASTPYPIAQFF,0,1,1,1
TRBV7-2,TRBJ2-3,CASSLSDTQYF,0,3,1,3
TRBV7-3,TRBJ1-2,RASSRTGQDLTNYGYTF,0,1,1,1
TRBV6-2/3/5/6,TRBJ2-1,CASSTGGRFLYNEQFF,0,1,1,1
TRBV6-2/3/5/6,TRBJ2-4,CASSIAGGAAKNIQYF,0,1,1,1
TRBV20-1,TRBJ2-3,CSARGPGVAGTDTQYF,0,1,1,1
TRBV15,TRBJ2-1,CATSRDRARTAEQFF,0,1,1,1
TRBV11-2,TRBJ2-3,CASSFSGRAVDTQYF,0,1,1,1
TRBV7-9,TRBJ2-7,CASRPISGKVYEQYF,0,1,1,1
TRBV7-9,TRBJ2-5,CASSFEGLGETQYF,0,2,1,2
TRBV18,TRBJ2-7,CAGSSRQGTYEQYF,0,1,1,1
TRBV24-1,TRBJ2-3,CATSVTSGSGTQYF,0,1,1,1
TRBV5-4,TRBJ2-7,CASSFRGGVEKQYF,0,1,1,1
TRBV11-2,TRBJ2-5,CASSLGTTGETQYF,0,1,1,1
TRBV20-1,TRBJ1-1,CSAREGYVDTEASF,0,1,1,1
TRBV10-3,TRBJ2-3,CAISPEITDTQYF,0,1,1,1
TRBV3-1,TRBJ2-5,CASSLGGEETQYS,0,1,1,1
TRBV3-1,TRBJ2-5,CASSQRGQETQYF,0,1,1,1
TRBV20-1,TRBJ2-4,CSASDMLKNIQYF,0,1,1,1
TRBV20-1,TRBJ2-1,CSARDLSYNEQFF,0,1,1,1
TRBV12-3/4,TRBJ2-1,CASNRVSNEQFF,0,1,1,1
TRBV20-1,TRBJ2-3,CGARDGQGQYF,0,1,1,1
TRBV9,TRBJ2-1,CASSVARGLAGERGRINEQFF,0,1,1,1
TRBV20-1,TRBJ2-2,CSARDPLEGTSGRASGELFF,0,1,1,1
TRBV19,TRBJ2-7,CASRTVRGRPSGSPYEQYF,0,1,1,1
TRBV20-1,TRBJ2-2,CSAQIGGLAGGVGTGELFF,0,1,1,1
TRBV20-1,TRBJ1-5,CSARDRPGQGSSSNQPQHF,0,1,1,1
TRBV19,TRBJ2-6,CASSIVPSGHSGANVLTF,0,1,1,1
TRBV27,TRBJ2-1,CASSSQSNLLGFYNEQFF,0,1,1,1
TRBV27,TRBJ2-1,CASSRSGLILSSYNEQFF,0,1,1,1
TRBV12-3/4,TRBJ2-3,CASSQISSSRVRTDTQYF,0,1,1,1
TRBV28,TRBJ2-3,CASRGLAGGGGSTDTQYF,0,1,1,1
TRBV2,TRBJ2-4,CASRSGTSGSGAKNIQYF,0,1,1,1
TRBV10-2,TRBJ1-5,CASSQHRGSNVGAQPQHF,0,1,1,1
TRBV29-1,TRBJ2-1,CSALPGTAGGPAYNEQFF,0,1,1,1
TRBV29-1,TRBJ1-1,CSIPPISRRGQEDTEAFF,0,1,1,1
TRBV10-3,TRBJ2-6,CAIRPGPRSSGANVLTF,0,1,1,1
TRBV3-1,TRBJ2-7,CASSRRQGPVWDYEQYF,0,1,1,1
TRBV28,TRBJ2-7,CASSADSWGDLSYEQYF,0,1,1,1
TRBV2,TRBJ1-2,CASSEITGAPVVHGYTF,0,1,1,1
TRBV7-2,TRBJ2-7,CASSFIVGQGRAYEQYF,0,1,1,1
TRBV5-4,TRBJ2-1,CASSLVTGTSGNNEQFF,0,1,1,1
TRBV3-1,TRBJ2-1,CASSYTASGVPMAEQFF,0,1,1,1
TRBV4-2,TRBJ2-3,CASSPRSLAGGGDTQYF,0,1,1,1
TRBV5-1,TRBJ2-5,CASSLVLAGGIQETQYF,0,1,1,1
TRBV5-1,TRBJ2-1,CASSSGTSGSAYNEQFF,0,1,1,1
TRBV5-1,TRBJ2-1,CASSWTLGANRFREQFF,0,1,1,1
TRBV5-1,TRBJ1-1,CASSLRQGDLVDTEAFF,0,1,1,1
TRBV4-1,TRBJ2-1,CASSQAVVQGLGLEQFF,0,1,1,1
TRBV20-1,TRBJ2-3,CSAHGGLAGVSTDTQYF,0,1,1,1
TRBV12-5,TRBJ2-5,CASGSLAGLYQETQYF,0,1,1,1
TRBV19,TRBJ1-5,CASSTGVQAGNQPQHF,0,1,1,1
TRBV18,TRBJ2-3,CASSPRKGGGTDTQYF,0,1,1,1
TRBV28,TRBJ2-1,CASSFPWGGGNNEQFF,0,1,1,1
TRBV12-3/4,TRBJ1-5,CASSLYQGGPNQPQHF,0,1,1,1
TRBV12-3/4,TRBJ1-2,CASSLVSGAARNGYTF,0,1,1,1
TRBV6-2/3/5/6,TRBJ1-6,CASSYGDRGYNSPLHF,0,1,1,1
TRBV12-3/4,TRBJ2-7,CASSPRGDRGIYEQYF,0,1,1,1
TRBV28,TRBJ2-4,CASSPQGARVKNIQYF,0,1,1,1
TRBV5-4,TRBJ2-3,CASSQKSGSRTDTQYF,0,1,1,1
TRBV6-1,TRBJ2-5,CASSESQGLYQETQYF,0,1,1,1
TRBV2,TRBJ1-1,CASSTQGTGMNTEAFF,0,1,1,1
TRBV6-1,TRBJ2-7,CASSRTRGTGAYEQYF,0,1,1,1
TRBV6-1,TRBJ2-7,CASSKGGTSGSYEQYF,0,1,1,1
TRBV5-6,TRBJ2-3,CASSFPGLDPTDTQYF,0,1,1,1
TRBV5-4,TRBJ2-1,CASSLDGGSSYNEQFF,0,1,1,1
TRBV13,TRBJ2-1,CASSSAGTKVYNEQFF,0,1,1,1
TRBV11-2,TRBJ2-3,CASSLLSRERTDTQYF,0,1,1,1
TRBV5-6,TRBJ2-5,CASSPPSSGRRETQYF,0,1,1,1
TRBV7-9,TRBJ2-3,CASSRQGAPHTDTQYF,0,1,1,1
TRBV3-1,TRBJ2-1,CASSQGLAAGVNEQFF,0,1,1,1
TRBV14,TRBJ2-1,CASSQVSGSSYNEQFF,0,1,1,1
TRBV14,TRBJ2-2,CASSQVAGKNTGELFF,0,1,1,1
TRBV3-1,TRBJ2-1,CASSQDGGRAGNEQFF,0,1,1,1
TRBV5-6,TRBJ2-3,CASSVPRGVGEDTQYF,0,1,1,1
TRBV7-9,TRBJ2-1,CASSGRTSGSYNEQFF,0,1,1,1
TRBV5-4,TRBJ2-1,CASSKPTGQSYNEQFF,0,1,1,1
TRBV5-1,TRBJ1-1,CASSPQGGGLDTEAFF,0,1,1,1
TRBV5-1,TRBJ2-1,CASSLWSGTTHAEQFF,0,1,1,1
TRBV5-1,TRBJ1-5,CASSLGTGYDNQPQHF,0,1,1,1
TRBV5-1,TRBJ1-1,CASSPPGQDMNTEAFF,0,2,1,2
TRBV4-1,TRBJ2-1,CASSRASGSEGNEQFF,0,1,1,1
TRBV5-1,TRBJ2-7,CASSAGTSGRRDEQYF,0,1,1,1
TRBV20-1,TRBJ2-3,CSARDFQGWVTDTQYF,0,1,1,1
TRBV29-1,TRBJ2-1,CSVLELAGASYNEQFF,0,1,1,1
TRBV29-1,TRBJ2-3,CSVSPGTSRPTDTQYF,0,2,1,2
TRBV29-1,TRBJ2-3,CSVYPWTNSLTDTQYF,0,1,1,1
TRBV29-1,TRBJ2-3,CSVEGVQGRGTDTQYF,0,1,1,1
TRBV29-1,TRBJ1-2,CSVEEFGVPPPDGYTF,0,1,1,1
TRBV9,TRBJ2-1,CAGSTGLAGNNEQFF,0,1,1,1
TRBV10-3,TRBJ2-3,CAISAWREVTDTQYF,0,1,1,1
TRBV12-3/4,TRBJ2-1,CASDSSVRGYNEQFF,0,1,1,1
TRBV19,TRBJ2-1,CASTSGRTGYDEQFF,0,1,1,1
TRBV19,TRBJ1-1,CASSLGEARNTEAFF,0,1,1,1
TRBV19,TRBJ2-1,CASSITGSSYNEQFF,0,1,1,1
TRBV19,TRBJ2-7,CASSISVSDRFLAYF,0,1,1,1
TRBV19,TRBJ1-5,CASKTLRTTNQPQHF,0,1,1,1
TRBV18,TRBJ2-1,CASSPPGSAYNEQFF,0,1,1,1
TRBV18,TRBJ2-7,CASSPPGSRWYEQYF,0,1,1,1
TRBV28,TRBJ2-7,CASCTPGTGNYEQYF,0,1,1,1
TRBV5-4,TRBJ2-4,CASTPGGAGKNIQYF,0,1,1,1
TRBV4-2,TRBJ2-1,CASTPGGSTYNEQFF,0,2,1,2
TRBV12-3/4,TRBJ1-5,CASTTTGPSGQPQHF,0,1,1,1
TRBV28,TRBJ2-7,CASSFSSGELYEQYF,0,1,1,1
TRBV12-3/4,TRBJ2-3,CASSLRIGGPDTQYF,0,1,1,1
TRBV2,TRBJ2-7,CASSLFPGAAYEQYF,0,1,1,1
TRBV12-3/4,TRBJ2-1,CASSLGGSSGADQFF,0,2,1,2
TRBV6-2/3/5/6,TRBJ2-1,CASSSAGIQYNEQFF,0,1,1,1
TRBV6-2/3/5/6,TRBJ1-4,CASSYSGTENEKLFF,0,1,1,1
TRBV6-2/3/5/6,TRBJ2-3,CASSYRDRSTDTQYF,0,1,1,1
TRBV6-2/3/5/6,TRBJ1-2,CASSYAPGPNYGYTF,0,1,1,1
TRBV6-2/3/5/6,TRBJ2-7,CASSYNAGGTYEQYF,0,1,1,1
TRBV28,TRBJ2-3,CASSPRGRTTDTQYF,0,1,1,1
TRBV28,TRBJ2-5,CASSPKEGRKETQYF,0,1,1,1
TRBV12-3/4,TRBJ1-5,CASSTGVGSNQPQHF,0,1,1,1
TRBV2,TRBJ2-7,CASSNRLAGVYEQYF,0,1,1,1
TRBV11-2,TRBJ2-7,CASSFSQGNNYEQYF,0,1,1,1
TRBV13,TRBJ2-3,CASSFGLADTDTQYF,0,1,1,1
TRBV7-9,TRBJ2-3,CASSFMGQSTDTQYF,0,1,1,1
TRBV11-2,TRBJ1-1,CASSLLRGSGTEAFF,0,1,1,1
TRBV7-2,TRBJ2-7,CASSLVAGSSYEQYF,0,1,1,1
TRBV7-2,TRBJ2-3,CASSLGGMNTDTQYF,0,1,1,1
TRBV7-2,TRBJ2-1,CASSLGGTLSNEQFF,0,1,1,1
TRBV5-6,TRBJ2-5,CASSLGRAVQETQYF,0,1,1,1
TRBV5-6,TRBJ2-7,CASSLDSRRAYEQYF,0,1,1,1
TRBV7-9,TRBJ2-7,CASSLVSGRVYEQYF,0,1,1,1
TRBV7-2,TRBJ2-1,CASSLGRLGYNEQFF,0,1,1,1
TRBV7-6,TRBJ2-1,CASSLGQGTYNEQFF,0,1,1,1
TRBV11-2,TRBJ1-1,CASSLDFWGNTEAFF,0,1,1,1
TRBV7-3,TRBJ2-1,CASSLMYGTYNEQFF,0,1,1,1
TRBV7-9,TRBJ2-7,CASSLSAGAQYEQYF,0,1,1,1
TRBV13,TRBJ2-4,CASSYRVGAKNIQYF,0,1,1,1
TRBV5-6,TRBJ1-3,CASSLRTYSGNTIYF,0,1,1,1
TRBV9,TRBJ2-1,CASSLRRTLADEQFF,0,1,1,1
TRBV3-1,TRBJ2-7,CASSPAAGTYYEQYF,0,1,1,1
TRBV28,TRBJ2-5,CASSPGGAGGETQYF,0,1,1,1
TRBV7-8,TRBJ1-6,CASSPRTGLPSPLHF,0,1,1,1
TRBV7-2,TRBJ2-1,CASSRRAGGGNEQFF,0,1,1,1
TRBV7-9,TRBJ2-1,CASSQGLAGVSEQFF,0,1,1,1
TRBV4-2,TRBJ2-1,CASSQDLRGGNEQFF,0,1,1,1
TRBV14,TRBJ2-5,CASSQDGRREETQYF,0,1,1,1
TRBV6-2/3/5/6,TRBJ2-7,CASSVGTGRHYEQYF,0,1,1,1
TRBV28,TRBJ2-1,CASSVGLGNRNEQFF,0,1,1,1
TRBV9,TRBJ2-1,CASSVDAGGWNEQFF,0,1,1,1
TRBV6-2/3/5/6,TRBJ2-1,CASRGGTSWDNEQFF,0,1,1,1
TRBV2,TRBJ2-5,CASRGTAGGQETQYF,0,1,1,1
TRBV7-2,TRBJ2-7,CASRTRDSRQYEQYF,0,1,1,1
TRBV6-2/3/5/6,TRBJ2-7,CASRTLARSSYEQYF,0,1,1,1
TRBV2,TRBJ2-7,CASRLDRGLGIEQYL,0,2,1,2
TRBV7-2,TRBJ2-1,CASRQTGSSYNEQFF,0,1,1,1
TRBV5-1,TRBJ2-2,CASSLSQGYTGELFF,0,1,1,1
TRBV5-1,TRBJ2-2,CASSLRSGDTGELFF,0,1,1,1
TRBV5-1,TRBJ2-7,CASSLGDSSSYEQYF,0,1,1,1
TRBV5-1,TRBJ2-3,CASSLERAGTDTQYF,0,1,1,1
TRBV5-1,TRBJ2-2,CASSLTTGSTGELFF,0,1,1,1
TRBV5-1,TRBJ1-1,CASSSNSQMNTEAFF,0,1,1,1
TRBV5-1,TRBJ2-3,CASSLGTHSTDTQYF,0,1,1,1
TRBV5-1,TRBJ2-2,CASSPGTVSTGELFF,0,1,1,1
TRBV5-1,TRBJ2-7,CASSRDLAANYEQYF,0,1,1,1
TRBV5-1,TRBJ1-6,CASSQSWARNSPLHF,0,1,1,1
TRBV5-1,TRBJ2-1,CASSETSGSGNEQFF,0,1,1,1
TRBV5-1,TRBJ2-7,CASSEGLAATYEQYF,0,1,1,1
TRBV5-1,TRBJ2-7,CASRPGTSGTYEQYF,0,1,1,1
TRBV20-1,TRBJ2-3,CSATPSGSESDTQYF,0,1,1,1
TRBV20-1,TRBJ2-7,CSARQGGTISYEQYF,0,1,1,1
TRBV20-1,TRBJ2-1,CSARDFGGSYNEQFF,0,1,1,1
TRBV20-1,TRBJ2-7,CSARDGKRETHEQYF,0,1,1,1
TRBV29-1,TRBJ2-1,CSVGKGLAFAHEQFF,0,1,1,1
TRBV29-1,TRBJ2-2,CSVGPSGRNTGELFF,0,1,1,1
TRBV29-1,TRBJ2-7,CSVRVGLAGGREQYF,0,1,1,1
TRBV30,TRBJ1-1,CAWSVKGVPPEAFF,0,1,1,1
TRBV10-3,TRBJ2-7,CAISDEKGGDEQYF,0,1,1,1
TRBV10-3,TRBJ2-5,CAISTGKDGETPYF,0,1,1,1
TRBV24-1,TRBJ2-3,CATSDSGTADTQYF,0,1,1,1
TRBV18,TRBJ1-5,CASGTGFSNQPQHF,0,1,1,1
TRBV19,TRBJ2-2,CASGRDTPPGELFF,0,1,1,1
TRBV19,TRBJ1-1,CASMEGFGETEAFF,0,1,1,1
TRBV19,TRBJ2-3,CASTAQGAGDTQYF,0,2,1,2
TRBV19,TRBJ1-1,CASSARGRITEAFF,0,1,1,1
TRBV19,TRBJ2-5,CASSITGTAETQYF,0,1,1,1
TRBV19,TRBJ1-1,CASSLRGPNTEAFF,0,1,1,1
TRBV18,TRBJ1-1,CASSPDWANTEAFF,0,1,1,1
TRBV18,TRBJ2-7,CASSRLVGSYEQYF,0,1,1,1
TRBV6-2/3/5/6,TRBJ1-5,CASVPGQGDQPQHF,0,1,1,1
TRBV12-3/4,TRBJ1-2,CASSLRTFNYGYTF,0,2,1,2
TRBV12-3/4,TRBJ1-1,CASSSPHLGTEAFF,0,1,1,1
TRBV11-2,TRBJ2-1,CASSSDDYGSEQFF,0,1,1,1
TRBV6-2/3/5/6,TRBJ2-3,CASSYAAGADTQYF,0,1,1,1
TRBV12-3/4,TRBJ1-1,CASSPTTANTEAFF,0,1,1,1
TRBV12-3/4,TRBJ2-7,CASSRQGGGYEQYF,0,1,1,1
TRBV12-3/4,TRBJ2-5,CASSQRGYEETQYF,0,1,1,1
TRBV2,TRBJ2-1,CASSASTSRYEQFF,0,1,1,1
TRBV25-1,TRBJ2-2,CASSERGSTGELFF,0,1,1,1
TRBV2,TRBJ1-1,CASSEEQGATEAFF,0,1,1,1
TRBV7-3,TRBJ2-1,CASSFAGQVNEQFF,0,1,1,1
TRBV5-5,TRBJ2-5,CASSLLAGEETQYF,0,1,1,1
TRBV5-6,TRBJ2-5,CASSLHSPGETQYF,0,1,1,1
TRBV5-5,TRBJ2-7,CASSLAAGVYEQYF,0,1,1,1
TRBV11-2,TRBJ2-3,CASSLSWTGDTQYF,0,1,1,1
TRBV11-2,TRBJ1-1,CASSLGAANTEASF,0,1,1,1
TRBV7-8,TRBJ1-4,CASSLGGANEKLFF,0,1,1,1
TRBV7-8,TRBJ1-1,CASSLDRGGTEAFF,0,2,1,2
TRBV7-9,TRBJ2-1,CASSLEWARGEQFF,0,1,1,1
TRBV6-2/3/5/6,TRBJ2-3,CASSLPGTVDTQYF,0,1,1,1
TRBV27,TRBJ2-3,CASSLGQTTDTQYF,0,1,1,1
TRBV14,TRBJ1-4,CASSPTSTNEKLFF,0,1,1,1
TRBV7-2,TRBJ2-2,CASSPRRNTGELFF,0,1,1,1
TRBV5-4,TRBJ2-3,CASSPGHGTDTQYF,0,1,1,1
TRBV7-9,TRBJ2-2,CASSPTGINGELFF,0,1,1,1
TRBV7-9,TRBJ1-2,CASSPGSGFYGYTF,0,1,1,1
TRBV5-4,TRBJ2-2,CASSPDRGFGELFF,0,1,1,1
TRBV7-3,TRBJ2-2,CASSRDGNTGELFF,0,1,1,1
TRBV7-9,TRBJ2-7,CASSHWDRVYEQYF,0,1,1,1
TRBV14,TRBJ2-2,CASSQAVQAGELFF,0,1,1,1
TRBV3-1,TRBJ1-3,CASSQGDRGNTIYF,0,1,1,1
TRBV3-1,TRBJ2-1,CASSQDLGGDEQFF,0,1,1,1
TRBV9,TRBJ1-4,CASSADSGNEKLFF,0,2,1,2
TRBV6-4,TRBJ2-7,CASSGGVFSYEQYF,0,1,1,1
TRBV3-1,TRBJ2-3,CASSKASEGDTQYF,0,1,1,1
TRBV28,TRBJ2-1,CASLLAGSYSEQFF,0,1,1,1
TRBV5-1,TRBJ2-3,CASSQQGIPDTQYF,0,2,1,2
TRBV5-1,TRBJ2-1,CASSLVPGASEQFF,0,1,1,1
TRBV5-1,TRBJ2-3,CASSLSQGIDTQYF,0,1,1,1
TRBV5-1,TRBJ2-7,CASSHGQGAYEQYF,0,1,1,1
TRBV4-1,TRBJ2-7,CASSQATGVYEQYF,0,1,1,1
TRBV5-1,TRBJ2-2,CASSTSDRIGELFF,0,1,1,1
TRBV5-1,TRBJ1-1,CASSRYRVTAEAFF,0,1,1,1
TRBV10-2,TRBJ2-5,CASRALAGEETQYF,0,1,1,1
TRBV20-1,TRBJ2-1,CSAAGDSSYNEQFF,0,1,1,1
TRBV20-1,TRBJ2-1,CSARTAVGVNEQFF,0,1,1,1
TRBV20-1,TRBJ2-5,CSARGSATQETQYF,0,1,1,1
TRBV20-1,TRBJ2-5,CSARDMAGEETQYF,0,1,1,1
TRBV20-1,TRBJ2-3,CSAREGSRGDTQYF,0,1,1,1
TRBV29-1,TRBJ2-3,CSVVVAAHTDTQYF,0,1,1,1
TRBV29-1,TRBJ2-4,CSVGDRESKNIQYF,0,1,1,1
TRBV29-1,TRBJ2-3,CSVGTHTSTDTQYF,0,1,1,1
TRBV29-1,TRBJ1-5,CSVGTDSRDQPQHF,0,1,1,1
TRBV29-1,TRBJ1-1,CSVEASARDTEAFF,0,1,1,1
TRBV29-1,TRBJ2-1,CSVEDLRAANEQFF,0,1,1,1
TRBV29-1,TRBJ2-1,CSVIPARALNEQFF,0,1,1,1
TRBV29-1,TRBJ2-5,CSVPDRETQETQYF,0,1,1,1
TRBV29-1,TRBJ2-3,CSVKRAGETDTQYF,0,1,1,1
TRBV29-1,TRBJ2-3,CSADPGLAGEMQYF,0,1,1,1
TRBV30,TRBJ1-4,CAWTRHISEKLFF,0,1,1,1
TRBV10-3,TRBJ2-7,CAISESRAEGQYF,0,1,1,1
TRBV19,TRBJ2-5,CASSIQIQETQYF,0,1,1,1
TRBV18,TRBJ2-1,CASSPSTYNEQFF,0,1,1,1
TRBV18,TRBJ1-5,CASCQGEDQPQHF,0,1,1,1
TRBV27,TRBJ2-1,CASVWGTYNEQFF,0,1,1,1
TRBV14,TRBJ2-5,CASGGSGQETQYF,0,1,1,1
TRBV12-3/4,TRBJ2-3,CASEGGGADTQYF,0,1,1,1
TRBV6-2/3/5/6,TRBJ2-5,CASTYGGMETQYF,0,1,1,1
TRBV7-2,TRBJ2-3,CASTGGRTDTQYF,0,1,1,1
TRBV12-3/4,TRBJ2-6,CASTISGANVLTF,0,1,1,1
TRBV6-2/3/5/6,TRBJ1-1,CASSLGQNTEAFF,0,1,1,1
TRBV28,TRBJ2-7,CASSLGTGDEQYF,0,1,1,1
TRBV6-2/3/5/6,TRBJ2-6,CASSYSGGPVLTF,0,1,1,1
TRBV12-3/4,TRBJ2-2,CASSLGGPGELFF,0,1,1,1
TRBV12-3/4,TRBJ2-1,CASSRTESVEQFF,0,1,1,1
TRBV2,TRBJ1-1,CASSVGGHTEAFF,0,1,1,1
TRBV12-3/4,TRBJ1-6,CASSGLDHSPLHF,0,1,1,1
TRBV2,TRBJ2-4,CASSDTNKNIQYF,0,2,1,2
TRBV2,TRBJ2-5,CASSERLGETQYF,0,1,1,1
TRBV3-1,TRBJ2-3,CASSEPSTDTQYF,0,1,1,1
TRBV5-6,TRBJ2-1,CASSFQTSNEQFF,0,1,1,1
TRBV11-3,TRBJ2-5,CASSFGQQETQYF,0,1,1,1
TRBV7-2,TRBJ2-3,CASSLISEDTQYF,0,1,1,1
TRBV7-3,TRBJ2-5,CASSLTREETQYF,0,1,1,1
TRBV7-9,TRBJ1-4,CASSSDRNEKLFF,0,1,1,1
TRBV11-3,TRBJ2-7,CASSWRAQGEQYF,0,1,1,1
TRBV6-2/3/5/6,TRBJ1-1,CASSYGRKTEAFF,0,1,1,1
TRBV5-4,TRBJ2-1,CASSPRGSGSTFF,0,1,1,1
TRBV7-8,TRBJ2-7,CASSPGYGNEQYF,0,1,1,1
TRBV5-4,TRBJ2-2,CASSPKGPGELFF,0,1,1,1
TRBV7-2,TRBJ1-1,CASSRSPNTEAFF,0,2,1,2
TRBV2,TRBJ2-1,CASSRERDNEQFF,0,1,1,1
TRBV7-3,TRBJ2-2,CASSQAGDGELFF,0,1,1,1
TRBV3-1,TRBJ2-7,CASSQARGSEQYF,0,1,1,1
TRBV14,TRBJ2-5,CASSQGNKETQYF,0,1,1,1
TRBV6-2/3/5/6,TRBJ1-5,CASSVGEGQPQHF,0,1,1,1
TRBV9,TRBJ2-1,CASSVGLAGEEFF,0,1,1,1
TRBV7-2,TRBJ2-2,CASSGTGTGELFF,0,1,1,1
TRBV7-9,TRBJ2-2,CASSTDNTGELFF,0,1,1,1
TRBV11-1,TRBJ2-5,CASSKASQETQYF,0,1,1,1
TRBV12-3/4,TRBJ2-1,CASRWADLNEQFF,0,1,1,1
TRBV27,TRBJ2-1,CASRQERYNEQFF,0,1,1,1
TRBV5-1,TRBJ2-7,CASSFPQGNEQYF,0,1,1,1
TRBV10-2,TRBJ2-3,CASSSGSTDTQYF,0,1,1,1
TRBV5-1,TRBJ1-2,CASSSGALGGYTF,0,1,1,1
TRBV5-1,TRBJ2-3,CASSQTSTDTQYF,0,1,1,1
TRBV5-1,TRBJ2-2,CASRRRATGELFF,0,1,1,1
TRBV29-1,TRBJ2-7,CGVVGTSSYEQYF,0,1,1,1
TRBV20-1,TRBJ2-1,CSVRGRSYNEQFF,0,1,1,1
TRBV20-1,TRBJ2-5,CSASREFRETQYF,0,1,1,1
TRBV20-1,TRBJ2-7,CSARVDSSYEQYF,0,2,1,2
TRBV20-1,TRBJ2-1,CSARDRGWGEQFF,0,1,1,1
TRBV20-1,TRBJ2-1,CSARRFGGNEQFF,0,1,1,1
TRBV20-1,TRBJ2-1,CSAPGQGFDEQFF,0,1,1,1
TRBV20-1,TRBJ2-3,CSSRTFSTDTQYF,0,1,1,1
TRBV29-1,TRBJ1-5,CSVLGQGDQPQHF,0,1,1,1
TRBV29-1,TRBJ2-1,CSVDGASYNEQFF,0,1,1,1
TRBV29-1,TRBJ2-5,CSVEVRPRETQYF,0,1,1,1
TRBV29-1,TRBJ1-2,CSAEAGTRGGYTF,0,1,1,1
TRBV29-1,TRBJ2-5,CSGTGLGGETQYF,0,1,1,1
TRBV5-1,TRBJ1-1,RASSSTTGYQAFF,0,1,1,1
TRBV19,TRBJ1-2,CASSTRQAGYTF,0,1,1,1
TRBV19,TRBJ2-5,CASSTDQETQYF,0,1,1,1
TRBV28,TRBJ2-1,CASTIGHTEQFF,0,1,1,1
TRBV3-1,TRBJ2-5,CASSQSWETQYF,0,1,1,1
TRBV5-4,TRBJ2-7,CASSLERDEQYF,0,1,1,1
TRBV5-6,TRBJ1-5,CASSLFGQHQHF,0,1,1,1
TRBV7-6,TRBJ2-1,CASSLLRGPKFF,0,1,1,1
TRBV7-9,TRBJ2-2,CASSLARQGLFF,0,1,1,1
TRBV6-2/3/5/6,TRBJ2-1,CASSSSGSGQFF,0,1,1,1
TRBV3-1,TRBJ1-5,CASSQGGLPQHF,0,1,1,1
TRBV5-4,TRBJ2-3,CASSAVSDTQYF,0,1,1,1
TRBV11-2,TRBJ1-1,CASSATGFGAFF,0,1,1,1
TRBV11-2,TRBJ1-2,CASSNRGGGYTF,0,1,1,1
TRBV6-2/3/5/6,TRBJ1-1,CASRPSDRGAFF,0,1,1,1
TRBV5-1,TRBJ1-1,CASSLGGDGALF,0,1,1,1
TRBV5-1,TRBJ2-3,CASSLTTDTQYF,0,1,1,1
TRBV20-1,TRBJ2-3,CSAHTGADTQYF,0,1,1,1
TRBV20-1,TRBJ2-3,CSARRLEDTQYF,0,1,1,1
TRBV29-1,TRBJ2-3,CSQSREADTQYF,0,1,1,1
TRBV29-1,TRBJ1-1,CSVGQAETEAFF,0,1,1,1
TRBV29-1,TRBJ2-7,CSAFEYGYEQYF,0,1,1,1
TRBV29-1,TRBJ2-7,CSILLGTYEQYF,0,1,1,1
TRBV28,TRBJ2-7,RASKGRVEDQYF,0,1,1,1
TRBV30,TRBJ1-4,CAWGTDEKLFF,0,1,1,1
TRBV28,TRBJ2-7,CAIGQTHQQYF,0,1,1,1
TRBV7-9,TRBJ2-1,CASGGYNEQFF,0,1,1,1
TRBV2,TRBJ1-5,CASGLDQPQHF,0,1,1,1
TRBV2,TRBJ2-1,CASMSPGGQFF,0,1,1,1
TRBV6-2/3/5/6,TRBJ2-3,CASSPQPTQYF,0,1,1,1
TRBV3-1,TRBJ2-1,CASSHVNEQFF,0,1,1,1
TRBV3-1,TRBJ2-7,CASSQLYEQYF,0,1,1,1
TRBV12-3/4,TRBJ2-1,CASRGGNEQFF,0,1,1,1
TRBV20-1,TRBJ2-7,CSAREPHTIIF,0,1,1,1
TRBV20-1,TRBJ1-1,CSAKKDTEAFF,0,1,1,1
TRBV20-1,TRBJ2-5,CSAEPTETQYF,0,1,1,1
TRBV20-1,TRBJ2-5,CSGWGTETQYF,0,1,1,1
TRBV20-1,TRBJ2-3,CSARPLTQYF,0,1,1,1
TRBV5-6,TRBJ1-5,CASSLAGQSSNQPRHF,0,1,1,1
TRBV5-4,TRBJ1-1,CASSLGGGRGNTEAFF,0,1,1,1
TRBV2,TRBJ1-1,CASVPGSGPGTEAFF,0,1,1,1
TRBV5-1,TRBJ2-7,CASSLALGIYYEQYF,0,1,1,1
TRBV18,TRBJ1-1,CASSIERSNTEAFF,0,1,1,1
TRBV2,TRBJ2-2,CASTWAQNTGELFF,0,1,1,1
TRBV12-3/4,TRBJ2-3,CASSLGVGADTQYF,0,1,1,1
TRBV29-1,TRBJ2-6,CSVSGPSGANVLTF,0,2,1,2
TRBV29-1,TRBJ2-7,CSVARRTGAYEQYF,0,1,1,1
TRBV28,TRBJ2-5,CASRGQGKATQCF,0,1,1,1
TRBV29-1,TRBJ2-7,CSVAPDRSYEQYF,0,1,1,1
TRBV5-4,TRBJ1-2,CASSPGLSGYTF,0,1,1,1
TRBV27,TRBJ2-1,CASSRRGPGQLAGGLWSYNEQFF,0,1,1,1
TRBV14,TRBJ1-3,CASSQDLVIRGNLFGSGNTIYF,0,1,1,1
TRBV12-3/4,TRBJ1-1,CASSLDMKPPGEAGWSFGAFF,0,1,1,1
TRBV25-1,TRBJ2-3,CASSEYATSGRATGTDTQYF,0,1,1,1
TRBV12-3/4,TRBJ1-5,CASSPSPRFGLGETNQPQHF,0,1,1,1
TRBV5-1,TRBJ2-6,CASSLDRQGALVIATNVLTF,0,1,1,1
TRBV10-3,TRBJ2-2,CAIKGPSSYRDRGPGELFF,0,1,1,1
TRBV18,TRBJ2-3,CASSKFSSSGLSGTDTQYF,0,1,1,1
TRBV19,TRBJ1-1,CASSALPGQGIVIGTEAFF,0,1,1,1
TRBV28,TRBJ2-5,CASVDRGVWAGGFSETQYF,0,1,1,1
TRBV7-9,TRBJ2-1,CASSRLAGGPGGMNNEQFF,0,1,1,1
TRBV7-6,TRBJ2-3,CASSLLGAGLRYSTDTQYF,0,1,1,1
TRBV4-1,TRBJ1-4,CASSQAGPWDRRGDEKLFF,0,1,1,1
TRBV5-1,TRBJ2-2,CASSIAIFKLASNTGELFF,0,1,1,1
TRBV29-1,TRBJ2-6,CSVVFTVNAGGSGANVLTF,0,1,1,1
TRBV19,TRBJ2-5,CASSARGLAETLRETQYF,0,1,1,1
TRBV6-2/3/5/6,TRBJ2-2,CASRITTGTARNTGELFF,0,1,1,1
TRBV28,TRBJ2-7,CASSLLGSGRAGSYEQYF,0,1,1,1
TRBV12-3/4,TRBJ1-1,CASSLARRGWTGNTEAFF,0,1,1,1
TRBV28,TRBJ2-3,CASSQVSASAREADTQYF,0,1,1,1
TRBV6-1,TRBJ1-5,CASSGRNQGQGINQPQHF,0,1,1,1
TRBV7-2,TRBJ2-5,CASSSSIVDSGSRETQYF,0,1,1,1
TRBV5-4,TRBJ2-3,CASRLGGLVAGGTDTQYF,0,1,1,1
TRBV20-1,TRBJ2-1,CSASPILGLAESYNEQFF,0,1,1,1
TRBV12-5,TRBJ2-1,CASGPQGLAVDYNEQFF,0,1,1,1
TRBV4-2,TRBJ2-1,CAGSQVAGTIGNNEQFF,0,1,1,1
TRBV19,TRBJ2-1,CASSTLSGLAVYNEQFF,0,1,1,1
TRBV19,TRBJ1-3,CASSTPRHADSGNTIYF,0,1,1,1
TRBV19,TRBJ2-3,CASSTKTGTSGTDTQYF,0,1,1,1
TRBV18,TRBJ2-1,CASSPYSNGRGDNEQFF,0,1,1,1
TRBV2,TRBJ2-7,CASTRASGRSQSYEQYF,0,1,1,1
TRBV6-2/3/5/6,TRBJ2-5,CASSLSPGQIIGETQYF,0,1,1,1
TRBV12-3/4,TRBJ1-2,CASSLWGLGRKGSGYTF,0,1,1,1
TRBV28,TRBJ2-1,CASSPNTGTSGYNEQFL,0,1,1,1
TRBV6-2/3/5/6,TRBJ2-1,CASSPGAGTSGSFEQFF,0,1,1,1
TRBV2,TRBJ2-1,CASSDPREESQYNEQFF,0,1,1,1
TRBV5-8,TRBJ2-2,CASSFPTSGANTGELFF,0,1,1,1
TRBV7-9,TRBJ2-1,CASSLVLRGRNYNEQFF,0,1,1,1
TRBV7-2,TRBJ2-3,CASSLGIREGPTDTQYF,0,1,1,1
TRBV7-3,TRBJ2-1,CASSLSPAGGVYNEQFF,0,1,1,1
TRBV7-2,TRBJ2-3,CASSYGTGITLTDTQYF,0,1,1,1
TRBV3-1,TRBJ2-1,CASSQVLPGQGVNEQFF,0,1,1,1
TRBV14,TRBJ2-1,CASSQGASGNSCNGQFF,0,1,1,1
TRBV3-1,TRBJ2-1,CASSQGRGGLASGEQFF,0,1,1,1
TRBV14,TRBJ2-1,CASSQDRVSGARLVQFF,0,1,1,1
TRBV7-9,TRBJ2-3,CASSALSQSLSTDTQYF,0,1,1,1
TRBV5-1,TRBJ2-6,CASSSGRISSGANVLTF,0,1,1,1
TRBV5-1,TRBJ2-6,CASSYLAGPSGANVLTF,0,1,1,1
TRBV5-1,TRBJ2-1,CASSPGGLAGAGVMEFF,0,1,1,1
TRBV20-1,TRBJ2-3,CSAMEPSGRAGVHTQYF,0,1,1,1
TRBV20-1,TRBJ2-3,CSARGPGRTGAVDTQYF,0,1,1,1
TRBV20-1,TRBJ2-1,CSARGVGGTSSYNEQFF,0,1,1,1
TRBV20-1,TRBJ2-5,CSARDFKGQGGQETQYF,0,1,1,1
TRBV12-3/4,TRBJ1-5,CAGSSNQGYSNQPQHF,0,1,1,1
TRBV10-3,TRBJ2-3,CAISEGSGLGTDTQYF,0,1,1,1
TRBV24-1,TRBJ2-5,CATSGSGTGNQETQYF,0,1,1,1
TRBV24-1,TRBJ2-1,CATSDLGQSSYNEQFL,0,1,1,1
TRBV19,TRBJ1-5,CASTKRGQNSNQPQHF,0,1,1,1
TRBV19,TRBJ2-1,CASSIRVAGANNEQFF,0,1,1,1
TRBV19,TRBJ2-1,CASSIGFGLAGNEQFF,0,2,1,2
TRBV18,TRBJ1-1,CASSPYTGTGGTEAFF,0,1,1,1
TRBV18,TRBJ2-3,CASSPPKGSGTDTQYF,0,1,1,1
TRBV7-9,TRBJ2-3,CASRQTGTGRADTQHF,0,1,1,1
TRBV7-2,TRBJ2-3,CASTSRGGGPTDTQYF,0,1,1,1
TRBV28,TRBJ2-1,CASTVPGTSAYNEQFF,0,1,1,1
TRBV12-3/4,TRBJ2-3,CASSFSSPTGSDTQYF,0,2,1,2
TRBV6-2/3/5/6,TRBJ2-7,CASSLYGTGGSYEQYF,0,1,1,1
TRBV12-3/4,TRBJ1-5,CASSLKGGISNQPQHF,0,1,1,1
TRBV28,TRBJ2-4,CASSSPFGQGFDIQYF,0,1,1,1
TRBV28,TRBJ2-1,CASSSSYPTFYNEQFF,0,1,1,1
TRBV6-2/3/5/6,TRBJ2-3,CASSSIEGRGPDTQYF,0,1,1,1
TRBV25-1,TRBJ2-7,CASSWAGSKGGYEQYF,0,1,1,1
TRBV6-2/3/5/6,TRBJ2-7,CASSYSVTGGYYEQYF,0,2,1,2
TRBV3-1,TRBJ2-2,CASSPTLAVNTGELFF,0,1,1,1
TRBV12-3/4,TRBJ1-5,CASSPRSLGGNQPQHF,0,1,1,1
TRBV12-3/4,TRBJ2-2,CASSATSGRAHGELFF,0,1,1,1
TRBV10-2,TRBJ2-1,CASSDPWREGYNEQFF,0,1,1,1
TRBV6-4,TRBJ2-1,CASSDGVAGGRDEQFF,0,1,1,1
TRBV10-2,TRBJ2-1,CASSESGTSGKDEQFF,0,1,1,1
TRBV2,TRBJ2-5,CASSEPQGLHQETQYF,0,1,1,1
TRBV5-6,TRBJ2-1,CASSLGLAVMVNEQFF,0,1,1,1
TRBV11-2,TRBJ1-1,CASSLAPRGQNTEAFF,0,1,1,1
TRBV11-2,TRBJ2-3,CASSLALAGGSDTQYF,0,1,1,1
TRBV7-2,TRBJ1-5,CASSLEAGLPDQPQHF,0,1,1,1
TRBV11-2,TRBJ2-3,CASSLTSGVGTDTQYF,0,1,1,1
TRBV7-3,TRBJ2-1,CASSLSLGGTANEQFF,0,1,1,1
TRBV7-8,TRBJ2-5,CASSSGTATGLETQYF,0,1,1,1
TRBV5-6,TRBJ1-1,CASSSAGTVANTEAFF,0,1,1,1
TRBV5-8,TRBJ2-3,CASSPLTFVGTDTQYF,0,1,1,1
TRBV27,TRBJ1-5,CASSPKLTGAEVPQHF,0,1,1,1
TRBV7-7,TRBJ2-1,CASSPGAGRAYNEQFF,0,1,1,1
TRBV11-2,TRBJ2-2,CASSRDSGRFTGELFF,0,1,1,1
TRBV11-2,TRBJ2-1,CASSRGQGTAINEQFF,0,1,1,1
TRBV3-1,TRBJ2-5,CASSQGQGTAGETQYF,0,1,1,1
TRBV3-1,TRBJ2-6,CASSQDSSSGANVLTF,0,1,1,1
TRBV5-5,TRBJ2-7,CASSQNLRDFSYEQYF,0,1,1,1
TRBV7-3,TRBJ2-2,CASSAIPGENTGELFF,0,1,1,1
TRBV6-2/3/5/6,TRBJ2-1,CASSNTQLGGGNEQFF,0,1,1,1
TRBV5-5,TRBJ2-1,CASRRTRLGGGNEQFF,0,1,1,1
TRBV6-2/3/5/6,TRBJ2-2,CASRQGGGRVTGELFF,0,1,1,1
TRBV20-1,TRBJ2-6,CSAPKGGNSGANVLTF,0,1,1,1
TRBV5-1,TRBJ2-1,CASSLWAGETYNEQFF,0,1,1,1
TRBV5-1,TRBJ2-1,CASSLLAGQGNNEQFF,0,1,1,1
TRBV5-1,TRBJ2-1,CASSLLAGEGYNEQFF,0,1,1,1
TRBV5-1,TRBJ2-7,CASSLGGTASSYEQYF,0,1,1,1
TRBV5-1,TRBJ2-1,CASSLDSGSRANEQFF,0,1,1,1
TRBV10-2,TRBJ2-1,CASSLTQGLAGGEQFI,0,1,1,1
TRBV4-1,TRBJ2-7,CASSQGLDRIPYEQYF,0,1,1,1
TRBV4-1,TRBJ2-3,CASSQGLAGRVDTQYF,0,1,1,1
TRBV20-1,TRBJ2-1,CSAPSLLAETYNEQFF,0,1,1,1
TRBV20-1,TRBJ2-5,CSASGAEGSISETQYF,0,1,1,1
TRBV20-1,TRBJ2-7,CSARGGGLADSYEQYF,0,1,1,1
TRBV20-1,TRBJ2-5,CSARDRTHERQETQYF,0,1,1,1
TRBV20-1,TRBJ2-3,CSARDALAASTDTQYF,0,1,1,1
TRBV20-1,TRBJ2-1,CSAPPAGQLSYNEQFF,0,1,1,1
TRBV20-1,TRBJ2-3,CSAGPPGQGSADTQYF,0,1,1,1
TRBV29-1,TRBJ1-3,CSVQGIEDFPGNTIYF,0,1,1,1
TRBV29-1,TRBJ2-6,CSVEGTGDSGANVLTF,0,1,1,1
TRBV29-1,TRBJ2-3,CSVEDESLGGTDTQYF,0,1,1,1
TRBV29-1,TRBJ2-3,CSVETPRGLNTDTQYF,0,1,1,1
TRBV29-1,TRBJ1-5,CSVSGTGGNSNQPQHF,0,1,1,1
TRBV29-1,TRBJ2-3,CSARGLAGGWTDTQYF,0,1,1,1
TRBV29-1,TRBJ2-1,CSGDGQGVGSYNEQFF,0,1,1,1
TRBV18,TRBJ2-1,CVSSPQREWGNEQFF,0,1,1,1
TRBV12-5,TRBJ1-2,CASGLVRLGNYGYTF,0,1,1,1
TRBV30,TRBJ2-5,CAWSARDSPDETQYF,0,1,1,1
TRBV10-3,TRBJ1-6,CAISDMGQDNSPLHF,0,1,1,1
TRBV2,TRBJ2-7,CASRALLILAYEQYF,0,1,1,1
TRBV19,TRBJ1-3,CASSSAANTGNTIYF,0,1,1,1
TRBV19,TRBJ1-5,CASSQDPRANQPQHF,0,1,1,1
TRBV19,TRBJ1-5,CASSISRGRNQPQHF,0,1,1,1
TRBV19,TRBJ2-1,CASSITLAEGNEQFF,0,1,1,1
TRBV19,TRBJ2-7,CASSRAGRFSYEQYF,0,1,1,1
TRBV19,TRBJ1-6,CASSPRGQVYSPLHF,0,1,1,1
TRBV19,TRBJ1-1,CASKTGTGLLPEAFF,0,1,1,1
TRBV6-2/3/5/6,TRBJ1-3,CASFGVGGSGNTIYF,0,1,1,1
TRBV2,TRBJ2-4,CASFKEGRSKNIQYF,0,1,1,1
TRBV18,TRBJ2-7,CASSASYRENYEQYF,0,1,1,1
TRBV7-9,TRBJ2-6,CASSVQGAGANVLTF,0,1,1,1
TRBV12-3/4,TRBJ2-1,CASQHRRLSRNEQFF,0,1,1,1
TRBV12-3/4,TRBJ1-3,CASILGGLTGNTIYF,0,1,1,1
TRBV7-9,TRBJ2-1,CASTPRLVSYNEQFF,0,1,1,1
TRBV7-2,TRBJ2-3,CASTPGLLGGSTQYF,0,1,1,1
TRBV9,TRBJ2-5,CASTMAGGGQETQYF,0,1,1,1
TRBV2,TRBJ2-1,CASTRLAGGGNEQFF,0,2,1,2
TRBV28,TRBJ2-3,CASSFGGRTADTQYF,0,1,1,1
TRBV6-2/3/5/6,TRBJ1-2,CASSFGTGMYYGYTF,0,1,1,1
TRBV7-2,TRBJ2-3,CASSFSGASTDTQYF,0,1,1,1
TRBV12-3/4,TRBJ2-3,CASSSRESSTDTQYF,0,1,1,1
TRBV12-3/4,TRBJ1-2,CASSSPGVANYGYTF,0,1,1,1
TRBV2,TRBJ2-1,CASSLSGSRRNEQFF,0,1,1,1
TRBV12-3/4,TRBJ2-7,CASSPPGTGPAEQYF,0,1,1,1
TRBV2,TRBJ2-3,CASSVRGSSTDTQYF,0,1,1,1
TRBV6-4,TRBJ2-1,CASSGLTSSYNEQFF,0,1,1,1
TRBV6-2/3/5/6,TRBJ2-7,CASSTLRDGAYEQYF,0,1,1,1
TRBV11-3,TRBJ2-1,CASSFSGTRYNEQCF,0,1,1,1
TRBV5-5,TRBJ2-5,CASSFSASPQETQYF,0,2,1,2
TRBV11-2,TRBJ2-1,CASSFGGSSYNEQFF,0,2,1,2
TRBV5-4,TRBJ2-2,CASSFPGQRSRELFF,0,1,1,1
TRBV7-2,TRBJ2-4,CASSFGGSTKNIQYF,0,1,1,1
TRBV11-2,TRBJ2-3,CASSFSGPRTDTQYF,0,1,1,1
TRBV5-4,TRBJ2-5,CASSLWLRGQETQYF,0,1,1,1
TRBV5-4,TRBJ2-3,CASSLPSGVSDTQYF,0,1,1,1
TRBV5-4,TRBJ2-1,CASSLVEASYNEQFF,0,1,1,1
TRBV5-4,TRBJ2-5,CASSLAGERGETQYF,0,1,1,1
TRBV7-9,TRBJ2-2,CASSLAGVGTGELFF,0,1,1,1
TRBV5-6,TRBJ2-3,CASSLSGRLSDTQYF,0,1,1,1
TRBV5-4,TRBJ2-3,CASSLRQGGTDTQYF,0,1,1,1
TRBV7-2,TRBJ2-7,CASSLHRDRTYEQYF,0,1,1,1
TRBV7-9,TRBJ2-7,CASSLASAGEYEQYF,0,1,1,1
TRBV7-2,TRBJ2-1,CASSLARILINEQFF,0,1,1,1
TRBV7-9,TRBJ2-1,CASSLASTALDEQFF,0,1,1,1
TRBV7-2,TRBJ2-1,CASSLGDRRTHEQFF,0,1,1,1
TRBV7-8,TRBJ2-3,CASSLDIRGPDTQYF,0,1,1,1
TRBV7-2,TRBJ2-1,CASSLSGVGYNEQFF,0,1,1,1
TRBV7-9,TRBJ2-1,CASSLRTSGYNEQFF,0,1,1,1
TRBV11-3,TRBJ2-3,CASSLNRGAAHTQYF,0,1,1,1
TRBV7-9,TRBJ2-1,CASSSAGTPTNEQFF,0,1,1,1
TRBV5-4,TRBJ2-7,CASSSTLGTGVEQYF,0,1,1,1
TRBV7-6,TRBJ1-3,CASSSYRGMRDTIYF,0,1,1,1
TRBV9,TRBJ2-5,CASSSQDRGLGTQCF,0,1,1,1
TRBV13,TRBJ2-1,CASSSAGGPVNEQFF,0,1,1,1
TRBV7-2,TRBJ2-5,CASSYTGLAGGNQYF,0,1,1,1
TRBV7-9,TRBJ2-5,CASSYGSGTQETQYF,0,2,1,2
TRBV5-6,TRBJ2-7,CASSLGLAGRYEQYF,0,1,1,1
TRBV6-2/3/5/6,TRBJ2-7,CASSPRKVLAYEQYF,0,1,1,1
TRBV7-9,TRBJ1-3,CASSPQGISGNTIYF,0,1,1,1
TRBV6-2/3/5/6,TRBJ1-5,CASSPGQGGNQPQHF,0,1,1,1
TRBV7-9,TRBJ2-3,CASSPDPDYTDTQYF,0,1,1,1
TRBV7-9,TRBJ1-2,CASSPFDRPNYGYTF,0,1,1,1
TRBV7-2,TRBJ2-7,CASSRSGTSSYEQYF,0,1,1,1
TRBV5-8,TRBJ2-3,CASSRGTAGTDTQYF,0,1,1,1
TRBV19,TRBJ2-7,CASSRDRGLWNEQYF,0,1,1,1
TRBV28,TRBJ2-7,CASSRAGVTSYEQYF,0,1,1,1
TRBV3-1,TRBJ1-3,CASSHRDNSANTIYF,0,1,1,1
TRBV3-1,TRBJ2-5,CASSQGLAGQETQYF,0,1,1,1
TRBV3-1,TRBJ2-1,CASSQVLSIPGGQFF,0,1,1,1
TRBV3-1,TRBJ2-7,CASSQDFGQGAEQYF,0,1,1,1
TRBV5-6,TRBJ2-3,CASSQTSEGGYTQYF,0,1,1,1
TRBV7-9,TRBJ2-5,CASSVRDRYQETQYF,0,1,1,1
TRBV5-4,TRBJ2-3,CASSVEGGRPDTQYF,0,2,1,2
TRBV9,TRBJ2-5,CASSVRTSGQETQYF,0,1,1,1
TRBV9,TRBJ2-7,CASSVGIGQTYEQYF,0,1,1,1
TRBV14,TRBJ2-3,CASSASGLATDTQYF,0,1,1,1
TRBV7-2,TRBJ2-6,CASSGALSGANVLTF,0,1,1,1
TRBV7-9,TRBJ2-2,CASSDPTGGPGELFF,0,1,1,1
TRBV2,TRBJ2-3,CASSDPGGAADTQYF,0,1,1,1
TRBV6-1,TRBJ1-5,CASSDRGYSNQPQHF,0,1,1,1
TRBV5-5,TRBJ2-1,CASSETGGSYNEQFF,0,1,1,1
TRBV6-4,TRBJ2-6,CASRRQGVGANVLTF,0,1,1,1
TRBV6-2/3/5/6,TRBJ1-5,CTSSQGTTSNQPQHF,0,1,1,1
TRBV10-1,TRBJ1-2,CASPEVPGTVYGYTF,0,1,1,1
TRBV5-1,TRBJ1-4,CASSWEGTGREKLFF,0,1,1,1
TRBV10-1,TRBJ2-3,CASSASGGGTDTQYF,0,1,1,1
TRBV5-1,TRBJ2-1,CASSLLTTPNNEQFF,0,1,1,1
TRBV5-1,TRBJ1-1,CASSLPTGDNTEAFF,0,1,1,1
TRBV5-1,TRBJ2-7,CASSLRSSGIYEQYF,0,1,1,1
TRBV5-1,TRBJ2-7,CASSLAGTNAYEQYF,0,1,1,1
TRBV5-1,TRBJ2-2,CASSYSLGNTGELFF,0,1,1,1
TRBV5-1,TRBJ2-5,CASSPGQSLKETQYF,0,1,1,1
TRBV5-1,TRBJ2-1,CASSQGQGNYNEQFF,0,1,1,1
TRBV5-1,TRBJ2-1,CASSVLAGGNNEQFF,0,1,1,1
TRBV5-1,TRBJ2-1,CASSAASGRAHEQFF,0,1,1,1
TRBV10-2,TRBJ2-3,CASRGHSGRTDTQYF,0,1,1,1
TRBV5-1,TRBJ2-2,CARSLDTGQTGELFF,0,1,1,1
TRBV20-1,TRBJ2-3,CSASPAGRDTDTQYF,0,1,1,1
TRBV20-1,TRBJ1-1,CSARVGRTLYTEAFF,0,1,1,1
TRBV20-1,TRBJ2-1,CSARGGTSGRNEQFF,0,2,1,2
TRBV20-1,TRBJ2-3,CSARGGGSLADTQYF,0,1,1,1
TRBV20-1,TRBJ2-1,CSARDPARGYNEQFF,0,1,1,1
TRBV20-1,TRBJ2-1,CSARDRLGGLNEQFF,0,1,1,1
TRBV20-1,TRBJ2-5,CSARDGRAYQETQYF,0,1,1,1
TRBV20-1,TRBJ1-5,CSAREIGNSNQPQHF,0,1,1,1
TRBV20-1,TRBJ1-1,CSASDRTALNTEAFF,0,1,1,1
TRBV20-1,TRBJ2-1,CSATRAGEWYNEQFF,0,1,1,1
TRBV29-1,TRBJ1-5,CSVSQGLLGNQPQHF,0,1,1,1
TRBV29-1,TRBJ2-1,CSVPPTGADYNEQFF,0,1,1,1
TRBV29-1,TRBJ2-3,CSVVPRRGATDTQYF,0,1,1,1
TRBV29-1,TRBJ2-3,CSVVRQGNPTDTQYF,0,1,1,1
TRBV29-1,TRBJ2-7,CSVEDQRVTFGEQYF,0,1,1,1
TRBV29-1,TRBJ2-3,CSVEDIAGVTDTQYF,0,1,1,1
TRBV29-1,TRBJ2-1,CSVERRGRSYNEQFF,0,1,1,1
TRBV19,TRBJ2-1,RASRTGLAGNNEQFF,0,1,1,1
TRBV12-5,TRBJ2-5,CASGLPGGRETQYF,0,1,1,1
TRBV12-5,TRBJ2-1,CASGLGGLGNEQFF,0,1,1,1
TRBV30,TRBJ1-6,CAWTPDRGSSPLHF,0,1,1,1
TRBV30,TRBJ2-3,CAWSATTSTDTQYF,0,1,1,1
TRBV30,TRBJ2-2,CAWSRDAITGELFF,0,1,1,1
TRBV10-3,TRBJ2-1,CAISGTSGNAEQFF,0,1,1,1
TRBV24-1,TRBJ2-7,CATSDLGTAGEQYF,0,1,1,1
TRBV24-1,TRBJ2-1,CATSDSLAGDVQFF,0,1,1,1
TRBV19,TRBJ2-1,CASSSGGSHNEQFF,0,1,1,1
TRBV4-2,TRBJ2-2,CASVSKVGTGELFF,0,1,1,1
TRBV19,TRBJ2-1,CASSSRDRAGEQFF,0,1,1,1
TRBV28,TRBJ2-3,CASSRGLAADTQYF,0,1,1,1
TRBV18,TRBJ2-3,CASSFPQGTDTQYF,0,2,1,2
TRBV18,TRBJ2-7,CASSPPSGANEQYF,0,1,1,1
TRBV18,TRBJ2-1,CASSPGNSHNEQFF,0,1,1,1
TRBV18,TRBJ2-5,CASSPNPGKETQYF,0,1,1,1
TRBV5-4,TRBJ2-3,CASRRTSVGNTQYF,0,1,1,1
TRBV7-2,TRBJ2-2,CASATGQNTGELFF,0,1,1,1
TRBV5-4,TRBJ2-2,CASGVNLGTGELFF,0,1,1,1
TRBV13,TRBJ2-7,CASTKGRGPYEQYF,0,1,1,1
TRBV6-2/3/5/6,TRBJ1-2,CASTALRAGYGYTF,0,1,1,1
TRBV28,TRBJ2-7,CASTELQGAREQYF,0,1,1,1
TRBV6-2/3/5/6,TRBJ1-5,CASTTGYGNQPQHF,0,1,1,1
TRBV2,TRBJ2-6,CASTGGKGANVLTF,0,1,1,1
TRBV27,TRBJ2-7,CASSFDRGTYEQYF,0,2,1,2
TRBV12-3/4,TRBJ2-7,CASSFWQGEDEQYF,0,1,1,1
TRBV6-2/3/5/6,TRBJ2-1,CASSFGTSGRRQFF,0,1,1,1
TRBV28,TRBJ2-7,CASSFGTRSYEQYF,0,1,1,1
TRBV6-2/3/5/6,TRBJ2-4,CASSFSGSKNIQYF,0,1,1,1
TRBV12-3/4,TRBJ2-1,CASSLDPEDDEQFF,0,2,1,2
TRBV6-2/3/5/6,TRBJ1-1,CASSLAGTGIGAFF,0,1,1,1
TRBV28,TRBJ2-7,CASSLGGQSYEQYF,0,1,1,1
TRBV6-2/3/5/6,TRBJ2-7,CASSLTPGLYEQYF,0,1,1,1
TRBV6-2/3/5/6,TRBJ1-1,CASSSSWTDTEAFF,0,1,1,1
TRBV12-3/4,TRBJ2-2,CASSSQGATGELFF,0,1,1,1
TRBV28,TRBJ2-5,CASSSPDRQETQYF,0,1,1,1
TRBV6-2/3/5/6,TRBJ2-7,CASSSGQSSYEQYL,0,1,1,1
TRBV6-2/3/5/6,TRBJ2-3,CASSYTHRADTQYF,0,1,1,1
TRBV12-3/4,TRBJ2-3,CASSPYGGSDTQYF,0,1,1,1
TRBV6-2/3/5/6,TRBJ2-6,CASSVLSGANVLTF,0,1,1,1
TRBV2,TRBJ2-7,CASSASRTHYEQYF,0,1,1,1
TRBV12-3/4,TRBJ2-7,CASSALAGGYEQYF,0,1,1,1
TRBV6-1,TRBJ2-1,CASSASGRYNEQFF,0,1,1,1
TRBV2,TRBJ1-2,CASSGALQGQGYTF,0,1,1,1
TRBV2,TRBJ1-5,CASSDLHYGQPQHF,0,1,1,1
TRBV6-4,TRBJ1-5,CASSDSSTNQPQHF,0,1,1,1
TRBV2,TRBJ1-2,CASSDWTDIDGYTF,0,1,1,1
TRBV6-1,TRBJ2-6,CASSESSGANVLTF,0,1,1,1
TRBV7-8,TRBJ2-1,CASSFGGASQNQFF,0,1,1,1
TRBV7-9,TRBJ2-5,CASSFRQGQETQYF,0,1,1,1
TRBV5-6,TRBJ2-7,CASSLLSGRGEQYF,0,1,1,1
TRBV5-4,TRBJ2-3,CASSLAGGTDTQYF,0,2,1,2
TRBV6-2/3/5/6,TRBJ2-5,CASSLGLSQETQYF,0,1,1,1
TRBV7-9,TRBJ2-3,CASSLTISTDTQYF,0,1,1,1
TRBV7-3,TRBJ2-2,CASSLSSNTGELFF,0,1,1,1
TRBV7-2,TRBJ2-3,CASSLAYGTDTQYF,0,1,1,1
TRBV7-9,TRBJ2-7,CASSYSTGVHEQYF,0,1,1,1
TRBV3-1,TRBJ1-1,CASSLRQGGTEAFF,0,1,1,1
TRBV4-2,TRBJ2-3,CASSLIRGPDTQYF,0,1,1,1
TRBV7-9,TRBJ2-4,CASSPEGQGNIQYF,0,1,1,1
TRBV3-1,TRBJ2-7,CASSPGLVQYEQYF,0,1,1,1
TRBV7-9,TRBJ1-1,CASSPGQGEVEAFF,0,1,1,1
TRBV3-1,TRBJ2-5,CASSPDRVQETQYF,0,1,1,1
TRBV11-3,TRBJ1-1,CASSHRGRDTEAFF,0,1,1,1
TRBV7-9,TRBJ2-7,CASSHDRGPTEQYF,0,1,1,1
TRBV3-1,TRBJ2-5,CASSQRDREETQYF,0,1,1,1
TRBV14,TRBJ2-7,CASSQVGGRREQYF,0,1,1,1
TRBV3-1,TRBJ2-7,CASSQEERGGEQYF,0,1,1,1
TRBV7-9,TRBJ1-1,CASSVGQTNTEAFF,0,1,1,1
TRBV9,TRBJ2-1,CASSVAGPRGEQFF,0,1,1,1
TRBV9,TRBJ2-3,CASSVTPSIDTQYF,0,2,1,2
TRBV3-1,TRBJ2-1,CASSIREGYNEQFF,0,1,1,1
TRBV7-2,TRBJ1-1,CASSTITRNTEAFF,0,1,1,1
TRBV9,TRBJ2-6,CASSRQGKANVLTF,0,1,1,1
TRBV11-2,TRBJ2-5,CASRRGALGETQYF,0,1,1,1
TRBV6-2/3/5/6,TRBJ2-1,CASRGRDSFNEQFF,0,1,1,1
TRBV12-3/4,TRBJ1-5,CASRSQYSNQPQHF,0,1,1,1
TRBV12-3/4,TRBJ1-2,CASRCGQGPYGYTF,0,1,1,1
TRBV5-1,TRBJ2-1,CASGQDSLYNEQFF,0,1,1,1
TRBV10-2,TRBJ2-1,CASTESPSYNEQFF,0,1,1,1
TRBV5-1,TRBJ2-2,CASSFSVGTGELFF,0,1,1,1
TRBV5-1,TRBJ2-3,CASSFEGFTDTQYF,0,1,1,1
TRBV5-1,TRBJ2-1,CASSLWGMNNEQFF,0,1,1,1
TRBV5-1,TRBJ2-5,CASSLPLAGETQYF,0,1,1,1
TRBV5-1,TRBJ2-1,CASSLRGSYNEQFF,0,1,1,1
TRBV5-1,TRBJ2-7,CASSLALLSREQYF,0,1,1,1
TRBV5-1,TRBJ1-1,CASSLAGGFPEAFF,0,1,1,1
TRBV5-1,TRBJ2-7,CASSLAMGANEQYF,0,1,1,1
TRBV5-1,TRBJ2-1,CASSLGGTQNEQFF,0,1,1,1
TRBV5-1,TRBJ2-5,CASSLGGPVETQYF,0,1,1,1
TRBV5-1,TRBJ2-3,CASSLGREGDTQYF,0,1,1,1
TRBV5-1,TRBJ1-5,CASSLDPLNQPQHF,0,1,1,1
TRBV5-1,TRBJ2-3,CASSPGLAGDTQYF,0,1,1,1
TRBV4-1,TRBJ1-2,CASSQEPGGTGYTF,0,1,1,1
TRBV5-1,TRBJ2-3,CASSETPLGDTQYF,0,1,1,1
TRBV5-1,TRBJ2-7,CASNRQGLAYEQYF,0,1,1,1
TRBV20-1,TRBJ2-4,CSVGNLLAKNIQYF,0,1,1,1
TRBV20-1,TRBJ2-7,CSVASGTSTYEQYF,0,1,1,1
TRBV20-1,TRBJ2-7,CSALPGLASDEQYF,0,1,1,1
TRBV20-1,TRBJ1-2,CSARTGTGGYGYTF,0,1,1,1
TRBV20-1,TRBJ2-1,CSAGFSGRYNEQFF,0,1,1,1
TRBV20-1,TRBJ2-3,CSAMYRRHTDTQYF,0,1,1,1
TRBV20-1,TRBJ2-7,CSASSGGARDEQYF,0,1,1,1
TRBV20-1,TRBJ1-5,CSASPDGNNQPQHF,0,1,1,1
TRBV20-1,TRBJ2-1,CSASRTGTNNEQFF,0,1,1,1
TRBV20-1,TRBJ2-5,CSARLQGRQETQYF,0,1,1,1
TRBV20-1,TRBJ2-3,CSARLGGRTDTQYF,0,1,1,1
TRBV20-1,TRBJ2-2,CSARDSGSPGELFF,0,1,1,1
TRBV20-1,TRBJ2-5,CSARDGGGGETQYF,0,1,1,1
TRBV20-1,TRBJ1-4,CSAREGTGNEKLFF,0,1,1,1
TRBV20-1,TRBJ2-5,CSAQRQGGQETQYF,0,1,1,1
TRBV20-1,TRBJ2-3,CSAPPGLGTDTQYF,0,1,1,1
TRBV29-1,TRBJ2-2,CSVVRTPNTGELFF,0,1,1,1
TRBV29-1,TRBJ2-1,CSVDDSGNLNEQFF,0,1,1,1
TRBV29-1,TRBJ2-7,CSVMDERGSYEQYF,0,1,1,1
TRBV29-1,TRBJ2-7,CSVPGPTTDYEQYF,0,1,1,1
TRBV29-1,TRBJ1-4,CSAQGGGYNEKLFF,0,1,1,1
TRBV29-1,TRBJ2-3,CSGHLAGYTDTQYF,0,1,1,1
TRBV7-2,TRBJ2-4,SASSSGTSANIQYF,0,1,1,1
TRBV11-2,TRBJ1-1,CATASERFTEAFF,0,1,1,1
TRBV12-5,TRBJ1-2,CASGLPPGDGYTF,0,1,1,1
TRBV30,TRBJ2-7,CAWMPGTSYEQYF,0,1,1,1
TRBV12-3/4,TRBJ2-1,CAGSLTSCNEQFF,0,1,1,1
TRBV10-3,TRBJ2-3,CAISESTGDTQYF,0,1,1,1
TRBV10-3,TRBJ2-7,CAISESDRYEQYF,0,1,1,1
TRBV15,TRBJ2-3,CATLLAGADTQYF,0,1,1,1
TRBV24-1,TRBJ2-3,CATSDGPSATQYF,0,1,1,1
TRBV24-1,TRBJ2-4,CATSEPDRGIQYF,0,1,1,1
TRBV19,TRBJ1-5,CASRDRGHQPQHF,0,1,1,1
TRBV19,TRBJ2-3,CASTPTATATQYF,0,2,1,2
TRBV19,TRBJ2-2,CASSFVLTGELFF,0,1,1,1
TRBV19,TRBJ2-1,CASSIGASNEQFF,0,1,1,1
TRBV19,TRBJ2-1,CASRAGRNNEQFF,0,1,1,1
TRBV18,TRBJ2-5,CASSFGDRETQYF,0,1,1,1
TRBV28,TRBJ2-3,CASSVGEVNTQYF,0,1,1,1
TRBV18,TRBJ1-1,CASSQDRGTEAFF,0,1,1,1
TRBV28,TRBJ2-7,CASQVKAFYEQYF,0,1,1,1
TRBV11-2,TRBJ1-3,CASGQAGRNTIYF,0,1,1,1
TRBV3-1,TRBJ2-5,CASDDQGGETQYF,0,1,1,1
TRBV2,TRBJ2-7,CASIMTHSSEQYF,0,1,1,1
TRBV6-2/3/5/6,TRBJ2-1,CASTPRGYNEQFF,0,1,1,1
TRBV12-3/4,TRBJ2-5,CASSFHLGETQYF,0,1,1,1
TRBV12-3/4,TRBJ1-5,CASSLGGRRSPHF,0,2,1,2
TRBV28,TRBJ1-2,CASSLEGIRGYTF,0,1,1,1
TRBV28,TRBJ2-5,CASSLKGGKTQYF,0,1,1,1
TRBV5-4,TRBJ2-7,CASSSGPSRKQYF,0,1,1,1
TRBV28,TRBJ2-7,CASSSKYSYEQYF,0,1,1,1
TRBV6-2/3/5/6,TRBJ1-5,CASSYSRNQPQHF,0,1,1,1
TRBV6-2/3/5/6,TRBJ1-4,CASSYSFQEKLFF,0,1,1,1
TRBV6-2/3/5/6,TRBJ1-3,CASSYGPRNTIYF,0,1,1,1
TRBV12-3/4,TRBJ1-5,CASSLELDQPQHF,0,1,1,1
TRBV6-1,TRBJ2-1,CASSGSGINEQFF,0,1,1,1
TRBV6-1,TRBJ2-2,CASSEANTGELFF,0,1,1,1
TRBV7-8,TRBJ2-7,CASSFYREGEQYF,0,1,1,1
TRBV3-1,TRBJ2-1,CASSFDRDNEQFF,0,1,1,1
TRBV5-6,TRBJ2-7,CASSLAGGYEQYF,0,1,1,1
TRBV7-3,TRBJ2-3,CASSLGVGDTQYF,0,1,1,1
TRBV7-2,TRBJ2-4,CASSLFENHIQYF,0,1,1,1
TRBV7-2,TRBJ2-1,CASSLSVINEQFF,0,1,1,1
TRBV7-9,TRBJ2-7,CASSLVGGNEQYF,0,1,1,1
TRBV7-9,TRBJ2-4,CASSLGDGGIQYF,0,1,1,1
TRBV5-4,TRBJ2-7,CASSLDLVYEQYF,0,1,1,1
TRBV7-3,TRBJ2-5,CASSLIGAETQYF,0,1,1,1
TRBV7-3,TRBJ2-7,CASSSGTVEKQYF,0,1,1,1
TRBV11-1,TRBJ2-3,CASSSGQGYTQYF,0,1,1,1
TRBV7-9,TRBJ2-7,CASSSGLDYEQYF,0,1,1,1
TRBV7-9,TRBJ2-7,CASSWLSAYEQYF,0,1,1,1
TRBV5-5,TRBJ2-1,CASSLTGLNEQFF,0,1,1,1
TRBV14,TRBJ1-2,CASSPLRGEGYTF,0,1,1,1
TRBV14,TRBJ1-2,CASSPRTGDGYTF,0,1,1,1
TRBV5-6,TRBJ2-3,CASSPAGEDTQYF,0,1,1,1
TRBV7-3,TRBJ2-5,CASSRGQGETQYF,0,2,1,2
TRBV3-1,TRBJ2-7,CASSRSPGYEQYF,0,1,1,1
TRBV4-2,TRBJ1-1,CASSRRIVSEAFF,0,1,1,1
TRBV3-1,TRBJ2-5,CASSQGLQETQYF,0,2,1,2
TRBV3-1,TRBJ2-1,CASSQGAGGRQFF,0,1,1,1
TRBV3-1,TRBJ1-6,CASSQDRDSPLHF,0,2,1,2
TRBV3-1,TRBJ2-6,CASSQEKDESLTF,0,1,1,1
TRBV7-2,TRBJ2-3,CASSASTSDTQYF,0,1,1,1
TRBV2,TRBJ1-1,CASSDGGNTEAFF,0,1,1,1
TRBV5-6,TRBJ2-3,CASRSRTSDTQYF,0,1,1,1
TRBV6-4,TRBJ2-1,CASRTSTYNEQFF,0,1,1,1
TRBV6-2/3/5/6,TRBJ1-4,CASRRQGGEKLFF,0,1,1,1
TRBV2,TRBJ2-5,CASNRQGRETQYF,0,1,1,1
TRBV19,TRBJ2-2,CASTPTGTGELFF,0,1,1,1
TRBV5-1,TRBJ2-4,CASSYGAKNIQYF,0,1,1,1
TRBV6-2/3/5/6,TRBJ2-7,CASSYEEDYEQYF,0,1,1,1
TRBV10-1,TRBJ1-2,CASSESSTYGYTF,0,1,1,1
TRBV5-1,TRBJ2-7,CASSLGQLYEQYF,0,1,1,1
TRBV5-1,TRBJ2-5,CASSSPPEETQYF,0,1,1,1
TRBV5-1,TRBJ2-5,CASSSSTQETQYF,0,1,1,1
TRBV4-1,TRBJ2-1,CASSQERSNEQFF,0,1,1,1
TRBV5-1,TRBJ2-1,CASSEDGPIGQFF,0,1,1,1
TRBV5-1,TRBJ2-3,CASSTFDTDTQYF,0,1,1,1
TRBV20-1,TRBJ1-1,CSAIDMRNTEAFF,0,1,1,1
TRBV20-1,TRBJ1-1,CSARVPASTEAFF,0,1,1,1
TRBV20-1,TRBJ1-5,CSARVRGSQPQHF,0,1,1,1
TRBV20-1,TRBJ1-5,CSARDLESQPQHF,0,1,1,1
TRBV20-1,TRBJ2-5,CSAALAGQETQYF,0,1,1,1
TRBV20-1,TRBJ2-4,CSAKHGQRVGGYF,0,1,1,1
TRBV29-1,TRBJ2-3,CSVLLAGLDTQYF,0,1,1,1
TRBV29-1,TRBJ1-1,CSVSFRDGSGAFF,0,1,1,1
TRBV29-1,TRBJ2-7,CSVPGQGAGEQYF,0,1,1,1
TRBV29-1,TRBJ2-3,CSVQGAEGDTQYF,0,1,1,1
TRBV29-1,TRBJ1-1,CSVAVRGVPEAFF,0,1,1,1
TRBV29-1,TRBJ2-3,CSVGQRWTDTQYF,0,1,1,1
TRBV29-1,TRBJ2-2,CSVGGTATGELFF,0,1,1,1
TRBV29-1,TRBJ2-7,CSVEGTGEPEQYF,0,1,1,1
TRBV29-1,TRBJ2-7,CSVLTGGRYEQYF,0,1,1,1
TRBV29-1,TRBJ2-3,CSAQGSSTDTQYF,0,1,1,1
TRBV29-1,TRBJ2-1,CSASGNSYNEQFF,0,1,1,1
TRBV29-1,TRBJ2-1,CSAAGTMYNEQFF,0,1,1,1
TRBV29-1,TRBJ2-5,CSAGGEGWETQYF,0,1,1,1
TRBV10-3,TRBJ2-3,CAIRAGADTQYF,0,1,1,1
TRBV10-3,TRBJ1-1,CAINQGRGEAFF,0,1,1,1
TRBV10-3,TRBJ2-1,CATSSRGNEQFF,0,1,1,1
TRBV10-3,TRBJ2-7,CATHRGGYEQYF,0,1,1,1
TRBV24-1,TRBJ2-3,CATSKSPDTQYF,0,1,1,1
TRBV2,TRBJ1-2,CASSAPSDGYTF,0,1,1,1
TRBV19,TRBJ1-5,CASSGGNQPQHF,0,1,1,1
TRBV19,TRBJ2-1,CASSIDQGEQFF,0,1,1,1
TRBV18,TRBJ1-1,CASSGDRTEAFF,0,1,1,1
TRBV12-3/4,TRBJ2-1,CASSFSVDEQFF,0,1,1,1
TRBV12-3/4,TRBJ2-7,CASSFVLGEQYF,0,1,1,1
TRBV12-3/4,TRBJ1-2,CASSFVGGVYTF,0,1,1,1
TRBV28,TRBJ2-5,CASSFGLAGSYF,0,1,1,1
TRBV12-3/4,TRBJ2-7,CASSLAVAEQYF,0,1,1,1
TRBV12-3/4,TRBJ1-6,CASSRDISPLHF,0,1,1,1
TRBV6-1,TRBJ2-7,CASSERKYEQYF,0,1,1,1
TRBV12-3/4,TRBJ1-2,CASSTGLYGYTF,0,1,1,1
TRBV7-9,TRBJ2-1,CASSLVRNEQFF,0,1,1,1
TRBV11-2,TRBJ1-2,CASSLDRVGYTF,0,1,1,1
TRBV6-4,TRBJ2-3,CASSVLADTQYF,0,1,1,1
TRBV7-8,TRBJ2-7,CASSATSYEQYF,0,1,1,1
TRBV2,TRBJ2-1,CASRYIDNEQFF,0,1,1,1
TRBV11-2,TRBJ1-1,CASRAGNTEAFF,0,1,1,1
TRBV2,TRBJ2-5,CASRGDGETQYF,0,1,1,1
TRBV6-4,TRBJ2-4,CASRDGLGIQYF,0,1,1,1
TRBV5-1,TRBJ2-1,CASSLAPGRQFF,0,1,1,1
TRBV5-1,TRBJ2-7,CASSLGGNEQYF,0,1,1,1
TRBV5-1,TRBJ2-7,CASSLPSYEQYF,0,1,1,1
TRBV20-1,TRBJ2-1,CSARQGANEQFF,0,1,1,1
TRBV20-1,TRBJ2-7,CSARVKGYEQYF,0,1,1,1
TRBV29-1,TRBJ2-2,CSSVGSAGELFF,0,1,1,1
TRBV20-1,TRBJ1-1,CSVSELNTEAFF,0,1,1,1
TRBV29-1,TRBJ2-7,CSVGQGAYEQYF,0,1,1,1
TRBV29-1,TRBJ2-7,CSVTIQGQGCLL,0,1,1,1
TRBV29-1,TRBJ1-2,CSVDSYNYGYTF,0,1,1,1
TRBV29-1,TRBJ2-5,CSAREGAETQYF,0,1,1,1
TRBV29-1,TRBJ2-2,CSIERGSGELFF,0,1,1,1
TRBV24-1,TRBJ2-3,CATSQSDTQYF,0,1,1,1
TRBV12-3/4,TRBJ2-7,CASTGRNGQYF,0,1,1,1
TRBV28,TRBJ2-3,CASSLGGLQYF,0,1,1,1
TRBV12-3/4,TRBJ2-1,CASSLSAVVLF,0,1,1,1
TRBV12-3/4,TRBJ2-5,CASSYRETQYF,0,1,1,1
TRBV7-9,TRBJ2-3,CASSLTGELYF,0,1,1,1
TRBV7-9,TRBJ2-1,CASSPGREQFF,0,1,1,1
TRBV7-8,TRBJ2-7,CASSPSYEQYF,0,1,1,1
TRBV9,TRBJ2-1,CASSPRTEQFF,0,1,1,1
TRBV3-1,TRBJ2-7,CASSHSHEQYF,0,1,1,1
TRBV3-1,TRBJ2-7,CASSQSYEQYF,0,1,1,1
TRBV7-9,TRBJ1-1,CASSIQYRLFF,0,1,1,1
TRBV20-1,TRBJ2-3,CSASVTDTQYF,0,1,1,1
TRBV29-1,TRBJ2-6,CSVAPANVLTF,0,1,1,1
TRBV29-1,TRBJ2-3,CSVAAADTQYF,0,1,1,1
TRBV29-1,TRBJ2-4,CSVETGYIQYF,0,1,1,1
TRBV29-1,TRBJ1-1,CSVGENTEAFF,0,1,1,1
TRBV4-1,TRBJ2-2,KNQTNTGELFF,0,1,1,1
TRBV29-1,TRBJ2-1,CSVSYNEQFF,0,1,1,1
TRBV20-1,TRBJ2-1,CSAKRGQFF,0,1,1,1
TRBV28,TRBJ1-1,CARGMAFF,0,1,1,1
TRBV4-1,TRBJ2-6,CASSQEGPRTGFISGANVLTY,0,1,1,1
TRBV2,TRBJ2-3,CASSVMPSNRGQDTQYF,0,1,1,1
TRBV4-1,TRBJ2-1,CASSPARLAVFFGEQFF,0,1,1,1
TRBV5-1,TRBJ2-1,CASSVRTSGSPYNEQFF,0,2,1,2
TRBV5-1,TRBJ2-2,CASSAGPGLAETGEPFF,0,1,1,1
TRBV19,TRBJ2-7,CASGIRGGIGTYEQYF,0,2,1,2
TRBV27,TRBJ2-2,CASSLFLRATTGVLFF,0,2,1,2
TRBV6-2/3/5/6,TRBJ2-7,CASSLSGTGSSYEQYF,0,1,1,1
TRBV5-4,TRBJ2-2,CASSLEDYQGAGELFF,0,1,1,1
TRBV7-9,TRBJ2-1,CASSPRLGQLYNEQFF,0,1,1,1
TRBV4-2,TRBJ2-6,CASSQGARSGANVLTF,0,1,1,1
TRBV12-3/4,TRBJ2-1,CASRGTSGREYNEQFF,0,1,1,1
TRBV18,TRBJ2-2,CASSLLARNTGELFF,0,1,1,1
TRBV7-2,TRBJ2-3,CASSFWAGSTDTQYF,0,2,1,2
TRBV11-2,TRBJ2-5,CASSLALSELETQYF,0,1,1,1
TRBV7-9,TRBJ2-7,CASSLGGTGSYEQYF,0,1,1,1
TRBV7-2,TRBJ2-7,CASSLDGTTSREQYF,0,1,1,1
TRBV20-1,TRBJ2-5,CSARGPNGSGETQYF,0,2,1,2
TRBV3-1,TRBJ2-1,SASSSRDRGENEQFF,0,1,1,1
TRBV7-9,TRBJ2-2,CAPEQLERPGELFF,0,1,1,1
TRBV7-9,TRBJ1-1,CASGRQGPDTEAFF,0,1,1,1
TRBV7-2,TRBJ2-6,CASSLNSGANVLTF,0,1,1,1
TRBV28,TRBJ1-1,CASRGVEGGTEAFF,0,1,1,1
TRBV20-1,TRBJ1-2,CSAREDRSNYGYTF,0,2,1,2
TRBV7-3,TRBJ2-4,CACSTDPGNIQYF,0,1,1,1
TRBV7-9,TRBJ2-7,CASSSGTRSRQYF,0,1,1,1
TRBV7-9,TRBJ2-7,CASRPTGGYEQYF,0,1,1,1
TRBV5-1,TRBJ2-7,CASSFSSPYEQYF,0,1,1,1
TRBV20-1,TRBJ1-1,CSARGRGGTEAFF,0,1,1,1
TRBV29-1,TRBJ2-1,CSVPSISYDEQFF,0,1,1,1
TRBV29-1,TRBJ1-4,CSVLRSTNEKLFF,0,1,1,1
TRBV11-2,TRBJ2-3,CASSSTTDKQYF,0,1,1,1
TRBV2,TRBJ2-7,RASRDSSYEQYF,0,1,1,1
TRBV12-5,TRBJ2-2,CASGLALTCGRVATNTGELFF,0,1,1,1
TRBV27,TRBJ2-2,CASSLARAGIQDVTVPEELFF,0,1,1,1
TRBV12-5,TRBJ2-1,CASGVKAGEPSPKRPSEQFF,0,1,1,1
TRBV6-2/3/5/6,TRBJ2-6,CASSYSPRTSSFSGANVLTF,0,1,1,1
TRBV5-6,TRBJ2-5,CASSRRYAGLAGGGGGTQYF,0,1,1,1
TRBV3-1,TRBJ2-2,CASSQGGLAGDDDDPGELFF,0,1,1,1
TRBV24-1,TRBJ2-6,CATSDFASKSDSGANVLTF,0,1,1,1
TRBV19,TRBJ2-2,CASIPRDYPPYRYTGELFF,0,1,1,1
TRBV19,TRBJ2-2,CASSRSGIRDSQITGELFF,0,1,1,1
TRBV19,TRBJ2-1,CASSIDQYYGQGQNNEQFF,0,1,1,1
TRBV6-2/3/5/6,TRBJ2-3,CASSPLGARARPPTDTQYF,0,1,1,1
TRBV7-2,TRBJ2-1,CASSIAGVLAGGTHNEQFF,0,1,1,1
TRBV5-5,TRBJ2-7,CASSNRGGLTSGISYEQYS,0,1,1,1
TRBV19,TRBJ2-1,CASSHWTSGSMRNNEQFF,0,1,1,1
TRBV2,TRBJ2-6,CASRVPPGQGTGANVLTF,0,1,1,1
TRBV6-4,TRBJ2-1,CASTEGRASGRDYNEQFF,0,1,1,1
TRBV28,TRBJ2-6,CASSLRREKPPGANVLTF,0,1,1,1
TRBV6-2/3/5/6,TRBJ1-1,CASSYFGGAVWMNTEAFF,0,1,1,1
TRBV6-2/3/5/6,TRBJ2-3,CASSYSVGQKYSTDTQYF,0,1,1,1
TRBV6-1,TRBJ1-5,CASSYRDRDYSGNQPQHF,0,1,1,1
TRBV28,TRBJ2-5,CASSLNRLQGRALETQYF,0,1,1,1
TRBV27,TRBJ1-6,CASSRWARGRGLGSPLHF,0,1,1,1
TRBV6-1,TRBJ2-2,CASSDEAAGRGVNGELFF,0,1,1,1
TRBV5-6,TRBJ2-1,CASSFDYIGTSGRDEQFF,0,1,1,1
TRBV5-4,TRBJ2-5,CASSFPRGSGRATETQYF,0,1,1,1
TRBV7-2,TRBJ2-7,CASSLARILGTGTYEQYF,0,1,1,1
TRBV3-1,TRBJ2-7,CASSQVLAGGPPTYEQYF,0,1,1,1
TRBV3-1,TRBJ2-1,CASSQGAPRTTIYNEQFF,0,1,1,1
TRBV3-1,TRBJ2-3,CASSQDLRLAGSTDTQYF,0,1,1,1
TRBV9,TRBJ1-1,CASSVGGDSYYMNTEAFF,0,1,1,1
TRBV5-1,TRBJ2-3,CASSFTSGSPRSTDTQYF,0,1,1,1
TRBV4-1,TRBJ2-7,CASSRQGLAGDSSYEEYF,0,1,1,1
TRBV20-1,TRBJ2-1,CSAPIWGGSSGLYNEQFF,0,1,1,1
TRBV20-1,TRBJ2-2,CSAGLLAGLGPNTGELFF,0,1,1,1
TRBV29-1,TRBJ2-3,CSVEDRGSALFSTDTQYF,0,1,1,1
TRBV29-1,TRBJ2-1,CSVTGTSGRGGSYNEQFF,0,1,1,1
TRBV12-5,TRBJ2-1,CASGRPLRVSSYNEQFF,0,1,1,1
TRBV24-1,TRBJ2-1,CATSDLPGQGSGSEQFS,0,1,1,1
TRBV24-1,TRBJ2-3,CATSDPVGDLSTDTQYF,0,1,1,1
TRBV24-1,TRBJ2-3,CATSDPASPPFTDTQYF,0,1,1,1
TRBV19,TRBJ1-4,CASSKEGQVSYDEKLFF,0,1,1,1
TRBV19,TRBJ2-1,CASSSPLQEEGYNEQFF,0,1,1,1
TRBV28,TRBJ2-3,CASSLRAAPSRGDTQYF,0,1,1,1
TRBV18,TRBJ2-2,CASSLPAGTGRTGELSF,0,1,1,1
TRBV9,TRBJ2-1,CASTHQGGRYRYNEQFF,0,1,1,1
TRBV6-2/3/5/6,TRBJ2-2,CASSFFGLAEHTGELFF,0,1,1,1
TRBV6-2/3/5/6,TRBJ2-2,CASSLSGQNANTGELFF,0,1,1,1
TRBV6-2/3/5/6,TRBJ2-1,CASSLYGDQSSYNGPFF,0,1,1,1
TRBV27,TRBJ2-1,CASSLYGDQSSYNGQFF,0,1,1,1
TRBV28,TRBJ2-3,CASSLTVSGGLTDTQYF,0,1,1,1
TRBV12-3/4,TRBJ2-1,CASSLTTSGTPRNEQFF,0,1,1,1
TRBV28,TRBJ2-7,CASSLNWGTSGHYEQYF,0,1,1,1
TRBV6-2/3/5/6,TRBJ2-7,CASSPRFFGQNPYEQYF,0,1,1,1
TRBV2,TRBJ2-5,CASSETGPLSAQETQYF,0,1,1,1
TRBV11-2,TRBJ2-5,CASSFRFLGARGETQYF,0,1,1,1
TRBV5-4,TRBJ2-1,CASSLLTSGLSYNEQFF,0,1,1,1
TRBV5-4,TRBJ2-4,CASSLGTSGRAKNIQYF,0,1,1,1
TRBV7-8,TRBJ2-7,CASSLYLSSGSAYEQYF,0,1,1,1
TRBV6-2/3/5/6,TRBJ1-1,CASSLNDPTGDPTEAFF,0,1,1,1
TRBV7-6,TRBJ2-4,CASSLKGKGQGENIQYF,0,1,1,1
TRBV7-9,TRBJ2-1,CASSSSGLAGVVNEQFF,0,1,1,1
TRBV5-5,TRBJ1-1,CASSSVRLPALNTEAFF,0,1,1,1
TRBV7-2,TRBJ2-2,CASSSTRGQVYTGELFF,0,1,1,1
TRBV7-6,TRBJ2-1,CASSLGLAGGPVNEQFS,0,1,1,1
TRBV3-1,TRBJ2-5,CASSPPRLALNQETQYF,0,1,1,1
TRBV7-9,TRBJ2-3,CASSPTQRERGTDTQYF,0,1,1,1
TRBV4-2,TRBJ2-1,CASSQDTRTSGRNEQFF,0,1,1,1
TRBV28,TRBJ2-1,CASRDETAGVGYNEQFF,0,1,1,1
TRBV5-6,TRBJ2-3,CASRTYTGTTFTDTQYF,0,1,1,1
TRBV6-2/3/5/6,TRBJ2-1,CASKRSPQPSFYNEQFF,0,1,1,1
TRBV5-1,TRBJ2-3,CASSFRSGVDSTDTQYF,0,1,1,1
TRBV4-1,TRBJ2-3,CASSFRLAGESTDSQYF,0,1,1,1
TRBV5-1,TRBJ1-5,CASSADRVLDSNQPQHF,0,1,1,1
TRBV5-1,TRBJ2-7,CASSETIPGGASYEQYF,0,1,1,1
TRBV20-1,TRBJ2-1,CSAGPLVRREGHNEQFF,0,1,1,1
TRBV20-1,TRBJ2-5,CSARGTSGSRRGETQYF,0,1,1,1
TRBV20-1,TRBJ1-2,CSARDLLSGAGISGYTF,0,1,1,1
TRBV29-1,TRBJ2-1,CSVGGLAGGRTYNEQFF,0,1,1,1
TRBV29-1,TRBJ2-7,CSVEDYSERDRSYEQYF,0,1,1,1
TRBV29-1,TRBJ1-1,CSVERTGGGGRNTEAFF,0,1,1,1
TRBV29-1,TRBJ2-3,CSAVPPGRGPFLDTQYF,0,1,1,1
TRBV9,TRBJ2-7,RASSVGPGLKYSYEQYF,0,1,1,1
TRBV10-3,TRBJ1-3,CAISGDRASSGNTIYF,0,1,1,1
TRBV10-3,TRBJ2-2,CAISRASGTNTGELFF,0,1,1,1
TRBV24-1,TRBJ2-4,CATSEESDRGENIQYF,0,1,1,1
TRBV15,TRBJ2-1,CATSRARTGVYNEQFY,0,1,1,1
TRBV19,TRBJ2-5,CASTPGGLAGQETQYF,0,1,1,1
TRBV19,TRBJ2-7,CASSMPGGLNDYEQYF,0,1,1,1
TRBV19,TRBJ2-3,CASSIARTSSTDTQYF,0,1,1,1
TRBV19,TRBJ1-4,CASSTTGRTTNEKLFF,0,1,1,1
TRBV19,TRBJ2-2,CASSTGLAGSVGELFF,0,1,1,1
TRBV19,TRBJ1-2,CASSDRDRRANYGYTF,0,1,1,1
TRBV19,TRBJ2-3,CASRGWDVRFTDTQYF,0,1,1,1
TRBV18,TRBJ2-1,CASSPVRLETYNEQFF,0,1,1,1
TRBV18,TRBJ2-7,CASSPRGRGLVSEQYF,0,1,1,1
TRBV18,TRBJ2-5,CASSPRGQGALETQYF,0,1,1,1
TRBV18,TRBJ2-2,CASSGLAGLNTGELFF,0,1,1,1
TRBV19,TRBJ2-6,CASLPRKASGANVLTF,0,1,1,1
TRBV10-3,TRBJ2-5,CASGYRQGGVQETQYF,0,1,1,1
TRBV6-2/3/5/6,TRBJ2-1,CASGSLTENSYNEQFF,0,1,1,1
TRBV6-2/3/5/6,TRBJ2-1,CASTYDSGIPTNEQFF,0,1,1,1
TRBV11-2,TRBJ1-4,CASTPGRVSTNGKLFF,0,1,1,1
TRBV18,TRBJ1-2,CASTPQPGASLVRYTF,0,1,1,1
TRBV28,TRBJ2-4,CASSFRRGSGKNIQYF,0,1,1,1
TRBV12-3/4,TRBJ1-1,CASSLWADERNTEAFF,0,1,1,1
TRBV28,TRBJ2-4,CASSLLAGLAKNIQYF,0,1,1,1
TRBV28,TRBJ2-1,CASSLQGVFSYNEQFF,0,1,1,1
TRBV12-3/4,TRBJ1-2,CASSLVAGHGAYGYTF,0,1,1,1
TRBV6-2/3/5/6,TRBJ1-4,CASSYPTGATNEKLFF,0,1,1,1
TRBV12-3/4,TRBJ1-5,CASSLSTGTNNQPQHF,0,1,1,1
TRBV6-2/3/5/6,TRBJ2-7,CASSPSLGTGPYEQYF,0,1,1,1
TRBV27,TRBJ2-7,CASSPMTGERLYEQYF,0,1,1,1
TRBV7-2,TRBJ1-1,CASSRPVTGLNTEAFF,0,1,1,1
TRBV6-1,TRBJ1-3,CASSEHWSGSGITIYF,0,1,1,1
TRBV2,TRBJ2-1,CASSERAGGSYNEQFF,0,1,1,1
TRBV5-5,TRBJ2-1,CASSLVGPRKYNEQFF,0,1,1,1
TRBV5-5,TRBJ2-2,CASSLAGGRYTGELFF,0,1,1,1
TRBV7-2,TRBJ2-3,CASSLSRDIGADTQYF,0,1,1,1
TRBV7-2,TRBJ1-2,CASSLVPGRINYGYTF,0,1,1,1
TRBV7-2,TRBJ1-3,CASSLALNSAGNTIYF,0,1,1,1
TRBV7-9,TRBJ2-5,CASSLAGGAFWETQYF,0,1,1,1
TRBV7-6,TRBJ2-2,CASSLGLAGTTGELFF,0,1,1,1
TRBV5-6,TRBJ2-5,CASSLDRGGMKETQYF,0,1,1,1
TRBV5-8,TRBJ2-3,CASSSRTSVFTDTQYF,0,1,1,1
TRBV7-6,TRBJ2-3,CASSSLRGEHTDTQYF,0,1,1,1
TRBV7-2,TRBJ2-7,CASSSVSGRTSYEQYF,0,1,1,1
TRBV7-9,TRBJ2-3,CASSSGTGVEMDTQYF,0,1,1,1
TRBV11-2,TRBJ2-2,CASSLGASANTGELFF,0,1,1,1
TRBV7-9,TRBJ2-3,CASSLGQGLITDTQYF,0,1,1,1
TRBV11-2,TRBJ1-1,CASSLDPVDPNTEAFF,0,1,1,1
TRBV14,TRBJ2-4,CASSPRGTSGQNIQYF,0,1,1,1
TRBV28,TRBJ2-3,CASSPGDSGRTDTQYF,0,1,1,1
TRBV5-4,TRBJ2-7,CASSPGSGTSGYEQYF,0,1,1,1
TRBV5-4,TRBJ2-7,CASSPRGTGANYEQYF,0,1,1,1
TRBV6-2/3/5/6,TRBJ1-2,CASSRTTGTANYGYTF,0,1,1,1
TRBV3-1,TRBJ2-6,CASSRGTGFEANVLTF,0,1,1,1
TRBV3-1,TRBJ2-3,CASSQSPSSFRDTQYF,0,1,1,1
TRBV14,TRBJ2-1,CASSQVAGGRWNEQFF,0,1,1,1
TRBV4-2,TRBJ2-1,CASSQDGRGDLNEQFF,0,1,1,1
TRBV25-1,TRBJ2-2,CASSVRGRKTAGELFF,0,1,1,1
TRBV9,TRBJ1-1,CASSVDDRFVATEAFF,0,1,1,1
TRBV7-3,TRBJ2-7,CASSAQGTGRFHEQYF,0,1,1,1
TRBV2,TRBJ2-7,CASSAAGQGAPYEQYF,0,1,1,1
TRBV7-2,TRBJ2-5,CASSDPGQGARETQYF,0,1,1,1
TRBV6-4,TRBJ2-1,CASSDRDRVIYNEQFF,0,1,1,1
TRBV27,TRBJ2-7,CASRGQTNAAVGEQYF,0,1,1,1
TRBV27,TRBJ2-1,CASRDGSGSSYNEQFF,0,1,1,1
TRBV6-2/3/5/6,TRBJ1-5,CASRPGTAGADQPQHF,0,1,1,1
TRBV3-1,TRBJ2-2,CASRPTSGVNTGELFF,0,1,1,1
TRBV12-3/4,TRBJ1-5,CASNSGSVAGNQPQHF,0,1,1,1
TRBV2,TRBJ2-7,CASKALTSGRPYEQYF,0,1,1,1
TRBV5-1,TRBJ2-1,CASTLAGTSGSNEQFF,0,1,1,1
TRBV4-1,TRBJ2-2,CASSHTPGVGTGELFF,0,1,1,1
TRBV10-2,TRBJ2-3,CASSELPAGGPDTQYF,0,1,1,1
TRBV5-1,TRBJ2-3,CASSLLGQGAPDTQYF,0,1,1,1
TRBV5-1,TRBJ2-1,CASSLGLAGGSYEQFF,0,1,1,1
TRBV5-1,TRBJ1-1,CASSLGPGEMNTEAFF,0,1,1,1
TRBV5-1,TRBJ2-3,CASSLGRTGGADTQYF,0,1,1,1
TRBV5-1,TRBJ2-7,CASSLPGLGLLHEQYF,0,1,1,1
TRBV5-1,TRBJ1-1,CASSLGLLGRNTEAFF,0,1,1,1
TRBV5-1,TRBJ1-1,CASSSGGGIPETEAFF,0,1,1,1
TRBV5-1,TRBJ1-2,CASSSDIGPTTTAYTF,0,1,1,1
TRBV5-1,TRBJ2-2,CASSPLQGANTGELFF,0,1,1,1
TRBV5-1,TRBJ2-7,CASSPYIGTSGAEQYF,0,1,1,1
TRBV4-1,TRBJ2-4,CASSHALRGTKNIQYF,0,1,1,1
TRBV4-1,TRBJ2-7,CASSQPVQGLGYEQYF,0,1,1,1
TRBV4-1,TRBJ2-7,CASSQDWASGYYEQYF,0,1,1,1
TRBV20-1,TRBJ2-5,CSARGTSAEGRETQYF,0,1,1,1
TRBV20-1,TRBJ2-1,CSARDMGPSSYNGQFF,0,1,1,1
TRBV20-1,TRBJ2-3,CSAFKRLISSTDTQYF,0,1,1,1
TRBV20-1,TRBJ2-3,CSAHSSGRANTDTQYF,0,1,1,1
TRBV20-1,TRBJ2-3,CSGGSTSRRGTDTQYF,0,1,1,1
TRBV20-1,TRBJ2-6,CSLSQWGGNGANVLTF,0,1,1,1
TRBV29-1,TRBJ1-1,CSVVSQQGTPNTEAFF,0,1,1,1
TRBV29-1,TRBJ2-1,CSVGGLASSSYNEQFF,0,1,1,1
TRBV29-1,TRBJ2-1,CSVDDPRQGGPNEQFF,0,1,1,1
TRBV29-1,TRBJ2-6,CSVEDLSSSGANVLTF,0,1,1,1
TRBV7-4,TRBJ1-5,RASTPGRVWSNQPQHF,0,1,1,1
TRBV5-6,TRBJ2-5,RASSLEQAGFGETQYF,0,1,1,1
TRBV12-5,TRBJ2-3,CASGLVYTDTDTQYF,0,1,1,1
TRBV12-5,TRBJ1-5,CASGPPGQSNQPQHF,0,1,1,1
TRBV12-3/4,TRBJ2-4,CASSTTSGRTNIQYF,0,1,1,1
TRBV28,TRBJ2-3,CASQRGRGSTDTQYF,0,1,1,1
TRBV10-3,TRBJ2-1,CAISASGSSYNEQFF,0,1,1,1
TRBV28,TRBJ2-1,CATLWTSGRRDEQFF,0,1,1,1
TRBV12-3/4,TRBJ2-3,CATVEGGSGTDTQYF,0,1,1,1
TRBV28,TRBJ2-3,CATIPSGLQADTQYF,0,1,1,1
TRBV24-1,TRBJ1-3,CATSDPDRESNTIYF,0,1,1,1
TRBV24-1,TRBJ2-3,CATSDRDFPTDTQYF,0,1,1,1
TRBV24-1,TRBJ2-3,CATSESGANTDTQYF,0,1,1,1
TRBV19,TRBJ2-7,CASSVTSYDSYEQYF,0,1,1,1
TRBV19,TRBJ2-6,CASSDPGAGANVLTF,0,1,1,1
TRBV19,TRBJ2-7,CASSEQISGRYEQYF,0,1,1,1
TRBV19,TRBJ1-5,CASSIGQVSNQPQHF,0,1,1,1
TRBV19,TRBJ1-6,CASSIGHRSATPLHF,0,1,1,1
TRBV19,TRBJ2-6,CASSSGTAGANVLTF,0,1,1,1
TRBV19,TRBJ2-3,CASSRGTTPGDTQYF,0,1,1,1
TRBV19,TRBJ2-1,CASSKLAGGNNEQFF,0,1,1,1
TRBV19,TRBJ1-1,CASNPTGQGRTEAFF,0,1,1,1
TRBV18,TRBJ1-6,CASSPQEISQSPLHF,0,1,1,1
TRBV18,TRBJ2-3,CASSSTSGGEDTQYF,0,1,1,1
TRBV18,TRBJ1-4,CASSPLGQVNEKLFF,0,1,1,1
TRBV18,TRBJ2-2,CASSPPGTYTGELFF,0,1,1,1
TRBV18,TRBJ2-7,CASSTTGTGIYEQYF,0,1,1,1
TRBV3-1,TRBJ2-5,CASCQGSGSVETQYF,0,1,1,1
TRBV27,TRBJ2-1,CASQSLAGGYNEQFF,0,1,1,1
TRBV9,TRBJ2-1,CASGRTSHSYNEQFF,0,1,1,1
TRBV6-2/3/5/6,TRBJ1-3,CASILGGSSGNTIYF,0,1,1,1
TRBV5-8,TRBJ2-3,CASILLGGKTDTQYF,0,1,1,1
TRBV5-6,TRBJ1-2,CASTLGPGMNYGYTF,0,1,1,1
TRBV28,TRBJ2-7,CASTSGADPRYEQYF,0,1,1,1
TRBV6-2/3/5/6,TRBJ2-1,CASTRAPWAGGEQFF,0,1,1,1
TRBV28,TRBJ2-1,CASTKTSPSYNEQFF,0,1,1,1
TRBV2,TRBJ1-1,CASTTEGVGSGPVFF,0,1,1,1
TRBV12-3/4,TRBJ2-1,CASSFRSGTYNEQFF,0,1,1,1
TRBV6-2/3/5/6,TRBJ2-3,CASSFQGTVCRSQYF,0,1,1,1
TRBV28,TRBJ2-7,CASSLRLNKWDEQYF,0,1,1,1
TRBV12-3/4,TRBJ2-1,CASSLMGRIGNEQFF,0,1,1,1
TRBV28,TRBJ2-1,CASSLREPANNEQFF,0,1,1,1
TRBV12-3/4,TRBJ2-7,CASSLNSGTTYEQYF,0,1,1,1
TRBV28,TRBJ1-2,CASSSPGTGGYGYTF,0,1,1,1
TRBV6-2/3/5/6,TRBJ2-1,CASSSPWLRGNEQFF,0,1,1,1
TRBV12-3/4,TRBJ1-6,CASSSQGYYNSPLHF,0,1,1,1
TRBV28,TRBJ2-3,CASSSGQGVVDTQYF,0,1,1,1
TRBV6-2/3/5/6,TRBJ1-3,CASSSMDRVGNTIYF,0,1,1,1
TRBV6-2/3/5/6,TRBJ1-6,CASSYSVQGSSPLHF,0,1,1,1
TRBV6-2/3/5/6,TRBJ2-3,CASSYSGDSTDTQYF,0,1,1,1
TRBV6-2/3/5/6,TRBJ2-2,CASSYSGPNTGELFF,0,1,1,1
TRBV6-2/3/5/6,TRBJ2-3,CASSYSMRNTDTQYF,0,1,1,1
TRBV12-3/4,TRBJ2-7,CASSPTSGSTYEQYF,0,1,1,1
TRBV28,TRBJ2-4,CASSPTGTQGNIQYF,0,1,1,1
TRBV6-2/3/5/6,TRBJ2-1,CASSPVAGVDNEQFF,0,2,1,2
TRBV7-2,TRBJ1-5,CASSRDRGGQQPQHF,0,1,1,1
TRBV28,TRBJ1-4,CASSRADRLREKLFF,0,1,1,1
TRBV6-4,TRBJ1-5,CASSQGTTSNQPQHF,0,1,1,1
TRBV12-3/4,TRBJ2-5,CASSQVSTLGETQYF,0,1,1,1
TRBV6-1,TRBJ2-3,CASSGQGSLPDTQYF,0,1,1,1
TRBV12-3/4,TRBJ2-7,CASSGGTGVFYEQYF,0,1,1,1
TRBV2,TRBJ2-7,CASSEPGGRNYEQYF,0,1,1,1
TRBV28,TRBJ2-3,CASSEPGPRWGTQYF,0,1,1,1
TRBV6-1,TRBJ2-1,CASSEGPGDRNEQFY,0,1,1,1
TRBV6-1,TRBJ2-3,CASSEGTSTTDTQYF,0,1,1,1
TRBV11-2,TRBJ2-4,CASSFLGGAKNIQYF,0,1,1,1
TRBV6-2/3/5/6,TRBJ2-5,CASSFNPGGAETQYF,0,1,1,1
TRBV13,TRBJ2-7,CASSFGGTGLLEQYF,0,1,1,1
TRBV7-2,TRBJ1-2,CASSLSYSHIYGYTF,0,1,1,1
TRBV5-4,TRBJ2-1,CASSLLTSFSNEQFF,0,1,1,1
TRBV11-3,TRBJ2-5,CASSLGLAGTETQYF,0,1,1,1
TRBV5-4,TRBJ2-1,CASSLDRAGYNEQFF,0,1,1,1
TRBV5-6,TRBJ2-1,CASSLTDRVWGEQFF,0,1,1,1
TRBV7-9,TRBJ2-7,CASSLRRDVLYEQYF,0,1,1,1
TRBV11-2,TRBJ2-3,CASSLVGTSGDTQYF,0,1,1,1
TRBV7-9,TRBJ1-4,CASSLGGTTNEKLFF,0,1,1,1
TRBV7-2,TRBJ2-2,CASSLGPSFGGELFF,0,1,1,1
TRBV7-9,TRBJ1-4,CASSLGDSLNEGLFF,0,1,1,1
TRBV7-6,TRBJ2-7,CASSLELGASYEQYF,0,1,1,1
TRBV7-2,TRBJ2-2,CASSLEGSDTGELFF,0,1,1,1
TRBV7-9,TRBJ2-1,CASSLRGGGDNEQFF,0,1,1,1
TRBV7-3,TRBJ2-5,CASSLNGRAQETQYF,0,1,1,1
TRBV7-9,TRBJ1-2,CASSSYLGTGNGYTF,0,1,1,1
TRBV11-2,TRBJ2-3,CASSSGQAYTDTQYF,0,1,1,1
TRBV7-2,TRBJ1-2,CASSSRLGGKEGYTF,0,1,1,1
TRBV28,TRBJ2-3,CASSCDSSSTDTQYF,0,1,1,1
TRBV7-2,TRBJ2-1,CASSYTSGSKNEQFF,0,1,1,1
TRBV11-2,TRBJ2-1,CASSYPQRGDSEQFF,0,1,1,1
TRBV7-9,TRBJ2-1,CASSPPGRLGNEQFF,0,1,1,1
TRBV7-8,TRBJ1-2,CASSPRDSYNYGYTF,0,1,1,1
TRBV7-2,TRBJ2-1,CASSPSGTRGNEQSF,0,1,1,1
TRBV5-4,TRBJ1-2,CASSPAGRANYGYTF,0,1,1,1
TRBV6-4,TRBJ1-5,CASSPDRDPNQPQHF,0,1,1,1
TRBV3-1,TRBJ2-7,CASSPNYRDAYEQYF,0,1,1,1
TRBV12-3/4,TRBJ2-4,CASSPPREGRDIQYF,0,1,1,1
TRBV5-4,TRBJ2-5,CASSPGGQQQETQYF,0,1,1,1
TRBV5-4,TRBJ2-7,CASSPGGPNDYEQYF,0,1,1,1
TRBV6-2/3/5/6,TRBJ2-3,CASSRRDNPTDTQYF,0,1,1,1
TRBV2,TRBJ2-2,CASSRGPQNTGELFF,0,1,1,1
TRBV28,TRBJ2-7,CASSRGGDMLDEQYF,0,1,1,1
TRBV7-2,TRBJ2-4,CASSREELAKNIQYF,0,1,1,1
TRBV6-2/3/5/6,TRBJ2-1,CASSRQGGSYNEQFF,0,1,1,1
TRBV14,TRBJ2-1,CASSQVPSSYNEQFF,0,1,1,1
TRBV4-2,TRBJ2-5,CASSQEEGLKGTQYF,0,1,1,1
TRBV7-2,TRBJ1-1,CASSQRGRENTEAFF,0,2,1,2
TRBV6-2/3/5/6,TRBJ2-1,CASSVGLGDRNEQFF,0,1,1,1
TRBV7-9,TRBJ2-1,CASSVLRDRSNEQFF,0,1,1,1
TRBV9,TRBJ2-5,CASSVSGDSAETQYF,0,1,1,1
TRBV9,TRBJ2-1,CASSVRQELYNEQFF,0,1,1,1
TRBV7-9,TRBJ1-6,CASSAGDRANSPLHF,0,1,1,1
TRBV2,TRBJ2-3,CASSAQGAHTDTQYF,0,1,1,1
TRBV5-4,TRBJ2-3,CASSDAASGRDTQYF,0,1,1,1
TRBV5-6,TRBJ2-5,CASSIRAGVGETQYF,0,1,1,1
TRBV7-2,TRBJ2-1,CASSIYSRSYNEQFF,0,1,1,1
TRBV7-2,TRBJ2-5,CASSNRLAGKETQYF,0,1,1,1
TRBV2,TRBJ1-6,CASRSTWGGSSPLHF,0,1,1,1
TRBV6-2/3/5/6,TRBJ2-1,CASRGVSGRANEQFP,0,1,1,1
TRBV6-2/3/5/6,TRBJ1-1,CASRIPGTGFTEAFF,0,1,1,1
TRBV12-3/4,TRBJ2-3,CANRRLAGWADTQYF,0,1,1,1
TRBV5-1,TRBJ2-2,CASTSTLANTGEPFF,0,1,1,1
TRBV27,TRBJ2-1,CASSLDTRGYGEQFF,0,1,1,1
TRBV10-1,TRBJ2-1,CASSESGTGVNEQFF,0,1,1,1
TRBV10-1,TRBJ2-1,CASSESLAGVNEQFF,0,1,1,1
TRBV7-2,TRBJ2-5,CASSFRDRSEETQYF,0,1,1,1
TRBV5-1,TRBJ2-1,CASSLVGVSYNEQFF,0,1,1,1
TRBV5-1,TRBJ2-1,CASSLVTGTMNEQFF,0,1,1,1
TRBV5-1,TRBJ2-7,CASSLAGDSHYEQYF,0,1,1,1
TRBV5-1,TRBJ2-3,CASSLAGNMADTQYF,0,1,1,1
TRBV5-1,TRBJ1-1,CASSLGGTGVTEAFF,0,1,1,1
TRBV5-1,TRBJ2-7,CASSLDPGVSYEQYF,0,1,1,1
TRBV5-1,TRBJ1-1,CASSLDVGKGTEAFF,0,1,1,1
TRBV5-1,TRBJ2-1,CASSLDESSYNEQFF,0,1,1,1
TRBV5-1,TRBJ2-2,CASSLEGDFTGELFF,0,1,1,1
TRBV5-1,TRBJ2-3,CASSLLEGAADTQYF,0,1,1,1
TRBV5-1,TRBJ2-2,CASSLRGRNTGELFF,0,1,1,1
TRBV5-1,TRBJ2-3,CASSSSGRNTDTQYF,0,1,1,1
TRBV5-1,TRBJ2-1,CASSSRQGEDNEQFF,0,1,1,1
TRBV5-1,TRBJ2-7,CASSYDSGSRYEQYF,0,1,1,1
TRBV5-1,TRBJ2-7,CASSLGWTSGGEQYF,0,1,1,1
TRBV5-1,TRBJ2-7,CASSPIPGLSYEQYF,0,1,1,1
TRBV4-1,TRBJ2-1,CASSRIHREHNEQFF,0,1,1,1
TRBV4-1,TRBJ1-1,CASSQATGKGTEAFF,0,1,1,1
TRBV4-1,TRBJ2-2,CASSQDPVLTGELFF,0,1,1,1
TRBV5-1,TRBJ2-7,CASSGGTSRVGEQYF,0,1,1,1
TRBV5-1,TRBJ2-2,CASSGLQGNTGELFF,0,1,1,1
TRBV5-1,TRBJ2-3,CASSDSASAADTQYF,0,1,1,1
TRBV5-1,TRBJ2-7,CASSERLAGTYEQYF,0,1,1,1
TRBV5-1,TRBJ2-1,CASSMAGAVGNEQFF,0,1,1,1
TRBV5-1,TRBJ1-1,CASNPGRIWGAEAFF,0,1,1,1
TRBV5-1,TRBJ2-1,CASNPGTGIYNEQFF,0,1,1,1
TRBV5-1,TRBJ1-1,CASNPGRRVNTEASF,0,1,1,1
TRBV20-1,TRBJ2-1,CSALPRDRGFDEQFF,0,1,1,1
TRBV20-1,TRBJ2-1,CSAYTSGRLYNEQFF,0,1,1,1
TRBV20-1,TRBJ2-3,CSALQSTGSTDTQYF,0,1,1,1
TRBV20-1,TRBJ1-1,CSAGAGGVGDTEAFF,0,1,1,1
TRBV20-1,TRBJ1-4,CSAIGSGGSPEKLFF,0,1,1,1
TRBV20-1,TRBJ2-3,CSAINPGARTDTQYF,0,1,1,1
TRBV20-1,TRBJ2-5,CSASGPAGRQETQYF,0,1,1,1
TRBV20-1,TRBJ1-5,CSARVAGLYNQPQHF,0,1,1,1
TRBV20-1,TRBJ1-4,CSARDSRDVNEKLFF,0,1,1,1
TRBV20-1,TRBJ2-5,CSARDPRTELGTQYF,0,1,1,1
TRBV20-1,TRBJ2-7,CSARDPQGGPYEEYF,0,1,1,1
TRBV20-1,TRBJ2-7,CSARDPRERQDEQYF,0,1,1,1
TRBV20-1,TRBJ1-2,CSARDPGTPNYGYTF,0,1,1,1
TRBV20-1,TRBJ2-1,CSARDHGTGGNEQFF,0,1,1,1
TRBV20-1,TRBJ2-1,CSAREREGPGGEQFF,0,1,1,1
TRBV20-1,TRBJ2-5,CSARPRQGSQETQYF,0,1,1,1
TRBV20-1,TRBJ2-7,CSASRTTKSSYEQYF,0,1,1,1
TRBV29-1,TRBJ2-3,CSVVASPNNADTQYF,0,1,1,1
TRBV29-1,TRBJ2-7,CSVDGETSGRYEQYF,0,1,1,1
TRBV29-1,TRBJ2-1,CSVEVAGDSYNEQFF,0,1,1,1
TRBV29-1,TRBJ2-7,CSVEDGQGPTYEQYF,0,1,1,1
TRBV29-1,TRBJ2-3,CSVGGQTKSTDTQYF,0,1,1,1
TRBV29-1,TRBJ2-3,CSVAPTSGGTDTQYF,0,1,1,1
TRBV29-1,TRBJ2-2,CSALYGTGHTGELFF,0,1,1,1
TRBV30,TRBJ2-6,CAWAKSPGANVLTF,0,1,1,1
TRBV30,TRBJ1-1,CAWTEGARDTEAFF,0,1,1,1
TRBV30,TRBJ2-1,CAWSGDRGYNEQFF,0,1,1,1
TRBV7-2,TRBJ2-1,CAGSPRLEANEQFF,0,1,1,1
TRBV10-3,TRBJ1-1,CAISETQGNTEAFF,0,1,1,1
TRBV10-3,TRBJ2-1,CAISTSGYYNEQFF,0,1,1,1
TRBV10-3,TRBJ2-1,CAIKSLSSYNEQFF,0,1,1,1
TRBV10-3,TRBJ2-7,CATYEASGTYEQYF,0,1,1,1
TRBV24-1,TRBJ2-7,CATSLGHRGDEQYF,0,1,1,1
TRBV15,TRBJ2-7,CATSLATPGREQYF,0,1,1,1
TRBV7-8,TRBJ2-1,CATGLLLSYNEQFF,0,1,1,1
TRBV19,TRBJ1-1,CASSIQGRGTEAFF,0,1,1,1
TRBV19,TRBJ2-4,CASSIGQGGNIQYF,0,1,1,1
TRBV19,TRBJ2-3,CASSMGDSTDTQYF,0,1,1,1
TRBV19,TRBJ1-5,CASSMTGGNQPQHF,0,1,1,1
TRBV19,TRBJ2-5,CASSIIGSQETQYF,0,1,1,1
TRBV19,TRBJ2-1,CASSSGGGYNEQFF,0,1,1,1
TRBV19,TRBJ1-1,CASSNGQGQAEAFF,0,1,1,1
TRBV19,TRBJ2-3,CASNQGSSTDTQYF,0,1,1,1
TRBV2,TRBJ2-3,CASSPGQPRTTQYF,0,1,1,1
TRBV18,TRBJ1-3,CASSPPAAGNTIYF,0,1,1,1
TRBV9,TRBJ2-3,CASLPRDRGGTQYF,0,1,1,1
TRBV6-2/3/5/6,TRBJ2-5,CASRRDIRKGTQYF,0,1,1,1
TRBV27,TRBJ2-1,CASHPGAHYNEQFF,0,1,1,1
TRBV12-3/4,TRBJ1-1,CASGFGQGGTEAFF,0,1,1,1
TRBV3-1,TRBJ2-2,CASGRREYTGELFF,0,1,1,1
TRBV5-5,TRBJ2-5,CASGGGGWQETQYF,0,1,1,1
TRBV28,TRBJ2-1,CASIPSGSYNEQFF,0,1,1,1
TRBV11-2,TRBJ1-1,CASTTGNSRAEAFF,0,1,1,1
TRBV7-9,TRBJ1-1,CASTGQGAGTEAFF,0,1,1,1
TRBV3-1,TRBJ2-3,CASTFSRRTDTQYF,0,1,1,1
TRBV12-3/4,TRBJ2-1,CASSFVWGHNEQFF,0,1,1,1
TRBV27,TRBJ2-1,CASSFGGSYNEQFF,0,1,1,1
TRBV12-3/4,TRBJ2-7,CASSFEGLAGEQYF,0,1,1,1
TRBV12-3/4,TRBJ1-1,CASSLGSVNTEAFF,0,2,1,2
TRBV6-2/3/5/6,TRBJ2-7,CASSLGTSANRQYF,0,1,1,1
TRBV28,TRBJ2-7,CASSLETGSYEQYF,0,1,1,1
TRBV6-2/3/5/6,TRBJ1-1,CASSLNIARGEAFF,0,1,1,1
TRBV7-9,TRBJ1-5,CASSSTGVNQPQHF,0,1,1,1
TRBV6-2/3/5/6,TRBJ1-4,CASSYRENNEKLVY,0,1,1,1
TRBV12-3/4,TRBJ2-1,CASSLTPDRNEQFF,0,1,1,1
TRBV28,TRBJ2-1,CASSLRGGGNEQFF,0,1,1,1
TRBV12-3/4,TRBJ2-1,CASSPLTGGNEQFF,0,1,1,1
TRBV6-2/3/5/6,TRBJ2-1,CASSRREGRGEQFF,0,1,1,1
TRBV6-2/3/5/6,TRBJ2-6,CASSQVSGANVLTF,0,1,1,1
TRBV6-1,TRBJ1-5,CASSQKASNQPQHF,0,1,1,1
TRBV6-1,TRBJ1-1,CASSVAGQNTEVFF,0,1,1,1
TRBV6-1,TRBJ2-7,CASSVDRHSYEQYF,0,1,1,1
TRBV6-2/3/5/6,TRBJ2-1,CASSVLRSYNEQFF,0,1,1,1
TRBV2,TRBJ1-2,CASSAGQGNYGYTF,0,1,1,1
TRBV6-1,TRBJ2-3,CASSASYVPDTQYF,0,1,1,1
TRBV28,TRBJ2-1,CASSAAHLAGEQFF,0,1,1,1
TRBV6-1,TRBJ1-1,CASSGGQGNTEAFF,0,1,1,1
TRBV2,TRBJ1-5,CASSDRVGNQPQHF,0,1,1,1
TRBV2,TRBJ2-1,CASSEASTVSEQFF,0,1,1,1
TRBV6-2/3/5/6,TRBJ2-3,CASSTGKVADTQYF,0,1,1,1
TRBV28,TRBJ2-3,CASSTRGGTDTQYF,0,1,1,1
TRBV7-3,TRBJ1-1,CASSFSTGGTEAFF,0,1,1,1
TRBV7-9,TRBJ1-4,CASSFFGGSEKLFF,0,1,1,1
TRBV11-2,TRBJ1-3,CASSFETGGNTIYF,0,1,1,1
TRBV7-6,TRBJ2-5,CASSLQVRQETQYF,0,1,1,1
TRBV5-4,TRBJ2-5,CASSLGDSQETQYF,0,1,1,1
TRBV5-6,TRBJ2-7,CASSLGGTGYEQYF,0,1,1,1
TRBV5-5,TRBJ1-1,CASSLEGPMVQAFF,0,1,1,1
TRBV5-6,TRBJ2-5,CASSLSYKPETQYF,0,1,1,1
TRBV11-2,TRBJ2-3,CASSLPGTADTQYF,0,1,1,1
TRBV7-3,TRBJ2-1,CASSLVGGGDEQFF,0,1,1,1
TRBV7-2,TRBJ2-5,CASSLGPIQETQYF,0,1,1,1
TRBV7-2,TRBJ1-1,CASSLGTGARVTFF,0,1,1,1
TRBV11-2,TRBJ2-1,CASSLDGSYNEQFF,0,1,1,1
TRBV7-2,TRBJ2-7,CASSLERLAAEQYF,0,1,1,1
TRBV7-9,TRBJ1-2,CASSLTVADGGYTF,0,1,1,1
TRBV5-6,TRBJ2-5,CASSSGMELGTQYF,0,1,1,1
TRBV7-9,TRBJ2-7,CASSSSALNYEQYF,0,1,1,1
TRBV7-3,TRBJ2-3,CASSSAGGASSQYF,0,1,1,1
TRBV7-2,TRBJ2-1,CASSSSTGPYEQFF,0,1,1,1
TRBV7-9,TRBJ2-1,CASSLGAGPNEQFF,0,1,1,1
TRBV14,TRBJ2-1,CASSPMGGGNEQFF,0,1,1,1
TRBV6-2/3/5/6,TRBJ1-1,CASSPSDGNTEAFF,0,1,1,1
TRBV7-9,TRBJ1-2,CASSPLSMGDGYTF,0,1,1,1
TRBV7-2,TRBJ2-5,CASSPGGRQETQYF,0,1,1,1
TRBV7-3,TRBJ2-2,CASSPNGGTGELFF,0,1,1,1
TRBV6-2/3/5/6,TRBJ2-1,CASSRDSERLGQFF,0,1,1,1
TRBV7-9,TRBJ1-3,CASSRDRGQDTIYF,0,1,1,1
TRBV3-1,TRBJ1-1,CASSHPPGSTEAFF,0,1,1,1
TRBV3-1,TRBJ2-2,CASSQLRNTGELFF,0,1,1,1
TRBV3-1,TRBJ2-7,CASSQAGVSYEQYF,0,1,1,1
TRBV3-1,TRBJ2-2,CASSQGRVGGELFF,0,1,1,1
TRBV4-2,TRBJ2-1,CASSQDGGSDEQFF,0,1,1,1
TRBV9,TRBJ2-2,CASSVEIDTGELFF,0,1,1,1
TRBV11-3,TRBJ2-3,CASSVQSGSDTQYF,0,1,1,1
TRBV9,TRBJ2-7,CASSVAEGLGQQYF,0,1,1,1
TRBV3-1,TRBJ2-7,CASSAGTGPYEQYF,0,1,1,1
TRBV2,TRBJ2-1,CASSGLAGFGEQFF,0,1,1,1
TRBV7-2,TRBJ2-7,CASSTVGAGAEQYF,0,1,1,1
TRBV7-2,TRBJ2-3,CASSTDSSTDTQYF,0,1,1,1
TRBV5-4,TRBJ2-1,CASSKREGDNEQFF,0,1,1,1
TRBV6-2/3/5/6,TRBJ2-3,CASRWSTSTDTQYF,0,1,1,1
TRBV7-9,TRBJ2-1,CASRLGPNHNEQFF,0,1,1,1
TRBV12-3/4,TRBJ2-7,CASRPGTFRGEQYF,0,1,1,1
TRBV2,TRBJ2-7,CASRPGLLTYEQYF,0,1,1,1
TRBV5-4,TRBJ1-2,CASRPGQPNYGYTF,0,1,1,1
TRBV12-3/4,TRBJ2-3,CASRGDYSTDTQYF,0,1,1,1
TRBV28,TRBJ2-7,CASRGTGGPYEQYF,0,1,1,1
TRBV7-2,TRBJ2-5,CASRLGGLEETQYF,0,1,1,1
TRBV6-2/3/5/6,TRBJ2-1,CASRPRPPGNEQFF,0,1,1,1
TRBV27,TRBJ1-2,CASRDRGSYYGYTF,0,1,1,1
TRBV12-3/4,TRBJ2-5,CASRRDRGGETQYF,0,1,1,1
TRBV6-2/3/5/6,TRBJ1-4,CASKPGATNEKLFF,0,1,1,1
TRBV12-3/4,TRBJ2-1,CAIRGGNAYNEQFF,0,1,1,1
TRBV5-1,TRBJ2-2,CASSGTSGTGELFF,0,1,1,1
TRBV10-2,TRBJ1-5,CASTDRDRNQPQHF,0,1,1,1
TRBV5-1,TRBJ2-1,CASSRLAEGNEQFF,0,1,1,1
TRBV10-2,TRBJ2-2,CASSENPNTGELFF,0,1,1,1
TRBV5-1,TRBJ1-2,CASSLSPTREGYTF,0,1,1,1
TRBV5-1,TRBJ1-2,CASSLVTGGYGYTF,0,1,1,1
TRBV5-1,TRBJ2-3,CASSLDGGPDTQYF,0,1,1,1
TRBV5-1,TRBJ2-5,CASSLDSGSETQYF,0,1,1,1
TRBV5-1,TRBJ2-1,CASSLETVYNEQFF,0,1,1,1
TRBV5-1,TRBJ2-7,CASSLKPPDLEQYF,0,1,1,1
TRBV5-1,TRBJ2-1,CASSLLAGGGEQFF,0,1,1,1
TRBV7-9,TRBJ2-7,CASSLPRDTYEQYF,0,1,1,1
TRBV5-1,TRBJ1-5,CASSLQGAGQPQHF,0,1,1,1
TRBV5-1,TRBJ2-7,CASSSASGNHEQYF,0,1,1,1
TRBV5-1,TRBJ1-6,CASSSTGRNSPLHF,0,1,1,1
TRBV5-1,TRBJ2-3,CASSSGTRTDTQYF,0,1,1,1
TRBV5-1,TRBJ1-1,CASSSGTVNTEAFF,0,1,1,1
TRBV5-1,TRBJ1-5,CASSSGQGGQPQHF,0,1,1,1
TRBV5-1,TRBJ2-7,CASSWATGTYEQYF,0,1,1,1
TRBV5-1,TRBJ2-1,CASSYSGTRDEQFF,0,1,1,1
TRBV5-1,TRBJ2-5,CASSLSTDSETQYF,0,1,1,1
TRBV5-1,TRBJ2-3,CASSPGLHTDTQYF,0,1,1,1
TRBV5-1,TRBJ2-7,CASSPQVGGDEQYF,0,1,1,1
TRBV5-1,TRBJ1-3,CASSPGAVGNTIYS,0,1,1,1
TRBV5-1,TRBJ2-1,CASSRLGVNDEQFF,0,1,1,1
TRBV5-1,TRBJ2-7,CASSKGQGAHEQYF,0,1,1,1
TRBV28,TRBJ2-2,CASRLRQITGELFF,0,1,1,1
TRBV5-1,TRBJ2-5,CARKGLGGQETQYF,0,1,1,1
TRBV20-1,TRBJ2-1,CSAFPGLASNEQFF,0,1,1,1
TRBV20-1,TRBJ2-3,CSALGGSGTDTQYF,0,1,1,1
TRBV20-1,TRBJ2-5,CSAQSPQGQETQYF,0,2,1,2
TRBV20-1,TRBJ2-5,CSAGAGTGGRTQYF,0,1,1,1
TRBV20-1,TRBJ2-2,CSAISGGRGRELFF,0,1,1,1
TRBV20-1,TRBJ2-1,CSASSLDYYNEQFF,0,1,1,1
TRBV20-1,TRBJ2-3,CSARGELATDTQYF,0,1,1,1
TRBV20-1,TRBJ2-3,CSARTRGVMDTQYF,0,1,1,1
TRBV20-1,TRBJ2-5,CSARGQEGRETQYF,0,1,1,1
TRBV20-1,TRBJ2-7,CSANKVDGPYEQYF,0,1,1,1
TRBV20-1,TRBJ2-3,CSAPSSGSPDTQYF,0,1,1,1
TRBV20-1,TRBJ2-7,CSATDLSGSDEQYF,0,1,1,1
TRBV20-1,TRBJ2-3,CSAGDQGGTDTQYF,0,1,1,1
TRBV29-1,TRBJ1-1,CSVQRTVVNTEAFF,0,1,1,1
TRBV29-1,TRBJ2-2,CSVVPANQGGELFF,0,1,1,1
TRBV29-1,TRBJ2-1,CSVEGGRRNNEQFF,0,1,1,1
TRBV29-1,TRBJ2-7,CSVLVAGISYEQYF,0,1,1,1
TRBV29-1,TRBJ2-3,CSAGAGGGTDTQYF,0,1,1,1
TRBV29-1,TRBJ1-1,CSAKTGTSNTEAFF,0,1,1,1
TRBV7-4,TRBJ2-7,RASSQKRGGYEQYF,0,1,1,1
TRBV29-1,TRBJ1-2,RSVTDRGAIYGHTS,0,1,1,1
TRBV5-6,TRBJ1-2,GASSRDRVLGGYTF,0,1,1,1
TRBV19,TRBJ2-1,CAFGTSGIGEQFF,0,1,1,1
TRBV30,TRBJ2-1,CAWSVWLGNEQFF,0,2,1,2
TRBV30,TRBJ1-5,CAWSVRSGQPQHY,0,1,1,1
TRBV30,TRBJ2-7,CAWSAGRTYEQYF,0,1,1,1
TRBV30,TRBJ1-2,CAWSRDFWVPYTF,0,1,1,1
TRBV30,TRBJ1-2,CAWNEGMNYGYTF,0,1,1,1
TRBV30,TRBJ1-5,CALSQGDNQPQHF,0,1,1,1
TRBV19,TRBJ2-1,CAGNGGLDNEQFF,0,1,1,1
TRBV10-3,TRBJ2-7,CAISGGTTSEQYF,0,1,1,1
TRBV24-1,TRBJ2-1,CATQDSSYNGQFF,0,1,1,1
TRBV7-9,TRBJ2-3,CATDSGSTDTQYF,0,1,1,1
TRBV24-1,TRBJ2-2,CATSDLNTGELFF,0,1,1,1
TRBV24-1,TRBJ2-3,CATSEPATDTQYF,0,1,1,1
TRBV10-3,TRBJ2-1,CATGTSGNNEQFF,0,1,1,1
TRBV19,TRBJ2-2,CASTIRTAGELFF,0,1,1,1
TRBV19,TRBJ2-7,CASSGYGIREQYI,0,1,1,1
TRBV19,TRBJ2-7,CASSYRASYEQYF,0,1,1,1
TRBV19,TRBJ2-5,CASSRLTQETQYF,0,1,1,1
TRBV3-1,TRBJ2-5,CASSQRNQETQYF,0,1,1,1
TRBV19,TRBJ2-1,CASSGSSYNEQFF,0,1,1,1
TRBV19,TRBJ2-1,CASSNPGGNEQFF,0,1,1,1
TRBV18,TRBJ2-1,CASSPLEYNEQFF,0,1,1,1
TRBV18,TRBJ2-1,CASSPPGENEQFF,0,1,1,1
TRBV6-2/3/5/6,TRBJ2-1,CASHPQDNNEQFF,0,1,1,1
TRBV7-9,TRBJ1-3,CASAPGTGNTIYF,0,1,1,1
TRBV5-5,TRBJ2-7,CASGYVLGDEKYF,0,1,1,1
TRBV12-3/4,TRBJ1-4,CASGLQNSEKLFF,0,1,1,1
TRBV7-6,TRBJ1-5,CASGKEPNQPQHF,0,1,1,1
TRBV2,TRBJ2-1,CASDRDFNNEQFF,0,1,1,1
TRBV6-2/3/5/6,TRBJ2-7,CASIHPGSYEQYF,0,1,1,1
TRBV6-2/3/5/6,TRBJ2-3,CASISGSTDTQHF,0,1,1,1
TRBV14,TRBJ2-7,CASTLAGGGEQYF,0,2,1,2
TRBV7-9,TRBJ2-2,CASTNRGDGELFF,0,2,1,2
TRBV2,TRBJ1-1,CASTGQPNTEAFF,0,1,1,1
TRBV28,TRBJ2-5,CASTSFVPETQYF,0,1,1,1
TRBV28,TRBJ2-3,CASSFYSTPTQYF,0,1,1,1
TRBV27,TRBJ2-1,CASSFGLANEQFF,0,1,1,1
TRBV12-3/4,TRBJ1-2,CASSLGGIYGYTF,0,1,1,1
TRBV28,TRBJ2-7,CASSSQGSYEQYF,0,1,1,1
TRBV11-3,TRBJ1-1,CASSSPGNTEAFF,0,2,1,2
TRBV6-1,TRBJ2-2,CASSGVNTGELFF,0,1,1,1
TRBV7-2,TRBJ2-7,CASSFGLAYEQYF,0,1,1,1
TRBV7-6,TRBJ2-7,CASSLGTSAQQYF,0,1,1,1
TRBV7-9,TRBJ2-3,CASSLDLAATQYF,0,1,1,1
TRBV11-2,TRBJ2-1,CASSLVPNNEQFF,0,1,1,1
TRBV7-6,TRBJ2-7,CASSLGRTYEQYF,0,1,1,1
TRBV7-9,TRBJ2-5,CASSLGVQETQYF,0,1,1,1
TRBV11-2,TRBJ2-1,CASSLGTGGEQFF,0,1,1,1
TRBV6-2/3/5/6,TRBJ1-1,CASSLTANTEAFF,0,1,1,1
TRBV11-2,TRBJ2-1,CASSLNPKNEQFF,0,1,1,1
TRBV5-4,TRBJ2-1,CASSSGTIDEQFF,0,1,1,1
TRBV7-7,TRBJ1-1,CASSSTENTEAFF,0,1,1,1
TRBV7-9,TRBJ2-1,CASSSTANDEQFF,0,1,1,1
TRBV7-9,TRBJ2-1,CASSYRESSEQFF,0,1,1,1
TRBV3-1,TRBJ1-5,CASSLNSDQPQHF,0,1,1,1
TRBV6-4,TRBJ2-7,CASSPGKIYEQYF,0,1,1,1
TRBV7-9,TRBJ2-7,CASSPRGPYEQYF,0,1,1,1
TRBV5-6,TRBJ2-5,CASSPLATETQYF,0,1,1,1
TRBV7-9,TRBJ1-2,CASSQETGIGYTF,0,1,1,1
TRBV3-1,TRBJ1-5,CASSQDELSRQHF,0,1,1,1
TRBV11-2,TRBJ2-7,CASSQTEGGEQYF,0,1,1,1
TRBV2,TRBJ2-1,CASSGDSDNEQFF,0,1,1,1
TRBV14,TRBJ2-5,CASSGQNQETQYF,0,1,1,1
TRBV12-3/4,TRBJ2-5,CASSRTGKETQYF,0,1,1,1
TRBV6-2/3/5/6,TRBJ1-2,CASRQDRRYGYTF,0,1,1,1
TRBV6-2/3/5/6,TRBJ2-5,CASRGRFRETQYF,0,1,1,1
TRBV7-2,TRBJ2-4,CASRGGDKNIQYF,0,1,1,1
TRBV6-2/3/5/6,TRBJ2-1,CASRLSQGGEQFF,0,1,1,1
TRBV6-4,TRBJ2-3,CASRRLSTDTQYF,0,1,1,1
TRBV6-2/3/5/6,TRBJ2-2,CASNRGVPGELFF,0,1,1,1
TRBV5-1,TRBJ2-7,CASFEAGAPEQYF,0,1,1,1
TRBV5-1,TRBJ1-4,CASRRAGKEKLFF,0,1,1,1
TRBV5-1,TRBJ1-2,CASSLVSSYGYTF,0,1,1,1
TRBV5-1,TRBJ2-6,CASSSIGANVLTF,0,2,1,2
TRBV5-1,TRBJ2-7,CASSSIGAYEQYF,0,1,1,1
TRBV5-1,TRBJ2-1,CASSRLLNHEQFF,0,1,1,1
TRBV5-1,TRBJ2-5,CASSNPTKETQYF,0,1,1,1
TRBV29-1,TRBJ2-2,CMGGQGGYGELFF,0,1,1,1
TRBV20-1,TRBJ1-5,CSVNQGSGQPQHF,0,1,1,1
TRBV20-1,TRBJ2-7,CSAGSDYVSEQYF,0,1,1,1
TRBV20-1,TRBJ2-5,CSAEGRTPETQYF,0,1,1,1
TRBV20-1,TRBJ2-3,CSASAYQGDTQYF,0,1,1,1
TRBV20-1,TRBJ2-3,CSARDRTADTQYF,0,1,1,1
TRBV20-1,TRBJ1-2,CSARDTGKGWGTF,0,1,1,1
TRBV20-1,TRBJ2-3,CSAKSGNTDTQYF,0,1,1,1
TRBV20-1,TRBJ2-7,CSAGQGAGYEQYF,0,1,1,1
TRBV20-1,TRBJ2-1,CSALTDRDNEQFF,0,1,1,1
TRBV29-1,TRBJ2-1,CSWGGGFYNEQFF,0,1,1,1
TRBV29-1,TRBJ2-1,CSVEAYPGNEQFF,0,1,1,1
TRBV29-1,TRBJ2-5,CSVEGGQSETQYF,0,1,1,1
TRBV29-1,TRBJ1-5,CSVSPTLEQPQHF,0,1,1,1
TRBV29-1,TRBJ2-2,CSGGQGRRGELFF,0,1,1,1
TRBV20-1,TRBJ2-1,CRASRGARLEHFF,0,1,1,1
TRBV6-4,TRBJ2-5,SASNKREETQYF,0,1,1,1
TRBV30,TRBJ1-1,CAWMPQVAEAFF,0,1,1,1
TRBV10-3,TRBJ2-5,CAISDSGETQYF,0,1,1,1
TRBV24-1,TRBJ2-7,CATESKVYEQYF,0,1,1,1
TRBV19,TRBJ1-2,CASSKGASGYTF,0,1,1,1
TRBV18,TRBJ2-2,CASSPSIGELFF,0,1,1,1
TRBV12-3/4,TRBJ2-7,CASGSRVGEQYF,0,1,1,1
TRBV28,TRBJ2-7,CASGVAGYEQYF,0,1,1,1
TRBV7-2,TRBJ2-7,CASTWGSREQYF,0,1,1,1
TRBV12-3/4,TRBJ2-7,CASSFLGDEQYF,0,1,1,1
TRBV12-3/4,TRBJ2-7,CASSFWRGEQYS,0,1,1,1
TRBV12-3/4,TRBJ1-5,CASSLNDQPQHF,0,1,1,1
TRBV6-2/3/5/6,TRBJ2-3,CASSYEGDTQYF,0,1,1,1
TRBV6-2/3/5/6,TRBJ2-7,CASSYSGHEQYF,0,1,1,1
TRBV6-2/3/5/6,TRBJ1-1,CASSLDRAEAFF,0,1,1,1
TRBV12-3/4,TRBJ2-3,CASSQSLDTQYF,0,1,1,1
TRBV28,TRBJ2-7,CASSGLIYEQYF,0,1,1,1
TRBV27,TRBJ2-5,CASSGERGTQYF,0,1,1,1
TRBV2,TRBJ2-7,CASSERDYEQYF,0,1,1,1
TRBV7-8,TRBJ2-7,CASSFSTSDGYF,0,1,1,1
TRBV5-4,TRBJ1-1,CASSLEAGEAFF,0,1,1,1
TRBV7-9,TRBJ2-7,CASSLSSYEQYF,0,1,1,1
TRBV7-9,TRBJ2-7,CASSLVPGGQYF,0,1,1,1
TRBV7-9,TRBJ1-1,CASSLVGGEAFF,0,1,1,1
TRBV11-2,TRBJ1-1,CASSLVGDEAFF,0,1,1,1
TRBV7-3,TRBJ2-3,CASSSQGSPQYF,0,1,1,1
TRBV3-1,TRBJ2-3,CASSPHRDTQYF,0,1,1,1
TRBV7-9,TRBJ2-1,CASSPSAYEQFF,0,1,1,1
TRBV7-2,TRBJ2-7,CASSPNLYEQYF,0,1,1,1
TRBV3-1,TRBJ2-2,CASSGDPGELFF,0,1,1,1
TRBV13,TRBJ2-3,CASSGSPDTQFF,0,1,1,1
TRBV7-9,TRBJ2-3,CASSMITDTQYF,0,1,1,1
TRBV5-5,TRBJ2-2,CASSTVSGELFF,0,1,1,1
TRBV12-3/4,TRBJ1-1,CASRYRNTEAFF,0,1,1,1
TRBV28,TRBJ2-2,CASRFQSGELFF,0,1,1,1
TRBV5-1,TRBJ2-2,CASSFSSGELFF,0,1,1,1
TRBV4-1,TRBJ1-1,CASSQPSTEAFF,0,1,1,1
TRBV5-1,TRBJ2-5,CASRASEETQYF,0,1,1,1
TRBV20-1,TRBJ2-1,CSARGDFDEQFF,0,1,1,1
TRBV29-1,TRBJ1-1,CSVRDRNTEAFF,0,1,1,1
TRBV29-1,TRBJ2-7,CSVAGRLHEQYF,0,1,1,1
TRBV29-1,TRBJ1-1,CSVGLGLTEAFF,0,1,1,1
TRBV29-1,TRBJ2-3,CSVGGGTDTQYF,0,1,1,1
TRBV29-1,TRBJ1-1,CSVGTDNTEAFF,0,1,1,1
TRBV29-1,TRBJ2-7,CSVELTDYEQYF,0,1,1,1
TRBV29-1,TRBJ2-7,CSVERQGYEQYF,0,1,1,1
TRBV29-1,TRBJ2-5,CSVTGGQETQYF,0,1,1,1
TRBV29-1,TRBJ1-2,CSAGEGNYGYTF,0,1,1,1
TRBV29-1,TRBJ2-1,CSATDFYNEQFF,0,1,1,1
TRBV30,TRBJ2-4,CASGGRAIQYF,0,1,1,1
TRBV30,TRBJ1-2,CAWSVGSGYTF,0,1,1,1
TRBV30,TRBJ1-1,CAWRSTGRAFL,0,1,1,1
TRBV2,TRBJ2-3,CAGASTDTQYY,0,1,1,1
TRBV10-3,TRBJ2-5,CAISEGETQYF,0,1,1,1
TRBV10-3,TRBJ2-1,CAINAGTGQFF,0,1,1,1
TRBV2,TRBJ2-7,CASRMGAEQYF,0,1,1,1
TRBV28,TRBJ2-4,CASTLGGIQYF,0,1,1,1
TRBV6-2/3/5/6,TRBJ2-5,CASSSQETQYF,0,1,1,1
TRBV11-2,TRBJ1-1,CASSFHWAAIF,0,1,1,1
TRBV7-9,TRBJ2-5,CASSLRETQYF,0,1,1,1
TRBV13,TRBJ2-7,CASSLVDEQYF,0,1,1,1
TRBV5-6,TRBJ2-7,CASSSRFEQYF,0,1,1,1
TRBV7-2,TRBJ2-3,CASSPHDTQYF,0,2,1,2
TRBV12-3/4,TRBJ2-1,CASSTWDEQFF,0,1,1,1
TRBV12-3/4,TRBJ1-2,CASRGDYGYTF,0,1,1,1
TRBV29-1,TRBJ2-1,CHVGGGGEQFF,0,1,1,1
TRBV20-1,TRBJ2-7,CSLQSSYEQYF,0,1,1,1
TRBV29-1,TRBJ2-5,CSALQGETQYF,0,1,1,1
TRBV20-1,TRBJ2-5,CSARPGETQYF,0,2,1,2
TRBV20-1,TRBJ2-1,CSAEGVNEQFF,0,1,1,1
TRBV29-1,TRBJ2-1,CSVVWGNEQFF,0,1,1,1
TRBV29-1,TRBJ2-1,CSVNPYNEQFF,0,1,1,1
TRBV20-1,TRBJ2-1,CSATQNNEQFF,0,1,1,1
TRBV25-1,TRBJ2-1,CATSRGEQFF,0,1,1,1
TRBV6-4,TRBJ1-4,CASSDRALFF,0,1,1,1
TRBV6-2/3/5/6,TRBJ2-1,CASSSSGTSGRYYSFDEQFF,0,1,1,1
TRBV18,TRBJ2-1,CASSPRGLAGDSHNEQFF,0,1,1,1
TRBV18,TRBJ2-1,CASSPPGTRTSYNEQFF,0,1,1,1
TRBV9,TRBJ2-1,CASSVDAGGSSYNEQFF,0,1,1,1
TRBV7-9,TRBJ2-2,CASSTTGTGVRTGELFF,0,1,1,1
TRBV7-2,TRBJ2-7,CASSLTVGSGRYGQYF,0,1,1,1
TRBV7-9,TRBJ2-3,CASSLGGVPWTDTQYF,0,1,1,1
TRBV9,TRBJ2-1,CASSVRLAGEGSEQFF,0,1,1,1
TRBV27,TRBJ1-1,CASRNYRDTLGTEAFF,0,1,1,1
TRBV19,TRBJ2-3,CASSRGNINPDTQYF,0,1,1,1
TRBV19,TRBJ2-6,CASRTGFPGANVLTF,0,1,1,1
TRBV18,TRBJ1-1,CASSPPPVGNTESFF,0,1,1,1
TRBV12-3/4,TRBJ1-6,CASSPGRGNNSPLHF,0,1,1,1
TRBV11-2,TRBJ2-2,CASSTRVYYVGELFF,0,1,1,1
TRBV5-4,TRBJ1-1,CASSSLGGMVAEAFF,0,1,1,1
TRBV4-1,TRBJ1-3,CASSRRTGTGNTIYF,0,1,1,1
TRBV4-1,TRBJ1-2,CASSQESSEVYGYAF,0,1,1,1
TRBV29-1,TRBJ2-4,CSVEGGRGVGNIQYF,0,1,1,1
TRBV5-1,TRBJ2-3,CASSLRADSDTQYF,0,1,1,1
TRBV29-1,TRBJ2-3,CSVEADGNTDTQYF,0,1,1,1
TRBV12-3/4,TRBJ2-1,RASRTSGSFDEQFF,0,1,1,1
TRBV10-3,TRBJ2-5,CAISGAGQETQYF,0,1,1,1
TRBV2,TRBJ2-1,CASGLGVRNEQFF,0,1,1,1
TRBV7-9,TRBJ2-7,CASSLRESGEQYF,0,1,1,1
TRBV28,TRBJ2-7,CASSSAGGREQYF,0,1,1,1
TRBV20-1,TRBJ2-1,CSARRGDNEQFF,0,1,1,1
TRBV5-6,TRBJ2-7,CASSPWSRRGTGAFSTSGTSYEQYF,0,1,1,1
TRBV3-1,TRBJ2-1,CASSPAGDEAPGLAGFSFGEQFF,0,1,1,1
TRBV29-1,TRBJ2-1,CSVEDFHPRTSGSLESYNEQFF,0,1,1,1
TRBV6-2/3/5/6,TRBJ2-3,CASSYRPGLAGGPRSTDTQYF,0,1,1,1
TRBV7-9,TRBJ2-6,CASSLPVHQGTSGGANVLTF,0,1,1,1
TRBV6-1,TRBJ2-2,CASRENPGTVREAGPGELFF,0,1,1,1
TRBV20-1,TRBJ2-6,CSAPTSGRASAGSGANVLTF,0,1,1,1
TRBV20-1,TRBJ2-1,CSASPGLAATTRLNLYEQFF,0,1,1,1
TRBV7-2,TRBJ2-1,CAGSTSGVLAGGTHNEQFF,0,1,1,1
TRBV19,TRBJ2-7,CASSRKDSGLAGSSYEQYF,0,1,1,1
TRBV18,TRBJ2-1,CASSSQGWLAGDSYNEQFF,0,1,1,1
TRBV27,TRBJ2-1,CASMKGLAGYSGTINEQFF,0,1,1,1
TRBV5-6,TRBJ2-1,CASSFFGTSGRTRDNEQFF,0,1,1,1
TRBV7-9,TRBJ2-3,CASSFPAGEGRTSTDTQYF,0,1,1,1
TRBV11-2,TRBJ2-4,CASSLEALTSRVAKNIQYF,0,1,1,1
TRBV11-2,TRBJ2-3,CASSSTGASGRAGADTQYF,0,1,1,1
TRBV5-1,TRBJ2-2,CASSLMTGGPRGNTGELFF,0,1,1,1
TRBV20-1,TRBJ2-3,CSARDPGLAGGRSTDTQYF,0,1,1,1
TRBV30,TRBJ2-1,CAWRNDRAGTSGYNEQFF,0,1,1,1
TRBV24-1,TRBJ2-1,CATSVPSGQGAGEHEQFF,0,1,1,1
TRBV24-1,TRBJ2-2,CATSDLGLAGGGTGELFF,0,1,1,1
TRBV15,TRBJ2-2,CATSSLGGKRPNTGELFF,0,1,1,1
TRBV19,TRBJ1-5,CASSPGRDRGYSNQPQHF,0,1,1,1
TRBV18,TRBJ2-3,CASSPPWDRPRQADTQYF,0,1,1,1
TRBV18,TRBJ2-1,CASSPRQEAGGPVGEQFF,0,1,1,1
TRBV9,TRBJ2-1,CASTRSGSGWGNLNEQFF,0,1,1,1
TRBV28,TRBJ2-7,CASSPKITTGAFSYEQYF,0,1,1,1
TRBV7-9,TRBJ2-1,CASSSGLAGLSSYNEQFF,0,1,1,1
TRBV5-6,TRBJ2-1,CASSWWGPSGRKANEQFF,0,1,1,1
TRBV5-6,TRBJ2-2,CASSPSLRGVWDTGELLF,0,1,1,1
TRBV3-1,TRBJ2-2,CASSQGGLAAINTGELFF,0,1,1,1
TRBV7-9,TRBJ2-2,CASSDSTSGRRRTGELFF,0,1,1,1
TRBV5-1,TRBJ2-7,CASSLAPKRTSGGYEQYF,0,1,1,1
TRBV5-1,TRBJ2-5,CASSLAGGSGAFQETQYF,0,1,1,1
TRBV4-1,TRBJ2-1,CASSQVGGQGLSYNEQFF,0,1,1,1
TRBV5-1,TRBJ2-1,CASSTGLAGDLSVDEQFF,0,1,1,1
TRBV29-1,TRBJ2-1,CSVEDPLERGLLGNEQFF,0,1,1,1
TRBV29-1,TRBJ2-5,CSVEDTAPDTVALGTQYF,0,1,1,1
TRBV30,TRBJ1-5,CAWSDGGGGVGNQPQHF,0,1,1,1
TRBV30,TRBJ1-1,CAWRVGQGIFVNTEAFF,0,1,1,1
TRBV28,TRBJ2-7,CALPRSSDGTGTYEQYF,0,1,1,1
TRBV10-3,TRBJ2-6,CAISETGGNSGANVLTF,0,1,1,1
TRBV19,TRBJ2-3,CASSEGGLAMSTDTQYF,0,1,1,1
TRBV19,TRBJ2-1,CASSISRSGGAYNVQFF,0,1,1,1
TRBV19,TRBJ2-2,CASSADRAAENTRELFF,0,1,1,1
TRBV19,TRBJ1-1,CASRDPLSQGANTEAFF,0,1,1,1
TRBV18,TRBJ1-5,CASSPRERGQGTQPQHF,0,1,1,1
TRBV18,TRBJ2-5,CASSPPSRRRVGETQYF,0,1,1,1
TRBV18,TRBJ2-3,CASSPVMGEPSTDTQYF,0,1,1,1
TRBV19,TRBJ1-1,CASLKKRPGTGVGEAFF,0,1,1,1
TRBV18,TRBJ2-2,CASALGMVSTNTGELFF,0,1,1,1
TRBV2,TRBJ2-1,CASIKGLAGARHNEQFF,0,1,1,1
TRBV6-2/3/5/6,TRBJ2-1,CASSFSPGTGVQDEQFF,0,1,1,1
TRBV6-2/3/5/6,TRBJ2-7,CASSFPQGGRIFYEQYF,0,1,1,1
TRBV27,TRBJ2-1,CASSFTSGSSTYNEQFF,0,1,1,1
TRBV28,TRBJ2-3,CASSLVSSGRQGDTQYF,0,1,1,1
TRBV27,TRBJ2-3,CASSLWWSGKNTDTQYF,0,1,1,1
TRBV28,TRBJ2-5,CASSSRRLAGGWETQYF,0,1,1,1
TRBV3-1,TRBJ1-2,CASSLTSTGRFFYGYTF,0,1,1,1
TRBV6-2/3/5/6,TRBJ1-1,CASSPGQGLGMGTEAFF,0,1,1,1
TRBV6-1,TRBJ2-6,CASSAFGVLTGANVLTF,0,1,1,1
TRBV6-4,TRBJ2-1,CASSDLVGGPSNNEQFF,0,1,1,1
TRBV7-2,TRBJ2-1,CASSTLPSGSSYNEQFF,0,1,1,1
TRBV6-2/3/5/6,TRBJ2-1,CASSRGLAGGGYNEQFF,0,1,1,1
TRBV11-2,TRBJ2-2,CASSLVGRRRSTGELFF,0,1,1,1
TRBV7-2,TRBJ2-2,CASSLVAGVRYTGELFF,0,1,1,1
TRBV7-6,TRBJ2-7,CASSLAPGTGSSYEQYF,0,1,1,1
TRBV7-9,TRBJ2-7,CASSLAKGSGRIDEQYF,0,1,1,1
TRBV7-6,TRBJ2-7,CASSLGIGASGNYEQYF,0,1,1,1
TRBV7-6,TRBJ1-1,CASSLEPPTPGNTEAFF,0,1,1,1
TRBV6-2/3/5/6,TRBJ2-7,CASSSDGLAGRAYEQYF,0,1,1,1
TRBV13,TRBJ2-2,CASSPPRTSGNTGELFF,0,1,1,1
TRBV5-6,TRBJ1-2,CASSPDGFKGANYGYTF,0,1,1,1
TRBV3-1,TRBJ2-1,CASSPGLAGAAYNEQFF,0,1,1,1
TRBV9,TRBJ2-7,CASSPAPGLASSYEQYF,0,1,1,1
TRBV14,TRBJ1-1,CASSRQPGLKSDTEAFF,0,1,1,1
TRBV3-1,TRBJ1-4,CASSQSHARLSNEKLFF,0,1,1,1
TRBV4-2,TRBJ2-7,CASSQEGLAGGTYEQYF,0,1,1,1
TRBV14,TRBJ2-1,CASSQESRLPLYNEQFF,0,1,1,1
TRBV9,TRBJ2-3,CASSVLAGQKSTGTQYF,0,1,1,1
TRBV7-2,TRBJ2-7,CASSVAAGATPGYEQYF,0,1,1,1
TRBV13,TRBJ2-3,CASSASGTSGITDTQYF,0,1,1,1
TRBV6-4,TRBJ2-5,CASSTSRAAGGQETQYF,0,1,1,1
TRBV6-2/3/5/6,TRBJ2-3,CASRHRGADTSTDTQYF,0,1,1,1
TRBV28,TRBJ2-5,CTSSPAWGTSGRETQYF,0,1,1,1
TRBV29-1,TRBJ2-3,CRVEDLYAPRHADTQYF,0,1,1,1
TRBV5-1,TRBJ2-5,CASSFRGQLLHQETQYF,0,1,1,1
TRBV5-1,TRBJ2-7,CASSLGQGLHLSYEQYF,0,1,1,1
TRBV4-1,TRBJ2-1,CASSQGLTSGSPSEQFF,0,1,1,1
TRBV4-1,TRBJ1-2,CASSQDSLTGANYGYTF,0,1,1,1
TRBV4-1,TRBJ2-1,CASSEVLAGVPYNEQFF,0,1,1,1
TRBV5-1,TRBJ2-5,CASRLEGSSKYQETQYF,0,1,1,1
TRBV20-1,TRBJ2-6,CSASPLQGIAGANVLTF,0,1,1,1
TRBV20-1,TRBJ2-3,CSASPGLAGDLTDTQYF,0,1,1,1
TRBV20-1,TRBJ2-1,CSARVLPSSGRYNEQFF,0,1,1,1
TRBV20-1,TRBJ2-7,CSARGGEDGGRRGRQYF,0,1,1,1
TRBV20-1,TRBJ2-1,CSARDQGASGRYGEQFF,0,1,1,1
TRBV20-1,TRBJ2-3,CSAPPRGAKSSTDTQYF,0,1,1,1
TRBV29-1,TRBJ2-7,CSVVASGRSTWNYEQYF,0,1,1,1
TRBV29-1,TRBJ2-1,CSVDWPGTSGFYNEQFF,0,1,1,1
TRBV29-1,TRBJ2-7,CSVEDQLAGAGAYERYF,0,1,1,1
TRBV29-1,TRBJ2-7,CSAVGPPGTGISYEQYF,0,1,1,1
TRBV5-1,TRBJ2-5,RASSSGQGGISGETQYF,0,1,1,1
TRBV4-1,TRBJ2-1,RASSQDVRVDSYNEQFF,0,1,1,1
TRBV28,TRBJ1-3,CVSSALIGYSGNTIYF,0,1,1,1
TRBV12-5,TRBJ2-3,CASGQTSGRAIDTQYF,0,1,1,1
TRBV30,TRBJ2-4,CAWSVRVGTGENIQYF,0,1,1,1
TRBV28,TRBJ2-3,CAGSTQDREVADTQYF,0,1,1,1
TRBV10-3,TRBJ2-7,CAIFPLAGAPSGEQYF,0,1,1,1
TRBV10-3,TRBJ2-1,CAISPRGGPLFNEQFF,0,1,1,1
TRBV24-1,TRBJ2-5,CATSGVLAGSQETQYF,0,1,1,1
TRBV24-1,TRBJ2-1,CATSDSSGRAYNEQFF,0,1,1,1
TRBV24-1,TRBJ2-6,CATSDSRSSGANVLTF,0,1,1,1
TRBV24-1,TRBJ2-5,CATSEPGTGDEETQYF,0,1,1,1
TRBV18,TRBJ2-5,CASSPGVGSTVETQYF,0,1,1,1
TRBV19,TRBJ1-5,CASRVRDRDSNQPQHF,0,1,1,1
TRBV19,TRBJ2-3,CASSGIADGSPDTQYF,0,1,1,1
TRBV19,TRBJ2-2,CASSILAGVVGGELFF,0,1,1,1
TRBV19,TRBJ1-6,CASSIEYRVENSPLHF,0,1,1,1
TRBV19,TRBJ2-1,CASRTLRTSGDNEQFF,0,1,1,1
TRBV19,TRBJ1-5,CASRKETGGINQPQHF,0,1,1,1
TRBV6-2/3/5/6,TRBJ2-7,CASSRPPRDRDYEQYF,0,1,1,1
TRBV18,TRBJ2-1,CASSLSSVSSYNEQFF,0,1,1,1
TRBV18,TRBJ1-5,CASSPQGRGGEQPQHF,0,1,1,1
TRBV18,TRBJ2-5,CASSPVGTGGKETQYF,0,1,1,1
TRBV18,TRBJ2-7,CASSPTGVGSSYEQYF,0,1,1,1
TRBV18,TRBJ2-1,CASSPPGAVVGNEQFF,0,1,1,1
TRBV18,TRBJ2-7,CASSVFTGTASYEQYF,0,1,1,1
TRBV6-2/3/5/6,TRBJ1-4,CASGYSLQGMVEKLFF,0,1,1,1
TRBV12-3/4,TRBJ2-1,CASTLVWGIGGNEQFF,0,1,1,1
TRBV7-6,TRBJ2-1,CASTGSETSSYNEQFF,0,1,1,1
TRBV12-3/4,TRBJ2-2,CASSFWTDENAGELFF,0,1,1,1
TRBV28,TRBJ2-7,CASSFKHPFGTYEQYF,0,1,1,1
TRBV10-2,TRBJ2-3,CASSFGSGRAADTQYF,0,1,1,1
TRBV12-3/4,TRBJ1-2,CASSLSSRQGSAGYTF,0,1,1,1
TRBV27,TRBJ2-5,CASSLSCPTEKETQYF,0,1,1,1
TRBV28,TRBJ2-7,CASSLGGGWSSYEQYF,0,1,1,1
TRBV12-3/4,TRBJ2-2,CASSLEGAANTGELFF,0,1,1,1
TRBV28,TRBJ2-1,CASSLISGDRANEQFF,0,1,1,1
TRBV28,TRBJ2-5,CASSSYRPTGEETQYF,0,1,1,1
TRBV28,TRBJ2-5,CASSSPGGPFGETQYF,0,1,1,1
TRBV28,TRBJ2-3,CASSSSGTGWADTQYF,0,1,1,1
TRBV28,TRBJ2-1,CASSSGPGLLANEQFF,0,1,1,1
TRBV6-2/3/5/6,TRBJ2-1,CASSYPTGRSYNEQFF,0,1,1,1
TRBV6-2/3/5/6,TRBJ2-1,CASSYSGLAGGREQFF,0,1,1,1
TRBV6-2/3/5/6,TRBJ2-1,CASSYSGTGVTNEQFF,0,1,1,1
TRBV6-2/3/5/6,TRBJ2-3,CASSYAGQGFRDTQYF,0,1,1,1
TRBV7-7,TRBJ2-1,CASSLRAVSGSNEQFF,0,1,1,1
TRBV28,TRBJ1-4,CASSPGEGLRREKLFF,0,1,1,1
TRBV6-2/3/5/6,TRBJ2-7,CASSPTGLAGGRVQYF,0,1,1,1
TRBV6-2/3/5/6,TRBJ2-2,CASSHSAGTDAGELFF,0,1,1,1
TRBV6-1,TRBJ2-4,CASSGGQAIAKNIQYF,0,1,1,1
TRBV25-1,TRBJ2-1,CASSGQTSGVYNEQFF,0,1,1,1
TRBV6-2/3/5/6,TRBJ2-2,CASSIVTGPNTGELFF,0,1,1,1
TRBV28,TRBJ2-2,CASSTIAGAQGGELLF,0,1,1,1
TRBV28,TRBJ2-5,CASSTLTGARKETQYF,0,1,1,1
TRBV5-4,TRBJ2-3,CASSLVSGSGADTQYF,0,1,1,1
TRBV5-8,TRBJ2-1,CASSLALQGRHNEQFF,0,1,1,1
TRBV5-6,TRBJ2-7,CASSLALAGMSYEQYF,0,1,1,1
TRBV11-2,TRBJ2-2,CASSLVGGPWAGELFF,0,1,1,1
TRBV7-9,TRBJ2-7,CASSLVGGTATYEQYF,0,1,1,1
TRBV7-9,TRBJ2-3,CASSLAQGTSTDTQYF,0,1,1,1
TRBV7-9,TRBJ2-1,CASSLGSGNLNDEQFF,0,1,1,1
TRBV7-2,TRBJ2-7,CASSLGVPSGPYEQYF,0,1,1,1
TRBV11-3,TRBJ2-1,CASSLGASGTTNEQFF,0,1,1,1
TRBV13,TRBJ2-2,CASSLGLAENTGELFF,0,1,1,1
TRBV11-2,TRBJ2-1,CASSLDLTLGYNEQFF,0,1,1,1
TRBV7-9,TRBJ1-2,CASSLRSGVKIYGYTF,0,1,1,1
TRBV11-1,TRBJ2-3,CASSLRRRRADGPQYF,0,1,1,1
TRBV11-3,TRBJ2-1,CASSSRTSGPYNEQFF,0,1,1,1
TRBV7-6,TRBJ2-5,CASSSIGDRGRETQYF,0,1,1,1
TRBV3-1,TRBJ2-1,CASSSKSGIVSREQFF,0,1,1,1
TRBV7-8,TRBJ2-7,CASSSVGGSAAYEQYF,0,1,1,1
TRBV5-4,TRBJ2-7,CASSSTTSGRSYEQYF,0,1,1,1
TRBV7-9,TRBJ2-5,CASSSTAGTSGETQYF,0,1,1,1
TRBV7-9,TRBJ2-7,CASSWGQAVTRGEQYF,0,1,1,1
TRBV5-4,TRBJ2-6,CASSYSGGAGANVLTF,0,1,1,1
TRBV14,TRBJ2-5,CASSLRPGLGQETQYF,0,1,1,1
TRBV7-2,TRBJ2-3,CASSLYRLAGADTQYF,0,1,1,1
TRBV11-2,TRBJ2-5,CASSLSGLAGEETQYF,0,1,1,1
TRBV11-2,TRBJ2-3,CASSPGTTVRTDTQYF,0,1,1,1
TRBV7-9,TRBJ2-3,CASSPSQGLGTDTQYF,0,1,1,1
TRBV7-2,TRBJ2-4,CASSPRRRGAKNIQYF,0,1,1,1
TRBV4-2,TRBJ1-1,CASSPRGTGVGAEAFF,0,1,1,1
TRBV7-6,TRBJ1-4,CASSPTGRSANEKLFF,0,1,1,1
TRBV28,TRBJ2-3,CASSPAVRQTTDTQYF,0,1,1,1
TRBV7-9,TRBJ1-2,CASSPGQGYKNYGYTF,0,1,1,1
TRBV11-2,TRBJ1-1,CASSPSGGRKNTEAFF,0,1,1,1
TRBV5-8,TRBJ2-7,CASSREGTSGSYEQYF,0,1,1,1
TRBV3-1,TRBJ2-3,CASSHVEGVGTDTQYL,0,1,1,1
TRBV3-1,TRBJ2-1,CASSHTGTGTYNEQFF,0,1,1,1
TRBV3-1,TRBJ1-5,CASSQPFRQGDQPQHF,0,1,1,1
TRBV4-2,TRBJ2-1,CASSQPFTSGNVEQFF,0,1,1,1
TRBV3-1,TRBJ2-4,CASSQVFGLAKDIQYF,0,1,1,1
TRBV3-1,TRBJ2-1,CASSQVETSANNEQFF,0,1,1,1
TRBV3-1,TRBJ1-1,CASSQDSPTGDTEAFF,0,1,1,1
TRBV3-1,TRBJ2-1,CASSQDRRASYNEQFF,0,1,1,1
TRBV9,TRBJ2-5,CASSVAATVHQETQYF,0,1,1,1
TRBV6-1,TRBJ2-1,CASRDRDLSSYNEQFF,0,1,1,1
TRBV6-1,TRBJ2-5,CASREPGPSGQETQYF,0,1,1,1
TRBV28,TRBJ2-1,CASRRGRTSYHNEQFF,0,1,1,1
TRBV6-2/3/5/6,TRBJ2-7,CASRPITGTGTNEQYF,0,1,1,1
TRBV2,TRBJ2-1,CASRALAGSSYNEQFF,0,1,1,1
TRBV27,TRBJ2-3,CASRTYRGLRTDTQYF,0,1,1,1
TRBV28,TRBJ2-7,CASNPGTGGVFGEQYF,0,1,1,1
TRBV20-1,TRBJ1-5,CRGRSGTHLMDQPQHF,0,1,1,1
TRBV5-1,TRBJ2-3,CVSSPNTGSLGDTQYF,0,1,1,1
TRBV5-1,TRBJ2-1,CASVPRPSGAYNEQFF,0,1,1,1
TRBV5-1,TRBJ2-7,CASTFTQRTVPYEQYF,0,1,1,1
TRBV5-1,TRBJ2-1,CASSFRGTSGYNEQFF,0,1,1,1
TRBV5-1,TRBJ2-2,CASSLVTSPNTGELFF,0,1,1,1
TRBV5-6,TRBJ2-5,CASSLAFGTSGETQYF,0,1,1,1
TRBV5-1,TRBJ2-1,CASSLALGGGYNEQFF,0,1,1,1
TRBV5-1,TRBJ2-7,CASSLAKTSGSYEQYF,0,1,1,1
TRBV5-1,TRBJ2-7,CASSLLPGQGNYEQYF,0,1,1,1
TRBV5-1,TRBJ2-1,CASSSLGPVGVNEQFF,0,1,1,1
TRBV5-1,TRBJ2-1,CASSYSGPGGINEQFF,0,1,1,1
TRBV5-1,TRBJ2-1,CASSPSGGSSYNEQFF,0,1,1,1
TRBV11-2,TRBJ2-3,CASSHSLAGYTDTQYF,0,1,1,1
TRBV4-1,TRBJ2-1,CASSHRGQTLYNEQFF,0,1,1,1
TRBV4-1,TRBJ1-2,CASSQSDSDANYGYTF,0,1,1,1
TRBV4-1,TRBJ1-1,CASSQVGRGKGTEAFF,0,1,1,1
TRBV5-1,TRBJ1-4,CASSDDLSATNEKLFF,0,1,1,1
TRBV5-1,TRBJ2-7,CASSTDPGQSIYEQYF,0,1,1,1
TRBV20-1,TRBJ2-1,CSPQAREGPSYSEQFF,0,1,1,1
TRBV20-1,TRBJ2-7,CSARGERGADSYEQYF,0,1,1,1
TRBV20-1,TRBJ1-3,CSAREGPAISGNTIYF,0,1,1,1
TRBV20-1,TRBJ2-7,CSARTRGLGNSYEQYF,0,1,1,1
TRBV29-1,TRBJ2-1,CSVVSGSDTFFNEQFF,0,1,1,1
TRBV29-1,TRBJ2-1,CSVAVGGTGGYNEKFF,0,1,1,1
TRBV29-1,TRBJ2-5,CSVDTVGGRWGETQYF,0,1,1,1
TRBV29-1,TRBJ2-7,CSVEGPGAGLSYEQYF,0,1,1,1
TRBV29-1,TRBJ2-1,CSVEDAGTSGIGEQFF,0,1,1,1
TRBV20-1,TRBJ2-5,CRALGLAGAGQETQYF,0,1,1,1
TRBV18,TRBJ2-4,YASSPGGAWTKNIQYF,0,1,1,1
TRBV12-5,TRBJ2-2,CASGLCQGNTGELFF,0,1,1,1
TRBV12-5,TRBJ2-7,CASGGNRGLTYEQYF,0,1,1,1
TRBV12-3/4,TRBJ2-3,CASSHTTDITDTQYF,0,1,1,1
TRBV30,TRBJ1-1,CACPPPGGLETEAFF,0,1,1,1
TRBV30,TRBJ1-5,CAWSVQGLGNQPQHF,0,1,1,1
TRBV10-3,TRBJ2-5,CAISDSQGSQETQYF,0,1,1,1
TRBV10-3,TRBJ2-1,CAISESARLNNEQFF,0,1,1,1
TRBV15,TRBJ1-5,CATADRLVGNQPQHF,0,1,1,1
TRBV24-1,TRBJ2-7,CATSAGTSGSYEQYF,0,1,1,1
TRBV24-1,TRBJ2-6,CATSGTATGANVLTF,0,1,1,1
TRBV24-1,TRBJ2-2,CATSDSGVNTGELFF,0,1,1,1
TRBV7-2,TRBJ2-5,CASLPTGPGGETQYF,0,1,1,1
TRBV19,TRBJ1-1,CASRSDRAETTEAFF,0,1,1,1
TRBV19,TRBJ2-1,CASTTGTSGNNEQFF,0,1,1,1
TRBV19,TRBJ2-7,CASTPSGRGGPEQYF,0,1,1,1
TRBV19,TRBJ2-3,CASTRSGGFGNTQYF,0,1,1,1
TRBV19,TRBJ2-5,CASSPGLAGAETQYF,0,1,1,1
TRBV19,TRBJ2-7,CASSITGQGIYEQYF,0,1,1,1
TRBV19,TRBJ1-2,CASSMGRAEYYGYTF,0,1,1,1
TRBV19,TRBJ1-3,CASSISWSSGNTIYF,0,1,1,1
TRBV19,TRBJ1-1,CASSTPGQGTFEAFF,0,1,1,1
TRBV19,TRBJ2-1,CASSNWTDAYNEQFF,0,1,1,1
TRBV19,TRBJ2-7,CASSLGTQLYYEQYF,0,1,1,1
TRBV19,TRBJ2-1,CASSLTSGNYNERFF,0,1,1,1
TRBV19,TRBJ2-1,CASSRGPSSYYEQFF,0,1,1,1
TRBV19,TRBJ1-5,CASNREGLGNQPQHF,0,1,1,1
TRBV18,TRBJ2-7,CASSSEGQASYEQYF,0,1,1,1
TRBV9,TRBJ2-1,CASSGRGDSYNEQFF,0,1,1,1
TRBV27,TRBJ2-1,CASSKAGAIHHEQFF,0,1,1,1
TRBV18,TRBJ2-5,CASSPRTAAQETQYF,0,1,1,1
TRBV18,TRBJ2-7,CASSPNARRSYEQYF,0,1,1,1
TRBV18,TRBJ2-7,CASSPASGILDEQYF,0,1,1,1
TRBV18,TRBJ2-5,CASSPLKSSGETQYF,0,1,1,1
TRBV18,TRBJ2-7,CASSPPRGPAYEQYF,0,1,1,1
TRBV18,TRBJ1-6,CASSPQENRGSPLHF,0,1,1,1
TRBV18,TRBJ1-6,CASSPVPVYNSPLHF,0,1,1,1
TRBV18,TRBJ2-1,CASSPGSGRVNEQSF,0,1,1,1
TRBV18,TRBJ1-1,CASSPGRAWDTEAFF,0,1,1,1
TRBV18,TRBJ1-5,CASSPGAGGNQPQHF,0,1,1,1
TRBV2,TRBJ2-1,CASWVGTAGPGGQFF,0,1,1,1
TRBV2,TRBJ2-7,CASLTPGQGRREQYF,0,1,1,1
TRBV27,TRBJ2-1,CASRRTAGRYNEQFF,0,1,1,1
TRBV12-3/4,TRBJ1-5,CASGLGTGPGQPQHF,0,1,1,1
TRBV28,TRBJ2-4,CASGPTGGYKNIQYF,0,1,1,1
TRBV6-2/3/5/6,TRBJ2-2,CASGGQETNTGELFF,0,1,1,1
TRBV28,TRBJ2-1,CASTGGGMDYNEQFF,0,1,1,1
TRBV12-3/4,TRBJ2-7,CASTLLGQGTYEQYF,0,1,1,1
TRBV11-1,TRBJ2-2,CASTRTGVNTGELFF,0,1,1,1
TRBV27,TRBJ2-1,CASTVVGSSYNEQFF,0,1,1,1
TRBV28,TRBJ2-5,CASSLYGTGQETQYF,0,1,1,1
TRBV6-2/3/5/6,TRBJ2-2,CASSLLGGNTGELFF,0,1,1,1
TRBV28,TRBJ2-7,CASSLVGRVNYEQYF,0,1,1,1
TRBV28,TRBJ2-1,CASSLAGGPLNEQFF,0,1,1,1
TRBV12-3/4,TRBJ2-5,CASSLAAGGLETQYF,0,1,1,1
TRBV6-2/3/5/6,TRBJ2-1,CASSLGLAVYNEQFF,0,1,1,1
TRBV12-3/4,TRBJ2-2,CASSLGAANTGELFF,0,1,1,1
TRBV6-2/3/5/6,TRBJ2-7,CASSLGDRVSYEQYF,0,1,1,1
TRBV12-3/4,TRBJ2-7,CASSLGGTGDNEQYF,0,1,1,1
TRBV27,TRBJ2-5,CASSLTSGNQETQYF,0,1,1,1
TRBV6-2/3/5/6,TRBJ2-1,CASSLSQGAYNEQFF,0,1,1,1
TRBV12-3/4,TRBJ2-5,CASSLRWSGGETQYF,0,1,1,1
TRBV12-3/4,TRBJ2-3,CASSSLGNSADTQYF,0,1,1,1
TRBV28,TRBJ1-2,CASSSRSTDYYGYTF,0,1,1,1
TRBV6-2/3/5/6,TRBJ2-5,CASSSGTSGQETQYF,0,1,1,1
TRBV12-3/4,TRBJ2-7,CASSSNRKTDYEQYF,0,1,1,1
TRBV6-2/3/5/6,TRBJ2-7,CASSWSGLAAYEQYF,0,1,1,1
TRBV6-2/3/5/6,TRBJ2-3,CASSYSTSGTHTQYF,0,1,1,1
TRBV6-2/3/5/6,TRBJ2-1,CASSYSTGGYNEQFF,0,1,1,1
TRBV6-2/3/5/6,TRBJ1-2,CASSLGQGDKNGYTF,0,1,1,1
TRBV11-1,TRBJ2-5,CASSLTGVLQETQYF,0,1,1,1
TRBV2,TRBJ2-1,CASSPRTSGGGEQFF,0,1,1,1
TRBV6-2/3/5/6,TRBJ2-1,CASSRGTSGPPEQFF,0,1,1,1
TRBV6-1,TRBJ2-7,CASSDEGRRPYEQYF,0,1,1,1
TRBV2,TRBJ2-7,CASSDRQGGSYEQYF,0,1,1,1
TRBV6-1,TRBJ1-1,CASSEQGAVFSEAFF,0,1,1,1
TRBV6-1,TRBJ2-1,CASSEVGLAGGGQFF,0,1,1,1
TRBV6-1,TRBJ1-2,CASSEASSRNYGYTF,0,1,1,1
TRBV6-1,TRBJ2-3,CASSESGGRADTQYF,0,1,1,1
TRBV2,TRBJ2-6,CASSRQISGANVLTF,0,1,1,1
TRBV11-2,TRBJ2-1,CASSFGGAGDTEQFF,0,1,1,1
TRBV11-2,TRBJ2-5,CASSFSGGGEETQYF,0,1,1,1
TRBV7-3,TRBJ2-5,CASSFGTSISETQYF,0,1,1,1
TRBV7-3,TRBJ2-3,CASSFTSGSTDTQYF,0,1,1,1
TRBV5-6,TRBJ2-7,CASSLVVGNSYEQYF,0,1,1,1
TRBV5-4,TRBJ2-1,CASSLAYGRHNEQFF,0,1,1,1
TRBV13,TRBJ2-2,CASSLGTGYTGELFF,0,1,1,1
TRBV5-4,TRBJ2-1,CASSLEDRGDNEQFF,0,1,1,1
TRBV7-8,TRBJ1-3,CASSLTGGFGNTIYF,0,1,1,1
TRBV5-4,TRBJ2-1,CASSLRLDAYNEQFF,0,1,1,1
TRBV7-6,TRBJ2-3,CASSLVGGSTDTQYF,0,1,1,1
TRBV7-9,TRBJ2-7,CASSLVASGRDEQYF,0,1,1,1
TRBV11-2,TRBJ2-7,CASSLAPDTSYEQYF,0,1,1,1
TRBV7-6,TRBJ2-1,CASSLGGINYNEQFF,0,1,1,1
TRBV7-2,TRBJ2-2,CASSLGAGTTGELFF,0,1,1,1
TRBV11-3,TRBJ2-5,CASSLGDSLRETQYF,0,1,1,1
TRBV7-6,TRBJ2-7,CASSLGTENTYEQYF,0,1,1,1
TRBV7-2,TRBJ2-1,CASSLGAGGFNEQFF,0,1,1,1
TRBV7-9,TRBJ2-1,CASSLGNDSVAPQFF,0,1,1,1
TRBV11-2,TRBJ2-5,CASSLEQGRGETQYF,0,1,1,1
TRBV5-4,TRBJ1-1,CASSLTGDGNTEAFF,0,1,1,1
TRBV7-2,TRBJ2-3,CASSLSLTGTDTQYF,0,1,1,1
TRBV7-6,TRBJ2-1,CASSLRTAPPNEQFF,0,1,1,1
TRBV7-2,TRBJ2-3,CASSLRQGLTDTQYF,0,1,1,1
TRBV5-4,TRBJ2-5,CASSSPTGSQETQYF,0,1,1,1
TRBV5-4,TRBJ2-5,CASSSPTDSQETQHY,0,1,1,1
TRBV12-3/4,TRBJ2-3,CASSSTSGVTDTQYF,0,1,1,1
TRBV6-2/3/5/6,TRBJ2-7,CASSSVAGVFNEQYF,0,1,1,1
TRBV7-9,TRBJ2-3,CASSSDSVSTDTQYF,0,1,1,1
TRBV7-9,TRBJ2-7,CASSSEDSHSYEQYF,0,1,1,1
TRBV11-2,TRBJ2-3,CASSSQGLATDTQYF,0,1,1,1
TRBV5-4,TRBJ2-3,CASSSGQGQIDTQYF,0,1,1,1
TRBV7-9,TRBJ2-2,CASSSTGRTTGELFF,0,1,1,1
TRBV11-2,TRBJ2-7,CASSSRTASSYEQYF,0,1,1,1
TRBV7-9,TRBJ2-2,CASSSQIEGAGELFF,0,1,1,1
TRBV7-2,TRBJ2-1,CASSSSGRAGDEQFF,0,1,1,1
TRBV3-1,TRBJ2-7,CASSLRQENSYEQYF,0,1,1,1
TRBV3-1,TRBJ2-7,CASSLTSVRSYEQYF,0,1,1,1
TRBV4-2,TRBJ2-5,CASSPGTSGDETQYF,0,1,1,1
TRBV7-2,TRBJ2-2,CASSPDGWNTGELFF,0,1,1,1
TRBV7-2,TRBJ1-2,CASSPPDRVTSGYTF,0,1,1,1
TRBV3-1,TRBJ1-5,CASSPRGLGNQPQHF,0,1,1,1
TRBV7-2,TRBJ2-3,CASSPRTGLTDTQYF,0,1,1,1
TRBV13,TRBJ2-6,CASSPVWAGANVLTF,0,1,1,1
TRBV11-2,TRBJ2-5,CASSPGLAEQETQYF,0,1,1,1
TRBV7-2,TRBJ2-1,CASSPTGLAGDEQFF,0,1,1,1
TRBV3-1,TRBJ2-7,CASSPRAGQGYEQYF,0,1,1,1
TRBV3-1,TRBJ2-7,CASSPLAASSYEQYF,0,1,1,1
TRBV7-9,TRBJ2-7,CASSPPGLAGYEQYF,0,1,1,1
TRBV7-2,TRBJ2-1,CASSPGLALGNEQFF,0,1,1,1
TRBV9,TRBJ2-7,CASSPRGTGPYEQYF,0,1,1,1
TRBV9,TRBJ2-3,CASSRMGVSTDTQYF,0,1,1,1
TRBV3-1,TRBJ2-7,CASSHTGTGGSEQYF,0,1,1,1
TRBV6-2/3/5/6,TRBJ2-3,CASSQGGRESDTQYF,0,1,1,1
TRBV3-1,TRBJ2-2,CASSQGLANTRELFF,0,1,1,1
TRBV14,TRBJ2-1,CASSQFGRGSNEQFF,0,1,1,1
TRBV3-1,TRBJ1-1,CASSQVGRADTEAFF,0,1,1,1
TRBV4-2,TRBJ2-7,CASSQVGSVTYEQYF,0,1,1,1
TRBV3-1,TRBJ2-7,CASSQGPMEPAEQYF,0,1,1,1
TRBV4-2,TRBJ2-4,CASSQGGTSMNIQYF,0,1,1,1
TRBV14,TRBJ1-2,CASSQELGAYYGFTF,0,1,1,1
TRBV9,TRBJ2-5,CASSVDGQGVETQYF,0,1,1,1
TRBV11-2,TRBJ2-3,CASSVLRTNTDTQYF,0,1,1,1
TRBV9,TRBJ2-3,CASSVGDTATDTQYF,0,1,1,1
TRBV9,TRBJ2-3,CASSAGTHSTDTQYF,0,1,1,1
TRBV5-4,TRBJ2-1,CASSADLGSYNEQFF,0,1,1,1
TRBV6-2/3/5/6,TRBJ2-7,CASSGDSFVEAEQYF,0,1,1,1
TRBV7-6,TRBJ2-3,CASSGDRSSTDTQYF,0,1,1,1
TRBV7-8,TRBJ2-1,CASSIYSRPYNEQFF,0,1,1,1
TRBV7-8,TRBJ2-7,CASSISGRPLREQYF,0,1,1,1
TRBV5-4,TRBJ1-1,CASSINRGLSTEAFF,0,1,1,1
TRBV7-6,TRBJ2-1,CASSTGLASGNEQFF,0,1,1,1
TRBV27,TRBJ2-1,CASRGYPGSYNEQFF,0,1,1,1
TRBV6-4,TRBJ1-4,CASRTGGGGNEKLFF,0,1,1,1
TRBV25-1,TRBJ2-3,CASRRGGGDTDTQYF,0,1,1,1
TRBV7-6,TRBJ2-5,CASRPTRLVGETQYF,0,1,1,1
TRBV3-1,TRBJ2-7,CASRPDGGGSNEQYF,0,1,1,1
TRBV7-9,TRBJ2-7,CASNLPGQGIYEQYF,0,1,1,1
TRBV11-2,TRBJ1-6,CASNKRGAYNSPLHF,0,1,1,1
TRBV6-2/3/5/6,TRBJ2-1,CASKVGTGGYNEQFF,0,1,1,1
TRBV6-2/3/5/6,TRBJ2-3,CASKLSGSVADTQYF,0,1,1,1
TRBV28,TRBJ2-5,CANSLSSGGQETQYF,0,1,1,1
TRBV5-1,TRBJ2-5,CASGLSGEREETQYF,0,1,1,1
TRBV5-1,TRBJ2-2,CASSFTAGLTGELFF,0,1,1,1
TRBV5-1,TRBJ2-1,CASSQSEVGGNEQFF,0,1,1,1
TRBV10-2,TRBJ2-7,CASSESASGTYEQYF,0,1,1,1
TRBV10-1,TRBJ2-3,CASSEGLAVTDTQYF,0,1,1,1
TRBV5-1,TRBJ2-1,CASSFTSSSYNEQFF,0,1,1,1
TRBV5-1,TRBJ1-1,CASSLLTGGEGEAFF,0,1,1,1
TRBV5-1,TRBJ2-7,CASSLVGPNSYEQYF,0,1,1,1
TRBV5-1,TRBJ2-3,CASSLAPGGTDTQYF,0,1,1,1
TRBV5-1,TRBJ1-3,CASSLARDSGDTIYF,0,1,1,1
TRBV5-1,TRBJ2-5,CASSLARNLEETQYF,0,1,1,1
TRBV5-1,TRBJ2-7,CASSLGGTNAYEQYF,0,1,1,1
TRBV5-1,TRBJ2-2,CASSLGQEGTGELFF,0,1,1,1
TRBV5-1,TRBJ1-5,CASSLGAGGNQPQHF,0,1,1,1
TRBV5-1,TRBJ2-1,CASSLEGEFYNEQFF,0,1,1,1
TRBV7-3,TRBJ2-7,CASSLGGAGGHEQYF,0,1,1,1
TRBV5-1,TRBJ2-7,CASSSGSGPRDEQYF,0,1,1,1
TRBV5-1,TRBJ2-5,CASSSSRQAQETQYF,0,1,1,1
TRBV5-1,TRBJ2-7,CASSWEGLAGLEQYF,0,1,1,1
TRBV5-1,TRBJ2-1,CASSYITSGSNEQFF,0,1,1,1
TRBV4-1,TRBJ2-1,CASSLQQNTYNEQFF,0,1,1,1
TRBV5-1,TRBJ2-3,CASSPPLAVTDTQYF,0,1,1,1
TRBV5-1,TRBJ2-1,CASSQTEGLYNEQFF,0,1,1,1
TRBV4-1,TRBJ2-5,CASSQDPDLFGTQYF,0,1,1,1
TRBV4-1,TRBJ2-1,CASSQDPTSGNEQFF,0,1,1,1
TRBV4-1,TRBJ1-3,CASSQDLSGGNTIYL,0,1,1,1
TRBV4-1,TRBJ2-7,CASSQDGGPSYEQYF,0,1,1,1
TRBV5-1,TRBJ2-5,CASSAQAGRGETQYF,0,1,1,1
TRBV5-1,TRBJ2-1,CASSARDATYNEQFF,0,1,1,1
TRBV5-1,TRBJ2-6,CASSGDPPGANVLTF,0,1,1,1
TRBV5-1,TRBJ2-1,CASSILAGGINEQFF,0,1,1,1
TRBV5-1,TRBJ2-1,CASSKLAGDSNEQFF,0,1,1,1
TRBV5-1,TRBJ2-4,CASRFSGTGDNIQYF,0,1,1,1
TRBV29-1,TRBJ2-3,CGVPNSGRLTDTQYF,0,1,1,1
TRBV20-1,TRBJ2-5,CSAFGLAGLVETQYF,0,1,1,1
TRBV20-1,TRBJ1-5,CSAVGQLNSNQPQHF,0,1,1,1
TRBV20-1,TRBJ2-3,CSATLGLAGADTQYF,0,1,1,1
TRBV20-1,TRBJ2-1,CSASSLAGEINEQFF,0,1,1,1
TRBV20-1,TRBJ2-3,CSASALAARTDTQYF,0,1,1,1
TRBV20-1,TRBJ2-7,CSARGLAGDSYEQYF,0,1,1,1
TRBV20-1,TRBJ2-1,CSARHTSGSGNEQFF,0,1,1,1
TRBV20-1,TRBJ2-5,CSARGGVHGGETQYF,0,1,1,1
TRBV20-1,TRBJ2-7,CSARDLGDGTGANRF,0,1,1,1
TRBV20-1,TRBJ2-7,CSARDLELASYEQYF,0,1,1,1
TRBV20-1,TRBJ2-3,CSARDPGEGTDTQYF,0,1,1,1
TRBV20-1,TRBJ2-5,CSARDNQAVRETQYF,0,1,1,1
TRBV20-1,TRBJ2-1,CSAREPLAGRYEQFF,0,1,1,1
TRBV20-1,TRBJ2-3,CSAREWSGGRDTQYF,0,1,1,1
TRBV20-1,TRBJ1-4,CSAKRDGTTNEKLFF,0,1,1,1
TRBV20-1,TRBJ1-4,CSAAKTGNLNEKLFF,0,1,1,1
TRBV20-1,TRBJ2-5,CSARRAGGNQETQYF,0,1,1,1
TRBV20-1,TRBJ2-7,CSANPGEREAGEQYF,0,1,1,1
TRBV29-1,TRBJ2-3,CSVRTDYSSADTQYF,0,1,1,1
TRBV29-1,TRBJ2-5,CSVDLGDSQQETQYF,0,1,1,1
TRBV29-1,TRBJ2-3,CSVDGVVLAADTQYF,0,1,1,1
TRBV29-1,TRBJ1-3,CSVDSDGDSGNTIYF,0,1,1,1
TRBV29-1,TRBJ2-3,CSVEESGQGEDTQYF,0,1,1,1
TRBV29-1,TRBJ2-2,CSVHRDRGQGGELFF,0,1,1,1
TRBV29-1,TRBJ2-1,CSVLREGWSYNEQFF,0,1,1,1
TRBV29-1,TRBJ2-2,CSVALGNPNTGELFF,0,1,1,1
TRBV29-1,TRBJ2-1,CSAYGQGATHNEQFF,0,1,1,1
TRBV29-1,TRBJ1-2,CSTRDREVGNYGYTF,0,1,1,1
TRBV7-2,TRBJ2-1,RASSFRWDSYNEQFF,0,1,1,1
TRBV18,TRBJ1-1,CAVESTSGTYKYIF,0,1,1,1
TRBV30,TRBJ2-7,CAWSVLGMSDEQYF,0,1,1,1
TRBV30,TRBJ1-5,CAWSEGAHNQPQHF,0,1,1,1
TRBV30,TRBJ2-5,CAWSTPGHGETQYF,0,1,1,1
TRBV18,TRBJ1-1,CAGSISSTATEAFF,0,1,1,1
TRBV12-3/4,TRBJ1-4,CAGSFWQNNEKLFF,0,1,1,1
TRBV7-3,TRBJ2-3,CAGSSSASTDTQYF,0,1,1,1
TRBV10-3,TRBJ2-1,CAISEGTTGNEQFF,0,1,1,1
TRBV10-3,TRBJ2-1,CAISERAGSNEQFF,0,1,1,1
TRBV10-3,TRBJ2-5,CATSGLAGAEIQYF,0,1,1,1
TRBV12-3/4,TRBJ2-1,CATQGWELNNEQFF,0,1,1,1
TRBV2,TRBJ2-7,CATDRWDRGHEQYF,0,1,1,1
TRBV15,TRBJ2-3,CATSRASLADTQYF,0,1,1,1
TRBV15,TRBJ2-3,CATSRDRFTDTQYF,0,1,1,1
TRBV24-1,TRBJ2-1,CATKASGSSYEQFF,0,1,1,1
TRBV6-2/3/5/6,TRBJ2-3,CASLSSYSTDTQYF,0,1,1,1
TRBV19,TRBJ1-1,CASIRSGRGSEAFL,0,1,1,1
TRBV19,TRBJ2-7,CASSRRDTDYEQYF,0,1,1,1
TRBV19,TRBJ2-1,CASSIGTGEYEQFF,0,1,1,1
TRBV19,TRBJ2-5,CASSIGLQELSQYF,0,1,1,1
TRBV19,TRBJ2-1,CASSKGQGANEQFF,0,1,1,1
TRBV12-3/4,TRBJ1-3,CASRPLTAGNTIYF,0,1,1,1
TRBV5-6,TRBJ2-1,CASSAGRAGDEQFF,0,1,1,1
TRBV18,TRBJ1-5,CASSPTGAYQPQHF,0,1,1,1
TRBV18,TRBJ1-1,CASSSNPWYTEAFF,0,1,1,1
TRBV18,TRBJ2-5,CASSLWDRRGTQYF,0,1,1,1
TRBV6-2/3/5/6,TRBJ2-1,CASSLAGHYNEQFF,0,1,1,1
TRBV18,TRBJ2-7,CASSPRTGRHGQYF,0,1,1,1
TRBV18,TRBJ2-3,CASSPVGETDTQYF,0,1,1,1
TRBV18,TRBJ1-5,CASSPGQGGQPQHF,0,1,1,1
TRBV18,TRBJ2-7,CASSPSGFGYEQYF,0,1,1,1
TRBV18,TRBJ2-2,CASSPQVNTGELFF,0,1,1,1
TRBV18,TRBJ2-3,CASSPEGRSDTQYF,0,1,1,1
TRBV18,TRBJ2-1,CASSQTSGTSEQFF,0,1,1,1
TRBV7-2,TRBJ2-5,CASCLGGRGETQYF,0,1,1,1
TRBV28,TRBJ2-7,CASPLSGTSYEQYF,0,1,1,1
TRBV6-2/3/5/6,TRBJ2-2,CASRQGVDTGELFF,0,1,1,1
TRBV7-9,TRBJ2-2,CASGADPNTGELFF,0,1,1,1
TRBV7-2,TRBJ2-5,CASIQTSGTGTQYF,0,1,1,1
TRBV28,TRBJ2-1,CASTLAGPNNEQFF,0,1,1,1
TRBV5-4,TRBJ1-2,CASTSGVAGYGYTF,0,1,1,1
TRBV11-2,TRBJ2-7,CASTSTGGLDEQYF,0,1,1,1
TRBV6-2/3/5/6,TRBJ2-7,CASTPGVGAYEQYF,0,1,1,1
TRBV5-4,TRBJ2-6,CASTRPSGANVLTF,0,1,1,1
TRBV3-1,TRBJ1-1,CASTQRGTNTEAFF,0,1,1,1
TRBV12-3/4,TRBJ2-3,CASTQTENADTQYF,0,1,1,1
TRBV9,TRBJ2-3,CASTASTSTDTQYF,0,1,1,1
TRBV5-6,TRBJ2-3,CASTGTGSTDTQYF,0,1,1,1
TRBV12-3/4,TRBJ1-4,CASSFSTGDEKLFF,0,1,1,1
TRBV28,TRBJ2-7,CASSFDQGAYEQYF,0,1,1,1
TRBV6-2/3/5/6,TRBJ2-7,CASSLAGIKNEQYF,0,1,1,1
TRBV6-2/3/5/6,TRBJ2-1,CASSLDPEVDEQFF,0,1,1,1
TRBV28,TRBJ1-2,CASSLEGVNYGYTF,0,1,1,1
TRBV6-2/3/5/6,TRBJ2-1,CASSLLAGVVEQFF,0,1,1,1
TRBV12-3/4,TRBJ2-1,CASSLAGGNNEQFF,0,1,1,1
TRBV12-3/4,TRBJ2-7,CASSLGLGGDEQYF,0,1,1,1
TRBV12-3/4,TRBJ2-1,CASSLTPLHNEQFF,0,1,1,1
TRBV28,TRBJ2-1,CASSSGLRDNEQFF,0,1,1,1
TRBV6-2/3/5/6,TRBJ1-6,CASSYGQGDSPLHF,0,1,1,1
TRBV6-2/3/5/6,TRBJ2-7,CASSYSILADEQYF,0,1,1,1
TRBV6-2/3/5/6,TRBJ2-7,CASSYADRAYEQYF,0,1,1,1
TRBV6-2/3/5/6,TRBJ2-7,CASSYNPPPYEQYF,0,1,1,1
TRBV3-1,TRBJ2-1,CASSLLTGLHEQFF,0,1,1,1
TRBV6-2/3/5/6,TRBJ2-3,CASSPYRGRNTQYF,0,1,1,1
TRBV6-2/3/5/6,TRBJ2-7,CASSPGTGRYEQYF,0,1,1,1
TRBV6-2/3/5/6,TRBJ2-1,CASSPALVYDEQFF,0,1,1,1
TRBV28,TRBJ2-7,CASSPGLAGKGQYF,0,1,1,1
TRBV6-2/3/5/6,TRBJ2-7,CASSRPTGSYEQYF,0,1,1,1
TRBV6-4,TRBJ1-1,CASSVSPGNTEAFF,0,1,1,1
TRBV6-1,TRBJ2-3,CASSADIRTDTQYF,0,1,1,1
TRBV6-4,TRBJ2-7,CASSAELGYYEQYF,0,1,1,1
TRBV2,TRBJ2-7,CASSGQGVPYEQYF,0,1,1,1
TRBV28,TRBJ2-1,CASSGQGVRDEQFF,0,1,1,1
TRBV2,TRBJ2-1,CASSDGQGYNEQFF,0,1,1,1
TRBV6-1,TRBJ2-3,CASSEALPRDTQYF,0,1,1,1
TRBV2,TRBJ2-1,CASSEGLGSGEQFF,0,1,1,1
TRBV2,TRBJ1-1,CASSEDSQTAEAFF,0,1,1,1
TRBV6-1,TRBJ2-7,CASSEVGGLHEQYF,0,1,1,1
TRBV2,TRBJ2-3,CASSERLKADTQYF,0,1,1,1
TRBV11-2,TRBJ2-2,CASSMDYNTGELFF,0,1,1,1
TRBV12-3/4,TRBJ1-2,CASSTPGVNYGYTF,0,1,1,1
TRBV28,TRBJ2-4,CASSTGTEKNIQYF,0,1,1,1
TRBV6-4,TRBJ1-1,CASSTFDRVTEAFF,0,1,1,1
TRBV28,TRBJ2-5,CASSRSDRQETQYF,0,1,1,1
TRBV6-4,TRBJ1-3,CASSRQGVGNTIYF,0,1,1,1
TRBV11-3,TRBJ2-3,CASSFSGSGDTQYF,0,1,1,1
TRBV7-2,TRBJ2-7,CASSFPGDLYEQYF,0,1,1,1
TRBV7-9,TRBJ2-7,CASSFGRPPYEQYF,0,1,1,1
TRBV7-9,TRBJ2-3,CASSLGSSTDTQYF,0,1,1,1
TRBV5-6,TRBJ2-1,CASSLGGGEGEQFF,0,1,1,1
TRBV5-4,TRBJ2-1,CASSLISDYNEQFF,0,1,1,1
TRBV7-2,TRBJ2-5,CASSLIQGWQTQYF,0,1,1,1
TRBV5-4,TRBJ2-5,CASSLTGAWETQYF,0,1,1,1
TRBV7-9,TRBJ2-3,CASSLFSGTDTQYF,0,1,1,1
TRBV7-2,TRBJ2-1,CASSLQDRLPRQFF,0,1,1,1
TRBV7-9,TRBJ2-7,CASSLAVGAYEQYF,0,1,1,1
TRBV7-9,TRBJ2-6,CASSLGSGANVLTF,0,1,1,1
TRBV7-3,TRBJ2-2,CASSLGGSTGELFF,0,1,1,1
TRBV7-6,TRBJ1-5,CASSLGGSGQPQHF,0,1,1,1
TRBV7-9,TRBJ2-1,CASSLDRAYNEQFF,0,1,1,1
TRBV11-2,TRBJ2-7,CASSLMRSRDEQYF,0,1,1,1
TRBV7-3,TRBJ2-1,CASSLTSHGDEQFF,0,1,1,1
TRBV7-3,TRBJ2-7,CASSLNGGDYEQYF,0,1,1,1
TRBV7-2,TRBJ2-3,CASSLNLASDTQYF,0,1,1,1
TRBV7-9,TRBJ2-6,CASSSGTGANVLTF,0,1,1,1
TRBV7-6,TRBJ2-7,CASSSSGMPWEQYS,0,1,1,1
TRBV7-9,TRBJ1-1,CASSSGSENTEAFF,0,1,1,1
TRBV13,TRBJ2-3,CASSLPTLGDTQYF,0,1,1,1
TRBV7-9,TRBJ1-1,CASSLLATNTEAFF,0,1,1,1
TRBV3-1,TRBJ2-7,CASSLGGGEDEQYF,0,1,1,1
TRBV3-1,TRBJ1-1,CASSLRTMNTEAFF,0,1,1,1
TRBV7-9,TRBJ2-4,CASSPGQGAFIQYF,0,1,1,1
TRBV7-9,TRBJ1-2,CASSPRAVFYGYTF,0,1,1,1
TRBV11-2,TRBJ2-1,CASSPRQDHHEQFF,0,1,1,1
TRBV7-9,TRBJ2-3,CASSPTESTDTQYF,0,1,1,1
TRBV9,TRBJ2-7,CASSPGGSPYEQYF,0,1,1,1
TRBV7-9,TRBJ2-1,CASSRPAATNEQFF,0,1,1,1
TRBV7-9,TRBJ2-1,CASSRGGRNNEQFF,0,1,1,1
TRBV7-9,TRBJ2-7,CASSRDGTLYEQYF,0,1,1,1
TRBV7-9,TRBJ1-1,CASSRDSANTEAFF,0,1,1,1
TRBV9,TRBJ1-1,CASSRTGMNTEAFF,0,1,1,1
TRBV7-3,TRBJ2-3,CASSQGLVTDTQYF,0,1,1,1
TRBV28,TRBJ2-5,CASSQTTTSETQYF,0,1,1,1
TRBV3-1,TRBJ2-5,CASSQWDTQETQYF,0,1,1,1
TRBV14,TRBJ2-7,CASSQVGTTYEQYF,0,1,1,1
TRBV14,TRBJ1-1,CASSQGTGARRAFF,0,1,1,1
TRBV4-2,TRBJ2-3,CASSQDGAGGTQYF,0,1,1,1
TRBV3-1,TRBJ1-5,CASSQDRVRQPQHF,0,1,1,1
TRBV3-1,TRBJ2-5,CASSQDKSRETQYF,0,1,1,1
TRBV3-1,TRBJ2-3,CASSQETSGRTQYF,0,1,1,1
TRBV9,TRBJ2-7,CASSVGEGFYEQYF,0,1,1,1
TRBV7-9,TRBJ2-7,CASSVGQSSYEQYF,0,1,1,1
TRBV9,TRBJ1-1,CASSARTGGTEAFF,0,1,1,1
TRBV9,TRBJ2-1,CASSAQLAGDEQFF,0,1,1,1
TRBV9,TRBJ2-7,CASSGSGSINEQYF,0,1,1,1
TRBV9,TRBJ2-7,CASSGRDNSYEQYF,0,1,1,1
TRBV5-4,TRBJ2-7,CASSDGLGQSEQYF,0,1,1,1
TRBV7-2,TRBJ2-5,CASSETTLPETQYF,0,1,1,1
TRBV7-2,TRBJ2-5,CASSMTGNQETQYF,0,1,1,1
TRBV5-4,TRBJ2-3,CASSSGMSTDTQYF,0,1,1,1
TRBV6-2/3/5/6,TRBJ2-7,CASRPKREVYEQYF,0,1,1,1
TRBV6-2/3/5/6,TRBJ2-2,CASRFTGGTGELFF,0,1,1,1
TRBV6-2/3/5/6,TRBJ2-1,CASRLAGGTMRQFF,0,1,1,1
TRBV12-3/4,TRBJ2-7,CASRRWGVGGEQYF,0,1,1,1
TRBV11-2,TRBJ2-7,CASRIQGAGYEQYF,0,1,1,1
TRBV7-9,TRBJ1-1,CASNNYRDDTEAFF,0,1,1,1
TRBV7-9,TRBJ1-2,CASNPSVVDYGYTF,0,1,1,1
TRBV5-4,TRBJ2-3,CASNGRTGEDTQYF,0,1,1,1
TRBV4-1,TRBJ2-3,CAAGSGRASDTQYF,0,1,1,1
TRBV5-1,TRBJ2-1,CASTREGAYNEQFF,0,1,1,1
TRBV5-1,TRBJ2-1,CASSPGTSYNEQFF,0,1,1,1
TRBV10-2,TRBJ2-3,CASSTNGRTDTQYF,0,1,1,1
TRBV5-1,TRBJ2-3,CASSKTSNPNTQYF,0,1,1,1
TRBV5-1,TRBJ2-5,CASSFGQTQETQYF,0,1,1,1
TRBV5-1,TRBJ2-7,CASSLRTGINEQYF,0,1,1,1
TRBV5-1,TRBJ2-7,CASSLVAGSCEQYF,0,1,1,1
TRBV5-1,TRBJ1-1,CASSLATGNTEAFF,0,1,1,1
TRBV5-1,TRBJ2-3,CASSLAGNADTQYF,0,1,1,1
TRBV5-1,TRBJ2-7,CASSLGQSLYEQYF,0,1,1,1
TRBV5-1,TRBJ2-7,CASSLGGTPGEQYF,0,1,1,1
TRBV5-1,TRBJ2-4,CASSLSQGANIQYF,0,1,1,1
TRBV5-1,TRBJ2-1,CASSLPGLAHEQFF,0,1,1,1
TRBV5-1,TRBJ2-7,CASSLREPSYEQYF,0,1,1,1
TRBV5-1,TRBJ2-7,CASSSTGGPYEQYF,0,1,1,1
TRBV5-1,TRBJ2-1,CASSPVGADNEQFF,0,1,1,1
TRBV5-1,TRBJ1-5,CASSPGTGNQPQHF,0,1,1,1
TRBV5-1,TRBJ2-5,CASSPGLAGETQYF,0,1,1,1
TRBV28,TRBJ1-2,CASSPGQPSGGYTF,0,1,1,1
TRBV4-1,TRBJ1-5,CASSHREINQPQHF,0,1,1,1
TRBV4-1,TRBJ1-1,CASSQTNLNTEAFF,0,1,1,1
TRBV5-1,TRBJ2-1,CASSTGGRNNEQFF,0,1,1,1
TRBV5-1,TRBJ2-7,CASSKDRVKNEQYF,0,1,1,1
TRBV5-1,TRBJ2-3,CASRGGGPTDTQYF,0,1,1,1
TRBV10-1,TRBJ2-3,CASKNSVWTDTQYF,0,1,1,1
TRBV29-1,TRBJ2-7,CGVSRPGSSYEQYF,0,1,1,1
TRBV20-1,TRBJ2-1,CSVGGTKSYNEQFF,0,1,1,1
TRBV20-1,TRBJ2-1,CSAPGLAGVREQFF,0,1,1,1
TRBV20-1,TRBJ2-1,CSARTSGSRNEQFF,0,1,1,1
TRBV20-1,TRBJ2-3,CSAQEDRGTDTQYF,0,1,1,1
TRBV20-1,TRBJ2-7,CSAGGRAGDLEQYF,0,1,1,1
TRBV20-1,TRBJ2-7,CSASPTGRFNEQYF,0,1,1,1
TRBV20-1,TRBJ2-1,CSASENQIINEQFF,0,1,1,1
TRBV20-1,TRBJ2-7,CSARGQGHSYEQYF,0,1,1,1
TRBV20-1,TRBJ2-7,CSAREGGSFYEQYF,0,1,1,1
TRBV20-1,TRBJ2-1,CSARSNEGLNEQFF,0,1,1,1
TRBV20-1,TRBJ2-7,CSARVLWGNYEPYF,0,1,1,1
TRBV20-1,TRBJ2-4,CSARGAVAKNIQYF,0,1,1,1
TRBV20-1,TRBJ2-5,CSARGGTGQETQYF,0,1,1,1
TRBV20-1,TRBJ2-1,CSARDSGSYNEQFF,0,1,1,1
TRBV20-1,TRBJ2-1,CSANPRLSRNEQFF,0,1,1,1
TRBV20-1,TRBJ2-3,CSAKESGRGDTQYF,0,1,1,1
TRBV20-1,TRBJ2-5,CSALAGQGRETQYF,0,1,1,1
TRBV20-1,TRBJ2-7,CSAETSGSSYEQYF,0,1,1,1
TRBV20-1,TRBJ2-1,CSAREPKGANEQFF,0,1,1,1
TRBV20-1,TRBJ2-1,CSAPSSGRDNEQFF,0,1,1,1
TRBV29-1,TRBJ2-5,CSLRLAANPETQYF,0,1,1,1
TRBV29-1,TRBJ1-1,CSVHTGTANTEAFF,0,1,1,1
TRBV29-1,TRBJ2-7,CSVVVQGAHDEQYF,0,1,1,1
TRBV29-1,TRBJ2-3,CSVAQGSGEDTQYF,0,1,1,1
TRBV29-1,TRBJ2-7,CSVGGGQGSREQYF,0,1,1,1
TRBV29-1,TRBJ1-2,CSVEPRDRENGYTF,0,1,1,1
TRBV29-1,TRBJ2-1,CSVEGSGKGYEQFF,0,1,1,1
TRBV29-1,TRBJ2-3,CSVRLAGGVDTQYF,0,1,1,1
TRBV29-1,TRBJ2-2,CSVGETGGVVPLFF,0,1,1,1
TRBV29-1,TRBJ2-7,CSVIPASLTYEQYF,0,1,1,1
TRBV29-1,TRBJ2-1,CSVITSATYNEQFF,0,1,1,1
TRBV29-1,TRBJ2-3,CSVGPGQGTDTQYF,0,1,1,1
TRBV29-1,TRBJ2-2,CSAPAGGPSGELFF,0,1,1,1
TRBV19,TRBJ1-5,CVSSRQEIQPQHF,0,1,1,1
TRBV3-1,TRBJ2-7,CVSGPDRGYEQYF,0,1,1,1
TRBV12-5,TRBJ2-7,CASALDRAYEQYF,0,1,1,1
TRBV12-5,TRBJ1-2,CASGLAGPHGYTF,0,1,1,1
TRBV30,TRBJ2-5,CAWGPRLGETQYF,0,1,1,1
TRBV30,TRBJ1-1,CAWSVTPNTEAFF,0,1,1,1
TRBV30,TRBJ2-5,CAWSVSDRETQYF,0,1,1,1
TRBV30,TRBJ2-7,CAWSIDRAYEQYF,0,1,1,1
TRBV30,TRBJ2-7,CAWSLTGNYEQYF,0,1,1,1
TRBV30,TRBJ1-4,CAWKTGGNEKLFF,0,1,1,1
TRBV12-3/4,TRBJ1-3,CAGLQGSGNTIYF,0,1,1,1
TRBV5-6,TRBJ2-5,CAGSFGSQETQYF,0,1,1,1
TRBV19,TRBJ2-1,CAIRDSLRNEQFF,0,1,1,1
TRBV10-3,TRBJ2-5,CAISESSGETQYF,0,1,1,1
TRBV10-3,TRBJ2-3,CAIRGQLTDTQYF,0,1,1,1
TRBV27,TRBJ2-7,CATTGTGSYEQYF,0,1,1,1
TRBV28,TRBJ2-5,CATGGPGQETQYF,0,1,1,1
TRBV24-1,TRBJ2-5,CATSRAGGETQYF,0,1,1,1
TRBV24-1,TRBJ2-1,CATSGYLDNEQFF,0,1,1,1
TRBV24-1,TRBJ2-7,CATSEDIRDEQYF,0,1,1,1
TRBV19,TRBJ2-7,CASATGGEYEQYF,0,1,1,1
TRBV19,TRBJ2-3,CASSVRPTDTQYF,0,1,1,1
TRBV19,TRBJ2-3,CASSIDNTDTQYF,0,1,1,1
TRBV19,TRBJ1-1,CASSIQGFTEAFF,0,1,1,1
TRBV19,TRBJ2-5,CASSIAREETQYF,0,1,1,1
TRBV19,TRBJ2-1,CASSKGGNNEQFL,0,1,1,1
TRBV18,TRBJ2-7,CASSPRHRDEQYF,0,1,1,1
TRBV18,TRBJ2-7,CASSPVDRGEQHF,0,1,1,1
TRBV28,TRBJ2-1,CASLGAGGREQFF,0,1,1,1
TRBV7-9,TRBJ2-3,CASRPSSTDTQYF,0,1,1,1
TRBV6-2/3/5/6,TRBJ2-7,CASGPGQGYEQYF,0,1,1,1
TRBV4-2,TRBJ2-3,CASDKTPTDTQYF,0,1,1,1
TRBV11-2,TRBJ2-1,CASERDSYNEQFF,0,1,1,1
TRBV6-2/3/5/6,TRBJ2-5,CASIPGLQETQYF,0,1,1,1
TRBV6-2/3/5/6,TRBJ2-3,CASMVAGADTQYF,0,1,1,1
TRBV6-2/3/5/6,TRBJ2-1,CASIGTGPNEQFF,0,1,1,1
TRBV6-2/3/5/6,TRBJ2-7,CASTSPARSEQYF,0,1,1,1
TRBV7-2,TRBJ2-3,CASTSWDGDTQYF,0,1,1,1
TRBV7-9,TRBJ2-1,CASTRNRDLEQFF,0,1,1,1
TRBV2,TRBJ1-6,CASTGLGNSPLHF,0,1,1,1
TRBV28,TRBJ1-2,CASSFGKVDGYTF,0,1,1,1
TRBV12-3/4,TRBJ2-1,CASSLTSYNKQFF,0,1,1,1
TRBV6-2/3/5/6,TRBJ2-7,CASSLNGIYEQYF,0,1,1,1
TRBV28,TRBJ2-5,CASSSGQQETQYF,0,1,1,1
TRBV12-3/4,TRBJ2-2,CASSSRQHGELFF,0,1,1,1
TRBV12-3/4,TRBJ2-1,CASSWGGYNEQFF,0,1,1,1
TRBV6-2/3/5/6,TRBJ2-1,CASSYASNYEQFF,0,1,1,1
TRBV7-2,TRBJ2-7,CASSYPTTREQYF,0,1,1,1
TRBV12-3/4,TRBJ2-7,CASSLGQGYEQYF,0,1,1,1
TRBV12-3/4,TRBJ2-7,CASSLTRGYEQYF,0,1,1,1
TRBV2,TRBJ1-2,CASSLQGADGYTF,0,1,1,1
TRBV6-2/3/5/6,TRBJ1-1,CASSRQVNTEAFF,0,1,1,1
TRBV27,TRBJ2-1,CASSRGLSWEQFF,0,1,1,1
TRBV6-4,TRBJ2-5,CASSRQGRGTQYF,0,1,1,1
TRBV27,TRBJ2-4,CASSQGIRGIQYF,0,1,1,1
TRBV25-1,TRBJ1-2,CASSGLGLHGYTF,0,1,1,1
TRBV6-1,TRBJ2-4,CASSGTLSDVQYF,0,1,1,1
TRBV6-1,TRBJ2-5,CASSEGSSGTQYF,0,1,1,1
TRBV2,TRBJ2-7,CASSEQASNEQYF,0,1,1,1
TRBV2,TRBJ2-7,CASSEALRLEQYF,0,1,1,1
TRBV6-1,TRBJ1-1,CASSEGAGAEAFL,0,1,1,1
TRBV6-1,TRBJ1-2,CASSEDRRYGYTF,0,1,1,1
TRBV7-2,TRBJ2-7,CASSNSGLDEQYF,0,1,1,1
TRBV7-2,TRBJ2-3,CASSFGGPDTQYF,0,1,1,1
TRBV7-9,TRBJ2-5,CASSFQGWETQYF,0,1,1,1
TRBV5-4,TRBJ1-2,CASSFGGGGGYTF,0,1,1,1
TRBV7-3,TRBJ2-3,CASSFGPGDTQYF,0,1,1,1
TRBV7-6,TRBJ2-5,CASSFDSQETQYF,0,1,1,1
TRBV13,TRBJ2-5,CASSFTGLETQYF,0,1,1,1
TRBV5-4,TRBJ2-3,CASSLDPSRTQYF,0,1,1,1
TRBV7-2,TRBJ2-7,CASSLTGAYEQYF,0,1,1,1
TRBV7-6,TRBJ1-1,CASSLFPYTEAFF,0,1,1,1
TRBV11-2,TRBJ1-1,CASSLQGDTEAFF,0,1,1,1
TRBV7-6,TRBJ2-3,CASSLVLADTQYF,0,1,1,1
TRBV11-2,TRBJ2-3,CASSLGSSDTQYF,0,1,1,1
TRBV11-2,TRBJ2-3,CASSLGGADTQYF,0,1,1,1
TRBV11-2,TRBJ2-1,CASSLDPNYEQFI,0,1,1,1
TRBV11-2,TRBJ1-1,CASSLRRNTEAFF,0,1,1,1
TRBV7-2,TRBJ2-1,CASSSPALARQFF,0,1,1,1
TRBV7-2,TRBJ2-5,CASSSRTGETQYF,0,1,1,1
TRBV7-2,TRBJ2-1,CASSSGQYNEQFF,0,1,1,1
TRBV7-2,TRBJ2-3,CASSSNQGDTQYF,0,1,1,1
TRBV7-2,TRBJ2-5,CASSSYREETQYF,0,1,1,1
TRBV11-2,TRBJ2-5,CASSSRLGETQYF,0,1,1,1
TRBV13,TRBJ2-7,CASSSRLADEQYF,0,1,1,1
TRBV13,TRBJ1-1,CASSLPANTEAFF,0,1,1,1
TRBV7-9,TRBJ1-1,CASSLDRTTEAFF,0,1,1,1
TRBV11-2,TRBJ2-1,CASSLGQGYEQFF,0,1,1,1
TRBV11-2,TRBJ2-1,CASSPPGGDEQFF,0,1,1,1
TRBV5-4,TRBJ2-1,CASSPGTFNEQFF,0,1,1,1
TRBV14,TRBJ2-1,CASSPGTHNEQFF,0,1,1,1
TRBV7-7,TRBJ2-5,CASSPRQQETQYF,0,1,1,1
TRBV11-2,TRBJ1-2,CASSRRGISGDTF,0,1,1,1
TRBV11-3,TRBJ2-1,CASSQGLAGGQFF,0,1,1,1
TRBV3-1,TRBJ2-1,CASSQKSNNEQFF,0,1,1,1
TRBV3-1,TRBJ2-7,CASSQGSYSEQYF,0,1,1,1
TRBV3-1,TRBJ2-3,CASSQNRPDTQYF,0,1,1,1
TRBV6-2/3/5/6,TRBJ2-7,CASSVGQVYEQYF,0,1,1,1
TRBV9,TRBJ2-3,CASSVQITDTQYF,0,1,1,1
TRBV9,TRBJ2-1,CASSVGHYNEQFF,0,1,1,1
TRBV7-2,TRBJ2-3,CASSGPDRNTQYF,0,1,1,1
TRBV7-8,TRBJ2-3,CASSGSYTDTQYL,0,1,1,1
TRBV7-9,TRBJ1-1,CASSGTENAEAFS,0,1,1,1
TRBV12-3/4,TRBJ2-5,CASSDRVEETQYF,0,1,1,1
TRBV12-3/4,TRBJ2-3,CASRLGRTDTQYF,0,1,1,1
TRBV2,TRBJ1-1,CASRVGRYTEAFF,0,1,1,1
TRBV6-2/3/5/6,TRBJ2-7,CASRRQGADEQYF,0,1,1,1
TRBV6-1,TRBJ2-1,CASKGSGRNEQFF,0,1,1,1
TRBV4-1,TRBJ1-5,CASSRQANQPQHF,0,1,1,1
TRBV10-1,TRBJ2-1,CASSGGVGSEQFF,0,1,1,1
TRBV5-1,TRBJ2-5,CASSFLATKTQYF,0,1,1,1
TRBV5-1,TRBJ2-2,CASSLVVEGELFF,0,1,1,1
TRBV5-1,TRBJ2-1,CASSLGLQNEQFF,0,1,1,1
TRBV5-1,TRBJ2-1,CASSLGIENEQFF,0,1,1,1
TRBV5-1,TRBJ2-5,CASSLTGRETQYF,0,1,1,1
TRBV5-1,TRBJ2-1,CASSLNPGNEQFF,0,1,1,1
TRBV5-1,TRBJ1-1,CASSLRVNTEAFF,0,1,1,1
TRBV5-1,TRBJ2-1,CASSPVQRNEQFF,0,1,1,1
TRBV4-1,TRBJ1-2,CASSQSANYGYTF,0,1,1,1
TRBV20-1,TRBJ2-1,CSAYSSGLDEQFF,0,1,1,1
TRBV20-1,TRBJ2-3,CSAPQGAADTQYF,0,1,1,1
TRBV20-1,TRBJ2-3,CSAVSLGTDTQYF,0,1,1,1
TRBV20-1,TRBJ1-1,CSAMPGQNTEAFF,0,1,1,1
TRBV20-1,TRBJ2-1,CSASRTTNNEQFF,0,1,1,1
TRBV20-1,TRBJ2-3,CSASRQVPDTQYF,0,1,1,1
TRBV20-1,TRBJ2-7,CSASAGPSYEQYF,0,1,1,1
TRBV20-1,TRBJ2-3,CSARAAGLSTQYF,0,1,1,1
TRBV20-1,TRBJ2-1,CSARTSSYNEQFF,0,1,1,1
TRBV20-1,TRBJ2-1,CSARPGGYNEQFF,0,1,1,1
TRBV20-1,TRBJ1-5,CSARGGGYQPQHF,0,1,1,1
TRBV20-1,TRBJ2-7,CSARDYGEDAEYF,0,1,1,1
TRBV20-1,TRBJ2-4,CSARDGAKNIQYF,0,1,1,1
TRBV20-1,TRBJ1-1,CSARDYSFYEAFF,0,1,1,1
TRBV20-1,TRBJ1-5,CSAALTGNQPQHF,0,1,1,1
TRBV20-1,TRBJ2-1,CSAGSGRYNEQFF,0,1,1,1
TRBV20-1,TRBJ2-7,CSGTQGGTYVQYF,0,1,1,1
TRBV29-1,TRBJ2-5,CSHTGGSQETQYF,0,1,1,1
TRBV29-1,TRBJ1-1,CSVVETVNTEAFF,0,1,1,1
TRBV29-1,TRBJ2-7,CSVVLAGDYEQYF,0,1,1,1
TRBV29-1,TRBJ2-3,CSVVGILTDTQYF,0,1,1,1
TRBV29-1,TRBJ2-2,CSVAPWNTGELFF,0,1,1,1
TRBV29-1,TRBJ2-5,CSVGRGEKETQYF,0,1,1,1
TRBV29-1,TRBJ2-3,CSVDAGGSDTQYF,0,1,1,1
TRBV29-1,TRBJ2-2,CSVIDNYTGELFF,0,1,1,1
TRBV29-1,TRBJ2-1,CSVTLSSYNEQFF,0,1,1,1
TRBV29-1,TRBJ2-7,CSVSRGAVYEQYF,0,1,1,1
TRBV29-1,TRBJ1-2,CSVQLTGGYGYTF,0,1,1,1
TRBV29-1,TRBJ2-7,CSVQLNRAYEQYF,0,1,1,1
TRBV20-1,TRBJ2-3,CSAGGLWGGTQYF,0,1,1,1
TRBV29-1,TRBJ2-7,CSASFGGGYEQYF,0,1,1,1
TRBV29-1,TRBJ2-5,CSAAGTGAETQYF,0,1,1,1
TRBV29-1,TRBJ1-5,CSAAADSNQPQHF,0,1,1,1
TRBV29-1,TRBJ2-1,CSATGGSYNEQFF,0,1,1,1
TRBV19,TRBJ2-4,RASSIGDGLRRYF,0,1,1,1
TRBV30,TRBJ1-4,CAWSYRAGKLFF,0,1,1,1
TRBV30,TRBJ2-1,CAQTKPQNEQFF,0,1,1,1
TRBV10-3,TRBJ1-6,CAISEQDSPLHF,0,1,1,1
TRBV15,TRBJ2-3,CATSNLGDTQYF,0,1,1,1
TRBV7-2,TRBJ2-1,CASQPGGSEQFF,0,1,1,1
TRBV19,TRBJ1-5,CASSVSRQPQHF,0,1,1,1
TRBV19,TRBJ2-1,CASKGSSNEQFF,0,1,1,1
TRBV18,TRBJ2-1,CASATSSNEQFS,0,1,1,1
TRBV5-6,TRBJ2-7,CASGEGAGVQYF,0,1,1,1
TRBV12-3/4,TRBJ2-2,CASSLVAGELFF,0,1,1,1
TRBV27,TRBJ2-5,CASSLKGETQYF,0,1,1,1
TRBV6-2/3/5/6,TRBJ2-1,CASSSPDGRQFF,0,1,1,1
TRBV7-9,TRBJ1-3,CASSSERNTIYF,0,1,1,1
TRBV6-2/3/5/6,TRBJ2-7,CASSYAGYEQYF,0,1,1,1
TRBV6-2/3/5/6,TRBJ2-7,CASSLLGDEQYF,0,1,1,1
TRBV2,TRBJ2-1,CASSPRSGEQFF,0,1,1,1
TRBV6-2/3/5/6,TRBJ1-1,CASSRTVTEAFF,0,1,1,1
TRBV7-3,TRBJ2-3,CASSDLADTQYF,0,1,1,1
TRBV6-1,TRBJ2-2,CASSEFVGELFF,0,1,1,1
TRBV6-2/3/5/6,TRBJ1-1,CASSNSTGYAFF,0,1,1,1
TRBV5-6,TRBJ2-1,CASSLANNEQFF,0,1,1,1
TRBV5-4,TRBJ2-5,CASSLGGETQYF,0,1,1,1
TRBV5-5,TRBJ1-2,CASSLGNYGYTF,0,1,1,1
TRBV5-6,TRBJ1-2,CASSLDRTGGTF,0,1,1,1
TRBV5-4,TRBJ2-7,CASSLDRFEQYF,0,1,1,1
TRBV7-9,TRBJ2-7,CASSLQGYEQYF,0,1,1,1
TRBV7-9,TRBJ1-1,CASSLAQTQAFF,0,1,1,1
TRBV7-9,TRBJ2-3,CASSLEVDTQYF,0,1,1,1
TRBV7-6,TRBJ2-7,CASSSTESEQYF,0,1,1,1
TRBV13,TRBJ2-1,CASSLSANEQFF,0,1,1,1
TRBV7-9,TRBJ2-3,CASSPGPDTQYF,0,1,1,1
TRBV7-9,TRBJ2-1,CASSPMVNEQFF,0,1,1,1
TRBV14,TRBJ2-3,CASSQAGPSQYF,0,1,1,1
TRBV3-1,TRBJ2-7,CASSQDWDRVYF,0,1,1,1
TRBV7-9,TRBJ2-7,CASSANSYEQYF,0,1,1,1
TRBV5-4,TRBJ1-2,CASSGPPGGYTF,0,1,1,1
TRBV6-2/3/5/6,TRBJ2-2,CASSNSPGELFF,0,1,1,1
TRBV6-1,TRBJ1-5,CASRDSNQPQHF,0,1,1,1
TRBV6-4,TRBJ2-7,CASRDPSYEQYF,0,1,1,1
TRBV5-4,TRBJ2-1,CASRNGLNEQFF,0,1,1,1
TRBV28,TRBJ2-2,CASRPSPGELFF,0,1,1,1
TRBV12-3/4,TRBJ2-7,CASNIQGLGQYF,0,1,1,1
TRBV19,TRBJ1-1,CASKARGTEAFF,0,1,1,1
TRBV7-9,TRBJ2-1,CANSPWGDEQFF,0,1,1,1
TRBV5-1,TRBJ2-5,CASSGGQETQYF,0,1,1,1
TRBV5-1,TRBJ2-7,CASSLIPREQYF,0,1,1,1
TRBV5-1,TRBJ1-2,CASSPDGYGYTF,0,1,1,1
TRBV4-1,TRBJ1-2,CASSQAGYGYTF,0,1,1,1
TRBV5-1,TRBJ2-1,CASSVNRGGEFF,0,1,1,1
TRBV5-1,TRBJ2-1,CASSITGTLVFF,0,1,1,1
TRBV20-1,TRBJ1-1,CSASVPSSEAFF,0,1,1,1
TRBV20-1,TRBJ1-2,CSARADSYGYTF,0,1,1,1
TRBV20-1,TRBJ2-7,CSASTGPGEQYF,0,1,1,1
TRBV20-1,TRBJ2-5,CSAGGGGETQYF,0,1,1,1
TRBV20-1,TRBJ2-3,CSASPGGHTQYF,0,1,1,1
TRBV20-1,TRBJ1-2,CSAQAGQTVPVA,0,1,1,1
TRBV20-1,TRBJ1-1,CSAAGGHTEAFF,0,1,1,1
TRBV20-1,TRBJ2-3,CSGWQKRDTQYF,0,1,1,1
TRBV29-1,TRBJ1-1,CSYAGINTEAFF,0,1,1,1
TRBV29-1,TRBJ2-1,CSVGWGDNVQFF,0,1,1,1
TRBV29-1,TRBJ2-3,CSVGGGGNTLYF,0,1,1,1
TRBV29-1,TRBJ2-3,CSVEAETNTQYF,0,1,1,1
TRBV29-1,TRBJ2-1,CSVEEGGAEQFF,0,1,1,1
TRBV29-1,TRBJ2-5,CSVRDSQETQYF,0,1,1,1
TRBV29-1,TRBJ2-1,CSARNPSGEQFF,0,1,1,1
TRBV29-1,TRBJ1-1,CSAQAGFTEAFF,0,1,1,1
TRBV29-1,TRBJ1-5,CSAEGGGQPQHF,0,1,1,1
TRBV30,TRBJ2-2,CAWTGTGELFF,0,1,1,1
TRBV30,TRBJ2-1,CAWSRATEQFF,0,1,1,1
TRBV28,TRBJ2-7,CAIQSTYEQYF,0,1,1,1
TRBV28,TRBJ2-3,CASGRGETQYF,0,1,1,1
TRBV28,TRBJ2-5,CASGGRETQYF,0,1,1,1
TRBV7-9,TRBJ2-5,CASDSQETQYF,0,1,1,1
TRBV28,TRBJ2-7,CASTNRYEQYF,0,1,1,1
TRBV28,TRBJ2-5,CASSFGTGGYF,0,1,1,1
TRBV6-2/3/5/6,TRBJ2-7,CASSLADEQYF,0,1,1,1
TRBV6-2/3/5/6,TRBJ2-3,CASSLTDTQYF,0,1,1,1
TRBV2,TRBJ2-5,CASSVEETQYF,0,1,1,1
TRBV7-9,TRBJ2-5,CASSRDTILYF,0,1,1,1
TRBV11-2,TRBJ2-7,CASSGQGEQYF,0,1,1,1
TRBV7-9,TRBJ2-7,CASSNHYEQYF,0,1,1,1
TRBV12-3/4,TRBJ2-5,CASSNGETQYF,0,1,1,1
TRBV12-3/4,TRBJ2-1,CASRQEGEQFF,0,1,1,1
TRBV2,TRBJ2-3,CASRGTDTQYF,0,1,1,1
TRBV6-2/3/5/6,TRBJ1-2,CASRRDYGYTF,0,1,1,1
TRBV5-1,TRBJ2-3,CASAETDTQYF,0,1,1,1
TRBV10-1,TRBJ1-2,CASSGQGGYTF,0,1,1,1
TRBV5-1,TRBJ2-7,CASREGSEQYF,0,1,1,1
TRBV5-1,TRBJ2-3,CASRTGNTQYF,0,1,1,1
TRBV20-1,TRBJ1-1,CSALRDSEAFF,0,1,1,1
TRBV29-1,TRBJ2-1,CSVGEQHEQFF,0,1,1,1
TRBV29-1,TRBJ2-7,CSVESGAGQYF,0,1,1,1
TRBV29-1,TRBJ2-1,CSVWTGNEQFF,0,1,1,1
TRBV29-1,TRBJ2-5,CSVGGGETQYF,0,1,1,1
TRBV29-1,TRBJ2-5,CSAGTGETQYF,0,1,1,1
TRBV29-1,TRBJ2-7,CSAGSSYEQYF,0,1,1,1
TRBV12-3/4,TRBJ2-1,CASSYNEQFF,0,1,1,1
TRBV29-1,TRBJ1-1,CSAGEEAFF,0,1,1,1
TRBV20-1,TRBJ2-1,CSARSTRRGLGLAGGLSYNEQFF,0,1,1,1
TRBV15,TRBJ2-1,CATSRETGSRLAGGMGYNEQFF,0,1,1,1
TRBV25-1,TRBJ2-4,CASTLNRDGKGVSGQAKNIQYF,0,1,1,1
TRBV12-5,TRBJ2-4,CASGFGGGYLDSSPKKNVQYF,0,1,1,1
TRBV6-2/3/5/6,TRBJ2-2,CASSSYPPGLAGGPEAGELFF,0,1,1,1
TRBV11-2,TRBJ2-3,CASSLSLYSGTSGRVTDTQYF,0,1,1,1
TRBV14,TRBJ2-1,CASSLTRPGTSGRTPYNEQFF,0,1,1,1
TRBV7-9,TRBJ2-1,CASSPRVGLAGGGGLNNEQFF,0,1,1,1
TRBV30,TRBJ2-3,CAWPVRSSGRRIGSTDTQYF,0,1,1,1
TRBV19,TRBJ2-6,CASSPGGEGQGHSGANVLTF,0,1,1,1
TRBV11-3,TRBJ1-5,CASSSYPRLGPSTTTQPQHF,0,1,1,1
TRBV20-1,TRBJ2-1,CSALRPVGAYNSPAYNEQFF,0,1,1,1
TRBV12-3/4,TRBJ2-1,CALIGVGKRTGGSGNEQFF,0,1,1,1
TRBV7-9,TRBJ2-1,CASSLMRYVSTSGVNEQFF,0,1,1,1
TRBV7-8,TRBJ2-7,CASSPSRTGTSQKAYEQYF,0,1,1,1
TRBV7-9,TRBJ2-2,CASSNRRPLAGGVTGELFF,0,1,1,1
TRBV28,TRBJ2-3,CASRPTSGTSSDSTDTQYF,0,1,1,1
TRBV7-2,TRBJ2-1,CASRKSALGVSWLGNEQFF,0,1,1,1
TRBV5-1,TRBJ2-7,CASSLADRFGGRTPYEQYF,0,1,1,1
TRBV20-1,TRBJ2-6,CSATLPKGASSSGANVLTF,0,1,1,1
TRBV20-1,TRBJ2-1,CSARGLIGLAQTTYNEQFF,0,1,1,1
TRBV20-1,TRBJ2-5,CSARGYRLAGVPRGETQYF,0,1,1,1
TRBV29-1,TRBJ2-1,CSVAGGLAGVFSSYNEQFF,0,1,1,1
TRBV29-1,TRBJ2-5,CSVTFGGLAGVVREETQYF,0,1,1,1
TRBV19,TRBJ2-6,CASSLTSGRTTGANVLTF,0,1,1,1
TRBV19,TRBJ2-1,CASSIPTMGLVGSNEQFF,0,1,1,1
TRBV19,TRBJ1-5,CASSIGVRGARSNQPQHF,0,1,1,1
TRBV18,TRBJ1-1,CASSPGMGQGEENTEAFF,0,1,1,1
TRBV18,TRBJ1-1,CASSRLFRDSQLNTEAFL,0,1,1,1
TRBV28,TRBJ2-3,CASSSTGTSGRPTISQYF,0,1,1,1
TRBV6-2/3/5/6,TRBJ2-7,CASSSRVLAGRGAYEQYF,0,1,1,1
TRBV6-2/3/5/6,TRBJ2-2,CASSYSPGTGKGTGELFF,0,1,1,1
TRBV6-2/3/5/6,TRBJ2-3,CASSYSGSRGDPTDTQYF,0,1,1,1
TRBV6-2/3/5/6,TRBJ2-7,CASSYSRTPSGSIAEQYF,0,1,1,1
TRBV7-2,TRBJ2-1,CASSFPPHSGRAIGEQFF,0,1,1,1
TRBV7-8,TRBJ2-7,CASSFQVLAGETSYEQYF,0,1,1,1
TRBV11-2,TRBJ2-6,CASSFRQRGQSGANVLTF,0,1,1,1
TRBV7-9,TRBJ2-6,CASSFVPGWLFGANVLTF,0,1,1,1
TRBV5-4,TRBJ2-5,CASSLGLAGGRGQETQYF,0,1,1,1
TRBV7-9,TRBJ2-1,CASSLAFRLAGGRNEQFF,0,1,1,1
TRBV7-2,TRBJ2-4,CASSLGTGRNLAKNIQYF,0,1,1,1
TRBV7-9,TRBJ2-2,CASSSTRTSGRDTGELFF,0,1,1,1
TRBV6-2/3/5/6,TRBJ2-3,CASSWDRDGMGITDTQYF,0,1,1,1
TRBV11-2,TRBJ2-1,CASSYKGRADRSYNEQFF,0,1,1,1
TRBV7-2,TRBJ2-1,CASSPRTRGWNSYNEQFF,0,1,1,1
TRBV4-2,TRBJ2-3,CASSQDRHRGTSPDTQYF,0,1,1,1
TRBV14,TRBJ2-3,CASSQDLVSGTSTDTQYF,0,1,1,1
TRBV9,TRBJ2-2,CASSVGLAGGSVTGELFF,0,1,1,1
TRBV3-1,TRBJ2-1,CASSVRLAVSWGYNEQFF,0,1,1,1
TRBV5-4,TRBJ2-1,CASSGGASGSVGYNEQFF,0,1,1,1
TRBV6-2/3/5/6,TRBJ2-1,CASRGGFHGSAQDNEQFF,0,1,1,1
TRBV5-1,TRBJ2-3,CASSFGAAGGSLTDTQYF,0,1,1,1
TRBV5-1,TRBJ2-7,CASSSGLAGAIYYIEQYF,0,1,1,1
TRBV5-1,TRBJ2-3,CASSWQAGGAGGTDTQYF,0,1,1,1
TRBV20-1,TRBJ2-1,CSARKGGRARRNYNEQFF,0,1,1,1
TRBV20-1,TRBJ2-4,CSARDPWASGMAKNIQYF,0,1,1,1
TRBV20-1,TRBJ2-7,CSARDERGGTDDHYEQYF,0,1,1,1
TRBV15,TRBJ2-3,CVTSKAFSGEATDTQYF,0,1,1,1
TRBV12-5,TRBJ2-1,CASGLPFLRESYNEQFF,0,1,1,1
TRBV30,TRBJ1-5,CAWSVKRTGGSYQPQHF,0,1,1,1
TRBV10-3,TRBJ2-6,CAISEGAGSSGANVLTF,0,1,1,1
TRBV12-3/4,TRBJ2-1,CATSWSPTASSYNEQFF,0,1,1,1
TRBV24-1,TRBJ2-2,CATSDLSGSGYTGELFF,0,1,1,1
TRBV15,TRBJ2-6,CATSRVTGAAGANVLTF,0,1,1,1
TRBV15,TRBJ2-2,CATSRDRLAVNTGELFY,0,1,1,1
TRBV9,TRBJ2-2,CASSLASGTMNTGELFF,0,1,1,1
TRBV19,TRBJ1-1,CASSRTRRQGINTEAFF,0,1,1,1
TRBV18,TRBJ2-1,CASSSLLASTTGNEQFF,0,1,1,1
TRBV18,TRBJ2-5,CASSPGTASGDQETQYF,0,1,1,1
TRBV18,TRBJ2-5,CASSPISLDSAWETQYF,0,1,1,1
TRBV18,TRBJ2-2,CASSPSLGEGGTGELFF,0,1,1,1
TRBV18,TRBJ2-7,CASSPPTSGDGFHEQYF,0,1,1,1
TRBV18,TRBJ2-1,CASSPRQGTSSYNEQFF,0,1,1,1
TRBV18,TRBJ2-6,CASSRFNGYSGANVLTF,0,1,1,1
TRBV7-8,TRBJ2-3,CASASGTTTFSTDTQYF,0,1,1,1
TRBV2,TRBJ2-3,CASGRGLAGGFGDTQYF,0,1,1,1
TRBV5-4,TRBJ2-6,CASTLGQTPSGANVLTF,0,1,1,1
TRBV28,TRBJ2-5,CASSFRAGHRTQETQYF,0,1,1,1
TRBV28,TRBJ2-2,CASSLLLAGGGTGELFF,0,1,1,1
TRBV27,TRBJ2-1,CASSLGGLAGGVNEQFF,0,1,1,1
TRBV27,TRBJ2-1,CASSLDLAGVGGNEQFF,0,1,1,1
TRBV28,TRBJ1-2,CASSLESVITVQYGYTF,0,1,1,1
TRBV6-2/3/5/6,TRBJ2-2,CASSSALTSGNTGELFF,0,1,1,1
TRBV6-2/3/5/6,TRBJ2-1,CASSYSHGVGSVDEQFF,0,1,1,1
TRBV6-2/3/5/6,TRBJ2-1,CASSYYPPGGPYNEQFF,0,1,1,1
TRBV12-3/4,TRBJ2-1,CASSPPHREIPYNEQFF,0,1,1,1
TRBV6-1,TRBJ2-1,CASSQGQAGSSYNEQFF,0,1,1,1
TRBV6-4,TRBJ2-1,CASSDVFFGTLKNEQFF,0,1,1,1
TRBV25-1,TRBJ2-2,CASSEFGTSGSDGELFF,0,1,1,1
TRBV6-1,TRBJ2-7,CASSEMGLAGGTYEQYF,0,1,1,1
TRBV6-1,TRBJ2-7,CASSETETSGRRYEQYF,0,1,1,1
TRBV5-6,TRBJ2-7,CASSFSLAGRDSYEQYF,0,1,1,1
TRBV5-6,TRBJ2-1,CASSFRPQVPPYNEQFF,0,1,1,1
TRBV5-4,TRBJ2-2,CASSLGGRTGSSGELFF,0,1,1,1
TRBV11-1,TRBJ2-1,CASSLGRGRFQSNEQFF,0,1,1,1
TRBV5-6,TRBJ2-7,CASSLDGPGASSYEQYF,0,1,1,1
TRBV7-2,TRBJ2-5,CASSLVLSGRVLETQYF,0,1,1,1
TRBV11-3,TRBJ2-5,CASSLGLAGADGETQYF,0,1,1,1
TRBV7-9,TRBJ2-5,CASSLGSSSGFQETQYF,0,1,1,1
TRBV9,TRBJ2-1,CASSSEGLAEAYNEQFF,0,1,1,1
TRBV7-9,TRBJ2-5,CASSSSRLSGTQETQYF,0,1,1,1
TRBV11-2,TRBJ2-1,CASSSQFTGNSYNEQSF,0,1,1,1
TRBV7-9,TRBJ2-3,CASSWGLFGAGADTQYF,0,1,1,1
TRBV13,TRBJ1-2,CASSLGTGRTLNYGYTF,0,1,1,1
TRBV4-2,TRBJ2-2,CASSLKEGTGADGELFF,0,1,1,1
TRBV6-2/3/5/6,TRBJ1-1,CASSLRQGGTGGTEAFF,0,1,1,1
TRBV13,TRBJ2-6,CASSPPGGVSGANVLTF,0,1,1,1
TRBV6-2/3/5/6,TRBJ2-3,CASSPEPAGGPRDTQYF,0,1,1,1
TRBV7-2,TRBJ2-1,CASSPRTLKGAYNEQFF,0,1,1,1
TRBV9,TRBJ2-4,CASSPHPDRPPKNIQYF,0,1,1,1
TRBV28,TRBJ2-6,CASSPPGVGTGANVLTF,0,1,1,1
TRBV7-2,TRBJ2-1,CASSPGALAGRYNEQFF,0,1,1,1
TRBV6-2/3/5/6,TRBJ2-1,CASSQQPGTSGHNEQFF,0,1,1,1
TRBV4-2,TRBJ2-7,CASSQVATSGIAYEQYF,0,1,1,1
TRBV4-2,TRBJ2-7,CASSQDPVGGSHYEQYF,0,1,1,1
TRBV3-1,TRBJ2-3,CASSQETSDLFGDTQYF,0,1,1,1
TRBV7-9,TRBJ2-3,CASSVFRDRWDTDTQYF,0,1,1,1
TRBV5-1,TRBJ2-1,CASSLEGSLSSYNEQFF,0,1,1,1
TRBV4-1,TRBJ2-5,CASSQDGLAGVRETQYF,0,1,1,1
TRBV5-1,TRBJ2-1,CASSLVSGSASYNEQFF,0,1,1,1
TRBV5-1,TRBJ2-3,CASSLVLAGSGTDTQYF,0,1,1,1
TRBV5-1,TRBJ2-3,CASSLAYAGGGADTQYF,0,1,1,1
TRBV5-1,TRBJ2-2,CASSLAVDRINTGELFF,0,1,1,1
TRBV5-1,TRBJ2-6,CASSLAGQGSGANVLTF,0,1,1,1
TRBV5-1,TRBJ1-5,CASSLGGTLGSNQPQHF,0,1,1,1
TRBV5-1,TRBJ2-4,CASSLEPGHPTGNIQYF,0,1,1,1
TRBV5-1,TRBJ2-1,CASSLEGPAASYNEQYF,0,1,1,1
TRBV5-1,TRBJ2-4,CASSSQLGLAGGNIQYF,0,1,1,1
TRBV5-1,TRBJ2-1,CASSWRTGGPGANEQFF,0,1,1,1
TRBV4-1,TRBJ2-1,CASSLTSGTGPYNEQFF,0,1,1,1
TRBV5-1,TRBJ2-1,CASSPGTSGREYNEQFF,0,1,1,1
TRBV4-1,TRBJ2-7,CASSPSSRGGGTYEQYF,0,1,1,1
TRBV4-1,TRBJ1-5,CASSQEGLGQRNQPQHF,0,1,1,1
TRBV4-1,TRBJ2-1,CASSQPSTSGRDNEQFF,0,1,1,1
TRBV4-1,TRBJ2-1,CASSQDPSTSDHNEQFF,0,1,1,1
TRBV20-1,TRBJ2-3,CSAFSGGAGGPEDTQYF,0,1,1,1
TRBV29-1,TRBJ2-1,CSVLLRVPYDSYNEQFF,0,1,1,1
TRBV5-1,TRBJ2-1,YASSLGGTGGAYNEQFF,0,1,1,1
TRBV4-1,TRBJ1-2,RASSQLTKDYGNYGYTF,0,1,1,1
TRBV30,TRBJ2-1,CAWSVHIGLSENEQFF,0,1,1,1
TRBV24-1,TRBJ2-1,CATTTSGANSYNEQFF,0,1,1,1
TRBV24-1,TRBJ2-2,CATSDLRDDAAGELFF,0,1,1,1
TRBV24-1,TRBJ2-1,CATSDSGTSGRDEQFF,0,1,1,1
TRBV24-1,TRBJ2-5,CATSETGLAGQETQYF,0,1,1,1
TRBV5-5,TRBJ2-6,CASCSPMAHGANVLTF,0,1,1,1
TRBV19,TRBJ2-2,CASSIWSGRAFGELFL,0,1,1,1
TRBV19,TRBJ2-1,CASSRGLADSYNEQFF,0,1,1,1
TRBV6-2/3/5/6,TRBJ2-1,CASLPPLGESYNEQFF,0,1,1,1
TRBV18,TRBJ1-2,CASSPLRDRVGDGYTF,0,1,1,1
TRBV18,TRBJ2-1,CASSPAGQGSYNEQFF,0,1,1,1
TRBV18,TRBJ1-1,CASSPLSEGVNTEAFL,0,1,1,1
TRBV18,TRBJ2-3,CASSPKEGGGADTQYF,0,1,1,1
TRBV6-2/3/5/6,TRBJ2-3,CASRPGYSGSKDTQYF,0,1,1,1
TRBV19,TRBJ2-7,CASRDGAGEGSYEQCF,0,1,1,1
TRBV27,TRBJ2-7,CASGPLGAGVNYEQYF,0,1,1,1
TRBV12-3/4,TRBJ2-2,CASTLPGLAVKGELFF,0,1,1,1
TRBV12-3/4,TRBJ2-3,CASTPRGGGGTDTQYF,0,1,1,1
TRBV12-3/4,TRBJ2-1,CASTPGGSTKGGEQFF,0,1,1,1
TRBV7-9,TRBJ2-2,CASSFPGLAITGELFF,0,1,1,1
TRBV28,TRBJ2-7,CASSFTPTHISYEQYF,0,1,1,1
TRBV28,TRBJ2-7,CASSFHLRDLNYEQYF,0,1,1,1
TRBV12-3/4,TRBJ2-5,CASSLWASSTQETQYF,0,1,1,1
TRBV28,TRBJ2-1,CASSLPAVVLIGEQFF,0,1,1,1
TRBV6-2/3/5/6,TRBJ2-1,CASSLARSGRRNEQFF,0,1,1,1
TRBV12-3/4,TRBJ2-7,CASSSPSGSGVYEQYF,0,1,1,1
TRBV10-3,TRBJ2-1,CASSSFGTSGHNEQFF,0,1,1,1
TRBV27,TRBJ2-1,CASSSTTPLDYNEQFF,0,1,1,1
TRBV6-2/3/5/6,TRBJ2-1,CASSYFGATSLNEQFF,0,1,1,1
TRBV6-2/3/5/6,TRBJ1-1,CASSYSPAAPNTEAFF,0,1,1,1
TRBV6-2/3/5/6,TRBJ1-6,CASSYSGRPVNSPLHF,0,1,1,1
TRBV6-2/3/5/6,TRBJ2-3,CASSYQLAGVADTQYF,0,1,1,1
TRBV6-2/3/5/6,TRBJ2-2,CASSYGGVPNTGELFF,0,1,1,1
TRBV2,TRBJ2-2,CASSYGRGGGTGELFF,0,1,1,1
TRBV11-2,TRBJ1-1,CASSPRGGSMNAEAFF,0,1,1,1
TRBV6-1,TRBJ2-2,CASSVLDRTNTGELFF,0,1,1,1
TRBV5-4,TRBJ2-3,CASSASTSGNTDTQYF,0,1,1,1
TRBV2,TRBJ2-7,CASSEGPTSGKREQYF,0,1,1,1
TRBV25-1,TRBJ2-7,CASSEYTATSSYEQYF,0,1,1,1
TRBV2,TRBJ2-7,CASSEAVAGAPYKQYL,0,1,1,1
TRBV2,TRBJ2-5,CASSEGLSRHQETQYF,0,1,1,1
TRBV2,TRBJ2-5,CASSEGLAGGGETQYF,0,1,1,1
TRBV7-2,TRBJ2-3,CASSFVAGTSANTQYF,0,1,1,1
TRBV7-2,TRBJ2-2,CASSFGSDRATGELFF,0,1,1,1
TRBV5-4,TRBJ2-3,CASSLPGLTRTDTQYF,0,1,1,1
TRBV4-2,TRBJ2-1,CASSLHVREPRNEQFF,0,1,1,1
TRBV5-4,TRBJ1-1,CASSLGPAGVNTEAFF,0,1,1,1
TRBV5-4,TRBJ2-2,CASSLEAGANTGELFF,0,1,1,1
TRBV5-8,TRBJ2-1,CASSLTPDRADDEQFF,0,1,1,1
TRBV7-2,TRBJ1-2,CASSLLGQSTVYGYTF,0,1,1,1
TRBV7-9,TRBJ2-1,CASSLVSLAGVHEQFF,0,1,1,1
TRBV7-2,TRBJ2-7,CASSLVYSGRGSEQYF,0,1,1,1
TRBV7-2,TRBJ2-1,CASSLAGTSSYNEQFF,0,1,1,1
TRBV7-9,TRBJ1-1,CASSLAGAGVGTEAFF,0,1,1,1
TRBV11-3,TRBJ2-1,CASSLGMGSSYNEQFF,0,1,1,1
TRBV7-2,TRBJ2-2,CASSLDSGRAAGELFF,0,1,1,1
TRBV7-6,TRBJ2-1,CASSLNGGGSYNEQFF,0,1,1,1
TRBV6-2/3/5/6,TRBJ2-7,CASSYGLGLPNYEQYF,0,1,1,1
TRBV7-9,TRBJ2-1,CASSYETGVLLNEQFF,0,1,1,1
TRBV7-9,TRBJ2-3,CASSYTSGILGDTQYF,0,1,1,1
TRBV3-1,TRBJ2-1,CASSPLPSGSRNEQFF,0,1,1,1
TRBV7-9,TRBJ2-3,CASSPGPGEGTDTQYF,0,1,1,1
TRBV6-2/3/5/6,TRBJ2-1,CASSPPGTRKYNEQFF,0,1,1,1
TRBV14,TRBJ2-1,CASSPRFTTISNEQFF,0,1,1,1
TRBV7-3,TRBJ2-1,CASSPRGGGSYNEQFF,0,1,1,1
TRBV9,TRBJ2-1,CASSPRTSGRRNEQFF,0,1,1,1
TRBV7-2,TRBJ2-7,CASSPGLAGASYEQYF,0,1,1,1
TRBV7-9,TRBJ2-2,CASSPRSGRVTGELFF,0,1,1,1
TRBV7-9,TRBJ2-3,CASSPKREGFTDTQYF,0,1,1,1
TRBV7-9,TRBJ1-4,CASSPLQTGRGEKLFF,0,1,1,1
TRBV7-3,TRBJ2-7,CASSPRDCTSSYEQYF,0,1,1,1
TRBV11-2,TRBJ2-1,CASSPLAGNSYNEQFF,0,1,1,1
TRBV7-9,TRBJ1-3,CASSPLRPSSGNTIYF,0,1,1,1
TRBV3-1,TRBJ2-1,CASSPGTSGRRNEQFF,0,1,1,1
TRBV3-1,TRBJ2-3,CASSRRAGVGTDTQYF,0,1,1,1
TRBV12-3/4,TRBJ1-5,CASSRSTRGENQPQHF,0,1,1,1
TRBV5-6,TRBJ2-5,CASSRRQFSGQETQYF,0,1,1,1
TRBV7-6,TRBJ2-7,CASSHEISGSSYEQYF,0,1,1,1
TRBV6-4,TRBJ2-1,CASSHRGLAMNNEQFF,0,1,1,1
TRBV7-9,TRBJ2-1,CASSQPGQGANNERFF,0,1,1,1
TRBV7-2,TRBJ2-3,CASSQRSSGSTDTQYF,0,1,1,1
TRBV14,TRBJ1-2,CASSQQRTSGAHGYTF,0,1,1,1
TRBV3-1,TRBJ2-1,CASSQVVLAGVREQFF,0,1,1,1
TRBV4-2,TRBJ2-7,CASSQAQDPGGSEQYF,0,1,1,1
TRBV16,TRBJ2-1,CASSQALAGAYNEQFF,0,1,1,1
TRBV4-2,TRBJ2-2,CASSQAPGPLTGELFF,0,1,1,1
TRBV14,TRBJ2-1,CASSQATSAINNEQFF,0,1,1,1
TRBV3-1,TRBJ1-4,CASSQGDRSSNEKLFF,0,1,1,1
TRBV4-2,TRBJ2-7,CASSQGEGLGLYEQYF,0,1,1,1
TRBV7-2,TRBJ2-1,CASSQGGQRSYNEQFF,0,1,1,1
TRBV4-2,TRBJ1-2,CASSQDRTISLDGYTF,0,1,1,1
TRBV9,TRBJ2-7,CASSVASGRAISEQYF,0,1,1,1
TRBV9,TRBJ2-7,CASSVEGQVGFYEQYF,0,1,1,1
TRBV5-6,TRBJ2-5,CASSAKLAGIQETQYF,0,1,1,1
TRBV6-4,TRBJ2-3,CASSDPVSFRANTQYF,0,1,1,1
TRBV6-1,TRBJ2-5,CASSEVSRWGRETQYF,0,1,1,1
TRBV7-8,TRBJ2-5,CASSIRDPHRRETQYF,0,1,1,1
TRBV5-5,TRBJ2-1,CASSTLAGVGYNEQFF,0,1,1,1
TRBV7-6,TRBJ2-2,CASSTIRGLAPGELFF,0,1,1,1
TRBV7-8,TRBJ1-6,CASRDRGSSYNSPLHF,0,1,1,1
TRBV12-3/4,TRBJ2-1,CASNVHRGPGGNEQFF,0,1,1,1
TRBV5-1,TRBJ2-1,CASCPMGEPGGNEQFF,0,1,1,1
TRBV5-1,TRBJ2-7,CASSLQRGGRSYEQYF,0,1,1,1
TRBV5-1,TRBJ2-7,CASSFLVPSGSYEQYF,0,1,1,1
TRBV5-1,TRBJ2-7,CASSFGTSGLSYEQYF,0,1,1,1
TRBV5-1,TRBJ2-1,CASSLVLLAAAREQFF,0,1,1,1
TRBV5-1,TRBJ2-3,CASSLDLQRGGDTQYF,0,1,1,1
TRBV5-1,TRBJ1-4,CASSLTGQTTNEKLFF,0,1,1,1
TRBV5-1,TRBJ2-7,CASSLRLAGELREQYF,0,1,1,1
TRBV5-1,TRBJ2-3,CASSLRTGESTDTQYL,0,1,1,1
TRBV5-1,TRBJ2-2,CASSPLGLTGIGELFF,0,1,1,1
TRBV4-1,TRBJ1-6,CASSRDRGLNDSHLHF,0,1,1,1
TRBV5-1,TRBJ1-2,CASSRGDRGPNYGYTF,0,1,1,1
TRBV4-1,TRBJ2-1,CASSHGPSGRLNEQFF,0,1,1,1
TRBV4-1,TRBJ2-2,CASSQASGPNTGELFF,0,1,1,1
TRBV4-1,TRBJ1-1,CASSQETTLQATEAFF,0,1,1,1
TRBV10-2,TRBJ2-1,CASSAPREPPYNEQFF,0,1,1,1
TRBV5-1,TRBJ2-6,CASSTGQGSGANVLTF,0,1,1,1
TRBV5-1,TRBJ2-1,CASRLAPSGAYNEQFF,0,1,1,1
TRBV5-1,TRBJ2-1,CGSSSGTSGSYNEQFF,0,1,1,1
TRBV20-1,TRBJ2-2,CSAIPFGGVSTGELFF,0,1,1,1
TRBV20-1,TRBJ2-5,CSASMLAGVGQETQNF,0,1,1,1
TRBV20-1,TRBJ2-6,CSARGRGKPGANVLTF,0,1,1,1
TRBV20-1,TRBJ2-3,CSARATGGRGTDTQYF,0,1,1,1
TRBV20-1,TRBJ2-5,CSARDSGREAGETQYF,0,1,1,1
TRBV20-1,TRBJ2-4,CSARDRARTSKNIQYF,0,1,1,1
TRBV20-1,TRBJ2-1,CSAQNPTSGDYNEQFF,0,1,1,1
TRBV20-1,TRBJ1-3,CSAIGPPEAGGNTIYF,0,1,1,1
TRBV20-1,TRBJ2-1,CSARVQAAGAYNEQFF,0,1,1,1
TRBV29-1,TRBJ2-3,CSVASRQGVSTDTQYF,0,1,1,1
TRBV29-1,TRBJ2-3,CSVALAGVGRTDTQYF,0,1,1,1
TRBV29-1,TRBJ2-1,CSVDASAKGGRNEQFF,0,1,1,1
TRBV19,TRBJ1-5,RASKGSAFNSNQPQHF,0,1,1,1
TRBV30,TRBJ1-1,CAWSAGPIQYTEAFF,0,1,1,1
TRBV30,TRBJ1-3,CAWSAGALPGNTIYF,0,1,1,1
TRBV30,TRBJ1-1,CAWRGIGEMNTEAFF,0,1,1,1
TRBV30,TRBJ1-1,CAWRTLGQGAGEAFF,0,1,1,1
TRBV19,TRBJ2-3,CAAGPQRGDGDTQYF,0,1,1,1
TRBV5-6,TRBJ2-1,CAGSFLLAANNEQFF,0,1,1,1
TRBV28,TRBJ2-7,CAIRGETGNSYEQYF,0,1,1,1
TRBV10-3,TRBJ2-1,CAIRGDHAGDNEQFF,0,1,1,1
TRBV24-1,TRBJ1-1,CATSDGGTVFSEAFF,0,1,1,1
TRBV15,TRBJ2-1,CATSLRTGQGNEQFF,0,1,1,1
TRBV19,TRBJ2-7,CASSLQGGYSYEQYF,0,1,1,1
TRBV19,TRBJ1-2,CASSPPGGWSYGYTF,0,1,1,1
TRBV19,TRBJ1-5,CASSHDGQGKQPQHF,0,1,1,1
TRBV19,TRBJ2-1,CASSITSGGLNEQFF,0,1,1,1
TRBV19,TRBJ2-7,CASSIVPTSRYEQYF,0,1,1,1
TRBV19,TRBJ2-7,CASSTWTSGIHEQYF,0,1,1,1
TRBV19,TRBJ2-7,CASSTQLAGAVEQYF,0,1,1,1
TRBV19,TRBJ2-1,CASSRLAGVNNEQFF,0,1,1,1
TRBV19,TRBJ2-3,CASSNPRAALDTQYF,0,1,1,1
TRBV19,TRBJ1-2,CASRPGPNEGDGYTF,0,1,1,1
TRBV19,TRBJ2-1,CASRRTSGGYNEQFL,0,1,1,1
TRBV19,TRBJ1-2,CASKTTGDFNYGYTF,0,1,1,1
TRBV6-2/3/5/6,TRBJ2-1,CASLTGLAGGNEQFF,0,1,1,1
TRBV18,TRBJ2-7,CASSLRDTRLYEQYF,0,1,1,1
TRBV18,TRBJ2-1,CASSPITSGRNEQFF,0,1,1,1
TRBV18,TRBJ2-1,CASSDVQGGYNEQFF,0,1,1,1
TRBV18,TRBJ2-2,CASSPPSGGTGELFF,0,1,1,1
TRBV18,TRBJ1-6,CASSPRQGLNSPLHF,0,1,1,1
TRBV18,TRBJ1-1,CASSPQNPLNTEAFF,0,1,1,1
TRBV18,TRBJ2-7,CASSPRRRGEYEQYF,0,1,1,1
TRBV18,TRBJ2-3,CASSEGWASTDKQYF,0,1,1,1
TRBV28,TRBJ1-4,CASLNPSGRDEKLFF,0,1,1,1
TRBV11-2,TRBJ2-4,CASRTWGLGETIQYF,0,1,1,1
TRBV2,TRBJ2-3,CASHGGPPGTDTQYF,0,1,1,1
TRBV27,TRBJ2-3,CASQGTSDSTDTQYF,0,1,1,1
TRBV5-4,TRBJ2-5,CASGERLAGQETQCF,0,1,1,1
TRBV6-2/3/5/6,TRBJ1-2,CASGRQGRANYGYTF,0,1,1,1
TRBV2,TRBJ2-2,CASDTSGVNTGELFF,0,1,1,1
TRBV6-2/3/5/6,TRBJ2-1,CASELVGQGYNEQFF,0,1,1,1
TRBV28,TRBJ2-7,CASIGTGGLSYEQYF,0,1,1,1
TRBV7-2,TRBJ2-1,CASTRGSSGTNEQFF,0,1,1,1
TRBV6-2/3/5/6,TRBJ2-3,CASSFVAGGGDTQYF,0,1,1,1
TRBV6-2/3/5/6,TRBJ1-2,CASSFGDRGRSGYTF,0,1,1,1
TRBV28,TRBJ2-7,CASSLGVLSWYEQYF,0,1,1,1
TRBV6-2/3/5/6,TRBJ2-5,CASSLSSGGQETQYF,0,1,1,1
TRBV12-3/4,TRBJ2-2,CASSLIGGGTGELFF,0,1,1,1
TRBV28,TRBJ2-3,CASSLTSGQTDTQYF,0,1,1,1
TRBV28,TRBJ2-1,CASSSGGRSYNEQFF,0,1,1,1
TRBV6-2/3/5/6,TRBJ1-2,CASSSPGRGDYGYTF,0,1,1,1
TRBV5-5,TRBJ1-4,CASSSGGGTNEKLFF,0,1,1,1
TRBV28,TRBJ2-1,CASSSSGAGYNEQFF,0,1,1,1
TRBV6-2/3/5/6,TRBJ2-1,CASSSPSGRGDEQFF,0,1,1,1
TRBV6-2/3/5/6,TRBJ1-4,CASSSGRGVNEKLFF,0,1,1,1
TRBV6-2/3/5/6,TRBJ2-7,CASSYATGETYEQYF,0,1,1,1
TRBV6-2/3/5/6,TRBJ2-7,CASSYAGQLPYEQYF,0,1,1,1
TRBV6-2/3/5/6,TRBJ2-7,CASSYGGGDLREQYF,0,1,1,1
TRBV6-2/3/5/6,TRBJ2-7,CASSYTMARAYEQYF,0,1,1,1
TRBV6-2/3/5/6,TRBJ2-5,CASSPHRGLDETQYF,0,1,1,1
TRBV27,TRBJ2-1,CASSPFRPDGDEQFF,0,1,1,1
TRBV28,TRBJ2-7,CASSQTGAPSYEQYF,0,1,1,1
TRBV6-1,TRBJ2-1,CASSAGGPPSDEQFF,0,1,1,1
TRBV6-1,TRBJ2-1,CASSDFGTSEDEQFF,0,1,1,1
TRBV25-1,TRBJ2-3,CASSDPSGRTDTQYF,0,1,1,1
TRBV6-4,TRBJ2-2,CASSDQGTDSGELFF,0,1,1,1
TRBV2,TRBJ2-5,CASSELSLASVTQYF,0,1,1,1
TRBV25-1,TRBJ2-5,CASSEWIGRVETQYF,0,1,1,1
TRBV6-1,TRBJ2-7,CASSEVVTPSYEQYF,0,1,1,1
TRBV2,TRBJ2-3,CASSEAGAGGDTQYF,0,1,1,1
TRBV6-1,TRBJ2-2,CASSEALGNTGELFF,0,1,1,1
TRBV2,TRBJ2-1,CASSEEGQGADEQFF,0,1,1,1
TRBV5-4,TRBJ2-1,CASSFSSGWANEQFF,0,1,1,1
TRBV7-3,TRBJ2-1,CASSFGSGPRGEQFF,0,1,1,1
TRBV5-4,TRBJ2-6,CASSFNRESPNVLTF,0,1,1,1
TRBV5-6,TRBJ2-5,CASSLALGTLVTQYF,0,1,1,1
TRBV5-5,TRBJ2-6,CASSLAGSGANVLTF,0,1,1,1
TRBV5-5,TRBJ2-3,CASSLAQGGTDTQYF,0,1,1,1
TRBV7-9,TRBJ1-2,CASSLGVAGAYGYTF,0,1,1,1
TRBV5-6,TRBJ2-1,CASSLGWTSPNEQFF,0,1,1,1
TRBV5-4,TRBJ2-1,CASSLDSGTYNEQFF,0,1,1,1
TRBV5-6,TRBJ2-7,CASSLERQNRNEQYF,0,1,1,1
TRBV5-5,TRBJ1-5,CASSLERQGTQPQHF,0,1,1,1
TRBV5-4,TRBJ2-1,CASSLSGRPGNEQFF,0,1,1,1
TRBV7-2,TRBJ2-1,CASSLAGSSYNEQFF,0,1,1,1
TRBV7-9,TRBJ2-7,CASSLALAGINEQYF,0,1,1,1
TRBV7-9,TRBJ2-1,CASSLAGGSDNEQFF,0,1,1,1
TRBV7-8,TRBJ2-5,CASSLGAGRQETQYF,0,1,1,1
TRBV11-2,TRBJ2-7,CASSLGGGMPYEQYF,0,1,1,1
TRBV7-9,TRBJ2-5,CASSLGSGGQETQYF,0,1,1,1
TRBV7-2,TRBJ2-3,CASSLGLWGRDTQYF,0,1,1,1
TRBV7-9,TRBJ2-5,CASSLGPRSKETQYF,0,1,1,1
TRBV11-3,TRBJ2-2,CASSLDQQGGGELFF,0,1,1,1
TRBV7-2,TRBJ1-5,CASSLDGGGGQPQHF,0,1,1,1
TRBV11-2,TRBJ2-5,CASSLSGTKQETQYF,0,1,1,1
TRBV7-6,TRBJ2-1,CASSLNQATHNEQFF,0,1,1,1
TRBV5-4,TRBJ2-7,CASSSTSGDFYEQYF,0,1,1,1
TRBV6-2/3/5/6,TRBJ2-7,CASSSLSGGFREQYF,0,1,1,1
TRBV7-2,TRBJ2-1,CASSSQAGGYNEQFF,0,1,1,1
TRBV11-3,TRBJ2-1,CASSSGTSGSHEQFF,0,1,1,1
TRBV7-9,TRBJ2-7,CASSSRPGPSYEQYF,0,1,1,1
TRBV7-2,TRBJ2-7,CASSSNGRISYEQYF,0,1,1,1
TRBV11-2,TRBJ1-1,CASSSWPDSDTEAFF,0,1,1,1
TRBV7-9,TRBJ2-7,CASSSGPRVTYEQYF,0,1,1,1
TRBV5-4,TRBJ2-7,CASSWAGTGTFEQYF,0,1,1,1
TRBV7-3,TRBJ2-1,CASSYLAGVSNEQFF,0,1,1,1
TRBV11-2,TRBJ1-1,CASSYNQGPYTEAFF,0,1,1,1
TRBV7-2,TRBJ2-6,CASSLDHSGANVLTF,0,1,1,1
TRBV13,TRBJ2-3,CASSLRDGSTDTQYF,0,1,1,1
TRBV11-3,TRBJ2-2,CASSLGLAGTGELFF,0,1,1,1
TRBV7-2,TRBJ2-3,CASSLDPLSTDTQYF,0,1,1,1
TRBV27,TRBJ2-1,CASSLDWDSYNEQFF,0,1,1,1
TRBV7-9,TRBJ1-1,CASSPLGGPGAEAFF,0,1,1,1
TRBV7-8,TRBJ2-3,CASSPRPRAPDTQYF,0,1,1,1
TRBV7-6,TRBJ2-5,CASSPNRDSQETQYF,0,1,1,1
TRBV3-1,TRBJ1-1,CASSPQQGEGLQAFF,0,1,1,1
TRBV9,TRBJ2-3,CASSPPGSYTDTQYF,0,1,1,1
TRBV5-4,TRBJ2-7,CASSRGGGVSYEQYF,0,1,1,1
TRBV5-4,TRBJ2-7,CASSRGVVAPYEQYF,0,1,1,1
TRBV14,TRBJ2-3,CASSRDRGWPDTQYF,0,1,1,1
TRBV6-2/3/5/6,TRBJ2-5,CASSRDRREAETQYF,0,1,1,1
TRBV5-5,TRBJ2-7,CASSRTSGAPYEQYF,0,1,1,1
TRBV7-2,TRBJ1-5,CASSRAGGGNQPQHF,0,1,1,1
TRBV13,TRBJ2-5,CASSHRTSNQETQYF,0,1,1,1
TRBV5-4,TRBJ2-7,CASSQELGSSYEQYF,0,1,1,1
TRBV7-9,TRBJ2-1,CASSQIRPTDNEQFF,0,1,1,1
TRBV3-1,TRBJ2-5,CASSQNVGGPETQYF,0,1,1,1
TRBV4-2,TRBJ1-2,CASSQPGQSHYGYTF,0,1,1,1
TRBV3-1,TRBJ2-1,CASSQVGLAGSKQFF,0,1,1,1
TRBV4-2,TRBJ2-5,CASSQAGRQQETQYF,0,1,1,1
TRBV3-1,TRBJ1-5,CASSQGALGDQPQHF,0,1,1,1
TRBV4-2,TRBJ2-7,CASSQGAAGAYEQYF,0,1,1,1
TRBV3-1,TRBJ2-5,CASSQDGNSWETQYF,0,1,1,1
TRBV4-2,TRBJ1-2,CASSQEEGLSYGYTF,0,1,1,1
TRBV9,TRBJ2-3,CASSVGTGTTDTQYF,0,1,1,1
TRBV11-2,TRBJ2-2,CASSVDRGNAGELFF,0,1,1,1
TRBV7-9,TRBJ2-1,CASSVIASSYNEQFF,0,1,1,1
TRBV9,TRBJ2-1,CASSVVDSPYNEQFF,0,1,1,1
TRBV9,TRBJ2-5,CASSVGVSPHETQYF,0,1,1,1
TRBV9,TRBJ2-5,CASSVDPGQQETQYF,0,1,1,1
TRBV9,TRBJ2-3,CASSVEDRGSNTQYF,0,1,1,1
TRBV9,TRBJ2-4,CASSVEGARKNIQYF,0,1,1,1
TRBV14,TRBJ2-7,CASSAHRGSPYEQYF,0,1,1,1
TRBV9,TRBJ2-3,CASSGTSGGADTQYF,0,1,1,1
TRBV6-1,TRBJ2-1,CASSEQGASYNEQFF,0,1,1,1
TRBV7-9,TRBJ1-3,CASSMTALAGNTIYF,0,1,1,1
TRBV6-2/3/5/6,TRBJ2-7,CASSTGLADSYEQYF,0,1,1,1
TRBV6-2/3/5/6,TRBJ2-5,CASRRLAGSQETQYF,0,1,1,1
TRBV6-2/3/5/6,TRBJ1-5,CASRVTGGVNQPQYF,0,1,1,1
TRBV2,TRBJ2-1,CASRERVLGSNEQFF,0,1,1,1
TRBV13,TRBJ2-7,CASRFGTASHYEQYF,0,1,1,1
TRBV27,TRBJ1-5,CASRPGRRSNQPQHF,0,1,1,1
TRBV12-3/4,TRBJ2-2,CASRPTGQNTGELFF,0,1,1,1
TRBV7-6,TRBJ2-5,CASRRATGGRVTQYF,0,1,1,1
TRBV6-2/3/5/6,TRBJ1-6,CASRQGVVQDSPLHF,0,1,1,1
TRBV2,TRBJ2-1,CASRVAGGSFNEQFF,0,1,1,1
TRBV6-2/3/5/6,TRBJ2-7,CASRTLRGDGYEQYF,0,1,1,1
TRBV2,TRBJ2-2,CASNDYPYNTGELFF,0,1,1,1
TRBV2,TRBJ2-1,CASKRASGSMGEQFF,0,1,1,1
TRBV12-3/4,TRBJ1-1,CASKHRGMTNTEAFF,0,1,1,1
TRBV6-2/3/5/6,TRBJ2-2,CASKGAGGSTGELFF,0,1,1,1
TRBV25-1,TRBJ2-1,CASKEDLAGANEQFF,0,1,1,1
TRBV7-9,TRBJ2-1,CGSSVGLAGYNEQFF,0,1,1,1
TRBV5-6,TRBJ2-7,CDSSLESRPSDEQYF,0,1,1,1
TRBV5-1,TRBJ1-1,CASYPGTGKGTEAFF,0,1,1,1
TRBV5-1,TRBJ2-3,CASRVAGGPVDTQYF,0,1,1,1
TRBV5-1,TRBJ2-3,CASTSSGRASDTQYF,0,1,1,1
TRBV5-1,TRBJ2-3,CASTTQGQSTDTQYF,0,1,1,1
TRBV5-1,TRBJ2-5,CASSFYGSTQETQYF,0,1,1,1
TRBV5-1,TRBJ2-5,CASSFGGTRQETQYY,0,1,1,1
TRBV5-1,TRBJ2-5,CASSFGGDVQETQYF,0,1,1,1
TRBV5-1,TRBJ2-1,CASSFEGESYNEQFF,0,1,1,1
TRBV5-1,TRBJ2-3,CASSFPGQITDTQYF,0,1,1,1
TRBV5-1,TRBJ2-7,CASSFGTGVVYEQYF,0,1,1,1
TRBV5-1,TRBJ1-1,CASSLVGGFNTEAFF,0,1,1,1
TRBV5-1,TRBJ2-7,CASSLAAGEGYEQYF,0,1,1,1
TRBV5-1,TRBJ1-3,CASSLGLGLGNTIYF,0,1,1,1
TRBV5-1,TRBJ1-6,CASSLGGTGESPLHF,0,1,1,1
TRBV5-1,TRBJ1-5,CASSLDGGSNQPQHF,0,1,1,1
TRBV5-1,TRBJ2-5,CASSLEGARRETQYF,0,1,1,1
TRBV5-1,TRBJ2-2,CASSLRQMNTGELFF,0,1,1,1
TRBV7-6,TRBJ2-6,CASSSPKSGANVLTF,0,1,1,1
TRBV5-1,TRBJ2-1,CASSSTGGFVNEQFF,0,1,1,1
TRBV5-1,TRBJ2-1,CASSWGGTRVNEQFF,0,1,1,1
TRBV4-1,TRBJ2-1,CASSLDRGSRSEQFF,0,1,1,1
TRBV5-1,TRBJ2-1,CASSLTGDSYNEQFF,0,1,1,1
TRBV5-1,TRBJ2-1,CASSPQGGSYNEQFF,0,1,1,1
TRBV5-1,TRBJ2-7,CASSPSSGDLYEQYF,0,1,1,1
TRBV4-1,TRBJ2-1,CASSPYYPSYNEQFF,0,1,1,1
TRBV4-1,TRBJ2-7,CASSPRDSKIYEQYF,0,1,1,1
TRBV5-1,TRBJ2-6,CASSPRGGGANVLTF,0,1,1,1
TRBV5-1,TRBJ1-2,CASSPRTGGDYGYTF,0,1,1,1
TRBV5-1,TRBJ2-5,CASSPTSGEQETQYF,0,1,1,1
TRBV5-1,TRBJ2-1,CASSPREGPYNEQFF,0,1,1,1
TRBV5-1,TRBJ1-2,CASSPNRGRGYGYTF,0,1,1,1
TRBV4-1,TRBJ2-1,CASSHGPRDINEQFF,0,1,1,1
TRBV4-1,TRBJ2-1,CASSQGRLAGNEQFF,0,1,1,1
TRBV4-1,TRBJ1-5,CASSQDGQGKQPQHF,0,1,1,1
TRBV5-1,TRBJ2-2,CASSGTSGSTGELFF,0,1,1,1
TRBV5-1,TRBJ2-1,CASSDLAGAVNEQFF,0,1,1,1
TRBV5-1,TRBJ2-1,CASSRGTVAANEQFF,0,1,1,1
TRBV10-2,TRBJ2-7,CASRGTKSSLYEQYF,0,1,1,1
TRBV5-1,TRBJ2-5,CASRSGTAGRETQYF,0,1,1,1
TRBV5-1,TRBJ2-7,CASRPRRIRDYEQYF,0,1,1,1
TRBV5-1,TRBJ2-7,CARSSIAGPTYEQYF,0,1,1,1
TRBV20-1,TRBJ2-1,CSVPLLAPIHNEQFF,0,1,1,1
TRBV20-1,TRBJ1-5,CSASASTGSGQPQHF,0,1,1,1
TRBV20-1,TRBJ2-7,CSATLPDRASYEQYF,0,1,1,1
TRBV20-1,TRBJ2-1,CSASSGIRVYNEQFF,0,1,1,1
TRBV20-1,TRBJ2-7,CSAREGKRGTYEQYF,0,1,1,1
TRBV20-1,TRBJ2-2,CSARPSGKNTGELFF,0,1,1,1
TRBV20-1,TRBJ2-3,CSARPAGGYADTQYF,0,1,1,1
TRBV20-1,TRBJ2-7,CSARADGEVLYEQYF,0,1,1,1
TRBV20-1,TRBJ2-7,CSANAPGGTSYEQYF,0,1,1,1
TRBV20-1,TRBJ2-7,CSANPSGPSTYEQYF,0,1,1,1
TRBV20-1,TRBJ2-7,CSANDPTSGIGEQYF,0,1,1,1
TRBV20-1,TRBJ2-3,CSAPQGANSGDTQYF,0,1,1,1
TRBV20-1,TRBJ1-1,CSASTGGMMNTEAFF,0,1,1,1
TRBV20-1,TRBJ2-5,CSARSGGGAGETQYF,0,1,1,1
TRBV29-1,TRBJ2-1,CSVSSGDPQYNEQFF,0,1,1,1
TRBV29-1,TRBJ1-1,CSVAGGTASNTEAFF,0,1,1,1
TRBV29-1,TRBJ2-3,CSVGMRDTGTDTQYF,0,1,1,1
TRBV29-1,TRBJ2-7,CSVERIQGGVYEQYF,0,1,1,1
TRBV29-1,TRBJ2-3,CSVNPLGGNTDTQYF,0,1,1,1
TRBV7-4,TRBJ1-5,RASSWSAGSNQPQHF,0,1,1,1
TRBV5-1,TRBJ2-7,GASSLARVGAYEQYF,0,1,1,1
TRBV5-1,TRBJ2-1,SASSLVGDSNNEQFF,0,1,1,1
TRBV12-5,TRBJ2-7,CASGWASGMREQYF,0,1,1,1
TRBV7-9,TRBJ2-3,CACSLRLAADTQYF,0,1,1,1
TRBV30,TRBJ2-7,CAWNTGGGSYEQYF,0,1,1,1
TRBV30,TRBJ2-7,CARSEGGSSYEQYF,0,1,1,1
TRBV3-1,TRBJ2-1,CAGSQEAGDNEQFF,0,1,1,1
TRBV10-3,TRBJ2-3,CAISAKVEADTQYF,0,1,1,1
TRBV10-3,TRBJ2-3,CAISDGSSTDTQYF,0,1,1,1
TRBV10-3,TRBJ2-5,CAISEGRVRETQYF,0,1,1,1
TRBV10-3,TRBJ2-1,CAISQREGRYEQFF,0,1,1,1
TRBV10-3,TRBJ2-7,CAISKSDGDYEQYF,0,1,1,1
TRBV7-9,TRBJ2-1,CATLPNVFYNGQFF,0,1,1,1
TRBV28,TRBJ2-2,CATIAPGDTGELFF,0,1,1,1
TRBV24-1,TRBJ2-1,CATSDPPLYNEQFF,0,1,1,1
TRBV24-1,TRBJ2-1,CATSDSGTSGEQFF,0,1,1,1
TRBV24-1,TRBJ2-7,CATSDSSSKYEQYF,0,1,1,1
TRBV15,TRBJ2-5,CATSRTGGQETQYF,0,1,1,1
TRBV19,TRBJ2-5,CASSKADIQETQYF,0,1,1,1
TRBV19,TRBJ2-3,CASSWAQVTDTQYF,0,1,1,1
TRBV19,TRBJ2-1,CASSYLGPNNEQFF,0,1,1,1
TRBV19,TRBJ2-5,CASSLQGDQETQYF,0,1,1,1
TRBV19,TRBJ2-2,CASSGTPNTGELFF,0,1,1,1
TRBV19,TRBJ2-5,CASSIYQGRETQYF,0,1,1,1
TRBV19,TRBJ2-3,CASSKTSGVDTQYF,0,1,1,1
TRBV19,TRBJ1-2,CASRAHGPDYGYTF,0,1,1,1
TRBV19,TRBJ2-3,CASRRRGPTDTQYF,0,1,1,1
TRBV19,TRBJ2-4,CASRGTGTKNIQYF,0,1,1,1
TRBV28,TRBJ2-7,CASNPGQALYEQNF,0,1,1,1
TRBV18,TRBJ2-5,CASSLDSFHETQYF,0,1,1,1
TRBV18,TRBJ2-3,CASSPFAGADTQYF,0,1,1,1
TRBV18,TRBJ2-3,CASSPADFTDTQYF,0,1,1,1
TRBV18,TRBJ2-1,CASSPPSELDEQFF,0,1,1,1
TRBV18,TRBJ1-1,CASSPPGGGTEAFF,0,1,1,1
TRBV18,TRBJ2-5,CASSPRTGKETQHF,0,1,1,1
TRBV18,TRBJ1-1,CASSPTALNTEAFF,0,1,1,1
TRBV28,TRBJ2-2,CASCDYANTGELFF,0,1,1,1
TRBV6-2/3/5/6,TRBJ2-7,CASLPEGLPYEQYF,0,1,1,1
TRBV10-3,TRBJ2-3,CASRAGLTTDTQYF,0,1,1,1
TRBV6-2/3/5/6,TRBJ2-1,CASRGAGGANEQFF,0,1,1,1
TRBV18,TRBJ2-6,CASRGGARANILTF,0,1,1,1
TRBV7-9,TRBJ2-2,CASQGLSDTGELFF,0,1,1,1
TRBV12-3/4,TRBJ2-1,CASVREGSYNEQFF,0,1,1,1
TRBV6-2/3/5/6,TRBJ1-1,CASARGFLNTEAFF,0,1,1,1
TRBV12-3/4,TRBJ1-2,CASTVLEASDLGTF,0,1,1,1
TRBV7-2,TRBJ1-2,CASTVQGLGYGYTF,0,1,1,1
TRBV7-9,TRBJ2-5,CASTAGGAEETQYF,0,1,1,1
TRBV28,TRBJ1-5,CASTVAGPNQPQHF,0,1,1,1
TRBV12-3/4,TRBJ2-1,CASSLAGGGGEQFF,0,1,1,1
TRBV12-3/4,TRBJ2-5,CASSLSGEEETQYF,0,1,1,1
TRBV12-3/4,TRBJ1-4,CASSLGGTNEKLFF,0,1,1,1
TRBV12-3/4,TRBJ2-7,CASSLGGAVDEQYF,0,1,1,1
TRBV6-2/3/5/6,TRBJ2-7,CASSLGGARYEQYF,0,1,1,1
TRBV28,TRBJ2-1,CASSLGQPYNEQFF,0,1,1,1
TRBV6-2/3/5/6,TRBJ1-5,CASSLGNQGQPQHF,0,1,1,1
TRBV6-2/3/5/6,TRBJ2-3,CASSLEDDTDAQYF,0,1,1,1
TRBV6-2/3/5/6,TRBJ2-7,CASSLTGGTYEQYF,0,1,1,1
TRBV6-2/3/5/6,TRBJ1-2,CASSLRGGSYGYTF,0,1,1,1
TRBV6-2/3/5/6,TRBJ1-2,CASSSLSNRGGYTF,0,1,1,1
TRBV28,TRBJ2-3,CASSSGLATDTQYF,0,1,1,1
TRBV28,TRBJ2-3,CASSSGAPTDTQYF,0,1,1,1
TRBV27,TRBJ2-5,CASSSNNRGETQYF,0,1,1,1
TRBV6-2/3/5/6,TRBJ2-3,CASSYGPLEDTQYF,0,1,1,1
TRBV6-2/3/5/6,TRBJ1-5,CASSYERPNQPQHF,0,1,1,1
TRBV6-2/3/5/6,TRBJ2-2,CASSLDQNTGELFF,0,1,1,1
TRBV12-3/4,TRBJ1-5,CASSPDYSNQPQHF,0,1,1,1
TRBV7-3,TRBJ2-5,CASSPAGERETQYF,0,1,1,1
TRBV6-4,TRBJ2-7,CASSRTSGSIEQYF,0,1,1,1
TRBV28,TRBJ2-7,CASSHRTDPYEQYF,0,1,1,1
TRBV7-9,TRBJ2-1,CASSQSEGFSVQFF,0,1,1,1
TRBV6-1,TRBJ2-3,CASSVPGLTDTQYF,0,1,1,1
TRBV6-1,TRBJ2-5,CASSAVGGQETQYF,0,1,1,1
TRBV28,TRBJ2-7,CASSGGWRAYEQYF,0,1,1,1
TRBV25-1,TRBJ2-1,CASSDGDKDNEQFF,0,1,1,1
TRBV6-4,TRBJ2-3,CASSDRQGADTQYF,0,1,1,1
TRBV6-4,TRBJ2-1,CASSDESPGNEQFF,0,1,1,1
TRBV6-1,TRBJ2-7,CASSETGGSYEQYF,0,1,1,1
TRBV25-1,TRBJ2-7,CASSEPGSSYEQYF,0,1,1,1
TRBV2,TRBJ2-2,CASSEVAATGELFF,0,1,1,1
TRBV6-1,TRBJ1-1,CASSENQMNTEAFF,0,1,1,1
TRBV2,TRBJ1-1,CASSENQMNNEAFF,0,1,1,1
TRBV28,TRBJ2-7,CASSIRAVGAEQYF,0,1,1,1
TRBV25-1,TRBJ2-3,CASSTSGSTDTQYF,0,1,1,1
TRBV2,TRBJ2-7,CASSNKRDSLEQYF,0,1,1,1
TRBV11-2,TRBJ2-1,CASSFRNSYNEQFF,0,1,1,1
TRBV5-4,TRBJ2-1,CASSFTGPYNEQFF,0,1,1,1
TRBV7-2,TRBJ2-7,CASSLAGTDYEQYF,0,1,1,1
TRBV7-2,TRBJ1-1,CASSLGGFSTEAFF,0,1,1,1
TRBV5-5,TRBJ2-7,CASSLEGTNYEQYF,0,1,1,1
TRBV7-7,TRBJ2-2,CASSLLMNTGELFF,0,1,1,1
TRBV11-2,TRBJ2-1,CASSLVQGSSEQFF,0,1,1,1
TRBV7-9,TRBJ2-7,CASSLGAGYFEQYF,0,1,1,1
TRBV7-9,TRBJ2-7,CASSLTDSNYEQYF,0,1,1,1
TRBV7-2,TRBJ1-5,CASSLRGANQPQHF,0,1,1,1
TRBV7-6,TRBJ2-1,CASSLREGRNEQFI,0,1,1,1
TRBV7-3,TRBJ2-5,CASSLNRNQEAQYF,0,1,1,1
TRBV7-2,TRBJ2-3,CASSSGRSTDTQYF,0,1,1,1
TRBV28,TRBJ2-7,CASSSGTGPGEQYF,0,1,1,1
TRBV11-1,TRBJ2-5,CASSSTEGRETQYF,0,1,1,1
TRBV5-4,TRBJ2-5,CASSSPTGGETQHF,0,1,1,1
TRBV5-4,TRBJ1-4,CASSSGTPGEKLFF,0,1,1,1
TRBV7-9,TRBJ2-1,CASSSGQSYNEQFF,0,1,1,1
TRBV7-3,TRBJ2-3,CASSSTGDTDTQYF,0,1,1,1
TRBV7-6,TRBJ2-3,CASSSTSSTDTQYF,0,1,1,1
TRBV5-4,TRBJ2-2,CASSWLLNTGELFF,0,1,1,1
TRBV5-4,TRBJ2-1,CASSLAGLNNEQFF,0,1,1,1
TRBV11-2,TRBJ2-3,CASSLGLEGRTQYF,0,1,1,1
TRBV12-3/4,TRBJ2-1,CASSLPQGNNEQFF,0,1,1,1
TRBV11-3,TRBJ2-1,CASSLRQGVNEQFF,0,1,1,1
TRBV6-2/3/5/6,TRBJ2-2,CASSLNFNTGELFF,0,1,1,1
TRBV12-3/4,TRBJ2-5,CASSPLQGAETQYF,0,1,1,1
TRBV6-2/3/5/6,TRBJ1-5,CASSPRGSNQPQHF,0,1,1,1
TRBV9,TRBJ2-4,CASSPEGTKNIQYF,0,1,1,1
TRBV7-9,TRBJ2-7,CASSPTGATYEQYF,0,1,1,1
TRBV7-2,TRBJ2-5,CASSPQPTGDNQYF,0,1,1,1
TRBV3-1,TRBJ2-1,CASSPGLAYNEQFF,0,1,1,1
TRBV5-4,TRBJ2-7,CASSPGQGDYEQYF,0,1,1,1
TRBV7-3,TRBJ2-3,CASSPGDRGDTQYF,0,1,1,1
TRBV7-9,TRBJ1-4,CASSPGQGDEKLFF,0,1,1,1
TRBV11-2,TRBJ2-3,CASSPRGTTDTQYF,0,1,1,1
TRBV12-3/4,TRBJ1-1,CASSPGGGSTEAFF,0,1,1,1
TRBV5-5,TRBJ2-7,CASSPIPNGYEQYF,0,1,1,1
TRBV7-2,TRBJ2-4,CASSRGGAKNIQYF,0,1,1,1
TRBV28,TRBJ2-7,CASSRSGSTYEQYF,0,1,1,1
TRBV6-2/3/5/6,TRBJ1-4,CASSRTGNNEKLFF,0,1,1,1
TRBV6-2/3/5/6,TRBJ2-1,CASSRLAGVREQFF,0,1,1,1
TRBV7-9,TRBJ2-1,CASSRPTLYNEQFF,0,1,1,1
TRBV7-9,TRBJ2-7,CASSRRGTGGFQYF,0,1,1,1
TRBV3-1,TRBJ1-1,CASSQSTGGRGAFF,0,1,1,1
TRBV11-1,TRBJ2-5,CASSQRTGQENQYF,0,1,1,1
TRBV3-1,TRBJ2-3,CASSQGASSDTQYF,0,1,1,1
TRBV5-4,TRBJ2-1,CASSQGGGYNEQFF,0,1,1,1
TRBV3-1,TRBJ1-3,CASSQDGFRNTIYF,0,1,1,1
TRBV4-2,TRBJ2-7,CASSQEAGFGEQYF,0,1,1,1
TRBV7-8,TRBJ2-3,CASSVGQAGGTQYF,0,1,1,1
TRBV7-6,TRBJ2-7,CASSARDFSYEQYF,0,1,1,1
TRBV28,TRBJ2-4,CASSATLAKNIQYF,0,1,1,1
TRBV2,TRBJ2-2,CASSANRNTGELFF,0,1,1,1
TRBV27,TRBJ2-3,CASSGWTSTDTQYF,0,1,1,1
TRBV11-2,TRBJ2-1,CASSGRVSYNEQFF,0,1,1,1
TRBV5-4,TRBJ2-1,CASSGGSSYNEQFF,0,1,1,1
TRBV4-2,TRBJ2-7,CASSEASGRYEQYF,0,1,1,1
TRBV7-9,TRBJ1-2,CASSMGQGAGGYTF,0,1,1,1
TRBV2,TRBJ2-5,CASSTLAGQETQYF,0,1,1,1
TRBV7-2,TRBJ2-5,CASSTQGAGETQYF,0,1,1,1
TRBV2,TRBJ2-5,CASSTEGGQETQYF,0,1,1,1
TRBV7-2,TRBJ2-3,CASSTIAGEDTQYF,0,1,1,1
TRBV7-9,TRBJ2-3,CASSRGLGSDTQYF,0,1,1,1
TRBV7-9,TRBJ2-1,CASSKGQNYNEQFF,0,1,1,1
TRBV3-1,TRBJ2-5,CASSKPTGEETQYF,0,1,1,1
TRBV7-2,TRBJ2-5,CASSKMVGEETQYF,0,1,1,1
TRBV6-2/3/5/6,TRBJ2-7,CASRGLGPSYEQYF,0,1,1,1
TRBV28,TRBJ2-3,CASRIAGATDTQYF,0,1,1,1
TRBV12-3/4,TRBJ2-7,CASRIAGISYEQYF,0,1,1,1
TRBV6-2/3/5/6,TRBJ1-3,CASRTGTTGNTIYF,0,1,1,1
TRBV7-2,TRBJ2-2,CASRNRVDTGELFF,0,1,1,1
TRBV6-2/3/5/6,TRBJ2-7,CASRSDRFFHEQYF,0,1,1,1
TRBV7-3,TRBJ2-1,CASRPGGPGNEQFF,0,1,1,1
TRBV3-1,TRBJ2-1,CASRQGAWYNEQFF,0,1,1,1
TRBV6-2/3/5/6,TRBJ1-5,CASRVTGGGQPQHF,0,1,1,1
TRBV28,TRBJ2-5,CASNTGSSQETQYF,0,1,1,1
TRBV7-3,TRBJ2-1,CASKRGGGHNEQFF,0,1,1,1
TRBV10-2,TRBJ2-7,CASGPYRVGYEQYF,0,1,1,1
TRBV5-1,TRBJ2-3,CASGGGRAGDTQYF,0,1,1,1
TRBV4-1,TRBJ2-1,CASTGTAASNEQFF,0,1,1,1
TRBV10-1,TRBJ1-2,CASSAGTNTGGYTF,0,1,1,1
TRBV5-1,TRBJ1-1,CASSFGGGDTEAFF,0,1,1,1
TRBV5-1,TRBJ2-3,CASSLATGADTQYF,0,1,1,1
TRBV5-1,TRBJ2-7,CASSLGVSSYEQYF,0,1,1,1
TRBV5-1,TRBJ2-3,CASSLGLTADTQYF,0,1,1,1
TRBV5-1,TRBJ1-5,CASSLDQGNQPQHF,0,1,1,1
TRBV5-1,TRBJ2-3,CASSLTSGSDTQYF,0,1,1,1
TRBV5-1,TRBJ2-1,CASSLVGRENEQFF,0,1,1,1
TRBV5-1,TRBJ2-7,CASSLGGVWDEQYF,0,1,1,1
TRBV5-1,TRBJ2-3,CASSSTGYTDTQYF,0,1,1,1
TRBV5-1,TRBJ2-5,CASSSGSTKETQYF,0,1,1,1
TRBV5-1,TRBJ2-1,CASSWGVDRGEQFF,0,1,1,1
TRBV5-1,TRBJ2-2,CASSPREATGELFF,0,1,1,1
TRBV5-1,TRBJ2-7,CASSPGTGNYEQYF,0,1,1,1
TRBV5-1,TRBJ2-3,CASSPGQITDTQYF,0,1,1,1
TRBV5-1,TRBJ2-1,CASSRGRAEDEQFF,0,1,1,1
TRBV4-1,TRBJ2-1,CASSREYSYNEQFF,0,1,1,1
TRBV5-1,TRBJ2-7,CASSQQGTTYEQYF,0,1,1,1
TRBV4-1,TRBJ1-5,CASSQQGVGQPQHF,0,1,1,1
TRBV4-1,TRBJ2-5,CASSQETAHETQYF,0,1,1,1
TRBV5-1,TRBJ2-3,CASSAQESGVRQYF,0,1,1,1
TRBV5-1,TRBJ2-7,CASSAGQPESEQYF,0,1,1,1
TRBV4-1,TRBJ1-5,CASSGSGGDQPQHF,0,1,1,1
TRBV10-2,TRBJ2-7,CASSGAGVSYEQYF,0,1,1,1
TRBV5-1,TRBJ2-5,CASSIGQGQETQYF,0,1,1,1
TRBV5-1,TRBJ2-2,CASSIHNFGGELFF,0,1,1,1
TRBV5-1,TRBJ2-7,CASSTGGRSYEQYF,0,1,1,1
TRBV5-1,TRBJ2-3,CASSTGTVTDTQYF,0,1,1,1
TRBV5-1,TRBJ1-1,CASRGMAENTEAFF,0,1,1,1
TRBV5-1,TRBJ2-7,CASRSGPIELEQYF,0,1,1,1
TRBV5-1,TRBJ2-4,CTSSPTGGLNIQYF,0,1,1,1
TRBV20-1,TRBJ2-5,CSVRGGALQETQYF,0,1,1,1
TRBV20-1,TRBJ2-3,CSAPVSGSTDTQYF,0,1,1,1
TRBV20-1,TRBJ2-5,CSARGTGGMETQYF,0,1,1,1
TRBV20-1,TRBJ2-1,CSARAGVSYNEQFF,0,1,1,1
TRBV20-1,TRBJ2-3,CSAGRDRGTDTQYF,0,1,1,1
TRBV20-1,TRBJ2-3,CSASQVLGTDTQYF,0,1,1,1
TRBV20-1,TRBJ2-1,CSARPSGPQGEQFF,0,1,1,1
TRBV20-1,TRBJ2-1,CSARPVGGYNEQFF,0,1,1,1
TRBV20-1,TRBJ2-7,CSARRQGGSYEQYF,0,1,1,1
TRBV20-1,TRBJ2-7,CSARGSLLSGEQYF,0,1,1,1
TRBV20-1,TRBJ2-3,CSARPRDKTDTQYF,0,1,1,1
TRBV20-1,TRBJ2-1,CSAKKSTGYNEQFF,0,1,1,1
TRBV20-1,TRBJ2-3,CSASPGGRTDTQYF,0,1,1,1
TRBV20-1,TRBJ2-1,CSAPAGAPSNEQFF,0,1,1,1
TRBV20-1,TRBJ1-1,CSAQVPDGNTEAFF,0,1,1,1
TRBV20-1,TRBJ2-1,CSAAYSVVYNEQFF,0,1,1,1
TRBV29-1,TRBJ2-7,CSLKICALSYEQYF,0,1,1,1
TRBV29-1,TRBJ2-4,CSVREPGPKNIQYF,0,1,1,1
TRBV29-1,TRBJ2-1,CSVASARSYNEQFF,0,1,1,1
TRBV29-1,TRBJ1-5,CSVAPGGGGQPQHF,0,1,1,1
TRBV29-1,TRBJ2-3,CSVGIAGVGDTQYF,0,1,1,1
TRBV29-1,TRBJ2-5,CSVGGTSGEETQYF,0,1,1,1
TRBV29-1,TRBJ2-1,CSVEWDTRTNEQFF,0,1,1,1
TRBV29-1,TRBJ2-1,CSVEAGEKGNEQFF,0,1,1,1
TRBV29-1,TRBJ2-7,CSVEDKATSYEQYF,0,1,1,1
TRBV29-1,TRBJ2-3,CSVRRGRTSDTQYF,0,1,1,1
TRBV29-1,TRBJ2-5,CSVVNYKESETQYF,0,1,1,1
TRBV29-1,TRBJ2-3,CSVAGTGSPDTQYF,0,1,1,1
TRBV20-1,TRBJ2-3,CSRPREGSTDTQYF,0,1,1,1
TRBV19,TRBJ2-3,RASKRASGSNTQYF,0,1,1,1
TRBV20-1,TRBJ2-7,RSAPSGTINYEQYF,0,1,1,1
TRBV12-5,TRBJ1-5,CASGLSYGQPQHF,0,1,1,1
TRBV30,TRBJ1-1,CAWSGTGNTEAFF,0,1,1,1
TRBV30,TRBJ1-5,CAWGAGTDQPQHF,0,1,1,1
TRBV30,TRBJ1-2,CAWSSPNNYGYTF,0,1,1,1
TRBV30,TRBJ2-7,CAWSVRSAYEQYF,0,1,1,1
TRBV30,TRBJ1-2,CAWSRGPPSGYTF,0,1,1,1
TRBV30,TRBJ1-1,CAWNPGGDTEAFF,0,1,1,1
TRBV2,TRBJ2-1,CAYGGRSYNEQFF,0,1,1,1
TRBV2,TRBJ2-7,CAAAGGGLGEQYF,0,1,1,1
TRBV7-2,TRBJ1-6,CAIGDSGNSPLHF,0,1,1,1
TRBV18,TRBJ2-7,CATSTGTGSEQYF,0,1,1,1
TRBV24-1,TRBJ2-3,CATGTGPTDTQYF,0,1,1,1
TRBV15,TRBJ2-5,CATSLNVQETQYF,0,1,1,1
TRBV24-1,TRBJ2-1,CATSGRYYNEQFF,0,1,1,1
TRBV15,TRBJ2-5,CATSRDQGENQYF,0,1,1,1
TRBV27,TRBJ1-1,CATRVRVTGEAFF,0,1,1,1
TRBV19,TRBJ2-3,CASSVGERDTQYF,0,1,1,1
TRBV19,TRBJ2-1,CASSGQGVDEQFF,0,1,1,1
TRBV19,TRBJ2-7,CASSISFRGEQYF,0,1,1,1
TRBV19,TRBJ2-7,CASSIGTGTEQYF,0,1,1,1
TRBV19,TRBJ2-7,CASRRAGGYEQYF,0,1,1,1
TRBV25-1,TRBJ2-3,CASRGGGTDTQYF,0,1,1,1
TRBV19,TRBJ2-2,CASKNDGAGELFF,0,1,1,1
TRBV6-2/3/5/6,TRBJ2-7,CASSQGPAYEQYF,0,1,1,1
TRBV9,TRBJ2-7,CASSTSGTLEQYF,0,1,1,1
TRBV18,TRBJ2-1,CASSAPMRNEQFF,0,1,1,1
TRBV2,TRBJ2-2,CASWGLATGELFF,0,1,1,1
TRBV28,TRBJ2-7,CASWTRGSPEQYF,0,1,1,1
TRBV3-1,TRBJ2-7,CASRPRGTYEQYF,0,1,1,1
TRBV12-3/4,TRBJ2-1,CASRQGTYNEQFF,0,1,1,1
TRBV28,TRBJ2-2,CASRQGNTGELFF,0,1,1,1
TRBV11-1,TRBJ2-7,CASGRDRVYEQYF,0,1,1,1
TRBV12-3/4,TRBJ2-5,CASTPGGRETQYS,0,1,1,1
TRBV6-2/3/5/6,TRBJ2-2,CASTKRNTGELFF,0,1,1,1
TRBV6-2/3/5/6,TRBJ2-3,CASSFSGSLTQYF,0,1,1,1
TRBV6-2/3/5/6,TRBJ2-3,CASSFGSTDTQYF,0,1,1,1
TRBV6-2/3/5/6,TRBJ2-4,CASSFTSGLIQYF,0,1,1,1
TRBV6-2/3/5/6,TRBJ1-5,CASSFNSNQPQHF,0,1,1,1
TRBV27,TRBJ2-1,CASSFSSSGSRVF,0,1,1,1
TRBV27,TRBJ2-3,CASSFPGADTQYF,0,1,1,1
TRBV12-3/4,TRBJ1-2,CASSLPPGPASSF,0,1,1,1
TRBV28,TRBJ2-7,CASSLGSFYEQYF,0,1,1,1
TRBV12-3/4,TRBJ2-2,CASSLSIPGELFF,0,1,1,1
TRBV6-2/3/5/6,TRBJ1-1,CASSLRGTGEALF,0,1,1,1
TRBV6-2/3/5/6,TRBJ2-7,CASSLFGTSEQYF,0,1,1,1
TRBV12-3/4,TRBJ2-3,CASSLAGGDTQYF,0,1,1,1
TRBV12-3/4,TRBJ1-5,CASSLGGDQPQHF,0,1,1,1
TRBV12-3/4,TRBJ2-3,CASSLGGTDTQYF,0,1,1,1
TRBV12-3/4,TRBJ2-7,CASSYVGGYEQYF,0,1,1,1
TRBV6-2/3/5/6,TRBJ2-1,CASSYSRDGEQFF,0,1,1,1
TRBV12-3/4,TRBJ2-7,CASSPSRGGEQYF,0,1,1,1
TRBV6-1,TRBJ2-7,CASSASGRNEQYF,0,1,1,1
TRBV6-1,TRBJ1-5,CASSGTDNQPQHF,0,1,1,1
TRBV6-1,TRBJ1-5,CASSEGGPGPQHF,0,1,1,1
TRBV6-1,TRBJ2-1,CASSEERGSPQFF,0,1,1,1
TRBV6-2/3/5/6,TRBJ2-7,CASSTGSSYEQYF,0,1,1,1
TRBV12-3/4,TRBJ1-3,CASSTDRGVSIYF,0,1,1,1
TRBV5-4,TRBJ2-1,CASSFSSNNEQFF,0,1,1,1
TRBV7-2,TRBJ2-5,CASSFRLQEIQYF,0,1,1,1
TRBV7-3,TRBJ2-1,CASSFTDRDQQFF,0,1,1,1
TRBV5-4,TRBJ1-1,CASSFREGTEAFF,0,1,1,1
TRBV7-2,TRBJ2-4,CASSFQRQNIQYF,0,1,1,1
TRBV7-2,TRBJ2-4,CASSFGGGNIQYF,0,1,1,1
TRBV5-4,TRBJ1-2,CASSFGQGGGYTF,0,1,1,1
TRBV5-6,TRBJ1-5,CASSLSTLGSQHF,0,1,1,1
TRBV5-6,TRBJ2-5,CASSLDGVKTQYF,0,1,1,1
TRBV7-2,TRBJ1-3,CASSLKSGNTIYF,0,1,1,1
TRBV7-2,TRBJ2-1,CASSLSSLDEQFF,0,1,1,1
TRBV7-2,TRBJ2-7,CASSLVTPPRSYF,0,1,1,1
TRBV7-9,TRBJ1-5,CASSLALNQPQHF,0,1,1,1
TRBV11-2,TRBJ1-1,CASSLARNTEAFF,0,1,1,1
TRBV7-9,TRBJ2-1,CASSLADRAREFF,0,1,1,1
TRBV7-9,TRBJ1-1,CASSLGEGTEAFF,0,1,1,1
TRBV7-3,TRBJ2-4,CASSLGDSNIQYF,0,1,1,1
TRBV7-9,TRBJ1-2,CASSLDRAHGYTF,0,1,1,1
TRBV7-3,TRBJ2-1,CASSLIGNNEQFF,0,1,1,1
TRBV7-9,TRBJ2-7,CASSLRGFYEQYF,0,1,1,1
TRBV7-9,TRBJ2-3,CASSSRGPDTQYF,0,1,1,1
TRBV7-9,TRBJ2-5,CASSSAGRETQYF,0,1,1,1
TRBV5-4,TRBJ2-3,CASSSGTEDTQYF,0,1,1,1
TRBV7-9,TRBJ1-1,CASSSGQGTEAFF,0,1,1,1
TRBV7-2,TRBJ2-1,CASSSAPANEQFF,0,1,1,1
TRBV27,TRBJ2-4,CASSSTGGIIQYF,0,1,1,1
TRBV2,TRBJ2-5,CASSLGLQETQYF,0,1,1,1
TRBV3-1,TRBJ2-5,CASSLPGTETQYF,0,1,1,1
TRBV12-3/4,TRBJ2-5,CASSLGQGGTQYF,0,1,1,1
TRBV6-2/3/5/6,TRBJ2-1,CASSLSPIDEQFF,0,1,1,1
TRBV3-1,TRBJ2-4,CASSLAVGNIQYF,0,1,1,1
TRBV11-2,TRBJ2-3,CASSPHPGMTQYF,0,1,1,1
TRBV7-2,TRBJ2-1,CASSPGLAFGQFF,0,1,1,1
TRBV7-2,TRBJ2-7,CASSPQPTDEQYF,0,1,1,1
TRBV12-3/4,TRBJ2-3,CASSPGFGDTQYF,0,1,1,1
TRBV28,TRBJ2-7,CASSPGTPYEQYF,0,1,1,1
TRBV7-9,TRBJ2-7,CASSPGTGVEQYF,0,1,1,1
TRBV6-2/3/5/6,TRBJ2-5,CASSPGQLETQYF,0,1,1,1
TRBV12-3/4,TRBJ2-5,CASSPLRSGAQYF,0,1,1,1
TRBV3-1,TRBJ2-3,CASSPREQGTQYF,0,1,1,1
TRBV14,TRBJ2-3,CASSPTRGDTQYF,0,1,1,1
TRBV11-1,TRBJ2-1,CASSRWGGREQFF,0,1,1,1
TRBV28,TRBJ2-1,CASSRTSRNEQFF,0,1,1,1
TRBV11-2,TRBJ2-3,CASSRTETDTQYF,0,1,1,1
TRBV3-1,TRBJ1-1,CASSHQMNTEACF,0,1,1,1
TRBV3-1,TRBJ1-1,CASSQGVNTEAFF,0,1,1,1
TRBV3-1,TRBJ2-3,CASSQVSSDTQYF,0,1,1,1
TRBV3-1,TRBJ2-1,CASSQGQGPEQFF,0,1,1,1
TRBV11-3,TRBJ2-2,CASSQRDPGELFF,0,1,1,1
TRBV14,TRBJ2-1,CASSQNLAGGQFF,0,1,1,1
TRBV9,TRBJ1-1,CASSVEQGSEAFF,0,1,1,1
TRBV7-8,TRBJ2-4,CASSAGQGYIQYF,0,1,1,1
TRBV11-2,TRBJ1-1,CASSGTGVTEAFF,0,1,1,1
TRBV7-6,TRBJ1-5,CASSGQGNQPQHF,0,1,1,1
TRBV7-3,TRBJ2-3,CASSIREGDTQYF,0,1,1,1
TRBV14,TRBJ2-3,CASSTRPPDTQYF,0,1,1,1
TRBV28,TRBJ2-5,CASSRTSSQTQYF,0,1,1,1
TRBV6-2/3/5/6,TRBJ1-4,CASSNGTPGKLFF,0,1,1,1
TRBV27,TRBJ2-7,CASRAEWSGEQYF,0,1,1,1
TRBV6-2/3/5/6,TRBJ2-7,CASRLTASYEQYF,0,1,1,1
TRBV6-2/3/5/6,TRBJ2-5,CASRPGRGETQYF,0,1,1,1
TRBV28,TRBJ2-1,CASKEGNYNEQFF,0,1,1,1
TRBV5-1,TRBJ2-7,CASSLGSNYEQYF,0,1,1,1
TRBV5-1,TRBJ2-1,CASSPGGSNEQFF,0,1,1,1
TRBV10-2,TRBJ2-2,CASSESFTRELFF,0,1,1,1
TRBV10-2,TRBJ2-3,CASSEVVPDTQYF,0,1,1,1
TRBV5-1,TRBJ2-5,CASSFEGEETQYF,0,1,1,1
TRBV5-1,TRBJ2-7,CASSLQDQSEQYF,0,1,1,1
TRBV5-1,TRBJ2-7,CASSLADEYEQYF,0,1,1,1
TRBV5-1,TRBJ2-7,CASSLGESYEQYF,0,1,1,1
TRBV5-1,TRBJ2-7,CASSSTANYEQYF,0,1,1,1
TRBV5-1,TRBJ2-7,CASSLGRVGEQYF,0,1,1,1
TRBV5-1,TRBJ2-4,CASSPGDGNIQYF,0,1,1,1
TRBV5-1,TRBJ2-4,CASSRDRDGIQHF,0,1,1,1
TRBV5-1,TRBJ2-7,CASSRDGTYEQYF,0,1,1,1
TRBV5-1,TRBJ2-4,CASSTWTSDIQYF,0,1,1,1
TRBV5-1,TRBJ2-7,CASSTDGYGEQYF,0,1,1,1
TRBV3-1,TRBJ1-2,CASSKGQGHGYTF,0,1,1,1
TRBV5-1,TRBJ1-1,CASRSLIQGEAFF,0,1,1,1
TRBV20-1,TRBJ2-3,CSVLNGLTDTQYF,0,1,1,1
TRBV20-1,TRBJ2-5,CSAPWRDRKTQYF,0,1,1,1
TRBV20-1,TRBJ2-3,CSAAAGGTDTQYF,0,1,1,1
TRBV20-1,TRBJ2-1,CSAEIGQTTEQFF,0,1,1,1
TRBV20-1,TRBJ1-4,CSASWARGGKLFF,0,1,1,1
TRBV20-1,TRBJ2-1,CSASGRGSFEQFF,0,1,1,1
TRBV20-1,TRBJ2-7,CSASRDIPYEQYF,0,1,1,1
TRBV20-1,TRBJ2-5,CSASKVEQETQYF,0,1,1,1
TRBV20-1,TRBJ2-3,CSARSYRTDTQYF,0,1,1,1
TRBV20-1,TRBJ2-1,CSARRGLGDEQFF,0,1,1,1
TRBV20-1,TRBJ2-1,CSARYDSGPLQFF,0,1,1,1
TRBV20-1,TRBJ1-1,CSARRGSGTEAFF,0,1,1,1
TRBV20-1,TRBJ1-2,CSARDQDRYGYTF,0,1,1,1
TRBV20-1,TRBJ1-1,CSARDGRRTEAFF,0,1,1,1
TRBV20-1,TRBJ1-1,CSARDRRVWGAFF,0,1,1,1
TRBV20-1,TRBJ2-5,CSALRTVQETQYF,0,1,1,1
TRBV20-1,TRBJ2-5,CSAPGPGGETQYF,0,1,1,1
TRBV20-1,TRBJ2-5,CSAGTSRGETQYF,0,1,1,1
TRBV20-1,TRBJ2-3,CSGTSGATDTQYF,0,1,1,1
TRBV29-1,TRBJ1-4,CSVSGAGNEKLFF,0,1,1,1
TRBV29-1,TRBJ2-7,CSVQQRSSYEQYF,0,1,1,1
TRBV29-1,TRBJ2-1,CSVAILLDNEQFF,0,1,1,1
TRBV29-1,TRBJ2-3,CSVASGNTDTQYF,0,1,1,1
TRBV29-1,TRBJ2-1,CSVGGQPYNEQSF,0,1,1,1
TRBV29-1,TRBJ1-1,CSVESDKRTEAFF,0,1,1,1
TRBV29-1,TRBJ1-1,CSVEAGRNTEAFF,0,1,1,1
TRBV29-1,TRBJ2-7,CSVETQRPYEQYF,0,1,1,1
TRBV29-1,TRBJ2-1,CSVALMPGNEQFF,0,1,1,1
TRBV29-1,TRBJ2-5,CSVLAGVWETQYF,0,1,1,1
TRBV29-1,TRBJ2-5,CSVQRQDQETQYF,0,1,1,1
TRBV29-1,TRBJ2-7,CSVTRDNTYEQYF,0,1,1,1
TRBV5-4,TRBJ2-7,RASSSEGRYEQYF,0,1,1,1
TRBV12-3/4,TRBJ1-1,RASRPDLYTEAFF,0,1,1,1
TRBV30,TRBJ2-2,CAWGLLGGELFF,0,1,1,1
TRBV30,TRBJ1-1,CAWSLGNTEAFF,0,1,1,1
TRBV30,TRBJ2-1,CAWSRVAIEQFF,0,1,1,1
TRBV6-2/3/5/6,TRBJ2-3,CAARIVTDTQYF,0,1,1,1
TRBV10-3,TRBJ1-1,CAISDGTGRAFF,0,1,1,1
TRBV2,TRBJ2-5,CATARFIETQYF,0,1,1,1
TRBV2,TRBJ1-5,CASGDRDQPQHF,0,1,1,1
TRBV19,TRBJ2-3,CASSPGLDTQYF,0,1,1,1
TRBV19,TRBJ2-1,CASSITGSEQFF,0,1,1,1
TRBV19,TRBJ2-3,CASRLAGERQYF,0,1,1,1
TRBV18,TRBJ2-7,CASSGGQYEQYF,0,1,1,1
TRBV19,TRBJ1-1,CASGRDSRPAFF,0,1,1,1
TRBV28,TRBJ1-1,CASIRGGTEAFF,0,1,1,1
TRBV12-3/4,TRBJ2-3,CASTSQRDTQYF,0,1,1,1
TRBV2,TRBJ1-5,CASTRGNQPQHL,0,1,1,1
TRBV6-1,TRBJ2-3,CASTTGTDTQYF,0,1,1,1
TRBV28,TRBJ2-7,CASSFSVYEQYF,0,1,1,1
TRBV28,TRBJ2-3,CASSLYGDTQYS,0,1,1,1
TRBV6-2/3/5/6,TRBJ2-3,CASSLRIDTQYF,0,1,1,1
TRBV6-2/3/5/6,TRBJ1-4,CASSSGGRKLFF,0,1,1,1
TRBV6-2/3/5/6,TRBJ2-3,CASSYASEAQYF,0,1,1,1
TRBV6-2/3/5/6,TRBJ2-7,CASSYRDDEQYF,0,1,1,1
TRBV12-3/4,TRBJ2-1,CASSLVYNEQFF,0,1,1,1
TRBV6-1,TRBJ2-5,CASSAWEKTQYF,0,1,1,1
TRBV2,TRBJ2-1,CASSEDSGSSFF,0,1,1,1
TRBV3-1,TRBJ2-7,CASSISSYEQYF,0,1,1,1
TRBV5-6,TRBJ2-1,CASSLLGNEQFF,0,1,1,1
TRBV5-8,TRBJ1-4,CASSLAGDRLFF,0,1,1,1
TRBV7-9,TRBJ2-5,CASSLVVETQYF,0,1,1,1
TRBV7-9,TRBJ2-1,CASSLVAFGGFF,0,1,1,1
TRBV11-2,TRBJ2-7,CASSLAAGNPYF,0,1,1,1
TRBV7-9,TRBJ2-4,CASSLGDRGLYF,0,1,1,1
TRBV7-8,TRBJ2-3,CASSLMVDTQYF,0,1,1,1
TRBV7-2,TRBJ2-7,CASSLTLDEQYF,0,1,1,1
TRBV7-2,TRBJ2-3,CASSSPRDTQYF,0,1,1,1
TRBV5-4,TRBJ2-2,CASSLNTGELFF,0,1,1,1
TRBV3-1,TRBJ2-5,CASSPLTETQYF,0,1,1,1
TRBV12-3/4,TRBJ2-1,CASSPSRNEQFF,0,1,1,1
TRBV7-2,TRBJ2-7,CASSPQGYEQYF,0,1,1,1
TRBV7-9,TRBJ2-5,CASSREGETQYF,0,2,1,2
TRBV2,TRBJ2-7,CASSQGSYEQYF,0,1,1,1
TRBV3-1,TRBJ1-1,CASSQYTNEAFF,0,1,1,1
TRBV5-4,TRBJ2-7,CASSGDSYEQYF,0,1,1,1
TRBV7-2,TRBJ2-1,CASSKRPNEQFF,0,1,1,1
TRBV6-2/3/5/6,TRBJ2-7,CASRLQGGEQYF,0,1,1,1
TRBV2,TRBJ2-3,CASRGLDSTQYF,0,1,1,1
TRBV6-2/3/5/6,TRBJ2-5,CASNKREETQYF,0,1,1,1
TRBV2,TRBJ2-5,CASKGQGETQYF,0,1,1,1
TRBV5-1,TRBJ2-1,CASKLEGDEQFF,0,1,1,1
TRBV10-2,TRBJ2-2,CASSGVAGELFF,0,1,1,1
TRBV5-1,TRBJ2-1,CASSMGLNEQFF,0,1,1,1
TRBV5-1,TRBJ2-1,CASSFGGDEQFF,0,1,1,1
TRBV5-1,TRBJ1-1,CASSLGGDRTFF,0,1,1,1
TRBV5-1,TRBJ2-1,CASSLDVLEQFF,0,1,1,1
TRBV5-1,TRBJ2-7,CASSLTAYEQYF,0,1,1,1
TRBV4-1,TRBJ1-2,CASSQAGYGYTS,0,1,1,1
TRBV4-1,TRBJ2-1,CASSQGGQEQFF,0,1,1,1
TRBV5-1,TRBJ2-1,CASSTAGIEQFF,0,1,1,1
TRBV20-1,TRBJ2-4,CSATVPPGIQYF,0,1,1,1
TRBV20-1,TRBJ2-7,CSARDHSYEQYF,0,1,1,1
TRBV20-1,TRBJ2-1,CSAREGTYEQFF,0,1,1,1
TRBV20-1,TRBJ2-1,CSTRQGYNEQFF,0,1,1,1
TRBV29-1,TRBJ2-2,CSVGGEAGELFF,0,1,1,1
TRBV29-1,TRBJ2-5,CSVEVEGETQYF,0,1,1,1
TRBV29-1,TRBJ2-5,CSVEASGRTQYF,0,1,1,1
TRBV29-1,TRBJ2-5,CSVEGASKTQYF,0,1,1,1
TRBV29-1,TRBJ2-5,CSVEGRPETQYF,0,1,1,1
TRBV29-1,TRBJ2-7,CSVASRGNEQYF,0,1,1,1
TRBV20-1,TRBJ2-7,CSVGDREGEQYF,0,1,1,1
TRBV5-6,TRBJ2-7,CPPGSRNEQYF,0,1,1,1
TRBV30,TRBJ2-1,CAWSVPNEQFF,0,1,1,1
TRBV24-1,TRBJ2-1,CATRQNNEQFF,0,1,1,1
TRBV3-1,TRBJ2-7,CASGVSYEQYF,0,1,1,1
TRBV19,TRBJ1-1,CASGTNTEAFF,0,1,1,1
TRBV28,TRBJ2-7,CASAGPYEQYF,0,1,1,1
TRBV28,TRBJ2-7,CASGRPYEQYF,0,1,1,1
TRBV12-3/4,TRBJ2-1,CASSFLEEKFF,0,1,1,1
TRBV12-3/4,TRBJ2-1,CASSLGREQFF,0,1,1,1
TRBV6-4,TRBJ2-5,CASSSVGAQYF,0,1,1,1
TRBV7-9,TRBJ1-2,CASSLEDGYTF,0,1,1,1
TRBV7-2,TRBJ2-1,CASSLVNEQFF,0,1,1,1
TRBV7-9,TRBJ2-1,CASSLNHEQFF,0,1,1,1
TRBV7-6,TRBJ1-4,CASSSREKLFF,0,1,1,1
TRBV5-6,TRBJ2-3,CASSLLDTQYF,0,1,1,1
TRBV7-9,TRBJ2-5,CASSPTETQYF,0,1,1,1
TRBV14,TRBJ2-1,CASSQYNEQFF,0,1,1,1
TRBV28,TRBJ2-2,CASRETGELFF,0,1,1,1
TRBV2,TRBJ2-7,CASNTPYEQYF,0,1,1,1
TRBV5-1,TRBJ2-2,CASSASGELFF,0,1,1,1
TRBV20-1,TRBJ2-3,CSVAGTDTQYF,0,1,1,1
TRBV20-1,TRBJ1-4,CSAPGEEKLFF,0,1,1,1
TRBV20-1,TRBJ1-1,CSASRAAEAFF,0,1,1,1
TRBV20-1,TRBJ2-7,CSASPSHEQYF,0,1,1,1
TRBV29-1,TRBJ1-2,CSVHLNYGYTF,0,1,1,1
TRBV29-1,TRBJ2-7,CSVESGDEQYF,0,1,1,1
TRBV29-1,TRBJ2-7,CSAAGGYEQYF,0,1,1,1
TRBV11-2,TRBJ1-1,SASRLVSEAFF,0,1,1,1
TRBV19,TRBJ2-3,CASESDTQYF,0,1,1,1
TRBV7-9,TRBJ2-1,CASSSRTQFF,0,1,1,1
TRBV2,TRBJ2-3,CARGVDTQYF,0,1,1,1
TRBV20-1,TRBJ2-5,CSAGSETQYF,0,1,1,1
TRBV29-1,TRBJ1-1,CSVKNTEAFF,0,1,1,1
