v_hit,j_hit,cdr3,S4-10ng_S9,S4-10ng_S21,freq,count_sum
TRBV19,TRBJ2-1,CASSVTSGDYNEQFF,1145,905,2,2050
TRBV18,TRBJ2-3,CASSPQGRAYTDTQYF,820,821,2,1641
TRBV28,TRBJ2-7,CASKGRVEEQYF,598,623,2,1221
TRBV5-1,TRBJ2-7,CASSLVWGPQYF,305,410,2,715
TRBV20-1,TRBJ2-4,CSARMPPGFSALAKNIQYF,240,356,2,596
TRBV2,TRBJ2-5,CASSDLASGNLRETQYF,214,365,2,579
TRBV19,TRBJ2-1,CASSRVPTNEQFF,140,144,2,284
TRBV19,TRBJ2-1,CASRKAGLYNEQFF,106,141,2,247
TRBV6-2/3/5/6,TRBJ2-3,CASISGSTDTQYF,104,89,2,193
TRBV19,TRBJ1-5,CASRIHPTGVDQPQHF,97,92,2,189
TRBV14,TRBJ2-7,CASSPANYEQYF,87,78,2,165
TRBV2,TRBJ1-4,CASSPMTALNEKLFF,85,89,2,174
TRBV19,TRBJ2-2,CASKPPSLTGELFF,65,114,2,179
TRBV19,TRBJ1-1,CASRTGSGTEAFF,62,70,2,132
TRBV3-1,TRBJ2-1,CASSPGRQQIDEQFF,58,21,2,79
TRBV19,TRBJ2-1,CASSMTSGSFDEQFF,55,90,2,145
TRBV19,TRBJ2-1,CASSVGRGEQFF,51,23,2,74
TRBV20-1,TRBJ2-7,CSARGLAAYYLEQYF,49,39,2,88
TRBV19,TRBJ2-3,CASEGDTQYF,46,28,2,74
TRBV28,TRBJ1-5,CASILSQARDQPQHF,45,32,2,77
TRBV29-1,TRBJ2-7,CSVEKGHDRGREEQYF,42,0,1,42
TRBV5-6,TRBJ2-1,CASSLIVNEQFF,38,0,1,38
TRBV19,TRBJ1-5,CASWRQGNQPQHF,37,13,2,50
TRBV14,TRBJ2-1,CASSQSPGGEQFF,36,33,2,69
TRBV27,TRBJ1-1,CASRIVGRGREAFF,34,72,2,106
TRBV12-5,TRBJ2-2,CASALRAGPNTGELFF,34,29,2,63
TRBV19,TRBJ2-1,CASSIGGHNEQFF,33,58,2,91
TRBV14,TRBJ1-2,CASSQGLNYGYTF,33,39,2,72
TRBV2,TRBJ2-7,CASSEGTSGIYEQYF,32,0,1,32
TRBV5-1,TRBJ2-2,CASSQRPPTGMGAGELFF,32,62,2,94
TRBV11-3,TRBJ2-1,CASSAYGSYNEQFF,31,2,2,33
TRBV5-1,TRBJ2-7,CASGQGLFSYEQYF,31,31,2,62
TRBV29-1,TRBJ1-2,CSVEEPGAGRGYTF,31,10,2,41
TRBV5-1,TRBJ2-1,CASSSQGSGYNEQFF,30,27,2,57
TRBV19,TRBJ2-7,CASSMASGAYEQYF,30,40,2,70
TRBV20-1,TRBJ2-3,CSATRTGPDTDTQYF,29,0,1,29
TRBV29-1,TRBJ2-1,CSGGRSGEQFF,29,16,2,45
TRBV20-1,TRBJ2-3,CSARDSLTTDTQYF,29,0,1,29
TRBV29-1,TRBJ1-4,CSVGSGGTNEKLFF,28,29,2,57
TRBV2,TRBJ2-4,CASSEREGVAKNIQYF,28,15,2,43
TRBV19,TRBJ2-7,CASSLTSGSSEQYF,28,31,2,59
TRBV14,TRBJ2-6,CASSQRESGANVLTF,27,3,2,30
TRBV29-1,TRBJ2-4,CSVEDQTLPNGDIQYF,27,11,2,38
TRBV29-1,TRBJ2-1,CSALTGNEQFF,25,20,2,45
TRBV29-1,TRBJ2-7,CSASGGIDYEQYF,25,0,1,25
TRBV12-3/4,TRBJ2-7,CASSLGRELVGQYF,24,0,1,24
TRBV7-9,TRBJ2-7,CASSSYRVPSSYEQYF,23,14,2,37
TRBV3-1,TRBJ2-1,CASSQEAGDNEQFF,23,0,1,23
TRBV19,TRBJ2-3,CASEADTQYF,23,16,2,39
TRBV12-5,TRBJ1-2,CASGLVPSTLANYGYTF,23,0,1,23
TRBV19,TRBJ1-5,CASRPRGASAQHF,23,0,1,23
TRBV19,TRBJ1-5,CASSLGVGQPQHF,23,14,2,37
TRBV5-1,TRBJ1-1,CASSLRRPARTEAFF,23,37,2,60
TRBV19,TRBJ2-1,CASSIVPSGPSAEQFF,22,26,2,48
TRBV7-9,TRBJ2-1,CASSYAFRTGQSSDEQFF,22,19,2,41
TRBV6-4,TRBJ1-4,CASSDSGTPTNEKLFF,22,0,1,22
TRBV19,TRBJ2-1,CASSNPGLAGGPSEQFF,22,0,1,22
TRBV19,TRBJ2-1,CASSPGTSGREDEQFF,22,0,1,22
TRBV2,TRBJ2-4,CASTPPGSGSDIQYF,22,18,2,40
TRBV5-6,TRBJ2-1,CASSSRDGTLRNEQFF,21,0,1,21
TRBV24-1,TRBJ2-1,CATTGVPYYYNEQFF,21,52,2,73
TRBV5-6,TRBJ2-7,CASSLESRPSDEQYF,21,0,1,21
TRBV29-1,TRBJ2-3,CSVERLAGDTDMQYF,21,0,1,21
TRBV28,TRBJ2-7,CASSFVSGTDEQYF,21,0,1,21
TRBV19,TRBJ1-1,CASSIGMGTGGVNTEAFF,20,0,1,20
TRBV5-1,TRBJ2-1,CASSSRSGGYNEQFF,20,0,1,20
TRBV20-1,TRBJ1-5,CSASGSPNQPQHF,20,50,2,70
TRBV29-1,TRBJ1-3,CSFRPDSGNTIYF,20,0,1,20
TRBV27,TRBJ1-2,CASSLGDYTF,20,28,2,48
TRBV10-2,TRBJ2-5,CASSSGLPLETQYF,20,0,1,20
TRBV3-1,TRBJ2-1,CASSLGLAGLEFF,20,0,1,20
TRBV7-9,TRBJ2-5,CASSPRAEETQYF,20,23,2,43
TRBV5-6,TRBJ1-3,CASSLIGVVGTLSGNTIYF,20,0,1,20
TRBV29-1,TRBJ2-7,CSARTTTIEQYF,20,19,2,39
TRBV29-1,TRBJ2-3,CSADQETSTDTQYF,19,15,2,34
TRBV2,TRBJ2-5,CASSERVAGGRETQYF,19,0,1,19
TRBV7-2,TRBJ2-3,CASSWTSLSTDTQYF,19,0,1,19
TRBV14,TRBJ1-1,CASSSQGALLPEAFF,19,20,2,39
TRBV20-1,TRBJ1-1,CSARGPRENTEAFF,19,0,1,19
TRBV20-1,TRBJ2-3,CSAGPLTSTDTQYF,19,36,2,55
TRBV20-1,TRBJ2-3,CSASSGADTQYF,19,0,1,19
TRBV20-1,TRBJ2-2,CSARAVTGELFF,19,0,1,19
TRBV29-1,TRBJ2-1,CSAREVDEQFF,19,3,2,22
TRBV9,TRBJ2-7,CASSVGSGTAYEQYF,19,18,2,37
TRBV20-1,TRBJ2-7,CSARAALAGPGGM,19,28,2,47
TRBV20-1,TRBJ2-7,CSGAPPEEYEQYF,19,0,1,19
TRBV2,TRBJ1-2,CASRESVVRQGTYTF,18,0,1,18
TRBV5-6,TRBJ2-3,CASSPGASTDTQYF,18,12,2,30
TRBV5-4,TRBJ2-7,CASSSGGREQYF,18,0,1,18
TRBV6-2/3/5/6,TRBJ2-1,CASSYGGNEQFF,18,0,1,18
TRBV2,TRBJ2-2,CAIRGTANTGELFF,18,0,1,18
TRBV19,TRBJ2-2,CAGGTGTGELFF,18,9,2,27
TRBV7-9,TRBJ2-2,CASSLANRRGGPGTGELFF,18,25,2,43
TRBV7-9,TRBJ1-6,CASAGGFYNSPLHF,18,0,1,18
TRBV29-1,TRBJ2-1,CSVEVTSRKPVLYNEQFF,17,0,1,17
TRBV5-4,TRBJ1-2,CASSLAVGGAYGYTF,17,6,2,23
TRBV11-2,TRBJ2-3,CASSLAHTTTDTQYF,17,0,1,17
TRBV19,TRBJ2-1,CASSSGRTYNEQFF,17,0,1,17
TRBV6-4,TRBJ2-1,CASSDGTDGHEQFF,17,0,1,17
TRBV19,TRBJ2-4,CASSIGDGLRRYF,17,0,1,17
TRBV18,TRBJ2-1,CASSPLREGEQFF,17,2,2,19
TRBV6-2/3/5/6,TRBJ1-1,CASSSSYWNTEAFF,17,0,1,17
TRBV16,TRBJ1-2,CASSPRLRGTYNGYTF,17,7,2,24
TRBV11-2,TRBJ1-2,CASSFSTVYGYTF,17,0,1,17
TRBV5-4,TRBJ2-7,CATSLDGTAYEQYF,17,0,1,17
TRBV12-3/4,TRBJ1-5,CASSFRNQPQHF,17,0,1,17
TRBV5-1,TRBJ2-1,CASSIARPGSTNNEQFF,16,0,1,16
TRBV11-2,TRBJ2-3,CASSLEQGPSTDTQYF,16,0,1,16
TRBV12-3/4,TRBJ1-1,CASSSEAQGGTEAFF,16,0,1,16
TRBV5-5,TRBJ1-3,CASSLGGPSGNTIYF,16,0,1,16
TRBV5-1,TRBJ2-1,CASSLASGPYNEQFF,16,56,2,72
TRBV5-6,TRBJ2-5,CASSLASVGETQYF,16,0,1,16
TRBV12-3/4,TRBJ2-1,CASSVGQYNEQFF,16,33,2,49
TRBV7-9,TRBJ1-1,CASSLPGQREAFF,16,0,1,16
TRBV5-1,TRBJ2-2,CATRSGAGELFF,16,0,1,16
TRBV2,TRBJ1-6,CASLGQRRFHF,16,0,1,16
TRBV12-3/4,TRBJ2-7,CASSLEGLVHF,16,0,1,16
TRBV19,TRBJ2-4,CASEGDIQYF,16,0,1,16
TRBV7-9,TRBJ2-1,CASSLVGGRVDNEQFF,16,0,1,16
TRBV5-1,TRBJ2-3,CASSPDSTDTQYF,16,0,1,16
TRBV12-3/4,TRBJ2-3,CASSQRQVGAVTDTQYF,16,0,1,16
TRBV29-1,TRBJ2-3,CSVFNPGSRLTDTQYF,16,3,2,19
TRBV14,TRBJ2-1,CASSPGSHNEQFF,18,0,1,18
TRBV29-1,TRBJ1-1,CSVDDTGYNTEAFF,16,0,1,16
TRBV20-1,TRBJ2-7,CSARGTSGGKNEQYF,15,0,1,15
TRBV5-4,TRBJ2-2,CASSLPRGGRITGELFF,15,8,2,23
TRBV5-1,TRBJ2-3,CASSLSGQITTNTQYF,15,0,1,15
TRBV29-1,TRBJ2-1,CSVEKVGVSSYNEQFF,15,0,1,15
TRBV27,TRBJ2-7,CASRGPQGLGYEQYF,15,0,1,15
TRBV5-1,TRBJ1-1,CASSLPKEPNTEAFF,15,11,2,26
TRBV7-2,TRBJ1-5,CASTIGVNNQPQHF,15,0,1,15
TRBV5-8,TRBJ1-2,CASSLGQADYGYTF,15,0,1,15
TRBV29-1,TRBJ1-1,CSAKSTGSSRGAFF,15,7,2,22
TRBV29-1,TRBJ1-2,CSVYSQGYNGYTF,15,0,1,15
TRBV2,TRBJ1-1,CATRQELTEAFF,15,0,1,15
TRBV5-5,TRBJ2-7,CASSFSSGEQYF,15,0,1,15
TRBV2,TRBJ2-1,CARKREEEQFF,15,0,1,15
TRBV28,TRBJ2-5,CASTKAGTHLETQYF,15,0,1,15
TRBV20-1,TRBJ2-7,CSAFRRDSSLRVQYF,15,0,1,15
TRBV5-6,TRBJ2-7,CASSLGPSQAVTYEQYF,15,0,1,15
TRBV25-1,TRBJ2-5,CASSEGQGARETQYF,15,0,1,15
TRBV11-3,TRBJ2-3,CASSTSGSMTDTQYF,14,0,1,14
TRBV6-2/3/5/6,TRBJ2-2,CASSYRTGPTGELFF,14,0,1,14
TRBV6-2/3/5/6,TRBJ2-7,CASSFHRTSQREATYEQYF,14,0,1,14
TRBV12-3/4,TRBJ2-3,CASSVNWDPWFTDTQYF,14,0,1,14
TRBV9,TRBJ2-1,CASSVAGASSYNEQFF,14,0,1,14
TRBV20-1,TRBJ2-7,CSARDRGPSGSYEQYF,14,0,1,14
TRBV2,TRBJ1-6,CASSETGGYNSPLHF,14,0,1,14
TRBV6-2/3/5/6,TRBJ1-4,CASRLGQGFDEKLFF,14,0,1,14
TRBV5-1,TRBJ2-5,CASSLEAGRGETQYF,14,0,1,14
TRBV5-1,TRBJ2-1,CASSLTSDSYNEQFF,14,0,1,14
TRBV11-2,TRBJ2-1,CAPTGNTSYNEQFF,14,12,2,26
TRBV7-2,TRBJ2-3,CASSFTTSTDTQYF,14,0,1,14
TRBV7-9,TRBJ2-7,CASSSYPPGLSHFF,14,0,1,14
TRBV11-1,TRBJ2-3,CASSSPRGGDTQYF,14,0,1,14
TRBV11-1,TRBJ2-7,CASSANRGLYEQYF,14,0,1,14
TRBV5-1,TRBJ2-1,CASSFLASGYEQFF,14,0,1,14
TRBV10-3,TRBJ2-7,CATLETGSYEQYF,14,0,1,14
TRBV6-2/3/5/6,TRBJ2-7,CASSPGQGSQYYF,14,19,2,33
TRBV20-1,TRBJ2-3,CSALAGLTDTQYF,14,0,1,14
TRBV29-1,TRBJ2-5,CSVEGQGVETQYF,14,0,1,14
TRBV3-1,TRBJ2-3,CASSQEEDTQYF,14,0,1,14
TRBV28,TRBJ2-1,CASREARSEQFF,14,2,2,16
TRBV20-1,TRBJ2-3,CSARAPSGDISTDTQYF,14,0,1,14
TRBV11-1,TRBJ2-1,CASSDRQGGSYNEQFF,14,0,1,14
TRBV7-2,TRBJ2-3,CASSPMGFSTDTQYF,14,0,1,14
TRBV19,TRBJ2-1,CASSPSDWPNEQVF,14,0,1,14
TRBV10-3,TRBJ2-3,CAIKVTDTQYF,14,9,2,23
TRBV5-1,TRBJ2-1,CASSLGTGGNEQFF,13,5,2,18
TRBV29-1,TRBJ2-3,CSVDRPPGTDTQYF,13,0,1,13
TRBV7-2,TRBJ2-1,CASSLRTGDEQFF,13,0,1,13
TRBV5-1,TRBJ1-2,CASSFNYRQGYTF,13,0,1,13
TRBV25-1,TRBJ2-7,CASSEFLYEQYF,13,0,1,13
TRBV6-2/3/5/6,TRBJ2-5,CASSYPIETGGRRETQYF,13,0,1,13
TRBV29-1,TRBJ2-7,CSVVSRSGENRAPYEQYF,13,0,1,13
TRBV19,TRBJ2-4,CASSSTPGSGAKNIQYF,13,0,1,13
TRBV20-1,TRBJ2-3,CSASYPFTGRPSDTQYF,13,0,1,13
TRBV5-1,TRBJ2-1,CASSLTTGGSYNEQFF,13,0,1,13
TRBV20-1,TRBJ2-3,CSATIEGGRGTDTQYF,13,0,1,13
TRBV12-3/4,TRBJ1-2,CASSLGTGLSYGYTF,13,0,1,13
TRBV6-2/3/5/6,TRBJ1-4,CASSYGGATNEKLFF,13,0,1,13
TRBV6-4,TRBJ2-2,CASSEHGAHLGELFF,13,0,1,13
TRBV5-6,TRBJ1-5,CASSLGWDSNQPQHF,13,0,1,13
TRBV5-1,TRBJ1-5,CASSLGTSSNQPQHF,13,0,1,13
TRBV5-1,TRBJ1-5,CASSPEGGSNQPQHF,13,0,1,13
TRBV29-1,TRBJ2-1,CSVEMTSGGYNEQFF,13,7,2,20
TRBV10-3,TRBJ2-5,CAISESGQGVTQYF,13,0,1,13
TRBV19,TRBJ2-3,CASTEREVTDTQYF,13,11,2,24
TRBV19,TRBJ1-5,CASSSRQGNQPQHF,13,0,1,13
TRBV12-3/4,TRBJ1-1,CASSLQYMNTEAFF,13,4,2,17
TRBV19,TRBJ1-1,CAAQAGTGVSEAFF,13,0,1,13
TRBV5-1,TRBJ2-1,CASCPFGGINEQFF,13,0,1,13
TRBV5-1,TRBJ2-7,CASSLGPETYEQYF,13,0,1,13
TRBV20-1,TRBJ2-7,CSASLAGGPDEQYF,13,0,1,13
TRBV29-1,TRBJ1-1,CSVDRGSMNTEAFF,13,0,1,13
TRBV19,TRBJ2-7,CASSAGQLYEQYF,13,4,2,17
TRBV19,TRBJ2-3,CASSVSGADTQYF,13,0,1,13
TRBV9,TRBJ2-7,CASSRDRGYEQYF,13,0,1,13
TRBV3-1,TRBJ2-1,CASSLLGGDEQFF,13,0,1,13
TRBV7-6,TRBJ2-3,CASSEGGVYTQYF,13,0,1,13
TRBV29-1,TRBJ2-7,CSVERQGVGEQYF,13,3,2,16
TRBV29-1,TRBJ2-1,CSVGSGVTREQFF,13,0,1,13
TRBV29-1,TRBJ2-1,CSALASENNEQFF,13,0,1,13
TRBV3-1,TRBJ1-1,CASSQPDSEAFF,13,0,1,13
TRBV4-2,TRBJ1-1,CASSLQHTEAFF,13,0,1,13
TRBV7-8,TRBJ2-5,CASSPQETQYF,13,0,1,13
TRBV6-2/3/5/6,TRBJ2-3,CASRTTGPQYF,13,10,2,23
TRBV20-1,TRBJ2-7,CSATRGTNSYEQYF,13,0,1,13
TRBV6-2/3/5/6,TRBJ2-5,CASSFRGLETQYF,13,0,1,13
TRBV7-2,TRBJ2-7,CASSLGTGGYEQYF,13,0,1,13
TRBV12-3/4,TRBJ2-1,CASSPTTEHNEQFF,13,2,2,15
TRBV11-2,TRBJ2-7,CASSPAREQYF,13,0,1,13
TRBV7-2,TRBJ2-3,CASSSGLVRDTQYF,13,15,2,28
TRBV12-3/4,TRBJ2-1,CASSKGGTSGTFYNEQFF,12,0,1,12
TRBV2,TRBJ2-1,CASSLSVTSGNYNERFF,12,0,1,12
TRBV20-1,TRBJ2-3,CSAASGDTDTQYF,12,0,1,12
TRBV19,TRBJ2-1,CASHYSKTGVPYNEQFF,12,0,1,12
TRBV5-4,TRBJ2-6,CASSPRGSPSGANVLTF,12,0,1,12
TRBV7-2,TRBJ2-5,CASSSGLAGQETQYF,12,0,1,12
TRBV20-1,TRBJ1-1,CSARVFKGDNTEAFF,12,0,1,12
TRBV20-1,TRBJ2-7,CSAGALGGSYEQYF,12,0,1,12
TRBV5-6,TRBJ2-7,CASSFPSSYEQYF,12,0,1,12
TRBV18,TRBJ1-1,CASSPPNTGTENTEAFF,12,0,1,12
TRBV27,TRBJ2-7,CASSLKVWGRTGYEQYF,12,15,2,27
TRBV7-2,TRBJ2-1,CASSSQLGGSDYNEQFF,12,0,1,12
TRBV3-1,TRBJ1-4,CASSQDRQPATNEKLFF,12,0,1,12
TRBV5-6,TRBJ1-2,CASSLPPGTDRYGYTF,12,0,1,12
TRBV7-9,TRBJ2-1,CASSLRTGAGYNEQFF,12,0,1,12
TRBV7-2,TRBJ2-7,CASSSGGTSRSYEQYF,12,0,1,12
TRBV12-3/4,TRBJ2-1,CASSLRQGTFYNEQFF,12,0,1,12
TRBV3-1,TRBJ2-1,CASSPGGSRSYNEQFF,12,0,1,12
TRBV19,TRBJ2-6,CASSLWSPEANVLTF,12,0,1,12
TRBV18,TRBJ2-3,CASSLLAESTDTQYF,12,0,1,12
TRBV14,TRBJ2-7,CASCQERGVSYEQYF,12,0,1,12
TRBV7-9,TRBJ2-1,CASSQGLAIYNEQFF,12,0,1,12
TRBV6-4,TRBJ1-6,CASSTEGQGLSPLHF,12,0,1,12
TRBV20-1,TRBJ2-1,CSARLLADTYNEQFF,12,0,1,12
TRBV29-1,TRBJ2-1,CSVEDTASSTNEQFF,12,8,2,20
TRBV18,TRBJ2-5,CASSPPGLQETQYF,12,0,1,12
TRBV6-2/3/5/6,TRBJ1-5,CASSLRESNQPQHF,12,0,1,12
TRBV13,TRBJ2-7,CASSPGQGATEQYF,12,0,1,12
TRBV2,TRBJ2-7,CASSEFQGGYEQYF,12,0,1,12
TRBV5-5,TRBJ2-1,CASSLGQGAGEQFF,12,0,1,12
TRBV3-1,TRBJ2-7,CASSRSDYQYEQYF,12,0,1,12
TRBV10-3,TRBJ2-7,CAINLGVAYEQYF,12,0,1,12
TRBV2,TRBJ1-1,CASILDWNTEAFF,12,0,1,12
TRBV12-3/4,TRBJ1-2,CASSPDRVRGYTF,12,0,1,12
TRBV2,TRBJ1-2,CASSDARVGGYTF,12,0,1,12
TRBV28,TRBJ2-3,CASNTGSTDTQYF,12,0,1,12
TRBV29-1,TRBJ1-2,CSVLLGQSNGYAF,12,0,1,12
TRBV29-1,TRBJ2-1,CSVGEGRHQGRFF,12,0,1,12
TRBV19,TRBJ1-1,CASSISSAEAFF,12,13,2,25
TRBV18,TRBJ2-1,CASSQEGNEQFF,12,0,1,12
TRBV6-2/3/5/6,TRBJ2-7,CASSSARYEQYF,12,0,1,12
TRBV28,TRBJ2-2,CASSSGTAELFF,12,0,1,12
TRBV5-6,TRBJ2-1,CASSFLASGQFF,12,5,2,17
TRBV29-1,TRBJ2-5,CSVADNQETQYF,12,0,1,12
TRBV10-3,TRBJ2-1,CAISSSAEQFF,12,0,1,12
TRBV3-1,TRBJ2-1,CASGSHGEQFF,12,0,1,12
TRBV5-1,TRBJ1-3,CASSLKRNQVEDAGNTIYF,12,0,1,12
TRBV20-1,TRBJ2-4,CSARDKLAGLAKNIQYF,12,0,1,12
TRBV19,TRBJ1-5,CASLESHTYSNQPQHF,12,0,1,12
TRBV5-1,TRBJ2-7,CASSLDSLSYEQYF,12,0,1,12
TRBV20-1,TRBJ2-1,CSARTIYRDRDFNEQFF,12,0,1,12
TRBV7-9,TRBJ2-2,CASSLAGYTGELFF,12,0,1,12
TRBV18,TRBJ2-1,CASSPESNEQFF,12,0,1,12
TRBV7-9,TRBJ2-7,CAIPGDYEQYF,12,3,2,15
TRBV18,TRBJ2-7,CASSLREAGTSGRVEQYF,11,6,2,17
TRBV7-2,TRBJ2-1,CASSLTTGVNEQFF,11,4,2,15
TRBV19,TRBJ2-1,CVSSITPRWTSGNNEQFF,11,0,1,11
TRBV28,TRBJ1-5,CASSLFEGSGNQPQHF,11,11,2,22
TRBV20-1,TRBJ2-3,CSGGLPGGSTDTQYF,11,0,1,11
TRBV30,TRBJ2-1,CASKGRVGVGEQFF,11,0,1,11
TRBV19,TRBJ2-7,CASSIEFAGLLTSYEQYF,11,0,1,11
TRBV14,TRBJ1-4,CASSPDRGRADNEKLFF,11,0,1,11
TRBV7-2,TRBJ2-5,CASSHRTSGSWGETQYF,11,5,2,16
TRBV10-3,TRBJ1-3,CAISDRRQGTGNTIYF,11,0,1,11
TRBV19,TRBJ2-2,CASSIGGQGGTGELFF,11,0,1,11
TRBV7-6,TRBJ2-1,CASSSPGGSTAHGQFF,11,6,2,17
TRBV28,TRBJ2-3,CASSGSGQGAIDTQYF,11,0,1,11
TRBV4-1,TRBJ2-4,CASSQDLRAAKNIQYF,11,0,1,11
TRBV29-1,TRBJ2-7,CSVRLELAVTSYEQYF,11,0,1,11
TRBV19,TRBJ2-7,CASSIRGRSSYEQYF,11,0,1,11
TRBV28,TRBJ1-5,CASSSYRGGNQPQHF,11,0,1,11
TRBV12-3/4,TRBJ2-5,CASSPGTGAGETQYF,11,0,1,11
TRBV9,TRBJ2-1,CASSASGVYTNEQFF,11,0,1,11
TRBV5-1,TRBJ2-1,CASDPGSGSFHEQFF,11,0,1,11
TRBV4-1,TRBJ1-2,CASSQLRAGEYGYTF,11,0,1,11
TRBV5-1,TRBJ1-5,CASRPGTGEGQPRHF,11,0,1,11
TRBV6-2/3/5/6,TRBJ2-3,CASTSYSRTDTQYF,11,0,1,11
TRBV2,TRBJ1-5,CASSEAGGNQPQHF,11,0,1,11
TRBV28,TRBJ1-1,CASSKGTAGTEAFF,11,0,1,11
TRBV5-6,TRBJ2-3,CASSPGTGRHTQYF,11,0,1,11
TRBV7-9,TRBJ2-1,CDGVDRGLYNEQFF,11,0,1,11
TRBV5-1,TRBJ2-7,CASSLFSGTSEQYF,11,0,1,11
TRBV5-1,TRBJ2-7,CASSLEMAAYEQYF,11,5,2,16
TRBV20-1,TRBJ2-3,CSARVVGVTDTQYF,11,0,1,11
TRBV29-1,TRBJ2-5,CSVGARDLQETQYF,11,0,1,11
TRBV18,TRBJ2-7,CASSPGEREKQYF,11,0,1,11
TRBV18,TRBJ2-3,CASSREGVDTQYF,11,0,1,11
TRBV2,TRBJ1-1,CASRETWDTEAFF,11,0,1,11
TRBV24-1,TRBJ2-2,CATSGYTGELFF,11,0,1,11
TRBV11-3,TRBJ2-3,CASSLGSDTQYF,11,0,1,11
TRBV11-2,TRBJ2-7,CASSLASYEQYF,11,0,1,11
TRBV20-1,TRBJ2-7,CSARTFSYEQYF,11,0,1,11
TRBV5-5,TRBJ2-3,CASSLPRNPGDTQYF,11,0,1,11
TRBV3-1,TRBJ2-7,RASTAGQARDQYF,11,0,1,11
TRBV7-9,TRBJ1-1,CASSLNQPEAFF,11,6,2,17
TRBV7-9,TRBJ1-1,CASSLVSSNEAFF,11,0,1,11
TRBV29-1,TRBJ1-4,CSVGQGGTNEKLFF,10,38,2,48
TRBV19,TRBJ2-1,CASSLTGGNEQFF,10,0,1,10
TRBV30,TRBJ1-2,CSLRKGGYTF,10,0,1,10
TRBV29-1,TRBJ2-3,CSVASGSVTDTQYF,10,0,1,10
TRBV20-1,TRBJ2-4,CSVRRQSKTIQYF,10,0,1,10
TRBV29-1,TRBJ2-1,CSASASDYNEQFF,10,0,1,10
TRBV3-1,TRBJ1-1,CASSQDFGHRIGKNTEAFL,10,0,1,10
TRBV18,TRBJ1-4,CASSPETTNEKLFF,10,0,1,10
TRBV9,TRBJ2-1,CASSVNRGRDNEQFF,10,0,1,10
TRBV7-9,TRBJ1-3,CASSLGISRQGDSGNTIYF,10,23,2,33
TRBV5-6,TRBJ1-1,CASSLRGQGANRAEAFF,10,0,1,10
TRBV18,TRBJ2-7,CASSPGLAGSSYEQYF,10,0,1,10
TRBV18,TRBJ2-1,CASSPRPPSSYNEQFF,10,0,1,10
TRBV28,TRBJ2-1,CASSSGGTQGWNEQFF,10,0,1,10
TRBV27,TRBJ1-2,CASSLTSERTNYGYTF,10,0,1,10
TRBV27,TRBJ1-3,CASSPLQGFSGNTIYF,10,0,1,10
TRBV7-9,TRBJ1-2,CASSPFGGTESYGYTF,10,0,1,10
TRBV5-6,TRBJ2-2,CASSVASGSFHRELFF,10,0,1,10
TRBV19,TRBJ2-5,CASSRTSGSYETQYF,10,46,2,56
TRBV18,TRBJ2-3,CASSKGAFLTDTQYF,10,0,1,10
TRBV5-5,TRBJ2-1,CASCLEGQTYNEQFF,10,0,1,10
TRBV28,TRBJ1-5,CASQKGGAGNQPQHF,10,12,2,22
TRBV5-4,TRBJ2-7,CASSFPTGGSYEQYF,10,0,1,10
TRBV5-5,TRBJ2-3,CASSFHSRGTDTQYF,10,0,1,10
TRBV7-2,TRBJ2-5,CASSSLAASRGTQYF,10,0,1,10
TRBV7-2,TRBJ2-3,CASSQGQGNTDTQYF,10,0,1,10
TRBV12-3/4,TRBJ2-3,CASRETHEGTDTQYF,10,0,1,10
TRBV5-1,TRBJ2-1,CASSSLAGAVNEQFF,10,0,1,10
TRBV20-1,TRBJ2-7,CSASGIAGSFAEQYF,10,0,1,10
TRBV12-5,TRBJ2-5,CASGTGTDRETQYF,10,0,1,10
TRBV19,TRBJ2-5,CASSISGGPGTQYF,10,0,1,10
TRBV19,TRBJ2-1,CASSIAPFPYEQFF,10,6,2,16
TRBV19,TRBJ2-2,CASSIAWGTGELFF,10,0,1,10
TRBV2,TRBJ2-3,CASSPGQSTDTQYF,10,12,2,22
TRBV18,TRBJ2-4,CASSPPSGSDIQYF,10,0,1,10
TRBV28,TRBJ2-7,CASTPPDSYHEQYF,10,0,1,10
TRBV28,TRBJ1-4,CASSWDGRDEKLFF,10,0,1,10
TRBV25-1,TRBJ2-5,CASSENRGRETQYF,10,0,1,10
TRBV6-1,TRBJ2-2,CASSEDVDPGELFF,10,0,1,10
TRBV5-8,TRBJ2-7,CASSFGTGSYEQYF,10,0,1,10
TRBV7-9,TRBJ2-3,CASSLEASGGTQYF,10,0,1,10
TRBV7-6,TRBJ2-2,CASSLVQGSGELFF,10,0,1,10
TRBV7-3,TRBJ2-3,CASSLNTGPDTQYF,10,0,1,10
TRBV5-6,TRBJ2-7,CASSSRTGSYEQYF,10,0,1,10
TRBV7-2,TRBJ2-7,CASSRSNWGYEQYF,10,5,2,15
TRBV28,TRBJ2-7,CASRSGGSTMKQYF,10,0,1,10
TRBV5-1,TRBJ1-5,CASSLGDKNQPQHF,10,0,1,10
TRBV5-1,TRBJ2-1,CASSLGFSYNEQFF,10,0,1,10
TRBV5-1,TRBJ2-7,CASNGDGRSYEQYF,10,0,1,10
TRBV20-1,TRBJ2-6,CSAHSNSGANVLTF,10,6,2,16
TRBV12-5,TRBJ1-1,CASGRGVGTEAFF,10,0,1,10
TRBV7-7,TRBJ2-5,CASSPGGRETQYF,10,0,1,10
TRBV2,TRBJ2-5,CASSVGDLETQYF,10,0,1,10
TRBV18,TRBJ2-5,CASSPGQQETQYF,10,0,1,10
TRBV6-2/3/5/6,TRBJ2-5,CASSLVLQETQYF,10,0,1,10
TRBV6-2/3/5/6,TRBJ2-7,CASSTSGSYEQYF,10,0,1,10
TRBV5-4,TRBJ2-1,CASSLTGYNEQFF,10,0,1,10
TRBV11-2,TRBJ2-1,CASSLGLSNEQFF,10,0,1,10
TRBV3-1,TRBJ2-7,CASSQEPQGEQYF,10,0,1,10
TRBV2,TRBJ2-2,CASSIRKTGELFF,10,0,1,10
TRBV12-5,TRBJ2-1,CASGSNDWRQFF,10,0,1,10
TRBV14,TRBJ2-5,CASSQGWETQYF,10,0,1,10
TRBV20-1,TRBJ2-7,CSATWDRYEQYF,10,0,1,10
TRBV29-1,TRBJ1-2,CSVGEGSYGYTF,10,0,1,10
TRBV29-1,TRBJ2-1,CSAARRFNEQFF,10,0,1,10
TRBV20-1,TRBJ2-1,CSAWGYNEQFF,10,0,1,10
TRBV6-2/3/5/6,TRBJ2-1,CASSYGGSYNEQFF,10,0,1,10
TRBV29-1,TRBJ2-1,CSVEDWMGLAGQPYNEQFF,9,0,1,9
TRBV6-2/3/5/6,TRBJ2-2,CASSYGSSGRAPTGELFF,9,0,1,9
TRBV25-1,TRBJ2-1,CASSSRVAGWENNEQFF,9,0,1,9
TRBV20-1,TRBJ2-1,CSAKPGLAGSFYNEQFF,9,0,1,9
TRBV24-1,TRBJ2-2,CATSDSRASNTGELFF,9,0,1,9
TRBV18,TRBJ1-3,CASSPREWLSGNTIYF,9,0,1,9
TRBV18,TRBJ2-4,CASSPQDSVSKNIQYF,9,0,1,9
TRBV27,TRBJ2-2,CASSLRARDHTGELFF,9,0,1,9
TRBV28,TRBJ2-1,CASSPMDYTAYNEQFF,9,0,1,9
TRBV7-9,TRBJ2-1,CASSLAVAGLYNEQFF,9,0,1,9
TRBV7-3,TRBJ2-5,CASSLNPAGGGETQYF,9,0,1,9
TRBV5-4,TRBJ2-2,CASSPNRGPSTGELFF,9,0,1,9
TRBV3-1,TRBJ2-5,CASSQDRGTAQETQYF,9,0,1,9
TRBV3-1,TRBJ2-1,CASNLGTSGSRNEQFF,9,0,1,9
TRBV20-1,TRBJ1-5,CSAVTGYRYSNQPQHF,9,14,2,23
TRBV19,TRBJ1-5,CATLRTGNGNQPQHF,9,0,1,9
TRBV24-1,TRBJ2-5,CATSDGGRAEETQYF,9,0,1,9
TRBV19,TRBJ2-7,CASSMTSGSLDEQYF,9,0,1,9
TRBV19,TRBJ1-1,CASSKTLGDRAEAFF,9,8,2,17
TRBV18,TRBJ2-1,CASSPPAAAYNEQFF,9,0,1,9
TRBV12-3/4,TRBJ1-6,CASGHSTVYNSPLHF,9,0,1,9
TRBV2,TRBJ2-1,CASTKLPSGSGEQFF,9,0,1,9
TRBV28,TRBJ2-7,CASSSVKRGPPEQYF,9,0,1,9
TRBV7-2,TRBJ2-3,CASSFGQGGTDTQYF,9,0,1,9
TRBV5-5,TRBJ2-1,CASSLAPGQGNEQFF,9,0,1,9
TRBV7-2,TRBJ1-2,CASSSDSFTTYGYTF,9,0,1,9
TRBV3-1,TRBJ2-7,CASSLFAGQSYEQYF,9,0,1,9
TRBV7-9,TRBJ2-1,CASSRPGLDSNEQFF,9,0,1,9
TRBV5-1,TRBJ2-1,CASSLPSGRSREQFF,9,0,1,9
TRBV5-1,TRBJ2-1,CASSPRTGGDNEQFF,9,2,2,11
TRBV20-1,TRBJ1-6,CSAGEERGYGSPLHF,9,0,1,9
TRBV20-1,TRBJ2-1,CSASPGTGGRNEQFF,9,0,1,9
TRBV20-1,TRBJ2-1,CSAPEYAAGNNEQFF,9,0,1,9
TRBV29-1,TRBJ2-1,CSVLVGLAGDNEQFF,9,0,1,9
TRBV29-1,TRBJ1-5,CSVVIGRVCNQPQHF,9,0,1,9
TRBV29-1,TRBJ2-5,CSVESIAGPQETQYF,9,0,1,9
TRBV29-1,TRBJ2-3,CSVARQGGSTDTQYF,9,0,1,9
TRBV4-1,TRBJ2-7,CNIRDYAGDLYEQYF,9,0,1,9
TRBV30,TRBJ2-3,CAWSVLGRADTQYF,9,7,2,16
TRBV24-1,TRBJ2-1,CATSAAGSYNEQFF,9,0,1,9
TRBV24-1,TRBJ2-1,CATQDRGSYNEQFF,9,0,1,9
TRBV18,TRBJ1-1,CASSPPSQNTEAFF,9,0,1,9
TRBV18,TRBJ1-5,CASSPGGGNQPQHF,9,0,1,9
TRBV12-3/4,TRBJ2-1,CASSLGRSYNEQFF,9,0,1,9
TRBV6-2/3/5/6,TRBJ2-3,CASSYYQRADTQYF,9,0,1,9
TRBV6-1,TRBJ1-5,CASSGQGGNQPQHF,9,0,1,9
TRBV2,TRBJ2-1,CASSIADTYNEQFF,9,0,1,9
TRBV7-2,TRBJ2-5,CASSFQTSEETQYF,9,0,1,9
TRBV7-2,TRBJ2-7,CASSSLLGQEEQYF,9,0,1,9
TRBV6-2/3/5/6,TRBJ1-1,CASSRRPDGSEAFF,9,0,1,9
TRBV3-1,TRBJ1-1,CASSQHSGDTEAFF,9,0,1,9
TRBV6-2/3/5/6,TRBJ2-7,CASSQVGDSYEQYF,9,0,1,9
TRBV11-2,TRBJ2-7,CASNSPGRDDEQYF,9,0,1,9
TRBV19,TRBJ2-7,CASSQGPSGDEQYF,9,0,1,9
TRBV5-1,TRBJ2-7,CASSLPGLAYEQYF,9,0,1,9
TRBV20-1,TRBJ2-7,CSAGGTSGSYEQYF,9,0,1,9
TRBV20-1,TRBJ2-3,CSARHAGGTDTQYF,9,0,1,9
TRBV20-1,TRBJ2-7,CSARDSGTAYEQYF,9,0,1,9
TRBV29-1,TRBJ2-1,CSVNRDRIYNEQFF,9,0,1,9
TRBV29-1,TRBJ1-2,CSILQGGESNGYTF,9,0,1,9
TRBV2,TRBJ2-6,CAGHPPGANVLTF,9,0,1,9
TRBV19,TRBJ1-1,CASSMLGRTEAFF,9,2,2,11
TRBV13,TRBJ2-2,CASGPLGTGELFF,9,0,1,9
TRBV6-4,TRBJ1-1,CASGGQLNTEAFF,9,0,1,9
TRBV12-3/4,TRBJ2-6,CASSLAGANVLTF,9,0,1,9
TRBV12-3/4,TRBJ2-1,CASSKGTPNEQFF,9,0,1,9
TRBV7-2,TRBJ2-7,CASSFPRRDEQYF,9,0,1,9
TRBV7-9,TRBJ2-7,CASSLTAQYEQYF,9,0,1,9
TRBV7-2,TRBJ1-5,CASSPRQGGTQHF,9,0,1,9
TRBV14,TRBJ2-5,CASSQDLEGTQYF,9,0,1,9
TRBV5-1,TRBJ2-3,CASSLFSTDTQYF,9,0,1,9
TRBV5-1,TRBJ2-7,CASSWDKPYEQYF,9,8,2,17
TRBV20-1,TRBJ1-5,CSATGDSNQPQHF,9,0,1,9
TRBV20-1,TRBJ1-5,CSATTGGDQPQHF,9,0,1,9
TRBV20-1,TRBJ2-7,CSASDREPYEQYF,9,0,1,9
TRBV29-1,TRBJ2-3,CSAQGLGTDTQYF,9,0,1,9
TRBV12-5,TRBJ2-1,CASGLGQNEQFF,9,31,2,40
TRBV10-3,TRBJ2-5,CAISVSGETQYF,9,0,1,9
TRBV19,TRBJ1-1,CASSELNTEAFF,9,16,2,25
TRBV19,TRBJ1-1,CASVPTGGEAFF,9,0,1,9
TRBV2,TRBJ2-7,CASGDIFYEQYF,9,5,2,14
TRBV14,TRBJ2-3,CASSRDRHTQYF,9,0,1,9
TRBV6-1,TRBJ2-2,CASSEVTGELFF,9,0,1,9
TRBV5-8,TRBJ1-3,CASSLVGNTIYF,9,0,1,9
TRBV12-3/4,TRBJ2-3,CASNPQEDTQYF,9,0,1,9
TRBV5-1,TRBJ1-1,CASSFDQEKAFF,9,0,1,9
TRBV20-1,TRBJ1-1,CSARVRNTEAFF,9,0,1,9
TRBV30,TRBJ2-5,CAWSEGETQYF,9,0,1,9
TRBV2,TRBJ2-3,CASTASDTQYF,9,0,1,9
TRBV29-1,TRBJ2-1,CSAPSGDEQFF,9,0,1,9
TRBV25-1,TRBJ2-3,CASTRDTQYF,9,5,2,14
TRBV29-1,TRBJ2-1,CSVRGESSYNEQFF,9,9,2,18
TRBV5-1,TRBJ2-1,CASSPEIFWREGLNEQFF,9,0,1,9
TRBV3-1,TRBJ1-5,CASSQGRRGNQPQHF,9,0,1,9
TRBV19,TRBJ1-1,CASSITGVNTEAFF,9,0,1,9
TRBV6-2/3/5/6,TRBJ1-1,CASSYARVNTEAFF,9,0,1,9
TRBV25-1,TRBJ1-1,CASNQGLTTEAFF,9,0,1,9
TRBV9,TRBJ2-5,CASSPGGRAQETQYF,9,0,1,9
TRBV9,TRBJ2-1,CASSGYSGSIDEQFF,9,0,1,9
TRBV15,TRBJ2-1,CATSRDSASAQFF,9,0,1,9
TRBV6-2/3/5/6,TRBJ1-1,CASRTEMNTEAFF,9,0,1,9
TRBV20-1,TRBJ2-1,CSARDPQSSYNEQFF,9,0,1,9
TRBV6-2/3/5/6,TRBJ2-5,CASSYSRTVETQYF,9,0,1,9
TRBV4-2,TRBJ2-5,CASSPQDREETQYF,9,0,1,9
TRBV19,TRBJ2-1,CASNRDIFNNEQFF,9,0,1,9
TRBV20-1,TRBJ2-1,CSATTSGEYNEQFF,9,0,1,9
TRBV12-3/4,TRBJ1-1,CASTSWGRSEAFF,9,0,1,9
TRBV7-9,TRBJ1-2,CASSIPAGYTF,9,0,1,9
TRBV15,TRBJ2-6,CATSSHLGTGPFSGANVLTF,8,0,1,8
TRBV7-2,TRBJ2-4,CASSPDPGQPLILAKNIQYF,8,0,1,8
TRBV19,TRBJ2-1,CASTLRRTSGSRSYNEQFF,8,0,1,8
TRBV28,TRBJ2-4,CASSLVYRQVALGSNIQYF,8,0,1,8
TRBV29-1,TRBJ2-1,CSVDPPTSGRTAPYNEQFF,8,0,1,8
TRBV28,TRBJ2-3,RASTSHWTRGPSSTDTQYF,8,0,1,8
TRBV18,TRBJ2-3,CASSPPGTSGTRTDTQYF,8,0,1,8
TRBV18,TRBJ2-7,CASSQGLRSERSFRKQYF,8,0,1,8
TRBV6-2/3/5/6,TRBJ2-3,CASSYIAMTSGSTDTQYF,8,0,1,8
TRBV27,TRBJ1-2,CASSPESTGSGLGNGYTF,8,0,1,8
TRBV13,TRBJ2-1,CASSSILGPSGRKNEQFF,8,0,1,8
TRBV10-1,TRBJ2-2,CASSGTSGSIIDSGELFL,8,0,1,8
TRBV24-1,TRBJ2-3,CATSDSKNSRGVDTQYF,8,0,1,8
TRBV19,TRBJ2-1,CASSISRSGGAYNEQFF,8,0,1,8
TRBV19,TRBJ2-6,CASSIRTAPSGANVLTF,8,0,1,8
TRBV6-2/3/5/6,TRBJ2-5,CASSSLKRGGGRETQYF,8,0,1,8
TRBV6-2/3/5/6,TRBJ2-4,CASSYSVSQWAKNIQYF,8,0,1,8
TRBV11-2,TRBJ2-5,CASSSGGALADQETQYF,8,0,1,8
TRBV7-6,TRBJ2-1,CASSSTLGQGRPNEQFF,8,0,1,8
TRBV7-9,TRBJ2-1,CASSPPGGAGGGGEQFF,8,0,1,8
TRBV7-9,TRBJ2-1,CASSPHSGGSWNYEQFF,8,0,1,8
TRBV29-1,TRBJ2-6,CSVERTDTNSGANVLTF,8,2,2,10
TRBV29-1,TRBJ2-3,CSGAHGSSGSFADTQYF,8,0,1,8
TRBV19,TRBJ2-7,CASSEEQGLGPYEQYF,8,0,1,8
TRBV18,TRBJ2-2,CASSVTRASNTGELFF,8,0,1,8
TRBV18,TRBJ1-1,CASSPRTPGANTEAFF,8,0,1,8
TRBV6-2/3/5/6,TRBJ2-3,CASSFSVGTGTDTQYF,8,0,1,8
TRBV27,TRBJ1-4,CASSLSPSTGNEKLFF,8,0,1,8
TRBV28,TRBJ2-5,CASSLSGGSGEETQYF,8,9,2,17
TRBV2,TRBJ2-1,CASSEARASSYNEQFF,8,0,1,8
TRBV5-4,TRBJ2-1,CASSLGGATSYNEQFF,8,0,1,8
TRBV7-9,TRBJ2-1,CASSLEMTGSGNEQFF,8,0,1,8
TRBV4-2,TRBJ2-2,CASSQDLRANTGELFF,8,0,1,8
TRBV5-1,TRBJ2-3,CASSLGLAGVKDTQYF,8,0,1,8
TRBV5-1,TRBJ2-3,CASSSLTGLGTDTQYF,8,0,1,8
TRBV20-1,TRBJ2-1,CSARPFSGISYNEQFF,8,0,1,8
TRBV20-1,TRBJ2-1,CSARSPVGGSRNEQFF,8,0,1,8
TRBV20-1,TRBJ2-3,CSARGTTSASTDTQYF,8,0,1,8
TRBV29-1,TRBJ2-7,CSVEGIPGQGWYEQYF,8,7,2,15
TRBV30,TRBJ1-1,CAWSRARPPRPEAFF,8,0,1,8
TRBV10-3,TRBJ2-1,CAASFTGRAENEQFF,8,0,1,8
TRBV10-3,TRBJ2-3,CAIRGIAGGTDTQYF,8,0,1,8
TRBV24-1,TRBJ2-5,CATSEGDGTGETQYF,8,0,1,8
TRBV19,TRBJ1-1,CASSLAGHPDTEAFF,8,0,1,8
TRBV18,TRBJ1-1,CASSPGTGRNTEAYF,8,0,1,8
TRBV18,TRBJ1-4,CASSPMSGGSEKLFF,8,0,1,8
TRBV5-5,TRBJ2-1,CASTVQEGAYNEQFF,8,0,1,8
TRBV28,TRBJ2-1,CASSLSAGVYNEQFF,8,0,1,8
TRBV28,TRBJ2-3,CASSLMGPYTDTQYF,8,0,1,8
TRBV12-3/4,TRBJ2-2,CASSLRTGQTGELFF,8,6,2,14
TRBV27,TRBJ1-2,CASSSGTGTAYGYTF,8,0,1,8
TRBV28,TRBJ1-6,CASSLTPGQGAPLHF,8,0,1,8
TRBV25-1,TRBJ2-1,CASSESSGSGREQFF,8,0,1,8
TRBV5-4,TRBJ2-1,CASSLRGRASNEQFF,8,0,1,8
TRBV7-8,TRBJ2-7,CASSLDRTAIYEQYF,8,9,2,17
TRBV5-8,TRBJ2-2,CASSLTGANTGELFF,8,0,1,8
TRBV5-4,TRBJ2-1,CASSSRTSGSVEQFF,8,0,1,8
TRBV3-1,TRBJ2-1,CASSPRDRGRNEQFF,8,0,1,8
TRBV7-2,TRBJ1-5,CASSPGGASNQPQHF,8,0,1,8
TRBV11-3,TRBJ1-3,CASSPTGTAGNTIYF,8,0,1,8
TRBV3-1,TRBJ2-7,CASSQGLAGGDEQYF,8,5,2,13
TRBV3-1,TRBJ2-7,CASSQTGQFSYEQYF,8,0,1,8
TRBV11-3,TRBJ2-1,CASSMTSGPYNEQFF,8,19,2,27
TRBV7-9,TRBJ2-7,CASSKRPLYRDEQYF,8,0,1,8
TRBV2,TRBJ2-3,CASKTGHPSTDTQYF,8,0,1,8
TRBV5-1,TRBJ2-7,CASQPGQGSSYEQYF,8,0,1,8
TRBV5-1,TRBJ2-1,CASSFGQGGYNEQFF,8,0,1,8
TRBV5-1,TRBJ2-7,CASSLAGQEVYEQYF,8,0,1,8
TRBV5-1,TRBJ2-3,CASRGLATSTDTQYF,8,0,1,8
TRBV20-1,TRBJ2-3,CSAGNSGKPTDTQYF,8,0,1,8
TRBV20-1,TRBJ2-7,CSARERGLAVDEQYF,8,0,1,8
TRBV29-1,TRBJ2-3,CSVLFWAAGTDTQYF,8,0,1,8
TRBV15,TRBJ1-1,CATSRGGPTYEAFF,8,0,1,8
TRBV7-2,TRBJ2-3,CASCLGLRTDTQYF,8,0,1,8
TRBV6-2/3/5/6,TRBJ2-1,CASSLWTEGNEQFF,8,0,1,8
TRBV12-3/4,TRBJ2-5,CASSLSGGAKTQYF,8,0,1,8
TRBV2,TRBJ2-7,CASSSNRGSYEQYF,8,0,1,8
TRBV28,TRBJ2-5,CASSSPGTRETQYF,8,0,1,8
TRBV3-1,TRBJ2-5,CASSSSGRRETQYF,8,0,1,8
TRBV5-6,TRBJ2-3,CASSQEWVTDTQYF,8,0,1,8
TRBV19,TRBJ2-1,CASSIGLAGDEQFF,8,0,1,8
TRBV2,TRBJ2-5,CASSRLAGGETQYF,13,0,1,13
TRBV5-4,TRBJ2-5,CASSLPSTLETQYF,8,0,1,8
TRBV7-9,TRBJ2-5,CASSLHAGQETQYF,8,0,1,8
TRBV7-9,TRBJ2-7,CASSSGTGAYEQYF,8,5,2,13
TRBV7-2,TRBJ2-7,CASSSTSGRYEQYF,8,0,1,8
TRBV7-2,TRBJ2-3,CASSPRETTDTQYF,8,0,1,8
TRBV3-1,TRBJ1-5,CASSPASGNQPQHF,8,0,1,8
TRBV4-2,TRBJ2-7,CASSRGLATGEQYF,8,0,1,8
TRBV3-1,TRBJ2-3,CASSQGGGTDTQYF,8,0,1,8
TRBV28,TRBJ2-5,CASRGQHYQETQYF,8,0,1,8
TRBV12-3/4,TRBJ1-3,CASRRQGSGNTIYF,8,0,1,8
TRBV5-1,TRBJ2-1,CASSLSHGSNEQFF,8,0,1,8
TRBV5-1,TRBJ2-7,CASSPGTAYYEQYF,8,0,1,8
TRBV5-1,TRBJ2-5,CASSAPSGQETQYF,8,0,1,8
TRBV20-1,TRBJ2-3,CSAPRSPSTDTQYF,8,0,1,8
TRBV20-1,TRBJ1-5,CSATPSGGDQPQHF,8,0,1,8
TRBV20-1,TRBJ2-1,CSAATSGRVNEQFF,8,10,2,18
TRBV29-1,TRBJ2-5,CSVAGGGRQETQYF,8,0,1,8
TRBV12-5,TRBJ2-5,CASGPEVRETQYF,8,0,1,8
TRBV2,TRBJ2-3,CASGLISTDTQYF,8,0,1,8
TRBV19,TRBJ1-1,CASSITRDSEAFF,8,0,1,8
TRBV18,TRBJ1-1,CASSLRADTEAFF,8,0,1,8
TRBV6-2/3/5/6,TRBJ2-1,CASSRTGTNEQFF,8,0,1,8
TRBV12-3/4,TRBJ2-3,CASSISRGDTQYF,8,0,1,8
TRBV11-2,TRBJ2-1,CASSLWAYNEQFF,8,0,1,8
TRBV5-5,TRBJ1-1,CASSLASQGTAFF,8,0,1,8
TRBV7-9,TRBJ1-1,CASSSTWNTEAFF,8,0,1,8
TRBV11-2,TRBJ1-5,CASSQTGVQPQHF,8,0,1,8
TRBV3-1,TRBJ1-5,CASSQYSNQPQHF,8,0,1,8
TRBV3-1,TRBJ2-7,CASSQPHSYEQYF,8,0,1,8
TRBV10-1,TRBJ2-1,CASSESIYNEQFF,8,0,1,8
TRBV5-1,TRBJ1-1,CASSLERRNEAFF,8,0,1,8
TRBV5-1,TRBJ1-1,CASSLEMDTEAFF,8,0,1,8
TRBV5-1,TRBJ2-3,CASSWDSTDTQYF,8,0,1,8
TRBV5-1,TRBJ2-7,CASSTLGGHEQYF,8,0,1,8
TRBV20-1,TRBJ2-1,CSARDDSGPLQFF,8,0,1,8
TRBV20-1,TRBJ2-1,CSPGLAGYNEQFF,8,0,1,8
TRBV29-1,TRBJ2-7,CSVNRDNTYEQYF,8,0,1,8
TRBV29-1,TRBJ2-7,CSADSTSEGGKYF,8,0,1,8
TRBV28,TRBJ2-7,CASSFGAYEQYF,8,0,1,8
TRBV5-6,TRBJ1-2,CASSRQGYGYTF,8,0,1,8
TRBV7-9,TRBJ2-3,CASSPSGDTQYF,8,0,1,8
TRBV7-9,TRBJ2-1,CASSRDSNEQFF,8,0,1,8
TRBV2,TRBJ2-5,CASRGLQETQYF,8,0,1,8
TRBV5-1,TRBJ2-1,CASSPPGDEQFF,8,0,1,8
TRBV20-1,TRBJ2-5,CSAGLNQETQYF,8,0,1,8
TRBV29-1,TRBJ2-1,CSVRLSYNEQFF,8,0,1,8
TRBV29-1,TRBJ2-3,CSALGGADTQYF,8,0,1,8
TRBV28,TRBJ2-7,CASSLSREQYF,8,0,1,8
TRBV7-8,TRBJ2-5,CASSLIGTQYF,8,12,2,20
TRBV20-1,TRBJ1-1,CSARLSAEAFF,8,0,1,8
TRBV5-4,TRBJ2-3,CASSLSTGGREDTQYF,8,0,1,8
TRBV3-1,TRBJ2-2,CASTGSGSVTGELFF,8,0,1,8
TRBV2,TRBJ2-7,CAIRRLAGAYEQYF,8,0,1,8
TRBV19,TRBJ2-1,CASSPRSSYNEQFF,8,0,1,8
TRBV11-2,TRBJ2-1,CASSLLSGLGEQFF,8,0,1,8
TRBV11-2,TRBJ2-2,CASSLSLNTGELFF,8,7,2,15
TRBV20-1,TRBJ2-5,CSAPAQRRETQYF,8,0,1,8
TRBV18,TRBJ2-5,CASSPPVGGGKETQYF,8,0,1,8
TRBV29-1,TRBJ2-5,CSAREIQETQYF,8,0,1,8
TRBV2,TRBJ2-5,CASGVQETQYF,8,0,1,8
TRBV5-1,TRBJ2-7,CASSLATDAITYEQYF,8,0,1,8
TRBV18,TRBJ2-3,CASSPEAGSTDTQYF,8,0,1,8
TRBV2,TRBJ1-4,CASTPDSTREKLFS,8,0,1,8
TRBV11-2,TRBJ2-7,CASSPQGRGLEQYF,8,0,1,8
TRBV7-9,TRBJ1-5,CASSRDISNQPQHF,8,7,2,15
TRBV2,TRBJ1-5,CASRTGFSNQPQHF,8,0,1,8
TRBV7-2,TRBJ2-4,CASSLSGQNIQYF,8,32,2,40
TRBV11-2,TRBJ2-3,CASSLEVKDTQYF,8,0,1,8
TRBV29-1,TRBJ2-3,CSVNSGMTDTQYF,8,0,1,8
TRBV5-1,TRBJ2-5,CASGPYGETQHF,8,0,1,8
TRBV5-1,TRBJ2-3,CASSLSTDTQYF,8,5,2,13
TRBV29-1,TRBJ2-7,CSVLGSSYEQYL,8,0,1,8
TRBV11-2,TRBJ2-3,CASRTTWLAGGRTRSSTDTQYF,7,0,1,7
TRBV12-3/4,TRBJ2-1,CASSLILRGLAFRSSYNEQFF,7,0,1,7
TRBV27,TRBJ2-2,CASSLITSGRERRITGELFF,7,0,1,7
TRBV5-4,TRBJ2-1,CASSPGTGDSGRALGNEQFF,7,0,1,7
TRBV6-2/3/5/6,TRBJ2-3,CASSPGGGSYKRTDTQYF,7,0,1,7
TRBV5-4,TRBJ2-3,CASSFPIPLGGRSDTQYF,7,0,1,7
TRBV7-9,TRBJ2-2,CASSYTRYAQTNTGELFF,7,0,1,7
TRBV6-2/3/5/6,TRBJ2-1,CASRQGLAVLEVNNEQFF,7,0,1,7
TRBV4-1,TRBJ1-2,CASSQDSPGAQANYGYTF,7,0,1,7
TRBV20-1,TRBJ2-1,CSARPLLHWGVGYNEQFF,7,0,1,7
TRBV20-1,TRBJ2-6,CSAMIAGTVLSGANVLTF,7,0,1,7
TRBV12-5,TRBJ2-2,CASGAWGGDWNTGELFF,7,0,1,7
TRBV18,TRBJ1-1,CASSPRRIGTVNTEAFF,7,0,1,7
TRBV28,TRBJ2-1,CASSLVASGTRRHEQFF,7,0,1,7
TRBV28,TRBJ2-4,CASSSSGTGAKGNIQYF,7,0,1,7
TRBV6-4,TRBJ2-1,CASSDSPRSGRANEQFF,7,0,1,7
TRBV14,TRBJ2-3,CASSFGTSGGPYDTQYF,7,0,1,7
TRBV11-2,TRBJ1-5,CASSLDLDGGTNQPQHF,7,0,1,7
TRBV5-6,TRBJ2-3,CASSSILDGVGTDTQYF,7,0,1,7
TRBV14,TRBJ2-3,CASSWGVGRARTDTQYF,7,0,1,7
TRBV7-2,TRBJ2-1,CASSLVSGGSSYNEQFF,7,0,1,7
TRBV14,TRBJ1-6,CASSQRRRSSYNSPLHF,7,0,1,7
TRBV3-1,TRBJ2-5,CASSQEAHAGSEETQYF,7,0,1,7
TRBV2,TRBJ1-1,CASRPSTATIMNTEAFF,7,0,1,7
TRBV10-1,TRBJ2-1,CASSDPRGASPNNEQFF,7,0,1,7
TRBV30,TRBJ1-2,CAWSNLRDRGRVGYTF,7,0,1,7
TRBV19,TRBJ2-2,CASMRMQGANTGELFF,7,0,1,7
TRBV19,TRBJ2-1,CASSKDRGRGVNEQFF,7,0,1,7
TRBV12-3/4,TRBJ2-2,CASGVLAGGNTGELFF,7,0,1,7
TRBV6-2/3/5/6,TRBJ2-3,CASSLIGTGYPDTQYF,7,0,1,7
TRBV6-2/3/5/6,TRBJ2-7,CASSYSASGKPYEQYF,7,0,1,7
TRBV6-2/3/5/6,TRBJ2-3,CASSYRLVRFGDTQYF,7,0,1,7
TRBV6-2/3/5/6,TRBJ2-1,CASSLISGWSHNEQFF,7,0,1,7
TRBV2,TRBJ2-3,CASSVRLAGIADTQYF,7,0,1,7
TRBV25-1,TRBJ2-5,CASSETGQGLQETQYF,7,0,1,7
TRBV12-3/4,TRBJ2-1,CASSTNLNLLAIEQFF,7,0,1,7
TRBV13,TRBJ2-7,CASSFGVAARSYEQYF,7,0,1,7
TRBV5-6,TRBJ2-1,CASSLPSGGFYNEQFF,7,0,1,7
TRBV5-4,TRBJ2-1,CASSLVGSRAYNEQFF,7,0,1,7
TRBV5-6,TRBJ2-1,CASSLARRGPYNEQFF,7,0,1,7
TRBV7-2,TRBJ1-5,CASSLVAGQGNQPQHF,7,0,1,7
TRBV7-2,TRBJ2-7,CASSLRGGPTSYEQYF,7,0,1,7
TRBV7-9,TRBJ1-5,CASSSTIGGVNQPQHF,7,0,1,7
TRBV3-1,TRBJ2-1,CASSLEGGSSYNEQFF,7,0,1,7
TRBV3-1,TRBJ2-3,CASSLPGTGGTDTQYF,7,0,1,7
TRBV11-2,TRBJ2-3,CASSPRASGFTDTQYF,7,0,1,7
TRBV5-6,TRBJ2-7,CASSPLRQGAADEQYF,7,0,1,7
TRBV5-8,TRBJ2-3,CASSHGLAGSIDTQYF,7,0,1,7
TRBV3-1,TRBJ2-1,CASSQDSQAGNNEQFF,7,0,1,7
TRBV11-3,TRBJ2-1,CASSALSGSPYNEQFF,7,0,1,7
TRBV12-3/4,TRBJ2-1,CASRRTSGSSYNEQFF,7,0,1,7
TRBV5-1,TRBJ2-1,CASSLARASGRDEQFF,7,0,1,7
TRBV5-1,TRBJ2-1,CASSLAAAGDGDEQFF,7,0,1,7
TRBV5-1,TRBJ2-3,CASSLTSGVRTDTQYF,7,0,1,7
TRBV5-1,TRBJ1-1,CASSPEGGPRNTEAFF,7,0,1,7
TRBV5-1,TRBJ2-7,CASSHRMQGSSYEQYF,7,0,1,7
TRBV5-1,TRBJ2-7,CASSSSWEGLFDEQYF,7,0,1,7
TRBV20-1,TRBJ2-5,CSATPGRGSMVETQYF,7,0,1,7
TRBV29-1,TRBJ2-5,CSVVGMGLADQETQYF,7,0,1,7
TRBV29-1,TRBJ1-1,CSVGFLTGRQNTEAFF,7,7,2,14
TRBV29-1,TRBJ2-1,CSVEDRGTGGYNEQFF,7,0,1,7
TRBV12-3/4,TRBJ2-7,CAGSASGPGGVWQYF,7,0,1,7
TRBV10-3,TRBJ2-1,CAISESPSAHNEQFF,7,0,1,7
TRBV10-3,TRBJ2-2,CAISEADTGSGELFF,7,0,1,7
TRBV2,TRBJ2-3,CATQVAVVGTDTQYF,7,0,1,7
TRBV24-1,TRBJ2-5,CATSETGAGQETQYF,7,0,1,7
TRBV15,TRBJ2-1,CATSRPPPDRNEQFF,7,0,1,7
TRBV19,TRBJ1-1,CASSSVQGGHTEAFF,7,0,1,7
TRBV19,TRBJ1-5,CASSMGRSKVQPQHF,7,0,1,7
TRBV18,TRBJ2-3,CASSQGQGDTDTQYF,7,0,1,7
TRBV18,TRBJ2-1,CASSPLRTSGPEQFF,7,0,1,7
TRBV9,TRBJ2-2,CASTSGTANTGELFF,7,0,1,7
TRBV28,TRBJ2-7,CASTMETSGSYEQYF,7,0,1,7
TRBV28,TRBJ2-7,CASSFRDRPGYEQYF,7,2,2,9
TRBV6-2/3/5/6,TRBJ2-3,CASSSPAGGTDTQYF,7,0,1,7
TRBV2,TRBJ2-3,CASSSELETADTQYF,7,0,1,7
TRBV2,TRBJ2-1,CASSSTSGIGDEQFF,7,0,1,7
TRBV5-4,TRBJ2-1,CASSGGGGGFNEQFF,7,0,1,7
TRBV6-1,TRBJ2-7,CASSEFRGGSGEQYF,7,0,1,7
TRBV6-1,TRBJ2-1,CASSEGLAGSNEQFF,7,0,1,7
TRBV27,TRBJ2-1,CASSKTRRDGNEQFF,7,0,1,7
TRBV7-2,TRBJ1-4,CASSFFGRENEKLFF,7,0,1,7
TRBV7-9,TRBJ2-3,CASSFLAENTDTQYF,7,0,1,7
TRBV7-8,TRBJ2-3,CASSLLPTSTDTQYF,7,7,2,14
TRBV7-2,TRBJ2-3,CASSLDGGSTDTQYF,7,3,2,10
TRBV7-9,TRBJ2-3,CASSLTEGSGDTQYF,7,0,1,7
TRBV28,TRBJ2-1,CASSPARSSYNEQFF,7,0,1,7
TRBV5-5,TRBJ1-5,CASSPISNSNQPQHF,7,0,1,7
TRBV13,TRBJ2-7,CASSPSAGGIYEQYF,7,0,1,7
TRBV3-1,TRBJ2-3,CASSPWGAGFNTQYF,7,0,1,7
TRBV5-4,TRBJ2-1,CASSRGTSTYNEQFF,7,0,1,7
TRBV14,TRBJ2-1,CASSQQLAGSDEQFF,7,0,1,7
TRBV14,TRBJ2-1,CASSQDRTVYNEQSF,7,0,1,7
TRBV3-1,TRBJ2-7,CASSQDITTPYEQYF,7,0,1,7
TRBV7-9,TRBJ2-2,CASSQIGGGAGELFF,7,0,1,7
TRBV9,TRBJ2-1,CASSAMTSPYNEQFF,7,0,1,7
TRBV9,TRBJ2-3,CASSGRDRGWNTQYF,7,0,1,7
TRBV7-2,TRBJ2-3,CASSIDRGSTDTQYF,7,0,1,7
TRBV2,TRBJ2-1,CASRPTLAGDGEQFF,7,2,2,9
TRBV28,TRBJ2-3,CASNDGGRARDTQYF,7,0,1,7
TRBV5-1,TRBJ2-1,CASSFQGSTYNEQFF,7,0,1,7
TRBV5-1,TRBJ2-5,CASSLADSHKETQYF,7,0,1,7
TRBV5-1,TRBJ2-1,CASSLIRGSWDEQFF,7,0,1,7
TRBV5-1,TRBJ2-1,CASSSQAGVRNEQFF,7,0,1,7
TRBV5-1,TRBJ2-2,CASSLLIGSNGELFF,7,0,1,7
TRBV5-1,TRBJ1-1,CASSPERGLGTEAFF,7,0,1,7
TRBV4-1,TRBJ2-1,CASSHREDGYNEQFF,7,0,1,7
TRBV20-1,TRBJ2-2,CSASSSGTNTGELFF,7,0,1,7
TRBV20-1,TRBJ2-6,CSASGPLQGANVLTF,7,0,1,7
TRBV20-1,TRBJ2-1,CSARGGLPGDNEQFF,7,0,1,7
TRBV20-1,TRBJ2-5,CSAGGQGDPVGTQYF,7,0,1,7
TRBV29-1,TRBJ2-7,CSVEGSSGSGDEQYF,7,0,1,7
TRBV28,TRBJ2-7,SASSLSSGSPREQYF,7,0,1,7
TRBV12-5,TRBJ2-2,CASGVLPNTGELFF,7,0,1,7
TRBV19,TRBJ2-1,CASGEAGGIDEQFF,7,0,1,7
TRBV19,TRBJ2-7,CASSPADRTYEQYF,7,0,1,7
TRBV19,TRBJ2-1,CASSKQGGYNEQFF,7,0,1,7
TRBV19,TRBJ2-4,CASNSDRGKNIQYF,7,0,1,7
TRBV2,TRBJ2-2,CASRDKGYTGELFF,7,0,1,7
TRBV6-2/3/5/6,TRBJ2-7,CASTLQGATYEQYF,7,0,1,7
TRBV6-2/3/5/6,TRBJ1-5,CASSFTGGDQPQHF,7,0,1,7
TRBV28,TRBJ2-4,CASSLPSGQGIQYF,7,0,1,7
TRBV12-3/4,TRBJ2-7,CASSLAGVAYEQYF,7,0,1,7
TRBV2,TRBJ1-1,CASSYRLVNTEAFF,7,0,1,7
TRBV12-3/4,TRBJ2-1,CASSLSGIFNEQFF,7,0,1,7
TRBV2,TRBJ2-1,CASSAFLADNEQFF,7,0,1,7
TRBV28,TRBJ2-4,CASSTRRGKNIQYF,7,10,2,17
TRBV5-4,TRBJ2-5,CASSFDRGQETQYF,7,0,1,7
TRBV5-4,TRBJ1-1,CASSLDRGVTEAFF,7,0,1,7
TRBV7-9,TRBJ2-3,CASSLVGGADTQYF,7,0,1,7
TRBV7-3,TRBJ2-5,CASSLTSGGETQYF,7,0,1,7
TRBV11-2,TRBJ2-7,CASSLSRATYEQYF,7,0,1,7
TRBV5-6,TRBJ2-5,CASSYGTSGETQYF,7,0,1,7
TRBV7-9,TRBJ2-7,CASSLVGGDREQYF,7,0,1,7
TRBV13,TRBJ1-1,CASSPRRRNTEAFF,7,0,1,7
TRBV28,TRBJ2-7,CASSRPTSAYEQYF,7,0,1,7
TRBV7-2,TRBJ2-1,CASSQGLPGYTQFF,7,0,1,7
TRBV7-3,TRBJ2-1,CASSTTGTDNEQFF,7,0,1,7
TRBV6-4,TRBJ1-2,CASRTLGGTYGYTF,7,0,1,7
TRBV5-6,TRBJ2-2,CSSSYYGGTGELFF,7,0,1,7
TRBV5-1,TRBJ2-1,CASSLVISNNEQFF,7,0,1,7
TRBV5-1,TRBJ2-7,CASSSRDWGYEQYF,7,0,1,7
TRBV5-1,TRBJ2-5,CASSSQGIQETQYF,7,0,1,7
TRBV5-1,TRBJ1-2,CASSALQANYGYTF,7,0,1,7
TRBV5-1,TRBJ2-1,CASSSVSVANEQFF,7,0,1,7
TRBV20-1,TRBJ2-1,CSAEPSGRAHEQFF,7,0,1,7
TRBV20-1,TRBJ1-2,CSASKLGRDYGYTF,7,0,1,7
TRBV20-1,TRBJ2-5,CSARPGTGQETQYF,7,0,1,7
TRBV20-1,TRBJ1-5,CSGRWGGTDQPQHF,7,0,1,7
TRBV29-1,TRBJ2-3,CSVESQARHTAQYF,7,0,1,7
TRBV29-1,TRBJ2-1,CSVERVAGIVEQFF,7,0,1,7
TRBV29-1,TRBJ2-7,CSVWTSGGGYEQYF,7,0,1,7
TRBV29-1,TRBJ2-7,CSVLVGTAPYEQYF,7,0,1,7
TRBV15,TRBJ1-1,CATSRGGSTEAFF,7,0,1,7
TRBV7-9,TRBJ2-3,CATRAASTDTQYF,7,0,1,7
TRBV19,TRBJ1-5,CASKNWDNQPQHF,7,4,2,11
TRBV18,TRBJ1-5,CASSGGENQPQHF,7,0,1,7
TRBV18,TRBJ2-5,CASSPPGEETQYF,7,0,1,7
TRBV18,TRBJ1-1,CASSPDENTEAFF,7,0,1,7
TRBV19,TRBJ1-2,CASAQRANYGYTF,7,0,1,7
TRBV12-3/4,TRBJ1-2,CASSLVSGVGYTF,7,0,1,7
TRBV27,TRBJ1-1,CASSLSGAVEAFF,7,0,1,7
TRBV12-3/4,TRBJ1-2,CASSLMENYGYTF,7,0,1,7
TRBV2,TRBJ2-5,CASSEGRWETQYF,7,0,1,7
TRBV7-2,TRBJ2-1,CASSLPGYNEQFF,7,0,1,7
TRBV7-9,TRBJ2-2,CASSLAGSGELFF,7,0,1,7
TRBV3-1,TRBJ2-7,CASSSGTSGLRYF,7,0,1,7
TRBV12-3/4,TRBJ1-2,CASSYRGGSGYTF,7,0,1,7
TRBV3-1,TRBJ2-5,CASSLRGQETQYF,7,0,1,7
TRBV5-4,TRBJ2-1,CASSPDSSGVRFF,7,0,1,7
TRBV3-1,TRBJ2-7,CASSPQYEGEQYF,7,0,1,7
TRBV12-3/4,TRBJ2-7,CASSPQVFHGQYF,7,0,1,7
TRBV14,TRBJ1-2,CASSQTGLYGYTF,7,0,1,7
TRBV9,TRBJ2-2,CASSVGGPGELFF,7,0,1,7
TRBV2,TRBJ2-5,CASSGQGSETQYF,7,0,1,7
TRBV5-4,TRBJ1-2,CASSTFGVVGYTF,7,0,1,7
TRBV5-1,TRBJ1-1,CASGGQGNTEAFF,7,0,1,7
TRBV5-1,TRBJ2-4,CASSLGQENIQYF,7,0,1,7
TRBV5-1,TRBJ2-7,CASSLDQLYEQYF,7,0,1,7
TRBV5-1,TRBJ1-1,CASSQEMNTEAFF,7,0,1,7
TRBV29-1,TRBJ2-1,CSVSTSSYNEQFF,7,0,1,7
TRBV20-1,TRBJ1-1,CSVAERLNTEAFF,7,0,1,7
TRBV20-1,TRBJ2-7,CSAGTSGLGEQYF,7,0,1,7
TRBV20-1,TRBJ1-1,CSASLRTNTEAFF,7,0,1,7
TRBV20-1,TRBJ2-3,CSARSGRTDTQYF,7,0,1,7
TRBV20-1,TRBJ2-1,CSANRGLANEQFF,7,0,1,7
TRBV29-1,TRBJ1-1,CSVDTGLGTEAFF,7,0,1,7
TRBV29-1,TRBJ2-2,CSVDPWNTGELFF,7,0,1,7
TRBV29-1,TRBJ2-2,CSVEEGSPGELFF,7,0,1,7
TRBV29-1,TRBJ2-7,CSVGLAGVYEQYF,7,0,1,7
TRBV2,TRBJ1-4,CAAGTRSEKLFF,7,0,1,7
TRBV28,TRBJ2-7,CASSIKAGWQYF,7,0,1,7
TRBV7-2,TRBJ1-1,CASSSIPLEAFF,7,0,1,7
TRBV11-2,TRBJ2-1,CASSHPYNEQFL,7,0,1,7
TRBV12-3/4,TRBJ2-3,CASNLLSGTQYF,7,0,1,7
TRBV5-1,TRBJ2-1,CASSNPNNEQFF,7,0,1,7
TRBV20-1,TRBJ2-3,CSARPAQNTQYF,7,0,1,7
TRBV20-1,TRBJ2-1,CSAPSGSDEQFF,7,0,1,7
TRBV20-1,TRBJ2-5,CSAAWTSETQYF,7,0,1,7
TRBV29-1,TRBJ1-1,CSVNTGFAEAFF,7,0,1,7
TRBV29-1,TRBJ2-5,CSVYHRGETQYF,7,0,1,7
TRBV29-1,TRBJ2-1,CSAGRSYDEQFF,7,0,1,7
TRBV29-1,TRBJ2-1,CSGLSSYNEQFF,7,0,1,7
TRBV19,TRBJ2-2,CASRSTGELFF,7,7,2,14
TRBV25-1,TRBJ2-3,CASTSSSTQYF,7,0,1,7
TRBV7-9,TRBJ2-7,CASSYLGEQYF,7,0,1,7
TRBV3-1,TRBJ2-5,CASSGTGAQYF,7,0,1,7
TRBV29-1,TRBJ1-2,CSSGQGSGYTF,7,0,1,7
TRBV29-1,TRBJ2-7,CSVDAGTATLF,7,5,2,12
TRBV29-1,TRBJ2-7,CSALGGDEQYF,7,0,1,7
TRBV2,TRBJ2-7,CASRVGEQYF,7,0,1,7
TRBV5-6,TRBJ2-5,CASSLSGLAGVKETQYF,7,0,1,7
TRBV6-2/3/5/6,TRBJ1-2,CASSYATGFNYGYTF,7,0,1,7
TRBV5-4,TRBJ1-3,CASSFGGGSGNTIYF,7,0,1,7
TRBV11-2,TRBJ2-1,CASSFGGLVGNEQFF,7,0,1,7
TRBV6-2/3/5/6,TRBJ2-5,CASKPGLAGDGTQYF,7,0,1,7
TRBV7-4,TRBJ2-4,CASSKQGLKNIQYF,7,12,2,19
TRBV7-9,TRBJ2-1,CASRAGGASNEQFF,7,0,1,7
TRBV5-1,TRBJ1-6,CASRQGAENSPLHF,7,0,1,7
TRBV25-1,TRBJ2-7,CASRLAGGVEQYF,7,0,1,7
TRBV10-3,TRBJ2-3,CAIRAGTDTQYF,7,0,1,7
TRBV20-1,TRBJ2-3,CSARDRLKGQGYTDTQYF,7,0,1,7
TRBV19,TRBJ2-1,CASSFNPTSGSLGEQFF,7,0,1,7
TRBV12-3/4,TRBJ2-5,CASSFLTSGSGETQYF,7,0,1,7
TRBV6-2/3/5/6,TRBJ2-3,CASSYSRLAGTDTLYF,7,0,1,7
TRBV14,TRBJ1-2,CACSQELGAYYGYTF,7,0,1,7
TRBV19,TRBJ2-1,CASSITSGSYNEQFF,7,83,2,90
TRBV12-3/4,TRBJ2-7,CASRNTGTGTYEQYL,7,0,1,7
TRBV5-1,TRBJ2-1,CAGSLLTGVGNEQFF,7,0,1,7
TRBV9,TRBJ2-1,CASSARDSYNEQFF,7,0,1,7
TRBV20-1,TRBJ2-7,CSARGDRGYYEQYF,7,0,1,7
TRBV29-1,TRBJ2-4,CSVRTGGRGNIQYF,7,0,1,7
TRBV6-1,TRBJ1-1,CASSELPNTEAFF,7,0,1,7
TRBV25-1,TRBJ2-1,CASKRSGNNEQFF,7,0,1,7
TRBV20-1,TRBJ2-5,CSAKLGLRETQYF,7,0,1,7
TRBV5-1,TRBJ2-7,CASSLGSYERYF,7,0,1,7
TRBV18,TRBJ2-1,CASSGTVHQGDQKSRYEQFF,6,0,1,6
TRBV24-1,TRBJ2-6,CATSDLERQQGSGANVLTF,6,0,1,6
TRBV7-2,TRBJ2-5,CASSLVAGVGTLGRGTQYF,6,0,1,6
TRBV19,TRBJ2-1,CASVDRHPNYNDQFF,6,0,1,6
TRBV19,TRBJ1-4,CASRPEGAQEKLFF,6,0,1,6
TRBV5-8,TRBJ2-1,CASSLLAMGNEQFF,6,0,1,6
TRBV19,TRBJ2-5,CARGEWTEQETQYF,6,0,1,6
TRBV12-3/4,TRBJ2-1,CASRRREGSEQFF,6,0,1,6
TRBV10-3,TRBJ1-4,CAISDGEKLFF,6,0,1,6
TRBV9,TRBJ2-2,CASERTGELFF,6,0,1,6
TRBV12-5,TRBJ2-3,CASGLVGGVPGTGVNTDTQYF,6,0,1,6
TRBV12-3/4,TRBJ2-3,CASSLGWDRTSNGKTDTQYF,6,3,2,9
TRBV4-2,TRBJ2-7,CASSQDKSRWLTFGGREQYF,6,6,2,12
TRBV12-5,TRBJ1-1,CASGPWSAGYSGVNTEAFF,6,0,1,6
TRBV27,TRBJ2-5,CASSLRVGSGLAGKETQYF,6,0,1,6
TRBV11-2,TRBJ1-1,CASSSLDPASTLPNTEAFF,6,0,1,6
TRBV12-3/4,TRBJ2-1,CASSPRGAYSRSSRNEQFF,6,0,1,6
TRBV7-3,TRBJ2-3,CASSPGPTGTGDRTDTQYF,6,6,2,12
TRBV7-8,TRBJ2-2,CASSTRTGGTGVGTGELFF,6,0,1,6
TRBV4-1,TRBJ2-4,CASSQDPLRTPIAKNIQYF,6,0,1,6
TRBV20-1,TRBJ2-3,CSARVPVGPNSQPTDTQYF,6,0,1,6
TRBV19,TRBJ2-6,CASSPSGTETLGANVLTF,6,0,1,6
TRBV19,TRBJ1-2,CASSKWRPDRGHLYGYTF,6,0,1,6
TRBV18,TRBJ1-1,CASSLSGQGNWANTEAFF,6,0,1,6
TRBV9,TRBJ2-3,CASVARDRGISSTDTQYF,6,0,1,6
TRBV6-2/3/5/6,TRBJ2-3,CASSYLPTSGSKSDTQYF,6,0,1,6
TRBV6-1,TRBJ1-6,CASSERDRGSSYNSPLHF,6,0,1,6
TRBV28,TRBJ2-2,CASSIFTLERLNTGELFF,6,0,1,6
TRBV5-6,TRBJ2-5,CASSFVVGAGDSGETQYF,6,0,1,6
TRBV7-6,TRBJ2-7,CASSLAGGRLAGSYEQYF,6,0,1,6
TRBV11-3,TRBJ2-5,CASSLGHLPSGTQETQYF,6,0,1,6
TRBV30,TRBJ2-1,CAWSVRGLAGVNNEQFF,6,0,1,6
TRBV10-3,TRBJ2-3,CAISDPHSGRARDTQYF,6,0,1,6
TRBV18,TRBJ2-3,CASSSIGPSKGTDTQYF,6,0,1,6
TRBV27,TRBJ2-1,CASSLSAAASSYNEQFF,9,0,1,9
TRBV28,TRBJ2-3,CASSTRRGGGVPDTQYF,6,0,1,6
TRBV5-4,TRBJ2-2,CASSFLSGSRDTGELFF,6,0,1,6
TRBV5-5,TRBJ1-5,CASSLSPGQVLEQPQHF,6,0,1,6
TRBV5-1,TRBJ2-3,CASSSRPGGPSTDTQYF,6,0,1,6
TRBV7-2,TRBJ2-7,CASSSGGLAGVQYEQYF,6,0,1,6
TRBV12-3/4,TRBJ2-3,CASSLSGGSGSQDTQYF,6,0,1,6
TRBV14,TRBJ2-1,CASSPRQREGPHNEQFF,6,0,1,6
TRBV7-3,TRBJ2-3,CASSRGQGEYPTDTQYF,6,0,1,6
TRBV14,TRBJ2-1,CASSQESRLPLYNEQFS,6,0,1,6
TRBV2,TRBJ1-1,CASSRGGRTGLTSLAFF,6,0,1,6
TRBV27,TRBJ2-1,CASRPGSGRVWANEQFF,6,0,1,6
TRBV5-1,TRBJ2-1,CASSIRTSGSPYNEQFF,6,0,1,6
TRBV20-1,TRBJ2-1,CSCGTSGGQSSYNEQFF,6,0,1,6
TRBV20-1,TRBJ2-5,CSASWQETLSTLETQYF,6,0,1,6
TRBV12-5,TRBJ2-1,CASGGSGSGAHNEQFF,6,0,1,6
TRBV19,TRBJ2-1,CASSMGYSGRANEQFF,6,0,1,6
TRBV19,TRBJ2-5,CASSTTYRDREETQYF,6,0,1,6
TRBV19,TRBJ2-3,CASSKRSSGNSDTQYF,6,0,1,6
TRBV19,TRBJ2-3,CASKGPSGGGVDTQYF,6,0,1,6
TRBV2,TRBJ1-3,CASGTLFGSSGNTIYF,6,0,1,6
TRBV28,TRBJ2-7,CASSLSGGGPTYEQYF,6,0,1,6
TRBV12-3/4,TRBJ2-6,CASSSSTGGRSNVLTF,6,0,1,6
TRBV6-2/3/5/6,TRBJ2-7,CASSYSNRPLSYEQYF,6,0,1,6
TRBV28,TRBJ2-3,CASSPSLSWATDTQYF,6,0,1,6
TRBV27,TRBJ2-3,CASSPGTSGSVDTQYF,6,0,1,6
TRBV2,TRBJ2-7,CASSGPGQGALHEQYF,6,0,1,6
TRBV2,TRBJ2-7,CASSDSGNRNSYEQYF,6,2,2,8
TRBV6-1,TRBJ2-3,CASSDKRRVNTDTQYF,6,0,1,6
TRBV2,TRBJ2-5,CASSELGGRAEETQYF,6,0,1,6
TRBV6-1,TRBJ1-5,CASSEAWGSINQPQHF,6,0,1,6
TRBV7-3,TRBJ2-3,CASSFRTTLAHVTQYF,6,0,1,6
TRBV5-6,TRBJ2-3,CASSLLAGGGTDTQYF,6,0,1,6
TRBV7-6,TRBJ2-1,CASSLGGRGRFNEQFF,6,0,1,6
TRBV7-6,TRBJ2-1,CASSLGILIHNNEQFF,6,0,1,6
TRBV25-1,TRBJ2-3,CASSLSEGSWADTQYF,6,0,1,6
TRBV7-2,TRBJ2-1,CASSLNPGGSYNEQFF,6,3,2,9
TRBV7-9,TRBJ1-1,CASSLNGYGRNAEAFF,6,0,1,6
TRBV7-9,TRBJ2-3,CASSPWTSGDTDTQYF,6,0,1,6
TRBV7-9,TRBJ2-1,CASSPRRVSSYNEQFF,6,0,1,6
TRBV3-1,TRBJ1-1,CASSHSQGGRGTEAFF,6,0,1,6
TRBV4-2,TRBJ2-1,CASSQESSSSYNEQFF,6,0,1,6
TRBV9,TRBJ2-1,CASSVEASGRVYEQFF,6,0,1,6
TRBV9,TRBJ2-2,CASSVETSWGAGELFF,6,0,1,6
TRBV6-2/3/5/6,TRBJ1-1,CASRPGTGVMNTEAFF,6,0,1,6
TRBV7-2,TRBJ2-1,CASRPGLAGGRNEQFF,6,0,1,6
TRBV2,TRBJ2-2,CASRADRRLGAGELFF,6,0,1,6
TRBV6-2/3/5/6,TRBJ2-7,CASRRKGQGFKYEQYF,6,0,1,6
TRBV10-2,TRBJ2-7,CASSMNLAGELDEQYF,6,0,1,6
TRBV5-1,TRBJ2-6,CASSLAPYSGANVLTF,6,0,1,6
TRBV5-1,TRBJ1-6,CASSSDTGNFYSPLHF,6,9,2,15
TRBV4-1,TRBJ2-1,CASSQVLTSGRQEQFF,6,0,1,6
TRBV5-1,TRBJ2-3,CASSDGTSGSTDTQYF,6,0,1,6
TRBV20-1,TRBJ1-1,CSARDHSGGRRWEAFF,6,0,1,6
TRBV29-1,TRBJ2-3,CSVVLGLAGRTDTQYF,6,0,1,6
TRBV28,TRBJ2-1,CAIKGQGGIMDEQFF,6,0,1,6
TRBV15,TRBJ2-1,CATSTGTSIYNEQFF,6,0,1,6
TRBV15,TRBJ2-3,CATSRGLDRVDTQYF,6,0,1,6
TRBV15,TRBJ2-3,CATSRDSGGPDTQYF,6,0,1,6
TRBV19,TRBJ1-3,CASRPKTGSGNTIYF,6,0,1,6
TRBV19,TRBJ2-5,CASMGLAAGQETQYF,6,0,1,6
TRBV19,TRBJ1-2,CASTLVAIRNYGYTF,6,0,1,6
TRBV19,TRBJ2-7,CASSSGTLSSYEQYF,6,0,1,6
TRBV19,TRBJ1-5,CASSIAPYSNQPQHF,6,12,2,18
TRBV19,TRBJ2-3,CASKETVGVTDTQYF,6,0,1,6
TRBV18,TRBJ2-2,CASSPFQGNTGELFF,6,0,1,6
TRBV18,TRBJ2-1,CASSPDRVGGNEQFF,6,0,1,6
TRBV18,TRBJ2-5,CASSPSQGWEETQYF,6,0,1,6
TRBV18,TRBJ1-2,CASSRERTGGYGYTF,6,0,1,6
TRBV6-2/3/5/6,TRBJ1-2,CASTLRRDSYYGYTF,6,4,2,10
TRBV12-3/4,TRBJ2-5,CASSFSGVRQETQYF,6,0,1,6
TRBV6-2/3/5/6,TRBJ2-6,CASSFRSSGANVLTF,6,0,1,6
TRBV12-3/4,TRBJ1-3,CASSLAPPSGNTIYF,6,0,1,6
TRBV7-3,TRBJ2-3,CASSSQPGGTDTQYF,6,0,1,6
TRBV6-2/3/5/6,TRBJ2-7,CASSSPQVLVYEQYF,6,0,1,6
TRBV6-2/3/5/6,TRBJ2-1,CASSYSGQGYNEQFF,6,0,1,6
TRBV6-2/3/5/6,TRBJ2-3,CASSYPDRGTDTQYF,6,0,1,6
TRBV28,TRBJ2-7,CASSPQPGLAYEQYF,6,0,1,6
TRBV6-2/3/5/6,TRBJ2-5,CASSQLAAIQETQYF,6,0,1,6
TRBV12-3/4,TRBJ2-1,CASSGPLGTRNEQFF,6,0,1,6
TRBV6-1,TRBJ1-4,CASSDGQAPNEKLFF,6,0,1,6
TRBV25-1,TRBJ2-7,CASSESYRGDLEQYF,6,0,1,6
TRBV6-2/3/5/6,TRBJ1-1,CASSTWGTPATEAFF,6,0,1,6
TRBV28,TRBJ2-7,CASSTPGSAGHEQYF,6,0,1,6
TRBV2,TRBJ2-7,CASSKEGTGAYEQYF,6,0,1,6
TRBV7-9,TRBJ2-5,CASSLAGGERDDQYF,6,0,1,6
TRBV7-9,TRBJ2-7,CASSLADYFTSEQYF,6,0,1,6
TRBV11-2,TRBJ2-4,CASSLGAIAKNIQYF,6,0,1,6
TRBV5-5,TRBJ2-5,CASSSSRTGRETQYF,6,0,1,6
TRBV7-2,TRBJ2-3,CASSWQGYPLDTQYF,6,0,1,6
TRBV5-4,TRBJ2-5,CASSLSGSPQETQYF,6,0,1,6
TRBV7-8,TRBJ2-1,CASSLGAADYNEQFF,6,0,1,6
TRBV11-1,TRBJ2-5,CASSPLADYQETQYF,6,0,1,6
TRBV7-2,TRBJ2-3,CASSPDSLGTDTQYF,6,0,1,6
TRBV3-1,TRBJ2-1,CASSQLAGGSGEQFF,6,0,1,6
TRBV11-2,TRBJ1-4,CASSQGDRENEKLFF,6,0,1,6
TRBV4-2,TRBJ2-7,CASSQDLAGSYEQYF,6,0,1,6
TRBV11-2,TRBJ2-3,CASSEGLLITDTQYF,6,0,1,6
TRBV28,TRBJ2-3,CASSIRQGSTDTQYF,6,0,1,6
TRBV2,TRBJ2-5,CASRGGGPYQETQYF,6,0,1,6
TRBV11-2,TRBJ2-1,CASRKPGSSYNEQFF,6,0,1,6
TRBV11-2,TRBJ2-3,CASNRGSGRADTQYF,6,0,1,6
TRBV5-1,TRBJ2-5,CASSPDRAGEETQCF,6,0,1,6
TRBV4-1,TRBJ2-7,CASSQAFASGDEQYF,6,0,1,6
TRBV5-1,TRBJ1-4,CASSVDRVTNEKLFF,6,0,1,6
TRBV5-1,TRBJ1-2,CASSEGSGGYYGYTF,6,0,1,6
TRBV5-1,TRBJ2-3,CASRSSPVDTDTQYF,6,0,1,6
TRBV20-1,TRBJ2-7,CSASQGQRGSYEQYF,6,0,1,6
TRBV20-1,TRBJ2-5,CSAPSRGQLQETQYF,6,0,1,6
TRBV20-1,TRBJ2-1,CSARTSGRATDEQFF,6,0,1,6
TRBV20-1,TRBJ1-2,CSAIPFRQGPTGYTF,6,0,1,6
TRBV20-1,TRBJ2-1,CSATQRRSVINEQFF,6,0,1,6
TRBV20-1,TRBJ2-1,CSASIGTSSYNEQFF,6,0,1,6
TRBV20-1,TRBJ2-1,CSARLIAGDPNEQFF,6,0,1,6
TRBV20-1,TRBJ1-5,CSARDSGRGHQPQHF,6,0,1,6
TRBV20-1,TRBJ2-6,CSARDRITGANVLTF,6,0,1,6
TRBV29-1,TRBJ2-1,CSVTPGLAGGNEQFF,6,0,1,6
TRBV5-6,TRBJ2-5,RASSPGAGRRETQYF,6,0,1,6
TRBV7-6,TRBJ1-6,CASSLAGGNSPLHF,6,0,1,6
TRBV10-3,TRBJ2-3,CAISPGTDQDTQYF,6,0,1,6
TRBV24-1,TRBJ2-1,CATAGTRGNNEQFF,6,0,1,6
TRBV24-1,TRBJ2-1,CATRGRPGSGEQFF,6,0,1,6
TRBV19,TRBJ1-2,CASSEDRGWYGYTF,6,0,1,6
TRBV19,TRBJ2-1,CASRELAEHNEQFF,6,0,1,6
TRBV19,TRBJ2-7,CASRRTSGISEQYF,6,12,2,18
TRBV18,TRBJ2-5,CASSPPGLYQTQYF,6,0,1,6
TRBV18,TRBJ1-6,CASSQREGNSPLHF,6,0,1,6
TRBV28,TRBJ2-3,CASVPGTLPGTQYF,6,0,1,6
TRBV7-2,TRBJ1-4,CASGRVTPNEKLFF,6,0,1,6
TRBV7-9,TRBJ2-6,CASTSLSGANVLTF,6,0,1,6
TRBV12-3/4,TRBJ2-7,CASSFSGAKGEQYF,6,0,1,6
TRBV28,TRBJ2-5,CASSFLSTEETQYF,6,0,1,6
TRBV27,TRBJ1-4,CASSLFADNEKLFL,6,0,1,6
TRBV6-2/3/5/6,TRBJ1-5,CASSYRDRYQPQHF,6,0,1,6
TRBV12-3/4,TRBJ2-1,CASSRTEISNEQFF,6,0,1,6
TRBV6-1,TRBJ2-3,CASSVGPEGDTQYF,6,0,1,6
TRBV2,TRBJ2-4,CASSEEVGKNIQYF,6,3,2,9
TRBV2,TRBJ2-7,CASSENRGQGEQYF,6,0,1,6
TRBV5-4,TRBJ2-5,CASSLVSGGETQYF,6,0,1,6
TRBV7-2,TRBJ2-3,CASSLVSGPDTQYF,6,0,1,6
TRBV7-2,TRBJ2-1,CASSLAGSDNEQFF,6,0,1,6
TRBV11-2,TRBJ2-1,CASSLGQGYGEQFF,6,0,1,6
TRBV7-2,TRBJ2-5,CASSSSRPQGTQYF,6,0,1,6
TRBV5-4,TRBJ2-2,CASSSDRGTGELFF,6,0,1,6
TRBV28,TRBJ2-7,CASSLPPPPYEQYF,6,0,1,6
TRBV4-2,TRBJ2-5,CASSLDLGEETQYF,6,0,1,6
TRBV7-2,TRBJ2-7,CASSPTSGRLEQYF,6,0,1,6
TRBV5-4,TRBJ2-5,CASSRQGAGETQYF,6,0,1,6
TRBV7-2,TRBJ2-4,CASSREVVENIQYF,6,0,1,6
TRBV3-1,TRBJ2-6,CASSHPSGANVLTF,6,0,1,6
TRBV3-1,TRBJ2-5,CASSQRGARETQYF,6,0,1,6
TRBV3-1,TRBJ2-7,CASSQGISPGEQYF,6,0,1,6
TRBV3-1,TRBJ2-7,CASSQDWGGSEQYF,6,0,1,6
TRBV6-2/3/5/6,TRBJ1-6,CASSDWGGNSPLHF,6,0,1,6
TRBV12-3/4,TRBJ1-1,CASSSDRGGTEAFF,6,0,1,6
TRBV28,TRBJ2-7,CASRSRGPTYEQYF,6,0,1,6
TRBV6-2/3/5/6,TRBJ2-5,CASRGGGSVKTQYF,6,0,1,6
TRBV10-3,TRBJ2-2,CASRRHPNTGELFF,6,0,1,6
TRBV12-3/4,TRBJ2-1,CASNLGRSYNEQFF,6,0,1,6
TRBV2,TRBJ1-1,CASNKGLLNPEAFF,6,0,1,6
TRBV2,TRBJ2-7,CARGGPGQPYEQYF,6,6,2,12
TRBV19,TRBJ2-5,CDSRLRAGRETQYF,6,0,1,6
TRBV5-1,TRBJ2-7,CASARGVPAYEQHF,6,0,1,6
TRBV5-1,TRBJ2-1,CASAGTSGSNEQFF,6,0,1,6
TRBV10-2,TRBJ2-5,CASSRETGRETQYF,6,0,1,6
TRBV5-1,TRBJ2-3,CASSLYLSSGTQYF,6,0,1,6
TRBV5-1,TRBJ2-7,CASSSAGVANEQYF,6,0,1,6
TRBV5-1,TRBJ2-1,CASSPGTSANEQFF,6,0,1,6
TRBV4-1,TRBJ2-7,CASSQEGLVDEQYF,6,0,1,6
TRBV5-1,TRBJ2-2,CASRISGDTGELFF,6,0,1,6
TRBV20-1,TRBJ2-3,CSSRQAKMTDTQYF,6,0,1,6
TRBV20-1,TRBJ2-7,CSALRPSATYEQYF,6,0,1,6
TRBV20-1,TRBJ1-5,CSAGPDRGDQPQHF,6,0,1,6
TRBV20-1,TRBJ2-1,CSATGTTGGKGQFF,6,0,1,6
TRBV20-1,TRBJ2-7,CSASVSSGAYEQYF,6,0,1,6
TRBV20-1,TRBJ2-1,CSASPGLADNEQFF,6,0,1,6
TRBV20-1,TRBJ2-6,CSASGGSGANVLTF,6,0,1,6
TRBV20-1,TRBJ2-3,CSARGGVATDTQYF,6,2,2,8
TRBV20-1,TRBJ2-5,CSARLDRGRETQYF,6,9,2,15
TRBV20-1,TRBJ2-1,CSEVGGTELNEQFF,6,0,1,6
TRBV29-1,TRBJ2-1,CSVVRGWFYNEQFF,6,0,1,6
TRBV29-1,TRBJ2-1,CSVERLAGGNEQFF,6,0,1,6
TRBV29-1,TRBJ2-7,CSVESGQGTYEQYF,6,0,1,6
TRBV29-1,TRBJ2-2,CSVEGGNDTGELFS,6,0,1,6
TRBV29-1,TRBJ2-5,CSVGGQGGGETQYF,6,4,2,10
TRBV29-1,TRBJ2-1,CSVIQRSSYNEQFF,6,0,1,6
TRBV29-1,TRBJ2-1,CSAGQGASYNEQFF,6,0,1,6
TRBV12-5,TRBJ2-4,CASGSEPMDIQYF,6,0,1,6
TRBV7-9,TRBJ2-1,CAWGLAGGDEQFF,6,0,1,6
TRBV30,TRBJ2-7,CAWSLTRTYEQYF,6,0,1,6
TRBV28,TRBJ2-3,CATWTETTDTQYF,6,0,1,6
TRBV7-2,TRBJ2-5,CASNRDRQETQYF,6,0,1,6
TRBV18,TRBJ1-2,CASSPESNYGYTF,6,0,1,6
TRBV28,TRBJ2-3,CASWDSPSDTQYF,6,0,1,6
TRBV28,TRBJ2-3,CASSFRNADTQYF,6,0,1,6
TRBV12-3/4,TRBJ2-7,CASSFELAARQYF,6,0,1,6
TRBV12-3/4,TRBJ2-7,CASSFRELYEQYF,6,0,1,6
TRBV12-3/4,TRBJ2-1,CASSFGAIGEQFF,6,0,1,6
TRBV6-2/3/5/6,TRBJ2-1,CASSLSRYGEQFF,6,0,1,6
TRBV12-3/4,TRBJ1-1,CASSLGPNTEAFF,6,6,2,12
TRBV12-3/4,TRBJ2-7,CASSSSGSYEQYF,6,0,1,6
TRBV7-9,TRBJ1-1,CASSPNGNTEAFF,6,0,1,6
TRBV6-1,TRBJ2-3,CASSRAPLNTQYF,6,5,2,11
TRBV2,TRBJ2-1,CASSTSFEGEQFF,6,0,1,6
TRBV5-4,TRBJ1-2,CASSFGAGNGYTF,6,0,1,6
TRBV7-9,TRBJ1-2,CASSFDRGGGYTF,6,0,1,6
TRBV7-2,TRBJ1-5,CASSLWRDQPQHF,11,12,2,23
TRBV5-6,TRBJ2-1,CASSLGARNEQFF,6,0,1,6
TRBV7-2,TRBJ2-4,CASSLDRSNIQYF,6,0,1,6
TRBV7-2,TRBJ2-5,CASSLGSRTSQYF,6,0,1,6
TRBV11-2,TRBJ1-2,CASSLEANYGYTF,6,0,1,6
TRBV7-3,TRBJ2-7,CASSLNLAGEQYF,6,0,1,6
TRBV7-9,TRBJ1-5,CASSSHGNQPQHF,6,0,1,6
TRBV7-2,TRBJ2-1,CASSSHRAEEQFF,6,0,1,6
TRBV3-1,TRBJ2-1,CASSLRRGNEQFF,6,0,1,6
TRBV3-1,TRBJ2-1,CASSPQAFNEQFF,6,0,1,6
TRBV14,TRBJ1-4,CASSPRVDEKLFF,6,0,1,6
TRBV7-9,TRBJ1-2,CASSRGQNYGYTF,6,4,2,10
TRBV11-1,TRBJ2-3,CASSRTGTDTQYF,6,0,1,6
TRBV3-1,TRBJ2-7,CASSRLASYEQYF,6,0,1,6
TRBV5-4,TRBJ2-5,CASSVTSRETQYF,6,0,1,6
TRBV7-8,TRBJ2-5,CASSIGTSGTQYF,6,0,1,6
TRBV7-8,TRBJ2-3,CASSTTTVNPGYF,6,0,1,6
TRBV6-2/3/5/6,TRBJ2-7,CASRSTQANEQYF,6,0,1,6
TRBV2,TRBJ1-5,CASRLGEDQPQHF,6,0,1,6
TRBV6-2/3/5/6,TRBJ2-5,CASRRRVQETQYF,6,0,1,6
TRBV6-2/3/5/6,TRBJ2-2,CASRIQGTGELFF,6,0,1,6
TRBV5-1,TRBJ2-5,CASSFAGQETQYF,6,0,1,6
TRBV5-1,TRBJ2-1,CASSFLAGDEQFF,6,0,1,6
TRBV20-1,TRBJ2-3,CSAQTLLTDTQYF,6,0,1,6
TRBV20-1,TRBJ1-5,CSAAAIPNQPQHF,6,0,1,6
TRBV20-1,TRBJ2-5,CSASQAGRETQYF,6,0,1,6
TRBV20-1,TRBJ2-7,CSANSPVTYEQYF,6,0,1,6
TRBV29-1,TRBJ1-1,CSFVETVNTEAFF,6,0,1,6
TRBV29-1,TRBJ1-1,CSVSTGAGAEAFF,6,0,1,6
TRBV29-1,TRBJ2-6,CSVVQGGANVLTF,6,0,1,6
TRBV29-1,TRBJ1-5,CSVVTTLNQPQHF,6,0,1,6
TRBV29-1,TRBJ2-7,CSVARGDLPEQYF,6,0,1,6
TRBV29-1,TRBJ2-7,CSVEGGRNYEQYF,6,0,1,6
TRBV29-1,TRBJ2-7,CSVGVRVKDEQYF,6,0,1,6
TRBV20-1,TRBJ2-7,CSAIRDGSYEQYF,6,0,1,6
TRBV29-1,TRBJ2-5,CSAPRQGEETQYF,6,0,1,6
TRBV29-1,TRBJ2-7,CSAATAQPYEQYF,6,0,1,6
TRBV6-2/3/5/6,TRBJ2-5,YASSPGLSETQYF,6,0,1,6
TRBV12-3/4,TRBJ1-1,GASSFSANTEAFF,6,0,1,6
TRBV24-1,TRBJ2-1,CATSDRTSEQFF,6,0,1,6
TRBV18,TRBJ1-2,CASSSMGMGYTF,6,0,1,6
TRBV18,TRBJ2-1,CASSPRDREQFF,6,0,1,6
TRBV9,TRBJ2-7,CASIDRPYEQYF,6,0,1,6
TRBV6-2/3/5/6,TRBJ2-2,CASTAGAGELFF,6,0,1,6
TRBV28,TRBJ2-5,CASSLSQETQYF,6,0,1,6
TRBV28,TRBJ1-2,CASSYGEYGYTF,6,0,1,6
TRBV12-3/4,TRBJ2-5,CASSGAGETQYF,6,0,1,6
TRBV6-4,TRBJ2-3,CASSDSTDTQYF,6,0,1,6
TRBV6-4,TRBJ2-7,CASSDYLGVQYF,6,0,1,6
TRBV6-2/3/5/6,TRBJ2-5,CASSTTRETQYF,6,0,1,6
TRBV7-9,TRBJ2-7,CASSLAVGEQYF,6,15,2,21
TRBV3-1,TRBJ2-2,CASSYSVGELFF,6,0,1,6
TRBV12-3/4,TRBJ2-4,CASSHVENIQYF,6,0,1,6
TRBV5-4,TRBJ2-1,CASSVYHNEQFF,6,0,1,6
TRBV6-2/3/5/6,TRBJ2-1,CASNPGTNEQFF,6,0,1,6
TRBV20-1,TRBJ2-3,CAGAGNTDTQYF,6,8,2,14
TRBV20-1,TRBJ2-4,CSARTGENIQYF,6,0,1,6
TRBV29-1,TRBJ2-1,CSVTSGNNEQFF,6,0,1,6
TRBV29-1,TRBJ2-4,CSVAGQSNIQYF,6,0,1,6
TRBV29-1,TRBJ2-1,CSVGLADNEQFF,6,0,1,6
TRBV29-1,TRBJ2-5,CSATGDRETQYF,6,0,1,6
TRBV29-1,TRBJ1-5,CSARDSNQPQHF,6,0,1,6
TRBV7-9,TRBJ2-7,CASGGAHEQYF,6,0,1,6
TRBV14,TRBJ2-6,CASGGANVLTF,6,0,1,6
TRBV28,TRBJ2-5,CASTSGTWQYF,6,0,1,6
TRBV12-3/4,TRBJ1-2,CASTLQGGYTF,6,0,1,6
TRBV7-9,TRBJ2-5,CASSFRGTQYF,6,0,1,6
TRBV5-4,TRBJ2-1,CASSLSREQFF,6,0,1,6
TRBV11-2,TRBJ2-1,CASSLEGIQFF,6,0,1,6
TRBV7-9,TRBJ2-1,CASSNRDHPVI,6,0,1,6
TRBV29-1,TRBJ1-2,CSVVSFYGYTF,6,0,1,6
TRBV29-1,TRBJ2-5,CSVGEVRTQYF,6,0,1,6
TRBV7-3,TRBJ1-4,RASSYAEKLFF,6,0,1,6
TRBV28,TRBJ2-7,CASGQYEQYF,6,0,1,6
TRBV7-2,TRBJ2-1,CASSANEQFF,6,18,2,24
TRBV29-1,TRBJ2-5,CSVESETQYF,6,0,1,6
TRBV29-1,TRBJ1-1,CSVSGTKAFF,6,0,1,6
TRBV28,TRBJ2-7,CASRRAPGHRLWYERYF,6,0,1,6
TRBV14,TRBJ2-1,CAGSQGSWTSRFEQIF,6,0,1,6
TRBV5-6,TRBJ1-5,CASSFWGRSSNQPQHF,6,0,1,6
TRBV3-1,TRBJ2-7,CASSQVGDTSSYEQYF,6,0,1,6
TRBV19,TRBJ2-2,CASSQGGGSKGELFF,6,0,1,6
TRBV18,TRBJ2-7,CASSAMGTSSGEQYF,6,0,1,6
TRBV12-3/4,TRBJ2-7,CASSFGSGSSYEQYF,6,0,1,6
TRBV9,TRBJ2-7,CASSVEPARTYEQYF,6,0,1,6
TRBV20-1,TRBJ2-1,CSASAGTSINNERFF,6,0,1,6
TRBV6-2/3/5/6,TRBJ1-1,CASSYRLNTEAFF,6,0,1,6
TRBV28,TRBJ2-1,CASTRTTFEQFF,6,0,1,6
TRBV14,TRBJ2-2,CASSQPPGSERNTGELFF,5,0,1,5
TRBV6-2/3/5/6,TRBJ2-7,CASSPGRDRGIYEQYF,5,0,1,5
TRBV6-2/3/5/6,TRBJ2-3,CASSLTGTVSTDTQYF,5,0,1,5
TRBV6-1,TRBJ1-1,CASSELGEADTEAFF,5,0,1,5
TRBV6-2/3/5/6,TRBJ2-1,CASSPGLAGDHEQFF,5,0,1,5
TRBV7-9,TRBJ2-7,CASSQRQGLSYEQYF,5,0,1,5
TRBV9,TRBJ1-3,CASSARGSSGNTIYF,5,0,1,5
TRBV19,TRBJ2-7,CGSSPPLTGAGEQYF,5,0,1,5
TRBV7-9,TRBJ2-7,CASSLSASGFEQYF,5,0,1,5
TRBV7-9,TRBJ2-3,CASSLARLGDTQYF,5,0,1,5
TRBV5-5,TRBJ2-7,CASSSPGRGYEQYY,5,0,1,5
TRBV5-1,TRBJ2-3,CASSLETRADTQYF,5,0,1,5
TRBV11-2,TRBJ1-1,CASSLTGQSTEAFF,5,0,1,5
TRBV28,TRBJ2-4,CASGTSDKNIQYY,5,0,1,5
TRBV18,TRBJ2-7,CASSPGPIYEQYF,5,0,1,5
TRBV12-3/4,TRBJ2-7,CASSRGSSYEQYF,5,0,1,5
TRBV5-1,TRBJ2-1,CASGSGGRTEQFF,5,0,1,5
TRBV5-1,TRBJ2-1,CASSFEGGGEQFF,5,0,1,5
TRBV29-1,TRBJ2-7,CSVEDPGDYEQYF,5,0,1,5
TRBV19,TRBJ2-1,CASPREQGTSGKAYTYNEQFF,5,0,1,5
TRBV6-2/3/5/6,TRBJ2-1,CASSYLLAGTSGSRPYNEQFF,5,0,1,5
TRBV6-1,TRBJ2-1,CASSEREGQRSLVLRPGEQFY,5,0,1,5
TRBV19,TRBJ2-2,CASSRLQGWTSGNTGELVF,5,0,1,5
TRBV4-2,TRBJ2-2,CASSQAPGLAGPNTGELFF,5,0,1,5
TRBV12-5,TRBJ2-6,CASGIWGRTFSGANVLTF,5,0,1,5
TRBV19,TRBJ2-3,CASSIDPLRRISTDTQYF,5,0,1,5
TRBV7-9,TRBJ2-3,CASISQPIGTGRTDTQYF,5,0,1,5
TRBV28,TRBJ2-5,CASSLLTLRKQGRETQYF,5,0,1,5
TRBV27,TRBJ2-7,CASSLSESGTIVPYEQYF,5,0,1,5
TRBV28,TRBJ2-5,CASSLGTSLAGVGETQYF,5,5,2,10
TRBV7-2,TRBJ2-4,CASSSIPQGWGTKNIQYF,5,0,1,5
TRBV7-2,TRBJ2-7,CASSYRTSGPITSYEQYF,5,0,1,5
TRBV3-1,TRBJ2-5,CASSQDSALAGDQETQYL,5,0,1,5
TRBV20-1,TRBJ2-1,CSASLPGSGTFSYNEQFF,5,0,1,5
TRBV20-1,TRBJ2-3,CSARLLVVAARQRDTQYF,5,0,1,5
TRBV15,TRBJ2-7,CATSRDLRASGTHEQYF,5,0,1,5
TRBV19,TRBJ2-3,CASSYSGRATYVDTQYF,5,0,1,5
TRBV19,TRBJ1-1,CASSPQGQGFMNTEAFF,5,0,1,5
TRBV19,TRBJ1-5,CASSIGPQGASNQPQHF,5,0,1,5
TRBV19,TRBJ2-5,CASSMSLRERKGETQYF,5,0,1,5
TRBV18,TRBJ2-1,CASSPTVGIAGDNEQFF,5,0,1,5
TRBV28,TRBJ2-1,CASTSSGRIQSYNEQFF,5,0,1,5
TRBV12-3/4,TRBJ2-2,CASSSKLAGVMGGELFF,5,0,1,5
TRBV28,TRBJ2-1,CASSLHLGGPTNNEQFF,5,0,1,5
TRBV25-1,TRBJ2-1,CASSEWERPSSYNEQFF,5,0,1,5
TRBV6-1,TRBJ2-1,CASSEWERPSSYNEQSF,5,0,1,5
TRBV5-6,TRBJ2-7,CASSFRAAGTESYEQYF,5,0,1,5
TRBV11-1,TRBJ2-1,CASSFSSGGFEYNEQFF,5,0,1,5
TRBV13,TRBJ2-1,CASSFGLAGGSYNEQFF,5,0,1,5
TRBV7-2,TRBJ2-4,CASSLRQGLLAKNIQYF,5,0,1,5
TRBV7-9,TRBJ2-5,CASSLARFGTPGETQYF,5,0,1,5
TRBV7-9,TRBJ2-7,CASSLRLAGVRVYEQYF,5,0,1,5
TRBV7-6,TRBJ2-1,CASSLRTAVGPYNEQFF,5,0,1,5
TRBV7-2,TRBJ2-7,CASSSFRAGTPTYEQYF,5,0,1,5
TRBV7-6,TRBJ2-1,CASSPRRGGGLYNEQFF,5,5,2,10
TRBV7-6,TRBJ2-1,CASSPGVSGRAYNEQFF,5,0,1,5
TRBV7-9,TRBJ2-7,CASSPTGQGGKNYEQYF,5,0,1,5
TRBV14,TRBJ2-3,CASSQDLAGGSADTQYF,5,0,1,5
TRBV3-1,TRBJ2-5,CASSQDRDRGSQETQYF,5,0,1,5
TRBV9,TRBJ2-5,CASSVGLAGGGQETQYF,5,0,1,5
TRBV7-2,TRBJ2-1,CASSGRGVAGGGNEQFF,5,0,1,5
TRBV5-1,TRBJ2-7,CASGGLAGGPLDYEQYF,5,0,1,5
TRBV5-1,TRBJ2-3,CASSLATAGGPEDTQYF,5,0,1,5
TRBV5-1,TRBJ2-7,CASSLGLGRTSPIEQYF,5,0,1,5
TRBV5-1,TRBJ2-1,CASSPGRGQGSYNEQFF,5,0,1,5
TRBV20-1,TRBJ2-5,CSAPRTSGSFAGETQYF,5,0,1,5
TRBV29-1,TRBJ2-2,CSVVGGGTSEDTGELFF,5,0,1,5
TRBV29-1,TRBJ2-1,CSVEGPGTSLEYNEQFF,5,0,1,5
TRBV12-5,TRBJ2-3,CASGLASGRATDTQYF,5,0,1,5
TRBV10-3,TRBJ1-6,CAIRPGTGAYNSPLHF,5,5,2,10
TRBV24-1,TRBJ2-2,CATSDATSGWTGELFF,5,0,1,5
TRBV15,TRBJ2-3,CATSSGTSPSTDTQYF,5,0,1,5
TRBV15,TRBJ2-6,CATSRHFGAGANVLTF,5,0,1,5
TRBV19,TRBJ2-3,CASALGPGTGDWGQYF,5,0,1,5
TRBV19,TRBJ1-5,CASSPRQRTNNQPQHF,5,0,1,5
TRBV19,TRBJ2-5,CASSPSGLRGQETQYF,5,0,1,5
TRBV19,TRBJ2-1,CASSIVSAEPYNEQFF,5,25,2,30
TRBV19,TRBJ2-1,CASSIETTSGRGEQFF,5,0,1,5
TRBV19,TRBJ2-7,CASSTGLAGGTYEQYF,5,3,2,8
TRBV19,TRBJ2-1,CASSSSGSAPYNEQFF,5,0,1,5
TRBV19,TRBJ1-5,CASSRARTGDNQPQHF,5,0,1,5
TRBV18,TRBJ2-3,CASSPLNMGSTDTQYF,5,0,1,5
TRBV18,TRBJ1-1,CASSPLSEGVNTEAFF,5,0,1,5
TRBV18,TRBJ2-6,CASSPPGISGANVLTF,5,0,1,5
TRBV18,TRBJ1-3,CASSPPGESSGNTIYF,5,0,1,5
TRBV2,TRBJ2-1,CASTLEPGQGFVGLIF,5,0,1,5
TRBV6-2/3/5/6,TRBJ2-5,CASSFTSGSIRETQYF,5,0,1,5
TRBV28,TRBJ2-3,CASSLMGRASGSGTDF,5,0,1,5
TRBV6-2/3/5/6,TRBJ2-1,CASSSPLAGDLIEQFF,5,0,1,5
TRBV6-2/3/5/6,TRBJ2-1,CASSSQLADIYNEQFF,5,0,1,5
TRBV12-3/4,TRBJ1-6,CASSPKDRGRNSPLHF,5,0,1,5
TRBV25-1,TRBJ2-3,CASSAQGGLGTDTQYF,5,0,1,5
TRBV27,TRBJ2-2,CASSTYRGPVPGELFF,5,0,1,5
TRBV7-9,TRBJ2-3,CASSFTSRGEADTQYF,5,0,1,5
TRBV5-4,TRBJ2-1,CASSFRTSGSGNEQFF,5,0,1,5
TRBV5-4,TRBJ2-3,CASSLAGRGSTDTQYF,5,3,2,8
TRBV5-6,TRBJ2-2,CASSLATGVNTGELFF,5,0,1,5
TRBV11-2,TRBJ2-2,CASSLFGGEVTGELFF,5,0,1,5
TRBV11-2,TRBJ2-1,CASSLVGGGRGNEQFF,5,0,1,5
TRBV13,TRBJ2-7,CASSLGRDGSIFEQYF,5,0,1,5
TRBV11-2,TRBJ1-1,CASSLEWGASRTEAFF,5,0,1,5
TRBV9,TRBJ2-3,CASSLRRQGVTDTQYF,5,0,1,5
TRBV7-2,TRBJ2-3,CASSPLSGTVTDTRYF,5,0,1,5
TRBV5-6,TRBJ2-1,CASSPLSGSSYNEQFF,5,0,1,5
TRBV7-6,TRBJ2-3,CASSRRGQGAGNTQYF,5,0,1,5
TRBV7-9,TRBJ2-5,CASSRRLGNTKETQYF,5,0,1,5
TRBV14,TRBJ2-2,CASSHLQGASTGELFF,5,0,1,5
TRBV3-1,TRBJ2-1,CASSQGEGWKSDEQFF,5,0,1,5
TRBV4-2,TRBJ1-1,CASSQDYRQGNTEAFF,5,0,1,5
TRBV14,TRBJ2-1,CASSQDPREPRNEQFF,5,0,1,5
TRBV14,TRBJ2-2,CASSQERVKNTGELFF,5,2,2,7
TRBV5-6,TRBJ2-2,CASSKVAGEYTGELFF,5,0,1,5
TRBV2,TRBJ2-1,CASREGVWESGNEQFF,5,0,1,5
TRBV2,TRBJ2-1,CASRPGLDTGVGEQFF,5,0,1,5
TRBV10-2,TRBJ2-2,CASSRNGGTNTGELFF,5,0,1,5
TRBV5-1,TRBJ2-1,CASSFGGASSYNEQFF,5,0,1,5
TRBV5-1,TRBJ2-7,CASSLGSGGRGYEQYF,5,0,1,5
TRBV11-3,TRBJ2-1,CASSLGTSGGYNEQFF,5,3,2,8
TRBV5-1,TRBJ1-1,CASSLESGQGNTEAFF,5,0,1,5
TRBV5-1,TRBJ2-5,CASSLTSQPDRETQYF,5,0,1,5
TRBV5-1,TRBJ1-1,CASSLYLTGWNTEAFF,5,11,2,16
TRBV5-1,TRBJ2-1,CASSLQGGSSYNEQYF,5,0,1,5
TRBV4-1,TRBJ1-5,CASSRGGVPGGQPQHF,5,0,1,5
TRBV5-1,TRBJ2-5,CASSTGQGGLQETQYF,5,0,1,5
TRBV20-1,TRBJ2-7,CSALDGRGGVRDVQYF,5,0,1,5
TRBV20-1,TRBJ2-1,CSASDPAAGGYNEQFF,5,0,1,5
TRBV20-1,TRBJ2-1,CSARDSGRALYNEQFF,5,0,1,5
TRBV20-1,TRBJ2-5,CSARAQVSIYQETQYF,5,0,1,5
TRBV20-1,TRBJ2-2,CSARDGGRGYTGELFF,5,0,1,5
TRBV20-1,TRBJ2-1,CSAREIGGRSYNEQFF,5,0,1,5
TRBV20-1,TRBJ2-5,CSAQSAWGDRQETQYF,5,0,1,5
TRBV20-1,TRBJ2-1,CSATRTGSFVYNEQFF,5,0,1,5
TRBV29-1,TRBJ2-1,CSVEGVAGARGYEQFF,5,0,1,5
TRBV29-1,TRBJ2-6,CSVEEDGTAGANVLTF,5,3,2,8
TRBV29-1,TRBJ2-4,CSVSPWTGSPKNIQYF,5,14,2,19
TRBV7-3,TRBJ2-2,RASSPSGSMNTGELFF,5,0,1,5
TRBV11-2,TRBJ2-3,RASSSGTSQVTDTQYF,5,0,1,5
TRBV7-3,TRBJ2-7,RASSSGLAGGTYEQYF,5,0,1,5
TRBV10-3,TRBJ2-3,CAISAGTGDTDTQYF,5,0,1,5
TRBV15,TRBJ2-5,CATSRERAGQETQYF,5,0,1,5
TRBV19,TRBJ2-2,CASTPPGRNTGELFF,5,0,1,5
TRBV19,TRBJ1-1,CASTTRGFMNTEAFF,5,0,1,5
TRBV19,TRBJ2-6,CASSSGTSGANVLTF,5,0,1,5
TRBV19,TRBJ2-7,CASSSIEAGVFVQYF,5,0,1,5
TRBV19,TRBJ2-1,CASSTGTSGHNEQFF,5,0,1,5
TRBV19,TRBJ2-7,CASSNGDESSYEQYF,5,0,1,5
TRBV18,TRBJ1-6,CASSPGQGSNSPLHF,5,0,1,5
TRBV18,TRBJ2-5,CASSPPGQNKETQYF,5,6,2,11
TRBV18,TRBJ2-1,CASSPGLAVYNEQFF,5,0,1,5
TRBV18,TRBJ2-6,CASSPSWDSATPLTF,5,0,1,5
TRBV18,TRBJ2-7,CASSPRITDAYEQYF,5,0,1,5
TRBV18,TRBJ1-5,CASSPQGGGNQPQHF,5,0,1,5
TRBV5-4,TRBJ2-3,CASRRAGEKADTQYF,5,0,1,5
TRBV12-3/4,TRBJ2-1,CASIEGLAGANEQFF,5,0,1,5
TRBV7-9,TRBJ2-1,CASTSPGPKNNEQFF,5,2,2,7
TRBV7-8,TRBJ2-1,CASTLGRLSYNEQFF,5,0,1,5
TRBV12-3/4,TRBJ1-5,CASTRDRGSNQPQHF,5,0,1,5
TRBV2,TRBJ2-6,CASTDRDVGANVLTF,5,0,1,5
TRBV12-3/4,TRBJ1-3,CASSFGFDSGSTIYF,5,0,1,5
TRBV27,TRBJ1-5,CASSLSFRGVQPQHF,5,0,1,5
TRBV12-3/4,TRBJ2-1,CASSLGLAEGNEQFF,5,9,2,14
TRBV6-2/3/5/6,TRBJ2-5,CASSLGQGYQETQYF,5,0,1,5
TRBV27,TRBJ2-7,CASSLSSAGPYEQYF,5,0,1,5
TRBV6-2/3/5/6,TRBJ2-5,CASSLGGRAEETQYF,5,0,1,5
TRBV27,TRBJ2-1,CASSLEGTGVYEQFF,5,0,1,5
TRBV6-2/3/5/6,TRBJ2-1,CASSSLASGINEQFF,5,0,1,5
TRBV6-2/3/5/6,TRBJ2-1,CASSSSGTGGGEQFF,5,0,1,5
TRBV6-2/3/5/6,TRBJ2-3,CASSYWGDPSDTQYF,5,0,1,5
TRBV6-2/3/5/6,TRBJ1-4,CASSYRAAKIEKLFF,5,0,1,5
TRBV12-3/4,TRBJ1-5,CASSPSDRGNQPQHF,5,0,1,5
TRBV28,TRBJ2-1,CASSRTGGAHNEQFF,5,0,1,5
TRBV6-1,TRBJ1-5,CASSQDRGLGQPQHF,5,0,1,5
TRBV6-1,TRBJ2-5,CASSVGPPGWETQYF,5,0,1,5
TRBV2,TRBJ1-1,CASSAGRQMNTEAFF,5,0,1,5
TRBV6-1,TRBJ2-5,CASSADRARAETQYF,5,0,1,5
TRBV6-1,TRBJ2-3,CASSAGAHSTDTQYF,5,0,1,5
TRBV6-1,TRBJ1-2,CASSDGGAGSYGYTF,5,0,1,5
TRBV2,TRBJ2-7,CASSEVRHPLDEQYF,5,0,1,5
TRBV2,TRBJ2-7,CASSELGQGYYEQYF,5,0,1,5
TRBV28,TRBJ2-1,CASSIQTSGRRAQFF,5,2,2,7
TRBV28,TRBJ2-7,CASSIAGTGTYEQYF,5,0,1,5
TRBV7-9,TRBJ2-1,CASSFGLAVINEQFF,5,0,1,5
TRBV5-5,TRBJ2-1,CASSLLRLASHEQFF,5,0,1,5
TRBV7-2,TRBJ2-2,CASSLVRASTGELFF,5,0,1,5
TRBV7-2,TRBJ2-5,CASSLAPTGVETQYF,5,0,1,5
TRBV5-8,TRBJ2-7,CASSLGTLHSYEQYF,5,0,1,5
TRBV7-9,TRBJ2-7,CASSLQGDRVNEQYF,5,0,1,5
TRBV7-9,TRBJ2-1,CASSLGDRAKGEQFF,5,0,1,5
TRBV11-2,TRBJ2-3,CASSLDRAGTDTQYF,5,0,1,5
TRBV11-3,TRBJ2-1,CASSSSGKVWNELFF,5,0,1,5
TRBV7-2,TRBJ2-5,CASSSTAGVGETQYF,5,0,1,5
TRBV5-4,TRBJ2-1,CASSYWTSGRDEQFF,5,0,1,5
TRBV7-2,TRBJ2-7,CASSLTGLAGAEQYF,5,0,1,5
TRBV7-2,TRBJ2-1,CASSPGSHSYNEQFF,5,0,1,5
TRBV9,TRBJ2-1,CASSPGLAWYNEQFF,5,0,1,5
TRBV14,TRBJ2-1,CASSQGDRGNDEQFF,5,0,1,5
TRBV14,TRBJ2-1,CASSQMRGAGNEQFF,5,0,1,5
TRBV14,TRBJ2-5,CASSQQNGRQETQYF,5,0,1,5
TRBV3-1,TRBJ2-7,CASSQAVWTDYEQYF,5,0,1,5
TRBV3-1,TRBJ1-2,CASSQGVPPRSGYTF,5,0,1,5
TRBV3-1,TRBJ2-1,CASSQDAGRYNEQFF,5,2,2,7
TRBV3-1,TRBJ2-7,CASSQDLTGLGEQYF,5,0,1,5
TRBV3-1,TRBJ2-2,CASSQETLSTGELFF,5,0,1,5
TRBV9,TRBJ1-1,CASSVNTGVNTEAFF,5,0,1,5
TRBV9,TRBJ2-3,CASSASVGRADTQYF,5,0,1,5
TRBV5-4,TRBJ1-2,CASSAGPTGSGGYTF,5,0,1,5
TRBV7-9,TRBJ1-1,CASSGRADTGAEAFF,5,0,1,5
TRBV7-2,TRBJ2-5,CASSGGWRGGETQYF,5,0,1,5
TRBV7-9,TRBJ1-1,CASSKNQGGDTEAFF,5,0,1,5
TRBV12-3/4,TRBJ2-5,CASRRLAGGRETQYF,5,0,1,5
TRBV6-2/3/5/6,TRBJ2-7,CASRARDRGPYEQYF,5,0,1,5
TRBV6-2/3/5/6,TRBJ2-1,CASRLAGGPGNEQFF,5,0,1,5
TRBV5-1,TRBJ2-1,CASSGPGKAYNEQFF,5,6,2,11
TRBV5-1,TRBJ2-2,CASATLAPRTGELFF,5,0,1,5
TRBV10-2,TRBJ2-5,CASSESSRVQETQYF,5,0,1,5
TRBV5-1,TRBJ2-2,CASSFGGIDTGELFF,5,0,1,5
TRBV5-1,TRBJ2-1,CASSLVPSNENEQFF,5,0,1,5
TRBV5-1,TRBJ2-3,CASSLVAGRTDTQYF,5,0,1,5
TRBV5-1,TRBJ1-1,CASSWDTKMNTEAFF,5,0,1,5
TRBV20-1,TRBJ2-3,CSAMASGRGTDTQYF,5,0,1,5
TRBV20-1,TRBJ2-5,CSARRDRGSQETQYF,5,0,1,5
TRBV20-1,TRBJ2-1,CSARSGSGRASEQFF,5,0,1,5
TRBV20-1,TRBJ1-1,CSARPPGGKDLPGCF,5,0,1,5
TRBV20-1,TRBJ2-7,CSARAPQGATDEQYF,5,0,1,5
TRBV20-1,TRBJ2-7,CSARDLAGLLNEQYF,5,0,1,5
TRBV20-1,TRBJ2-7,CSARDLGTGVLEQYF,5,0,1,5
TRBV20-1,TRBJ2-5,CSARDPAGNQETQYF,5,0,1,5
TRBV20-1,TRBJ2-1,CSARDGAGDQNEQFF,5,0,1,5
TRBV20-1,TRBJ1-1,CSAKGQGGKSTEAFF,5,0,1,5
TRBV20-1,TRBJ1-5,CSAPQGGGSNQPQHF,5,0,1,5
TRBV29-1,TRBJ2-1,CSSGGPSGSYNEQFF,5,0,1,5
TRBV29-1,TRBJ2-1,CSVLPGLASLNEQFF,5,0,1,5
TRBV29-1,TRBJ1-5,CSVGDGLLGNQPQHF,5,0,1,5
TRBV29-1,TRBJ2-7,CSVEDLGTGGSEQYF,5,0,1,5
TRBV29-1,TRBJ2-7,CSVGGQGQGAGEQYF,5,0,1,5
TRBV29-1,TRBJ2-3,CSVIGGSGTGDTQYF,5,0,1,5
TRBV29-1,TRBJ2-1,CRLRRLAGSYNEQFF,5,0,1,5
TRBV5-5,TRBJ2-1,RASSLLPDSYNEQFF,5,0,1,5
TRBV15,TRBJ2-5,CATSFAGGQETQYF,5,0,1,5
TRBV24-1,TRBJ2-7,CATSGRGVYDEQYF,5,0,1,5
TRBV15,TRBJ2-3,CATSRGGGGNTQYF,5,6,2,11
TRBV28,TRBJ2-5,CATKRGGAKGTQYF,5,0,1,5
TRBV19,TRBJ2-1,CASSPGLVGNEQFF,5,0,1,5
TRBV19,TRBJ2-1,CASSIRAGKDEQFF,5,0,1,5
TRBV18,TRBJ2-1,CASSLGRLNNEQFF,5,0,1,5
TRBV18,TRBJ2-5,CASSPNGVSETQYF,5,0,1,5
TRBV18,TRBJ2-5,CASSPPFPKETQYF,5,0,1,5
TRBV18,TRBJ2-5,CASSPGKTEETQYF,5,0,1,5
TRBV18,TRBJ1-2,CASSQMNGPSDYTF,5,0,1,5
TRBV3-1,TRBJ2-1,CASRGLAGGNEQFF,5,4,2,9
TRBV28,TRBJ1-5,CASHFGGVNQPQHF,5,0,1,5
TRBV6-2/3/5/6,TRBJ2-7,CASTRTSGSGEQYF,5,0,1,5
TRBV7-2,TRBJ2-5,CASTLGDRGETQYF,5,0,1,5
TRBV7-6,TRBJ2-7,CASTPGASGYEQYF,5,0,1,5
TRBV7-2,TRBJ1-3,CASTGGSSGTTIYF,5,0,1,5
TRBV27,TRBJ2-7,CASSFTSGPSEQYF,5,0,1,5
TRBV5-6,TRBJ2-1,CASSFSGARNEQFF,5,0,1,5
TRBV12-3/4,TRBJ2-1,CASSFLTVGNEQFF,5,0,1,5
TRBV6-2/3/5/6,TRBJ2-4,CASSLWGVKNIQYF,5,0,1,5
TRBV6-2/3/5/6,TRBJ2-7,CASSLWGQYYEQYF,5,0,1,5
TRBV12-3/4,TRBJ2-7,CASSLLPGSYEQYF,5,0,1,5
TRBV28,TRBJ2-7,CASSLTGLSYEQYF,5,0,1,5
TRBV12-3/4,TRBJ1-1,CASSSHQANTEAFF,5,0,1,5
TRBV6-2/3/5/6,TRBJ2-1,CASSYSQRENEQFF,5,0,1,5
TRBV6-2/3/5/6,TRBJ2-5,CASSYSVGPRAQYF,5,0,1,5
TRBV6-2/3/5/6,TRBJ2-1,CASSLRLAGYEQFF,5,0,1,5
TRBV2,TRBJ2-7,CASSPGQGSYEQYF,5,0,1,5
TRBV28,TRBJ2-7,CASSRYRFYYEQYF,5,0,1,5
TRBV28,TRBJ2-7,CASSARQISYEQYF,5,0,1,5
TRBV2,TRBJ2-6,CASSGISGANVLTF,5,0,1,5
TRBV2,TRBJ2-1,CASSDQGVHNEQFF,5,0,1,5
TRBV10-3,TRBJ1-1,CASSESYRTVEAFF,5,0,1,5
TRBV12-3/4,TRBJ2-7,CASSTRRVPYEQYF,5,0,1,5
TRBV7-2,TRBJ2-7,CASSFRQGVYEQYF,5,0,1,5
TRBV5-5,TRBJ2-4,CASSLASLLDIQYF,5,0,1,5
TRBV5-6,TRBJ2-1,CASSLAGTGNEQFF,5,0,1,5
TRBV7-2,TRBJ2-5,CASSLLTREETQYF,5,0,1,5
TRBV7-9,TRBJ1-3,CASSLAVSGNTIYF,5,0,1,5
TRBV11-2,TRBJ2-7,CASSLGGPCTEQYF,5,0,1,5
TRBV11-2,TRBJ1-1,CASSLETRNTEAFF,5,0,1,5
TRBV7-9,TRBJ2-5,CASSLSQGERAQYF,5,0,1,5
TRBV5-5,TRBJ1-6,CASSSDRGNSPLHF,5,0,1,5
TRBV7-6,TRBJ1-1,CASSYFEADTEAFF,5,0,1,5
TRBV11-2,TRBJ2-2,CASSYSIGPGELFF,5,0,1,5
TRBV28,TRBJ2-7,CASSPSGRSYEQYF,5,0,1,5
TRBV3-1,TRBJ2-1,CASSPPGRANEQFF,5,0,1,5
TRBV11-2,TRBJ1-1,CASSPSGGRIEAFF,5,0,1,5
TRBV11-2,TRBJ1-1,CASSPGALNTEAFF,5,0,1,5
TRBV5-4,TRBJ2-5,CASSPPGMRETQYF,5,0,1,5
TRBV7-2,TRBJ2-7,CASSPQGASHEQYF,5,0,1,5
TRBV14,TRBJ2-1,CASSHLTSYNEQFF,5,0,1,5
TRBV3-1,TRBJ2-7,CASSHRHSPYEQYF,5,0,1,5
TRBV3-1,TRBJ1-3,CASSQYRDGNTIYF,5,0,1,5
TRBV3-1,TRBJ2-1,CASSQQTFSNEQFF,5,0,1,5
TRBV4-2,TRBJ2-7,CASSQGSSGYEQYF,5,0,1,5
TRBV3-1,TRBJ2-7,CASSQGTGNYEQYF,5,0,1,5
TRBV6-2/3/5/6,TRBJ1-2,CASSVLQGLYGYTF,5,0,1,5
TRBV9,TRBJ2-2,CASSVAGSPGELFF,5,0,1,5
TRBV5-4,TRBJ2-3,CASSERAGSDTQYF,5,0,1,5
TRBV7-6,TRBJ2-2,CASSTGTFTGELFF,5,0,1,5
TRBV2,TRBJ1-4,CASSNPLSLEKQFF,5,0,1,5
TRBV7-9,TRBJ2-1,CASRSGLAINEQFF,5,0,1,5
TRBV6-2/3/5/6,TRBJ2-7,CASRGTRSSYEQYF,5,0,1,5
TRBV2,TRBJ2-2,CASRETGASGELFF,5,0,1,5
TRBV7-2,TRBJ2-2,CASRNRVGTGELFF,5,0,1,5
TRBV28,TRBJ2-7,CASRSGQNTYEQYF,5,0,1,5
TRBV5-6,TRBJ2-5,CASRLTKYQETQYF,5,0,1,5
TRBV6-2/3/5/6,TRBJ1-5,CASRAGFSNQPQHF,5,0,1,5
TRBV27,TRBJ1-2,CASRGGGLGYGYTF,5,0,1,5
TRBV5-1,TRBJ2-1,CASYPGTSNNEQFF,5,0,1,5
TRBV5-1,TRBJ2-2,CASRLAGSTGELFF,5,0,1,5
TRBV5-1,TRBJ2-7,CASTPGGIFYEQYF,5,0,1,5
TRBV5-1,TRBJ2-7,CASSLSLAGREQYF,5,0,1,5
TRBV5-1,TRBJ2-3,CASSSQGADDTQYF,5,5,2,10
TRBV5-1,TRBJ2-5,CASSSGTPTETQYF,5,0,1,5
TRBV5-1,TRBJ2-1,CASSPGLAGGEQFF,5,0,1,5
TRBV3-1,TRBJ2-3,CASSPRLEENTQYF,5,0,1,5
TRBV5-1,TRBJ2-5,CASSARSGGETQYF,5,0,1,5
TRBV5-1,TRBJ1-4,CASRQGGEGEKLFF,5,0,1,5
TRBV20-1,TRBJ1-1,CSAPDPNGNTEAFF,5,0,1,5
TRBV20-1,TRBJ2-5,CSASLEGAGETQYF,5,0,1,5
TRBV20-1,TRBJ2-7,CSARAGTSSSEQYF,5,0,1,5
TRBV20-1,TRBJ2-2,CSAREMTAAGELFF,5,0,1,5
TRBV20-1,TRBJ2-3,CSAPKSRGADTQYF,5,0,1,5
TRBV20-1,TRBJ2-6,CSAPREPGANVLTF,5,0,1,5
TRBV20-1,TRBJ2-5,CSAPPGTIKETQYF,5,0,1,5
TRBV20-1,TRBJ2-5,CSTTQGAGEETQYF,5,0,1,5
TRBV29-1,TRBJ2-6,CSVVSGAGANVLTF,5,0,1,5
TRBV29-1,TRBJ2-3,CSVALAASTDTQYF,5,0,1,5
TRBV29-1,TRBJ2-3,CSVDVSPSADTQYF,5,0,1,5
TRBV29-1,TRBJ2-4,CSVDIAGGGNIQYF,5,0,1,5
TRBV29-1,TRBJ2-1,CSVEAPGGNNEQFF,5,0,1,5
TRBV29-1,TRBJ1-1,CSVEGGGPPFAAFF,5,0,1,5
TRBV29-1,TRBJ2-2,CSVRETSNTGELFF,5,0,1,5
TRBV29-1,TRBJ1-2,CSVTDRGAIYGYTF,5,5,2,10
TRBV29-1,TRBJ2-5,CSAEAGRGQETQYF,5,0,1,5
TRBV29-1,TRBJ2-1,CSGGQSLSYNEQFF,5,0,1,5
TRBV29-1,TRBJ2-7,CSDAPGTSKYEQYF,5,0,1,5
TRBV18,TRBJ1-5,CVSSQDRGEPQHF,5,0,1,5
TRBV7-9,TRBJ1-2,CASNEGGNYGYTF,5,0,1,5
TRBV30,TRBJ2-3,CAWSGDSTDTQYF,5,0,1,5
TRBV10-3,TRBJ2-2,CALRDTNTGELFF,5,0,1,5
TRBV12-3/4,TRBJ2-5,CAIRSSGQETQYF,5,0,1,5
TRBV24-1,TRBJ2-1,CATSSRYLVEQFF,5,0,1,5
TRBV19,TRBJ2-7,CASSPGTVYEQYF,5,0,1,5
TRBV19,TRBJ1-2,CASSEGFGYGYTF,5,0,1,5
TRBV19,TRBJ2-2,CASSRTPPGELFF,5,12,2,17
TRBV19,TRBJ2-3,CASSVSGAGTQYF,5,0,1,5
TRBV19,TRBJ1-1,CASNLGGRTEAFF,5,0,1,5
TRBV18,TRBJ2-5,CASSPGDQETQYF,5,0,1,5
TRBV18,TRBJ2-2,CASSPTTTGELFF,5,0,1,5
TRBV7-6,TRBJ2-7,CASGLAGTYEQYF,5,0,1,5
TRBV7-2,TRBJ2-5,CASGTGPQETQYF,5,0,1,5
TRBV12-3/4,TRBJ2-7,CASTFSGAHEQYF,5,0,1,5
TRBV5-6,TRBJ1-2,CASTLGRSYGYTF,5,0,1,5
TRBV2,TRBJ2-3,CASTREQGDTQYF,5,0,1,5
TRBV6-2/3/5/6,TRBJ1-5,CASTDRRDQLQHF,5,0,1,5
TRBV6-2/3/5/6,TRBJ2-3,CASSFRPHHTQYF,5,0,1,5
TRBV6-2/3/5/6,TRBJ2-5,CASSLDRGETQYF,5,0,1,5
TRBV6-2/3/5/6,TRBJ1-2,CASSSEGRGGYTF,5,0,1,5
TRBV28,TRBJ2-3,CASSHYRSDTQYF,5,0,1,5
TRBV6-1,TRBJ2-7,CASSVDASYEQYF,5,0,1,5
TRBV25-1,TRBJ2-1,CASSVSGRNEQFF,5,0,1,5
TRBV5-5,TRBJ1-5,CASSFQGNQPQHF,5,0,1,5
TRBV5-4,TRBJ2-1,CASSLVSGGGLFF,5,0,1,5
TRBV5-4,TRBJ2-5,CASSLIFEETQYF,5,0,1,5
TRBV7-9,TRBJ2-7,CASSLVGGNEQFF,5,0,1,5
TRBV7-6,TRBJ2-1,CASSLVADNEQFF,5,0,1,5
TRBV7-2,TRBJ1-1,CASSLALAVEAFF,5,0,1,5
TRBV7-8,TRBJ2-1,CASSLAHYNEQFF,5,0,1,5
TRBV7-2,TRBJ1-5,CASSLDYDQPQHF,5,0,1,5
TRBV5-6,TRBJ2-5,CASSLSDQETQYF,5,0,1,5
TRBV12-3/4,TRBJ2-7,CASSLRGPYEQYF,5,2,2,7
TRBV13,TRBJ2-7,CASSPRGAYEQYF,5,0,1,5
TRBV27,TRBJ1-3,CASSPSFGNTIYF,5,0,1,5
TRBV14,TRBJ2-3,CASSRGLTDTQCF,5,0,1,5
TRBV11-2,TRBJ2-1,CASSRTRYNEQFF,5,0,1,5
TRBV7-9,TRBJ2-3,CASSRPGPDTQYF,5,0,1,5
TRBV3-1,TRBJ2-5,CASSQPGTETQYF,5,0,1,5
TRBV11-2,TRBJ2-5,CASSQQGWQTQYF,5,0,1,5
TRBV3-1,TRBJ2-1,CASSQDRYNEQFF,5,0,1,5
TRBV7-2,TRBJ1-5,CASSDRGNQPQHF,5,0,1,5
TRBV7-2,TRBJ2-3,CASSTRGADTQYF,5,4,2,9
TRBV12-3/4,TRBJ1-1,CASRESGNTEAFF,5,0,1,5
TRBV2,TRBJ1-1,CASRAEMNTEAFF,5,0,1,5
TRBV6-2/3/5/6,TRBJ2-3,CASKASGTDTQYF,5,0,1,5
TRBV10-1,TRBJ2-7,CASSESGDYEQYF,5,0,1,5
TRBV5-1,TRBJ2-7,CASSLVQSYEQYF,5,0,1,5
TRBV20-1,TRBJ2-7,CSASEGQSYEQYF,5,0,1,5
TRBV20-1,TRBJ2-7,CSARPFTKYEQYF,5,6,2,11
TRBV20-1,TRBJ1-3,CSARVGGGNTIYF,5,0,1,5
TRBV20-1,TRBJ2-1,CSAKWSGSDEQFF,5,0,1,5
TRBV20-1,TRBJ2-5,CSAPGGGQETQYF,5,0,1,5
TRBV20-1,TRBJ1-1,CSPTQGRDTEAFF,5,0,1,5
TRBV29-1,TRBJ2-1,CSVPSISYNEQFF,5,0,1,5
TRBV29-1,TRBJ2-7,CSVEGSGGNEQYF,5,0,1,5
TRBV29-1,TRBJ2-5,CSVETNNQETQYF,5,0,1,5
TRBV29-1,TRBJ2-1,CSVAGTPYNEQFF,5,0,1,5
TRBV29-1,TRBJ1-1,CSVLTGMNTEAFF,5,0,1,5
TRBV29-1,TRBJ2-3,CSGAQGWTDTQYF,5,0,1,5
TRBV10-3,TRBJ2-1,CAISNTGDEQFF,5,0,1,5
TRBV18,TRBJ1-5,CATRGENQPQHF,5,0,1,5
TRBV19,TRBJ1-1,CASSVRQTEAFF,5,0,1,5
TRBV19,TRBJ2-1,CASSPARNEQFF,5,0,1,5
TRBV3-1,TRBJ2-7,CASSNRGYEQYF,5,0,1,5
TRBV18,TRBJ2-3,CASSPSRDTQYF,5,0,1,5
TRBV7-9,TRBJ1-1,CASQARNTEAFF,5,0,1,5
TRBV2,TRBJ1-5,CASTRGNQPQHF,5,0,1,5
TRBV27,TRBJ2-5,CASSFHNGLQYF,5,0,1,5
TRBV2,TRBJ1-1,CASSGDIRIVFF,5,0,1,5
TRBV5-5,TRBJ2-1,CASSLPSNEQFF,5,0,1,5
TRBV6-2/3/5/6,TRBJ1-1,CASSLVRRGAFF,5,0,1,5
TRBV7-2,TRBJ2-3,CASSLGTDTQYF,5,0,1,5
TRBV7-9,TRBJ2-7,CASSLGGGEQYF,5,0,1,5
TRBV7-2,TRBJ2-7,CASSLELSEQYF,5,0,1,5
TRBV5-4,TRBJ2-7,CASSSSFYEQYF,5,6,2,11
TRBV7-9,TRBJ1-5,CASSSPGQPQHF,5,0,1,5
TRBV7-9,TRBJ1-5,CASSYGNQPQHF,5,20,2,25
TRBV3-1,TRBJ2-1,CASSPRDNEQFF,5,0,1,5
TRBV14,TRBJ2-7,CASSQGRNEQYF,5,0,1,5
TRBV7-9,TRBJ2-5,CASSQEQETQYF,5,0,1,5
TRBV7-6,TRBJ2-3,CASSEDSKTQYF,5,12,2,17
TRBV6-2/3/5/6,TRBJ2-5,CASRAGAETQYF,5,0,1,5
TRBV5-1,TRBJ2-1,CASSLEGTEQFF,5,0,1,5
TRBV5-1,TRBJ2-7,CASSLNSYEQYF,5,0,1,5
TRBV5-1,TRBJ2-7,CASSSQGNEQYF,5,0,1,5
TRBV5-1,TRBJ2-1,CASSLAGNEQFF,5,0,1,5
TRBV29-1,TRBJ2-5,CIVDRDQETQYF,5,0,1,5
TRBV20-1,TRBJ1-1,CSARAGNTEAFF,5,0,1,5
TRBV20-1,TRBJ1-3,CSARAGGNTIYF,5,0,1,5
TRBV29-1,TRBJ2-5,CSVSLEIETQYF,5,0,1,5
TRBV29-1,TRBJ1-2,CSVEEGRGGYTF,5,11,2,16
TRBV29-1,TRBJ2-7,CSVRDRTYEQYF,5,0,1,5
TRBV29-1,TRBJ2-5,CSVYRGLETQYF,5,11,2,16
TRBV30,TRBJ1-1,CAWRSTGRAFF,5,0,1,5
TRBV19,TRBJ1-1,CASTLAFEAFF,5,0,1,5
TRBV19,TRBJ2-5,CASTWRETQYF,5,0,1,5
TRBV19,TRBJ2-5,CASSIRETQYF,5,0,1,5
TRBV12-3/4,TRBJ2-7,CASSLSYEQYF,5,0,1,5
TRBV11-2,TRBJ2-7,CASSLGTGQYF,5,2,2,7
TRBV19,TRBJ2-4,CAVSGSNIQYF,5,0,1,5
TRBV5-1,TRBJ2-3,CASSPGQVQYF,5,0,1,5
TRBV20-1,TRBJ2-1,CSAYSRNEQFF,5,0,1,5
TRBV20-1,TRBJ1-1,CSARENTEAFF,5,2,2,7
TRBV29-1,TRBJ1-1,CSVGLNTEAFF,5,0,1,5
TRBV29-1,TRBJ2-1,CSVGLAGEQFF,5,0,1,5
TRBV7-9,TRBJ2-1,CASSLETEFF,5,0,1,5
TRBV12-3/4,TRBJ2-7,CASSLALRVGTSPRGFSYEQYF,4,0,1,4
TRBV24-1,TRBJ1-5,CATSDLGRPGQGNYSNQPQHF,4,0,1,4
TRBV11-2,TRBJ2-1,CASSLGTGLAGGYTGRNEQFF,4,0,1,4
TRBV5-1,TRBJ2-3,CASSSIGSSGRNYLSTDTQYF,4,0,1,4
TRBV29-1,TRBJ2-6,CSVEDPGETQVTRSGANVLTF,4,0,1,4
TRBV9,TRBJ2-1,CASSPSGLAGGGGDYNEQFF,4,0,1,4
TRBV5-1,TRBJ1-2,CASSLAPGFGSVKLDYGYTF,4,0,1,4
TRBV6-2/3/5/6,TRBJ2-1,CASIRDPSGSLSSYNEQFF,4,0,1,4
TRBV12-3/4,TRBJ2-3,CASSAGFIAGEGDTDTQYF,4,0,1,4
TRBV25-1,TRBJ2-1,CASSDSGQISGREYNEQFF,4,0,1,4
TRBV7-9,TRBJ1-3,CASSLSARPSTRSGNTIYF,4,0,1,4
TRBV7-9,TRBJ2-2,CASSREPRDYRRNTGELFF,4,0,1,4
TRBV14,TRBJ2-3,CASSQGQGLRQARTDTQYF,4,0,1,4
TRBV5-1,TRBJ2-6,CASSLTGQGYLSGANVLTF,4,0,1,4
TRBV10-3,TRBJ2-1,CAISESKAGKATHNEQFF,4,0,1,4
TRBV15,TRBJ2-1,CATSRDLTSGRRVNEQFF,4,0,1,4
TRBV19,TRBJ2-7,CASSLYSTGTSGRYEQYF,4,0,1,4
TRBV12-3/4,TRBJ2-7,CASSFPPGLAGGSYEQYF,4,0,1,4
TRBV28,TRBJ1-2,CASSSARGRGKNNYGYTF,4,0,1,4
TRBV11-1,TRBJ2-6,CASSLRGLAGSGANVLTF,4,0,1,4
TRBV5-6,TRBJ2-2,CASSSRLGPVSNTGELFF,4,0,1,4
TRBV3-1,TRBJ2-7,CASSQVLAGGPPTYGQYF,4,0,1,4
TRBV14,TRBJ2-5,CASSQGRAGGPRIETQYY,4,0,1,4
TRBV9,TRBJ2-1,CASSVLAGSTPTYNEQFF,4,4,2,8
TRBV9,TRBJ2-1,CASSAIGSRDRGYNEQFF,4,0,1,4
TRBV7-2,TRBJ2-3,CASSIVGRRTSSTDTQYF,4,0,1,4
TRBV5-1,TRBJ2-6,CASSLVGLRSSGANVLTF,4,0,1,4
TRBV5-1,TRBJ2-1,CASSPQGGGTGRYNEQFF,4,0,1,4
TRBV4-1,TRBJ2-6,CASSQDPAGGSGANVLTF,4,0,1,4
TRBV20-1,TRBJ2-1,CSARTGTSGGPSYNEQFF,4,0,1,4
TRBV20-1,TRBJ2-3,CSARGPERGRATADTQYF,4,0,1,4
TRBV29-1,TRBJ2-1,CSVEGRMSGSMMGDEQFF,4,0,1,4
TRBV24-1,TRBJ2-2,CATSDSLAGPNTGELFF,4,0,1,4
TRBV15,TRBJ2-5,CATSRDIEATRGETQYF,4,0,1,4
TRBV19,TRBJ2-3,CASSVPGTSGMRDTQYF,4,0,1,4
TRBV19,TRBJ2-4,CASSIGSGRVAKNIQYF,4,0,1,4
TRBV19,TRBJ2-5,CASSITSGTGGGETQYF,4,0,1,4
TRBV18,TRBJ2-3,CASSRRQDRPDKDTQNF,4,0,1,4
TRBV27,TRBJ2-1,CASQGLAGGGGGNEQFF,4,0,1,4
TRBV5-6,TRBJ2-7,CASTAQLFRDRDNEQYF,4,0,1,4
TRBV28,TRBJ2-3,CASSFADRDYLTDTQYF,4,3,2,7
TRBV28,TRBJ2-7,CASSLCTSGRAICEQYF,4,3,2,7
TRBV6-2/3/5/6,TRBJ2-7,CASSYRGQNYISYEQYF,4,0,1,4
TRBV6-2/3/5/6,TRBJ1-5,CASSYGQSIHSNQPQHF,4,0,1,4
TRBV2,TRBJ2-5,CASSDRTSGRGRETQYF,4,0,1,4
TRBV6-1,TRBJ1-4,CASSESRAWATNEKLFF,4,0,1,4
TRBV5-4,TRBJ2-3,CASSLDSWGTSTDTQYF,4,0,1,4
TRBV7-2,TRBJ2-5,CASSSRAGGLHQETQYF,4,0,1,4
TRBV7-2,TRBJ2-1,CASSSPAGTSGYNEQFF,4,0,1,4
TRBV5-4,TRBJ2-5,CASSSGGTSGSRETQYF,4,0,1,4
TRBV14,TRBJ2-2,CASSPSVAGAATGELFF,4,0,1,4
TRBV28,TRBJ2-3,CASSPVRTSGRTDTQYF,4,0,1,4
TRBV3-1,TRBJ2-7,CASSQTSGRPGAYEQYF,4,0,1,4
TRBV14,TRBJ2-5,CASSQQLGGSLQETQYF,4,0,1,4
TRBV4-2,TRBJ1-3,CASSQVDGSGTGNTIYF,4,0,1,4
TRBV14,TRBJ1-1,CASSQGIWGRVNTEAFF,4,0,1,4
TRBV4-2,TRBJ2-7,CASSQESGTGRLYEQYF,4,0,1,4
TRBV7-9,TRBJ2-1,CASSDLAGGVYYNEQFF,4,0,1,4
TRBV11-1,TRBJ2-1,CASSKGGFVGGPKFQFF,4,0,1,4
TRBV7-2,TRBJ2-1,CASRSSGYYLSYNEQFF,4,0,1,4
TRBV4-1,TRBJ2-7,CASSHPSGRGTSYEQYF,4,0,1,4
TRBV4-1,TRBJ2-1,CASSQAGTSGIAGEQFF,4,0,1,4
TRBV5-1,TRBJ2-3,CASSQGEEWEGTDTQYF,4,0,1,4
TRBV4-1,TRBJ2-3,CASSQDPAGASTDTQYF,4,0,1,4
TRBV5-1,TRBJ2-3,CASSRYGLAGETDTQYF,4,0,1,4
TRBV20-1,TRBJ2-1,CSALRVAGHSSYNEQFF,4,0,1,4
TRBV20-1,TRBJ2-3,CSASPLPGNTGTDTQYF,4,0,1,4
TRBV20-1,TRBJ2-5,CSARTGTGGLREETQYF,4,0,1,4
TRBV20-1,TRBJ2-1,CSARDASGTNGKNEQFF,4,0,1,4
TRBV20-1,TRBJ1-2,CSARRIPGGMPNYGYTF,4,0,1,4
TRBV29-1,TRBJ2-5,CSSSKPGGGDSRETQYF,4,0,1,4
TRBV29-1,TRBJ2-3,CSVRLFVGQGFPDTQYF,4,0,1,4
TRBV12-5,TRBJ2-3,CASGLGLAVGADTQYF,4,0,1,4
TRBV25-1,TRBJ2-3,CASSPPPDRGADTQYF,4,0,1,4
TRBV30,TRBJ1-5,CAWSVQGPYSNQPQHF,4,0,1,4
TRBV10-3,TRBJ2-3,CAITPGSGRVTDTQYF,4,0,1,4
TRBV2,TRBJ2-7,CATFLSPEQGSYEQYF,4,0,1,4
TRBV24-1,TRBJ2-2,CATSRGKRDDPGELFF,4,0,1,4
TRBV19,TRBJ2-3,CASSLGNPPSTDTQYF,4,2,2,6
TRBV19,TRBJ1-1,CASSPSGGTARTEAFF,4,0,1,4
TRBV19,TRBJ1-2,CASSIDGSAARYSYTF,4,0,1,4
TRBV19,TRBJ2-3,CASSPLSGYSTDTQYF,4,0,1,4
TRBV18,TRBJ2-5,CASSPLTGTGKETQYF,4,0,1,4
TRBV18,TRBJ2-1,CASSPFSGSLDNEQFF,4,0,1,4
TRBV18,TRBJ2-5,CASSPPPWRSQETQYF,4,0,1,4
TRBV18,TRBJ2-1,CASSPPGTSGRIPQFF,4,0,1,4
TRBV6-2/3/5/6,TRBJ2-2,CASCYFGGANTGELFF,4,0,1,4
TRBV12-3/4,TRBJ2-3,CASLRTSGSGTDTQYF,4,0,1,4
TRBV2,TRBJ1-5,CASMWGKSNSNQPQHF,4,0,1,4
TRBV2,TRBJ2-3,CASMGGLALTGDTQYF,4,0,1,4
TRBV7-3,TRBJ2-3,CASTISGGQGWGTQYF,4,0,1,4
TRBV6-2/3/5/6,TRBJ2-3,CASSFLIASGTDTQYF,4,0,1,4
TRBV28,TRBJ1-1,CASSFAPGLINTEAFF,4,0,1,4
TRBV12-3/4,TRBJ2-3,CASSLSSGVQGDTQYF,4,0,1,4
TRBV12-3/4,TRBJ1-5,CASSLARSGVNQPQHF,4,0,1,4
TRBV27,TRBJ2-2,CASSLEGTPNTGELFF,4,0,1,4
TRBV6-2/3/5/6,TRBJ2-3,CASSLSLGRAPDTQYF,4,0,1,4
TRBV28,TRBJ2-7,CASSSPLGQGRLEQYF,4,0,1,4
TRBV28,TRBJ1-1,CASSYEWGILNTEAFF,4,0,1,4
TRBV12-3/4,TRBJ2-5,CASSPRTSGVGETQYF,4,0,1,4
TRBV6-1,TRBJ2-4,CASSEVDTGGKNIQYF,4,0,1,4
TRBV6-1,TRBJ2-2,CASSEELAGVTGELFF,4,0,1,4
TRBV7-9,TRBJ2-3,CASSKLWTGAEDTQYF,4,0,1,4
TRBV5-6,TRBJ2-7,CASSLFGVGASYEQYF,4,0,1,4
TRBV5-5,TRBJ2-7,CASSLGTSGHHYEPYF,4,0,1,4
TRBV5-4,TRBJ2-7,CASSLMTSGSDYEQYF,4,0,1,4
TRBV11-3,TRBJ2-1,CASSLLGTRPYNEQFF,4,0,1,4
TRBV7-9,TRBJ1-2,CASSLATGESIYGYTF,4,0,1,4
TRBV3-1,TRBJ2-2,CASSLGAGVRTGELFF,4,0,1,4
TRBV7-3,TRBJ2-5,CASSLTAGQGGETQYF,4,0,1,4
TRBV7-2,TRBJ2-7,CASSSSGTSFLYEQYF,4,0,1,4
TRBV13,TRBJ2-1,CASSSPQGRTHHEQFF,4,0,1,4
TRBV7-9,TRBJ2-2,CASSSTNRGNTGELFF,4,0,1,4
TRBV7-2,TRBJ2-3,CASSPLRFAVTDTQYF,4,0,1,4
TRBV7-2,TRBJ2-7,CASSPRSGRSSYEQYF,4,0,1,4
TRBV9,TRBJ1-2,CASSPQSRGPFYGYTF,4,0,1,4
TRBV11-2,TRBJ1-2,CASSPVRGRGNYGYTF,4,0,1,4
TRBV7-9,TRBJ2-3,CASSPLIGPTTDTQYF,4,0,1,4
TRBV7-2,TRBJ2-1,CASSPGTSGTYNEQFF,4,4,2,8
TRBV12-3/4,TRBJ2-5,CASSPTSGSGQETQYF,4,0,1,4
TRBV7-6,TRBJ2-1,CASSPRASGALTEQFF,4,0,1,4
TRBV9,TRBJ2-1,CASSPRTSGFNNEQFF,4,0,1,4
TRBV7-9,TRBJ2-3,CASSRRGGRSTDTQYF,4,0,1,4
TRBV5-6,TRBJ2-5,CASSQWGSGILETQYF,4,0,1,4
TRBV3-1,TRBJ2-3,CASSQVWTQNRDTQYF,4,0,1,4
TRBV4-2,TRBJ2-6,CASSQDEGSGANVLTF,4,0,1,4
TRBV3-1,TRBJ2-2,CASSQDRGARTGELFF,4,0,1,4
TRBV7-6,TRBJ2-1,CASSARLAGGPNEQFF,4,0,1,4
TRBV3-1,TRBJ2-1,CASSATGGIVVNEQFF,4,0,1,4
TRBV14,TRBJ2-7,CASSGPSGRALREQYF,4,0,1,4
TRBV6-1,TRBJ2-2,CASSDTGLGGTGELFF,4,0,1,4
TRBV7-6,TRBJ2-3,CASSDRLAGVTDTQYF,4,0,1,4
TRBV5-4,TRBJ2-1,CASRDRHTSGNNEQFF,4,0,1,4
TRBV6-4,TRBJ1-5,CASRNTGQGSNQPQHF,4,0,1,4
TRBV6-2/3/5/6,TRBJ2-5,CASNPRQGGGAETQYF,4,0,1,4
TRBV4-1,TRBJ1-5,CASSVYQGNSNQPQHF,4,0,1,4
TRBV10-2,TRBJ1-2,CASSATREGRSLGYTF,4,0,1,4
TRBV10-2,TRBJ2-7,CASSGTGTGTYNEQYF,4,0,1,4
TRBV10-1,TRBJ2-3,CASSDGLAGVTDTQYF,4,0,1,4
TRBV5-5,TRBJ2-7,CASSLPLPGIGYEQYF,4,0,1,4
TRBV5-1,TRBJ2-2,CASSLMTSGNTGELLF,4,0,1,4
TRBV5-1,TRBJ1-2,CASSLNPFGQGYGYTF,4,0,1,4
TRBV13,TRBJ2-3,CASSLNLGPGADTQYF,4,0,1,4
TRBV5-1,TRBJ2-1,CASSLVRLARYNEQFF,4,0,1,4
TRBV4-1,TRBJ2-3,CASSQEGGYAPGTQCF,4,0,1,4
TRBV5-1,TRBJ2-7,CASSVGHLGSSYEQYF,4,0,1,4
TRBV5-1,TRBJ2-3,CASSIVAGQGTDTQYF,4,0,1,4
TRBV5-1,TRBJ2-3,CASRGLAGESTDTQYF,4,0,1,4
TRBV5-1,TRBJ2-1,CASKAGGSLSYNEQFF,4,0,1,4
TRBV20-1,TRBJ2-5,CSAPISGLAGVETQYF,4,0,1,4
TRBV20-1,TRBJ2-5,CSATSGREGIQETQYF,4,0,1,4
TRBV20-1,TRBJ2-5,CSARAFLAGVKETQYF,4,0,1,4
TRBV29-1,TRBJ2-7,CSVVPAVPPSSYEQYF,4,0,1,4
TRBV29-1,TRBJ2-1,CSVAVGGTGGYNEQFF,4,0,1,4
TRBV29-1,TRBJ2-1,CSVDPRGDRSSNEQFF,4,0,1,4
TRBV29-1,TRBJ2-3,CSVEDYLAGKTDTQYF,4,0,1,4
TRBV27,TRBJ2-5,YASRPPTSGSRETQYF,4,0,1,4
TRBV30,TRBJ1-1,CAWSFLGQANTEAFF,4,0,1,4
TRBV10-3,TRBJ2-5,CAISANSFPEETQYF,4,0,1,4
TRBV24-1,TRBJ2-5,CATSLGGTGGETQYF,4,0,1,4
TRBV24-1,TRBJ2-5,CATSDGREFGETQYF,4,6,2,10
TRBV27,TRBJ2-7,CATLPTGTGTYEQYF,4,2,2,6
TRBV19,TRBJ1-1,CASSYAPVPNTEAFF,4,10,2,14
TRBV19,TRBJ2-3,CASSPGRDYTDTQYF,4,0,1,4
TRBV19,TRBJ2-3,CASSQTFTLTDTQYF,4,0,1,4
TRBV19,TRBJ1-3,CASSGGHNSGNTIYF,4,0,1,4
TRBV19,TRBJ2-1,CASSISSGSVDEQFF,4,6,2,10
TRBV19,TRBJ2-1,CASSISSGSLNEQFF,4,0,1,4
TRBV19,TRBJ2-1,CASSIGGYSYNGQFF,4,0,1,4
TRBV19,TRBJ2-1,CASSITSGRLNEQFF,4,0,1,4
TRBV19,TRBJ1-6,CASSTRPRGPSPLHF,4,0,1,4
TRBV19,TRBJ1-1,CASSKRTPVSTEAFF,4,0,1,4
TRBV19,TRBJ2-7,CASSPGLAGLDEQYF,4,0,1,4
TRBV19,TRBJ2-4,CASSDGQGGKNIQYF,4,0,1,4
TRBV18,TRBJ1-2,CASSPTGQSNYGYTF,4,0,1,4
TRBV18,TRBJ2-3,CASSRLVDSTDTQYF,4,0,1,4
TRBV7-2,TRBJ1-1,CASSWTGGMNTEAFF,4,0,1,4
TRBV18,TRBJ2-7,CASSTGGTGNYEQYF,4,0,1,4
TRBV18,TRBJ2-4,CASSSFDRGGNIQYF,4,0,1,4
TRBV18,TRBJ1-1,CASSPLEIGQNEAFF,4,0,1,4
TRBV18,TRBJ2-7,CASSPGSGSSYEQYF,4,0,1,4
TRBV18,TRBJ1-1,CASSPEDRTNTEAFF,4,0,1,4
TRBV18,TRBJ1-1,CASSASQGAPAEAFF,4,0,1,4
TRBV7-2,TRBJ2-3,CASLDRGRSTDTQYF,4,0,1,4
TRBV4-2,TRBJ2-2,CASARGGQGAGELFF,4,0,1,4
TRBV6-4,TRBJ2-4,CASEERELAKNIQYF,4,0,1,4
TRBV6-2/3/5/6,TRBJ2-7,CASTPLAGVIYEQYF,4,0,1,4
TRBV4-2,TRBJ2-1,CASTPGGSAYNGQFF,4,0,1,4
TRBV12-3/4,TRBJ2-5,CASTRGPGGQETQYF,4,0,1,4
TRBV6-2/3/5/6,TRBJ2-2,CASTMGQGYTGELFF,4,0,1,4
TRBV6-2/3/5/6,TRBJ1-3,CASSFGFDSGNTIYF,4,0,1,4
TRBV6-2/3/5/6,TRBJ2-1,CASSFLAGGFNEQFF,4,0,1,4
TRBV12-3/4,TRBJ1-4,CASSFGGTGSEKLFF,4,0,1,4
TRBV6-2/3/5/6,TRBJ1-1,CASSLFGLRNTEAFF,4,0,1,4
TRBV12-3/4,TRBJ2-1,CASSLALAGANEQFF,4,0,1,4
TRBV12-3/4,TRBJ2-7,CASSLGQGSSYEQYF,4,4,2,8
TRBV12-3/4,TRBJ2-7,CASSLGRGRSHEQYF,4,0,1,4
TRBV27,TRBJ2-7,CASSSPNRGPYEQYF,4,0,1,4
TRBV28,TRBJ2-1,CASSSAGGPDDEQFF,4,0,1,4
TRBV6-2/3/5/6,TRBJ2-3,CASSSSTGGTDTQYF,4,0,1,4
TRBV12-3/4,TRBJ2-2,CASSSGTGATGELFF,4,0,1,4
TRBV7-9,TRBJ2-3,CASSSGLAGWGTQYF,4,0,1,4
TRBV6-2/3/5/6,TRBJ2-4,CASSSTGSRKNIQYF,4,0,1,4
TRBV6-2/3/5/6,TRBJ2-1,CASSYAGTGVDEQFF,4,0,1,4
TRBV6-2/3/5/6,TRBJ2-6,CASSYGKTGANVLTF,4,0,1,4
TRBV5-6,TRBJ2-1,CASSLEGAGKNEQFF,4,0,1,4
TRBV12-3/4,TRBJ2-1,CASSLRAGSGNEQFF,4,0,1,4
TRBV6-2/3/5/6,TRBJ2-1,CASSRTSPTYNEQFF,4,0,1,4
TRBV28,TRBJ2-1,CASSRSGSSYNEQFF,4,0,1,4
TRBV6-2/3/5/6,TRBJ2-1,CASSHRLTGGNEQFF,4,0,1,4
TRBV2,TRBJ2-5,CASSGSGQPQETQYF,4,0,1,4
TRBV6-4,TRBJ2-3,CASSDPAGGTDTQYF,4,0,1,4
TRBV2,TRBJ2-7,CASSDGTSGTYEQYF,4,0,1,4
TRBV6-1,TRBJ2-7,CASSEPQGPGYEQYF,4,0,1,4
TRBV6-1,TRBJ2-1,CASSESTSLGNEQFF,4,0,1,4
TRBV6-1,TRBJ2-1,CASSEGQGRYNEQFF,4,0,1,4
TRBV2,TRBJ2-1,CASSESLAGANEQFF,4,0,1,4
TRBV5-4,TRBJ2-7,CASSSGPRKPYEQYF,4,0,1,4
TRBV7-9,TRBJ1-4,CASSFSVRTNEKLSF,4,0,1,4
TRBV6-2/3/5/6,TRBJ2-1,CASSFWASGSNEQFF,4,0,1,4
TRBV7-6,TRBJ2-5,CASSFPAVVGETQYF,4,0,1,4
TRBV7-9,TRBJ2-1,CASSFGTSGSNEQFF,4,0,1,4
TRBV6-2/3/5/6,TRBJ2-7,CASSFRGQGSYEQYF,4,0,1,4
TRBV7-2,TRBJ2-7,CASSFPAGGHYEQYF,4,0,1,4
TRBV7-2,TRBJ2-7,CASSFRASESYEQYF,4,0,1,4
TRBV7-2,TRBJ2-6,CASSFDRTGANVLTF,4,0,1,4
TRBV7-2,TRBJ2-3,CASSFTRGRPDTQYF,4,0,1,4
TRBV5-5,TRBJ1-1,CASSLLGSLNTEAFF,4,0,1,4
TRBV7-9,TRBJ2-2,CASSLASIDTGELFF,4,0,1,4
TRBV7-9,TRBJ1-2,CASSLGQALNYGYTF,4,0,1,4
TRBV11-2,TRBJ1-1,CASSLTGTGATEAFF,4,0,1,4
TRBV7-9,TRBJ2-7,CASSLYGGGSYEQYF,4,0,1,4
TRBV7-9,TRBJ2-5,CASSLASSRKETQYF,4,0,1,4
TRBV6-2/3/5/6,TRBJ2-3,CASSLGGRATDTQYF,4,0,1,4
TRBV7-9,TRBJ2-1,CASSLGTGPYNEQFF,4,0,1,4
TRBV7-9,TRBJ1-1,CASSLEARGLTEAFF,4,0,1,4
TRBV7-6,TRBJ2-1,CASSLTEGRHNEQFF,4,0,1,4
TRBV11-2,TRBJ1-2,CASSLKQGANYGYTF,4,0,1,4
TRBV7-9,TRBJ2-1,CASSSRGNAYNEQFF,4,0,1,4
TRBV7-9,TRBJ1-2,CASSSRTGGPHGYTF,4,0,1,4
TRBV12-3/4,TRBJ2-7,CASSSLGGFSYEQYF,4,0,1,4
TRBV7-9,TRBJ1-1,CASSSRHSMNTEAFF,4,0,1,4
TRBV7-9,TRBJ2-2,CASSSGGRNTGELFF,4,0,1,4
TRBV7-9,TRBJ2-2,CASSSPLANTGELFF,4,3,2,7
TRBV5-4,TRBJ1-1,CASSYFGTGYTEAFF,4,0,1,4
TRBV5-4,TRBJ2-1,CASSLRGTSPYEQFF,4,0,1,4
TRBV5-4,TRBJ2-1,CASSLTGRSYNEQFF,4,0,1,4
TRBV7-9,TRBJ1-1,CASSLSGTMNTEAFF,4,0,1,4
TRBV3-1,TRBJ2-1,CASSLQGQTYNEQFF,4,0,1,4
TRBV7-3,TRBJ2-1,CASSLGLAGGNEQFF,4,0,1,4
TRBV7-9,TRBJ1-1,CASSLIGGVDTEAFF,4,0,1,4
TRBV3-1,TRBJ2-1,CASSPWTSGGDEQFF,4,0,1,4
TRBV7-2,TRBJ2-3,CASSPPGLATDTQYF,4,0,1,4
TRBV9,TRBJ2-4,CASSPRGESGDIQYF,4,0,1,4
TRBV7-9,TRBJ1-5,CASSPSGTSNQPQHF,4,0,1,4
TRBV7-2,TRBJ2-1,CASSRTTSSYNEQFF,4,0,1,4
TRBV6-2/3/5/6,TRBJ1-1,CASSRIDTGGTGAFF,4,0,1,4
TRBV14,TRBJ2-4,CASSHWGMDKNIQYF,4,0,1,4
TRBV7-2,TRBJ1-4,CASSHQTGEGEKLFF,4,0,1,4
TRBV5-4,TRBJ2-1,CASSQTGGFWDEQFF,4,0,1,4
TRBV3-1,TRBJ2-7,CASSQDGVAHYEQYS,4,0,1,4
TRBV9,TRBJ2-7,CASSVAGTSSYEQYF,4,0,1,4
TRBV6-2/3/5/6,TRBJ2-3,CASSVGSGRADTQYF,4,0,1,4
TRBV9,TRBJ2-7,CASSVGLAGAYEQYF,4,0,1,4
TRBV9,TRBJ2-1,CASSAETSLYNEQFF,4,0,1,4
TRBV9,TRBJ2-7,CASSAGDSGSHEQYF,4,24,2,28
TRBV7-2,TRBJ2-7,CASSGSSGRGDEQYF,4,0,1,4
TRBV7-2,TRBJ2-5,CASSTKGWAQETQYF,4,0,1,4
TRBV11-2,TRBJ2-1,CASSTGLAGGDEQFF,4,2,2,6
TRBV6-2/3/5/6,TRBJ1-1,CASRSPGGSNTEAFF,4,0,1,4
TRBV12-3/4,TRBJ2-1,CASRLAGRSYNEQFF,4,0,1,4
TRBV6-2/3/5/6,TRBJ2-1,CASRAGTRPYNEQFF,4,0,1,4
TRBV12-3/4,TRBJ2-1,CASRFGGRGLNEQFF,4,0,1,4
TRBV5-1,TRBJ2-1,CASVPGPSPRDEQFF,4,0,1,4
TRBV5-1,TRBJ2-5,CASSFQGGGQETQYF,4,0,1,4
TRBV5-1,TRBJ2-7,CASSPVGGSTYEQYF,4,0,1,4
TRBV5-1,TRBJ1-1,CASSFDGQPNTEAFF,4,0,1,4
TRBV5-1,TRBJ2-5,CASSLSGGLQETQYS,4,0,1,4
TRBV5-1,TRBJ2-7,CASSLLPGGSYEQYF,4,0,1,4
TRBV5-1,TRBJ2-1,CASSLLPDSYNEQFF,4,0,1,4
TRBV5-1,TRBJ2-3,CASSLDGGQTDTQYF,4,0,1,4
TRBV5-1,TRBJ2-7,CASSLVAGEGLEQYF,4,0,1,4
TRBV5-1,TRBJ2-1,CASSSWGDLANEQFF,4,0,1,4
TRBV5-1,TRBJ2-3,CASSSGLADTDTQYF,4,0,1,4
TRBV4-1,TRBJ2-5,CASSSPGHRQETQYF,4,0,1,4
TRBV5-1,TRBJ2-7,CASSLLGGALYEQYF,4,0,1,4
TRBV5-1,TRBJ2-7,CASSLDRGASYEQYF,4,0,1,4
TRBV5-1,TRBJ2-3,CASSPDRLRTDTQYF,4,0,1,4
TRBV5-1,TRBJ2-1,CASSRELESNNEQFF,4,0,1,4
TRBV4-1,TRBJ2-1,CASSHTGTRSNEQFF,4,0,1,4
TRBV4-1,TRBJ2-7,CASSQVASGKYEQYF,4,0,1,4
TRBV4-1,TRBJ2-1,CASSQWSGTVNEQFF,4,0,1,4
TRBV4-1,TRBJ1-2,CASSQDYRQGYGYTF,4,0,1,4
TRBV5-1,TRBJ2-3,CASRPGTSGRDTQYF,4,0,1,4
TRBV5-1,TRBJ2-3,CASRTGLERSDTQYF,4,0,1,4
TRBV5-1,TRBJ2-5,CASNPSLGERETQYF,4,0,1,4
TRBV10-2,TRBJ2-3,CASKRQGGYSDTQYF,4,3,2,7
TRBV20-1,TRBJ2-7,CSVPQTGTGGGEQYF,4,0,1,4
TRBV20-1,TRBJ2-1,CSASTSGRGVNEQFF,4,0,1,4
TRBV20-1,TRBJ2-3,CSAGQTGTSADTQYF,4,0,1,4
TRBV20-1,TRBJ2-3,CSASLAGGWTDTQYF,4,0,1,4
TRBV20-1,TRBJ1-5,CSASGDQDSNQPQHF,4,0,1,4
TRBV20-1,TRBJ2-5,CSARDASGSDGTQYF,4,0,1,4
TRBV20-1,TRBJ2-7,CSARDGPADSYEQYF,4,0,1,4
TRBV29-1,TRBJ1-1,CSVVSQGQHGGEAFF,4,0,1,4
TRBV29-1,TRBJ2-3,CSVGDSGTVTDTEYF,4,0,1,4
TRBV29-1,TRBJ2-7,CSVGNFGTGNYEQYF,4,0,1,4
TRBV29-1,TRBJ2-3,CSVEDLAGSPDTQYF,4,0,1,4
TRBV29-1,TRBJ2-7,CSARGPGQGDWEQYF,4,0,1,4
TRBV7-3,TRBJ1-4,RASKILWERDEKLFF,4,0,1,4
TRBV30,TRBJ2-2,CAWSRDPQAGELFF,4,0,1,4
TRBV19,TRBJ2-1,CATTPGLPNNEQFF,4,0,1,4
TRBV24-1,TRBJ2-5,CATSDLTQKETQYF,4,0,1,4
TRBV24-1,TRBJ2-2,CATSDDRARGELFF,4,0,1,4
TRBV24-1,TRBJ2-3,CATRQGAGTDTQYF,4,0,1,4
TRBV19,TRBJ1-5,CASSVTGAHQPQHF,4,0,1,4
TRBV19,TRBJ1-5,CASSEQGLGQPQHF,4,0,1,4
TRBV19,TRBJ2-1,CASSIAGWGNEQFF,4,0,1,4
TRBV19,TRBJ2-7,CASSIEGRNYEQYF,4,0,1,4
TRBV19,TRBJ1-5,CASSTRGAWQPQHF,4,0,1,4
TRBV19,TRBJ2-1,CASSSGQKINERFF,4,0,1,4
TRBV19,TRBJ2-4,CASSKRGTKNIQYF,4,0,1,4
TRBV19,TRBJ2-5,CASSEAGGRETQYF,4,0,1,4
TRBV19,TRBJ2-3,CASRRQVGTDTQYF,4,0,1,4
TRBV6-2/3/5/6,TRBJ2-1,CASSVTGGYNEQFF,4,0,1,4
TRBV18,TRBJ2-5,CASSPPSRQETQYF,4,0,1,4
TRBV18,TRBJ2-7,CASSPANSGGEQYF,4,0,1,4
TRBV27,TRBJ1-1,CASSITGANTEAFF,4,0,1,4
TRBV12-3/4,TRBJ2-7,CASPKVGTAYEQYF,4,0,1,4
TRBV28,TRBJ2-1,CASASGGAYNEQFF,4,0,1,4
TRBV12-3/4,TRBJ2-7,CASGLGGDLYEQYF,4,0,1,4
TRBV2,TRBJ2-5,CASELAGGQETQYF,4,0,1,4
TRBV6-2/3/5/6,TRBJ2-7,CASIGTVSSYEQYF,4,0,1,4
TRBV12-3/4,TRBJ2-5,CASSFGTWGETQYF,4,0,1,4
TRBV12-3/4,TRBJ2-7,CASSLGPVIYEQYF,4,0,1,4
TRBV12-3/4,TRBJ1-4,CASSLTGGDEKLFF,4,0,1,4
TRBV12-3/4,TRBJ2-7,CASSSLSYPGEQYF,4,0,1,4
TRBV12-3/4,TRBJ1-1,CASSSIDSLTEAFF,4,0,1,4
TRBV6-2/3/5/6,TRBJ1-2,CASSSGGGSVGYTF,4,0,1,4
TRBV6-2/3/5/6,TRBJ2-2,CASSPSGPTGELFF,4,0,1,4
TRBV28,TRBJ2-5,CASSPASRVETQYF,4,0,1,4
TRBV27,TRBJ2-1,CASSPGRGGNEQFF,4,0,1,4
TRBV11-1,TRBJ1-1,CASSPDGMNTEAFF,4,0,1,4
TRBV7-6,TRBJ2-3,CASSPNRGADTQYF,4,0,1,4
TRBV11-3,TRBJ2-1,CASSRGGGVYEQFF,4,0,1,4
TRBV7-2,TRBJ2-3,CASSGVSSTDTQYF,4,0,1,4
TRBV2,TRBJ2-3,CASSGSPRADTQYF,4,0,1,4
TRBV2,TRBJ2-3,CASSGQTPTDTQYF,4,0,1,4
TRBV6-1,TRBJ1-2,CASSEQTGRYGYTF,4,0,1,4
TRBV6-1,TRBJ1-2,CASSETGGSGRNTF,4,0,1,4
TRBV6-2/3/5/6,TRBJ2-5,CASSTWGSQETQYF,4,0,1,4
TRBV7-9,TRBJ2-1,CASSFQGRYNEQFF,4,10,2,14
TRBV7-9,TRBJ2-7,CASSFRGRAEEQYF,4,0,1,4
TRBV5-4,TRBJ2-1,CASSFPGKQSEQFF,4,0,1,4
TRBV5-6,TRBJ2-2,CASSLLGNTGELFF,4,3,2,7
TRBV5-5,TRBJ2-7,CASSLLDITYEQYF,4,0,1,4
TRBV5-6,TRBJ2-5,CASSLRGQGETQYF,4,0,1,4
TRBV5-6,TRBJ1-1,CASSLKGTAAEAFF,4,0,1,4
TRBV11-1,TRBJ2-1,CASSLVAGTGVPFF,4,8,2,12
TRBV7-2,TRBJ2-7,CASSLGAGGSEQYF,4,0,1,4
TRBV7-6,TRBJ1-2,CASSLGGFMDGYTF,4,0,1,4
TRBV7-9,TRBJ1-4,CASSLGGYGEKLFF,4,2,2,6
TRBV14,TRBJ1-1,CASSSDRGQGEAFF,4,0,1,4
TRBV7-9,TRBJ2-1,CASSSRILYNEQFF,4,0,1,4
TRBV7-3,TRBJ2-2,CASSSQGGAGELFF,4,0,1,4
TRBV11-2,TRBJ2-7,CASSSPGSPVGQYF,4,0,1,4
TRBV7-3,TRBJ2-7,CASSSGQINYEQYF,4,0,1,4
TRBV7-6,TRBJ1-1,CASSSAPRDTEAFF,4,0,1,4
TRBV11-2,TRBJ2-1,CASSWDWGDNEQFF,4,0,1,4
TRBV7-8,TRBJ2-7,CASSYRQGTYEQYF,4,0,1,4
TRBV9,TRBJ2-3,CASSPIPSTDTQYF,4,7,2,11
TRBV3-1,TRBJ1-3,CASSPGTAGNTIYF,4,0,1,4
TRBV7-9,TRBJ2-7,CASSPGLAGDEQYF,4,0,1,4
TRBV7-3,TRBJ2-5,CASSPTGLQETQYF,4,0,1,4
TRBV11-2,TRBJ2-5,CASSPGTGSETQYF,4,0,1,4
TRBV7-8,TRBJ2-1,CASSPRTSGHEQFF,4,0,1,4
TRBV5-4,TRBJ2-1,CASSRAGTFNEQFF,4,0,1,4
TRBV12-3/4,TRBJ2-3,CASSRPTSTDTQYF,4,0,1,4
TRBV14,TRBJ2-7,CASSHTTLSYEQYF,4,6,2,10
TRBV3-1,TRBJ2-7,CASSQAPTGNEQYF,4,0,1,4
TRBV6-4,TRBJ2-1,CASSQDRSYNEQFF,4,0,1,4
TRBV14,TRBJ2-1,CASSQDQLYNEQFF,4,6,2,10
TRBV9,TRBJ2-7,CASSVEPVTSEQYF,4,0,1,4
TRBV7-2,TRBJ1-2,CASSAPDVGYGYTF,4,0,1,4
TRBV9,TRBJ2-1,CASSADWGPNEQFF,4,0,1,4
TRBV2,TRBJ2-2,CASSGLAGVGELFF,4,0,1,4
TRBV7-8,TRBJ2-3,CASSGALSTDTQYF,4,0,1,4
TRBV2,TRBJ2-3,CASSGGVTTDTQYF,4,0,1,4
TRBV3-1,TRBJ2-3,CASSDGLHTDTQYF,4,0,1,4
TRBV3-1,TRBJ2-7,CASSTGTSAYEQYF,4,0,1,4
TRBV7-6,TRBJ1-4,CASSNSISNEKLFF,4,0,1,4
TRBV12-3/4,TRBJ2-1,CASREGLAGNEQFF,4,0,1,4
TRBV7-2,TRBJ2-7,CASRLAVSSYEQYF,4,0,1,4
TRBV11-2,TRBJ2-3,CASRRTQSGDTQYF,4,0,1,4
TRBV2,TRBJ1-3,CASRAPPTGNTIYF,4,0,1,4
TRBV7-9,TRBJ2-1,CASREIGPFNEQFF,4,0,1,4
TRBV11-2,TRBJ1-2,CASNIQGGTCGYTF,4,0,1,4
TRBV12-3/4,TRBJ1-1,CASKERNQPTEAFF,4,0,1,4
TRBV10-3,TRBJ2-3,CANSAGGLADTQYF,4,0,1,4
TRBV5-1,TRBJ2-3,CASMRADPTDTQYF,4,0,1,4
TRBV5-1,TRBJ2-2,CASSLALFPGELFF,4,0,1,4
TRBV5-1,TRBJ2-1,CASSLGVYANEQFF,4,0,1,4
TRBV5-1,TRBJ2-5,CASSLGQGVKTQYF,4,0,1,4
TRBV5-1,TRBJ2-7,CASSLGTEGYEQYF,4,0,1,4
TRBV5-1,TRBJ2-7,CASSLDQGGREQYF,4,0,1,4
TRBV5-1,TRBJ2-1,CASSLDEGYNEQFF,4,0,1,4
TRBV5-1,TRBJ2-1,CASSLEGTPNEQFF,4,0,1,4
TRBV5-1,TRBJ2-3,CASSLDGGQDTQYF,4,0,1,4
TRBV5-1,TRBJ2-1,CASSSTSSYNEQFF,4,6,2,10
TRBV5-1,TRBJ1-4,CASSWGAGKEKLFF,4,0,1,4
TRBV5-1,TRBJ2-1,CASSLITGGNEQFF,4,0,1,4
TRBV5-1,TRBJ2-7,CASSPGQGTYEQYF,4,0,1,4
TRBV5-1,TRBJ1-2,CASSPDGLKDGYTF,4,0,1,4
TRBV4-1,TRBJ1-1,CASSQREVGTEAFF,4,0,1,4
TRBV5-1,TRBJ2-1,CASSGDGGSGEQFF,4,0,1,4
TRBV5-1,TRBJ1-1,CASSMGRTDDKAFF,4,0,1,4
TRBV20-1,TRBJ2-5,CSVLAGQGRETQYF,4,0,1,4
TRBV20-1,TRBJ2-1,CSASRGPTYNEQFF,4,0,1,4
TRBV20-1,TRBJ2-7,CSALLAGGRYEQYF,4,0,1,4
TRBV20-1,TRBJ2-1,CSAVRPIATNEQFF,4,0,1,4
TRBV20-1,TRBJ2-1,CSASRLAVYNEQFF,4,0,1,4
TRBV20-1,TRBJ2-3,CSARTSGRADTQYF,4,0,1,4
TRBV20-1,TRBJ1-2,CSAREGSEDYGYTF,4,0,1,4
TRBV20-1,TRBJ2-7,CSAEAGTGTYEQYF,4,0,1,4
TRBV20-1,TRBJ2-3,CSAISGRVEDTQYF,4,0,1,4
TRBV20-1,TRBJ2-5,CSGSGAPKRETQYF,4,0,1,4
TRBV29-1,TRBJ2-1,CSVSPSGRYNEQFF,4,0,1,4
TRBV29-1,TRBJ2-1,CSVRVPNNPNEQFF,4,0,1,4
TRBV29-1,TRBJ2-2,CSVQGASNTGELFF,4,0,1,4
TRBV29-1,TRBJ2-5,CSVVSDTGQVTQYF,4,0,1,4
TRBV29-1,TRBJ2-5,CSVVLQGGRETQYF,4,0,1,4
TRBV29-1,TRBJ2-3,CSVELRGPTDTQYF,4,0,1,4
TRBV29-1,TRBJ1-5,CSVASGNSNQPQHF,4,0,1,4
TRBV29-1,TRBJ2-7,CSVTTTGSVYEQYF,4,0,1,4
TRBV29-1,TRBJ2-5,CSASVGSRTSAQYF,4,0,1,4
TRBV12-5,TRBJ2-3,CASRREDTDTQYF,4,0,1,4
TRBV7-3,TRBJ2-3,CASGPGSTDTQYF,4,18,2,22
TRBV28,TRBJ2-7,CASGRASPYEQYF,4,0,1,4
TRBV2,TRBJ1-5,CATRVMGNQPQHF,4,0,1,4
TRBV19,TRBJ2-2,CASADSNTGELFF,4,0,1,4
TRBV19,TRBJ1-6,CASTRDTNSPLHF,4,0,1,4
TRBV19,TRBJ1-2,CASTVGQLYGYTF,4,0,1,4
TRBV19,TRBJ1-1,CASSSRANTEAFF,4,0,1,4
TRBV19,TRBJ2-7,CASSKEGSYEQYF,4,0,1,4
TRBV19,TRBJ2-1,CASRRAGMTEQFF,4,0,1,4
TRBV19,TRBJ2-2,CASNNIRGIGLFF,4,0,1,4
TRBV18,TRBJ1-1,CASSRNRDLEAFF,4,0,1,4
TRBV18,TRBJ2-7,CASSLGTSGEQYF,4,0,1,4
TRBV18,TRBJ1-1,CASSPDRNTEAFF,4,0,1,4
TRBV7-9,TRBJ2-7,CASRGQGTYEQYF,4,0,1,4
TRBV28,TRBJ2-1,CASRQGINNEQFF,4,0,1,4
TRBV2,TRBJ2-4,CASATSGENIQHF,4,0,1,4
TRBV27,TRBJ2-7,CASTFGGTYEQYF,4,0,1,4
TRBV12-3/4,TRBJ2-3,CASTAGSTDTQYF,4,0,1,4
TRBV12-3/4,TRBJ1-2,CASTRTGGSGYTF,4,0,1,4
TRBV12-3/4,TRBJ2-7,CASSLRGPGFQYF,4,0,1,4
TRBV6-2/3/5/6,TRBJ2-5,CASSSLRGETQYF,4,0,1,4
TRBV6-2/3/5/6,TRBJ2-1,CASSYPGAEEQFF,4,0,1,4
TRBV6-2/3/5/6,TRBJ1-1,CASSYARNTEAFF,4,0,1,4
TRBV6-2/3/5/6,TRBJ2-3,CASSYKHTDTQYF,4,0,1,4
TRBV13,TRBJ2-1,CASSLRLVNEQFF,4,4,2,8
TRBV28,TRBJ2-2,CASSLSGARELFF,4,0,1,4
TRBV25-1,TRBJ2-7,CASSAPGAYEQYF,4,0,1,4
TRBV2,TRBJ1-4,CASSARGNEKLFF,4,0,1,4
TRBV2,TRBJ2-3,CASSEGSQDTQYF,4,0,1,4
TRBV2,TRBJ1-1,CASSENGNTEAFF,4,0,1,4
TRBV2,TRBJ2-3,CASSEEARNTQYF,4,0,1,4
TRBV7-2,TRBJ2-1,CASSFDRADEQFF,4,0,1,4
TRBV5-6,TRBJ2-5,CASSFEGSETQYF,4,0,1,4
TRBV7-6,TRBJ1-2,CASSFPGGYGYTF,4,0,1,4
TRBV11-2,TRBJ2-7,CASSLGELYEQYF,4,0,1,4
TRBV7-2,TRBJ2-5,CASSLSRLETQYF,4,0,1,4
TRBV7-2,TRBJ2-1,CASSLQSYNEQFF,4,0,1,4
TRBV11-2,TRBJ1-5,CASSLGGPRPQHF,4,0,1,4
TRBV7-2,TRBJ2-1,CASSLEGYNEQFF,4,0,1,4
TRBV7-6,TRBJ2-6,CASSSGQGTVLTL,4,0,1,4
TRBV7-2,TRBJ1-1,CASSLSVNTEAFF,4,0,1,4
TRBV6-2/3/5/6,TRBJ2-5,CASSLGEPRAQYF,4,0,1,4
TRBV28,TRBJ1-2,CASSPQDLYGYTF,4,0,1,4
TRBV7-8,TRBJ2-1,CASSPPRGDEQFF,4,0,1,4
TRBV14,TRBJ2-2,CASSPRTVGELFF,4,0,1,4
TRBV7-2,TRBJ2-5,CASSPRVQETQYF,4,0,1,4
TRBV7-9,TRBJ2-1,CASSPGQPNEQFF,4,0,1,4
TRBV11-2,TRBJ2-3,CASSRQGTDTQYF,4,0,1,4
TRBV7-6,TRBJ2-3,CASSHRSTDTQYF,4,0,1,4
TRBV16,TRBJ2-1,CASSQPSSGEQFF,4,0,1,4
TRBV14,TRBJ2-7,CASSQGLAYEQYF,4,0,1,4
TRBV3-1,TRBJ1-2,CASSQGQLYGYTF,4,0,1,4
TRBV7-3,TRBJ2-1,CASSQGGHNEQFF,4,0,1,4
TRBV7-2,TRBJ1-6,CASSALREGQNHF,4,0,1,4
TRBV9,TRBJ2-7,CASSAGLSYEQYF,4,0,1,4
TRBV11-1,TRBJ1-1,CASSAEMNSEAFF,4,0,1,4
TRBV7-3,TRBJ2-1,CASSARGGNEQFF,4,0,1,4
TRBV7-9,TRBJ2-5,CASSIGSEETQYF,4,0,1,4
TRBV7-2,TRBJ2-1,CASSKPGTLQQFF,4,0,1,4
TRBV7-2,TRBJ2-7,CASRRGGSYEQYF,4,0,1,4
TRBV28,TRBJ2-3,CASRRDSTDTQYF,4,0,1,4
TRBV2,TRBJ2-7,CASKFGEDYEQYF,4,0,1,4
TRBV27,TRBJ2-7,CASKRTGINEKYF,4,0,1,4
TRBV5-1,TRBJ1-2,CASSLVAGDGYTF,4,0,1,4
TRBV5-1,TRBJ2-3,CASSLASTDTQYF,4,0,1,4
TRBV5-1,TRBJ2-7,CASSLGQPWEQYF,4,0,1,4
TRBV5-1,TRBJ2-7,CASSLGGSDEQYF,4,0,1,4
TRBV4-1,TRBJ1-5,CASSSGANQPQHF,4,0,1,4
TRBV5-1,TRBJ2-7,CASSPATNYEQYF,4,0,1,4
TRBV5-1,TRBJ2-3,CASSVTGSDTQYF,4,0,1,4
TRBV5-1,TRBJ1-2,CASSIQGARGYTF,4,0,1,4
TRBV5-1,TRBJ2-7,CASKTSGFDEQYF,4,0,1,4
TRBV20-1,TRBJ2-7,CSASGTAGYEQYF,4,0,1,4
TRBV20-1,TRBJ2-7,CSAWTSGIYEQYF,4,0,1,4
TRBV20-1,TRBJ2-5,CSASWGYAETQYF,4,0,1,4
TRBV20-1,TRBJ2-3,CSARWLAQDTQYF,4,0,1,4
TRBV20-1,TRBJ1-1,CSAPQGAIAEAFF,4,0,1,4
TRBV20-1,TRBJ1-2,CSARTVSNYGYTF,4,15,2,19
TRBV29-1,TRBJ1-3,CSVPGNSGNTIYF,4,0,1,4
TRBV29-1,TRBJ1-1,CSVEREAGIEAFF,4,0,1,4
TRBV29-1,TRBJ2-1,CSVTRDSNNEQFF,4,0,1,4
TRBV7-9,TRBJ2-7,YASSLGRGYEQCL,4,0,1,4
TRBV12-5,TRBJ2-1,CASGLLSNEQFF,4,3,2,7
TRBV10-3,TRBJ2-5,CAISARGETQYF,4,0,1,4
TRBV19,TRBJ1-1,CATQTGNTEAFF,4,0,1,4
TRBV15,TRBJ2-1,CATSNRVNEQFF,4,0,1,4
TRBV19,TRBJ2-3,CASSIDLQTQYF,4,0,1,4
TRBV19,TRBJ1-1,CASSTVNTEAFF,4,0,1,4
TRBV19,TRBJ2-1,CASKGSSNEQLF,4,0,1,4
TRBV12-3/4,TRBJ2-3,CASGRGSDTQYF,4,0,1,4
TRBV2,TRBJ2-3,CASTKSGDTQYF,4,0,1,4
TRBV12-3/4,TRBJ2-7,CASSFQTYEQYF,4,0,1,4
TRBV28,TRBJ2-1,CASSPGVDQQFF,4,0,1,4
TRBV2,TRBJ1-2,CASSAQGNGYTF,4,0,1,4
TRBV2,TRBJ2-3,CASSGLADTQYF,4,0,1,4
TRBV7-9,TRBJ2-7,CASSLSGYEQYF,4,0,1,4
TRBV7-8,TRBJ2-5,CASSLGLETQYF,4,5,2,9
TRBV7-9,TRBJ2-1,CASSSTGNEQFF,4,0,1,4
TRBV7-8,TRBJ2-2,CASSPTTGELFF,4,0,1,4
TRBV7-9,TRBJ1-1,CASSPQNTEAFF,4,0,1,4
TRBV9,TRBJ2-7,CASSPGIYEQYF,4,0,1,4
TRBV7-8,TRBJ1-2,CASSRSGDGYTF,4,0,1,4
TRBV11-2,TRBJ2-5,CASSRGLETQYF,4,0,1,4
TRBV4-2,TRBJ2-2,CASSQASGELFF,4,0,1,4
TRBV3-1,TRBJ1-2,CASSQGREGYTF,4,0,1,4
TRBV2,TRBJ2-2,CASSVGNGELFF,4,0,1,4
TRBV7-2,TRBJ2-1,CASSASPNEQFF,4,0,1,4
TRBV7-9,TRBJ2-7,CASSISSYEQCF,4,0,1,4
TRBV6-4,TRBJ1-2,CASRSGGIGYTF,4,0,1,4
TRBV7-2,TRBJ2-3,CASRLDIDTQYF,4,0,1,4
TRBV28,TRBJ2-3,CASNEGTDTQYF,4,0,1,4
TRBV5-1,TRBJ2-5,CASSSEEETQYF,4,0,1,4
TRBV5-1,TRBJ1-2,CASSPDSRGYTF,4,0,1,4
TRBV20-1,TRBJ1-2,CSARDLDYGYTF,4,0,1,4
TRBV20-1,TRBJ2-5,CSAKDGRETQYF,4,0,1,4
TRBV20-1,TRBJ2-5,CSAASGQETQYF,4,0,1,4
TRBV20-1,TRBJ2-3,CSANGQADTQYF,4,0,1,4
TRBV29-1,TRBJ2-7,CSVEGDRASQYF,4,0,1,4
TRBV29-1,TRBJ2-4,CSVTVGGNIQYF,4,0,1,4
TRBV29-1,TRBJ2-7,CSVAIGPLEQYS,4,0,1,4
TRBV29-1,TRBJ2-7,CSVEDSSYEQYF,4,0,1,4
TRBV29-1,TRBJ2-7,CSAQRSSYEQYF,4,0,1,4
TRBV12-3/4,TRBJ1-2,RASSSPQGGYTF,4,0,1,4
TRBV30,TRBJ1-1,CAGRDVIEAFF,4,0,1,4
TRBV3-1,TRBJ1-1,CASLGTAEAFF,4,0,1,4
TRBV28,TRBJ2-5,CASSLGETQYF,4,0,1,4
TRBV6-2/3/5/6,TRBJ2-7,CASSSFFEQYF,4,0,1,4
TRBV6-2/3/5/6,TRBJ2-5,CASSYSGTQYF,4,0,1,4
TRBV5-4,TRBJ2-5,CASSFQETQYF,4,0,1,4
TRBV7-9,TRBJ2-1,CASSLYNEQFF,4,2,2,6
TRBV7-2,TRBJ2-1,CASSPLNEQFF,4,0,1,4
TRBV3-1,TRBJ2-1,CASSQVSEQFF,4,0,1,4
TRBV6-2/3/5/6,TRBJ2-1,CASRGSNEQFF,4,0,1,4
TRBV6-2/3/5/6,TRBJ2-3,CASRTENTQYF,4,0,1,4
TRBV20-1,TRBJ2-7,CSARRSYEQYF,4,0,1,4
TRBV29-1,TRBJ2-1,CSVDLGGEQFF,4,0,1,4
TRBV29-1,TRBJ1-2,CSASRGGGYTF,4,0,1,4
TRBV29-1,TRBJ2-7,CSARAGSEQYF,4,0,1,4
TRBV20-1,TRBJ2-7,CSISTSYEQYF,4,0,1,4
TRBV6-2/3/5/6,TRBJ2-1,WASSWDREQFF,4,0,1,4
TRBV6-2/3/5/6,TRBJ2-7,CASNPYEQYF,4,0,1,4
TRBV11-2,TRBJ2-1,CASSLEVSGGLAGYNEQSF,4,0,1,4
TRBV6-2/3/5/6,TRBJ1-5,CASRLFGGGRFYNQPQHF,4,8,2,12
TRBV5-1,TRBJ2-1,CASSTGQGSSYNEQFF,4,0,1,4
TRBV19,TRBJ2-1,CASSTTSGALNDQFF,4,0,1,4
TRBV5-6,TRBJ2-5,CASIRQDRVQETQYF,4,10,2,14
TRBV12-3/4,TRBJ1-1,CASTKAGIMNTEAFF,4,0,1,4
TRBV7-2,TRBJ2-3,CASSLDNPGADTQYF,4,0,1,4
TRBV5-1,TRBJ2-7,CASSFSGQGAGEQYF,4,2,2,6
TRBV29-1,TRBJ2-3,CSVRGGGTGQTTQYL,4,0,1,4
TRBV19,TRBJ1-2,CASSRTGLGYGYTF,4,0,1,4
TRBV11-2,TRBJ1-1,CASSLGAANTEAFF,4,0,1,4
TRBV7-9,TRBJ2-3,CASSQGLYTDTQYF,4,0,1,4
TRBV14,TRBJ2-3,CASSKNNYGTTQYF,4,0,1,4
TRBV9,TRBJ2-3,CASSALNTDTQYF,4,0,1,4
TRBV5-1,TRBJ2-1,CASSLSSYNEQFF,4,0,1,4
TRBV7-9,TRBJ2-1,CASPNEQFF,4,0,1,4
TRBV7-9,TRBJ2-6,CASSLARAQTGTGRQPSGANVLAF,3,0,1,3
TRBV15,TRBJ2-4,CATSRDRPTGLAGLAKNIQYF,3,0,1,3
TRBV15,TRBJ2-5,CATSRDSRWGGREEETQYF,3,0,1,3
TRBV6-2/3/5/6,TRBJ2-1,CASSFGLAGGKGGYNEQFF,3,0,1,3
TRBV28,TRBJ2-3,CASSLSGPGGNSGGDTQYF,3,0,1,3
TRBV28,TRBJ2-7,CASSLSGGAVWGSLYEQYF,3,0,1,3
TRBV7-2,TRBJ2-3,CASSLAPGLAGGSKTTQYF,3,0,1,3
TRBV7-9,TRBJ1-5,CASSLKGEGGGGGGQPQHF,3,0,1,3
TRBV9,TRBJ2-6,CASSVALRGRGSGANVLTF,3,0,1,3
TRBV5-1,TRBJ2-1,CASSLGSGTSGSSYNEQFF,3,7,2,10
TRBV5-1,TRBJ2-6,CASSPRSGSRGSGANVLTF,3,0,1,3
TRBV4-1,TRBJ2-5,CASSHTAGTGFGSQETQYF,3,0,1,3
TRBV5-1,TRBJ2-1,CASSTTSGSLRDTSDEQFF,3,0,1,3
TRBV5-1,TRBJ2-3,CASSKGLAGGGGGTDTQYF,3,0,1,3
TRBV20-1,TRBJ2-1,CSARAFQGLAGRTYNEQFF,3,5,2,8
TRBV30,TRBJ1-5,CAWRATQGYAFGNQPQHF,3,0,1,3
TRBV19,TRBJ2-1,CASSKFSTSGKFINEQFF,3,0,1,3
TRBV19,TRBJ2-1,CASSRLAGGRGLGNEQFF,3,0,1,3
TRBV18,TRBJ2-7,CASSPRSGGRTPSYEQYF,3,0,1,3
TRBV7-9,TRBJ2-7,CASTYSGTGRNAAYEQYF,3,0,1,3
TRBV12-3/4,TRBJ2-6,CASTTYDLGGAGANVLTF,3,0,1,3
TRBV6-1,TRBJ2-3,CASSAGLSNPISTDTQYF,3,0,1,3
TRBV6-1,TRBJ2-3,CASSEALSGRGGTDTQYF,3,0,1,3
TRBV7-8,TRBJ2-5,CASSFPGTSGNEGETQYF,3,0,1,3
TRBV11-2,TRBJ2-3,CASSSFGTSGRSTDTQYF,3,0,1,3
TRBV2,TRBJ2-7,CASSLQGGRPTHIYEQYF,3,0,1,3
TRBV3-1,TRBJ2-6,CASSLRTGQGAGANVLTF,3,0,1,3
TRBV3-1,TRBJ2-6,CASSQSEGPLLGANVLTF,3,0,1,3
TRBV4-2,TRBJ2-7,CASSQDRQIGGAAYEQYF,3,0,1,3
TRBV7-2,TRBJ2-5,CASSISWTSGDTAETQYF,3,0,1,3
TRBV2,TRBJ1-6,CASNIPAGTADVNSPLHF,3,0,1,3
TRBV4-1,TRBJ1-2,CASSQAGGRDTLGYGYTF,3,0,1,3
TRBV4-1,TRBJ2-4,CASSQGTGVTKAKNIQYF,3,0,1,3
TRBV4-1,TRBJ1-1,CASSQGFGQGVWGTEAFF,3,0,1,3
TRBV4-1,TRBJ2-1,CASSQDTVRQGAYNEQFF,3,0,1,3
TRBV5-1,TRBJ2-1,CASSIGVSSGRAGNEQFF,3,0,1,3
TRBV5-1,TRBJ2-5,CASSTGTSGSPNQETQYF,3,0,1,3
TRBV4-1,TRBJ2-1,CASSRLGLAGPMGNEQFF,3,0,1,3
TRBV20-1,TRBJ2-1,CSAGGRGASGSSYNEQFF,3,0,1,3
TRBV20-1,TRBJ2-3,CSARGTRSSGVGTDTQYF,3,0,1,3
TRBV20-1,TRBJ2-5,CSARDPGGLALYQETQYF,3,0,1,3
TRBV29-1,TRBJ2-1,CSVPLPLFEVRAYNEQFF,3,0,1,3
TRBV10-3,TRBJ2-6,CAISESIARAGANVLTF,3,0,1,3
TRBV10-3,TRBJ2-2,CATTGTSGRRNTGELFF,3,0,1,3
TRBV24-1,TRBJ2-1,CATSGRRLAASYNEQFF,3,0,1,3
TRBV12-3/4,TRBJ2-3,CASSFWRREVFTDTQYF,3,2,2,5
TRBV27,TRBJ2-3,CASSFRPSGQGTDTQYF,3,0,1,3
TRBV27,TRBJ2-3,CASSLPLVGGVTDTQYF,3,0,1,3
TRBV5-8,TRBJ2-1,CASSSGTSAGLENEQFF,3,0,1,3
TRBV27,TRBJ2-1,CASSSVSGTSRTMKQFF,3,0,1,3
TRBV6-2/3/5/6,TRBJ2-3,CASSPPRSWEGTDTLYF,3,0,1,3
TRBV6-1,TRBJ2-2,CASSEAFMAGGTGELFF,3,0,1,3
TRBV7-9,TRBJ2-5,CASSFETGTSGRETQYF,3,0,1,3
TRBV7-9,TRBJ2-2,CASSLPRAGVRGGELFF,3,0,1,3
TRBV11-2,TRBJ2-3,CASSLVGLADYTDAQYF,3,0,1,3
TRBV7-9,TRBJ1-1,CASSLGARDRGNTEAFF,3,0,1,3
TRBV13,TRBJ2-3,CASSWRGGGSPTDTQYF,3,0,1,3
TRBV9,TRBJ2-1,CASSLTPGTDSYNEQFF,3,0,1,3
TRBV7-9,TRBJ1-3,CASSLTTGTGGMDTIYF,3,0,1,3
TRBV7-2,TRBJ2-5,CASSPPGGIAGVETQYF,3,0,1,3
TRBV3-1,TRBJ2-6,CASSPTGGGSGANVLTF,3,0,1,3
TRBV7-6,TRBJ1-6,CASSPDGMSSYNSPLHF,3,0,1,3
TRBV4-2,TRBJ2-2,CASSQLEGAGGGGELFF,3,0,1,3
TRBV3-1,TRBJ2-5,CASSQRTSGSFQETQYF,3,0,1,3
TRBV3-1,TRBJ1-6,CASSQDGGGSLNSPLHF,3,0,1,3
TRBV9,TRBJ2-2,CASSVGLAGGSTGELFF,3,0,1,3
TRBV6-2/3/5/6,TRBJ2-3,CASSISGRVRGTDTQYF,3,0,1,3
TRBV7-2,TRBJ2-1,CASSTWDRDRGHNEQFF,3,0,1,3
TRBV7-9,TRBJ1-3,CASSTYRDAGSGNTIYF,3,0,1,3
TRBV7-6,TRBJ1-1,CASSRMPGQSLGTEAFF,3,3,2,6
TRBV7-9,TRBJ2-1,CASSKEALAGGNNEQFF,3,4,2,7
TRBV5-6,TRBJ1-1,CASRRGTGLGVDTEAFF,3,0,1,3
TRBV5-6,TRBJ1-2,CASRVKSLEEANYGYTF,3,0,1,3
TRBV5-1,TRBJ2-1,CASAFGTLAGGYNEQFF,3,0,1,3
TRBV5-1,TRBJ2-3,CASGSGRRSSPTDTQYF,3,0,1,3
TRBV10-2,TRBJ2-7,CASSESGPSGISYEQYY,3,0,1,3
TRBV5-1,TRBJ2-1,CASSLGSGTSGPNEQFF,3,0,1,3
TRBV5-1,TRBJ2-5,CASSLGPGTSALETQYF,3,0,1,3
TRBV5-1,TRBJ1-1,CASSLVRGMTPDTEAFF,3,0,1,3
TRBV4-1,TRBJ2-3,CASSPRFEGLEKDTQYF,3,0,1,3
TRBV4-1,TRBJ2-6,CASSPHYRSSGANVLTF,3,0,1,3
TRBV4-1,TRBJ1-2,CASSQLLRTRANYGYTF,3,0,1,3
TRBV4-1,TRBJ2-5,CASSQGRITGGSETQYF,3,0,1,3
TRBV4-1,TRBJ2-7,CASSQDSPGQGRDEQYF,3,0,1,3
TRBV4-1,TRBJ2-2,CASSQETGLAGTGELFF,3,4,2,7
TRBV4-1,TRBJ2-7,CASSQEGTGGTGYEQYF,3,0,1,3
TRBV29-1,TRBJ2-3,CSVEAWTSGRATDTQYF,3,0,1,3
TRBV29-1,TRBJ2-1,CSVEATSGGSSYNEQFF,3,0,1,3
TRBV28,TRBJ2-4,CVSSLLAGLAENIQYF,3,0,1,3
TRBV30,TRBJ1-1,CAWSAPGGSGITEAFF,3,0,1,3
TRBV30,TRBJ2-5,CAWSSLAGEYQETQYF,3,0,1,3
TRBV7-9,TRBJ2-5,CAISHPRLALRETQYF,3,0,1,3
TRBV19,TRBJ2-1,CATTKSRAISYNEQFF,3,0,1,3
TRBV15,TRBJ2-2,CATSRDRGWGGGELFF,3,0,1,3
TRBV19,TRBJ2-1,CASESRVGAAYNEQFF,3,0,1,3
TRBV19,TRBJ2-1,CASSTLLAGGYNEQFF,3,0,1,3
TRBV19,TRBJ2-1,CASSNRIIGGRDEQFF,3,0,1,3
TRBV19,TRBJ1-5,CASRGTGLGFNQPQHF,3,0,1,3
TRBV18,TRBJ2-1,CASSPAFGVSYNEQFF,3,0,1,3
TRBV18,TRBJ2-1,CASSRASGQIYNEQFF,3,0,1,3
TRBV18,TRBJ2-7,CASSSSPSGRGHEQYF,3,0,1,3
TRBV12-3/4,TRBJ2-3,CASTPPGTGVKGTQYF,3,0,1,3
TRBV2,TRBJ2-3,CASTQIKAGGQDTQYF,3,0,1,3
TRBV2,TRBJ2-3,CASTIRASGRSDTQYF,3,0,1,3
TRBV28,TRBJ2-1,CASSLGGGQGHNEQFF,3,0,1,3
TRBV6-2/3/5/6,TRBJ2-7,CASSLRGASGNYEQYF,3,0,1,3
TRBV6-2/3/5/6,TRBJ1-5,CASSSPGGYSNQPQHF,3,0,1,3
TRBV12-3/4,TRBJ2-1,CASSSTGSERRNGQFF,3,0,1,3
TRBV6-2/3/5/6,TRBJ2-1,CASSSLAAPSYNEQFF,3,0,1,3
TRBV12-3/4,TRBJ1-2,CASSPPSLGGLWGYTF,3,0,1,3
TRBV6-2/3/5/6,TRBJ2-6,CASSHAGTGARGVLTF,3,0,1,3
TRBV6-1,TRBJ2-1,CASSGGAGGEGNEQFF,3,0,1,3
TRBV6-1,TRBJ2-7,CASSGITRGTAYEQYF,3,3,2,6
TRBV25-1,TRBJ2-5,CASSESGRGGQETQYF,3,0,1,3
TRBV2,TRBJ2-1,CASSERFLALYKEQFF,3,0,1,3
TRBV6-2/3/5/6,TRBJ1-6,CASSTYRGQYNSPLHF,3,0,1,3
TRBV5-6,TRBJ2-3,CASSFFSGRAADTQYF,3,0,1,3
TRBV9,TRBJ2-1,CASSFSSGISTDEQFF,3,0,1,3
TRBV5-5,TRBJ1-5,CASSLRQGYSNQPQHF,3,0,1,3
TRBV5-5,TRBJ2-1,CASSLASGKSYNEQFF,3,0,1,3
TRBV11-2,TRBJ2-3,CASSLRVGGATDTQYF,3,0,1,3
TRBV7-9,TRBJ2-1,CASSLRASGGYNEQFF,3,0,1,3
TRBV11-2,TRBJ1-1,CASSLVMGQPNTEAFF,3,0,1,3
TRBV7-2,TRBJ1-1,CASSLAMGQGGTEAFS,3,0,1,3
TRBV7-2,TRBJ2-7,CASSLAAELRSYEQYF,3,0,1,3
TRBV11-2,TRBJ1-1,CASSLAGGAGNTEAFF,3,0,1,3
TRBV7-2,TRBJ2-1,CASSLGRTSGRPEQFF,3,0,1,3
TRBV7-9,TRBJ2-2,CASSLGSERWTGELFF,3,0,1,3
TRBV11-2,TRBJ1-1,CASSLDGQGGSTEAFF,3,0,1,3
TRBV11-2,TRBJ2-1,CASSLDTAGAYNEQFF,3,0,1,3
TRBV7-2,TRBJ2-1,CASSLDRVGSYNEQFF,3,0,1,3
TRBV7-9,TRBJ2-3,CASSLTQDWDKDTQYF,3,0,1,3
TRBV11-2,TRBJ2-7,CASSLTGGHVTYEQYF,3,0,1,3
TRBV7-9,TRBJ2-7,CASSSRADGSSYEQYF,3,0,1,3
TRBV7-2,TRBJ1-4,CASSSRQGGTNEKLFF,3,0,1,3
TRBV5-4,TRBJ2-3,CASSSGRAPYTDTQYF,3,0,1,3
TRBV7-2,TRBJ2-1,CASSYQGAGGRDEQFF,3,0,1,3
TRBV5-4,TRBJ2-1,CASSYRQSGLYNEQFF,3,0,1,3
TRBV11-2,TRBJ2-1,CASSLRGSDTKNEQFF,3,2,2,5
TRBV3-1,TRBJ2-6,CASSPQGTLGANVLTF,3,0,1,3
TRBV5-4,TRBJ2-7,CASSPSGVAGPYEQYF,3,0,1,3
TRBV7-2,TRBJ2-7,CASSPRGGGPAYEQYF,3,0,1,3
TRBV7-3,TRBJ2-2,CASSPALAANTGELFF,3,0,1,3
TRBV7-2,TRBJ1-1,CASSPALGGRSTEAFF,3,0,1,3
TRBV6-2/3/5/6,TRBJ2-1,CASSPKTDGSYNEQFF,3,0,1,3
TRBV5-4,TRBJ2-3,CASSPGAGSSTDTQYF,3,0,1,3
TRBV11-3,TRBJ2-1,CASSRGTPLDYNEQFF,3,0,1,3
TRBV9,TRBJ2-3,CASSRSWGGAHDTQYF,3,0,1,3
TRBV14,TRBJ2-5,CASSHSRDSLAETQYF,3,0,1,3
TRBV12-3/4,TRBJ1-1,CASSHDSLRWDTEAFF,3,0,1,3
TRBV14,TRBJ2-1,CASSQASGSTYNEQFF,3,0,1,3
TRBV11-3,TRBJ2-2,CASSTRQPVNTGELFF,3,0,1,3
TRBV28,TRBJ2-2,CASSSLAGSETGELFF,3,0,1,3
TRBV12-3/4,TRBJ2-1,CASRRRGQGAVNEQFF,3,0,1,3
TRBV6-2/3/5/6,TRBJ2-1,CASRPPLSLSYNEQFF,3,0,1,3
TRBV7-9,TRBJ1-4,CASRDPRDLANEKLFF,3,0,1,3
TRBV10-1,TRBJ2-1,CASSGGLAGDRNEQFF,3,0,1,3
TRBV5-1,TRBJ2-4,CASSLASGVAKNIQYF,3,0,1,3
TRBV5-1,TRBJ2-1,CASSLGSSGSGNEQFF,3,0,1,3
TRBV5-1,TRBJ2-1,CASSLDVGGAYNEQFF,3,0,1,3
TRBV5-1,TRBJ2-3,CASSLEWATITDTQYF,3,0,1,3
TRBV5-1,TRBJ2-2,CASSLETGQATGELFF,3,0,1,3
TRBV5-1,TRBJ1-4,CASSLRPDSSSAKLFF,3,0,1,3
TRBV5-1,TRBJ1-1,CASSYGDREFNTEAFF,3,0,1,3
TRBV5-1,TRBJ2-3,CASSPIGSGSTDTQYF,3,0,1,3
TRBV5-1,TRBJ2-7,CASSPGLAGSFYEQYF,3,0,1,3
TRBV5-1,TRBJ2-1,CASSRTSGGIYNEQFF,3,0,1,3
TRBV5-1,TRBJ2-2,CASSVETIANTGELFF,3,0,1,3
TRBV20-1,TRBJ2-1,CSATPGTSGSHNEQFF,3,0,1,3
TRBV20-1,TRBJ2-7,CSASEPLAGASGEQYF,3,5,2,8
TRBV20-1,TRBJ2-5,CSARRQGRRYQETQYF,3,0,1,3
TRBV20-1,TRBJ2-5,CSAREVGQGLQETQYF,3,0,1,3
TRBV29-1,TRBJ2-1,CSVVSPGTSRYNEQFF,3,0,1,3
TRBV29-1,TRBJ2-2,CSVERGQSANTGELFF,3,0,1,3
TRBV29-1,TRBJ2-3,CSVEVLGTGASDTQYF,3,0,1,3
TRBV29-1,TRBJ2-7,CSASGPSGQVNNEQYF,3,0,1,3
TRBV29-1,TRBJ2-5,CSATTGLGAGLGTQYF,3,0,1,3
TRBV10-3,TRBJ2-3,RAISEREGRGTDTQYF,3,0,1,3
TRBV12-3/4,TRBJ2-3,RASSFPGQGGLDTQYF,3,0,1,3
TRBV12-5,TRBJ2-3,CASGPAGGRVDTQYF,3,0,1,3
TRBV12-5,TRBJ2-1,CASGVGSGGFNEQFF,3,0,1,3
TRBV30,TRBJ2-7,CAWSPWEGESYEQYF,3,0,1,3
TRBV30,TRBJ2-7,CAWSVGAGVIYEQYF,3,0,1,3
TRBV30,TRBJ2-5,CAWSGGTLGGETQYF,3,0,1,3
TRBV30,TRBJ2-7,CAWRAFAGASYEQYF,3,0,1,3
TRBV10-3,TRBJ1-1,CAISDPVLMNTEAFF,3,0,1,3
TRBV10-3,TRBJ2-7,CAISEFTGPTYEQYF,3,0,1,3
TRBV10-3,TRBJ2-1,CAISDNRDPNNEQFF,3,0,1,3
TRBV24-1,TRBJ2-1,CATSDFFAREGEQFF,3,0,1,3
TRBV24-1,TRBJ2-5,CATSDSGTSVETQYF,3,0,1,3
TRBV15,TRBJ2-7,CATSPRLAGGPEQYF,3,0,1,3
TRBV15,TRBJ2-1,CATSRTSESYNEQFF,3,0,1,3
TRBV15,TRBJ2-1,CATSRSLAGVKEQFF,3,0,1,3
TRBV15,TRBJ2-7,CATSRDPLSVYEQYF,3,0,1,3
TRBV19,TRBJ1-3,CASAQDRSSGNTIYF,3,0,1,3
TRBV19,TRBJ2-5,CASSRTSGNQETQYF,3,0,1,3
TRBV19,TRBJ1-1,CASSASSRGSTEAFF,3,0,1,3
TRBV19,TRBJ2-7,CASSMTSSGAYEQYF,3,3,2,6
TRBV19,TRBJ2-1,CASSKSPSGSYEQFF,3,0,1,3
TRBV18,TRBJ1-5,CASSSGTGIDQPQHF,3,0,1,3
TRBV18,TRBJ2-1,CASSPGVGDYNEQFF,3,0,1,3
TRBV18,TRBJ2-1,CASSPITGGPSEQFF,3,0,1,3
TRBV18,TRBJ1-1,CASSPVPGANTEAFF,3,0,1,3
TRBV18,TRBJ2-1,CASSPEFDAYNEQFF,3,0,1,3
TRBV18,TRBJ2-3,CASSTKQGITDTQYF,3,0,1,3
TRBV28,TRBJ2-3,CASQQEGASTDTQYF,3,0,1,3
TRBV2,TRBJ2-2,CASGDLAGGSGELFF,3,0,1,3
TRBV6-2/3/5/6,TRBJ2-2,CASIRGFQNTGGLFF,3,0,1,3
TRBV2,TRBJ2-1,CASTKLAGGFDEQFF,3,5,2,8
TRBV27,TRBJ2-6,CASTRQWAGANVLTF,3,0,1,3
TRBV28,TRBJ2-1,CASSFRGRLYNEQFF,3,0,1,3
TRBV6-2/3/5/6,TRBJ2-4,CASSLYRGFGNIQYF,3,0,1,3
TRBV6-2/3/5/6,TRBJ2-1,CASSLRGSSYNEQFF,3,0,1,3
TRBV12-3/4,TRBJ2-7,CASSLTAGGSYEQYF,3,0,1,3
TRBV28,TRBJ1-2,CASSSPTGGHYGYAF,3,0,1,3
TRBV27,TRBJ2-3,CASSSGPSPSDTQYF,3,0,1,3
TRBV28,TRBJ2-7,CASSSPGTGPHEQYF,3,0,1,3
TRBV28,TRBJ2-1,CASSSTRGGINEQFF,3,0,1,3
TRBV28,TRBJ2-1,CASSSSGAGHNEQFF,3,0,1,3
TRBV6-2/3/5/6,TRBJ2-5,CASSSREAGQETQYF,3,0,1,3
TRBV6-2/3/5/6,TRBJ2-4,CASSSVELAKNIQYF,3,0,1,3
TRBV6-2/3/5/6,TRBJ2-2,CASSYLAANTGELFF,3,0,1,3
TRBV6-2/3/5/6,TRBJ2-4,CASSYRSGENNIQYF,3,0,1,3
TRBV6-2/3/5/6,TRBJ2-7,CASSYRWGRPYEQYF,3,0,1,3
TRBV6-2/3/5/6,TRBJ2-2,CASSYARGGTGELFF,3,0,1,3
TRBV4-2,TRBJ1-2,CASSLTQGGGYGYTF,3,0,1,3
TRBV9,TRBJ2-1,CASSLSFSSYNEQFF,3,0,1,3
TRBV6-2/3/5/6,TRBJ2-1,CASSLQGTGRNEQFF,3,0,1,3
TRBV12-3/4,TRBJ2-5,CASSPRGGRGETQYF,3,0,1,3
TRBV7-3,TRBJ2-1,CASSPSGKALSEQFF,3,0,1,3
TRBV6-2/3/5/6,TRBJ1-5,CASSPETVPHQPQHF,3,0,1,3
TRBV12-3/4,TRBJ2-7,CASSQRQGISYEQYF,3,0,1,3
TRBV2,TRBJ2-1,CASSVGGSAYNEQFF,3,5,2,8
TRBV2,TRBJ1-5,CASSAASFSNQPQHF,3,0,1,3
TRBV27,TRBJ2-7,CASSDGQGLKGEQYF,3,0,1,3
TRBV12-3/4,TRBJ2-1,CASSESGAFYNEQFL,3,0,1,3
TRBV6-1,TRBJ2-3,CASSEGILRTDTQYF,3,0,1,3
TRBV6-1,TRBJ1-5,CASSELGQGVQPQHF,3,0,1,3
TRBV6-1,TRBJ2-3,CASSEEGRGEGTQYF,3,0,1,3
TRBV6-2/3/5/6,TRBJ2-7,CASSSRLAGDYEQYF,3,0,1,3
TRBV7-2,TRBJ2-7,CASSFNPSGIYEQYF,3,0,1,3
TRBV7-9,TRBJ1-1,CASSFLTGRETEAFF,3,0,1,3
TRBV5-5,TRBJ2-7,CASSFLRTGSYEQYF,3,0,1,3
TRBV5-6,TRBJ2-6,CASSLPVSGANVLTF,3,0,1,3
TRBV11-2,TRBJ2-7,CASSLSAPGPYEQYF,3,0,1,3
TRBV7-2,TRBJ2-7,CASSLPGQGTYEQYF,3,0,1,3
TRBV7-2,TRBJ2-6,CASSLRGSGANVLTF,3,0,1,3
TRBV11-2,TRBJ2-5,CASSLVGGRGETQYF,3,0,1,3
TRBV5-4,TRBJ2-7,CASSLGASLIYEQYF,3,0,1,3
TRBV11-2,TRBJ2-1,CASSLEGFSYNEQFF,3,0,1,3
TRBV7-3,TRBJ2-1,CASSLTPSGFNEQFF,3,0,1,3
TRBV11-2,TRBJ2-2,CASSLSVRNTGEQFF,3,0,1,3
TRBV7-9,TRBJ2-3,CASSSRAALADTQYF,3,0,1,3
TRBV7-9,TRBJ1-1,CASSSMWSRNTEAFF,3,0,1,3
TRBV7-9,TRBJ2-3,CASSSTISATDTQYF,3,0,1,3
TRBV5-8,TRBJ2-1,CASSWAGTSLIEQFF,3,0,1,3
TRBV5-4,TRBJ2-1,CASSLRGGSYNEQFF,3,0,1,3
TRBV7-9,TRBJ2-1,CASSLQGTVGNEQFF,3,0,1,3
TRBV7-2,TRBJ2-4,CASSLGGAAKNIQYF,3,0,1,3
TRBV27,TRBJ2-1,CASSLDRDSYNEQFF,3,0,1,3
TRBV14,TRBJ2-1,CASSPLAGAYNEQFF,3,0,1,3
TRBV27,TRBJ2-7,CASSPLAGGGYEQYF,3,0,1,3
TRBV7-9,TRBJ2-1,CASSPPGLAGNEQFF,3,0,1,3
TRBV5-4,TRBJ2-1,CASSPQGAHYNEQFF,3,0,1,3
TRBV7-9,TRBJ2-7,CASSPGLADYYEQYF,3,0,1,3
TRBV7-6,TRBJ2-2,CASSRWAGGSGELFF,3,0,1,3
TRBV3-1,TRBJ2-1,CASSRGQGGYNEQFF,3,0,1,3
TRBV11-2,TRBJ2-7,CASSRGTSGPYEQYF,3,0,1,3
TRBV6-2/3/5/6,TRBJ2-3,CASSRDRGITDTQYF,3,0,1,3
TRBV3-1,TRBJ1-2,CASSHFRPKTYGYTF,3,0,1,3
TRBV7-9,TRBJ2-7,CASSHFRDRNYEQYF,3,0,1,3
TRBV12-3/4,TRBJ2-2,CASSHPTGKAGELVF,3,0,1,3
TRBV11-2,TRBJ1-4,CASSHGQGGNEKLFF,3,0,1,3
TRBV7-8,TRBJ2-1,CASSQRSVQSNEQFF,3,0,1,3
TRBV27,TRBJ2-1,CASSQGGNLYNEQFF,3,0,1,3
TRBV14,TRBJ2-1,CASSQDWIGDREQFF,3,0,1,3
TRBV3-1,TRBJ1-2,CASSQDPVNNYGYTF,3,0,1,3
TRBV28,TRBJ2-4,CASSVTSGRGDIQYF,3,0,1,3
TRBV9,TRBJ1-1,CASSVLGAGDTEAFF,3,0,1,3
TRBV2,TRBJ1-1,CASSVQGARDTEAFF,3,0,1,3
TRBV9,TRBJ2-1,CASSVGDPPRGEQFF,3,0,1,3
TRBV9,TRBJ2-7,CASSASGTAAYEQYF,3,0,1,3
TRBV14,TRBJ2-2,CASSGQGANTGELFF,3,8,2,11
TRBV5-6,TRBJ2-7,CASSGARDFSYEQYF,3,0,1,3
TRBV9,TRBJ2-1,CASSEMGELHNEQFF,3,0,1,3
TRBV11-2,TRBJ2-1,CASSTQGQGRNEQFF,3,0,1,3
TRBV28,TRBJ2-6,CASRLLGSGANVLTF,3,0,1,3
TRBV27,TRBJ2-1,CASRGSSGSDNEQFF,3,0,1,3
TRBV6-2/3/5/6,TRBJ1-1,CASRYRRGENTEAFF,3,0,1,3
TRBV12-3/4,TRBJ2-1,CASRPRLAGVGEQFF,3,0,1,3
TRBV2,TRBJ2-7,CASRGGGVNTYEQYF,3,0,1,3
TRBV6-4,TRBJ2-2,CASRMQGGLPGEPFF,3,0,1,3
TRBV5-1,TRBJ1-4,CASSSEGQADEKLFF,3,0,1,3
TRBV5-1,TRBJ2-6,CASGSPGSGANVLTF,3,0,1,3
TRBV10-2,TRBJ2-7,CASSDHDREPYEQYF,3,0,1,3
TRBV10-1,TRBJ2-3,CASSEASVRTDTQYF,3,0,1,3
TRBV10-2,TRBJ2-3,CASSSAGVGTDTQYF,3,0,1,3
TRBV5-1,TRBJ2-7,CASSFAGTTAYEQYF,3,0,1,3
TRBV5-1,TRBJ1-1,CASSLGFRGRTEAFF,3,0,1,3
TRBV5-1,TRBJ2-3,CASSLESASADTQYF,3,0,1,3
TRBV5-1,TRBJ2-7,CASSLTSRENYEQYF,3,0,1,3
TRBV5-1,TRBJ2-3,CASSLTGDATDTQYF,3,0,1,3
TRBV5-1,TRBJ2-7,CASSLDLAGVNEQYF,3,0,1,3
TRBV5-1,TRBJ2-7,CASSSLPDVFYEQYF,3,7,2,10
TRBV5-1,TRBJ2-1,CASSSPGLASNEQFF,3,0,1,3
TRBV5-1,TRBJ2-1,CASSSALAGLNEQFF,3,0,1,3
TRBV5-1,TRBJ2-1,CASSSGLAIDNEQFF,3,0,1,3
TRBV5-1,TRBJ1-5,CASSSEGVRGQPQHF,3,0,1,3
TRBV5-1,TRBJ1-6,CASSWAPGGDSPLHF,3,0,1,3
TRBV5-1,TRBJ1-1,CASSPLQGRGTEAFF,3,0,1,3
TRBV5-4,TRBJ2-1,CASSPGTSGYNEQFF,3,6,2,9
TRBV5-1,TRBJ2-3,CASSPGGAGTDTQYF,3,0,1,3
TRBV5-1,TRBJ2-1,CASSVDPSPYNEQFF,3,0,1,3
TRBV5-1,TRBJ2-1,CASRLSSEAYNEQFF,3,0,1,3
TRBV20-1,TRBJ2-6,CSVPGQSSGANVLTF,3,0,1,3
TRBV20-1,TRBJ2-3,CSAWDRGQGTDTQYF,3,0,1,3
TRBV20-1,TRBJ2-3,CSAGGGTGGTDTQYF,3,0,1,3
TRBV20-1,TRBJ2-3,CSAELASGSTDTQYF,3,0,1,3
TRBV20-1,TRBJ2-1,CSASPSGSSYNEQFF,3,0,1,3
TRBV20-1,TRBJ2-3,CSARPMGGWADTQYF,3,0,1,3
TRBV20-1,TRBJ2-3,CSARGWNPRADTQYF,3,0,1,3
TRBV20-1,TRBJ2-1,CSARYPGQGYNEQFF,3,0,1,3
TRBV20-1,TRBJ2-6,CSARQGGSGANVLTF,3,0,1,3
TRBV20-1,TRBJ1-2,CSARALDRGDYGYTF,3,0,1,3
TRBV20-1,TRBJ2-7,CSALLEGGTAYEQYF,3,0,1,3
TRBV29-1,TRBJ2-1,CSVSSGDPKYNEQFF,3,0,1,3
TRBV29-1,TRBJ2-2,CSVAQGNPNTGELSF,3,0,1,3
TRBV29-1,TRBJ2-5,CSVGSQGNPSDAQYF,3,0,1,3
TRBV29-1,TRBJ2-1,CSVGRASGSFNEQFF,3,0,1,3
TRBV29-1,TRBJ2-1,CSVGDGEGVRDEQFF,3,0,1,3
TRBV29-1,TRBJ1-2,CSVESRRARGNGYTF,3,0,1,3
TRBV29-1,TRBJ2-3,CSVEGTSGGTDTQYF,3,0,1,3
TRBV29-1,TRBJ2-3,CSVILLLGATDTQYF,3,0,1,3
TRBV29-1,TRBJ2-2,CSVGTAPLGTGELFF,3,0,1,3
TRBV29-1,TRBJ2-1,CSVPPTSGSYNEQFF,3,0,1,3
TRBV7-3,TRBJ1-6,RASRKPGQEPSPLHF,3,0,1,3
TRBV5-1,TRBJ2-2,RASSWTGLESGELFF,3,0,1,3
TRBV29-1,TRBJ2-1,RSVDRDQAQFDERFF,3,0,1,3
TRBV7-2,TRBJ2-3,RASSLAPSGTDTQYF,3,0,1,3
TRBV6-1,TRBJ2-1,FASSERGTSFEQFF,3,0,1,3
TRBV30,TRBJ1-1,CAWVKLQGETEAFF,3,0,1,3
TRBV30,TRBJ2-7,CAWSPRDTLGEQYF,3,0,1,3
TRBV5-4,TRBJ2-7,CAGSPGPGAYELYF,3,0,1,3
TRBV7-9,TRBJ2-1,CAGTSGGTYNEQFF,3,0,1,3
TRBV10-3,TRBJ2-7,CAISDWQGVNEQYF,3,3,2,6
TRBV24-1,TRBJ2-7,CATSDGDRGYEQYF,3,0,1,3
TRBV3-1,TRBJ2-2,CASVMGEGLGELFF,3,0,1,3
TRBV19,TRBJ2-1,CASSGRTFYSEQFF,3,0,1,3
TRBV19,TRBJ2-2,CASSITGSGGELFF,3,0,1,3
TRBV19,TRBJ1-2,CASSMAGGPARYTF,3,0,1,3
TRBV19,TRBJ1-2,CASSTQSITRGYTF,3,0,1,3
TRBV19,TRBJ2-2,CASSTSQGTGELFF,3,0,1,3
TRBV19,TRBJ2-1,CASSRGVDLNEQFF,3,0,1,3
TRBV19,TRBJ1-1,CASRGDRGYTEAFF,3,0,1,3
TRBV19,TRBJ2-3,CASRLGTGRDTQYF,3,0,1,3
TRBV18,TRBJ2-1,CASSPPTRSDEQFF,3,0,1,3
TRBV18,TRBJ2-7,CASSPPGETSEQYF,3,0,1,3
TRBV18,TRBJ2-1,CASSPHRDGYEQFF,3,0,1,3
TRBV18,TRBJ1-1,CASSPGRGHREAFF,3,0,1,3
TRBV19,TRBJ2-7,CASLPGSSPYEQYF,3,0,1,3
TRBV2,TRBJ2-1,CASRVAQANDEQFF,3,0,1,3
TRBV5-6,TRBJ1-1,CASRRGTANTEAFF,3,0,1,3
TRBV12-3/4,TRBJ1-1,CASRRRPRNTEAFF,3,0,1,3
TRBV27,TRBJ1-6,CASAKEAYNSPLHF,3,0,1,3
TRBV2,TRBJ2-4,CASGDSLAKNIQYF,3,0,1,3
TRBV12-3/4,TRBJ2-2,CASDAGGNTGELFF,3,0,1,3
TRBV28,TRBJ2-1,CASTTGGGSGEQFF,3,0,1,3
TRBV28,TRBJ2-3,CASSFGRGTDTQYF,3,0,1,3
TRBV27,TRBJ1-1,CASSFTGRPTEAFF,3,0,1,3
TRBV12-3/4,TRBJ2-3,CASSFLRAGDTQYF,3,0,1,3
TRBV6-2/3/5/6,TRBJ1-1,CASSLWQGRNEAFF,3,0,1,3
TRBV12-3/4,TRBJ2-3,CASSLGQDTDTQYF,3,0,1,3
TRBV27,TRBJ2-2,CASSLSRGLGELFF,3,0,1,3
TRBV27,TRBJ2-7,CASSLWRQGDEQYF,3,0,1,3
TRBV6-2/3/5/6,TRBJ1-1,CASSLVAGNTEAFF,3,0,1,3
TRBV12-3/4,TRBJ1-5,CASSLATRGQPQHF,3,0,1,3
TRBV6-2/3/5/6,TRBJ2-7,CASSLDGGSYEQYF,3,0,1,3
TRBV6-2/3/5/6,TRBJ2-7,CASSSQIAGYEQYF,3,0,1,3
TRBV2,TRBJ2-2,CASSWTGVTGELFF,3,0,1,3
TRBV6-2/3/5/6,TRBJ2-3,CASSYPDRVDTQYF,3,0,1,3
TRBV6-2/3/5/6,TRBJ1-6,CASSYDRYNSPLHF,3,0,1,3
TRBV7-9,TRBJ1-5,CASSHKDGLQPQHF,3,0,1,3
TRBV27,TRBJ2-3,CASSHGPSTDTQYF,3,0,1,3
TRBV28,TRBJ2-1,CASSHDRAYNEQFF,3,0,1,3
TRBV2,TRBJ1-2,CASSVDRGWHGYTF,3,0,1,3
TRBV2,TRBJ1-1,CASSADSKNTEAFF,3,0,1,3
TRBV2,TRBJ1-1,CASSEAGGDTEAFF,3,0,1,3
TRBV2,TRBJ1-2,CASSREMAGYGYTF,3,0,1,3
TRBV5-4,TRBJ2-5,CASSFGTAQETQYF,3,0,1,3
TRBV11-2,TRBJ2-1,CASSLASGANEQFF,3,0,1,3
TRBV5-4,TRBJ2-1,CASSLGQGVNKQFF,3,0,1,3
TRBV9,TRBJ2-5,CASSLGQTQETQYF,3,0,1,3
TRBV7-2,TRBJ2-1,CASSLAGSYNEQFF,3,0,1,3
TRBV7-2,TRBJ2-3,CASSLGFLGNTQYF,3,0,1,3
TRBV7-3,TRBJ2-5,CASSLGPSQETQYF,3,11,2,14
TRBV7-9,TRBJ1-1,CASSLGGTGTEAFF,3,0,1,3
TRBV7-9,TRBJ2-7,CASSLGTRFYEQYF,3,3,2,6
TRBV7-2,TRBJ2-3,CASSLGGGKDTQYF,3,0,1,3
TRBV11-2,TRBJ1-5,CASSLDFANQPQHF,3,0,1,3
TRBV7-2,TRBJ2-7,CASSLEPSSYEQYF,3,0,1,3
TRBV7-9,TRBJ2-3,CASSLSTPTDTQYF,3,0,1,3
TRBV7-2,TRBJ2-7,CASSSRIGGYEQYF,3,0,1,3
TRBV11-2,TRBJ2-7,CASSSNYGIYEQYF,3,0,1,3
TRBV11-2,TRBJ1-1,CASSSQGGQTEASF,3,0,1,3
TRBV5-4,TRBJ2-5,CASSSGLAQETQYF,3,0,1,3
TRBV7-6,TRBJ1-3,CASSSTNSGNTIYF,3,0,1,3
TRBV12-3/4,TRBJ1-5,CASSLRQGGQPQHF,3,0,1,3
TRBV3-1,TRBJ2-5,CASSLSGAQETQYF,3,0,1,3
TRBV11-2,TRBJ2-5,CASSLPRGEETQYF,3,0,1,3
TRBV27,TRBJ2-7,CASSPRWGLYEQYF,3,0,1,3
TRBV7-6,TRBJ2-5,CASSPSRGGETQYF,3,0,1,3
TRBV14,TRBJ1-1,CASSPLGGDTEAFF,3,0,1,3
TRBV7-2,TRBJ2-7,CASSPPGLPYEQYF,3,0,1,3
TRBV11-2,TRBJ2-5,CASSPGRGGETQYL,3,0,1,3
TRBV11-2,TRBJ2-6,CASSPTSGANVLTF,3,0,1,3
TRBV5-5,TRBJ2-1,CASSPRGQYNEQFF,3,0,1,3
TRBV12-3/4,TRBJ2-7,CASSPLSAGNEQYF,3,0,1,3
TRBV7-6,TRBJ1-1,CASSPTGRNTEAFF,3,0,1,3
TRBV7-9,TRBJ1-5,CASSPSYSNQPQHF,3,0,1,3
TRBV12-3/4,TRBJ2-1,CASSPRENYNEQFF,3,0,1,3
TRBV7-2,TRBJ2-2,CASSRRVSTGEQFF,3,0,1,3
TRBV7-6,TRBJ2-5,CASSHSGVQETQYF,3,0,1,3
TRBV14,TRBJ2-1,CASSQVGLALEQFF,3,0,1,3
TRBV9,TRBJ2-5,CASSQTGSGETQYF,3,0,1,3
TRBV7-6,TRBJ2-3,CASSQGPVADTQYF,3,0,1,3
TRBV3-1,TRBJ2-4,CASSQGQGTNIQYF,3,0,1,3
TRBV9,TRBJ2-5,CASSVSSGKETQYF,3,0,1,3
TRBV9,TRBJ2-3,CASSVGPGTDTQYF,3,0,1,3
TRBV9,TRBJ2-3,CASSVGVGQDTQYF,3,0,1,3
TRBV5-4,TRBJ2-1,CASSARDSNNEQFF,3,17,2,20
TRBV9,TRBJ2-7,CASSGGAGHEEQYF,3,0,1,3
TRBV7-2,TRBJ2-2,CASSGEGFTGELFF,3,0,1,3
TRBV7-6,TRBJ2-2,CASSEGPNTGELFF,3,0,1,3
TRBV7-9,TRBJ1-2,CASSTAGHSYGYTF,3,0,1,3
TRBV7-8,TRBJ2-7,CASSTSGSFYEQYF,3,0,1,3
TRBV25-1,TRBJ2-7,CASSTSGRIYEQYF,3,5,2,8
TRBV4-2,TRBJ1-3,CASSTRVSGNTIYF,3,0,1,3
TRBV5-8,TRBJ2-1,CASRFGTSRYEQFF,3,0,1,3
TRBV6-2/3/5/6,TRBJ2-7,CASRPTGTVGEQYF,3,0,1,3
TRBV5-6,TRBJ1-1,CASRLGQLNTEAFF,3,0,1,3
TRBV6-2/3/5/6,TRBJ2-7,CASRVQATSYEQYF,3,0,1,3
TRBV5-1,TRBJ2-1,CASSRTGQNNEQFF,3,3,2,6
TRBV5-1,TRBJ2-7,CASSFAGARYEQYF,3,0,1,3
TRBV5-1,TRBJ2-1,CASSFVAGGDEQFF,3,0,1,3
TRBV5-1,TRBJ1-1,CASSFTGANTEAFF,3,0,1,3
TRBV5-1,TRBJ2-3,CASSLALAGDTQYF,3,0,1,3
TRBV5-1,TRBJ2-3,CASSLDSGTDTQYF,3,0,1,3
TRBV5-1,TRBJ2-5,CASSLEQGSETQYF,3,0,1,3
TRBV5-1,TRBJ2-7,CASSLEANSYEQYL,3,0,1,3
TRBV5-1,TRBJ2-1,CASSLQGFDNEQFF,3,0,1,3
TRBV5-1,TRBJ2-1,CASSWGGGVNEQFF,3,0,1,3
TRBV5-1,TRBJ2-5,CASSLPGGGETQYF,3,0,1,3
TRBV5-1,TRBJ2-7,CASSLGAGPFEQYF,3,0,1,3
TRBV5-1,TRBJ1-5,CASSLGQGGEPQHF,3,0,1,3
TRBV5-1,TRBJ2-3,CASSPFSATDTQYF,3,0,1,3
TRBV5-1,TRBJ2-5,CASSPRTGQETQYF,3,0,1,3
TRBV5-1,TRBJ2-5,CASSPDRGRETQYF,3,0,1,3
TRBV5-1,TRBJ2-7,CASSREAGPHEQYF,3,0,1,3
TRBV5-1,TRBJ2-5,CASSQGRYGETQYF,3,0,1,3
TRBV4-1,TRBJ2-1,CASSQGTRGPEQFF,3,0,1,3
TRBV4-1,TRBJ2-3,CASSQGTGVDTQYF,3,0,1,3
TRBV5-1,TRBJ2-1,CASSIQAGGDEQFF,3,0,1,3
TRBV5-1,TRBJ2-1,CASRPVGPDNEQFF,3,0,1,3
TRBV20-1,TRBJ2-7,CSASKGGSSYEQYF,3,0,1,3
TRBV20-1,TRBJ2-1,CSASVWRGYNEQFF,3,0,1,3
TRBV20-1,TRBJ2-3,CSAPQRVQSDTQYF,3,0,1,3
TRBV20-1,TRBJ2-1,CSAISGSIRNEQFF,3,0,1,3
TRBV20-1,TRBJ2-5,CSASRVGLEGTQYF,3,0,1,3
TRBV20-1,TRBJ2-1,CSASGLAGYNEQFF,3,5,2,8
TRBV20-1,TRBJ2-2,CSARVGGATGELFF,3,0,1,3
TRBV20-1,TRBJ1-2,CSARATGGNYGYTF,3,0,1,3
TRBV20-1,TRBJ2-7,CSARDPYRAYEQYF,3,0,1,3
TRBV20-1,TRBJ1-1,CSARDQKGHTEAFF,3,0,1,3
TRBV20-1,TRBJ2-1,CSARDGSGYNEQFF,3,0,1,3
TRBV20-1,TRBJ2-5,CSARDKAGGETQYF,3,0,1,3
TRBV20-1,TRBJ2-1,CSARGLAVNNEQFF,3,0,1,3
TRBV20-1,TRBJ2-3,CSAQTSGYTDTQYF,3,10,2,13
TRBV20-1,TRBJ2-3,CSAVRVAGKDTQYF,3,0,1,3
TRBV20-1,TRBJ2-1,CSAPGPVRYNEQFF,3,0,1,3
TRBV20-1,TRBJ2-2,CSAGLAENTGELFF,3,0,1,3
TRBV20-1,TRBJ2-1,CSGLPGVSWNEQFF,3,0,1,3
TRBV29-1,TRBJ2-5,CSVSSGLNAQTQYF,3,0,1,3
TRBV29-1,TRBJ1-2,CSVAGAGGVYGYTF,3,0,1,3
TRBV29-1,TRBJ2-5,CSVASAGGGETQYF,3,4,2,7
TRBV29-1,TRBJ2-2,CSVEPGGRTGELFF,3,0,1,3
TRBV29-1,TRBJ2-3,CSVEGTGGSDTQYF,3,4,2,7
TRBV29-1,TRBJ1-1,CSVEFRRVRPEAFF,3,0,1,3
TRBV29-1,TRBJ2-6,CSVEGGSGANVLTF,3,0,1,3
TRBV29-1,TRBJ2-7,CSVFQTGTSYEQYF,3,0,1,3
TRBV29-1,TRBJ2-1,CSVEGPNSYNEQFF,3,0,1,3
TRBV29-1,TRBJ2-3,CSVIPGTVTDTQYF,3,0,1,3
TRBV29-1,TRBJ2-5,CSALIPGRVQTQYF,3,0,1,3
TRBV29-1,TRBJ2-5,CSGLGQGAGETQYF,3,0,1,3
TRBV20-1,TRBJ2-2,CRARSGSVTGELFF,3,0,1,3
TRBV12-5,TRBJ2-5,CASGLSYEETQYF,3,0,1,3
TRBV28,TRBJ1-5,CASRAPSNQPQHF,3,6,2,9
TRBV30,TRBJ1-2,CAWSRASVDGYTF,3,0,1,3
TRBV30,TRBJ1-5,CAWSVRSNRPQHF,3,0,1,3
TRBV30,TRBJ2-3,CAWSGGNDDTQYF,3,0,1,3
TRBV30,TRBJ1-1,CAWSTATNTEAFF,3,0,1,3
TRBV30,TRBJ1-2,CAWKRVDFDGYTF,3,2,2,5
TRBV12-3/4,TRBJ2-1,CAVQFVMEDEQFF,3,0,1,3
TRBV5-4,TRBJ2-5,CAAQEGPVETQYF,3,0,1,3
TRBV2,TRBJ2-1,CAISDRRNNEQFF,3,0,1,3
TRBV10-3,TRBJ1-5,CAIQADSNQPQRF,3,0,1,3
TRBV10-3,TRBJ2-2,CAISDLGDGELFF,3,0,1,3
TRBV27,TRBJ2-7,CATSRGNLYEQYF,3,0,1,3
TRBV15,TRBJ1-1,CATSRGGSTEAFL,3,0,1,3
TRBV19,TRBJ2-1,CATSGRFDNEQFF,3,0,1,3
TRBV19,TRBJ2-2,CATRQGATGELFF,3,9,2,12
TRBV19,TRBJ1-5,CASARVPNQPQHF,3,0,1,3
TRBV19,TRBJ1-5,CASGRGGNQPQHF,3,0,1,3
TRBV19,TRBJ2-1,CASSQERNNEQFF,3,0,1,3
TRBV19,TRBJ2-5,CASSIGLQETQYF,3,0,1,3
TRBV18,TRBJ2-1,CASSWTSENEQFF,3,0,1,3
TRBV18,TRBJ2-5,CASSPTREETQYF,3,0,1,3
TRBV18,TRBJ1-1,CASSGEQGTEAFF,3,0,1,3
TRBV2,TRBJ1-1,CASQGQQYTEAFF,3,0,1,3
TRBV25-1,TRBJ2-6,CASQGAGANVLTF,3,0,1,3
TRBV14,TRBJ2-2,CASAGRELGELFF,3,0,1,3
TRBV7-9,TRBJ1-4,CASGVEIIEKLFF,3,0,1,3
TRBV11-2,TRBJ1-5,CASGQASNQPQHF,3,0,1,3
TRBV5-6,TRBJ2-7,CASTRTGGYEQYF,3,0,1,3
TRBV28,TRBJ2-2,CASTHRGTGELFF,3,0,1,3
TRBV6-1,TRBJ2-7,CASTEAGGDEQYF,3,0,1,3
TRBV12-3/4,TRBJ1-1,CASSLAANTEAFF,3,0,1,3
TRBV12-3/4,TRBJ1-1,CASSSGEGTKAFF,3,0,1,3
TRBV6-2/3/5/6,TRBJ2-3,CASSYPGADTQYF,3,0,1,3
TRBV12-3/4,TRBJ1-1,CASSLSQNTEAFF,3,0,1,3
TRBV27,TRBJ2-1,CASSPLPGTQQFF,3,0,1,3
TRBV14,TRBJ2-7,CASSRGTSYEQYF,3,0,1,3
TRBV6-2/3/5/6,TRBJ1-1,CASSRTGGGWAFF,3,0,1,3
TRBV2,TRBJ2-7,CASSVGTVGRQYF,3,0,1,3
TRBV2,TRBJ2-5,CASSVRYQETQYF,3,0,1,3
TRBV6-1,TRBJ2-1,CASSADPFNEQFF,3,0,1,3
TRBV25-1,TRBJ2-7,CASSGTTDYEQYF,3,2,2,5
TRBV25-1,TRBJ2-3,CASSDARGDTQYF,3,0,1,3
TRBV6-1,TRBJ2-7,CASSEDGRSEQYF,3,0,1,3
TRBV2,TRBJ1-6,CASSEDSGSPLHF,3,0,1,3
TRBV2,TRBJ2-1,CASSEEHANEQFF,3,0,1,3
TRBV25-1,TRBJ2-1,CASSEWGPGEQFF,3,0,1,3
TRBV6-1,TRBJ2-7,CASSEGGQGEQYF,3,0,1,3
TRBV2,TRBJ2-1,CASSEGTSGRVLF,3,0,1,3
TRBV28,TRBJ2-3,CASSTPITDTQYF,3,0,1,3
TRBV7-2,TRBJ2-1,CASSLQLYNVQFF,3,0,1,3
TRBV7-9,TRBJ2-5,CASSLGTGETQYF,3,0,1,3
TRBV7-9,TRBJ2-6,CASSLDRANVLTF,3,0,1,3
TRBV5-6,TRBJ2-7,CASSLKGSYEQYF,3,0,1,3
TRBV7-2,TRBJ2-1,CASSLSQGFEQFF,3,0,1,3
TRBV7-6,TRBJ1-1,CASSLSIGAEAFF,3,0,1,3
TRBV5-5,TRBJ1-5,CASSLWQNQPQHF,3,0,1,3
TRBV7-8,TRBJ2-7,CASSLVFQYEQYF,3,11,2,14
TRBV11-2,TRBJ1-6,CASSLAVYSPLHF,3,0,1,3
TRBV7-9,TRBJ2-1,CASSLGFGDEQFF,3,7,2,10
TRBV11-2,TRBJ1-5,CASSLDRNQPQHF,3,0,1,3
TRBV11-2,TRBJ1-1,CASSLEGFTEAFF,3,0,1,3
TRBV7-9,TRBJ2-3,CASSLRGTDTQYF,3,0,1,3
TRBV7-2,TRBJ1-3,CASSSSYGNTIYF,3,0,1,3
TRBV13,TRBJ2-7,CASSPQGGHEQYF,3,0,1,3
TRBV5-6,TRBJ2-5,CASSPQGQETQYF,3,0,1,3
TRBV11-1,TRBJ2-2,CASSRQGPGELFF,3,0,1,3
TRBV3-1,TRBJ1-1,CASSRRATAEAFF,3,0,1,3
TRBV7-9,TRBJ1-2,CASSHGQNYGYTF,3,0,1,3
TRBV7-3,TRBJ2-7,CASSQREGYEQYF,3,0,1,3
TRBV14,TRBJ2-6,CASSQTGPNVLTF,3,0,1,3
TRBV14,TRBJ2-3,CASSQDSLDTQYF,3,0,1,3
TRBV6-2/3/5/6,TRBJ2-1,CASSIEGYNEQFF,3,0,1,3
TRBV12-3/4,TRBJ1-1,CASSTSTGAEAFF,3,0,1,3
TRBV11-3,TRBJ2-7,CASSTSRGHEQYF,3,0,1,3
TRBV6-2/3/5/6,TRBJ1-1,CASRYPGNTEAFF,3,0,1,3
TRBV7-2,TRBJ2-3,CASRGGSTDTQYF,3,0,1,3
TRBV6-2/3/5/6,TRBJ1-1,CASRRQGPTEAFF,3,0,1,3
TRBV6-2/3/5/6,TRBJ1-1,CASRSGTHTEAFF,3,0,1,3
TRBV7-6,TRBJ2-1,CTSSLGPTMEQFF,3,0,1,3
TRBV20-1,TRBJ2-3,CCASYGYTDTQYF,3,0,1,3
TRBV10-1,TRBJ2-3,CASTGTPTDTQYF,3,0,1,3
TRBV5-1,TRBJ2-3,CASTPGGTDTQYF,3,0,1,3
TRBV5-1,TRBJ2-7,CASTGGAGDEQYF,3,0,1,3
TRBV5-1,TRBJ2-7,CASSLVGGDEQYF,3,0,1,3
TRBV5-1,TRBJ2-1,CASSLSPGPEQFF,3,0,1,3
TRBV10-1,TRBJ1-5,CASSRDGNQPQHF,3,0,1,3
TRBV4-1,TRBJ1-1,CASSQGRDTEAFF,3,0,1,3
TRBV4-1,TRBJ1-5,CASSGTVAQPQHF,3,0,1,3
TRBV10-1,TRBJ2-4,CASSRQGENIQYF,3,0,1,3
TRBV5-1,TRBJ2-3,CASRRTGSDTQYF,3,0,1,3
TRBV20-1,TRBJ2-1,CSATGTGYNEQFF,3,0,1,3
TRBV20-1,TRBJ2-5,CSASTGVQETQYF,3,0,1,3
TRBV20-1,TRBJ2-3,CSARAPSADTQYF,3,0,1,3
TRBV29-1,TRBJ1-1,CSVLGGTDTEASF,3,0,1,3
TRBV29-1,TRBJ1-3,CSVRDRGGNTIYF,3,8,2,11
TRBV29-1,TRBJ2-1,CSVRLLGHNEQFF,3,0,1,3
TRBV29-1,TRBJ2-7,CSVVWAGLYEQYF,3,0,1,3
TRBV29-1,TRBJ2-3,CSVVPGITDTQYF,3,0,1,3
TRBV29-1,TRBJ1-5,CSVAEGRNQPQHF,3,0,1,3
TRBV29-1,TRBJ2-7,CSVGRGTDYEQYL,3,0,1,3
TRBV29-1,TRBJ2-5,CSVDSGQRESQYF,3,0,1,3
TRBV29-1,TRBJ2-3,CSVEGQGSDTQYF,3,0,1,3
TRBV29-1,TRBJ2-7,CSVEIAGVYEQYF,3,0,1,3
TRBV29-1,TRBJ2-5,CSVEVGRGETQYF,3,0,1,3
TRBV29-1,TRBJ2-3,CSVEVANTDTQYF,3,0,1,3
TRBV29-1,TRBJ2-5,CSVEDAGAETQYF,3,0,1,3
TRBV29-1,TRBJ2-2,CSVERGVFGELFF,3,0,1,3
TRBV29-1,TRBJ2-7,CSVRDVRSYEQYF,3,0,1,3
TRBV29-1,TRBJ2-2,CSVGDKNTGELFF,3,0,1,3
TRBV29-1,TRBJ2-1,CSAIAGGPYEQFF,3,0,1,3
TRBV29-1,TRBJ2-1,CSAQRAVGNEQFF,3,0,1,3
TRBV29-1,TRBJ2-7,CSAGTGGSYEQYF,3,0,1,3
TRBV12-5,TRBJ1-1,CASGRESTEAFF,3,0,1,3
TRBV24-1,TRBJ2-3,CATSGDTDTQYF,3,0,1,3
TRBV19,TRBJ2-4,CATGHDKNIQYF,3,0,1,3
TRBV28,TRBJ2-2,CASLGILGELFF,3,0,1,3
TRBV10-3,TRBJ2-2,CASGQGPGELFF,3,6,2,9
TRBV19,TRBJ2-1,CASTGAHNEQFF,3,0,1,3
TRBV19,TRBJ1-1,CASTRMNTEAFF,3,0,1,3
TRBV19,TRBJ1-5,CASTTLDQPQHF,3,0,1,3
TRBV19,TRBJ2-7,CASSSGSYEQYF,3,0,1,3
TRBV18,TRBJ2-7,CASSPGASEQYF,3,0,1,3
TRBV6-2/3/5/6,TRBJ2-1,CASTDRGPEQFF,3,0,1,3
TRBV27,TRBJ2-7,CASSFGSGGQYF,3,0,1,3
TRBV28,TRBJ2-1,CASSFEKIEQFF,3,0,1,3
TRBV12-3/4,TRBJ1-2,CASSLGVIGYTF,3,0,1,3
TRBV28,TRBJ2-7,CASSLAPYEQYF,3,0,1,3
TRBV12-3/4,TRBJ1-1,CASSLRRTEAFF,3,0,1,3
TRBV12-3/4,TRBJ2-1,CASSYFFNEQFF,3,0,1,3
TRBV6-2/3/5/6,TRBJ2-7,CASSPTSYEQYF,3,0,1,3
TRBV2,TRBJ2-7,CASSRLAYEQYF,3,0,1,3
TRBV12-3/4,TRBJ1-4,CASSHYNEKLFF,3,0,1,3
TRBV6-1,TRBJ2-7,CASSVTSYEQYF,3,0,1,3
TRBV2,TRBJ2-7,CASSENGYEQYF,3,9,2,12
TRBV6-1,TRBJ2-1,CASSELQGYRFF,3,0,1,3
TRBV5-4,TRBJ2-5,CASSLPRETQYF,3,0,1,3
TRBV5-4,TRBJ1-3,CASSLDGNTIYF,3,0,1,3
TRBV7-4,TRBJ2-7,CASSSDSYEQYF,3,0,1,3
TRBV3-1,TRBJ2-1,CASSLTSDEQFF,3,0,1,3
TRBV11-2,TRBJ2-1,CASSPQGDEQFF,3,0,1,3
TRBV3-1,TRBJ2-7,CASSRGTYEQYF,3,0,1,3
TRBV3-1,TRBJ2-1,CASSQEYNEQFF,3,0,1,3
TRBV9,TRBJ2-1,CASSVVAGAPFF,3,0,1,3
TRBV12-3/4,TRBJ2-1,CASRSRDNEQFF,3,0,1,3
TRBV5-5,TRBJ2-7,CASRPDSYEQYF,3,0,1,3
TRBV2,TRBJ2-5,CASRQGEETQYF,3,0,1,3
TRBV2,TRBJ2-7,CASRADLYEQYF,3,0,1,3
TRBV5-5,TRBJ2-5,CASRRGEETQYF,3,0,1,3
TRBV19,TRBJ2-5,CASKGLEETQYF,3,31,2,34
TRBV5-8,TRBJ1-1,CASKATPAEAFF,3,0,1,3
TRBV4-1,TRBJ2-1,CASSRSANEQFF,3,0,1,3
TRBV10-2,TRBJ1-5,CASSEGGQPQHF,3,0,1,3
TRBV5-1,TRBJ2-7,CASSLVSYEQYF,3,0,1,3
TRBV5-1,TRBJ2-1,CASSLVANEQFF,3,0,1,3
TRBV5-1,TRBJ2-1,CASSLKPHEQFF,3,0,1,3
TRBV5-1,TRBJ2-3,CASSLFQDTQYF,3,0,1,3
TRBV5-1,TRBJ2-5,CASRSGSETQYF,3,0,1,3
TRBV20-1,TRBJ1-5,CSVGISNQPQHF,3,0,1,3
TRBV20-1,TRBJ2-7,CSAISGAYEQYF,3,0,1,3
TRBV20-1,TRBJ2-7,CSASGGNGKQYF,3,0,1,3
TRBV20-1,TRBJ2-4,CSARGLFMIQYF,3,0,1,3
TRBV20-1,TRBJ1-5,CSAVTGDQPQHF,3,0,1,3
TRBV20-1,TRBJ2-7,CSAGQGSYEQYF,3,0,1,3
TRBV29-1,TRBJ2-3,CSVRQGADTQYF,3,0,1,3
TRBV29-1,TRBJ2-2,CSVVGAGGELLF,3,0,1,3
TRBV29-1,TRBJ1-3,CSVGETGNTIYF,3,0,1,3
TRBV29-1,TRBJ2-1,CSVEPLYWEQFF,3,0,1,3
TRBV29-1,TRBJ2-7,CSVGGNANEQYF,3,0,1,3
TRBV29-1,TRBJ2-3,CSAGDIGDTQYF,3,0,1,3
TRBV29-1,TRBJ2-5,CSAGHSKETQYF,3,0,1,3
TRBV30,TRBJ1-2,CAWSPRQGYTF,3,0,1,3
TRBV10-3,TRBJ1-2,CAIQGAGGYTF,3,0,1,3
TRBV27,TRBJ2-3,CATQNTDTQYF,3,0,1,3
TRBV6-1,TRBJ1-2,CATGEGAGYTF,3,0,1,3
TRBV19,TRBJ1-2,CASGRSYGYTF,3,0,1,3
TRBV27,TRBJ2-3,CASRRGYTQYF,3,0,1,3
TRBV7-9,TRBJ2-4,CASGQTGLQYF,3,0,1,3
TRBV6-1,TRBJ1-3,CASSAGNTIYF,3,0,1,3
TRBV6-1,TRBJ2-5,CASSERETQYF,3,0,1,3
TRBV7-9,TRBJ2-5,CASSFGEPQYF,3,0,1,3
TRBV7-9,TRBJ2-1,CASSSYNEQFF,3,0,1,3
TRBV7-6,TRBJ1-1,CASSSDRVAFS,3,0,1,3
TRBV7-6,TRBJ2-3,CASSSQLTQYF,3,0,1,3
TRBV7-9,TRBJ2-4,CASSLSVIKYF,3,0,1,3
TRBV6-2/3/5/6,TRBJ2-1,CASKRGGEQFF,3,0,1,3
TRBV5-1,TRBJ2-7,CASSQEYEQYF,3,0,1,3
TRBV20-1,TRBJ1-4,CSARKNEKLFF,3,0,1,3
TRBV20-1,TRBJ2-7,CSADHDYEQYF,3,0,1,3
TRBV20-1,TRBJ2-1,CSATENNEQFF,3,0,1,3
TRBV20-1,TRBJ2-5,CSANQQETQYF,3,0,1,3
TRBV20-1,TRBJ1-1,CSARGGDGAFF,3,0,1,3
TRBV29-1,TRBJ2-3,CSVEPRDTQYF,3,0,1,3
TRBV29-1,TRBJ1-2,CSVENQGSYTF,3,0,1,3
TRBV29-1,TRBJ1-4,CSVSQEEKLFF,3,0,1,3
TRBV2,TRBJ2-5,CASHGETQYF,3,0,1,3
TRBV29-1,TRBJ2-3,CSVVTDTQYF,3,0,1,3
TRBV29-1,TRBJ2-5,CSAGQGWVLF,3,0,1,3
TRBV12-3/4,TRBJ1-2,CASSPGYTF,3,0,1,3
TRBV24-1,TRBJ2-1,CATSDSPGRAGIWESSYNEQFF,2,0,1,2
TRBV12-3/4,TRBJ2-1,CASSAVLLAGAIRKGLNEQFF,2,0,1,2
TRBV27,TRBJ2-1,CASSPQLSVARTTFYNEQFF,2,3,2,5
TRBV7-2,TRBJ2-1,CASSSLWGLAGVSSVNEQFF,2,0,1,2
TRBV19,TRBJ2-1,CASSPRTSGVHSSYNEQFF,2,0,1,2
TRBV28,TRBJ2-3,CASSQGWVLAGIITDTQYF,2,0,1,2
TRBV2,TRBJ2-1,CASSEAHSSGPGSYNEQFF,2,0,1,2
TRBV7-9,TRBJ1-4,CASSLDPPAGLSTNEKLFF,2,0,1,2
TRBV4-2,TRBJ2-1,CASSQDPPKLAGGTNEQFF,2,0,1,2
TRBV12-3/4,TRBJ1-5,CASRSGQWGGSGGNQPQHF,2,0,1,2
TRBV5-1,TRBJ2-1,CASSLGSGRAFRSYNEQFF,2,0,1,2
TRBV4-1,TRBJ1-3,CASSPTSGEMIFSGNTIYF,2,0,1,2
TRBV4-1,TRBJ2-7,CASSQIAGEGDEGNYEQYF,2,0,1,2
TRBV5-4,TRBJ2-7,RASSSYLGQGTSFYYEQYF,2,0,1,2
TRBV10-3,TRBJ1-4,CAISEVLSGTATNEKLFF,2,0,1,2
TRBV24-1,TRBJ2-1,CATSDFSPSGSDYNEQFF,2,0,1,2
TRBV15,TRBJ2-1,CATSRDYSGDTSYNEQFF,2,0,1,2
TRBV19,TRBJ2-1,CASSQGLAGVLYYNEQFF,2,0,1,2
TRBV19,TRBJ1-2,CASSIPSSRDRKRYGYTF,2,0,1,2
TRBV27,TRBJ2-3,CASSFLPPTATSTDTQYF,2,0,1,2
TRBV6-2/3/5/6,TRBJ2-6,CASSLFGTGGSGANVLTF,2,0,1,2
TRBV6-2/3/5/6,TRBJ2-7,CASSLRGLAETLLFEQYF,2,0,1,2
TRBV5-5,TRBJ2-1,CASSLEVAGAVFGDEQFF,2,0,1,2
TRBV3-1,TRBJ2-3,CASSSRLAGGLSTDTQYF,2,0,1,2
TRBV5-4,TRBJ2-1,CASSYTASSGGFYNEQFF,2,0,1,2
TRBV11-2,TRBJ1-2,CASSPNLGQGVANYGYTF,2,0,1,2
TRBV4-2,TRBJ2-2,CASSQERNQGLAPGELFF,2,0,1,2
TRBV3-1,TRBJ2-1,CASSQDPRTSGYYNEQFF,2,0,1,2
TRBV14,TRBJ2-3,CASSQEGRGGPSADTQYF,2,0,1,2
TRBV7-9,TRBJ2-3,CASSATSGPLHSTDTQYF,2,0,1,2
TRBV5-1,TRBJ2-2,CASSLPVHRPRGTGELFF,2,0,1,2
TRBV4-1,TRBJ2-4,CASSQSPPAGVAKNIQYF,2,0,1,2
TRBV10-1,TRBJ2-2,CASSERLAGGPNTGELFF,2,0,1,2
TRBV20-1,TRBJ2-5,CSASGGLGLAGTKETQYF,2,0,1,2
TRBV20-1,TRBJ2-7,CSARVQRGGTSDSYEQYF,2,0,1,2
TRBV29-1,TRBJ2-1,CSAGVASGSPSPYNEQFF,2,0,1,2
TRBV12-3/4,TRBJ2-1,YASSRRPGLAGGRYEQFF,2,0,1,2
TRBV4-2,TRBJ2-7,YASSHQGTSGSNFHEQYF,2,0,1,2
TRBV12-5,TRBJ2-5,CASGWGSGQVNQETQYF,2,0,1,2
TRBV10-3,TRBJ2-5,CAISDSGGGVVRETQYF,2,0,1,2
TRBV15,TRBJ2-3,CATSRPTSALATDTQYF,2,0,1,2
TRBV15,TRBJ2-7,CATSRDQGTGGTYEQYF,2,14,2,16
TRBV19,TRBJ2-6,CASSTKGRFSGANVLTF,2,0,1,2
TRBV19,TRBJ2-1,CASSKDRAGGPFDEQFF,2,0,1,2
TRBV7-3,TRBJ2-2,CASTEPGQGKKGGELFS,2,0,1,2
TRBV28,TRBJ2-4,CASSLDPPYRGKNIQYF,2,0,1,2
TRBV6-2/3/5/6,TRBJ2-6,CASSYSPDRAGANVLTF,2,0,1,2
TRBV28,TRBJ2-1,CASSPPPRTTLRNEQFF,2,0,1,2
TRBV6-1,TRBJ2-1,CASSQNRPGISANEQFF,2,0,1,2
TRBV6-1,TRBJ2-3,CASSVGPLAGNLDAQYF,2,0,1,2
TRBV6-1,TRBJ2-6,CASSEITSFSGANVLTF,2,0,1,2
TRBV2,TRBJ2-1,CASSEAGLAGGPHEQFF,2,0,1,2
TRBV25-1,TRBJ2-1,CASSETRSQGSYNEQFF,2,5,2,7
TRBV2,TRBJ2-3,CASSESSSLDPSDTQYF,2,0,1,2
TRBV11-1,TRBJ2-3,CASSFRLAGDRADTQYF,2,0,1,2
TRBV5-8,TRBJ2-2,CASSFTGTSGSIGELFF,2,0,1,2
TRBV5-4,TRBJ2-1,CASSLGGLAGVVNEQFF,2,0,1,2
TRBV7-8,TRBJ1-1,CASSLGGTAHMNTEAFF,2,0,1,2
TRBV7-9,TRBJ2-7,CASSLGDSRTGAGEQYF,2,0,1,2
TRBV7-2,TRBJ2-2,CASSLTRDRVDTGELFF,2,0,1,2
TRBV7-3,TRBJ2-5,CASSLTRASGRSETQYF,2,0,1,2
TRBV7-9,TRBJ1-1,CASSLTRGPDLNTEAFF,2,0,1,2
TRBV5-4,TRBJ2-3,CASSLRAGGPTADTQYF,2,0,1,2
TRBV11-2,TRBJ2-4,CASSPRTGGVAKNIQYF,2,0,1,2
TRBV5-6,TRBJ2-2,CASSPGTSGMNTGELLL,2,0,1,2
TRBV7-6,TRBJ2-3,CASSPGIAGGRADTQYF,2,0,1,2
TRBV5-6,TRBJ2-1,CASSPMAGTVYYNEQFF,2,0,1,2
TRBV3-1,TRBJ2-1,CASSQGLAGEFYNEQFF,2,0,1,2
TRBV3-1,TRBJ2-5,CASSQDLGVGYQETQYF,2,0,1,2
TRBV9,TRBJ2-1,CASSQTPSRSSYNEQFF,2,0,1,2
TRBV7-9,TRBJ2-3,CASSVLAGGLVADTQNF,2,0,1,2
TRBV28,TRBJ2-3,CASRPPTSGASTDTQYF,2,0,1,2
TRBV6-1,TRBJ2-1,CASRENSGTPANNEQFF,2,0,1,2
TRBV6-2/3/5/6,TRBJ2-3,CASRRTSGMTSTDTQYF,2,0,1,2
TRBV5-1,TRBJ2-1,CASSLAPSGTTYNEQFF,2,0,1,2
TRBV5-1,TRBJ2-1,CASSLDLGQRSYNEQFF,2,0,1,2
TRBV5-1,TRBJ2-7,CASSYTPGTFGSYEQYF,2,0,1,2
TRBV5-1,TRBJ2-2,CASSPRLAGGSAGELFF,2,0,1,2
TRBV4-1,TRBJ2-1,CASSPSPSESTYNEQFF,2,0,1,2
TRBV4-1,TRBJ2-1,CASSQDWGLAGVNEQFF,2,0,1,2
TRBV4-1,TRBJ2-5,CASSQDRGGRGQETQYF,2,0,1,2
TRBV20-1,TRBJ2-1,CSVGGASGGTVYNEQVF,2,0,1,2
TRBV20-1,TRBJ2-3,CSASLLAGGAPPDTQYF,2,0,1,2
TRBV20-1,TRBJ2-3,CSASGGSRPMGADTQYF,2,0,1,2
TRBV20-1,TRBJ2-4,CSARALSAGQGNSVQYF,2,0,1,2
TRBV20-1,TRBJ2-7,CSAPKGLLGGTSYEQYF,2,0,1,2
TRBV29-1,TRBJ2-6,CSVLTGTASSGANVLTL,2,0,1,2
TRBV29-1,TRBJ2-7,CSVQLPLAGARGYEQYF,2,0,1,2
TRBV29-1,TRBJ2-1,CSVDGSAGTRVHNEQFF,2,0,1,2
TRBV29-1,TRBJ2-3,CSVEGQGDQLRPDTQYF,2,0,1,2
TRBV29-1,TRBJ2-3,CSVEGLVTGDDPDTQYF,2,0,1,2
TRBV28,TRBJ2-1,CVSSSFGGRAYNEQFF,2,0,1,2
TRBV16,TRBJ1-6,CALSESWNTNAGKSTF,2,0,1,2
TRBV12-5,TRBJ2-1,CARGLIPGQNYNEQFF,2,0,1,2
TRBV30,TRBJ2-5,CAWSVLGQGHQETQYF,2,0,1,2
TRBV10-3,TRBJ2-2,CAIMGLAGAGGGELFF,2,0,1,2
TRBV3-1,TRBJ2-7,CATSQDFRRETYEQYF,2,0,1,2
TRBV19,TRBJ2-6,CASGPGDLSGANVLTF,2,0,1,2
TRBV19,TRBJ1-2,CASTPGPLGNNYGYTF,2,0,1,2
TRBV19,TRBJ2-1,CASSLQGREPYNEQFF,2,0,1,2
TRBV19,TRBJ2-1,CASSISSGSEANEQFF,2,0,1,2
TRBV19,TRBJ2-1,CASSSRGLADYNEQFF,2,0,1,2
TRBV19,TRBJ1-1,CASSKPSTGTPTGAFF,2,0,1,2
TRBV18,TRBJ2-4,CASSPPGSPVGNIQYF,2,0,1,2
TRBV18,TRBJ2-3,CASSPPSGRAADTQYF,2,0,1,2
TRBV18,TRBJ2-7,CASSPAGRDRGREQYF,2,0,1,2
TRBV28,TRBJ2-2,CASTPSGRGDTGELFF,2,0,1,2
TRBV28,TRBJ2-7,CASSFHLAVLSYEQYF,2,0,1,2
TRBV27,TRBJ2-3,CASSSHGTGGTDTQYF,2,0,1,2
TRBV6-2/3/5/6,TRBJ2-1,CASSYELAGVRDEQFF,2,0,1,2
TRBV6-2/3/5/6,TRBJ2-3,CASSYSLADSTDTQYF,2,0,1,2
TRBV6-2/3/5/6,TRBJ2-6,CASSYSRAPGANVLTF,2,0,1,2
TRBV28,TRBJ2-3,CASSLGRFKGADTQYF,2,0,1,2
TRBV6-2/3/5/6,TRBJ2-6,CASSPTGGSGANVLTF,2,5,2,7
TRBV6-1,TRBJ2-2,CASSGLAPTNTGELFF,2,0,1,2
TRBV6-4,TRBJ2-7,CASSDGTSGSRHEQYF,2,0,1,2
TRBV6-1,TRBJ1-5,CASSEGTGNAYQPQHF,2,4,2,6
TRBV6-1,TRBJ1-5,CASSEAVDRNNQPQHF,2,0,1,2
TRBV27,TRBJ2-3,CASSTRLAGYTDTQYF,2,0,1,2
TRBV25-1,TRBJ1-5,CASSSAGGVGNQPQHF,2,0,1,2
TRBV7-2,TRBJ2-5,CASSFPFGQGEETQYF,2,0,1,2
TRBV13,TRBJ2-7,CASSFGHGQGVYEQYF,2,0,1,2
TRBV7-3,TRBJ2-3,CASSLQGGPTSDTQYF,2,0,1,2
TRBV5-5,TRBJ2-7,CASSLVRTRSSYEQYF,2,0,1,2
TRBV5-4,TRBJ2-7,CASSLGTSGRSYEQYF,2,0,1,2
TRBV5-4,TRBJ2-3,CASSLELAGGMNTQYF,2,0,1,2
TRBV5-6,TRBJ2-3,CASSLRPSGLTDTQYF,2,0,1,2
TRBV11-2,TRBJ2-2,CASSLFWTEDTGELFF,2,0,1,2
TRBV7-9,TRBJ2-2,CASSLLGTSNTGELFF,2,0,1,2
TRBV7-2,TRBJ2-1,CASSLSAGGIDNEQFF,2,0,1,2
TRBV7-2,TRBJ2-7,CASSLRGSPFSYEQYF,2,0,1,2
TRBV7-6,TRBJ2-1,CASSLVGTRDGGEQFF,2,0,1,2
TRBV7-2,TRBJ2-1,CASSLAPTSGNNEQFF,2,0,1,2
TRBV7-6,TRBJ2-1,CASSLGSGNSYNEQFL,2,0,1,2
TRBV7-6,TRBJ2-1,CASSLGGIAPPNEQFF,2,0,1,2
TRBV7-9,TRBJ2-4,CASSLGALQPKNIQYF,2,0,1,2
TRBV11-2,TRBJ2-1,CASSLEGFRSYNEQFF,2,0,1,2
TRBV7-2,TRBJ2-1,CASSLKRLLSGGEQFF,2,0,1,2
TRBV5-4,TRBJ2-7,CASSSSGTSGTYEQYF,2,0,1,2
TRBV7-8,TRBJ2-1,CASSSAGTSGYNEQFF,2,0,1,2
TRBV5-6,TRBJ2-5,CASSSRTQGAGETQYF,2,0,1,2
TRBV5-4,TRBJ2-2,CASSSPSSANTGELFF,2,0,1,2
TRBV7-2,TRBJ2-2,CASSSRVGGNTGELFF,2,0,1,2
TRBV7-9,TRBJ2-4,CASSSGTAIAKNIQYF,2,0,1,2
TRBV7-9,TRBJ2-3,CASSSSRGGRTDTQYF,2,0,1,2
TRBV5-8,TRBJ2-7,CASSSNRLAGVSEQYF,2,0,1,2
TRBV11-3,TRBJ2-3,CASSSPWTIPPDTQYF,2,0,1,2
TRBV7-9,TRBJ2-5,CASSSEGGLPQETQYF,2,0,1,2
TRBV11-1,TRBJ2-2,CASSYQAGSGTGELFF,2,0,1,2
TRBV7-6,TRBJ2-3,CASSLGGLAGTDTQYF,2,0,1,2
TRBV12-3/4,TRBJ1-2,CASSPSWEGATYGYTF,2,0,1,2
TRBV7-2,TRBJ2-7,CASSPSSGRVPYEQYF,2,0,1,2
TRBV7-9,TRBJ2-3,CASSPRPRGGPDTQYF,2,3,2,5
TRBV7-9,TRBJ1-3,CASSPDGTATGNTIYF,2,0,1,2
TRBV5-4,TRBJ2-1,CASSRGGSSSYNEQFF,2,0,1,2
TRBV4-2,TRBJ2-6,CASSHQTGSGANVLTF,2,0,1,2
TRBV7-2,TRBJ2-3,CASSQSSGIRSDTQYF,2,0,1,2
TRBV7-6,TRBJ2-5,CASSQIAGGGQETQYF,2,0,1,2
TRBV6-2/3/5/6,TRBJ2-7,CASSQGQQARFYEQYF,2,0,1,2
TRBV14,TRBJ1-4,CASSQGGRWSNEKLFF,2,0,1,2
TRBV4-2,TRBJ2-1,CASSQDSSFPYNEQFF,2,0,1,2
TRBV4-2,TRBJ2-3,CASSQDGRGGGDTQYF,2,0,1,2
TRBV3-1,TRBJ1-1,CASSQDNWGTITRAFF,2,0,1,2
TRBV3-1,TRBJ2-7,CASSQEGRAPEYEQYF,2,0,1,2
TRBV3-1,TRBJ1-1,CASSQEVEGQNTEAFF,2,0,1,2
TRBV3-1,TRBJ2-7,CASSQSLLAGVHEQYF,2,0,1,2
TRBV11-1,TRBJ2-5,CASSVLAGATQETQYF,2,0,1,2
TRBV9,TRBJ2-1,CASSVDSGQPYNEQFF,2,0,1,2
TRBV4-2,TRBJ2-1,CASSAPSGGDRNEQFF,2,0,1,2
TRBV5-6,TRBJ2-1,CASSGRRAPPYNEQFF,2,0,1,2
TRBV7-8,TRBJ2-7,CASSGAFTGGGYEQYF,2,0,1,2
TRBV5-8,TRBJ2-7,CASSRTGTATPYEQCF,2,0,1,2
TRBV7-2,TRBJ2-7,CASSKYRLAGVYEQYF,2,0,1,2
TRBV2,TRBJ2-1,CASRLGQVISYNEQFF,2,0,1,2
TRBV2,TRBJ1-4,CASNSGQGATNEKLFF,2,0,1,2
TRBV4-1,TRBJ2-4,CASGLPGQIAKNIQYF,2,0,1,2
TRBV10-1,TRBJ1-4,CASSRDRGATNEKLFF,2,0,1,2
TRBV5-1,TRBJ2-1,CASSLRGPLEGNEQFF,2,0,1,2
TRBV5-1,TRBJ2-3,CASSLASRRGTDTQCF,2,0,1,2
TRBV5-1,TRBJ2-2,CASSLAGGEYTGELFF,2,0,1,2
TRBV5-1,TRBJ2-3,CASSLAAQGDADTQYF,2,0,1,2
TRBV5-1,TRBJ2-3,CASSLGPSESTDTQYF,2,0,1,2
TRBV5-1,TRBJ2-1,CASSLGRPLGSNEQFF,2,0,1,2
TRBV5-1,TRBJ2-3,CASSWQGRFSTDTQYF,2,0,1,2
TRBV5-1,TRBJ1-2,CASSWGVGPQSYGYTF,2,0,1,2
TRBV5-1,TRBJ2-2,CASSWDGRQGAGELFF,2,0,1,2
TRBV5-1,TRBJ2-3,CASSPLGQGGTDTQYF,2,0,1,2
TRBV4-1,TRBJ1-3,CASSPRSIIPGNTIYF,2,0,1,2
TRBV4-1,TRBJ2-1,CASSHKLAGGSNEQFF,2,0,1,2
TRBV4-1,TRBJ2-7,CASSQSGGLAIHEQYF,2,0,1,2
TRBV4-1,TRBJ2-3,CASSQAYGSTTDTQYF,2,0,1,2
TRBV4-1,TRBJ2-1,CASSQTGTSGNNEQVF,2,0,1,2
TRBV4-1,TRBJ2-7,CASSQKRSSDPYEQYF,2,0,1,2
TRBV5-1,TRBJ2-2,CASSERVAANTGELFF,2,0,1,2
TRBV5-1,TRBJ2-7,CASSTRTSGRPYEQYF,2,0,1,2
TRBV5-1,TRBJ2-5,CASNSYGTSRGGTQYF,2,0,1,2
TRBV20-1,TRBJ2-1,CSATAAGGLGYNEQFF,2,0,1,2
TRBV20-1,TRBJ2-1,CSASQQGTSGTVGEFF,2,0,1,2
TRBV20-1,TRBJ2-1,CSARPSGSMFYNEQFF,2,0,1,2
TRBV20-1,TRBJ1-5,CSARQGGGGSNQPQHF,2,0,1,2
TRBV20-1,TRBJ2-1,CSARDPREGPSDEQFF,2,0,1,2
TRBV20-1,TRBJ2-4,CSSPPEASLAKNIQYF,2,0,1,2
TRBV29-1,TRBJ2-5,CSVEGRNGILQETQYF,2,0,1,2
TRBV29-1,TRBJ1-2,CSVEDRGTGAYYGYTF,2,0,1,2
TRBV29-1,TRBJ2-3,CSVNAQGPETADAQYF,2,0,1,2
TRBV29-1,TRBJ2-1,CSAPGLAGGRYNEQFF,2,0,1,2
TRBV6-2/3/5/6,TRBJ2-7,RASSPQTSGSSYEQYF,2,0,1,2
TRBV12-5,TRBJ2-4,CASGTRQLAKNIQYF,2,0,1,2
TRBV30,TRBJ1-2,CAWSDQQGANYGYTF,2,0,1,2
TRBV10-3,TRBJ2-5,CAISLGHARGETQYF,2,0,1,2
TRBV10-3,TRBJ2-3,CAIKGQGGSTDTRYF,2,0,1,2
TRBV28,TRBJ2-3,CATLRGGGSIDTQYF,2,4,2,6
TRBV15,TRBJ2-5,CATSPWGEAQETQYF,2,0,1,2
TRBV27,TRBJ2-7,CASSNGQGPPYEQYF,2,0,1,2
TRBV19,TRBJ2-1,CASTRTLGDYNEHFF,2,0,1,2
TRBV19,TRBJ2-7,CASSIFGGSSYEQYF,2,0,1,2
TRBV19,TRBJ2-3,CASSILRSRTDTQYF,2,0,1,2
TRBV19,TRBJ2-7,CASSIGTGTTYEQYF,2,0,1,2
TRBV19,TRBJ1-1,CASSRTVARNTEAFF,2,0,1,2
TRBV19,TRBJ2-7,CASSLPGTSGGKQYF,2,0,1,2
TRBV18,TRBJ2-5,CASSPGTGSQETQHF,2,0,1,2
TRBV18,TRBJ2-3,CASSPKDRSTDTQYF,2,0,1,2
TRBV18,TRBJ2-1,CASSPLTGSGNEQFF,2,0,1,2
TRBV18,TRBJ1-1,CASSPTTGTNAEAFF,2,0,1,2
TRBV18,TRBJ2-1,CASSPSVAGYNEQFF,2,0,1,2
TRBV7-2,TRBJ2-1,CASLQTSYAYNEQFF,2,0,1,2
TRBV12-3/4,TRBJ2-3,CASHRGARSTDTQYF,2,0,1,2
TRBV6-2/3/5/6,TRBJ2-1,CASASGTSGYNEQFF,2,0,1,2
TRBV2,TRBJ2-1,CASTSLAGGGNEQFF,2,0,1,2
TRBV5-4,TRBJ2-1,CASTSGVAIYNEQFF,2,0,1,2
TRBV3-1,TRBJ2-1,CASTHSASGRNEQFF,2,0,1,2
TRBV6-2/3/5/6,TRBJ2-1,CASSFLGGFYNEQFF,2,0,1,2
TRBV6-2/3/5/6,TRBJ2-1,CASSFASGRYNEQFF,2,0,1,2
TRBV28,TRBJ2-1,CASSFAGAGYNERFF,2,0,1,2
TRBV12-3/4,TRBJ2-3,CASSFGGMVGDTQYF,2,0,1,2
TRBV28,TRBJ2-2,CASSLLGLNTGELFF,2,0,1,2
TRBV27,TRBJ2-3,CASSLARGLRDTQYF,2,0,1,2
TRBV12-3/4,TRBJ1-3,CASSLRRTGAHTIYF,2,0,1,2
TRBV12-3/4,TRBJ2-3,CASSSREREWNTQYF,2,0,1,2
TRBV28,TRBJ2-2,CASSSPSAYTGELFF,2,0,1,2
TRBV7-9,TRBJ2-5,CASSSGTSVPETQYF,2,0,1,2
TRBV6-2/3/5/6,TRBJ2-3,CASSSLAGGPNTQYF,2,0,1,2
TRBV6-2/3/5/6,TRBJ1-2,CASSYSLVANYGYTF,2,0,1,2
TRBV6-2/3/5/6,TRBJ1-1,CASSYSGTIGTEAFF,2,0,1,2
TRBV6-2/3/5/6,TRBJ2-7,CASSYAGASSYEQYF,2,0,1,2
TRBV6-2/3/5/6,TRBJ1-6,CASSYGTPDNSPLHF,2,0,1,2
TRBV7-2,TRBJ2-2,CASSLLGGGSGELFF,2,0,1,2
TRBV3-1,TRBJ1-2,CASSPPHRGDGGYAF,2,0,1,2
TRBV27,TRBJ2-1,CASSPSGYLTSEQFF,2,0,1,2
TRBV11-3,TRBJ2-1,CASSQGTSAYNEQFF,2,0,1,2
TRBV2,TRBJ2-1,CASSASGTSVNEQFF,2,0,1,2
TRBV2,TRBJ2-3,CASSAYRDRGSAQYF,2,0,1,2
TRBV6-1,TRBJ2-5,CASSASGQAQETQYF,2,0,1,2
TRBV2,TRBJ2-5,CASSATGDREETQYF,2,0,1,2
TRBV2,TRBJ2-3,CASSGRLAAQDTQYF,2,0,1,2
TRBV6-1,TRBJ2-1,CASSDVGATGEEQFF,2,0,1,2
TRBV6-1,TRBJ2-7,CASSESDGNPYEQYF,2,0,1,2
TRBV7-6,TRBJ2-1,CASSFAVGSYNEQFF,2,0,1,2
TRBV11-2,TRBJ2-1,CASSFMASGDSEQFF,2,0,1,2
TRBV7-2,TRBJ2-1,CASSFIIAGEGEQFF,2,0,1,2
TRBV7-9,TRBJ2-6,CASSFVGSGANVQTF,2,0,1,2
TRBV5-6,TRBJ1-5,CASSLYRGPGQPQHF,2,0,1,2
TRBV5-4,TRBJ2-7,CASSLASGFKYEQYF,2,0,1,2
TRBV5-6,TRBJ1-2,CASSLGFSREDGYTF,2,0,1,2
TRBV5-6,TRBJ1-2,CASSLESSNNYGYTF,2,0,1,2
TRBV7-9,TRBJ2-5,CASSLSRGYQETQYF,2,0,1,2
TRBV7-3,TRBJ2-1,CASSLWTSSYNEQLF,2,0,1,2
TRBV7-3,TRBJ2-6,CASSLLREGANVLTF,2,7,2,9
TRBV7-2,TRBJ2-7,CASSLPLGPFNEQYF,2,0,1,2
TRBV7-9,TRBJ2-7,CASSLVSGRSYEQYF,2,0,1,2
TRBV7-2,TRBJ2-3,CASSLVSATTDTQYF,2,0,1,2
TRBV7-9,TRBJ1-4,CASSLVRQGNEKLFF,2,0,1,2
TRBV7-2,TRBJ2-3,CASSLVRGRAETQYF,2,0,1,2
TRBV7-6,TRBJ2-3,CASSLAGDRIDTQYF,2,0,1,2
TRBV7-9,TRBJ2-7,CASSLAGVVSYEQYF,2,0,1,2
TRBV11-2,TRBJ2-2,CASSLGSVNTGELFF,2,0,1,2
TRBV7-2,TRBJ2-1,CASSLGGLAYNEQFF,2,0,1,2
TRBV7-9,TRBJ2-7,CASSLDGRAVDEQYF,2,0,1,2
TRBV7-9,TRBJ2-5,CASSLTTTLQETQYF,2,0,1,2
TRBV7-6,TRBJ2-7,CASSLSGTGTGEQYF,2,0,1,2
TRBV7-2,TRBJ2-3,CASSLRDRGADTQYF,2,0,1,2
TRBV5-6,TRBJ2-3,CASSSRGGLTDTQYF,2,0,1,2
TRBV7-9,TRBJ2-3,CASSSGTGAADTQYF,2,0,1,2
TRBV11-2,TRBJ1-2,CASSLYRAGNYGYTF,2,0,1,2
TRBV7-2,TRBJ2-7,CASSLVAGALYEQYF,2,0,1,2
TRBV6-2/3/5/6,TRBJ1-3,CASSLQGETGNTIYF,2,0,1,2
TRBV6-2/3/5/6,TRBJ2-7,CASSPLLGGGGEQYF,2,0,1,2
TRBV5-4,TRBJ2-5,CASSPPGSGRETQYF,2,0,1,2
TRBV12-3/4,TRBJ2-1,CASSPPDGGYNEQFF,2,0,1,2
TRBV6-2/3/5/6,TRBJ2-7,CASSPGTTRAYEQYF,2,0,1,2
TRBV7-6,TRBJ2-7,CASSPGQEGIYEQYF,2,0,1,2
TRBV5-6,TRBJ2-7,CASSPGGGALDEQYF,2,0,1,2
TRBV28,TRBJ2-3,CASSRRGYGSDTQYF,2,0,1,2
TRBV7-2,TRBJ2-5,CASSRASGAQETQYF,2,0,1,2
TRBV4-2,TRBJ2-7,CASSQVRAESYEQYF,2,0,1,2
TRBV3-1,TRBJ2-7,CASSQVASGFYEQYF,2,0,1,2
TRBV3-1,TRBJ2-3,CASSQVNRVTDTQYF,2,0,1,2
TRBV3-1,TRBJ2-5,CASSQGTGGYETQYF,2,0,1,2
TRBV3-1,TRBJ2-1,CASSQGSGPRNEQFF,2,0,1,2
TRBV4-2,TRBJ2-5,CASSQDPTGEETQYF,2,0,1,2
TRBV4-2,TRBJ2-1,CASSQDDAAYNEQFF,2,0,1,2
TRBV3-1,TRBJ2-1,CASSQDSAGGREQFF,2,0,1,2
TRBV6-2/3/5/6,TRBJ2-7,CASSQKQGPSYVQYF,2,0,1,2
TRBV9,TRBJ2-3,CASSVSLAGADTQYF,2,0,1,2
TRBV7-2,TRBJ2-3,CASSVVRNSWDTQYF,2,0,1,2
TRBV9,TRBJ2-7,CASSVNRLADYEQYF,2,0,1,2
TRBV9,TRBJ2-3,CASSVKLNSADTQYF,2,0,1,2
TRBV7-9,TRBJ2-1,CASSGGLAGDHEQFF,2,0,1,2
TRBV7-2,TRBJ2-1,CASSGDRSSYNEQFF,2,0,1,2
TRBV11-2,TRBJ2-1,CASSDRDVVYNEQFF,2,0,1,2
TRBV7-9,TRBJ2-3,CASSEGATLQRTQYF,2,0,1,2
TRBV5-5,TRBJ2-5,CASSIRTGGLETQYF,2,0,1,2
TRBV7-9,TRBJ2-7,CASSRGQGSVYEQYF,2,0,1,2
TRBV12-3/4,TRBJ2-5,CASRPSGGARETQYF,2,0,1,2
TRBV2,TRBJ2-1,CASRVLAGGDQQQFF,2,0,1,2
TRBV27,TRBJ1-1,CASRASYQGRTEAFF,2,0,1,2
TRBV2,TRBJ1-5,CASRGSWQRNQPQHF,2,0,1,2
TRBV6-4,TRBJ2-6,CASRDDASGANVLTF,2,0,1,2
TRBV2,TRBJ2-7,CASRTPLGAPYEQYF,2,0,1,2
TRBV3-1,TRBJ2-2,CASRPSVSNTGELFF,2,0,1,2
TRBV10-1,TRBJ2-2,CASADAGPNTGELFF,2,0,1,2
TRBV5-1,TRBJ2-7,CASCRQLDRPHEQYF,2,0,1,2
TRBV5-1,TRBJ2-5,CASYTSGSGQETQYF,2,0,1,2
TRBV5-1,TRBJ2-1,CASRTGTSGYNEQFF,2,0,1,2
TRBV5-1,TRBJ2-2,CASTGTGGYTGELFF,2,0,1,2
TRBV5-1,TRBJ2-1,CASSFLQGAGNEQFF,2,0,1,2
TRBV5-1,TRBJ2-3,CASSFPRGQADTQYF,2,0,1,2
TRBV5-1,TRBJ1-2,CASSFRRPLNYGYTF,2,0,1,2
TRBV5-1,TRBJ1-4,CASSLLHSGSEKLFF,2,0,1,2
TRBV5-1,TRBJ2-1,CASSLVLAEGDEQFF,2,0,1,2
TRBV5-1,TRBJ2-2,CASSLAAINTGELFF,2,0,1,2
TRBV5-1,TRBJ2-1,CASSLAGASYNEQFF,2,0,1,2
TRBV5-1,TRBJ2-6,CASSLAHSGANVLTF,2,0,1,2
TRBV5-1,TRBJ2-6,CASSLGVSGANVLTF,2,0,1,2
TRBV5-1,TRBJ1-4,CASSLDGNNPGKLFF,2,0,1,2
TRBV5-1,TRBJ2-7,CASSLDGDGFYEQYF,2,0,1,2
TRBV5-1,TRBJ1-5,CASSLDGQINQPQHF,2,0,1,2
TRBV5-1,TRBJ2-3,CASSLTPGGLDTQYF,2,0,1,2
TRBV5-1,TRBJ2-2,CASSLTGDSTGELFF,2,0,1,2
TRBV5-1,TRBJ2-1,CASSLQGGTYNEQFF,2,0,1,2
TRBV5-1,TRBJ1-3,CASSSDIGSGNTIYF,2,0,1,2
TRBV5-1,TRBJ2-1,CASSSRLAAYNEQFF,2,0,1,2
TRBV5-1,TRBJ2-1,CASSLSGSSYNEQFF,2,10,2,12
TRBV5-1,TRBJ2-3,CASSLWGPSTDTQYF,2,0,1,2
TRBV5-1,TRBJ2-7,CASSPLAGAFYEQYF,2,0,1,2
TRBV5-1,TRBJ2-5,CASSPRLAGAETQSF,2,0,1,2
TRBV4-1,TRBJ2-3,CASSHPASGQDTQYF,2,0,1,2
TRBV5-1,TRBJ2-1,CASSVGGDSYNEQFF,2,0,1,2
TRBV5-1,TRBJ2-1,CASSARWGSYNEQFF,2,0,1,2
TRBV20-1,TRBJ2-1,CSATSGLEGHNEQFF,2,0,1,2
TRBV20-1,TRBJ2-1,CSASSSGRSRNEQFF,2,0,1,2
TRBV20-1,TRBJ2-1,CSASKRGSGSFEQFF,2,0,1,2
TRBV20-1,TRBJ2-3,CSARSETGFSDTQYF,2,0,1,2
TRBV20-1,TRBJ2-3,CSARTGLGFTDTQYF,2,0,1,2
TRBV20-1,TRBJ2-7,CSARRTSGIVHEQYF,2,0,1,2
TRBV20-1,TRBJ2-5,CSARVAGGPRETQYF,2,0,1,2
TRBV20-1,TRBJ1-4,CSARDLGTGGEELFF,2,0,1,2
TRBV20-1,TRBJ2-5,CSARDGQGARETQYF,2,0,1,2
TRBV20-1,TRBJ2-7,CSARDRTSGKYEQYF,2,0,1,2
TRBV20-1,TRBJ2-7,CSASPTSGSIYEQYF,2,0,1,2
TRBV29-1,TRBJ2-3,CSVFGLAGARDTQYF,2,0,1,2
TRBV29-1,TRBJ2-5,CSVPYRESPQETQYF,2,0,1,2
TRBV29-1,TRBJ1-5,CSVGQGAGGNQPQHF,2,0,1,2
TRBV29-1,TRBJ2-7,CSVEWTGGSEYEQYF,2,0,1,2
TRBV29-1,TRBJ1-1,CSVEVGDRADTEAFF,2,0,1,2
TRBV29-1,TRBJ2-7,CSVEGGTGAAYEQYF,2,0,1,2
TRBV29-1,TRBJ2-1,CSVEGTSAFYNEQFF,2,0,1,2
TRBV29-1,TRBJ2-3,CSVEDWGQGPDAQYF,2,0,1,2
TRBV29-1,TRBJ2-5,CSVEELASGRETQYF,2,0,1,2
TRBV29-1,TRBJ2-7,CSVESRGAGGREQYF,2,0,1,2
TRBV29-1,TRBJ1-1,CSVGTGAHPGTEAFF,2,0,1,2
TRBV29-1,TRBJ2-3,CSVDLMGQSTDTQYF,2,0,1,2
TRBV7-9,TRBJ2-7,RASSLSGTSDYEQYF,2,0,1,2
TRBV14,TRBJ2-7,CACSQEGGPYEQYF,2,0,1,2
TRBV30,TRBJ2-3,CAWSHRTGSDTQYF,2,0,1,2
TRBV30,TRBJ2-1,CAWSGGQGSNEQFF,2,0,1,2
TRBV30,TRBJ2-1,CAWSAGLEDNEQFF,2,0,1,2
TRBV10-3,TRBJ2-7,CAISFETGVHEQYF,2,0,1,2
TRBV12-3/4,TRBJ1-3,CATGMAASGNTIYF,2,0,1,2
TRBV19,TRBJ2-1,CATGPIDSYNEQSF,2,0,1,2
TRBV24-1,TRBJ2-3,CATSARGGTDTQYF,2,0,1,2
TRBV24-1,TRBJ2-3,CATSDRTGPDTQYF,2,0,1,2
TRBV7-9,TRBJ2-5,CATSTTTGGETQYF,2,2,2,4
TRBV19,TRBJ1-2,CASTLRGDLYGYSF,2,0,1,2
TRBV19,TRBJ2-3,CASSAGLGTDTQYF,2,0,1,2
TRBV19,TRBJ2-1,CASSADLRLNEQFF,2,0,1,2
TRBV19,TRBJ2-7,CASSIVSGSYEQYF,2,0,1,2
TRBV19,TRBJ1-1,CASSMGQSNTEAFF,2,0,1,2
TRBV19,TRBJ1-1,CASSKELMNTEAFF,2,0,1,2
TRBV19,TRBJ1-5,CASSFREAHQPQHF,2,0,1,2
TRBV19,TRBJ1-1,CASSSGGAQLGAFF,2,0,1,2
TRBV19,TRBJ2-3,CASSPPGSTDTQYF,2,0,1,2
TRBV18,TRBJ2-5,CASSPGTEQETQYF,2,0,1,2
TRBV18,TRBJ2-5,CASSPPSGGETQYF,2,0,1,2
TRBV18,TRBJ2-3,CASSPNPDRDTQYF,2,0,1,2
TRBV18,TRBJ2-3,CASSPGQGADTQYF,2,0,1,2
TRBV18,TRBJ2-5,CASSPRGLQETQYF,2,0,1,2
TRBV12-3/4,TRBJ2-2,CASTFSGNTGELFF,2,0,1,2
TRBV12-3/4,TRBJ2-7,CASTSSGSSYEQYF,2,0,1,2
TRBV3-1,TRBJ2-2,CASTAGQGTGELFF,2,0,1,2
TRBV2,TRBJ2-1,CASTTSGSFNEQFF,2,0,1,2
TRBV12-3/4,TRBJ1-1,CASSFGQGGTEAFF,2,0,1,2
TRBV12-3/4,TRBJ1-2,CASSFRGVGYGYPF,2,0,1,2
TRBV28,TRBJ2-7,CASSLWGRTYEQYF,2,0,1,2
TRBV6-2/3/5/6,TRBJ2-3,CASSLGLAGVTQYF,2,0,1,2
TRBV7-9,TRBJ1-1,CASSLTGAYTEAFF,2,0,1,2
TRBV12-3/4,TRBJ1-1,CASSLFLENTEAFF,2,0,1,2
TRBV28,TRBJ2-2,CASSLWGQAGELFF,2,0,1,2
TRBV6-2/3/5/6,TRBJ2-7,CASSLGQENYEQYF,2,0,1,2
TRBV12-3/4,TRBJ1-5,CASSLGSRGQPKHF,2,0,1,2
TRBV6-2/3/5/6,TRBJ2-7,CASSLGVSPPEQYF,2,0,1,2
TRBV12-3/4,TRBJ2-7,CASSLEEFGYEQYF,2,0,1,2
TRBV6-2/3/5/6,TRBJ2-1,CASSLNLWGNEQFF,2,0,1,2
TRBV28,TRBJ1-2,CASSSNPGVYGYTF,2,0,1,2
TRBV27,TRBJ1-5,CASSSQVQNQPQHF,2,0,1,2
TRBV6-2/3/5/6,TRBJ2-7,CASSYSVTGNEQYF,2,0,1,2
TRBV6-2/3/5/6,TRBJ2-1,CASSYSGGWNEQFF,2,0,1,2
TRBV6-2/3/5/6,TRBJ2-3,CASSYNTRTDTQYF,2,0,1,2
TRBV7-2,TRBJ2-1,CASSLMGTSNEQFF,2,0,1,2
TRBV7-3,TRBJ2-3,CASSPLSGSPTQYF,2,0,1,2
TRBV6-2/3/5/6,TRBJ2-1,CASSPGQGANEQFF,2,0,1,2
TRBV7-9,TRBJ2-4,CASSPTGGRNIQYF,2,0,1,2
TRBV28,TRBJ2-5,CASSPPLGLRTQYF,2,0,1,2
TRBV6-2/3/5/6,TRBJ1-1,CASSRRQGNTEAFF,2,0,1,2
TRBV7-9,TRBJ2-1,CASSRLAGVNEQFY,2,0,1,2
TRBV11-3,TRBJ2-2,CASSRAGSTGELVF,2,0,1,2
TRBV25-1,TRBJ2-2,CASSVPGFAGELFF,2,0,1,2
TRBV6-1,TRBJ1-2,CASSVGRGVRSYTF,2,0,1,2
TRBV6-1,TRBJ2-1,CASSGDTIYNEQFF,2,0,1,2
TRBV6-4,TRBJ1-4,CASSDVRFNEKLFF,2,0,1,2
TRBV2,TRBJ2-1,CASSEQGAGNEQFF,2,0,1,2
TRBV2,TRBJ2-2,CASSEGNLPPELFF,2,0,1,2
TRBV6-2/3/5/6,TRBJ2-2,CASSITRNTGELFF,2,0,1,2
TRBV6-2/3/5/6,TRBJ1-1,CASSTFDRVAEAFF,2,0,1,2
TRBV12-3/4,TRBJ2-2,CASSKAVGTGELFF,2,0,1,2
TRBV7-3,TRBJ2-5,CASSFYRYQETQYF,2,0,1,2
TRBV5-5,TRBJ1-3,CASSFRDSGNTIYF,2,0,1,2
TRBV7-9,TRBJ2-3,CASSFVDSADTQYF,2,0,1,2
TRBV7-9,TRBJ2-2,CASSFVQNTGELFF,2,0,1,2
TRBV5-4,TRBJ2-3,CASSFGSDPDTQYF,2,0,1,2
TRBV11-1,TRBJ1-1,CASSLLFGNTEAFF,2,0,1,2
TRBV7-6,TRBJ2-2,CASSLVLDTGELFF,2,0,1,2
TRBV5-4,TRBJ2-1,CASSLVTLYNEQFF,2,0,1,2
TRBV5-4,TRBJ2-7,CASSLAQGSYEQYF,2,0,1,2
TRBV5-4,TRBJ2-2,CASSLADLAGELFF,2,0,1,2
TRBV5-6,TRBJ2-1,CASSLGGLAEEQFF,2,0,1,2
TRBV5-8,TRBJ1-5,CASSLIRGQEPQHF,2,0,1,2
TRBV11-1,TRBJ2-7,CASSLSGFSYEQYF,2,0,1,2
TRBV5-4,TRBJ2-5,CASSLPQGARTQYF,2,0,1,2
TRBV7-2,TRBJ2-7,CASSLRFRNYEQYF,2,0,1,2
TRBV7-6,TRBJ2-3,CASSLQVQADTQYF,2,0,1,2
TRBV11-2,TRBJ2-1,CASSLVRKFGEQFF,2,0,1,2
TRBV11-2,TRBJ2-4,CASSLAGGLDIQYF,2,0,1,2
TRBV11-2,TRBJ2-5,CASSLGTVQETQYF,2,0,1,2
TRBV11-2,TRBJ1-4,CASSLDWANEKLFF,2,0,1,2
TRBV7-6,TRBJ2-5,CASSLTGGDETQYF,2,0,1,2
TRBV11-2,TRBJ2-3,CASSLTQAVRTQYF,2,0,1,2
TRBV5-6,TRBJ2-1,CASSSLAGVNEQFF,2,0,1,2
TRBV11-2,TRBJ2-1,CASSSEVGHNEQFF,2,0,1,2
TRBV5-6,TRBJ1-1,CASSSLGGSTEAFF,2,0,1,2
TRBV7-6,TRBJ2-7,CASSSRDGQYEQYF,2,0,1,2
TRBV3-1,TRBJ1-4,CASSSGTGNEKLFF,2,0,1,2
TRBV7-2,TRBJ2-5,CASSSGLVKETQYF,2,3,2,5
TRBV7-6,TRBJ2-1,CASSLDREINEQFF,2,0,1,2
TRBV6-2/3/5/6,TRBJ2-7,CASSPLGQNYEQYF,2,0,1,2
TRBV7-9,TRBJ2-7,CASSPVGGAYEQYF,2,0,1,2
TRBV7-6,TRBJ1-4,CASSPTGRDEKLFF,2,0,1,2
TRBV11-2,TRBJ2-3,CASSPSGRSDTQYF,2,0,1,2
TRBV9,TRBJ2-1,CASSPPGWGNEQFF,2,0,1,2
TRBV12-3/4,TRBJ2-7,CASSPSATVSEQYF,2,0,1,2
TRBV9,TRBJ2-7,CASSPGQGAYEQYF,2,0,1,2
TRBV7-2,TRBJ2-3,CASSPSVGTDTQYF,2,0,1,2
TRBV4-2,TRBJ2-7,CASSPGLVLDEQYF,2,0,1,2
TRBV12-3/4,TRBJ1-5,CASSRMGPNQPQHF,2,0,1,2
TRBV14,TRBJ1-2,CASSQQKQLYGYTF,2,0,1,2
TRBV3-1,TRBJ2-4,CASSQVGQGNIQYF,2,0,1,2
TRBV3-1,TRBJ2-7,CASSQAGVTYEQYF,2,0,1,2
TRBV4-2,TRBJ1-1,CASSQGYRFTEAFF,2,0,1,2
TRBV3-1,TRBJ1-2,CASSQGEGARGYTF,2,0,1,2
TRBV14,TRBJ1-1,CASSQGTRGTEAFF,2,0,1,2
TRBV5-5,TRBJ2-3,CASSQTDRANTQYF,2,0,1,2
TRBV7-2,TRBJ1-6,CASSVERGSRPLHF,2,0,1,2
TRBV13,TRBJ2-1,CASSARTGGYEQFF,2,0,1,2
TRBV7-2,TRBJ2-3,CASSAEGGTDTQYF,2,0,1,2
TRBV3-1,TRBJ2-7,CASSGGGRRYEQYF,2,0,1,2
TRBV7-9,TRBJ2-7,CASSEAGVVYEQYF,2,0,1,2
TRBV11-2,TRBJ2-1,CASSTYRWESEQFF,2,0,1,2
TRBV5-4,TRBJ2-3,CASSTPDSTDTQYF,2,0,1,2
TRBV5-4,TRBJ2-3,CASSTQQGSDTQYF,2,0,1,2
TRBV2,TRBJ2-5,CASREQGVSETQYF,2,0,1,2
TRBV27,TRBJ1-5,CASREGYSNQPQHF,2,0,1,2
TRBV28,TRBJ2-7,CASRSLAGVYEQYF,2,0,1,2
TRBV2,TRBJ2-5,CASRPGTGGETQYF,2,0,1,2
TRBV7-9,TRBJ2-7,CASRRGGSADEQYF,2,0,1,2
TRBV12-3/4,TRBJ2-5,CASNDLAGLGAQYF,2,0,1,2
TRBV27,TRBJ2-3,CASKLAAGADTQYF,2,4,2,6
TRBV12-3/4,TRBJ2-2,CANRGELNTGELFF,2,0,1,2
TRBV20-1,TRBJ2-1,CRARDLRERYEQFF,2,0,1,2
TRBV10-3,TRBJ2-7,CAIADRRFRVEQYF,2,0,1,2
TRBV5-1,TRBJ1-1,CASSPQGGDTEAFF,2,0,1,2
TRBV2,TRBJ1-6,CASSEEQGDSPLHF,2,0,1,2
TRBV5-1,TRBJ2-7,CASSLDSGRGEQYF,2,0,1,2
TRBV5-1,TRBJ1-2,CASSLDRVLKGYTF,2,0,1,2
TRBV5-1,TRBJ1-1,CASSLEGQGTEAFF,2,0,1,2
TRBV5-1,TRBJ2-1,CASSLRDRHNEQFF,2,0,1,2
TRBV4-1,TRBJ1-1,CASSPSWGTTEAFF,2,0,1,2
TRBV4-1,TRBJ2-7,CASSRRGDAYEQYF,2,0,1,2
TRBV4-1,TRBJ2-1,CASSQGLFSNEQFF,2,0,1,2
TRBV4-1,TRBJ2-3,CASSQDKYRVTQYF,2,0,1,2
TRBV4-1,TRBJ2-5,CASSQEDPSGDQYF,2,0,1,2
TRBV5-1,TRBJ1-1,CASSGQGANTEAFF,2,0,1,2
TRBV5-1,TRBJ1-4,CASSIDTFNEKLFF,2,0,1,2
TRBV5-1,TRBJ1-1,CASSTQGADTEAFF,2,0,1,2
TRBV5-1,TRBJ2-7,CASSTNRELYEQYF,2,0,1,2
TRBV5-1,TRBJ2-1,CASRPGTQDNEQFF,2,0,1,2
TRBV20-1,TRBJ1-5,CSALEFIGPQPQHF,2,11,2,13
TRBV20-1,TRBJ2-7,CSAHTTTGDYELYF,2,0,1,2
TRBV20-1,TRBJ2-3,CSAQQAGGPGTQYF,2,0,1,2
TRBV20-1,TRBJ2-1,CSATGGLADNEQFF,2,0,1,2
TRBV20-1,TRBJ2-1,CSASSSGRYNEQFF,2,0,1,2
TRBV20-1,TRBJ2-3,CSASQGAETDTQYF,2,0,1,2
TRBV20-1,TRBJ1-1,CSARDFRGLAEAFF,2,0,1,2
TRBV20-1,TRBJ2-1,CSARDQGHYNEQFF,2,0,1,2
TRBV20-1,TRBJ2-7,CSAKGRPLSYEQYF,2,0,1,2
TRBV20-1,TRBJ2-1,CSALSGRAGNEQFF,2,0,1,2
TRBV20-1,TRBJ2-1,CSAGGTPSYNEQFF,2,0,1,2
TRBV20-1,TRBJ2-6,CSAMRTAGANVLTF,2,0,1,2
TRBV20-1,TRBJ2-3,CSAPLTHFTDTQYL,2,0,1,2
TRBV20-1,TRBJ2-1,CSAVSGSSYNEQFF,2,0,1,2
TRBV29-1,TRBJ2-7,CSVVGPRGYREQCF,2,0,1,2
TRBV29-1,TRBJ2-5,CSVALTGGLETQYF,2,0,1,2
TRBV29-1,TRBJ2-6,CSVALGPGANVLTF,2,0,1,2
TRBV29-1,TRBJ2-1,CSVAAGTGNNEQFF,2,0,1,2
TRBV29-1,TRBJ2-1,CSVGNLDSYNEQFF,2,0,1,2
TRBV29-1,TRBJ2-1,CSVEGIATYNEQFF,2,0,1,2
TRBV29-1,TRBJ2-3,CSVEVAIAADTQYF,2,0,1,2
TRBV29-1,TRBJ2-1,CSVQRELTYNEQFF,2,0,1,2
TRBV29-1,TRBJ2-7,CSVAAAGPGEVQYF,2,0,1,2
TRBV29-1,TRBJ1-2,CSAEGQGAGYGYTF,2,0,1,2
TRBV7-3,TRBJ2-7,RASSLVGLDGEQYF,2,2,2,4
TRBV5-4,TRBJ2-1,CVPGKEDYNEQFF,2,0,1,2
TRBV28,TRBJ2-7,CVSRSQGAGEQYF,2,0,1,2
TRBV7-7,TRBJ2-5,CASSLALVETEYY,2,0,1,2
TRBV10-3,TRBJ2-2,CASGPRETGELFF,2,0,1,2
TRBV28,TRBJ2-1,CACSSGAYNELFF,2,0,1,2
TRBV30,TRBJ2-7,CAWSRDPPHEQYF,2,0,1,2
TRBV30,TRBJ2-7,CAWSVIWGNEQYF,2,0,1,2
TRBV30,TRBJ2-5,CAWSAGHKETQYF,2,0,1,2
TRBV30,TRBJ2-5,CAWSIAGWETQYF,2,0,1,2
TRBV10-3,TRBJ2-7,CAISDRFLYEQYF,2,0,1,2
TRBV2,TRBJ2-5,CAISTGLGETQYF,2,0,1,2
TRBV10-3,TRBJ2-5,CAISDSNEETQYF,2,0,1,2
TRBV10-3,TRBJ2-5,CAISESNEETQYF,2,0,1,2
TRBV10-3,TRBJ2-5,CAIRGQGEETQYF,2,0,1,2
TRBV10-3,TRBJ1-2,CAMRQDLFYGYTF,2,0,1,2
TRBV7-9,TRBJ2-1,CATDRVSYNEQFF,2,0,1,2
TRBV19,TRBJ2-7,CATSSAGVSEQYF,2,0,1,2
TRBV2,TRBJ1-1,CATDIQVGTEAFF,2,0,1,2
TRBV24-1,TRBJ2-1,CATSDTDRDRQFF,2,0,1,2
TRBV28,TRBJ2-2,CASSTSNTGELFF,2,0,1,2
TRBV19,TRBJ2-2,CASTAANTGELFF,2,0,1,2
TRBV19,TRBJ2-1,CASSFGLQTGQFF,2,0,1,2
TRBV19,TRBJ1-1,CASRSGQNTEAFF,2,0,1,2
TRBV19,TRBJ2-1,CASRNSGSNEQFF,2,0,1,2
TRBV18,TRBJ2-5,CASSPGREETQYF,2,0,1,2
TRBV18,TRBJ1-5,CASSPTGDQPQHF,2,0,1,2
TRBV18,TRBJ2-7,CASSPLREIEQYF,2,0,1,2
TRBV18,TRBJ1-5,CASSPAGGQPQHF,2,0,1,2
TRBV6-1,TRBJ2-3,CASISSAGDTQYF,2,0,1,2
TRBV6-2/3/5/6,TRBJ1-1,CASTRGRNTEAYF,2,0,1,2
TRBV5-4,TRBJ2-1,CASTTGVHNEQFF,2,0,1,2
TRBV28,TRBJ1-6,CASSFNREGPLHF,2,0,1,2
TRBV28,TRBJ2-1,CASSLITSGEQFF,2,0,1,2
TRBV28,TRBJ2-1,CASSSGAYNEQFF,2,0,1,2
TRBV7-9,TRBJ2-3,CASSSTLTDTQYF,2,0,1,2
TRBV6-2/3/5/6,TRBJ1-1,CASSYDPGTEAFF,2,0,1,2
TRBV12-3/4,TRBJ2-7,CASSYGTADEQYF,2,0,1,2
TRBV12-3/4,TRBJ2-7,CASSYGLADEQYF,2,0,1,2
TRBV12-3/4,TRBJ2-5,CASSYEGGETQYF,2,0,1,2
TRBV12-3/4,TRBJ2-1,CASSRGQGREQFF,2,0,1,2
TRBV12-3/4,TRBJ2-5,CASSQASSQAQYF,2,0,1,2
TRBV12-3/4,TRBJ2-2,CASSQGRTGELFF,2,0,1,2
TRBV2,TRBJ2-1,CASSVGGGDEQFF,2,0,1,2
TRBV28,TRBJ2-5,CASSGGKRETQYF,2,0,1,2
TRBV2,TRBJ1-5,CASSERSAQPQHF,2,4,2,6
TRBV2,TRBJ2-7,CASSEVISYEQYF,2,0,1,2
TRBV12-3/4,TRBJ2-1,CASSTGPWGEQFF,2,0,1,2
TRBV12-3/4,TRBJ2-7,CASSRRGSYEQYF,2,0,1,2
TRBV11-1,TRBJ2-7,CASSFSRSYEQYF,2,0,1,2
TRBV7-6,TRBJ2-1,CASSFNPYNEQFF,2,2,2,4
TRBV7-2,TRBJ1-2,CASSLSGNYGYTF,2,0,1,2
TRBV7-2,TRBJ2-6,CASSLPGANVLTF,2,13,2,15
TRBV11-2,TRBJ1-5,CASSLVYNQPQHF,2,0,1,2
TRBV11-3,TRBJ2-1,CASSLVPSVEQFF,2,0,1,2
TRBV7-2,TRBJ2-5,CASSLVERETQYF,2,0,1,2
TRBV7-9,TRBJ1-1,CASSLGQVTEAFF,2,0,1,2
TRBV7-2,TRBJ2-7,CASSLDTLYEQYF,2,0,1,2
TRBV7-9,TRBJ2-7,CASSLEPISEQYF,2,0,1,2
TRBV7-6,TRBJ1-2,CASSLEGINGYTF,2,0,1,2
TRBV5-6,TRBJ2-1,CASSLELDNEQFF,2,0,1,2
TRBV11-2,TRBJ2-5,CASSLRRDGAQYF,2,3,2,5
TRBV7-3,TRBJ2-3,CASSSPGTDTQYF,2,0,1,2
TRBV7-9,TRBJ2-1,CASSSGRAHEQFF,2,0,1,2
TRBV7-8,TRBJ1-1,CASSWAGVTEAFF,2,0,1,2
TRBV5-6,TRBJ1-2,CASSYPGNYGYTF,2,0,1,2
TRBV7-6,TRBJ2-1,CASSYQGGNEQFF,2,0,1,2
TRBV5-6,TRBJ2-7,CASSYGGGYEQYF,2,0,1,2
TRBV2,TRBJ1-6,CASSLQGGSPLHF,2,0,1,2
TRBV7-2,TRBJ2-4,CASSLTSGDIQYF,2,0,1,2
TRBV7-2,TRBJ2-7,CASSLSSTVEQYF,2,0,1,2
TRBV27,TRBJ2-1,CASSLSVNHEQFF,2,0,1,2
TRBV3-1,TRBJ2-7,CASSPPFDGEQYF,2,0,1,2
TRBV11-2,TRBJ2-1,CASSPKMAQREFF,2,0,1,2
TRBV7-9,TRBJ2-1,CASSPRSYNEQFF,2,0,1,2
TRBV11-2,TRBJ2-5,CASSPIERETQYF,2,0,1,2
TRBV27,TRBJ2-2,CASSPWDRGWLFF,2,0,1,2
TRBV7-9,TRBJ2-3,CASSPIPADTQYF,2,0,1,2
TRBV14,TRBJ2-2,CASSRFNTGELFF,2,0,1,2
TRBV3-1,TRBJ2-1,CASSQLAGNEQFF,2,0,1,2
TRBV6-2/3/5/6,TRBJ2-1,CASSQDREAIQFF,2,0,1,2
TRBV14,TRBJ2-3,CASSQTEQSLQYF,2,0,1,2
TRBV14,TRBJ1-1,CASSQVGGFEAFF,2,0,1,2
TRBV3-1,TRBJ2-1,CASSQSGSNEQFF,2,0,1,2
TRBV2,TRBJ2-1,CASSVANNNEQFF,2,0,1,2
TRBV5-4,TRBJ1-1,CASSGGRNTEAFF,2,0,1,2
TRBV11-2,TRBJ1-1,CASSGRRNTEAFF,2,0,1,2
TRBV7-9,TRBJ2-3,CASSGAGTDTQYF,2,0,1,2
TRBV6-1,TRBJ2-2,CASSETRTGELFF,2,0,1,2
TRBV27,TRBJ2-5,CASRLAGEGTQYF,2,0,1,2
TRBV9,TRBJ2-7,CASRPGQRHEQYF,2,0,1,2
TRBV12-3/4,TRBJ2-4,CASRHGPGNFQYF,2,0,1,2
TRBV2,TRBJ2-7,CASRAAGGDEQYF,2,0,1,2
TRBV6-4,TRBJ1-2,CASRTDRNYGYTF,2,0,1,2
TRBV6-2/3/5/6,TRBJ2-5,CASRRGHQETQYF,2,0,1,2
TRBV2,TRBJ2-1,CASRRLADNEQFF,2,0,1,2
TRBV28,TRBJ2-3,CASRRQGTDTQYF,2,2,2,4
TRBV3-1,TRBJ2-5,CASRNQGGETQYF,2,0,1,2
TRBV5-6,TRBJ2-1,CASNQGAINEQFF,2,0,1,2
TRBV11-2,TRBJ2-3,CASNGGSTDTQYF,2,0,1,2
TRBV6-2/3/5/6,TRBJ2-4,CASKGPLKNIQYF,2,0,1,2
TRBV2,TRBJ1-5,CAGARGNNQPQHF,2,0,1,2
TRBV20-1,TRBJ2-7,CCASEGSSYEQYF,2,0,1,2
TRBV5-1,TRBJ2-5,CASRLGQGETQYF,2,0,1,2
TRBV5-1,TRBJ2-7,CASGTGTTYEQYF,2,0,1,2
TRBV5-1,TRBJ2-1,CASTRASYNEQFF,2,0,1,2
TRBV5-1,TRBJ2-7,CASSPEGGYEQYF,2,0,1,2
TRBV10-1,TRBJ1-1,CASSELDRGPAFF,2,0,1,2
TRBV5-1,TRBJ2-3,CASSFSGTDTQYF,2,0,1,2
TRBV5-1,TRBJ2-7,CASSLGRVNEQYF,2,0,1,2
TRBV5-1,TRBJ2-7,CASSLSSGLEQYF,2,0,1,2
TRBV5-1,TRBJ1-1,CASSLGGSPEAFF,2,0,1,2
TRBV5-1,TRBJ2-7,CASSLGQGGEQYF,2,0,1,2
TRBV4-1,TRBJ2-3,CASSQDGDDTQYF,2,0,1,2
TRBV20-1,TRBJ2-4,CSVLAGSKNIQYF,2,0,1,2
TRBV20-1,TRBJ2-5,CSVVGEGQETQYF,2,0,1,2
TRBV20-1,TRBJ2-1,CSALWTADNEQFF,2,0,1,2
TRBV20-1,TRBJ2-7,CSAPDLRRREQYF,2,0,1,2
TRBV20-1,TRBJ2-1,CSAGFIQGNEQFF,2,0,1,2
TRBV20-1,TRBJ2-2,CSATPPWNGELFF,2,0,1,2
TRBV20-1,TRBJ1-1,CSARVMGGPEAFF,2,0,1,2
TRBV20-1,TRBJ2-5,CSAKRTGQETQYF,2,4,2,6
TRBV20-1,TRBJ1-1,CSAPGGGRTEAFF,2,0,1,2
TRBV20-1,TRBJ2-7,CSAGGREGLEQYF,2,0,1,2
TRBV20-1,TRBJ2-1,CSAPATPPDEQFF,2,0,1,2
TRBV29-1,TRBJ2-5,CSVSMDRQETQYF,2,0,1,2
TRBV29-1,TRBJ2-5,CSVLQGGQETQYF,2,0,1,2
TRBV29-1,TRBJ1-1,CSVASGSSTEAFF,2,0,1,2
TRBV29-1,TRBJ2-3,CSVESGGADTQYF,2,0,1,2
TRBV29-1,TRBJ2-3,CSVEPARTDTQYF,2,0,1,2
TRBV29-1,TRBJ2-1,CSVESGSMDEQFF,2,0,1,2
TRBV29-1,TRBJ2-1,CSVEGQGYNEQFF,2,0,1,2
TRBV29-1,TRBJ2-7,CSVEGADSYEQYF,2,5,2,7
TRBV29-1,TRBJ2-7,CSGGPGPSYEQYF,2,2,2,4
TRBV20-1,TRBJ2-3,YSVLNGLTDTQYF,2,0,1,2
TRBV30,TRBJ1-2,CAWQEANYGYTF,2,0,1,2
TRBV30,TRBJ2-2,CAWSVGAGELFF,2,0,1,2
TRBV24-1,TRBJ2-1,CATQTSNNEQFF,2,0,1,2
TRBV3-1,TRBJ2-7,CATGQGGYEQYF,2,0,1,2
TRBV24-1,TRBJ1-5,CATSRYNQPQHF,2,0,1,2
TRBV24-1,TRBJ2-2,CATRSSIGELFF,2,0,1,2
TRBV7-9,TRBJ2-7,CATGGGAGEQYF,2,0,1,2
TRBV2,TRBJ1-2,CASRGPPKGYTF,2,0,1,2
TRBV18,TRBJ2-3,CASSELTDTQYF,2,0,1,2
TRBV28,TRBJ2-7,CASQRGNYEQYF,2,0,1,2
TRBV6-2/3/5/6,TRBJ2-1,CASSLPRQKQSS,2,0,1,2
TRBV28,TRBJ2-2,CASSLRTGELFF,2,0,1,2
TRBV6-2/3/5/6,TRBJ2-1,CASSLRAGATFF,2,0,1,2
TRBV27,TRBJ2-7,CASSLRGVEQYF,2,0,1,2
TRBV6-2/3/5/6,TRBJ2-1,CASSSGGNEQFF,2,0,1,2
TRBV28,TRBJ2-7,CASSSTGDEQYF,2,0,1,2
TRBV12-3/4,TRBJ2-3,CASSSRTSRRHF,2,0,1,2
TRBV6-2/3/5/6,TRBJ2-7,CASSYGSYEQYF,2,3,2,5
TRBV6-2/3/5/6,TRBJ2-1,CASSYGSNEQFF,2,0,1,2
TRBV12-3/4,TRBJ2-7,CASSAQGYEQYF,2,0,1,2
TRBV6-2/3/5/6,TRBJ1-1,CASSTGPTEAFF,2,0,1,2
TRBV7-9,TRBJ2-3,CASSFSWDTQYF,2,0,1,2
TRBV11-2,TRBJ2-2,CASSFHLGELFF,2,0,1,2
TRBV7-2,TRBJ2-3,CASSFNGDTQYF,2,0,1,2
TRBV7-9,TRBJ2-5,CASSFWDGAQYF,2,0,1,2
TRBV7-2,TRBJ2-3,CASSLTPPFPYF,2,0,1,2
TRBV7-9,TRBJ2-7,CASSLFGYEQYF,2,0,1,2
TRBV7-3,TRBJ2-2,CASSLQAGELFF,2,0,1,2
TRBV28,TRBJ2-1,CASSLKFRGQFF,2,0,1,2
TRBV7-9,TRBJ2-2,CASSSYTGELFF,2,0,1,2
TRBV11-2,TRBJ2-7,CASSSSGVLAGF,2,0,1,2
TRBV7-9,TRBJ2-1,CASSSPRVEQFF,2,0,1,2
TRBV7-9,TRBJ2-5,CASSSGSGTQYF,2,0,1,2
TRBV7-9,TRBJ1-2,CASSLTGGGYTF,2,0,1,2
TRBV7-9,TRBJ2-1,CASSLELNGQFF,2,0,1,2
TRBV7-9,TRBJ2-1,CASSPAPDEQFF,2,0,1,2
TRBV11-2,TRBJ2-3,CASSPELVSQYF,2,0,1,2
TRBV7-3,TRBJ2-3,CASSPTGETQYF,2,0,1,2
TRBV5-6,TRBJ2-1,CASSPRGQTAFF,2,0,1,2
TRBV12-3/4,TRBJ2-7,CASSRSGYEQYF,2,0,1,2
TRBV4-2,TRBJ2-7,CASSQDLIEQYF,2,35,2,37
TRBV14,TRBJ2-7,CASSQDRQREYF,2,0,1,2
TRBV5-4,TRBJ2-3,CASSRAGGQEYF,2,0,1,2
TRBV3-1,TRBJ2-7,CASRHTGGEQYF,2,0,1,2
TRBV14,TRBJ2-3,CASNPGGDTQYF,2,0,1,2
TRBV14,TRBJ2-1,CASNQADRGRLF,2,0,1,2
TRBV5-1,TRBJ2-5,CASSLGEETQYF,2,0,1,2
TRBV5-1,TRBJ2-7,CASSSDSGEQYF,2,0,1,2
TRBV4-1,TRBJ1-4,CASSQAYGKLFF,2,0,1,2
TRBV29-1,TRBJ1-2,CSLGQEGYGYTF,2,0,1,2
TRBV20-1,TRBJ2-7,CSARGVYYEQYY,2,0,1,2
TRBV20-1,TRBJ2-1,CSASRSGNEQFF,2,0,1,2
TRBV20-1,TRBJ2-7,CSARDLVNEQYF,2,0,1,2
TRBV20-1,TRBJ2-3,CSARDGRDTQYF,2,0,1,2
TRBV20-1,TRBJ2-7,CSAPGQLYEQYF,2,0,1,2
TRBV29-1,TRBJ2-4,CSVGLAKNIQYF,2,0,1,2
TRBV29-1,TRBJ2-5,CSVDGEQETQYF,2,0,1,2
TRBV29-1,TRBJ2-1,CSVTLTSGSVFF,2,0,1,2
TRBV29-1,TRBJ2-7,CSVKDTSYEQYF,2,4,2,6
TRBV29-1,TRBJ2-3,CSAITSSDTQYF,2,0,1,2
TRBV29-1,TRBJ2-5,CSGRQGGETQYF,2,0,1,2
TRBV28,TRBJ2-7,CVSSQSIGQYF,2,0,1,2
TRBV30,TRBJ2-7,CAYGRGYEQYF,2,0,1,2
TRBV27,TRBJ2-3,CASTWGSTQYF,2,0,1,2
TRBV6-2/3/5/6,TRBJ2-7,CASSWGYEQYF,2,0,1,2
TRBV2,TRBJ2-3,CASSKPDTQYF,2,0,1,2
TRBV5-6,TRBJ2-1,CASSLFGEQFF,2,0,1,2
TRBV5-6,TRBJ2-5,CASSLRQTQYF,2,0,1,2
TRBV7-9,TRBJ2-7,CASSLEGRQYF,2,0,1,2
TRBV7-6,TRBJ2-1,CASSSWDEQFF,2,0,1,2
TRBV5-1,TRBJ2-5,CASSSEETQYF,2,6,2,8
TRBV5-4,TRBJ2-4,CASSYKNIQYF,2,0,1,2
TRBV7-6,TRBJ2-5,CASSPGETQYF,2,0,1,2
TRBV7-9,TRBJ2-5,CASSPLQTQYF,2,0,1,2
TRBV6-4,TRBJ1-1,CASSDRGLAFF,2,0,1,2
TRBV20-1,TRBJ2-3,CSASLGDTQYF,2,0,1,2
TRBV20-1,TRBJ2-1,CSARLGVEQFF,2,0,1,2
TRBV29-1,TRBJ2-7,CSYLGTYEQYF,2,0,1,2
TRBV29-1,TRBJ2-5,CSVGLQETQYF,2,0,1,2
TRBV29-1,TRBJ2-7,CSVEGEGEQYF,2,0,1,2
TRBV29-1,TRBJ2-1,CSVLTGVVQFF,2,0,1,2
TRBV29-1,TRBJ2-5,CSARDVQTQYF,2,0,1,2
TRBV19,TRBJ2-3,CAAEGDTQYF,2,14,2,16
TRBV6-2/3/5/6,TRBJ2-3,CASRGHTQYF,2,0,1,2
TRBV20-1,TRBJ2-7,CSTLAYEQYF,2,0,1,2
TRBV29-1,TRBJ2-1,CSAHWNEQFF,2,0,1,2
TRBV20-1,TRBJ2-3,CSPGPQRHF,2,0,1,2
TRBV29-1,TRBJ2-5,CSVGIQYF,2,0,1,2
TRBV19,TRBJ2-1,CASSQTSGNYNEQFF,0,130,1,130
TRBV19,TRBJ2-1,CASSLTSGSYNEQFF,0,128,1,128
TRBV19,TRBJ2-1,CASSRTSGTYNEQFF,0,127,1,127
TRBV7-8,TRBJ2-1,CASSSDRYNEQFF,0,49,1,49
TRBV3-1,TRBJ1-4,CASSQEGRTGLFF,0,45,1,45
TRBV20-1,TRBJ2-7,CSARVTGGTYEQYF,0,43,1,43
TRBV4-1,TRBJ2-2,CASRPNSGVNTGELFF,0,42,1,42
TRBV7-2,TRBJ2-3,CASSPGRPADTQYF,0,37,1,37
TRBV2,TRBJ2-1,CAGTAEGFYNEQFF,0,36,1,36
TRBV19,TRBJ1-5,CASSFSTTPYQPQHF,0,36,1,36
TRBV19,TRBJ2-2,CATEGGLRNTGELFF,0,34,1,34
TRBV3-1,TRBJ2-1,CASSTGLAGGEQFF,0,32,1,32
TRBV7-2,TRBJ2-3,CASSPLQGLKDTQYF,0,31,1,31
TRBV9,TRBJ1-1,CASSVKGGTEAFF,0,30,1,30
TRBV3-1,TRBJ2-1,CASSQGGNEQFF,0,29,1,29
TRBV12-3/4,TRBJ1-1,CASSAQGEGTEAFF,0,28,1,28
TRBV12-3/4,TRBJ2-1,CASSPRLAGAGEQFF,0,27,1,27
TRBV19,TRBJ2-7,CASSIGGYEQYF,0,27,1,27
TRBV5-4,TRBJ2-2,CASSPQRSSGIIGELFF,0,27,1,27
TRBV19,TRBJ2-7,CASSLLTDRDYEQYF,0,27,1,27
TRBV10-2,TRBJ1-6,CASSAQSLRLGFNSPLHF,0,26,1,26
TRBV7-9,TRBJ1-1,CASRYVQQNTEAFF,0,24,1,24
TRBV10-3,TRBJ2-5,CAISESKGLLQETQYF,0,23,1,23
TRBV12-3/4,TRBJ1-1,CASSLGAGMNTEAFF,0,23,1,23
TRBV20-1,TRBJ2-5,CSARPSTGNGETQYF,0,23,1,23
TRBV14,TRBJ2-7,CASSPFRQSQQYF,0,23,1,23
TRBV29-1,TRBJ2-1,CSVDADRVSYNEQFF,0,23,1,23
TRBV18,TRBJ2-3,CASSPPASNAQYF,0,23,1,23
TRBV2,TRBJ2-7,CASSEWAEQYF,0,23,1,23
TRBV19,TRBJ2-1,CASSLTSGDYNEQFF,0,22,1,22
TRBV19,TRBJ2-7,CASAVGHGGSYEQYF,0,22,1,22
TRBV3-1,TRBJ2-1,CASSQERSNKQFF,0,22,1,22
TRBV29-1,TRBJ1-2,CSVVAGGDYGYTF,0,22,1,22
TRBV19,TRBJ1-1,CASSMGNTEAFF,0,22,1,22
TRBV28,TRBJ2-7,CASIPGQGKTYEQYF,0,22,1,22
TRBV19,TRBJ2-1,CASRKNSGNEQFF,0,22,1,22
TRBV2,TRBJ2-1,CASSEDRGSGLAVINEQFF,0,21,1,21
TRBV2,TRBJ1-2,CASRDGQGAGSNYGYTF,0,21,1,21
TRBV18,TRBJ2-6,CASSPPWDSGANVLTF,0,21,1,21
TRBV9,TRBJ2-1,CASDRGNFNNEQFF,0,21,1,21
TRBV20-1,TRBJ2-1,CSATTSWRPHEQFF,0,21,1,21
TRBV20-1,TRBJ2-1,CSATTWQGGEQFF,0,21,1,21
TRBV29-1,TRBJ2-1,CSVDEGRVGFF,0,21,1,21
TRBV3-1,TRBJ1-1,CASSGYGNTEAFF,0,20,1,20
TRBV11-2,TRBJ2-2,CASSQGPGELFF,0,20,1,20
TRBV3-1,TRBJ1-5,CASSQASGNQPQHF,0,20,1,20
TRBV18,TRBJ2-6,CASSRSGPTPISGANVLTF,0,20,1,20
TRBV20-1,TRBJ2-3,CSAGLAGGSTDTQYF,0,20,1,20
TRBV29-1,TRBJ2-5,CSVVRTTQETQYF,0,19,1,19
TRBV19,TRBJ2-1,CASSSSGGGFSSYNEQFF,0,19,1,19
TRBV14,TRBJ2-2,CASSLGTGASRRELFF,0,19,1,19
TRBV20-1,TRBJ2-3,CSARDPVAGDPDTQYF,0,19,1,19
TRBV6-1,TRBJ2-3,CASSESAGAPDTQYF,0,19,1,19
TRBV19,TRBJ2-7,CASSIGEGFYEQYF,0,19,1,19
TRBV3-1,TRBJ2-4,CASSQDVTKNIQYF,0,19,1,19
TRBV30,TRBJ1-2,CAWAPGGPYGYTF,0,19,1,19
TRBV7-2,TRBJ1-6,CASSLDRNSPLHF,0,19,1,19
TRBV7-2,TRBJ2-3,CASSLVGRRTSSTDTQYF,0,18,1,18
TRBV20-1,TRBJ2-5,CSATTGTSGGHQETQYF,0,18,1,18
TRBV19,TRBJ1-1,CASKSQGLVTEAFF,0,18,1,18
TRBV2,TRBJ2-3,CASSEGGGDTQYF,0,18,1,18
TRBV2,TRBJ2-7,CASSRGEQYF,0,18,1,18
TRBV19,TRBJ2-1,CASSIPWGSPSGRLQFF,0,18,1,18
TRBV20-1,TRBJ2-3,CSARPSGLAGFTDTQYF,0,18,1,18
TRBV5-1,TRBJ2-5,CASSLGRTQETQYL,0,18,1,18
TRBV14,TRBJ2-6,CASSQFVQGAGGANVLTF,0,17,1,17
TRBV11-3,TRBJ2-1,CASSSRGTSGRDEQFF,0,17,1,17
TRBV12-3/4,TRBJ2-3,CASSFFASATDTQYF,0,17,1,17
TRBV5-4,TRBJ2-7,CASSLDSPASYEQYF,0,17,1,17
TRBV12-3/4,TRBJ2-7,CASSSGLAGVYEQYF,0,17,1,17
TRBV5-6,TRBJ2-3,CASSPTRGFTDTQYF,0,17,1,17
TRBV12-3/4,TRBJ1-4,CASTTGVTNEKLFF,0,17,1,17
TRBV2,TRBJ2-7,CASSAGWGGSGEYF,0,17,1,17
TRBV6-1,TRBJ2-4,CASSEQAKNIQYF,0,17,1,17
TRBV7-2,TRBJ2-7,CASSLGHRTEQYF,0,17,1,17
TRBV29-1,TRBJ2-7,CSVEDGQDYEQYF,0,17,1,17
TRBV12-3/4,TRBJ1-1,CASTLRNTEAFF,0,17,1,17
TRBV30,TRBJ1-2,CAWEGEGQAF,0,17,1,17
TRBV20-1,TRBJ2-1,CSASGELAGVLSYEQFF,0,17,1,17
TRBV12-3/4,TRBJ2-7,CASSFQRNYEQYF,0,17,1,17
TRBV20-1,TRBJ2-3,CSARDRSGVSADTQYF,0,17,1,17
TRBV19,TRBJ2-6,CASSSGNSGANVLTF,0,17,1,17
TRBV12-3/4,TRBJ2-3,CASSLGRMRDTQYF,0,17,1,17
TRBV19,TRBJ2-1,CASKSPYGSLSDNEQFF,0,17,1,17
TRBV3-1,TRBJ2-1,CASSQQGQYHNEQFF,0,17,1,17
TRBV11-2,TRBJ2-7,CASSLQRALLPNSYEQYF,0,16,1,16
TRBV6-2/3/5/6,TRBJ2-1,CASSYSKTWGAFEQFF,0,16,1,16
TRBV19,TRBJ2-2,CASGPGTGNTGELFF,0,16,1,16
TRBV6-2/3/5/6,TRBJ1-6,CASSLGGLLNSPLHF,0,16,1,16
TRBV5-1,TRBJ1-4,CASSLGSPTNEKLFF,0,16,1,16
TRBV5-1,TRBJ2-1,CASSPGTTSYNEQFF,0,16,1,16
TRBV29-1,TRBJ2-1,CSVALGGGRINEQFF,0,16,1,16
TRBV18,TRBJ2-3,CASSPWDREDTQYF,0,16,1,16
TRBV7-9,TRBJ2-2,CASSIQDTGELFF,0,16,1,16
TRBV28,TRBJ2-4,CASNMGAKNIQYF,0,16,1,16
TRBV12-3/4,TRBJ2-1,CASSSSANEQFF,0,16,1,16
TRBV3-1,TRBJ1-3,CASSPQLSSSGNTIYF,0,16,1,16
TRBV12-3/4,TRBJ2-4,CASSFRLMAKNIQYF,0,16,1,16
TRBV6-2/3/5/6,TRBJ2-3,CASSYRREADTQYF,0,16,1,16
TRBV11-3,TRBJ2-1,CASSLAPNEQFF,0,16,1,16
TRBV5-4,TRBJ2-2,CASSFLGVRTELFF,0,16,1,16
TRBV20-1,TRBJ2-7,CSASTTLREGYEQYF,0,16,1,16
TRBV6-2/3/5/6,TRBJ2-7,CASSYGGSSYEQYF,0,16,1,16
TRBV24-1,TRBJ1-3,CATSDAGGTIYF,0,16,1,16
TRBV7-9,TRBJ2-2,CASSDRTGGPNTGELFF,0,15,1,15
TRBV28,TRBJ2-6,CASSHWGQGANVLTF,0,15,1,15
TRBV19,TRBJ1-5,CASSIQGTDQPQHF,0,15,1,15
TRBV5-5,TRBJ2-3,CASLGLAGTTDTQYF,0,15,1,15
TRBV6-2/3/5/6,TRBJ2-1,CASSYSPSGSSYNEQFF,0,15,1,15
TRBV19,TRBJ2-6,CASSIAGQAYSGANVLTF,0,15,1,15
TRBV12-3/4,TRBJ1-6,CASASLLGRSSYNSPLHF,0,15,1,15
TRBV18,TRBJ1-3,CASSPFSVGAGRNTIYF,0,15,1,15
TRBV5-1,TRBJ2-5,CASSFQATSGVQTQYF,0,15,1,15
TRBV5-1,TRBJ2-7,CASSLSGGTRSDEQYF,0,15,1,15
TRBV20-1,TRBJ2-3,CSAGHVTGRETDTQYF,0,15,1,15
TRBV29-1,TRBJ2-3,CSVATSGTSMPDTQYF,0,15,1,15
TRBV5-6,TRBJ2-7,CASGGPGQGYSEQYF,0,15,1,15
TRBV12-3/4,TRBJ2-5,CASRTSGRASETQYF,0,15,1,15
TRBV3-1,TRBJ2-2,CASRQDVQNGELFF,0,15,1,15
TRBV6-1,TRBJ1-2,CASSEALQGQGYTF,0,15,1,15
TRBV20-1,TRBJ2-3,CSASLRTSTDTQYF,0,15,1,15
TRBV29-1,TRBJ2-7,CSVASRDPPYEQYF,0,15,1,15
TRBV29-1,TRBJ2-3,CSVDRPQGTDTQYF,0,15,1,15
TRBV12-5,TRBJ2-4,CASGLVSSGPQYF,0,15,1,15
TRBV12-5,TRBJ1-5,CASGLVGGQPQHF,0,15,1,15
TRBV12-3/4,TRBJ1-5,CASSSAVNQPQHF,0,15,1,15
TRBV12-3/4,TRBJ1-2,CASSPKTGYGYTF,0,15,1,15
TRBV7-2,TRBJ2-3,CASSPHSTDTQYF,0,15,1,15
TRBV12-3/4,TRBJ2-7,CASSLGREQYF,0,15,1,15
TRBV18,TRBJ2-3,CASSPRATSTDTQYF,0,15,1,15
TRBV20-1,TRBJ2-4,CSARSAGAEAGIQYF,0,15,1,15
TRBV27,TRBJ2-6,CASSPLGTGAAPGANVLTF,0,14,1,14
TRBV11-2,TRBJ1-2,CASSLKFGTGAWFNGYTF,0,14,1,14
TRBV28,TRBJ1-5,RASSSGGALSSNQPQHF,0,14,1,14
TRBV5-1,TRBJ1-5,CASSLGQGWSNQPQHF,0,14,1,14
TRBV5-1,TRBJ2-3,CASSPGTSGYTDTQYF,0,14,1,14
TRBV4-1,TRBJ2-1,CASSQGPSGRYNEQFF,0,14,1,14
TRBV19,TRBJ2-3,CASSSSGTLTDTQYF,0,14,1,14
TRBV12-3/4,TRBJ1-4,CASSFFAVEGGKLFF,0,14,1,14
TRBV6-2/3/5/6,TRBJ1-5,CASSLGTGPGQPQHF,0,14,1,14
TRBV7-2,TRBJ2-3,CASSFRGQSTDTQYF,0,14,1,14
TRBV3-1,TRBJ2-1,CASSQAGGPHNEQFF,0,14,1,14
TRBV20-1,TRBJ2-3,CSASEGEGGTDTQYF,0,14,1,14
TRBV7-2,TRBJ2-4,CASSRGTSANIQYF,0,14,1,14
TRBV5-1,TRBJ2-1,CASSLGRGHNEQFF,0,14,1,14
TRBV20-1,TRBJ2-5,CSAPLILGGETQYF,0,14,1,14
TRBV20-1,TRBJ1-1,CSARGGHSNTEAFF,0,14,1,14
TRBV29-1,TRBJ1-5,CSVSGTGGNQPQHF,0,14,1,14
TRBV18,TRBJ1-5,CASSPAGNQPQHF,0,14,1,14
TRBV13,TRBJ2-1,CASSLGRGDEQFF,0,14,1,14
TRBV7-9,TRBJ1-6,CASSVRGGLPLHF,0,14,1,14
TRBV5-1,TRBJ2-1,CASSWTSGNEQFF,0,14,1,14
TRBV5-1,TRBJ2-7,CASSIGQTYEQYF,0,14,1,14
TRBV20-1,TRBJ1-3,CSARSQVGNTIYF,0,14,1,14
TRBV29-1,TRBJ2-5,CSVGGQHQETQYF,0,14,1,14
TRBV29-1,TRBJ2-1,CSVEGTGSDEQFF,0,14,1,14
TRBV29-1,TRBJ2-7,CSVTRDLTYEQYF,0,14,1,14
TRBV14,TRBJ2-7,CATLGGSEQYF,0,14,1,14
TRBV20-1,TRBJ2-5,CSVQAGETQYF,0,14,1,14
TRBV12-3/4,TRBJ2-4,CASSRTGSLAKNIQYF,0,14,1,14
TRBV29-1,TRBJ2-7,CSAKLRWGASYEQYF,0,14,1,14
TRBV11-2,TRBJ1-2,CASNIQGGTYGYTF,0,14,1,14
TRBV12-3/4,TRBJ1-2,CASSLLGFGYTF,0,14,1,14
TRBV9,TRBJ2-3,CASSERTGGPGDTQYF,0,14,1,14
TRBV24-1,TRBJ2-3,CATSDERDSTDTQYF,0,14,1,14
TRBV5-1,TRBJ2-2,CASSLNQADTGELFF,0,14,1,14
TRBV30,TRBJ2-3,CAWRQASTDTQYF,0,14,1,14
TRBV20-1,TRBJ2-1,CSARVGSSYNEQFF,0,14,1,14
TRBV12-3/4,TRBJ2-2,CASSSWGTGELFF,0,14,1,14
TRBV28,TRBJ2-3,CASSRSGSWTFTGNTDTQYF,0,13,1,13
TRBV3-1,TRBJ2-7,CASSQGRPSGTTSYEQYF,0,13,1,13
TRBV3-1,TRBJ1-3,CASSQVGTGTAGNTIYF,0,13,1,13
TRBV6-1,TRBJ1-1,CASSEETGTTYTEAFF,0,13,1,13
TRBV13,TRBJ2-1,CASSLGTLGYGNEQFF,0,13,1,13
TRBV18,TRBJ1-5,CASSLSYTSNQPQHF,0,13,1,13
TRBV5-4,TRBJ2-1,CASRGTSGSLNEQFF,0,13,1,13
TRBV6-1,TRBJ2-1,CASREEGSGMNEQFF,0,13,1,13
TRBV5-1,TRBJ1-1,CASSGGDRVGTEAFF,0,13,1,13
TRBV12-5,TRBJ2-5,CASGPGQGKETQYF,0,13,1,13
TRBV18,TRBJ2-5,CASSPPGSSETQYF,0,13,1,13
TRBV5-5,TRBJ2-7,CASSSPGRGYEQYF,0,13,1,13
TRBV3-1,TRBJ2-7,CASSQDGGSRMQYF,0,13,1,13
TRBV2,TRBJ2-5,CASRGTGLQETQYF,0,13,1,13
TRBV28,TRBJ2-7,CASNRASGSYEQYF,0,13,1,13
TRBV5-1,TRBJ2-2,CASREPARGGELFF,0,13,1,13
TRBV20-1,TRBJ2-1,CSASSPGAYNEQFF,0,13,1,13
TRBV20-1,TRBJ1-1,CSARPGPMNTEAFF,0,13,1,13
TRBV19,TRBJ1-1,CASSTQPNTEAFF,0,13,1,13
TRBV18,TRBJ2-1,CASSPPASNEQFF,0,13,1,13
TRBV18,TRBJ1-1,CASSTGANTEAFF,0,13,1,13
TRBV25-1,TRBJ1-2,CASSESANYGYTF,0,13,1,13
TRBV2,TRBJ2-1,CASSEALRTEQFF,0,13,1,13
TRBV11-2,TRBJ2-1,CASSLGAGSEQFF,0,13,1,13
TRBV7-3,TRBJ2-6,CASSSSGANVLTF,0,16,1,16
TRBV3-1,TRBJ2-5,CASSRWGGETQYF,0,13,1,13
TRBV14,TRBJ2-1,CASSQARQTRSFF,0,13,1,13
TRBV29-1,TRBJ2-1,CSVESGLRVDQFF,0,13,1,13
TRBV9,TRBJ2-1,CASSVGGNEQFF,0,13,1,13
TRBV5-4,TRBJ2-1,CASSTEDNEQFF,0,13,1,13
TRBV5-1,TRBJ2-1,CASSLGGDEQFF,0,13,1,13
TRBV20-1,TRBJ2-7,CSADDPSYEQYF,0,13,1,13
TRBV2,TRBJ2-1,CASRQGGQFF,0,13,1,13
TRBV11-2,TRBJ2-3,CASSLGRPNTQYF,0,13,1,13
TRBV12-3/4,TRBJ2-1,CACNLGRSYNEQFF,0,13,1,13
TRBV20-1,TRBJ2-3,CSAEGGGVDTQYF,0,13,1,13
TRBV24-1,TRBJ2-5,CATSDPGGGEETQYF,0,13,1,13
TRBV5-5,TRBJ1-1,CASSLVQSNTEAFF,0,13,1,13
TRBV20-1,TRBJ1-6,CSATGQIQGSPLHF,0,13,1,13
TRBV20-1,TRBJ1-1,CSGGSVRAKNTEAFF,0,13,1,13
TRBV11-2,TRBJ2-3,CASSLAVFPDTQYF,0,13,1,13
TRBV4-2,TRBJ2-1,CASSQVVLTGDGYEQFF,0,13,1,13
TRBV5-1,TRBJ2-1,CASSLEGGVSYNEQFF,0,13,1,13
TRBV12-3/4,TRBJ2-3,CASSLGFTDTQYF,0,13,1,13
TRBV10-1,TRBJ2-7,CASSGDKDEQYF,0,13,1,13
TRBV20-1,TRBJ2-5,CSAPGDTLQETQYF,0,12,1,12
TRBV19,TRBJ2-1,CASSPIGWGSSYNEQFF,0,12,1,12
TRBV6-4,TRBJ2-1,CASSTINRGARFSEQFF,0,12,1,12
TRBV27,TRBJ1-5,CASSFSSTGSNQPQHF,0,12,1,12
TRBV11-2,TRBJ2-1,CASSLSRGSSYNEQFF,0,12,1,12
TRBV7-6,TRBJ2-1,CASSPWTSGRGNEQFF,0,12,1,12
TRBV3-1,TRBJ2-2,CASSRRDWGTTGELFF,0,12,1,12
TRBV19,TRBJ2-1,CASISSGRADNEQFF,0,12,1,12
TRBV12-3/4,TRBJ2-1,CASSFLAGGPGEQFF,0,12,1,12
TRBV12-3/4,TRBJ2-1,CASSSPTDRGDEQFF,0,12,1,12
TRBV6-2/3/5/6,TRBJ1-5,CASSSEGLESQPQHF,0,12,1,12
TRBV2,TRBJ2-7,CASSENRDRGYEQYF,0,12,1,12
TRBV11-2,TRBJ2-7,CASSLVGGVSSEQYF,0,12,1,12
TRBV7-2,TRBJ2-3,CASSLASYSTDTQYF,0,12,1,12
TRBV3-1,TRBJ2-2,CASSPFSGAAGELFF,0,12,1,12
TRBV27,TRBJ1-2,CASSHTGGSNYGYTF,0,12,1,12
TRBV5-1,TRBJ2-2,CASSLAGLNTGELFF,0,12,1,12
TRBV5-1,TRBJ2-6,CASRVQGSGANVLTF,0,12,1,12
TRBV20-1,TRBJ2-5,CSARPGLAGVQTQYF,0,12,1,12
TRBV20-1,TRBJ2-5,CSARPGGGGSETQYF,0,12,1,12
TRBV29-1,TRBJ2-3,CSVGGRAPSTDTQYF,0,12,1,12
TRBV29-1,TRBJ2-1,CSAKVRLGAYNEQFF,0,12,1,12
TRBV19,TRBJ1-1,CASSVGGMNTEAFF,0,12,1,12
TRBV18,TRBJ1-1,CASSERTGGTEAFF,0,12,1,12
TRBV28,TRBJ2-3,CASGKREVTDTQYF,0,12,1,12
TRBV2,TRBJ2-5,CASSEIRVRETQYF,0,12,1,12
TRBV3-1,TRBJ2-7,CASSQTARGYEQYF,0,12,1,12
TRBV5-6,TRBJ2-7,CASNPGLGAYEQYF,0,12,1,12
TRBV5-1,TRBJ2-1,CASQAGGPYNEQFF,0,12,1,12
TRBV5-1,TRBJ1-2,CASSVAGQGIGYTF,0,12,1,12
TRBV29-1,TRBJ2-4,CSVGLAVGRDIQYF,0,12,1,12
TRBV29-1,TRBJ2-5,CSVEAPTGGETQYF,0,12,1,12
TRBV29-1,TRBJ2-3,CSASAGELADTQYF,0,12,1,12
TRBV10-3,TRBJ1-5,CAIQADSNQPQHF,0,12,1,12
TRBV19,TRBJ1-1,CASSRGSYTEAFF,0,12,1,12
TRBV12-3/4,TRBJ2-1,CASSLTSYNEQFF,0,12,1,12
TRBV6-1,TRBJ2-1,CASSVEGYNEQFF,0,12,1,12
TRBV2,TRBJ1-1,CASSESPDRVAFF,0,12,1,12
TRBV7-6,TRBJ2-7,CASSLGGSGEQYF,0,12,1,12
TRBV5-4,TRBJ2-3,CASSLVGSDTQYF,0,12,1,12
TRBV7-9,TRBJ1-1,CASSGTENTEAFF,0,12,1,12
TRBV5-1,TRBJ2-1,CASSPQGYNEQFF,0,12,1,12
TRBV20-1,TRBJ2-5,CSAWDSSSETQYF,0,12,1,12
TRBV7-9,TRBJ2-7,CATGDPAYEQYF,0,12,1,12
TRBV28,TRBJ2-1,CASSSRNNEQFF,0,12,1,12
TRBV5-1,TRBJ2-1,CASRRGNEQFF,0,12,1,12
TRBV29-1,TRBJ2-1,CSARVYNEQFF,0,12,1,12
TRBV29-1,TRBJ1-1,CSVEKGGAFF,0,12,1,12
TRBV19,TRBJ1-4,CASSRTGGHPNEKLFF,0,12,1,12
TRBV12-3/4,TRBJ2-7,CASSFFGGYEQYF,0,12,1,12
TRBV2,TRBJ2-3,CASNDISTDTQYF,0,12,1,12
TRBV7-3,TRBJ2-1,CASSPPGGEQFF,0,12,1,12
TRBV6-2/3/5/6,TRBJ1-5,CASSPGGLSFPHQPQHF,0,12,1,12
TRBV30,TRBJ1-2,CAWSRPPRSYGYTF,0,12,1,12
TRBV7-2,TRBJ1-2,CASSPSFYPGGYTF,0,12,1,12
TRBV6-2/3/5/6,TRBJ2-1,CASRYKEPYNEQFF,0,12,1,12
TRBV7-2,TRBJ2-3,CASSLKLAGGGDTQYF,0,12,1,12
TRBV29-1,TRBJ2-1,CSVPPGGTGGYNEQFF,0,12,1,12
TRBV7-3,TRBJ2-3,CASSPSGTSGATQYF,0,12,1,12
TRBV5-1,TRBJ2-3,CASSRRVSTDTQYF,0,12,1,12
TRBV29-1,TRBJ1-1,CSVRPTGLNTEAFF,0,12,1,12
TRBV5-6,TRBJ2-7,CASRPGGRSEQYF,0,12,1,12
TRBV19,TRBJ2-3,CASSIGWTGGDFKSTDTQYF,0,11,1,11
TRBV12-3/4,TRBJ2-2,CASSRQAGTSSTGELFF,0,11,1,11
TRBV20-1,TRBJ2-1,CSAQGLAGERGGGEQFF,0,11,1,11
TRBV20-1,TRBJ2-2,CSARSFRSGANTGELFF,0,11,1,11
TRBV20-1,TRBJ2-3,CSATRGSGSGRTDTQYF,0,11,1,11
TRBV28,TRBJ2-1,CASSLPPGLAGLEQFF,0,11,1,11
TRBV28,TRBJ2-1,CASSLGGLATYNEQFF,0,11,1,11
TRBV3-1,TRBJ2-5,CASSQSGTGEWETQYF,0,11,1,11
TRBV3-1,TRBJ2-4,CASSQGWVLAKNIQYF,0,11,1,11
TRBV5-1,TRBJ2-3,CASSLRGTSGAYTQYF,0,11,1,11
TRBV5-1,TRBJ2-1,CASSLEGQGSYNEQFF,0,11,1,11
TRBV20-1,TRBJ2-5,CSARDKEGDHQETQYF,0,11,1,11
TRBV19,TRBJ2-1,CASSSGTGEIHEQFF,0,11,1,11
TRBV28,TRBJ2-1,CASSPLAGLSHEQFF,0,11,1,11
TRBV2,TRBJ2-3,CASSRGTAATDTQYF,0,11,1,11
TRBV5-6,TRBJ2-4,CASSSSTPPRNIQYF,0,11,1,11
TRBV3-1,TRBJ2-3,CASSPSGSDTDTQYF,0,11,1,11
TRBV3-1,TRBJ1-5,CASSQGPGYDQPQHF,0,11,1,11
TRBV4-2,TRBJ1-1,CASSQGDRGRTEAFF,0,11,1,11
TRBV4-1,TRBJ2-7,CASSQGRAYSYEQYF,0,11,1,11
TRBV28,TRBJ2-7,CASSLYRGSYEQYF,0,11,1,11
TRBV6-2/3/5/6,TRBJ2-7,CASSYSVSSYEQYF,0,11,1,11
TRBV6-2/3/5/6,TRBJ1-2,CASSYSGGKYGYTF,0,11,1,11
TRBV6-2/3/5/6,TRBJ2-1,CASSYGGRYNEQFF,0,11,1,11
TRBV12-3/4,TRBJ2-5,CASSPRGLDGDQYF,0,11,1,11
TRBV5-6,TRBJ1-2,CASSLRPGTYGYTF,0,11,1,11
TRBV5-1,TRBJ2-7,CASSFASDSYEQYF,0,11,1,11
TRBV5-1,TRBJ2-7,CASSSADSSYEQYF,0,11,1,11
TRBV20-1,TRBJ1-1,CSAPHPGSNTEAFF,0,11,1,11
TRBV29-1,TRBJ1-1,CSVEQGARNTEAFF,0,11,1,11
TRBV29-1,TRBJ2-3,CSVEVGRGGDTQYF,0,11,1,11
TRBV30,TRBJ1-5,CAWSRQGPQPQHF,0,11,1,11
TRBV19,TRBJ2-5,CASNSLFQETQYF,0,11,1,11
TRBV12-3/4,TRBJ1-1,CASSLGGATEAFF,0,11,1,11
TRBV7-9,TRBJ2-7,CASSLGSGYEQYF,0,11,1,11
TRBV7-8,TRBJ1-1,CASSLGGNTEAFF,0,11,1,11
TRBV11-1,TRBJ2-1,CASSLIGANEQFF,0,11,1,11
TRBV5-6,TRBJ2-1,CASSWDGSNEQFF,0,11,1,11
TRBV7-2,TRBJ2-3,CASSPRLKDTQYF,0,11,1,11
TRBV7-9,TRBJ2-3,CASSPKWADTQYF,0,11,1,11
TRBV10-1,TRBJ1-1,CASSESTGKGAFF,0,11,1,11
TRBV20-1,TRBJ2-1,CSAPLAGLNEQFF,0,11,1,11
TRBV29-1,TRBJ2-7,CSVAGTGMGEQYF,0,11,1,11
TRBV29-1,TRBJ2-1,CSVRTSGRDEQFF,0,11,1,11
TRBV19,TRBJ2-1,CASSPRRNEQFF,0,11,1,11
TRBV29-1,TRBJ2-7,CSVGEGQYEQYF,0,11,1,11
TRBV29-1,TRBJ1-4,CSATGGYEKLFF,0,11,1,11
TRBV19,TRBJ1-1,CASWQNTEAFF,0,11,1,11
TRBV2,TRBJ2-7,CASRGAYEQYF,0,11,1,11
TRBV20-1,TRBJ2-1,CSASGGNEQFF,0,11,1,11
TRBV29-1,TRBJ2-1,CSVVGNNEQFF,0,11,1,11
TRBV5-1,TRBJ2-2,CASSLRQLTNTGELFF,0,11,1,11
TRBV12-3/4,TRBJ2-6,CARVLAGSGANVLTF,0,11,1,11
TRBV12-3/4,TRBJ1-5,CASSLGPGPNQPQHF,0,11,1,11
TRBV5-4,TRBJ2-3,CASSLGPGYTDTQYF,0,11,1,11
TRBV29-1,TRBJ2-2,CSATGTASNTGELFF,0,11,1,11
TRBV12-3/4,TRBJ2-3,CASLRSPDDTQYF,0,11,1,11
TRBV20-1,TRBJ2-4,CSAMARQGNIQYF,0,11,1,11
TRBV6-2/3/5/6,TRBJ1-3,CASSYDGDTIYF,0,11,1,11
TRBV5-6,TRBJ2-5,CASSFSGGYFGQQETQYF,0,11,1,11
TRBV11-2,TRBJ2-7,CASSLPKTSGKSYEQYF,0,11,1,11
TRBV18,TRBJ1-1,CASSPPVGRGMTEAFF,0,11,1,11
TRBV18,TRBJ1-1,CASSPSTGGDTEAFF,0,11,1,11
TRBV11-2,TRBJ1-1,CASSLQLRLNTEAFF,0,11,1,11
TRBV5-4,TRBJ2-2,CASSRGQGAGELFF,0,11,1,11
TRBV27,TRBJ2-1,CASEGGGYNEQFF,0,11,1,11
TRBV12-3/4,TRBJ1-2,CASSFQGANYGYTF,0,11,1,11
TRBV19,TRBJ2-3,CASSGTSGTVDTQYF,0,11,1,11
TRBV5-1,TRBJ2-7,CASSYGTSGPYEQYF,0,11,1,11
TRBV2,TRBJ2-1,CASGLGQGNVQFF,0,11,1,11
TRBV3-1,TRBJ1-5,CASSSWIDQPQHL,0,11,1,11
TRBV20-1,TRBJ1-4,CSASKGSGEKLFF,0,11,1,11
TRBV19,TRBJ2-1,CASSTYPQRLSSYNEQFF,0,11,1,11
TRBV19,TRBJ1-5,CASSPQLGASNQPQHF,0,10,1,10
TRBV3-1,TRBJ1-1,CASSPRGAVDTEAFF,0,10,1,10
TRBV12-3/4,TRBJ1-5,CASTSSSNQPQHF,0,10,1,10
TRBV7-9,TRBJ1-6,CASKEAASPLHF,0,10,1,10
TRBV20-1,TRBJ2-1,CSARLPGQLEFF,0,10,1,10
TRBV18,TRBJ2-1,RASSPSSGAYNEQFF,0,10,1,10
TRBV3-1,TRBJ2-1,CASSQRLGLEANEQFF,0,10,1,10
TRBV20-1,TRBJ2-7,CSADGGVLRSSYEQYF,0,10,1,10
TRBV19,TRBJ2-7,CASSDSGRIDEQYF,0,10,1,10
TRBV7-2,TRBJ2-1,CASGSRSSYNEQFF,0,10,1,10
TRBV9,TRBJ2-1,CASSQSPRYNEQFF,0,10,1,10
TRBV5-1,TRBJ1-1,CASSRYMNTEAFF,0,10,1,10
TRBV25-1,TRBJ2-1,CASSGRGEQFF,0,10,1,10
TRBV20-1,TRBJ2-3,CSASGVDTQYF,0,10,1,10
TRBV5-6,TRBJ2-1,CASSFRTSGSKGYNEQFF,0,10,1,10
TRBV5-1,TRBJ2-3,CASSFRTGGGTDTQYF,0,10,1,10
TRBV19,TRBJ2-1,CASTDTGGSYNEQSF,0,10,1,10
TRBV7-2,TRBJ2-5,CASSLTLQGRETQYF,0,10,1,10
TRBV7-9,TRBJ1-1,CASSWSGTLNTEAFF,0,10,1,10
TRBV19,TRBJ2-1,WASSISWDPYNEQFF,0,10,1,10
TRBV5-6,TRBJ2-3,CASCYDGGGDTQYF,0,10,1,10
TRBV7-9,TRBJ2-3,CAGGRDARSDTQYF,0,10,1,10
TRBV5-1,TRBJ2-7,CASSPQTSSYEQYF,0,10,1,10
TRBV30,TRBJ1-5,CAWGRGLSNQPQHF,0,10,1,10
TRBV18,TRBJ2-2,CASSPSEDCGELFF,0,10,1,10
TRBV5-1,TRBJ1-1,CASSRPPAGSREFGFGNTEAFF,0,10,1,10
TRBV2,TRBJ2-3,CASTLWGWGASTDTQYF,0,10,1,10
TRBV2,TRBJ2-3,CASSPTSGGMTTDTQYF,0,10,1,10
TRBV29-1,TRBJ2-3,CSVEGGLAGGSTDTQYF,0,10,1,10
TRBV12-5,TRBJ1-6,CASGSTGSSYNSPLHF,0,10,1,10
TRBV19,TRBJ1-1,CASTSDSIVGNTEAFF,0,10,1,10
TRBV27,TRBJ1-3,CASSLTAGFSGNTIYF,0,10,1,10
TRBV5-5,TRBJ2-1,CASSFRLPSSYNEQFF,0,10,1,10
TRBV5-1,TRBJ2-7,CASSPRTSGGEHEQYF,0,10,1,10
TRBV20-1,TRBJ1-5,CSATRDKPNSNQPQHF,0,10,1,10
TRBV29-1,TRBJ2-2,CSVSGRSQGATGELFF,0,10,1,10
TRBV10-3,TRBJ2-5,CAISESAGEGETQYF,0,10,1,10
TRBV10-3,TRBJ2-7,CAISESGGEVDEQYF,0,10,1,10
TRBV24-1,TRBJ2-7,CATSDPRQASYEQYF,0,10,1,10
TRBV12-3/4,TRBJ2-7,CASSFRRTGVPQQYF,0,10,1,10
TRBV12-3/4,TRBJ1-5,CASSLGAVSNQPQHF,0,10,1,10
TRBV7-2,TRBJ2-1,CASSFDLQVLNEQFF,0,10,1,10
TRBV3-1,TRBJ2-1,CASSSRLAVVDEQFF,0,10,1,10
TRBV7-2,TRBJ2-1,CASSSGLASNNEQFF,0,10,1,10
TRBV7-4,TRBJ2-3,CASSRDGLSTDTQYF,0,10,1,10
TRBV3-1,TRBJ2-7,CASSHEATSPYEQYF,0,10,1,10
TRBV9,TRBJ2-5,CASSVGRGSQETQYF,0,10,1,10
TRBV6-2/3/5/6,TRBJ2-3,CASNRASGSTDTQYF,0,10,1,10
TRBV27,TRBJ1-3,CASKRQGTSGNTIYF,0,10,1,10
TRBV5-1,TRBJ2-7,CASSFAGTNAYEQYF,0,10,1,10
TRBV5-1,TRBJ1-1,CASSYIKPRGPEAFF,0,10,1,10
TRBV29-1,TRBJ2-3,CSVVGTSGITDTQYF,0,10,1,10
TRBV29-1,TRBJ2-2,CSVGSGPKNTGELFF,0,10,1,10
TRBV19,TRBJ2-7,CASSFKAGPYEQYF,0,10,1,10
TRBV19,TRBJ2-2,CASSALGGTGELFF,0,10,1,10
TRBV19,TRBJ1-1,CASSIEGTNTEAFF,0,10,1,10
TRBV27,TRBJ2-3,CASSLEDDTDTQYF,0,10,1,10
TRBV27,TRBJ2-5,CASSYRERKETQYF,0,10,1,10
TRBV12-3/4,TRBJ1-5,CASSGVTANQPQHF,0,10,1,10
TRBV7-2,TRBJ2-1,CASSFGGSVNEQFF,0,10,1,10
TRBV7-9,TRBJ2-5,CASSLVGGRETQYF,0,10,1,10
TRBV5-4,TRBJ1-1,CASSSPGTRIQAFF,0,10,1,10
TRBV3-1,TRBJ2-1,CASSLSGVANEQFF,0,10,1,10
TRBV3-1,TRBJ2-7,CASSPGSGAYEQYF,0,10,1,10
TRBV3-1,TRBJ2-2,CASSRLADTGELFF,0,10,1,10
TRBV7-9,TRBJ1-2,CASSTLDGLGGYTF,0,10,1,10
TRBV12-3/4,TRBJ2-1,CASKSGSIYNEQFF,0,10,1,10
TRBV20-1,TRBJ2-5,CSAIQHIDQETQYF,0,10,1,10
TRBV20-1,TRBJ2-3,CSARTGLATDTQYF,0,10,1,10
TRBV20-1,TRBJ2-3,CSARGAGYTDTQYF,0,10,1,10
TRBV20-1,TRBJ2-5,CSARDLGHKETQYF,0,10,1,10
TRBV20-1,TRBJ1-5,CSARDEEGNQPQHF,0,10,1,10
TRBV20-1,TRBJ2-2,CSARSPSNTGELFF,0,10,1,10
TRBV29-1,TRBJ2-3,CSVETRASTDTQYF,0,10,1,10
TRBV18,TRBJ1-1,CASSQTVSTEAFF,0,10,1,10
TRBV7-6,TRBJ2-2,CASGQGSTGELFF,0,10,1,10
TRBV28,TRBJ2-3,CASSSLMTDTQYF,0,10,1,10
TRBV12-3/4,TRBJ2-7,CASSPGLGDEQYF,0,10,1,10
TRBV2,TRBJ2-5,CASSATLEETQYF,0,10,1,10
TRBV5-5,TRBJ2-5,CASSLPGKETQYF,0,10,1,10
TRBV7-9,TRBJ1-4,CASSSGGGEKLFF,0,10,1,10
TRBV14,TRBJ2-7,CASSRGLAEEQYF,0,10,1,10
TRBV5-4,TRBJ2-7,CASSRDYLYEQYF,0,10,1,10
TRBV5-1,TRBJ1-1,CASSSQEGTEAFF,0,10,1,10
TRBV4-1,TRBJ2-4,CASSQGVSDIQYF,0,10,1,10
TRBV5-1,TRBJ2-3,CASSGRQGGTQYF,0,10,1,10
TRBV5-1,TRBJ2-3,CASRPPGYGTQYF,0,10,1,10
TRBV20-1,TRBJ2-3,CSASGLRTDTQYF,0,10,1,10
TRBV20-1,TRBJ2-7,CSARSRGGYEQYF,0,10,1,10
TRBV20-1,TRBJ2-5,CSATILARKTQYF,0,10,1,10
TRBV29-1,TRBJ2-7,CSVEDRAGYEQYF,0,10,1,10
TRBV29-1,TRBJ2-5,CSVTTSAQETQYF,0,10,1,10
TRBV6-2/3/5/6,TRBJ2-1,CASSRPYNEQFF,0,10,1,10
TRBV7-9,TRBJ2-1,CASSLVSGGHSF,0,10,1,10
TRBV7-2,TRBJ2-3,CASSSGVDTQYF,0,10,1,10
TRBV5-5,TRBJ2-1,CASSPKTLEQFF,0,10,1,10
TRBV5-4,TRBJ2-5,CASSTDEETQYF,0,10,1,10
TRBV7-2,TRBJ2-3,CASSEGTDTQYF,0,12,1,12
TRBV4-1,TRBJ2-5,CASSQEDGTQYF,0,10,1,10
TRBV29-1,TRBJ1-2,CSVERGYYGYTF,0,10,1,10
TRBV6-4,TRBJ2-3,CASSATSPGLAGTGTDTQYF,0,9,1,9
TRBV14,TRBJ1-4,CASSQEGEGIDATNEKLFF,0,9,1,9
TRBV18,TRBJ2-7,CASSPFQGDRVASYEQYF,0,9,1,9
TRBV28,TRBJ2-5,CASSLSPGLGTTEETQYF,0,9,1,9
TRBV13,TRBJ2-1,CASSFPSGIGFRDNEQFF,0,9,1,9
TRBV10-3,TRBJ2-4,CAISGDGRSGAKNIQYF,0,9,1,9
TRBV19,TRBJ2-4,CASSMEARSGLGNIQYF,0,9,1,9
TRBV19,TRBJ2-7,CASSTPGLAGVNHEQYF,0,9,1,9
TRBV2,TRBJ2-4,CASSDGTTAIAKNIQYF,0,9,1,9
TRBV4-1,TRBJ1-5,CASSQDPGVRRNQPQHF,0,9,1,9
TRBV20-1,TRBJ1-1,CSARDHSSGTVNTEAFF,0,9,1,9
TRBV30,TRBJ2-6,CAWTDRLYSGANVLTF,0,9,1,9
TRBV30,TRBJ2-3,CAWSAARAVRTDTQYF,0,9,1,9
TRBV19,TRBJ2-1,CASSLQTGGIGNEQFF,0,9,1,9
TRBV18,TRBJ1-1,CASSPPLQGMNTEAFF,0,9,1,9
TRBV12-3/4,TRBJ2-3,CASSPGLNPGTDTQYF,0,9,1,9
TRBV6-1,TRBJ2-1,CASSDQVAGEYNEQFF,0,9,1,9
TRBV5-4,TRBJ2-3,CASSLRAGRGTDTQYF,0,9,1,9
TRBV7-9,TRBJ2-2,CASSLLAGQNTGELFF,0,9,1,9
TRBV11-1,TRBJ2-1,CASSPLLAGSFGEQFF,0,9,1,9
TRBV3-1,TRBJ2-2,CASSQLRGVSTGELFF,0,9,1,9
TRBV3-1,TRBJ2-7,CASSQYPRRSVYEQYF,0,9,1,9
TRBV9,TRBJ2-3,CASSVAGGLSTDTQYF,0,9,1,9
TRBV2,TRBJ2-2,CASSEPQGADTGELFF,0,9,1,9
TRBV5-1,TRBJ2-7,CASSLRLPGRPLEQYF,0,9,1,9
TRBV20-1,TRBJ2-3,CSARASGSGWRDTQCF,0,9,1,9
TRBV20-1,TRBJ2-3,CSARDTQATSTDTQYF,0,9,1,9
TRBV19,TRBJ1-1,CASGIDEGWDTEAFF,0,9,1,9
TRBV7-9,TRBJ1-2,CASLATGAKDYGYTF,0,9,1,9
TRBV6-2/3/5/6,TRBJ2-7,CASTKTSGSSYEQYF,0,9,1,9
TRBV6-2/3/5/6,TRBJ1-1,CASSYGTPMNTEAFF,0,9,1,9
TRBV12-3/4,TRBJ2-3,CASSPRALGTDTQYF,0,9,1,9
TRBV6-2/3/5/6,TRBJ2-7,CASSRGGGTYYEQYF,0,9,1,9
TRBV6-2/3/5/6,TRBJ1-4,CASSSRLQRGEKLFF,0,9,1,9
TRBV3-1,TRBJ1-1,CASSLYGGPNTEAFF,0,9,1,9
TRBV5-6,TRBJ2-5,CASSLSAGARETQYF,0,9,1,9
TRBV11-2,TRBJ2-7,CASSLQEWTGREQYF,0,9,1,9
TRBV7-9,TRBJ2-5,CASSLVGGRSETQYF,0,9,1,9
TRBV7-9,TRBJ2-7,CASSSPFAGSYEQYF,0,9,1,9
TRBV7-2,TRBJ2-7,CASSSQGSVTYEQYF,0,9,1,9
TRBV5-4,TRBJ2-1,CASSPPAARGTGLFF,0,9,1,9
TRBV3-1,TRBJ2-1,CASSPEGLATNEQFF,0,9,1,9
TRBV3-1,TRBJ1-1,CASSQASGLLTEAFF,0,9,1,9
TRBV3-1,TRBJ2-7,CASSQELAGRGEQYF,0,9,1,9
TRBV7-9,TRBJ2-1,CASSRTGVGYNEQFF,0,9,1,9
TRBV12-3/4,TRBJ1-1,CASRPGVSMNTEAFF,0,9,1,9
TRBV2,TRBJ2-3,CASNEASGTMELQYF,0,9,1,9
TRBV10-2,TRBJ2-7,CASSEGHLKTYEQYF,0,9,1,9
TRBV5-1,TRBJ1-3,CASSLVAVPGNTIYF,0,9,1,9
TRBV5-1,TRBJ2-7,CASSLASGRTDEQYF,0,9,1,9
TRBV5-1,TRBJ2-1,CASSLLAGGGNEQFF,0,9,1,9
TRBV20-1,TRBJ2-1,CSAGGAGGLDNEQFF,0,9,1,9
TRBV20-1,TRBJ2-7,CSARDPSGPNYEQYF,0,9,1,9
TRBV20-1,TRBJ2-1,CSAEILQSSYNEQFF,0,9,1,9
TRBV29-1,TRBJ2-3,CSAGTSGIRTDTQYF,0,9,1,9
TRBV12-5,TRBJ1-5,CASGPGRSDQPQHF,0,9,1,9
TRBV12-5,TRBJ1-2,CASGDVRGANGYTF,0,9,1,9
TRBV30,TRBJ1-5,CASAYRGRNQPQHF,0,9,1,9
TRBV19,TRBJ2-7,CASSPWGLYYEQYF,0,9,1,9
TRBV18,TRBJ1-4,CASSPSGTVEKLFF,0,9,1,9
TRBV28,TRBJ2-1,CASMTPSSYNEQFF,0,9,1,9
TRBV7-2,TRBJ2-3,CASTPELAGDTQYF,0,9,1,9
TRBV2,TRBJ1-4,CASTTGGNNEKLFF,0,9,1,9
TRBV6-4,TRBJ2-3,CASSLTPVGDTQYF,0,9,1,9
TRBV12-3/4,TRBJ1-6,CASSLALGRSPLHF,0,9,1,9
TRBV5-4,TRBJ2-1,CASSLAGVNNEQFF,0,9,1,9
TRBV7-9,TRBJ2-7,CASSLIGDTYEQYF,0,9,1,9
TRBV5-4,TRBJ2-3,CASSLGQSTDTQYF,0,9,1,9
TRBV11-2,TRBJ2-5,CASSPRRAQETQYF,0,9,1,9
TRBV7-6,TRBJ2-1,CASSPRAKYNEQFF,0,9,1,9
TRBV28,TRBJ2-2,CASSRGTPTGELFF,0,9,1,9
TRBV3-1,TRBJ2-1,CASSHRQGWNEEFF,0,9,1,9
TRBV3-1,TRBJ2-3,CASSQVGTTDTQYF,0,9,1,9
TRBV12-3/4,TRBJ1-1,CASSARTFNTEAFF,0,9,1,9
TRBV5-6,TRBJ2-7,CASSTGTSGYEQYF,0,9,1,9
TRBV12-3/4,TRBJ2-3,CASRALGATDTQYF,0,9,1,9
TRBV16,TRBJ2-1,CASRRTSGYNEQFF,0,9,1,9
TRBV11-1,TRBJ2-1,CASKGTLSYNEQFF,0,9,1,9
TRBV5-1,TRBJ2-3,CASTEGGFGDTQYF,0,9,1,9
TRBV5-1,TRBJ1-1,CASSLGPGRAGTFF,0,9,1,9
TRBV20-1,TRBJ2-7,CSVPKAGVTYEQYF,0,9,1,9
TRBV20-1,TRBJ1-1,CSASALTVWTEAFF,0,9,1,9
TRBV20-1,TRBJ2-7,CSARRGTGGYEQYF,0,9,1,9
TRBV20-1,TRBJ2-1,CSAYSGRENNEQFF,0,9,1,9
TRBV29-1,TRBJ2-3,CSVLPGPSTDTQYF,0,9,1,9
TRBV29-1,TRBJ2-7,CSVSQGNSLYEQYF,0,9,1,9
TRBV12-5,TRBJ2-1,CASGLAGTRKQFF,0,9,1,9
TRBV19,TRBJ1-5,CATALYSNQPQHF,0,9,1,9
TRBV19,TRBJ1-1,CASSATLGQEAFF,0,9,1,9
TRBV7-3,TRBJ1-1,CASRQDLNTEAFF,0,9,1,9
TRBV28,TRBJ2-7,CASIGTFSYEQYF,0,9,1,9
TRBV7-2,TRBJ2-7,CASTVRGPGEQYF,0,9,1,9
TRBV12-3/4,TRBJ2-5,CASSLMVQETQYF,0,9,1,9
TRBV6-2/3/5/6,TRBJ2-1,CASSLIQGNEQFF,0,9,1,9
TRBV6-1,TRBJ2-1,CASSEVGDSHQFF,0,9,1,9
TRBV5-5,TRBJ1-1,CASSLEPGLGAFF,0,9,1,9
TRBV2,TRBJ2-3,CASSRGSGDTQYF,0,9,1,9
TRBV3-1,TRBJ2-3,CASSQRDRVTQYF,0,9,1,9
TRBV5-4,TRBJ2-5,CASSAERERVQYF,0,9,1,9
TRBV6-2/3/5/6,TRBJ1-2,CASRLTENYGYTF,0,9,1,9
TRBV5-1,TRBJ2-7,CASSFWGSYEQYF,0,9,1,9
TRBV5-1,TRBJ2-1,CASSLGTYNEQFF,0,9,1,9
TRBV5-1,TRBJ2-4,CASSLDILNIQYF,0,9,1,9
TRBV5-1,TRBJ1-1,CASSSGSNTEAFF,0,9,1,9
TRBV5-1,TRBJ2-1,CASSSGQTNEQFF,0,9,1,9
TRBV5-1,TRBJ1-1,CASSYTGDTEAFF,0,9,1,9
TRBV20-1,TRBJ2-1,CSAETGAYNEQFF,0,9,1,9
TRBV6-1,TRBJ1-5,RASRKDSNQPQHF,0,9,1,9
TRBV10-3,TRBJ2-7,CADGNGGCEQYF,0,9,1,9
TRBV10-3,TRBJ2-1,CAITPGATEQFF,0,9,1,9
TRBV6-2/3/5/6,TRBJ1-1,CASSLHSGEAFF,0,9,1,9
TRBV12-3/4,TRBJ2-1,CASSYANNEQFF,0,9,1,9
TRBV5-6,TRBJ2-7,CASSLGSYEQYF,0,9,1,9
TRBV5-6,TRBJ2-5,CASSRIEETQYF,0,9,1,9
TRBV12-3/4,TRBJ2-3,CASRQGTSAQYF,0,9,1,9
TRBV5-1,TRBJ2-1,CASSLASDEQFF,0,9,1,9
TRBV10-2,TRBJ1-1,CASRFPDTEAFF,0,9,1,9
TRBV29-1,TRBJ2-5,CSVEPSQETQYF,0,9,1,9
TRBV10-3,TRBJ1-1,CAIRKTDEAFF,0,9,1,9
TRBV12-3/4,TRBJ2-1,CASSSLYEQFF,0,9,1,9
TRBV13,TRBJ2-1,CASSLYDEQFF,0,9,1,9
TRBV29-1,TRBJ2-7,CSVLTQGFFVF,0,9,1,9
TRBV7-9,TRBJ2-1,CAWDGNEQFF,0,9,1,9
TRBV2,TRBJ2-5,CATTLMDQYF,0,9,1,9
TRBV20-1,TRBJ2-5,CSASWETQYF,0,9,1,9
TRBV29-1,TRBJ2-1,CAADEQFF,0,9,1,9
TRBV20-1,TRBJ1-1,CTEEVRNQGGTMNTEAFF,0,9,1,9
TRBV11-2,TRBJ2-5,CASSFGTTSREGTQYF,0,9,1,9
TRBV19,TRBJ2-6,CASSPTGSGANVLTF,0,9,1,9
TRBV20-1,TRBJ1-1,CSARGNYRVGEAFF,0,9,1,9
TRBV20-1,TRBJ2-7,CSAREYSSFYEQYF,0,9,1,9
TRBV12-3/4,TRBJ1-2,CASSLTSGYGYTF,0,9,1,9
TRBV3-1,TRBJ2-7,CASSLGSHYEQYF,0,9,1,9
TRBV11-2,TRBJ1-2,CASTHRRTGITF,0,9,1,9
TRBV20-1,TRBJ2-1,CSAITGLAGGPWGEQFF,0,9,1,9
TRBV3-1,TRBJ2-3,CASSQGGGQGPDTQYF,0,9,1,9
TRBV5-6,TRBJ2-1,CASSLSLAGLYEQFF,0,9,1,9
TRBV5-1,TRBJ2-1,CASSFSQGSYNEQFF,0,9,1,9
TRBV5-1,TRBJ2-1,CASSSGLAVYNEQFF,0,9,1,9
TRBV18,TRBJ2-4,CASSPVREKNIQYF,0,9,1,9
TRBV18,TRBJ2-3,CASSRPAATDTQYF,0,9,1,9
TRBV28,TRBJ2-7,CASSPYRETYEQYF,0,9,1,9
TRBV5-1,TRBJ2-7,CASSLGDESRDPYF,0,9,1,9
TRBV28,TRBJ2-7,CASTTGDRYEQHF,0,9,1,9
TRBV7-9,TRBJ1-2,CASSFGGSGGYTF,0,9,1,9
TRBV7-2,TRBJ2-1,CASSLTVGDEQFF,0,9,1,9
TRBV19,TRBJ1-2,CASSTGPYGYTF,0,9,1,9
TRBV7-9,TRBJ1-1,CASSLESTEAFF,0,9,1,9
TRBV19,TRBJ2-2,CASSMTLAGGTGELFF,0,9,1,9
TRBV6-1,TRBJ2-3,CASSEDGASATDTQYF,0,9,1,9
TRBV19,TRBJ2-1,CASSAYVGSYNEQFF,0,9,1,9
TRBV18,TRBJ1-1,CASSPGRNGGTEAFF,0,9,1,9
TRBV6-2/3/5/6,TRBJ2-1,CASSYGGPAYNEQFF,0,9,1,9
TRBV2,TRBJ2-7,CASSLDRTGVHEQYF,0,9,1,9
TRBV5-6,TRBJ2-7,CASSMTGPSLNEQYF,0,9,1,9
TRBV5-1,TRBJ2-6,CASSPGSGANVLTF,0,15,1,15
TRBV3-1,TRBJ1-5,CASSHLNQPQHF,0,9,1,9
TRBV5-8,TRBJ2-5,CASSLVGTQYF,0,9,1,9
TRBV11-2,TRBJ2-3,CASSSGLTTDTQYF,0,9,1,9
TRBV5-5,TRBJ2-1,CASSLEASGRPYISYNEQFF,0,8,1,8
TRBV6-2/3/5/6,TRBJ2-3,CASSLFSGTSGLTDTQYF,0,8,1,8
TRBV13,TRBJ1-2,CASSLASGTGGPGGGYTF,0,8,1,8
TRBV7-9,TRBJ2-2,CASRIKAGGSVNTGELFF,0,8,1,8
TRBV20-1,TRBJ2-1,CSARDRGRRRAGYNEQFF,0,8,1,8
TRBV20-1,TRBJ2-5,CSAREQTGGLAGKETQYF,0,8,1,8
TRBV5-6,TRBJ1-5,CASSLYGTGSSNQPQHF,0,8,1,8
TRBV7-8,TRBJ1-4,CASSLQGATLTMGELFF,0,8,1,8
TRBV13,TRBJ2-6,CASSLQGAFSGANVLTF,0,8,1,8
TRBV9,TRBJ2-3,CASSVGIRDSSPDTQYF,0,12,1,12
TRBV5-1,TRBJ2-1,CASSLNGPGAGPPEQFF,0,8,1,8
TRBV20-1,TRBJ2-1,CSARDASGTSGKNEQFF,0,8,1,8
TRBV24-1,TRBJ2-2,CATSDPVDRDTGELFF,0,8,1,8
TRBV24-1,TRBJ2-7,CATSDPPSQSSYEQYF,0,8,1,8
TRBV18,TRBJ2-3,CASSPTGTPFTDTQYF,0,8,1,8
TRBV6-2/3/5/6,TRBJ2-5,CASTLGTSGYQETQYF,0,8,1,8
TRBV12-3/4,TRBJ1-1,CASTITLGQANTEAFF,0,8,1,8
TRBV6-2/3/5/6,TRBJ2-2,CASSFQLAGNTGELFF,0,8,1,8
TRBV12-3/4,TRBJ2-2,CASSLAQGVWTGELFF,0,8,1,8
TRBV6-2/3/5/6,TRBJ2-4,CASSYNRRSAKNIQYF,0,8,1,8
TRBV6-4,TRBJ2-5,CASSDLRTGTQETQYF,0,8,1,8
TRBV7-9,TRBJ2-3,CASSLAGTRWIDTQYF,0,8,1,8
TRBV5-6,TRBJ1-6,CASSSGVRRAGSPLHF,0,8,1,8
TRBV3-1,TRBJ2-3,CASSPTLDVGPDTQYF,0,8,1,8
TRBV5-6,TRBJ1-5,CASSRRTDLANQPQHF,0,8,1,8
TRBV7-2,TRBJ2-4,CASSQGAGGAKNIQYF,0,8,1,8
TRBV11-2,TRBJ2-4,CASSASGGGAKNIQYF,0,8,1,8
TRBV5-1,TRBJ2-1,CASSSGELAGVHEQFF,0,8,1,8
TRBV20-1,TRBJ2-3,CSASRGAPAPGDTQYF,0,8,1,8
TRBV20-1,TRBJ2-5,CSARVQGMGFQETQYF,0,8,1,8
TRBV29-1,TRBJ2-1,CSVLRAHSGRGDEQFF,0,8,1,8
TRBV29-1,TRBJ2-3,CSVQGQLAGVTDTQYF,0,8,1,8
TRBV12-5,TRBJ2-6,CASGLLTSGANVLTF,0,8,1,8
TRBV10-3,TRBJ2-1,CAISEGGRADNEQFF,0,8,1,8
TRBV2,TRBJ1-5,CATKRGSSGNQPQHF,0,8,1,8
TRBV19,TRBJ2-1,CASSMRALNYNEQFF,0,8,1,8
TRBV19,TRBJ2-5,CASSIGSQLKETQYF,0,8,1,8
TRBV19,TRBJ1-6,CASSLTGKENSPLHF,0,8,1,8
TRBV18,TRBJ2-1,CASSPRTSVHNEQFF,0,8,1,8
TRBV18,TRBJ2-7,CASSNPGQGTYEQYF,0,8,1,8
TRBV28,TRBJ2-2,CASQTSGSTTGELFF,0,8,1,8
TRBV2,TRBJ2-1,CASGAPLRARNEQFF,0,8,1,8
TRBV28,TRBJ2-7,CASIPGQGRSYEQYF,0,8,1,8
TRBV5-6,TRBJ1-4,CASTLWPSSNEKLFF,0,8,1,8
TRBV12-3/4,TRBJ1-1,CASSFSSTGNTEAFF,0,8,1,8
TRBV28,TRBJ2-1,CASSLPTGAHNEQFF,0,8,1,8
TRBV12-3/4,TRBJ1-4,CASSLGRGVNEKLFF,0,8,1,8
TRBV27,TRBJ2-2,CASSSGTANTGELFF,0,8,1,8
TRBV28,TRBJ2-7,CASSSRLAGGYEQYF,0,8,1,8
TRBV6-2/3/5/6,TRBJ1-5,CASSYATSGNQPQHF,0,8,1,8
TRBV27,TRBJ2-3,CASSYGWGGTDTQYF,0,8,1,8
TRBV6-2/3/5/6,TRBJ2-1,CASSYRTGKNNEQFF,0,8,1,8
TRBV7-3,TRBJ2-1,CASSLTSTSENEQFF,0,8,1,8
TRBV5-6,TRBJ2-1,CASSSTVSSYNEQFF,0,8,1,8
TRBV13,TRBJ2-5,CASSLSGTRKETQYF,0,8,1,8
TRBV14,TRBJ2-1,CASSLSGDSYNEQFF,0,8,1,8
TRBV14,TRBJ2-7,CASSLLAGGKNEQYF,0,8,1,8
TRBV3-1,TRBJ1-1,CASSQRQGAGTEAFF,0,8,1,8
TRBV4-2,TRBJ2-1,CASSQEAGGHNEQFF,0,8,1,8
TRBV6-2/3/5/6,TRBJ2-7,CASSVPSVATYEQYF,0,8,1,8
TRBV6-2/3/5/6,TRBJ2-5,CASRSPTGGQETQYF,0,8,1,8
TRBV6-4,TRBJ2-3,CASRTKGQAADTQYF,0,8,1,8
TRBV2,TRBJ2-2,CASNKALLNTGELFF,0,8,1,8
TRBV6-2/3/5/6,TRBJ1-5,CASKDRGVVNQPQHF,0,8,1,8
TRBV19,TRBJ2-1,CANSIVPSGIFEQFF,0,8,1,8
TRBV5-1,TRBJ2-3,CASSLAGSASDTQYF,0,8,1,8
TRBV5-1,TRBJ2-5,CASSLAGTAQETQYF,0,8,1,8
TRBV5-1,TRBJ1-1,CASSLPRQGGTEAFF,0,8,1,8
TRBV5-1,TRBJ2-3,CASSTTSVPGDTQYF,0,8,1,8
TRBV20-1,TRBJ1-5,CSARVGQASNQPQHF,0,8,1,8
TRBV20-1,TRBJ2-3,CSAPKRSGSTDTQYF,0,8,1,8
TRBV29-1,TRBJ2-7,CSVSPPRGGLGEQYF,0,8,1,8
TRBV29-1,TRBJ2-5,CSVVYDRGSQETQYF,0,8,1,8
TRBV29-1,TRBJ2-3,CSAKREGRLTDTQYF,0,8,1,8
TRBV29-1,TRBJ2-3,CSGLPAGGPGDTQYF,0,8,1,8
TRBV7-9,TRBJ2-1,CAFQGASAHNEQFF,0,8,1,8
TRBV30,TRBJ2-3,CAWSVLSGADTQYF,0,8,1,8
TRBV24-1,TRBJ2-1,CATSGGDSRNEQFF,0,8,1,8
TRBV19,TRBJ1-4,CASTSRATNEKLFF,0,8,1,8
TRBV28,TRBJ2-1,CASIGAGVLNEQFF,0,8,1,8
TRBV28,TRBJ2-2,CASMGQPNTGELFF,0,8,1,8
TRBV2,TRBJ2-7,CASTEDRVFYEQYF,0,8,1,8
TRBV28,TRBJ2-7,CASSFSPALTEQYF,0,8,1,8
TRBV28,TRBJ2-7,CASSLVQGHREQYF,0,8,1,8
TRBV5-4,TRBJ2-2,CASSSGFNTGELFF,0,8,1,8
TRBV27,TRBJ2-3,CASSSPKRTDTQYF,0,8,1,8
TRBV5-5,TRBJ2-1,CASSPGQVNNEQFF,0,8,1,8
TRBV6-1,TRBJ1-5,CASSKAGSNQPQHF,0,8,1,8
TRBV5-6,TRBJ2-4,CASSFRAAKNIQYF,0,8,1,8
TRBV5-4,TRBJ2-3,CASSLRGRTDTQYF,0,8,1,8
TRBV7-9,TRBJ2-1,CASSLRLVGNELFF,0,8,1,8
TRBV7-9,TRBJ1-5,CASSLMGVNQPQHF,0,8,1,8
TRBV9,TRBJ2-5,CASSSRDRGGTQYF,0,8,1,8
TRBV7-9,TRBJ1-1,CASSLHTMNTEAFF,0,8,1,8
TRBV11-2,TRBJ2-5,CASSLGQRQETQYF,0,8,1,8
TRBV7-2,TRBJ2-1,CASSRSSSYNEQFS,0,8,1,8
TRBV3-1,TRBJ2-7,CASSQGGQSYEQYF,0,8,1,8
TRBV3-1,TRBJ1-6,CASSQGTGESPLHF,0,8,1,8
TRBV2,TRBJ2-3,CASSGEGGSDTQYF,0,8,1,8
TRBV2,TRBJ2-3,CASRETGAADTQYF,0,8,1,8
TRBV6-2/3/5/6,TRBJ2-5,CASRPGTDIRAQYF,0,8,1,8
TRBV7-9,TRBJ2-5,CASRKADRVETQYF,0,8,1,8
TRBV6-2/3/5/6,TRBJ2-7,CASKPRDRPYEQYF,0,8,1,8
TRBV5-1,TRBJ2-2,CASHPAANTGELFF,0,8,1,8
TRBV5-1,TRBJ2-7,CASSLATGGNGQYF,0,8,1,8
TRBV4-1,TRBJ2-1,CASSPGTNYNEQFF,0,8,1,8
TRBV20-1,TRBJ2-1,CSATDRRKYNEQFF,0,8,1,8
TRBV20-1,TRBJ2-2,CSASRGANTGELFF,0,8,1,8
TRBV20-1,TRBJ2-3,CSARAGGPTDTQYF,0,8,1,8
TRBV20-1,TRBJ1-4,CSARDEGLGEKLFF,0,8,1,8
TRBV20-1,TRBJ2-1,CSAPNSYGRNEQFF,0,8,1,8
TRBV29-1,TRBJ2-1,CSVESGGAYNEQFF,0,8,1,8
TRBV29-1,TRBJ2-7,CSVIGQGSSYEQYF,0,8,1,8
TRBV29-1,TRBJ1-1,CSVRVLTTGTEAFF,0,8,1,8
TRBV29-1,TRBJ1-4,CSVGGGATNEKLFF,0,8,1,8
TRBV29-1,TRBJ2-1,CSASVARGYNEQFF,0,8,1,8
TRBV24-1,TRBJ2-3,CATTTGSTDTQYF,0,8,1,8
TRBV19,TRBJ2-3,CASSTTGSDTQYF,0,8,1,8
TRBV18,TRBJ2-3,CASSPPSEDTQYF,0,8,1,8
TRBV3-1,TRBJ2-1,CASLSGGRNEQFF,0,8,1,8
TRBV7-9,TRBJ1-1,CASTRVGDTEAFF,0,8,1,8
TRBV27,TRBJ1-1,CASSFGSNTEAFF,0,8,1,8
TRBV11-1,TRBJ2-7,CASSLLSSYEQYF,0,8,1,8
TRBV12-3/4,TRBJ1-2,CASSLGARYGYTF,0,8,1,8
TRBV12-3/4,TRBJ2-7,CASSPRTGQRQYF,0,8,1,8
TRBV7-9,TRBJ2-5,CASSFWGEETQYF,0,8,1,8
TRBV5-6,TRBJ2-3,CASSLGWADTQYF,0,8,1,8
TRBV5-4,TRBJ2-3,CASSLGGGDTQYF,0,8,1,8
TRBV7-9,TRBJ2-1,CASSLDLYNEQFF,0,8,1,8
TRBV12-3/4,TRBJ2-7,CASSLLETYEQYF,0,8,1,8
TRBV7-7,TRBJ2-3,CASSLAEADTQYF,0,8,1,8
TRBV6-2/3/5/6,TRBJ2-7,CASSPGTLPEQYF,0,8,1,8
TRBV7-3,TRBJ2-3,CASSPAATDTQYF,0,8,1,8
TRBV7-6,TRBJ1-2,CASSQGGSYGYTF,0,8,1,8
TRBV5-1,TRBJ2-3,CASSLPPADTQYF,0,8,1,8
TRBV5-1,TRBJ2-7,CASSFDPGNEQYF,0,8,1,8
TRBV20-1,TRBJ1-5,CSALGAVGQPQHF,0,8,1,8
TRBV29-1,TRBJ2-7,CSVGQEKIYEQYF,0,8,1,8
TRBV29-1,TRBJ2-5,CSVEQAGGETQYF,0,8,1,8
TRBV29-1,TRBJ2-3,CSVLDRDGDTQYF,0,8,1,8
TRBV19,TRBJ2-5,CASSITQETQYF,0,8,1,8
TRBV18,TRBJ2-7,CASSPQGGEQYF,0,8,1,8
TRBV18,TRBJ2-5,CASSPSRETQYF,0,8,1,8
TRBV28,TRBJ1-5,CASEEVDQPQHF,0,8,1,8
TRBV6-1,TRBJ1-5,CASSESNQPQHF,0,8,1,8
TRBV7-2,TRBJ2-3,CASSFLPDTQYF,0,8,1,8
TRBV5-6,TRBJ2-1,CASSLGAYEQFF,0,8,1,8
TRBV7-6,TRBJ2-1,CASSLVPDEQFF,0,8,1,8
TRBV11-1,TRBJ2-1,CASSSGGQEQFF,0,8,1,8
TRBV7-2,TRBJ2-3,CASSLSRDTQYF,0,8,1,8
TRBV7-9,TRBJ2-4,CASSPTGGPQYF,0,8,1,8
TRBV3-1,TRBJ2-7,CASSQTGDEQYF,0,8,1,8
TRBV7-9,TRBJ2-7,CASSGGLREQYF,0,8,1,8
TRBV12-3/4,TRBJ2-5,CASRGRVETQYF,0,8,1,8
TRBV6-2/3/5/6,TRBJ2-7,CASRGNGYEQYF,0,8,1,8
TRBV5-1,TRBJ2-7,CASSSSDSEQYF,0,8,1,8
TRBV20-1,TRBJ2-3,CSARVFGDTQYF,0,8,1,8
TRBV20-1,TRBJ1-1,CSARGQLTEAFF,0,8,1,8
TRBV6-2/3/5/6,TRBJ1-2,RASRLSKGGYTF,0,8,1,8
TRBV12-5,TRBJ1-5,CASGLVQPQHF,0,8,1,8
TRBV7-9,TRBJ2-7,CASSQGYEQYF,0,12,1,12
TRBV5-6,TRBJ1-2,CASKREEGYTF,0,8,1,8
TRBV4-1,TRBJ1-4,CASSLEQKLFF,0,8,1,8
TRBV29-1,TRBJ2-1,CSVGTEYEQFF,0,8,1,8
TRBV4-1,TRBJ2-3,CASSQTGGGTSGPTDTQYF,0,8,1,8
TRBV19,TRBJ2-1,CASCSGDAAESSYKEQFF,0,8,1,8
TRBV12-3/4,TRBJ2-1,CAISRDTLWDEPFF,0,8,1,8
TRBV18,TRBJ2-1,CASSPDRGRNEQFF,0,8,1,8
TRBV29-1,TRBJ2-3,CSVGTQGDTQYF,0,8,1,8
TRBV29-1,TRBJ2-2,CSVSSYTGELFF,0,8,1,8
TRBV19,TRBJ2-1,CASSIRGRYCNEQFF,0,8,1,8
TRBV6-2/3/5/6,TRBJ2-1,CASSPGLALNREQFF,0,8,1,8
TRBV29-1,TRBJ1-2,CSAEDSRDRGGGYTL,0,8,1,8
TRBV7-2,TRBJ2-3,CASSLAGDTDTQYF,0,8,1,8
TRBV4-1,TRBJ2-2,CASRLTRGTGELFF,0,8,1,8
TRBV19,TRBJ2-3,CASSVQGTDTQYF,0,8,1,8
TRBV7-2,TRBJ2-1,CASSLIANEQFF,0,8,1,8
TRBV7-9,TRBJ1-1,CASSAGTGQAFF,0,8,1,8
TRBV5-1,TRBJ1-3,CASSFENTIYF,0,8,1,8
TRBV19,TRBJ2-1,CASSGSGTAFSNGQFF,0,8,1,8
TRBV18,TRBJ2-3,CASSPLRTLSRVTDTQYF,0,8,1,8
TRBV5-1,TRBJ2-5,CASSLAYLGGGQETQYF,0,8,1,8
TRBV7-3,TRBJ2-3,CASSLNPSGSTDTQYF,0,8,1,8
TRBV7-3,TRBJ2-1,CASSYTGTPWGNEQFF,0,8,1,8
TRBV5-5,TRBJ2-3,CASSVTSGSSADTQYF,0,8,1,8
TRBV20-1,TRBJ1-2,CSARPRDSPPPFGYTF,0,8,1,8
TRBV12-3/4,TRBJ1-5,CASSLHGASNQPQHF,0,8,1,8
TRBV7-9,TRBJ2-1,CASSLPGQGLNEQFF,0,8,1,8
TRBV7-9,TRBJ2-5,CASKVGRGRQETQYF,0,8,1,8
TRBV18,TRBJ1-5,CASSPSTGDQPQHF,0,8,1,8
TRBV18,TRBJ2-3,CASSPGENRDTQYF,0,8,1,8
TRBV11-2,TRBJ2-1,CASRDSSFYNEQFF,0,8,1,8
TRBV7-9,TRBJ1-1,CASGQTDTEAFF,0,8,1,8
TRBV7-8,TRBJ2-3,CASSLEGVRLGGAFTDTQYF,0,7,1,7
TRBV10-1,TRBJ2-2,CASSESLSAGSSNTGELFF,0,7,1,7
TRBV19,TRBJ2-1,CASIGPTQAGQSYNEQFF,0,7,1,7
TRBV5-8,TRBJ2-1,CASSLATLAGGVYNEQFF,0,7,1,7
TRBV4-1,TRBJ2-2,CASSHAGLAGAVAGELFF,0,7,1,7
TRBV5-1,TRBJ1-2,CASSFHPGSDRLAYGYTF,0,7,1,7
TRBV29-1,TRBJ2-1,CSVEERFGDILSYNEQFF,0,7,1,7
TRBV10-3,TRBJ2-1,CAISESIAGGKYNEQFF,0,7,1,7
TRBV6-1,TRBJ2-1,CASSASRGGRANYEQFF,0,7,1,7
TRBV28,TRBJ2-3,CASSGSQGTGQTDTQYF,0,7,1,7
TRBV7-8,TRBJ2-3,CASSLIGGLAGTDTQYF,0,7,1,7
TRBV11-3,TRBJ2-6,CASSSGTGMTGANVLTF,0,7,1,7
TRBV7-2,TRBJ2-3,CASSPREPGLPPDTQYF,0,7,1,7
TRBV7-3,TRBJ2-7,CASSPGLGLAGVHEQYF,0,7,1,7
TRBV4-2,TRBJ2-7,CASSPAGLGGSSYEQYF,0,7,1,7
TRBV3-1,TRBJ2-3,CASSHGLAGLGTDTQYF,0,7,1,7
TRBV5-4,TRBJ2-1,CASSGPNGGIRQDEQFF,0,7,1,7
TRBV4-2,TRBJ2-1,CASSTRTSGNPYNEQFF,0,7,1,7
TRBV10-1,TRBJ2-1,CASSESLGTGMGWEQFF,0,7,1,7
TRBV5-1,TRBJ2-2,CASSFAPTGANTGELFF,0,7,1,7
TRBV5-1,TRBJ2-1,CASSLAGLAGTYNEQSF,0,7,1,7
TRBV29-1,TRBJ2-7,CSVEAPKGSGGTYEQYF,0,7,1,7
TRBV29-1,TRBJ2-1,CSAEEGTGGRSYNEQFF,0,7,1,7
TRBV12-5,TRBJ1-1,CASGSTTGAGDTEAFF,0,7,1,7
TRBV27,TRBJ2-7,CAGRPGQGSLWVEQYF,0,7,1,7
TRBV15,TRBJ2-1,CATMESAGSSYNEQFF,0,7,1,7
TRBV19,TRBJ1-5,CASRTEGSGSNQPQHF,0,7,1,7
TRBV18,TRBJ2-1,CASSPPLGLNTDEQFF,0,7,1,7
TRBV28,TRBJ2-1,CASITPGLAGHNEQFF,0,7,1,7
TRBV12-3/4,TRBJ2-2,CASSLRPGTNTGELFF,0,7,1,7
TRBV12-3/4,TRBJ1-1,CASSLVRGREDTEAFF,0,7,1,7
TRBV6-2/3/5/6,TRBJ1-1,CASSRDRGPLNTEAFF,0,7,1,7
TRBV6-2/3/5/6,TRBJ2-5,CASSRETGTSSSAQYF,0,7,1,7
TRBV28,TRBJ2-5,CASSHPTGKEVETQYF,0,7,1,7
TRBV6-1,TRBJ2-7,CASSESEGRGSYEQYF,0,7,1,7
TRBV2,TRBJ2-1,CASSEGSSSSYNEQFF,0,7,1,7
TRBV11-3,TRBJ2-3,CASSFLTPGGTDTQYF,0,7,1,7
TRBV5-4,TRBJ2-1,CASSFPGTRSLDEQFF,0,7,1,7
TRBV11-2,TRBJ1-1,CASSSSQGQGYTEAFF,0,7,1,7
TRBV7-9,TRBJ1-2,CASSWLLYNPNYGYTF,0,7,1,7
TRBV7-9,TRBJ2-3,CASSLVGAGGRDTQYF,0,7,1,7
TRBV6-2/3/5/6,TRBJ2-7,CASSPGLAQLSYEQYF,0,7,1,7
TRBV5-5,TRBJ2-5,CASSRAWQSIRETQYF,0,7,1,7
TRBV4-2,TRBJ2-7,CASSQEASGRGYEQYF,0,7,1,7
TRBV9,TRBJ2-1,CASSGAAGGDNNEQFF,0,7,1,7
TRBV5-1,TRBJ2-3,CASSFLAGGNTDTQYF,0,7,1,7
TRBV5-1,TRBJ2-3,CASSFRLASNTDTQYF,0,7,1,7
TRBV5-1,TRBJ2-3,CASSLQGGSSTDTQYF,0,7,1,7
TRBV5-1,TRBJ2-3,CASSYNRGQRIDTQYF,0,7,1,7
TRBV4-1,TRBJ2-5,CASSQDRDTDRETQYF,0,7,1,7
TRBV4-1,TRBJ1-4,CASRTGTGGNNEKLFF,0,7,1,7
TRBV5-1,TRBJ2-3,CASRGLAGDRTDTQYF,0,7,1,7
TRBV20-1,TRBJ2-4,CSASLAGQLAKNIQYF,0,7,1,7
TRBV20-1,TRBJ2-5,CSARGDRGLGQETQYF,0,7,1,7
TRBV20-1,TRBJ1-5,CSARDRSPFRGQPQHF,0,7,1,7
TRBV29-1,TRBJ2-2,CSVGRGSPGGTGELFF,0,7,1,7
TRBV29-1,TRBJ1-5,CSVILQGRGISQPQHF,0,7,1,7
TRBV10-3,TRBJ2-1,CAISPGTGRINEQFF,0,7,1,7
TRBV24-1,TRBJ2-1,CATSDSRGLGNEQFF,0,7,1,7
TRBV28,TRBJ2-2,CASRPGQGRTGELFF,0,7,1,7
TRBV19,TRBJ2-1,CASSSSGQGANEQFF,0,7,1,7
TRBV19,TRBJ1-1,CASSLPTGQNTEAFF,0,7,1,7
TRBV19,TRBJ2-2,CASSMAGPNTGELFF,0,7,1,7
TRBV19,TRBJ2-1,CASSIGGQYIYEQFF,0,7,1,7
TRBV19,TRBJ1-5,CASSRQSRSNQPQHF,0,7,1,7
TRBV18,TRBJ2-2,CASSPGTANTGELFF,0,7,1,7
TRBV7-9,TRBJ1-2,CASTMGGLAGYGYTF,0,7,1,7
TRBV6-2/3/5/6,TRBJ1-3,CASSSGQGAGNTIYF,0,7,1,7
TRBV25-1,TRBJ2-5,CASSDPGRFQETQYF,0,7,1,7
TRBV6-1,TRBJ1-5,CASSELSQAGQPQHF,0,7,1,7
TRBV6-4,TRBJ1-5,CASSEWASYNQPQHF,0,7,1,7
TRBV2,TRBJ2-7,CASSEGVGNSYEQYF,0,7,1,7
TRBV7-9,TRBJ2-5,CASSFSPTGEETQYF,0,7,1,7
TRBV11-2,TRBJ2-3,CASSLFLAGTDTQYF,0,7,1,7
TRBV11-2,TRBJ2-4,CASSLSLVAGGIQYF,0,7,1,7
TRBV7-2,TRBJ2-2,CASSLVVLNTGELFF,0,7,1,7
TRBV7-2,TRBJ1-1,CASSLVGGLNTEAFF,0,7,1,7
TRBV7-2,TRBJ2-1,CASSLASGIYNEQFF,0,7,1,7
TRBV7-2,TRBJ2-1,CASSLGAGTYNEQFF,0,7,1,7
TRBV5-4,TRBJ2-1,CASSLGASGYNEQFF,0,7,1,7
TRBV7-2,TRBJ2-3,CASSLNGHNTDTQYF,0,7,1,7
TRBV11-3,TRBJ2-1,CASSSRLAVYNEQFF,0,7,1,7
TRBV7-9,TRBJ2-1,CASSSGTNPYNEQFF,0,7,1,7
TRBV11-2,TRBJ1-2,CASSSIHRDNYGYTF,0,7,1,7
TRBV3-1,TRBJ2-1,CASSLAGGTYNEQFF,0,7,1,7
TRBV11-2,TRBJ2-3,CASSPLRRGLDTQYF,0,7,1,7
TRBV27,TRBJ2-1,CASSRAIGTYNEQFF,0,7,1,7
TRBV12-3/4,TRBJ2-2,CASSRTGRNTGELFF,0,7,1,7
TRBV4-2,TRBJ2-7,CASSQGPRPLHEQYF,0,7,1,7
TRBV3-1,TRBJ1-3,CASSQISNSGNTIYF,0,7,1,7
TRBV3-1,TRBJ2-1,CASSQISSGQREQFF,0,7,1,7
TRBV9,TRBJ2-5,CASSVGGLAEETQYF,0,7,1,7
TRBV7-2,TRBJ2-1,CASSIRTSGENEQFF,0,7,1,7
TRBV9,TRBJ2-1,CASSTGTGGYNEQFF,0,7,1,7
TRBV7-6,TRBJ2-7,CASSTGLAGAREQYF,0,7,1,7
TRBV2,TRBJ2-5,CASRPRGQYQETQYF,0,7,1,7
TRBV5-6,TRBJ2-1,CASRVRGSSYNEQFF,0,7,1,7
TRBV2,TRBJ2-1,CASRPGTSGTNEQFF,0,7,1,7
TRBV18,TRBJ2-7,CASNTGGTSGYEQYF,0,7,1,7
TRBV7-6,TRBJ1-4,CTSSLSTGTNEKLFF,0,7,1,7
TRBV5-1,TRBJ2-5,CASSLALGARETQYF,0,7,1,7
TRBV5-1,TRBJ2-7,CASSLAMTGGDEQYF,0,7,1,7
TRBV5-1,TRBJ2-5,CASSLGGAIQETQYF,0,7,1,7
TRBV5-1,TRBJ2-3,CASSLISETWDTQYF,0,7,1,7
TRBV5-1,TRBJ1-1,CASSSGQGSNTEAFF,0,7,1,7
TRBV5-1,TRBJ2-1,CASRATSGRWNEQFF,0,7,1,7
TRBV5-1,TRBJ2-7,CASRTTGTEIYEQYF,0,7,1,7
TRBV20-1,TRBJ2-3,CSAQSGLAVTDTQYF,0,7,1,7
TRBV20-1,TRBJ2-3,CSAALAGGSTDTQYF,0,7,1,7
TRBV20-1,TRBJ2-1,CSAAHPSGPYNEQFF,0,7,1,7
TRBV20-1,TRBJ2-7,CSATDGTSGTYEQYF,0,7,1,7
TRBV20-1,TRBJ1-1,CSAREAGTENTEAFF,0,7,1,7
TRBV20-1,TRBJ2-7,CSAKGLTGAVYEQYF,0,7,1,7
TRBV30,TRBJ1-2,CAWSAGQGLYGYTF,0,7,1,7
TRBV24-1,TRBJ2-7,CATSDLAGRTGQYF,0,7,1,7
TRBV2,TRBJ1-3,CASFRDSSGNTIYF,0,7,1,7
TRBV19,TRBJ2-7,CASSRTGGWYEQYF,0,7,1,7
TRBV19,TRBJ2-7,CASSPLAGSHEQYF,0,7,1,7
TRBV19,TRBJ2-7,CASRPAGSPHEQYF,0,7,1,7
TRBV27,TRBJ2-7,CASSPSPSPYEQYF,0,7,1,7
TRBV18,TRBJ2-1,CASSPPSSGGEQFF,0,7,1,7
TRBV25-1,TRBJ1-1,CASLRQGRNTEAFF,0,7,1,7
TRBV12-3/4,TRBJ2-1,CASRKSGKITEQFF,0,7,1,7
TRBV12-3/4,TRBJ2-7,CASSLGTSGNRQYF,0,7,1,7
TRBV6-2/3/5/6,TRBJ2-2,CASSYHSDTGELFF,0,7,1,7
TRBV27,TRBJ2-2,CASSPSRATGELFF,0,7,1,7
TRBV12-3/4,TRBJ2-5,CASSPGGGSETQYF,0,7,1,7
TRBV6-1,TRBJ1-4,CASSDQSTNEKLFF,0,7,1,7
TRBV5-4,TRBJ2-3,CASSFSGITDTQYF,0,7,1,7
TRBV5-4,TRBJ1-2,CASSLATGGVGYTF,0,7,1,7
TRBV5-6,TRBJ2-1,CASSLGDGRGEQFF,0,7,1,7
TRBV5-6,TRBJ2-4,CASSLGSQGNIQYF,0,7,1,7
TRBV7-6,TRBJ2-1,CASSLAGTNNEQFF,0,7,1,7
TRBV7-9,TRBJ1-5,CASSLGSGNQPQHF,0,7,1,7
TRBV6-2/3/5/6,TRBJ2-2,CASSSYGVTGELFF,0,7,1,7
TRBV7-7,TRBJ2-7,CASSSSDYSYEQYF,0,7,1,7
TRBV3-1,TRBJ1-5,CASSLGQLNQPQHF,0,7,1,7
TRBV11-2,TRBJ1-1,CASSPSGGRSEAFF,0,7,1,7
TRBV3-1,TRBJ1-2,CASSPLERSYGYTF,0,7,1,7
TRBV11-2,TRBJ1-4,CASSPGQTNEKLFF,0,7,1,7
TRBV5-4,TRBJ2-5,CASSPTGGGETQYF,0,7,1,7
TRBV4-2,TRBJ2-5,CASSQAGGAETQYF,0,7,1,7
TRBV5-5,TRBJ2-7,CASSQGQGYYEQYF,0,7,1,7
TRBV3-1,TRBJ1-2,CASSQEGRIGGYTF,0,7,1,7
TRBV6-2/3/5/6,TRBJ2-5,CASRPDRFQETQYF,0,7,1,7
TRBV5-1,TRBJ2-3,CASSLGTSTDTQYF,0,7,1,7
TRBV5-1,TRBJ2-1,CASSLSSAGNEQFF,0,7,1,7
TRBV5-1,TRBJ2-3,CASSLAASTDTQYF,0,7,1,7
TRBV4-1,TRBJ2-5,CASSQAQRQETQYF,0,7,1,7
TRBV10-1,TRBJ2-2,CASSATGVPGELFF,0,7,1,7
TRBV29-1,TRBJ2-3,CSALTSGSTDTQYF,0,13,1,13
TRBV20-1,TRBJ2-2,CSAWTEPNTGELFF,0,7,1,7
TRBV20-1,TRBJ2-7,CSAMTDYHDDEQYF,0,7,1,7
TRBV20-1,TRBJ2-7,CSARAVVQGYEQYF,0,7,1,7
TRBV20-1,TRBJ2-7,CSALGTSGSYEQYF,0,7,1,7
TRBV29-1,TRBJ2-3,CSVRTSGITDTQYF,0,7,1,7
TRBV29-1,TRBJ2-7,CSVVVTGNSYEQYF,0,7,1,7
TRBV29-1,TRBJ1-5,CSVAGGTSNQPQHF,0,7,1,7
TRBV29-1,TRBJ2-7,CSVTGGQGAGEQYF,0,7,1,7
TRBV29-1,TRBJ2-5,CSVRGQGGKETQYF,0,7,1,7
TRBV29-1,TRBJ2-6,CSAGADAGANVLTF,0,7,1,7
TRBV29-1,TRBJ2-3,CSGVGPAGGDTQYF,0,7,1,7
TRBV2,TRBJ2-3,CAGGTGVTDTQYF,0,7,1,7
TRBV10-3,TRBJ2-2,CAISNRDTGELFF,0,7,1,7
TRBV24-1,TRBJ2-1,CATSDFGAYEQFF,0,7,1,7
TRBV19,TRBJ2-5,CASSIIPQETQYF,0,7,1,7
TRBV19,TRBJ1-1,CASSISPNSEAFF,0,7,1,7
TRBV19,TRBJ1-1,CASSISGARQAFF,0,7,1,7
TRBV18,TRBJ2-7,CASSPPAGYEQYF,0,7,1,7
TRBV12-3/4,TRBJ1-2,CASGAGQGYGYTF,0,7,1,7
TRBV2,TRBJ2-2,CASTWTSGRELFF,0,7,1,7
TRBV11-3,TRBJ2-1,CASTDGNGNEQFF,0,7,1,7
TRBV12-3/4,TRBJ1-2,CASSLRQGNGYTF,0,7,1,7
TRBV12-3/4,TRBJ1-6,CASSWGILGSLHF,0,7,1,7
TRBV28,TRBJ2-6,CASSLPPANVLTF,0,7,1,7
TRBV2,TRBJ2-5,CASSEGPQETQYF,0,7,1,7
TRBV7-2,TRBJ2-2,CASSSGNTGELFF,0,7,1,7
TRBV7-3,TRBJ2-3,CASSFDSADTQYF,0,7,1,7
TRBV11-2,TRBJ2-3,CASSLARTDTQYF,0,7,1,7
TRBV7-6,TRBJ2-4,CASSLDGGSPQYF,0,7,1,7
TRBV5-4,TRBJ1-2,CASSSGQGYGYTF,0,7,1,7
TRBV3-1,TRBJ2-7,CASSRLGQYEQYF,0,7,1,7
TRBV3-1,TRBJ2-1,CASSQSLPNEQFF,0,7,1,7
TRBV7-9,TRBJ2-7,CASRQGTGYEQYF,0,7,1,7
TRBV5-1,TRBJ2-7,CASSLTDSYEQYF,0,7,1,7
TRBV5-1,TRBJ1-4,CASSRDTNEKLFF,0,7,1,7
TRBV20-1,TRBJ2-7,CSAPGTGGYEQYF,0,7,1,7
TRBV20-1,TRBJ2-3,CSAGTSGRGTQYF,0,7,1,7
TRBV20-1,TRBJ1-6,CSATGTGSSPLHF,0,7,1,7
TRBV29-1,TRBJ2-3,CSVDRAGVDTQYF,0,7,1,7
TRBV29-1,TRBJ2-3,CSVEQEITDTQYF,0,7,1,7
TRBV29-1,TRBJ1-1,CSVAQTGNTEAFF,0,7,1,7
TRBV29-1,TRBJ2-1,CSALPYVYNEQFF,0,7,1,7
TRBV30,TRBJ2-7,CAFSGPYYEQYF,0,7,1,7
TRBV18,TRBJ1-2,CASSVTNYGYTF,0,7,1,7
TRBV7-9,TRBJ1-1,CASRNGNTEAFF,0,7,1,7
TRBV2,TRBJ2-1,CASSEVGDEQFF,0,7,1,7
TRBV6-1,TRBJ2-7,CASSEIQNEQYF,0,7,1,7
TRBV7-9,TRBJ2-7,CASSLAGHEQYF,0,7,1,7
TRBV12-3/4,TRBJ2-4,CASSQVENIQYF,0,7,1,7
TRBV13,TRBJ2-1,CASSGDANEQFF,0,7,1,7
TRBV5-1,TRBJ2-7,CASSLNTYEQYF,0,7,1,7
TRBV5-1,TRBJ2-1,CASSSTLNEQFF,0,7,1,7
TRBV20-1,TRBJ1-1,CSARGQGTEAFF,0,7,1,7
TRBV29-1,TRBJ2-5,CSVVLASETQYF,0,7,1,7
TRBV29-1,TRBJ2-7,CSVGTGLGEQYF,0,7,1,7
TRBV30,TRBJ2-2,CAWSRTGELFF,0,7,1,7
TRBV11-2,TRBJ1-1,CAISFHWAAFF,0,7,1,7
TRBV19,TRBJ2-1,CASSMGDEQFF,0,7,1,7
TRBV2,TRBJ2-1,CASSDGAEQFF,0,7,1,7
TRBV7-9,TRBJ2-7,CASSSFYEQYF,0,7,1,7
TRBV9,TRBJ2-7,CASSDSYEQYF,0,7,1,7
TRBV7-9,TRBJ2-2,CASNSAGELFF,0,7,1,7
TRBV29-1,TRBJ2-1,CTGQIFNEQFF,0,7,1,7
TRBV29-1,TRBJ2-3,CSVDRGDTQYF,0,7,1,7
TRBV29-1,TRBJ2-5,CSVGLAATQYF,0,7,1,7
TRBV19,TRBJ2-1,CASSLLGETGGPYNEQFF,0,7,1,7
TRBV6-2/3/5/6,TRBJ2-3,CASSPGKGLAATDTQYF,0,7,1,7
TRBV20-1,TRBJ2-1,CSAIHLAGGSLNEQFF,0,7,1,7
TRBV12-3/4,TRBJ2-1,CASTPRTSGNNEQFF,0,7,1,7
TRBV5-5,TRBJ2-1,CASSSLGDSYNEQFF,0,7,1,7
TRBV5-1,TRBJ1-6,CASSLESSYNSPLHF,0,7,1,7
TRBV20-1,TRBJ2-1,CSARDLREGRNKQFF,0,7,1,7
TRBV30,TRBJ2-5,CAWSVGGPQETQYF,0,7,1,7
TRBV12-3/4,TRBJ2-3,CASWSGKPTDTQYF,0,7,1,7
TRBV7-9,TRBJ2-3,CASSLGGTTDTQYF,0,7,1,7
TRBV12-3/4,TRBJ2-7,CASSPGGSSYEQYF,0,7,1,7
TRBV5-1,TRBJ2-1,CASSWTSQGNEQFF,0,7,1,7
TRBV7-7,TRBJ2-5,CASSQGVQETQYF,0,7,1,7
TRBV24-1,TRBJ1-1,CATSDSTGAEAFI,0,7,1,7
TRBV5-4,TRBJ2-3,RASSLRRSDTQYF,0,7,1,7
TRBV29-1,TRBJ2-3,SSAGDIGDTQYF,0,7,1,7
TRBV6-2/3/5/6,TRBJ2-7,CASSSPGYEQYF,0,7,1,7
TRBV29-1,TRBJ1-1,CSVEVWYTEAFF,0,7,1,7
TRBV5-1,TRBJ2-1,CASSLRNEQFF,0,10,1,10
TRBV6-2/3/5/6,TRBJ2-6,CASIAGQGRAGANVLTF,0,7,1,7
TRBV6-2/3/5/6,TRBJ2-1,CASSSRPGGGAYNEQFF,0,7,1,7
TRBV20-1,TRBJ2-7,CSARDLLAGGQSREQYF,0,7,1,7
TRBV29-1,TRBJ2-7,CSVRGLAGATRAYEQYF,0,7,1,7
TRBV12-3/4,TRBJ2-3,FATSLASGTRPDTQYF,0,7,1,7
TRBV11-2,TRBJ2-1,CASSFGESGPYNEQFF,0,7,1,7
TRBV9,TRBJ2-2,CASSSTLLANTGELFF,0,7,1,7
TRBV12-3/4,TRBJ1-1,CASSFRLGRDTEAFF,0,7,1,7
TRBV6-1,TRBJ1-1,CASSEVGSWRIEAFF,0,7,1,7
TRBV28,TRBJ2-7,CASSSPRTSRYEQYF,0,7,1,7
TRBV3-1,TRBJ2-3,CASSPRGRPFDTQYF,0,7,1,7
TRBV7-3,TRBJ2-2,CASSPQQSNTGELFF,0,7,1,7
TRBV20-1,TRBJ2-7,CSARDPGGVSYEQYF,0,7,1,7
TRBV29-1,TRBJ1-1,CSVGDRYTEGGEAFF,0,7,1,7
TRBV15,TRBJ2-7,CATSRDLKRYEQYF,0,7,1,7
TRBV6-4,TRBJ2-7,CASSRLKGSYEQYF,0,7,1,7
TRBV6-4,TRBJ1-1,CASRDLSANTEAFF,0,7,1,7
TRBV2,TRBJ2-2,CASSRENTGELFF,0,7,1,7
TRBV5-4,TRBJ2-1,CASSLREPGEQFF,0,7,1,7
TRBV12-3/4,TRBJ2-5,CASRRTGEETQYF,0,10,1,10
TRBV5-1,TRBJ2-1,CASSLWTSNEQFF,0,7,1,7
TRBV12-3/4,TRBJ2-1,CASTPYPIAQFF,0,7,1,7
TRBV7-2,TRBJ2-3,CASSLSDTQYF,0,9,1,9
TRBV7-3,TRBJ1-2,RASSRTGQDLTNYGYTF,0,6,1,6
TRBV6-2/3/5/6,TRBJ2-1,CASSTGGRFLYNEQFF,0,6,1,6
TRBV6-2/3/5/6,TRBJ2-4,CASSIAGGAAKNIQYF,0,6,1,6
TRBV20-1,TRBJ2-3,CSARGPGVAGTDTQYF,0,6,1,6
TRBV15,TRBJ2-1,CATSRDRARTAEQFF,0,6,1,6
TRBV11-2,TRBJ2-3,CASSFSGRAVDTQYF,0,6,1,6
TRBV7-9,TRBJ2-7,CASRPISGKVYEQYF,0,6,1,6
TRBV7-9,TRBJ2-5,CASSFEGLGETQYF,0,6,1,6
TRBV18,TRBJ2-7,CAGSSRQGTYEQYF,0,6,1,6
TRBV24-1,TRBJ2-3,CATSVTSGSGTQYF,0,6,1,6
TRBV5-4,TRBJ2-7,CASSFRGGVEKQYF,0,6,1,6
TRBV11-2,TRBJ2-5,CASSLGTTGETQYF,0,6,1,6
TRBV20-1,TRBJ1-1,CSAREGYVDTEASF,0,6,1,6
TRBV10-3,TRBJ2-3,CAISPEITDTQYF,0,6,1,6
TRBV3-1,TRBJ2-5,CASSLGGEETQYS,0,6,1,6
TRBV3-1,TRBJ2-5,CASSQRGQETQYF,0,6,1,6
TRBV20-1,TRBJ2-4,CSASDMLKNIQYF,0,6,1,6
TRBV20-1,TRBJ2-1,CSARDLSYNEQFF,0,6,1,6
TRBV12-3/4,TRBJ2-1,CASNRVSNEQFF,0,6,1,6
TRBV20-1,TRBJ2-3,CGARDGQGQYF,0,6,1,6
TRBV9,TRBJ2-1,CASSVARGLAGERGRINEQFF,0,6,1,6
TRBV20-1,TRBJ2-2,CSARDPLEGTSGRASGELFF,0,6,1,6
TRBV19,TRBJ2-7,CASRTVRGRPSGSPYEQYF,0,6,1,6
TRBV20-1,TRBJ2-2,CSAQIGGLAGGVGTGELFF,0,6,1,6
TRBV20-1,TRBJ1-5,CSARDRPGQGSSSNQPQHF,0,6,1,6
TRBV19,TRBJ2-6,CASSIVPSGHSGANVLTF,0,6,1,6
TRBV27,TRBJ2-1,CASSSQSNLLGFYNEQFF,0,6,1,6
TRBV27,TRBJ2-1,CASSRSGLILSSYNEQFF,0,6,1,6
TRBV12-3/4,TRBJ2-3,CASSQISSSRVRTDTQYF,0,6,1,6
TRBV28,TRBJ2-3,CASRGLAGGGGSTDTQYF,0,6,1,6
TRBV2,TRBJ2-4,CASRSGTSGSGAKNIQYF,0,6,1,6
TRBV10-2,TRBJ1-5,CASSQHRGSNVGAQPQHF,0,6,1,6
TRBV29-1,TRBJ2-1,CSALPGTAGGPAYNEQFF,0,6,1,6
TRBV29-1,TRBJ1-1,CSIPPISRRGQEDTEAFF,0,6,1,6
TRBV10-3,TRBJ2-6,CAIRPGPRSSGANVLTF,0,6,1,6
TRBV3-1,TRBJ2-7,CASSRRQGPVWDYEQYF,0,6,1,6
TRBV28,TRBJ2-7,CASSADSWGDLSYEQYF,0,6,1,6
TRBV2,TRBJ1-2,CASSEITGAPVVHGYTF,0,6,1,6
TRBV7-2,TRBJ2-7,CASSFIVGQGRAYEQYF,0,6,1,6
TRBV5-4,TRBJ2-1,CASSLVTGTSGNNEQFF,0,6,1,6
TRBV3-1,TRBJ2-1,CASSYTASGVPMAEQFF,0,6,1,6
TRBV4-2,TRBJ2-3,CASSPRSLAGGGDTQYF,0,6,1,6
TRBV5-1,TRBJ2-5,CASSLVLAGGIQETQYF,0,6,1,6
TRBV5-1,TRBJ2-1,CASSSGTSGSAYNEQFF,0,6,1,6
TRBV5-1,TRBJ2-1,CASSWTLGANRFREQFF,0,6,1,6
TRBV5-1,TRBJ1-1,CASSLRQGDLVDTEAFF,0,6,1,6
TRBV4-1,TRBJ2-1,CASSQAVVQGLGLEQFF,0,6,1,6
TRBV20-1,TRBJ2-3,CSAHGGLAGVSTDTQYF,0,6,1,6
TRBV12-5,TRBJ2-5,CASGSLAGLYQETQYF,0,6,1,6
TRBV19,TRBJ1-5,CASSTGVQAGNQPQHF,0,6,1,6
TRBV18,TRBJ2-3,CASSPRKGGGTDTQYF,0,6,1,6
TRBV28,TRBJ2-1,CASSFPWGGGNNEQFF,0,6,1,6
TRBV12-3/4,TRBJ1-5,CASSLYQGGPNQPQHF,0,6,1,6
TRBV12-3/4,TRBJ1-2,CASSLVSGAARNGYTF,0,6,1,6
TRBV6-2/3/5/6,TRBJ1-6,CASSYGDRGYNSPLHF,0,6,1,6
TRBV12-3/4,TRBJ2-7,CASSPRGDRGIYEQYF,0,6,1,6
TRBV28,TRBJ2-4,CASSPQGARVKNIQYF,0,6,1,6
TRBV5-4,TRBJ2-3,CASSQKSGSRTDTQYF,0,6,1,6
TRBV6-1,TRBJ2-5,CASSESQGLYQETQYF,0,6,1,6
TRBV2,TRBJ1-1,CASSTQGTGMNTEAFF,0,6,1,6
TRBV6-1,TRBJ2-7,CASSRTRGTGAYEQYF,0,6,1,6
TRBV6-1,TRBJ2-7,CASSKGGTSGSYEQYF,0,6,1,6
TRBV5-6,TRBJ2-3,CASSFPGLDPTDTQYF,0,6,1,6
TRBV5-4,TRBJ2-1,CASSLDGGSSYNEQFF,0,6,1,6
TRBV13,TRBJ2-1,CASSSAGTKVYNEQFF,0,6,1,6
TRBV11-2,TRBJ2-3,CASSLLSRERTDTQYF,0,6,1,6
TRBV5-6,TRBJ2-5,CASSPPSSGRRETQYF,0,6,1,6
TRBV7-9,TRBJ2-3,CASSRQGAPHTDTQYF,0,6,1,6
TRBV3-1,TRBJ2-1,CASSQGLAAGVNEQFF,0,6,1,6
TRBV14,TRBJ2-1,CASSQVSGSSYNEQFF,0,6,1,6
TRBV14,TRBJ2-2,CASSQVAGKNTGELFF,0,6,1,6
TRBV3-1,TRBJ2-1,CASSQDGGRAGNEQFF,0,6,1,6
TRBV5-6,TRBJ2-3,CASSVPRGVGEDTQYF,0,6,1,6
TRBV7-9,TRBJ2-1,CASSGRTSGSYNEQFF,0,6,1,6
TRBV5-4,TRBJ2-1,CASSKPTGQSYNEQFF,0,6,1,6
TRBV5-1,TRBJ1-1,CASSPQGGGLDTEAFF,0,6,1,6
TRBV5-1,TRBJ2-1,CASSLWSGTTHAEQFF,0,6,1,6
TRBV5-1,TRBJ1-5,CASSLGTGYDNQPQHF,0,6,1,6
TRBV5-1,TRBJ1-1,CASSPPGQDMNTEAFF,0,6,1,6
TRBV4-1,TRBJ2-1,CASSRASGSEGNEQFF,0,6,1,6
TRBV5-1,TRBJ2-7,CASSAGTSGRRDEQYF,0,6,1,6
TRBV20-1,TRBJ2-3,CSARDFQGWVTDTQYF,0,6,1,6
TRBV29-1,TRBJ2-1,CSVLELAGASYNEQFF,0,6,1,6
TRBV29-1,TRBJ2-3,CSVSPGTSRPTDTQYF,0,6,1,6
TRBV29-1,TRBJ2-3,CSVYPWTNSLTDTQYF,0,6,1,6
TRBV29-1,TRBJ2-3,CSVEGVQGRGTDTQYF,0,6,1,6
TRBV29-1,TRBJ1-2,CSVEEFGVPPPDGYTF,0,6,1,6
TRBV9,TRBJ2-1,CAGSTGLAGNNEQFF,0,6,1,6
TRBV10-3,TRBJ2-3,CAISAWREVTDTQYF,0,6,1,6
TRBV12-3/4,TRBJ2-1,CASDSSVRGYNEQFF,0,6,1,6
TRBV19,TRBJ2-1,CASTSGRTGYDEQFF,0,6,1,6
TRBV19,TRBJ1-1,CASSLGEARNTEAFF,0,6,1,6
TRBV19,TRBJ2-1,CASSITGSSYNEQFF,0,6,1,6
TRBV19,TRBJ2-7,CASSISVSDRFLAYF,0,6,1,6
TRBV19,TRBJ1-5,CASKTLRTTNQPQHF,0,6,1,6
TRBV18,TRBJ2-1,CASSPPGSAYNEQFF,0,6,1,6
TRBV18,TRBJ2-7,CASSPPGSRWYEQYF,0,6,1,6
TRBV28,TRBJ2-7,CASCTPGTGNYEQYF,0,6,1,6
TRBV5-4,TRBJ2-4,CASTPGGAGKNIQYF,0,6,1,6
TRBV4-2,TRBJ2-1,CASTPGGSTYNEQFF,0,6,1,6
TRBV12-3/4,TRBJ1-5,CASTTTGPSGQPQHF,0,6,1,6
TRBV28,TRBJ2-7,CASSFSSGELYEQYF,0,6,1,6
TRBV12-3/4,TRBJ2-3,CASSLRIGGPDTQYF,0,6,1,6
TRBV2,TRBJ2-7,CASSLFPGAAYEQYF,0,6,1,6
TRBV12-3/4,TRBJ2-1,CASSLGGSSGADQFF,0,6,1,6
TRBV6-2/3/5/6,TRBJ2-1,CASSSAGIQYNEQFF,0,6,1,6
TRBV6-2/3/5/6,TRBJ1-4,CASSYSGTENEKLFF,0,6,1,6
TRBV6-2/3/5/6,TRBJ2-3,CASSYRDRSTDTQYF,0,6,1,6
TRBV6-2/3/5/6,TRBJ1-2,CASSYAPGPNYGYTF,0,6,1,6
TRBV6-2/3/5/6,TRBJ2-7,CASSYNAGGTYEQYF,0,6,1,6
TRBV28,TRBJ2-3,CASSPRGRTTDTQYF,0,6,1,6
TRBV28,TRBJ2-5,CASSPKEGRKETQYF,0,6,1,6
TRBV12-3/4,TRBJ1-5,CASSTGVGSNQPQHF,0,6,1,6
TRBV2,TRBJ2-7,CASSNRLAGVYEQYF,0,6,1,6
TRBV11-2,TRBJ2-7,CASSFSQGNNYEQYF,0,6,1,6
TRBV13,TRBJ2-3,CASSFGLADTDTQYF,0,6,1,6
TRBV7-9,TRBJ2-3,CASSFMGQSTDTQYF,0,6,1,6
TRBV11-2,TRBJ1-1,CASSLLRGSGTEAFF,0,6,1,6
TRBV7-2,TRBJ2-7,CASSLVAGSSYEQYF,0,6,1,6
TRBV7-2,TRBJ2-3,CASSLGGMNTDTQYF,0,6,1,6
TRBV7-2,TRBJ2-1,CASSLGGTLSNEQFF,0,6,1,6
TRBV5-6,TRBJ2-5,CASSLGRAVQETQYF,0,6,1,6
TRBV5-6,TRBJ2-7,CASSLDSRRAYEQYF,0,6,1,6
TRBV7-9,TRBJ2-7,CASSLVSGRVYEQYF,0,6,1,6
TRBV7-2,TRBJ2-1,CASSLGRLGYNEQFF,0,6,1,6
TRBV7-6,TRBJ2-1,CASSLGQGTYNEQFF,0,6,1,6
TRBV11-2,TRBJ1-1,CASSLDFWGNTEAFF,0,6,1,6
TRBV7-3,TRBJ2-1,CASSLMYGTYNEQFF,0,6,1,6
TRBV7-9,TRBJ2-7,CASSLSAGAQYEQYF,0,6,1,6
TRBV13,TRBJ2-4,CASSYRVGAKNIQYF,0,6,1,6
TRBV5-6,TRBJ1-3,CASSLRTYSGNTIYF,0,6,1,6
TRBV9,TRBJ2-1,CASSLRRTLADEQFF,0,6,1,6
TRBV3-1,TRBJ2-7,CASSPAAGTYYEQYF,0,6,1,6
TRBV28,TRBJ2-5,CASSPGGAGGETQYF,0,6,1,6
TRBV7-8,TRBJ1-6,CASSPRTGLPSPLHF,0,6,1,6
TRBV7-2,TRBJ2-1,CASSRRAGGGNEQFF,0,6,1,6
TRBV7-9,TRBJ2-1,CASSQGLAGVSEQFF,0,6,1,6
TRBV4-2,TRBJ2-1,CASSQDLRGGNEQFF,0,6,1,6
TRBV14,TRBJ2-5,CASSQDGRREETQYF,0,6,1,6
TRBV6-2/3/5/6,TRBJ2-7,CASSVGTGRHYEQYF,0,6,1,6
TRBV28,TRBJ2-1,CASSVGLGNRNEQFF,0,6,1,6
TRBV9,TRBJ2-1,CASSVDAGGWNEQFF,0,6,1,6
TRBV6-2/3/5/6,TRBJ2-1,CASRGGTSWDNEQFF,0,6,1,6
TRBV2,TRBJ2-5,CASRGTAGGQETQYF,0,6,1,6
TRBV7-2,TRBJ2-7,CASRTRDSRQYEQYF,0,6,1,6
TRBV6-2/3/5/6,TRBJ2-7,CASRTLARSSYEQYF,0,6,1,6
TRBV2,TRBJ2-7,CASRLDRGLGIEQYL,0,6,1,6
TRBV7-2,TRBJ2-1,CASRQTGSSYNEQFF,0,6,1,6
TRBV5-1,TRBJ2-2,CASSLSQGYTGELFF,0,6,1,6
TRBV5-1,TRBJ2-2,CASSLRSGDTGELFF,0,6,1,6
TRBV5-1,TRBJ2-7,CASSLGDSSSYEQYF,0,6,1,6
TRBV5-1,TRBJ2-3,CASSLERAGTDTQYF,0,6,1,6
TRBV5-1,TRBJ2-2,CASSLTTGSTGELFF,0,6,1,6
TRBV5-1,TRBJ1-1,CASSSNSQMNTEAFF,0,6,1,6
TRBV5-1,TRBJ2-3,CASSLGTHSTDTQYF,0,6,1,6
TRBV5-1,TRBJ2-2,CASSPGTVSTGELFF,0,6,1,6
TRBV5-1,TRBJ2-7,CASSRDLAANYEQYF,0,6,1,6
TRBV5-1,TRBJ1-6,CASSQSWARNSPLHF,0,6,1,6
TRBV5-1,TRBJ2-1,CASSETSGSGNEQFF,0,6,1,6
TRBV5-1,TRBJ2-7,CASSEGLAATYEQYF,0,6,1,6
TRBV5-1,TRBJ2-7,CASRPGTSGTYEQYF,0,6,1,6
TRBV20-1,TRBJ2-3,CSATPSGSESDTQYF,0,6,1,6
TRBV20-1,TRBJ2-7,CSARQGGTISYEQYF,0,6,1,6
TRBV20-1,TRBJ2-1,CSARDFGGSYNEQFF,0,6,1,6
TRBV20-1,TRBJ2-7,CSARDGKRETHEQYF,0,6,1,6
TRBV29-1,TRBJ2-1,CSVGKGLAFAHEQFF,0,6,1,6
TRBV29-1,TRBJ2-2,CSVGPSGRNTGELFF,0,6,1,6
TRBV29-1,TRBJ2-7,CSVRVGLAGGREQYF,0,6,1,6
TRBV30,TRBJ1-1,CAWSVKGVPPEAFF,0,6,1,6
TRBV10-3,TRBJ2-7,CAISDEKGGDEQYF,0,6,1,6
TRBV10-3,TRBJ2-5,CAISTGKDGETPYF,0,6,1,6
TRBV24-1,TRBJ2-3,CATSDSGTADTQYF,0,6,1,6
TRBV18,TRBJ1-5,CASGTGFSNQPQHF,0,6,1,6
TRBV19,TRBJ2-2,CASGRDTPPGELFF,0,6,1,6
TRBV19,TRBJ1-1,CASMEGFGETEAFF,0,6,1,6
TRBV19,TRBJ2-3,CASTAQGAGDTQYF,0,6,1,6
TRBV19,TRBJ1-1,CASSARGRITEAFF,0,6,1,6
TRBV19,TRBJ2-5,CASSITGTAETQYF,0,6,1,6
TRBV19,TRBJ1-1,CASSLRGPNTEAFF,0,6,1,6
TRBV18,TRBJ1-1,CASSPDWANTEAFF,0,6,1,6
TRBV18,TRBJ2-7,CASSRLVGSYEQYF,0,6,1,6
TRBV6-2/3/5/6,TRBJ1-5,CASVPGQGDQPQHF,0,6,1,6
TRBV12-3/4,TRBJ1-2,CASSLRTFNYGYTF,0,6,1,6
TRBV12-3/4,TRBJ1-1,CASSSPHLGTEAFF,0,6,1,6
TRBV11-2,TRBJ2-1,CASSSDDYGSEQFF,0,6,1,6
TRBV6-2/3/5/6,TRBJ2-3,CASSYAAGADTQYF,0,6,1,6
TRBV12-3/4,TRBJ1-1,CASSPTTANTEAFF,0,6,1,6
TRBV12-3/4,TRBJ2-7,CASSRQGGGYEQYF,0,6,1,6
TRBV12-3/4,TRBJ2-5,CASSQRGYEETQYF,0,6,1,6
TRBV2,TRBJ2-1,CASSASTSRYEQFF,0,6,1,6
TRBV25-1,TRBJ2-2,CASSERGSTGELFF,0,6,1,6
TRBV2,TRBJ1-1,CASSEEQGATEAFF,0,6,1,6
TRBV7-3,TRBJ2-1,CASSFAGQVNEQFF,0,6,1,6
TRBV5-5,TRBJ2-5,CASSLLAGEETQYF,0,6,1,6
TRBV5-6,TRBJ2-5,CASSLHSPGETQYF,0,6,1,6
TRBV5-5,TRBJ2-7,CASSLAAGVYEQYF,0,6,1,6
TRBV11-2,TRBJ2-3,CASSLSWTGDTQYF,0,6,1,6
TRBV11-2,TRBJ1-1,CASSLGAANTEASF,0,6,1,6
TRBV7-8,TRBJ1-4,CASSLGGANEKLFF,0,6,1,6
TRBV7-8,TRBJ1-1,CASSLDRGGTEAFF,0,6,1,6
TRBV7-9,TRBJ2-1,CASSLEWARGEQFF,0,6,1,6
TRBV6-2/3/5/6,TRBJ2-3,CASSLPGTVDTQYF,0,6,1,6
TRBV27,TRBJ2-3,CASSLGQTTDTQYF,0,6,1,6
TRBV14,TRBJ1-4,CASSPTSTNEKLFF,0,6,1,6
TRBV7-2,TRBJ2-2,CASSPRRNTGELFF,0,6,1,6
TRBV5-4,TRBJ2-3,CASSPGHGTDTQYF,0,6,1,6
TRBV7-9,TRBJ2-2,CASSPTGINGELFF,0,6,1,6
TRBV7-9,TRBJ1-2,CASSPGSGFYGYTF,0,6,1,6
TRBV5-4,TRBJ2-2,CASSPDRGFGELFF,0,6,1,6
TRBV7-3,TRBJ2-2,CASSRDGNTGELFF,0,6,1,6
TRBV7-9,TRBJ2-7,CASSHWDRVYEQYF,0,6,1,6
TRBV14,TRBJ2-2,CASSQAVQAGELFF,0,6,1,6
TRBV3-1,TRBJ1-3,CASSQGDRGNTIYF,0,6,1,6
TRBV3-1,TRBJ2-1,CASSQDLGGDEQFF,0,6,1,6
TRBV9,TRBJ1-4,CASSADSGNEKLFF,0,6,1,6
TRBV6-4,TRBJ2-7,CASSGGVFSYEQYF,0,6,1,6
TRBV3-1,TRBJ2-3,CASSKASEGDTQYF,0,6,1,6
TRBV28,TRBJ2-1,CASLLAGSYSEQFF,0,6,1,6
TRBV5-1,TRBJ2-3,CASSQQGIPDTQYF,0,6,1,6
TRBV5-1,TRBJ2-1,CASSLVPGASEQFF,0,6,1,6
TRBV5-1,TRBJ2-3,CASSLSQGIDTQYF,0,6,1,6
TRBV5-1,TRBJ2-7,CASSHGQGAYEQYF,0,6,1,6
TRBV4-1,TRBJ2-7,CASSQATGVYEQYF,0,6,1,6
TRBV5-1,TRBJ2-2,CASSTSDRIGELFF,0,6,1,6
TRBV5-1,TRBJ1-1,CASSRYRVTAEAFF,0,6,1,6
TRBV10-2,TRBJ2-5,CASRALAGEETQYF,0,6,1,6
TRBV20-1,TRBJ2-1,CSAAGDSSYNEQFF,0,6,1,6
TRBV20-1,TRBJ2-1,CSARTAVGVNEQFF,0,6,1,6
TRBV20-1,TRBJ2-5,CSARGSATQETQYF,0,6,1,6
TRBV20-1,TRBJ2-5,CSARDMAGEETQYF,0,6,1,6
TRBV20-1,TRBJ2-3,CSAREGSRGDTQYF,0,6,1,6
TRBV29-1,TRBJ2-3,CSVVVAAHTDTQYF,0,6,1,6
TRBV29-1,TRBJ2-4,CSVGDRESKNIQYF,0,6,1,6
TRBV29-1,TRBJ2-3,CSVGTHTSTDTQYF,0,6,1,6
TRBV29-1,TRBJ1-5,CSVGTDSRDQPQHF,0,6,1,6
TRBV29-1,TRBJ1-1,CSVEASARDTEAFF,0,6,1,6
TRBV29-1,TRBJ2-1,CSVEDLRAANEQFF,0,6,1,6
TRBV29-1,TRBJ2-1,CSVIPARALNEQFF,0,6,1,6
TRBV29-1,TRBJ2-5,CSVPDRETQETQYF,0,6,1,6
TRBV29-1,TRBJ2-3,CSVKRAGETDTQYF,0,6,1,6
TRBV29-1,TRBJ2-3,CSADPGLAGEMQYF,0,6,1,6
TRBV30,TRBJ1-4,CAWTRHISEKLFF,0,6,1,6
TRBV10-3,TRBJ2-7,CAISESRAEGQYF,0,6,1,6
TRBV19,TRBJ2-5,CASSIQIQETQYF,0,6,1,6
TRBV18,TRBJ2-1,CASSPSTYNEQFF,0,6,1,6
TRBV18,TRBJ1-5,CASCQGEDQPQHF,0,6,1,6
TRBV27,TRBJ2-1,CASVWGTYNEQFF,0,6,1,6
TRBV14,TRBJ2-5,CASGGSGQETQYF,0,6,1,6
TRBV12-3/4,TRBJ2-3,CASEGGGADTQYF,0,6,1,6
TRBV6-2/3/5/6,TRBJ2-5,CASTYGGMETQYF,0,6,1,6
TRBV7-2,TRBJ2-3,CASTGGRTDTQYF,0,6,1,6
TRBV12-3/4,TRBJ2-6,CASTISGANVLTF,0,6,1,6
TRBV6-2/3/5/6,TRBJ1-1,CASSLGQNTEAFF,0,6,1,6
TRBV28,TRBJ2-7,CASSLGTGDEQYF,0,6,1,6
TRBV6-2/3/5/6,TRBJ2-6,CASSYSGGPVLTF,0,6,1,6
TRBV12-3/4,TRBJ2-2,CASSLGGPGELFF,0,6,1,6
TRBV12-3/4,TRBJ2-1,CASSRTESVEQFF,0,6,1,6
TRBV2,TRBJ1-1,CASSVGGHTEAFF,0,6,1,6
TRBV12-3/4,TRBJ1-6,CASSGLDHSPLHF,0,6,1,6
TRBV2,TRBJ2-4,CASSDTNKNIQYF,0,6,1,6
TRBV2,TRBJ2-5,CASSERLGETQYF,0,6,1,6
TRBV3-1,TRBJ2-3,CASSEPSTDTQYF,0,6,1,6
TRBV5-6,TRBJ2-1,CASSFQTSNEQFF,0,6,1,6
TRBV11-3,TRBJ2-5,CASSFGQQETQYF,0,6,1,6
TRBV7-2,TRBJ2-3,CASSLISEDTQYF,0,6,1,6
TRBV7-3,TRBJ2-5,CASSLTREETQYF,0,6,1,6
TRBV7-9,TRBJ1-4,CASSSDRNEKLFF,0,6,1,6
TRBV11-3,TRBJ2-7,CASSWRAQGEQYF,0,6,1,6
TRBV6-2/3/5/6,TRBJ1-1,CASSYGRKTEAFF,0,6,1,6
TRBV5-4,TRBJ2-1,CASSPRGSGSTFF,0,6,1,6
TRBV7-8,TRBJ2-7,CASSPGYGNEQYF,0,6,1,6
TRBV5-4,TRBJ2-2,CASSPKGPGELFF,0,6,1,6
TRBV7-2,TRBJ1-1,CASSRSPNTEAFF,0,6,1,6
TRBV2,TRBJ2-1,CASSRERDNEQFF,0,6,1,6
TRBV7-3,TRBJ2-2,CASSQAGDGELFF,0,6,1,6
TRBV3-1,TRBJ2-7,CASSQARGSEQYF,0,6,1,6
TRBV14,TRBJ2-5,CASSQGNKETQYF,0,6,1,6
TRBV6-2/3/5/6,TRBJ1-5,CASSVGEGQPQHF,0,6,1,6
TRBV9,TRBJ2-1,CASSVGLAGEEFF,0,6,1,6
TRBV7-2,TRBJ2-2,CASSGTGTGELFF,0,6,1,6
TRBV7-9,TRBJ2-2,CASSTDNTGELFF,0,6,1,6
TRBV11-1,TRBJ2-5,CASSKASQETQYF,0,6,1,6
TRBV12-3/4,TRBJ2-1,CASRWADLNEQFF,0,6,1,6
TRBV27,TRBJ2-1,CASRQERYNEQFF,0,6,1,6
TRBV5-1,TRBJ2-7,CASSFPQGNEQYF,0,6,1,6
TRBV10-2,TRBJ2-3,CASSSGSTDTQYF,0,6,1,6
TRBV5-1,TRBJ1-2,CASSSGALGGYTF,0,6,1,6
TRBV5-1,TRBJ2-3,CASSQTSTDTQYF,0,6,1,6
TRBV5-1,TRBJ2-2,CASRRRATGELFF,0,6,1,6
TRBV29-1,TRBJ2-7,CGVVGTSSYEQYF,0,6,1,6
TRBV20-1,TRBJ2-1,CSVRGRSYNEQFF,0,6,1,6
TRBV20-1,TRBJ2-5,CSASREFRETQYF,0,6,1,6
TRBV20-1,TRBJ2-7,CSARVDSSYEQYF,0,6,1,6
TRBV20-1,TRBJ2-1,CSARDRGWGEQFF,0,6,1,6
TRBV20-1,TRBJ2-1,CSARRFGGNEQFF,0,6,1,6
TRBV20-1,TRBJ2-1,CSAPGQGFDEQFF,0,6,1,6
TRBV20-1,TRBJ2-3,CSSRTFSTDTQYF,0,6,1,6
TRBV29-1,TRBJ1-5,CSVLGQGDQPQHF,0,6,1,6
TRBV29-1,TRBJ2-1,CSVDGASYNEQFF,0,6,1,6
TRBV29-1,TRBJ2-5,CSVEVRPRETQYF,0,6,1,6
TRBV29-1,TRBJ1-2,CSAEAGTRGGYTF,0,6,1,6
TRBV29-1,TRBJ2-5,CSGTGLGGETQYF,0,6,1,6
TRBV5-1,TRBJ1-1,RASSSTTGYQAFF,0,6,1,6
TRBV19,TRBJ1-2,CASSTRQAGYTF,0,6,1,6
TRBV19,TRBJ2-5,CASSTDQETQYF,0,6,1,6
TRBV28,TRBJ2-1,CASTIGHTEQFF,0,6,1,6
TRBV3-1,TRBJ2-5,CASSQSWETQYF,0,6,1,6
TRBV5-4,TRBJ2-7,CASSLERDEQYF,0,6,1,6
TRBV5-6,TRBJ1-5,CASSLFGQHQHF,0,6,1,6
TRBV7-6,TRBJ2-1,CASSLLRGPKFF,0,6,1,6
TRBV7-9,TRBJ2-2,CASSLARQGLFF,0,6,1,6
TRBV6-2/3/5/6,TRBJ2-1,CASSSSGSGQFF,0,6,1,6
TRBV3-1,TRBJ1-5,CASSQGGLPQHF,0,6,1,6
TRBV5-4,TRBJ2-3,CASSAVSDTQYF,0,6,1,6
TRBV11-2,TRBJ1-1,CASSATGFGAFF,0,6,1,6
TRBV11-2,TRBJ1-2,CASSNRGGGYTF,0,6,1,6
TRBV6-2/3/5/6,TRBJ1-1,CASRPSDRGAFF,0,6,1,6
TRBV5-1,TRBJ1-1,CASSLGGDGALF,0,6,1,6
TRBV5-1,TRBJ2-3,CASSLTTDTQYF,0,6,1,6
TRBV20-1,TRBJ2-3,CSAHTGADTQYF,0,6,1,6
TRBV20-1,TRBJ2-3,CSARRLEDTQYF,0,6,1,6
TRBV29-1,TRBJ2-3,CSQSREADTQYF,0,6,1,6
TRBV29-1,TRBJ1-1,CSVGQAETEAFF,0,6,1,6
TRBV29-1,TRBJ2-7,CSAFEYGYEQYF,0,6,1,6
TRBV29-1,TRBJ2-7,CSILLGTYEQYF,0,6,1,6
TRBV28,TRBJ2-7,RASKGRVEDQYF,0,6,1,6
TRBV30,TRBJ1-4,CAWGTDEKLFF,0,6,1,6
TRBV28,TRBJ2-7,CAIGQTHQQYF,0,6,1,6
TRBV7-9,TRBJ2-1,CASGGYNEQFF,0,6,1,6
TRBV2,TRBJ1-5,CASGLDQPQHF,0,6,1,6
TRBV2,TRBJ2-1,CASMSPGGQFF,0,6,1,6
TRBV6-2/3/5/6,TRBJ2-3,CASSPQPTQYF,0,6,1,6
TRBV3-1,TRBJ2-1,CASSHVNEQFF,0,6,1,6
TRBV3-1,TRBJ2-7,CASSQLYEQYF,0,6,1,6
TRBV12-3/4,TRBJ2-1,CASRGGNEQFF,0,6,1,6
TRBV20-1,TRBJ2-7,CSAREPHTIIF,0,6,1,6
TRBV20-1,TRBJ1-1,CSAKKDTEAFF,0,6,1,6
TRBV20-1,TRBJ2-5,CSAEPTETQYF,0,6,1,6
TRBV20-1,TRBJ2-5,CSGWGTETQYF,0,6,1,6
TRBV20-1,TRBJ2-3,CSARPLTQYF,0,6,1,6
TRBV5-6,TRBJ1-5,CASSLAGQSSNQPRHF,0,6,1,6
TRBV5-4,TRBJ1-1,CASSLGGGRGNTEAFF,0,6,1,6
TRBV2,TRBJ1-1,CASVPGSGPGTEAFF,0,6,1,6
TRBV5-1,TRBJ2-7,CASSLALGIYYEQYF,0,6,1,6
TRBV18,TRBJ1-1,CASSIERSNTEAFF,0,6,1,6
TRBV2,TRBJ2-2,CASTWAQNTGELFF,0,6,1,6
TRBV12-3/4,TRBJ2-3,CASSLGVGADTQYF,0,6,1,6
TRBV29-1,TRBJ2-6,CSVSGPSGANVLTF,0,6,1,6
TRBV29-1,TRBJ2-7,CSVARRTGAYEQYF,0,6,1,6
TRBV28,TRBJ2-5,CASRGQGKATQCF,0,6,1,6
TRBV29-1,TRBJ2-7,CSVAPDRSYEQYF,0,6,1,6
TRBV5-4,TRBJ1-2,CASSPGLSGYTF,0,6,1,6
TRBV27,TRBJ2-1,CASSRRGPGQLAGGLWSYNEQFF,0,5,1,5
TRBV14,TRBJ1-3,CASSQDLVIRGNLFGSGNTIYF,0,5,1,5
TRBV12-3/4,TRBJ1-1,CASSLDMKPPGEAGWSFGAFF,0,5,1,5
TRBV25-1,TRBJ2-3,CASSEYATSGRATGTDTQYF,0,5,1,5
TRBV12-3/4,TRBJ1-5,CASSPSPRFGLGETNQPQHF,0,5,1,5
TRBV5-1,TRBJ2-6,CASSLDRQGALVIATNVLTF,0,5,1,5
TRBV10-3,TRBJ2-2,CAIKGPSSYRDRGPGELFF,0,5,1,5
TRBV18,TRBJ2-3,CASSKFSSSGLSGTDTQYF,0,5,1,5
TRBV19,TRBJ1-1,CASSALPGQGIVIGTEAFF,0,5,1,5
TRBV28,TRBJ2-5,CASVDRGVWAGGFSETQYF,0,5,1,5
TRBV7-9,TRBJ2-1,CASSRLAGGPGGMNNEQFF,0,5,1,5
TRBV7-6,TRBJ2-3,CASSLLGAGLRYSTDTQYF,0,5,1,5
TRBV4-1,TRBJ1-4,CASSQAGPWDRRGDEKLFF,0,5,1,5
TRBV5-1,TRBJ2-2,CASSIAIFKLASNTGELFF,0,5,1,5
TRBV29-1,TRBJ2-6,CSVVFTVNAGGSGANVLTF,0,5,1,5
TRBV19,TRBJ2-5,CASSARGLAETLRETQYF,0,5,1,5
TRBV6-2/3/5/6,TRBJ2-2,CASRITTGTARNTGELFF,0,5,1,5
TRBV28,TRBJ2-7,CASSLLGSGRAGSYEQYF,0,5,1,5
TRBV12-3/4,TRBJ1-1,CASSLARRGWTGNTEAFF,0,5,1,5
TRBV28,TRBJ2-3,CASSQVSASAREADTQYF,0,5,1,5
TRBV6-1,TRBJ1-5,CASSGRNQGQGINQPQHF,0,5,1,5
TRBV7-2,TRBJ2-5,CASSSSIVDSGSRETQYF,0,5,1,5
TRBV5-4,TRBJ2-3,CASRLGGLVAGGTDTQYF,0,5,1,5
TRBV20-1,TRBJ2-1,CSASPILGLAESYNEQFF,0,5,1,5
TRBV12-5,TRBJ2-1,CASGPQGLAVDYNEQFF,0,5,1,5
TRBV4-2,TRBJ2-1,CAGSQVAGTIGNNEQFF,0,5,1,5
TRBV19,TRBJ2-1,CASSTLSGLAVYNEQFF,0,5,1,5
TRBV19,TRBJ1-3,CASSTPRHADSGNTIYF,0,5,1,5
TRBV19,TRBJ2-3,CASSTKTGTSGTDTQYF,0,5,1,5
TRBV18,TRBJ2-1,CASSPYSNGRGDNEQFF,0,5,1,5
TRBV2,TRBJ2-7,CASTRASGRSQSYEQYF,0,5,1,5
TRBV6-2/3/5/6,TRBJ2-5,CASSLSPGQIIGETQYF,0,5,1,5
TRBV12-3/4,TRBJ1-2,CASSLWGLGRKGSGYTF,0,5,1,5
TRBV28,TRBJ2-1,CASSPNTGTSGYNEQFL,0,5,1,5
TRBV6-2/3/5/6,TRBJ2-1,CASSPGAGTSGSFEQFF,0,5,1,5
TRBV2,TRBJ2-1,CASSDPREESQYNEQFF,0,5,1,5
TRBV5-8,TRBJ2-2,CASSFPTSGANTGELFF,0,5,1,5
TRBV7-9,TRBJ2-1,CASSLVLRGRNYNEQFF,0,5,1,5
TRBV7-2,TRBJ2-3,CASSLGIREGPTDTQYF,0,5,1,5
TRBV7-3,TRBJ2-1,CASSLSPAGGVYNEQFF,0,5,1,5
TRBV7-2,TRBJ2-3,CASSYGTGITLTDTQYF,0,5,1,5
TRBV3-1,TRBJ2-1,CASSQVLPGQGVNEQFF,0,5,1,5
TRBV14,TRBJ2-1,CASSQGASGNSCNGQFF,0,5,1,5
TRBV3-1,TRBJ2-1,CASSQGRGGLASGEQFF,0,5,1,5
TRBV14,TRBJ2-1,CASSQDRVSGARLVQFF,0,5,1,5
TRBV7-9,TRBJ2-3,CASSALSQSLSTDTQYF,0,5,1,5
TRBV5-1,TRBJ2-6,CASSSGRISSGANVLTF,0,5,1,5
TRBV5-1,TRBJ2-6,CASSYLAGPSGANVLTF,0,5,1,5
TRBV5-1,TRBJ2-1,CASSPGGLAGAGVMEFF,0,5,1,5
TRBV20-1,TRBJ2-3,CSAMEPSGRAGVHTQYF,0,5,1,5
TRBV20-1,TRBJ2-3,CSARGPGRTGAVDTQYF,0,5,1,5
TRBV20-1,TRBJ2-1,CSARGVGGTSSYNEQFF,0,5,1,5
TRBV20-1,TRBJ2-5,CSARDFKGQGGQETQYF,0,5,1,5
TRBV12-3/4,TRBJ1-5,CAGSSNQGYSNQPQHF,0,5,1,5
TRBV10-3,TRBJ2-3,CAISEGSGLGTDTQYF,0,5,1,5
TRBV24-1,TRBJ2-5,CATSGSGTGNQETQYF,0,5,1,5
TRBV24-1,TRBJ2-1,CATSDLGQSSYNEQFL,0,5,1,5
TRBV19,TRBJ1-5,CASTKRGQNSNQPQHF,0,5,1,5
TRBV19,TRBJ2-1,CASSIRVAGANNEQFF,0,5,1,5
TRBV19,TRBJ2-1,CASSIGFGLAGNEQFF,0,5,1,5
TRBV18,TRBJ1-1,CASSPYTGTGGTEAFF,0,5,1,5
TRBV18,TRBJ2-3,CASSPPKGSGTDTQYF,0,5,1,5
TRBV7-9,TRBJ2-3,CASRQTGTGRADTQHF,0,5,1,5
TRBV7-2,TRBJ2-3,CASTSRGGGPTDTQYF,0,5,1,5
TRBV28,TRBJ2-1,CASTVPGTSAYNEQFF,0,5,1,5
TRBV12-3/4,TRBJ2-3,CASSFSSPTGSDTQYF,0,5,1,5
TRBV6-2/3/5/6,TRBJ2-7,CASSLYGTGGSYEQYF,0,5,1,5
TRBV12-3/4,TRBJ1-5,CASSLKGGISNQPQHF,0,5,1,5
TRBV28,TRBJ2-4,CASSSPFGQGFDIQYF,0,5,1,5
TRBV28,TRBJ2-1,CASSSSYPTFYNEQFF,0,5,1,5
TRBV6-2/3/5/6,TRBJ2-3,CASSSIEGRGPDTQYF,0,5,1,5
TRBV25-1,TRBJ2-7,CASSWAGSKGGYEQYF,0,5,1,5
TRBV6-2/3/5/6,TRBJ2-7,CASSYSVTGGYYEQYF,0,5,1,5
TRBV3-1,TRBJ2-2,CASSPTLAVNTGELFF,0,5,1,5
TRBV12-3/4,TRBJ1-5,CASSPRSLGGNQPQHF,0,5,1,5
TRBV12-3/4,TRBJ2-2,CASSATSGRAHGELFF,0,5,1,5
TRBV10-2,TRBJ2-1,CASSDPWREGYNEQFF,0,10,1,10
TRBV6-4,TRBJ2-1,CASSDGVAGGRDEQFF,0,5,1,5
TRBV10-2,TRBJ2-1,CASSESGTSGKDEQFF,0,8,1,8
TRBV2,TRBJ2-5,CASSEPQGLHQETQYF,0,5,1,5
TRBV5-6,TRBJ2-1,CASSLGLAVMVNEQFF,0,5,1,5
TRBV11-2,TRBJ1-1,CASSLAPRGQNTEAFF,0,5,1,5
TRBV11-2,TRBJ2-3,CASSLALAGGSDTQYF,0,5,1,5
TRBV7-2,TRBJ1-5,CASSLEAGLPDQPQHF,0,5,1,5
TRBV11-2,TRBJ2-3,CASSLTSGVGTDTQYF,0,5,1,5
TRBV7-3,TRBJ2-1,CASSLSLGGTANEQFF,0,5,1,5
TRBV7-8,TRBJ2-5,CASSSGTATGLETQYF,0,5,1,5
TRBV5-6,TRBJ1-1,CASSSAGTVANTEAFF,0,5,1,5
TRBV5-8,TRBJ2-3,CASSPLTFVGTDTQYF,0,5,1,5
TRBV27,TRBJ1-5,CASSPKLTGAEVPQHF,0,5,1,5
TRBV7-7,TRBJ2-1,CASSPGAGRAYNEQFF,0,5,1,5
TRBV11-2,TRBJ2-2,CASSRDSGRFTGELFF,0,5,1,5
TRBV11-2,TRBJ2-1,CASSRGQGTAINEQFF,0,5,1,5
TRBV3-1,TRBJ2-5,CASSQGQGTAGETQYF,0,5,1,5
TRBV3-1,TRBJ2-6,CASSQDSSSGANVLTF,0,5,1,5
TRBV5-5,TRBJ2-7,CASSQNLRDFSYEQYF,0,5,1,5
TRBV7-3,TRBJ2-2,CASSAIPGENTGELFF,0,5,1,5
TRBV6-2/3/5/6,TRBJ2-1,CASSNTQLGGGNEQFF,0,5,1,5
TRBV5-5,TRBJ2-1,CASRRTRLGGGNEQFF,0,5,1,5
TRBV6-2/3/5/6,TRBJ2-2,CASRQGGGRVTGELFF,0,5,1,5
TRBV20-1,TRBJ2-6,CSAPKGGNSGANVLTF,0,5,1,5
TRBV5-1,TRBJ2-1,CASSLWAGETYNEQFF,0,5,1,5
TRBV5-1,TRBJ2-1,CASSLLAGQGNNEQFF,0,5,1,5
TRBV5-1,TRBJ2-1,CASSLLAGEGYNEQFF,0,5,1,5
TRBV5-1,TRBJ2-7,CASSLGGTASSYEQYF,0,5,1,5
TRBV5-1,TRBJ2-1,CASSLDSGSRANEQFF,0,5,1,5
TRBV10-2,TRBJ2-1,CASSLTQGLAGGEQFI,0,5,1,5
TRBV4-1,TRBJ2-7,CASSQGLDRIPYEQYF,0,5,1,5
TRBV4-1,TRBJ2-3,CASSQGLAGRVDTQYF,0,5,1,5
TRBV20-1,TRBJ2-1,CSAPSLLAETYNEQFF,0,5,1,5
TRBV20-1,TRBJ2-5,CSASGAEGSISETQYF,0,5,1,5
TRBV20-1,TRBJ2-7,CSARGGGLADSYEQYF,0,5,1,5
TRBV20-1,TRBJ2-5,CSARDRTHERQETQYF,0,5,1,5
TRBV20-1,TRBJ2-3,CSARDALAASTDTQYF,0,5,1,5
TRBV20-1,TRBJ2-1,CSAPPAGQLSYNEQFF,0,5,1,5
TRBV20-1,TRBJ2-3,CSAGPPGQGSADTQYF,0,5,1,5
TRBV29-1,TRBJ1-3,CSVQGIEDFPGNTIYF,0,5,1,5
TRBV29-1,TRBJ2-6,CSVEGTGDSGANVLTF,0,5,1,5
TRBV29-1,TRBJ2-3,CSVEDESLGGTDTQYF,0,5,1,5
TRBV29-1,TRBJ2-3,CSVETPRGLNTDTQYF,0,5,1,5
TRBV29-1,TRBJ1-5,CSVSGTGGNSNQPQHF,0,5,1,5
TRBV29-1,TRBJ2-3,CSARGLAGGWTDTQYF,0,5,1,5
TRBV29-1,TRBJ2-1,CSGDGQGVGSYNEQFF,0,5,1,5
TRBV18,TRBJ2-1,CVSSPQREWGNEQFF,0,5,1,5
TRBV12-5,TRBJ1-2,CASGLVRLGNYGYTF,0,5,1,5
TRBV30,TRBJ2-5,CAWSARDSPDETQYF,0,5,1,5
TRBV10-3,TRBJ1-6,CAISDMGQDNSPLHF,0,5,1,5
TRBV2,TRBJ2-7,CASRALLILAYEQYF,0,5,1,5
TRBV19,TRBJ1-3,CASSSAANTGNTIYF,0,5,1,5
TRBV19,TRBJ1-5,CASSQDPRANQPQHF,0,5,1,5
TRBV19,TRBJ1-5,CASSISRGRNQPQHF,0,5,1,5
TRBV19,TRBJ2-1,CASSITLAEGNEQFF,0,5,1,5
TRBV19,TRBJ2-7,CASSRAGRFSYEQYF,0,5,1,5
TRBV19,TRBJ1-6,CASSPRGQVYSPLHF,0,5,1,5
TRBV19,TRBJ1-1,CASKTGTGLLPEAFF,0,5,1,5
TRBV6-2/3/5/6,TRBJ1-3,CASFGVGGSGNTIYF,0,5,1,5
TRBV2,TRBJ2-4,CASFKEGRSKNIQYF,0,5,1,5
TRBV18,TRBJ2-7,CASSASYRENYEQYF,0,5,1,5
TRBV7-9,TRBJ2-6,CASSVQGAGANVLTF,0,5,1,5
TRBV12-3/4,TRBJ2-1,CASQHRRLSRNEQFF,0,5,1,5
TRBV12-3/4,TRBJ1-3,CASILGGLTGNTIYF,0,5,1,5
TRBV7-9,TRBJ2-1,CASTPRLVSYNEQFF,0,5,1,5
TRBV7-2,TRBJ2-3,CASTPGLLGGSTQYF,0,5,1,5
TRBV9,TRBJ2-5,CASTMAGGGQETQYF,0,5,1,5
TRBV2,TRBJ2-1,CASTRLAGGGNEQFF,0,5,1,5
TRBV28,TRBJ2-3,CASSFGGRTADTQYF,0,5,1,5
TRBV6-2/3/5/6,TRBJ1-2,CASSFGTGMYYGYTF,0,5,1,5
TRBV7-2,TRBJ2-3,CASSFSGASTDTQYF,0,5,1,5
TRBV12-3/4,TRBJ2-3,CASSSRESSTDTQYF,0,5,1,5
TRBV12-3/4,TRBJ1-2,CASSSPGVANYGYTF,0,5,1,5
TRBV2,TRBJ2-1,CASSLSGSRRNEQFF,0,5,1,5
TRBV12-3/4,TRBJ2-7,CASSPPGTGPAEQYF,0,5,1,5
TRBV2,TRBJ2-3,CASSVRGSSTDTQYF,0,5,1,5
TRBV6-4,TRBJ2-1,CASSGLTSSYNEQFF,0,5,1,5
TRBV6-2/3/5/6,TRBJ2-7,CASSTLRDGAYEQYF,0,5,1,5
TRBV11-3,TRBJ2-1,CASSFSGTRYNEQCF,0,5,1,5
TRBV5-5,TRBJ2-5,CASSFSASPQETQYF,0,5,1,5
TRBV11-2,TRBJ2-1,CASSFGGSSYNEQFF,0,10,1,10
TRBV5-4,TRBJ2-2,CASSFPGQRSRELFF,0,5,1,5
TRBV7-2,TRBJ2-4,CASSFGGSTKNIQYF,0,5,1,5
TRBV11-2,TRBJ2-3,CASSFSGPRTDTQYF,0,5,1,5
TRBV5-4,TRBJ2-5,CASSLWLRGQETQYF,0,5,1,5
TRBV5-4,TRBJ2-3,CASSLPSGVSDTQYF,0,5,1,5
TRBV5-4,TRBJ2-1,CASSLVEASYNEQFF,0,5,1,5
TRBV5-4,TRBJ2-5,CASSLAGERGETQYF,0,5,1,5
TRBV7-9,TRBJ2-2,CASSLAGVGTGELFF,0,5,1,5
TRBV5-6,TRBJ2-3,CASSLSGRLSDTQYF,0,5,1,5
TRBV5-4,TRBJ2-3,CASSLRQGGTDTQYF,0,5,1,5
TRBV7-2,TRBJ2-7,CASSLHRDRTYEQYF,0,5,1,5
TRBV7-9,TRBJ2-7,CASSLASAGEYEQYF,0,5,1,5
TRBV7-2,TRBJ2-1,CASSLARILINEQFF,0,5,1,5
TRBV7-9,TRBJ2-1,CASSLASTALDEQFF,0,5,1,5
TRBV7-2,TRBJ2-1,CASSLGDRRTHEQFF,0,5,1,5
TRBV7-8,TRBJ2-3,CASSLDIRGPDTQYF,0,5,1,5
TRBV7-2,TRBJ2-1,CASSLSGVGYNEQFF,0,5,1,5
TRBV7-9,TRBJ2-1,CASSLRTSGYNEQFF,0,5,1,5
TRBV11-3,TRBJ2-3,CASSLNRGAAHTQYF,0,5,1,5
TRBV7-9,TRBJ2-1,CASSSAGTPTNEQFF,0,5,1,5
TRBV5-4,TRBJ2-7,CASSSTLGTGVEQYF,0,5,1,5
TRBV7-6,TRBJ1-3,CASSSYRGMRDTIYF,0,5,1,5
TRBV9,TRBJ2-5,CASSSQDRGLGTQCF,0,5,1,5
TRBV13,TRBJ2-1,CASSSAGGPVNEQFF,0,5,1,5
TRBV7-2,TRBJ2-5,CASSYTGLAGGNQYF,0,5,1,5
TRBV7-9,TRBJ2-5,CASSYGSGTQETQYF,0,5,1,5
TRBV5-6,TRBJ2-7,CASSLGLAGRYEQYF,0,5,1,5
TRBV6-2/3/5/6,TRBJ2-7,CASSPRKVLAYEQYF,0,5,1,5
TRBV7-9,TRBJ1-3,CASSPQGISGNTIYF,0,5,1,5
TRBV6-2/3/5/6,TRBJ1-5,CASSPGQGGNQPQHF,0,5,1,5
TRBV7-9,TRBJ2-3,CASSPDPDYTDTQYF,0,5,1,5
TRBV7-9,TRBJ1-2,CASSPFDRPNYGYTF,0,5,1,5
TRBV7-2,TRBJ2-7,CASSRSGTSSYEQYF,0,5,1,5
TRBV5-8,TRBJ2-3,CASSRGTAGTDTQYF,0,5,1,5
TRBV19,TRBJ2-7,CASSRDRGLWNEQYF,0,5,1,5
TRBV28,TRBJ2-7,CASSRAGVTSYEQYF,0,5,1,5
TRBV3-1,TRBJ1-3,CASSHRDNSANTIYF,0,5,1,5
TRBV3-1,TRBJ2-5,CASSQGLAGQETQYF,0,5,1,5
TRBV3-1,TRBJ2-1,CASSQVLSIPGGQFF,0,5,1,5
TRBV3-1,TRBJ2-7,CASSQDFGQGAEQYF,0,5,1,5
TRBV5-6,TRBJ2-3,CASSQTSEGGYTQYF,0,5,1,5
TRBV7-9,TRBJ2-5,CASSVRDRYQETQYF,0,5,1,5
TRBV5-4,TRBJ2-3,CASSVEGGRPDTQYF,0,5,1,5
TRBV9,TRBJ2-5,CASSVRTSGQETQYF,0,5,1,5
TRBV9,TRBJ2-7,CASSVGIGQTYEQYF,0,5,1,5
TRBV14,TRBJ2-3,CASSASGLATDTQYF,0,5,1,5
TRBV7-2,TRBJ2-6,CASSGALSGANVLTF,0,5,1,5
TRBV7-9,TRBJ2-2,CASSDPTGGPGELFF,0,5,1,5
TRBV2,TRBJ2-3,CASSDPGGAADTQYF,0,5,1,5
TRBV6-1,TRBJ1-5,CASSDRGYSNQPQHF,0,5,1,5
TRBV5-5,TRBJ2-1,CASSETGGSYNEQFF,0,5,1,5
TRBV6-4,TRBJ2-6,CASRRQGVGANVLTF,0,5,1,5
TRBV6-2/3/5/6,TRBJ1-5,CTSSQGTTSNQPQHF,0,5,1,5
TRBV10-1,TRBJ1-2,CASPEVPGTVYGYTF,0,5,1,5
TRBV5-1,TRBJ1-4,CASSWEGTGREKLFF,0,5,1,5
TRBV10-1,TRBJ2-3,CASSASGGGTDTQYF,0,5,1,5
TRBV5-1,TRBJ2-1,CASSLLTTPNNEQFF,0,5,1,5
TRBV5-1,TRBJ1-1,CASSLPTGDNTEAFF,0,5,1,5
TRBV5-1,TRBJ2-7,CASSLRSSGIYEQYF,0,5,1,5
TRBV5-1,TRBJ2-7,CASSLAGTNAYEQYF,0,5,1,5
TRBV5-1,TRBJ2-2,CASSYSLGNTGELFF,0,5,1,5
TRBV5-1,TRBJ2-5,CASSPGQSLKETQYF,0,5,1,5
TRBV5-1,TRBJ2-1,CASSQGQGNYNEQFF,0,5,1,5
TRBV5-1,TRBJ2-1,CASSVLAGGNNEQFF,0,5,1,5
TRBV5-1,TRBJ2-1,CASSAASGRAHEQFF,0,5,1,5
TRBV10-2,TRBJ2-3,CASRGHSGRTDTQYF,0,5,1,5
TRBV5-1,TRBJ2-2,CARSLDTGQTGELFF,0,5,1,5
TRBV20-1,TRBJ2-3,CSASPAGRDTDTQYF,0,5,1,5
TRBV20-1,TRBJ1-1,CSARVGRTLYTEAFF,0,5,1,5
TRBV20-1,TRBJ2-1,CSARGGTSGRNEQFF,0,5,1,5
TRBV20-1,TRBJ2-3,CSARGGGSLADTQYF,0,5,1,5
TRBV20-1,TRBJ2-1,CSARDPARGYNEQFF,0,5,1,5
TRBV20-1,TRBJ2-1,CSARDRLGGLNEQFF,0,5,1,5
TRBV20-1,TRBJ2-5,CSARDGRAYQETQYF,0,5,1,5
TRBV20-1,TRBJ1-5,CSAREIGNSNQPQHF,0,5,1,5
TRBV20-1,TRBJ1-1,CSASDRTALNTEAFF,0,5,1,5
TRBV20-1,TRBJ2-1,CSATRAGEWYNEQFF,0,5,1,5
TRBV29-1,TRBJ1-5,CSVSQGLLGNQPQHF,0,5,1,5
TRBV29-1,TRBJ2-1,CSVPPTGADYNEQFF,0,5,1,5
TRBV29-1,TRBJ2-3,CSVVPRRGATDTQYF,0,5,1,5
TRBV29-1,TRBJ2-3,CSVVRQGNPTDTQYF,0,5,1,5
TRBV29-1,TRBJ2-7,CSVEDQRVTFGEQYF,0,5,1,5
TRBV29-1,TRBJ2-3,CSVEDIAGVTDTQYF,0,5,1,5
TRBV29-1,TRBJ2-1,CSVERRGRSYNEQFF,0,5,1,5
TRBV19,TRBJ2-1,RASRTGLAGNNEQFF,0,5,1,5
TRBV12-5,TRBJ2-5,CASGLPGGRETQYF,0,5,1,5
TRBV12-5,TRBJ2-1,CASGLGGLGNEQFF,0,5,1,5
TRBV30,TRBJ1-6,CAWTPDRGSSPLHF,0,5,1,5
TRBV30,TRBJ2-3,CAWSATTSTDTQYF,0,5,1,5
TRBV30,TRBJ2-2,CAWSRDAITGELFF,0,5,1,5
TRBV10-3,TRBJ2-1,CAISGTSGNAEQFF,0,5,1,5
TRBV24-1,TRBJ2-7,CATSDLGTAGEQYF,0,5,1,5
TRBV24-1,TRBJ2-1,CATSDSLAGDVQFF,0,5,1,5
TRBV19,TRBJ2-1,CASSSGGSHNEQFF,0,5,1,5
TRBV4-2,TRBJ2-2,CASVSKVGTGELFF,0,5,1,5
TRBV19,TRBJ2-1,CASSSRDRAGEQFF,0,5,1,5
TRBV28,TRBJ2-3,CASSRGLAADTQYF,0,5,1,5
TRBV18,TRBJ2-3,CASSFPQGTDTQYF,0,5,1,5
TRBV18,TRBJ2-7,CASSPPSGANEQYF,0,5,1,5
TRBV18,TRBJ2-1,CASSPGNSHNEQFF,0,5,1,5
TRBV18,TRBJ2-5,CASSPNPGKETQYF,0,5,1,5
TRBV5-4,TRBJ2-3,CASRRTSVGNTQYF,0,5,1,5
TRBV7-2,TRBJ2-2,CASATGQNTGELFF,0,5,1,5
TRBV5-4,TRBJ2-2,CASGVNLGTGELFF,0,5,1,5
TRBV13,TRBJ2-7,CASTKGRGPYEQYF,0,5,1,5
TRBV6-2/3/5/6,TRBJ1-2,CASTALRAGYGYTF,0,5,1,5
TRBV28,TRBJ2-7,CASTELQGAREQYF,0,5,1,5
TRBV6-2/3/5/6,TRBJ1-5,CASTTGYGNQPQHF,0,5,1,5
TRBV2,TRBJ2-6,CASTGGKGANVLTF,0,5,1,5
TRBV27,TRBJ2-7,CASSFDRGTYEQYF,0,5,1,5
TRBV12-3/4,TRBJ2-7,CASSFWQGEDEQYF,0,5,1,5
TRBV6-2/3/5/6,TRBJ2-1,CASSFGTSGRRQFF,0,5,1,5
TRBV28,TRBJ2-7,CASSFGTRSYEQYF,0,5,1,5
TRBV6-2/3/5/6,TRBJ2-4,CASSFSGSKNIQYF,0,5,1,5
TRBV12-3/4,TRBJ2-1,CASSLDPEDDEQFF,0,5,1,5
TRBV6-2/3/5/6,TRBJ1-1,CASSLAGTGIGAFF,0,5,1,5
TRBV28,TRBJ2-7,CASSLGGQSYEQYF,0,5,1,5
TRBV6-2/3/5/6,TRBJ2-7,CASSLTPGLYEQYF,0,5,1,5
TRBV6-2/3/5/6,TRBJ1-1,CASSSSWTDTEAFF,0,5,1,5
TRBV12-3/4,TRBJ2-2,CASSSQGATGELFF,0,5,1,5
TRBV28,TRBJ2-5,CASSSPDRQETQYF,0,5,1,5
TRBV6-2/3/5/6,TRBJ2-7,CASSSGQSSYEQYL,0,5,1,5
TRBV6-2/3/5/6,TRBJ2-3,CASSYTHRADTQYF,0,5,1,5
TRBV12-3/4,TRBJ2-3,CASSPYGGSDTQYF,0,5,1,5
TRBV6-2/3/5/6,TRBJ2-6,CASSVLSGANVLTF,0,5,1,5
TRBV2,TRBJ2-7,CASSASRTHYEQYF,0,5,1,5
TRBV12-3/4,TRBJ2-7,CASSALAGGYEQYF,0,5,1,5
TRBV6-1,TRBJ2-1,CASSASGRYNEQFF,0,5,1,5
TRBV2,TRBJ1-2,CASSGALQGQGYTF,0,5,1,5
TRBV2,TRBJ1-5,CASSDLHYGQPQHF,0,5,1,5
TRBV6-4,TRBJ1-5,CASSDSSTNQPQHF,0,5,1,5
TRBV2,TRBJ1-2,CASSDWTDIDGYTF,0,5,1,5
TRBV6-1,TRBJ2-6,CASSESSGANVLTF,0,5,1,5
TRBV7-8,TRBJ2-1,CASSFGGASQNQFF,0,5,1,5
TRBV7-9,TRBJ2-5,CASSFRQGQETQYF,0,5,1,5
TRBV5-6,TRBJ2-7,CASSLLSGRGEQYF,0,5,1,5
TRBV5-4,TRBJ2-3,CASSLAGGTDTQYF,0,9,1,9
TRBV6-2/3/5/6,TRBJ2-5,CASSLGLSQETQYF,0,5,1,5
TRBV7-9,TRBJ2-3,CASSLTISTDTQYF,0,5,1,5
TRBV7-3,TRBJ2-2,CASSLSSNTGELFF,0,5,1,5
TRBV7-2,TRBJ2-3,CASSLAYGTDTQYF,0,5,1,5
TRBV7-9,TRBJ2-7,CASSYSTGVHEQYF,0,5,1,5
TRBV3-1,TRBJ1-1,CASSLRQGGTEAFF,0,5,1,5
TRBV4-2,TRBJ2-3,CASSLIRGPDTQYF,0,5,1,5
TRBV7-9,TRBJ2-4,CASSPEGQGNIQYF,0,5,1,5
TRBV3-1,TRBJ2-7,CASSPGLVQYEQYF,0,5,1,5
TRBV7-9,TRBJ1-1,CASSPGQGEVEAFF,0,5,1,5
TRBV3-1,TRBJ2-5,CASSPDRVQETQYF,0,5,1,5
TRBV11-3,TRBJ1-1,CASSHRGRDTEAFF,0,5,1,5
TRBV7-9,TRBJ2-7,CASSHDRGPTEQYF,0,5,1,5
TRBV3-1,TRBJ2-5,CASSQRDREETQYF,0,5,1,5
TRBV14,TRBJ2-7,CASSQVGGRREQYF,0,5,1,5
TRBV3-1,TRBJ2-7,CASSQEERGGEQYF,0,5,1,5
TRBV7-9,TRBJ1-1,CASSVGQTNTEAFF,0,5,1,5
TRBV9,TRBJ2-1,CASSVAGPRGEQFF,0,5,1,5
TRBV9,TRBJ2-3,CASSVTPSIDTQYF,0,5,1,5
TRBV3-1,TRBJ2-1,CASSIREGYNEQFF,0,5,1,5
TRBV7-2,TRBJ1-1,CASSTITRNTEAFF,0,5,1,5
TRBV9,TRBJ2-6,CASSRQGKANVLTF,0,5,1,5
TRBV11-2,TRBJ2-5,CASRRGALGETQYF,0,5,1,5
TRBV6-2/3/5/6,TRBJ2-1,CASRGRDSFNEQFF,0,5,1,5
TRBV12-3/4,TRBJ1-5,CASRSQYSNQPQHF,0,5,1,5
TRBV12-3/4,TRBJ1-2,CASRCGQGPYGYTF,0,5,1,5
TRBV5-1,TRBJ2-1,CASGQDSLYNEQFF,0,5,1,5
TRBV10-2,TRBJ2-1,CASTESPSYNEQFF,0,5,1,5
TRBV5-1,TRBJ2-2,CASSFSVGTGELFF,0,5,1,5
TRBV5-1,TRBJ2-3,CASSFEGFTDTQYF,0,5,1,5
TRBV5-1,TRBJ2-1,CASSLWGMNNEQFF,0,5,1,5
TRBV5-1,TRBJ2-5,CASSLPLAGETQYF,0,5,1,5
TRBV5-1,TRBJ2-1,CASSLRGSYNEQFF,0,5,1,5
TRBV5-1,TRBJ2-7,CASSLALLSREQYF,0,5,1,5
TRBV5-1,TRBJ1-1,CASSLAGGFPEAFF,0,5,1,5
TRBV5-1,TRBJ2-7,CASSLAMGANEQYF,0,5,1,5
TRBV5-1,TRBJ2-1,CASSLGGTQNEQFF,0,5,1,5
TRBV5-1,TRBJ2-5,CASSLGGPVETQYF,0,5,1,5
TRBV5-1,TRBJ2-3,CASSLGREGDTQYF,0,5,1,5
TRBV5-1,TRBJ1-5,CASSLDPLNQPQHF,0,5,1,5
TRBV5-1,TRBJ2-3,CASSPGLAGDTQYF,0,5,1,5
TRBV4-1,TRBJ1-2,CASSQEPGGTGYTF,0,5,1,5
TRBV5-1,TRBJ2-3,CASSETPLGDTQYF,0,5,1,5
TRBV5-1,TRBJ2-7,CASNRQGLAYEQYF,0,5,1,5
TRBV20-1,TRBJ2-4,CSVGNLLAKNIQYF,0,5,1,5
TRBV20-1,TRBJ2-7,CSVASGTSTYEQYF,0,5,1,5
TRBV20-1,TRBJ2-7,CSALPGLASDEQYF,0,5,1,5
TRBV20-1,TRBJ1-2,CSARTGTGGYGYTF,0,5,1,5
TRBV20-1,TRBJ2-1,CSAGFSGRYNEQFF,0,5,1,5
TRBV20-1,TRBJ2-3,CSAMYRRHTDTQYF,0,5,1,5
TRBV20-1,TRBJ2-7,CSASSGGARDEQYF,0,5,1,5
TRBV20-1,TRBJ1-5,CSASPDGNNQPQHF,0,5,1,5
TRBV20-1,TRBJ2-1,CSASRTGTNNEQFF,0,5,1,5
TRBV20-1,TRBJ2-5,CSARLQGRQETQYF,0,5,1,5
TRBV20-1,TRBJ2-3,CSARLGGRTDTQYF,0,5,1,5
TRBV20-1,TRBJ2-2,CSARDSGSPGELFF,0,5,1,5
TRBV20-1,TRBJ2-5,CSARDGGGGETQYF,0,5,1,5
TRBV20-1,TRBJ1-4,CSAREGTGNEKLFF,0,5,1,5
TRBV20-1,TRBJ2-5,CSAQRQGGQETQYF,0,5,1,5
TRBV20-1,TRBJ2-3,CSAPPGLGTDTQYF,0,5,1,5
TRBV29-1,TRBJ2-2,CSVVRTPNTGELFF,0,5,1,5
TRBV29-1,TRBJ2-1,CSVDDSGNLNEQFF,0,5,1,5
TRBV29-1,TRBJ2-7,CSVMDERGSYEQYF,0,5,1,5
TRBV29-1,TRBJ2-7,CSVPGPTTDYEQYF,0,5,1,5
TRBV29-1,TRBJ1-4,CSAQGGGYNEKLFF,0,5,1,5
TRBV29-1,TRBJ2-3,CSGHLAGYTDTQYF,0,5,1,5
TRBV7-2,TRBJ2-4,SASSSGTSANIQYF,0,5,1,5
TRBV11-2,TRBJ1-1,CATASERFTEAFF,0,5,1,5
TRBV12-5,TRBJ1-2,CASGLPPGDGYTF,0,5,1,5
TRBV30,TRBJ2-7,CAWMPGTSYEQYF,0,5,1,5
TRBV12-3/4,TRBJ2-1,CAGSLTSCNEQFF,0,5,1,5
TRBV10-3,TRBJ2-3,CAISESTGDTQYF,0,5,1,5
TRBV10-3,TRBJ2-7,CAISESDRYEQYF,0,5,1,5
TRBV15,TRBJ2-3,CATLLAGADTQYF,0,5,1,5
TRBV24-1,TRBJ2-3,CATSDGPSATQYF,0,5,1,5
TRBV24-1,TRBJ2-4,CATSEPDRGIQYF,0,5,1,5
TRBV19,TRBJ1-5,CASRDRGHQPQHF,0,5,1,5
TRBV19,TRBJ2-3,CASTPTATATQYF,0,5,1,5
TRBV19,TRBJ2-2,CASSFVLTGELFF,0,5,1,5
TRBV19,TRBJ2-1,CASSIGASNEQFF,0,5,1,5
TRBV19,TRBJ2-1,CASRAGRNNEQFF,0,5,1,5
TRBV18,TRBJ2-5,CASSFGDRETQYF,0,5,1,5
TRBV28,TRBJ2-3,CASSVGEVNTQYF,0,5,1,5
TRBV18,TRBJ1-1,CASSQDRGTEAFF,0,5,1,5
TRBV28,TRBJ2-7,CASQVKAFYEQYF,0,5,1,5
TRBV11-2,TRBJ1-3,CASGQAGRNTIYF,0,5,1,5
TRBV3-1,TRBJ2-5,CASDDQGGETQYF,0,5,1,5
TRBV2,TRBJ2-7,CASIMTHSSEQYF,0,5,1,5
TRBV6-2/3/5/6,TRBJ2-1,CASTPRGYNEQFF,0,5,1,5
TRBV12-3/4,TRBJ2-5,CASSFHLGETQYF,0,5,1,5
TRBV12-3/4,TRBJ1-5,CASSLGGRRSPHF,0,5,1,5
TRBV28,TRBJ1-2,CASSLEGIRGYTF,0,5,1,5
TRBV28,TRBJ2-5,CASSLKGGKTQYF,0,5,1,5
TRBV5-4,TRBJ2-7,CASSSGPSRKQYF,0,5,1,5
TRBV28,TRBJ2-7,CASSSKYSYEQYF,0,5,1,5
TRBV6-2/3/5/6,TRBJ1-5,CASSYSRNQPQHF,0,5,1,5
TRBV6-2/3/5/6,TRBJ1-4,CASSYSFQEKLFF,0,5,1,5
TRBV6-2/3/5/6,TRBJ1-3,CASSYGPRNTIYF,0,5,1,5
TRBV12-3/4,TRBJ1-5,CASSLELDQPQHF,0,5,1,5
TRBV6-1,TRBJ2-1,CASSGSGINEQFF,0,5,1,5
TRBV6-1,TRBJ2-2,CASSEANTGELFF,0,5,1,5
TRBV7-8,TRBJ2-7,CASSFYREGEQYF,0,5,1,5
TRBV3-1,TRBJ2-1,CASSFDRDNEQFF,0,5,1,5
TRBV5-6,TRBJ2-7,CASSLAGGYEQYF,0,5,1,5
TRBV7-3,TRBJ2-3,CASSLGVGDTQYF,0,5,1,5
TRBV7-2,TRBJ2-4,CASSLFENHIQYF,0,5,1,5
TRBV7-2,TRBJ2-1,CASSLSVINEQFF,0,5,1,5
TRBV7-9,TRBJ2-7,CASSLVGGNEQYF,0,5,1,5
TRBV7-9,TRBJ2-4,CASSLGDGGIQYF,0,5,1,5
TRBV5-4,TRBJ2-7,CASSLDLVYEQYF,0,5,1,5
TRBV7-3,TRBJ2-5,CASSLIGAETQYF,0,5,1,5
TRBV7-3,TRBJ2-7,CASSSGTVEKQYF,0,5,1,5
TRBV11-1,TRBJ2-3,CASSSGQGYTQYF,0,5,1,5
TRBV7-9,TRBJ2-7,CASSSGLDYEQYF,0,5,1,5
TRBV7-9,TRBJ2-7,CASSWLSAYEQYF,0,5,1,5
TRBV5-5,TRBJ2-1,CASSLTGLNEQFF,0,5,1,5
TRBV14,TRBJ1-2,CASSPLRGEGYTF,0,5,1,5
TRBV14,TRBJ1-2,CASSPRTGDGYTF,0,5,1,5
TRBV5-6,TRBJ2-3,CASSPAGEDTQYF,0,5,1,5
TRBV7-3,TRBJ2-5,CASSRGQGETQYF,0,7,1,7
TRBV3-1,TRBJ2-7,CASSRSPGYEQYF,0,5,1,5
TRBV4-2,TRBJ1-1,CASSRRIVSEAFF,0,5,1,5
TRBV3-1,TRBJ2-5,CASSQGLQETQYF,0,5,1,5
TRBV3-1,TRBJ2-1,CASSQGAGGRQFF,0,5,1,5
TRBV3-1,TRBJ1-6,CASSQDRDSPLHF,0,5,1,5
TRBV3-1,TRBJ2-6,CASSQEKDESLTF,0,5,1,5
TRBV7-2,TRBJ2-3,CASSASTSDTQYF,0,5,1,5
TRBV2,TRBJ1-1,CASSDGGNTEAFF,0,5,1,5
TRBV5-6,TRBJ2-3,CASRSRTSDTQYF,0,5,1,5
TRBV6-4,TRBJ2-1,CASRTSTYNEQFF,0,5,1,5
TRBV6-2/3/5/6,TRBJ1-4,CASRRQGGEKLFF,0,5,1,5
TRBV2,TRBJ2-5,CASNRQGRETQYF,0,5,1,5
TRBV19,TRBJ2-2,CASTPTGTGELFF,0,5,1,5
TRBV5-1,TRBJ2-4,CASSYGAKNIQYF,0,5,1,5
TRBV6-2/3/5/6,TRBJ2-7,CASSYEEDYEQYF,0,5,1,5
TRBV10-1,TRBJ1-2,CASSESSTYGYTF,0,5,1,5
TRBV5-1,TRBJ2-7,CASSLGQLYEQYF,0,5,1,5
TRBV5-1,TRBJ2-5,CASSSPPEETQYF,0,5,1,5
TRBV5-1,TRBJ2-5,CASSSSTQETQYF,0,5,1,5
TRBV4-1,TRBJ2-1,CASSQERSNEQFF,0,5,1,5
TRBV5-1,TRBJ2-1,CASSEDGPIGQFF,0,5,1,5
TRBV5-1,TRBJ2-3,CASSTFDTDTQYF,0,5,1,5
TRBV20-1,TRBJ1-1,CSAIDMRNTEAFF,0,5,1,5
TRBV20-1,TRBJ1-1,CSARVPASTEAFF,0,5,1,5
TRBV20-1,TRBJ1-5,CSARVRGSQPQHF,0,5,1,5
TRBV20-1,TRBJ1-5,CSARDLESQPQHF,0,5,1,5
TRBV20-1,TRBJ2-5,CSAALAGQETQYF,0,5,1,5
TRBV20-1,TRBJ2-4,CSAKHGQRVGGYF,0,5,1,5
TRBV29-1,TRBJ2-3,CSVLLAGLDTQYF,0,5,1,5
TRBV29-1,TRBJ1-1,CSVSFRDGSGAFF,0,5,1,5
TRBV29-1,TRBJ2-7,CSVPGQGAGEQYF,0,5,1,5
TRBV29-1,TRBJ2-3,CSVQGAEGDTQYF,0,5,1,5
TRBV29-1,TRBJ1-1,CSVAVRGVPEAFF,0,5,1,5
TRBV29-1,TRBJ2-3,CSVGQRWTDTQYF,0,5,1,5
TRBV29-1,TRBJ2-2,CSVGGTATGELFF,0,5,1,5
TRBV29-1,TRBJ2-7,CSVEGTGEPEQYF,0,5,1,5
TRBV29-1,TRBJ2-7,CSVLTGGRYEQYF,0,5,1,5
TRBV29-1,TRBJ2-3,CSAQGSSTDTQYF,0,5,1,5
TRBV29-1,TRBJ2-1,CSASGNSYNEQFF,0,5,1,5
TRBV29-1,TRBJ2-1,CSAAGTMYNEQFF,0,5,1,5
TRBV29-1,TRBJ2-5,CSAGGEGWETQYF,0,5,1,5
TRBV10-3,TRBJ2-3,CAIRAGADTQYF,0,5,1,5
TRBV10-3,TRBJ1-1,CAINQGRGEAFF,0,5,1,5
TRBV10-3,TRBJ2-1,CATSSRGNEQFF,0,5,1,5
TRBV10-3,TRBJ2-7,CATHRGGYEQYF,0,5,1,5
TRBV24-1,TRBJ2-3,CATSKSPDTQYF,0,5,1,5
TRBV2,TRBJ1-2,CASSAPSDGYTF,0,5,1,5
TRBV19,TRBJ1-5,CASSGGNQPQHF,0,5,1,5
TRBV19,TRBJ2-1,CASSIDQGEQFF,0,5,1,5
TRBV18,TRBJ1-1,CASSGDRTEAFF,0,5,1,5
TRBV12-3/4,TRBJ2-1,CASSFSVDEQFF,0,5,1,5
TRBV12-3/4,TRBJ2-7,CASSFVLGEQYF,0,5,1,5
TRBV12-3/4,TRBJ1-2,CASSFVGGVYTF,0,5,1,5
TRBV28,TRBJ2-5,CASSFGLAGSYF,0,5,1,5
TRBV12-3/4,TRBJ2-7,CASSLAVAEQYF,0,5,1,5
TRBV12-3/4,TRBJ1-6,CASSRDISPLHF,0,5,1,5
TRBV6-1,TRBJ2-7,CASSERKYEQYF,0,5,1,5
TRBV12-3/4,TRBJ1-2,CASSTGLYGYTF,0,5,1,5
TRBV7-9,TRBJ2-1,CASSLVRNEQFF,0,5,1,5
TRBV11-2,TRBJ1-2,CASSLDRVGYTF,0,5,1,5
TRBV6-4,TRBJ2-3,CASSVLADTQYF,0,5,1,5
TRBV7-8,TRBJ2-7,CASSATSYEQYF,0,5,1,5
TRBV2,TRBJ2-1,CASRYIDNEQFF,0,5,1,5
TRBV11-2,TRBJ1-1,CASRAGNTEAFF,0,5,1,5
TRBV2,TRBJ2-5,CASRGDGETQYF,0,5,1,5
TRBV6-4,TRBJ2-4,CASRDGLGIQYF,0,5,1,5
TRBV5-1,TRBJ2-1,CASSLAPGRQFF,0,5,1,5
TRBV5-1,TRBJ2-7,CASSLGGNEQYF,0,5,1,5
TRBV5-1,TRBJ2-7,CASSLPSYEQYF,0,5,1,5
TRBV20-1,TRBJ2-1,CSARQGANEQFF,0,5,1,5
TRBV20-1,TRBJ2-7,CSARVKGYEQYF,0,5,1,5
TRBV29-1,TRBJ2-2,CSSVGSAGELFF,0,5,1,5
TRBV20-1,TRBJ1-1,CSVSELNTEAFF,0,5,1,5
TRBV29-1,TRBJ2-7,CSVGQGAYEQYF,0,5,1,5
TRBV29-1,TRBJ2-7,CSVTIQGQGCLL,0,5,1,5
TRBV29-1,TRBJ1-2,CSVDSYNYGYTF,0,5,1,5
TRBV29-1,TRBJ2-5,CSAREGAETQYF,0,5,1,5
TRBV29-1,TRBJ2-2,CSIERGSGELFF,0,5,1,5
TRBV24-1,TRBJ2-3,CATSQSDTQYF,0,5,1,5
TRBV12-3/4,TRBJ2-7,CASTGRNGQYF,0,5,1,5
TRBV28,TRBJ2-3,CASSLGGLQYF,0,5,1,5
TRBV12-3/4,TRBJ2-1,CASSLSAVVLF,0,5,1,5
TRBV12-3/4,TRBJ2-5,CASSYRETQYF,0,5,1,5
TRBV7-9,TRBJ2-3,CASSLTGELYF,0,5,1,5
TRBV7-9,TRBJ2-1,CASSPGREQFF,0,5,1,5
TRBV7-8,TRBJ2-7,CASSPSYEQYF,0,5,1,5
TRBV9,TRBJ2-1,CASSPRTEQFF,0,5,1,5
TRBV3-1,TRBJ2-7,CASSHSHEQYF,0,5,1,5
TRBV3-1,TRBJ2-7,CASSQSYEQYF,0,5,1,5
TRBV7-9,TRBJ1-1,CASSIQYRLFF,0,5,1,5
TRBV20-1,TRBJ2-3,CSASVTDTQYF,0,5,1,5
TRBV29-1,TRBJ2-6,CSVAPANVLTF,0,5,1,5
TRBV29-1,TRBJ2-3,CSVAAADTQYF,0,5,1,5
TRBV29-1,TRBJ2-4,CSVETGYIQYF,0,5,1,5
TRBV29-1,TRBJ1-1,CSVGENTEAFF,0,5,1,5
TRBV4-1,TRBJ2-2,KNQTNTGELFF,0,5,1,5
TRBV29-1,TRBJ2-1,CSVSYNEQFF,0,5,1,5
TRBV20-1,TRBJ2-1,CSAKRGQFF,0,5,1,5
TRBV28,TRBJ1-1,CARGMAFF,0,5,1,5
TRBV4-1,TRBJ2-6,CASSQEGPRTGFISGANVLTY,0,5,1,5
TRBV2,TRBJ2-3,CASSVMPSNRGQDTQYF,0,5,1,5
TRBV4-1,TRBJ2-1,CASSPARLAVFFGEQFF,0,5,1,5
TRBV5-1,TRBJ2-1,CASSVRTSGSPYNEQFF,0,5,1,5
TRBV5-1,TRBJ2-2,CASSAGPGLAETGEPFF,0,5,1,5
TRBV19,TRBJ2-7,CASGIRGGIGTYEQYF,0,5,1,5
TRBV27,TRBJ2-2,CASSLFLRATTGVLFF,0,5,1,5
TRBV6-2/3/5/6,TRBJ2-7,CASSLSGTGSSYEQYF,0,5,1,5
TRBV5-4,TRBJ2-2,CASSLEDYQGAGELFF,0,5,1,5
TRBV7-9,TRBJ2-1,CASSPRLGQLYNEQFF,0,5,1,5
TRBV4-2,TRBJ2-6,CASSQGARSGANVLTF,0,5,1,5
TRBV12-3/4,TRBJ2-1,CASRGTSGREYNEQFF,0,5,1,5
TRBV18,TRBJ2-2,CASSLLARNTGELFF,0,5,1,5
TRBV7-2,TRBJ2-3,CASSFWAGSTDTQYF,0,5,1,5
TRBV11-2,TRBJ2-5,CASSLALSELETQYF,0,5,1,5
TRBV7-9,TRBJ2-7,CASSLGGTGSYEQYF,0,5,1,5
TRBV7-2,TRBJ2-7,CASSLDGTTSREQYF,0,5,1,5
TRBV20-1,TRBJ2-5,CSARGPNGSGETQYF,0,5,1,5
TRBV3-1,TRBJ2-1,SASSSRDRGENEQFF,0,5,1,5
TRBV7-9,TRBJ2-2,CAPEQLERPGELFF,0,5,1,5
TRBV7-9,TRBJ1-1,CASGRQGPDTEAFF,0,5,1,5
TRBV7-2,TRBJ2-6,CASSLNSGANVLTF,0,5,1,5
TRBV28,TRBJ1-1,CASRGVEGGTEAFF,0,5,1,5
TRBV20-1,TRBJ1-2,CSAREDRSNYGYTF,0,5,1,5
TRBV7-3,TRBJ2-4,CACSTDPGNIQYF,0,5,1,5
TRBV7-9,TRBJ2-7,CASSSGTRSRQYF,0,5,1,5
TRBV7-9,TRBJ2-7,CASRPTGGYEQYF,0,5,1,5
TRBV5-1,TRBJ2-7,CASSFSSPYEQYF,0,5,1,5
TRBV20-1,TRBJ1-1,CSARGRGGTEAFF,0,5,1,5
TRBV29-1,TRBJ2-1,CSVPSISYDEQFF,0,5,1,5
TRBV29-1,TRBJ1-4,CSVLRSTNEKLFF,0,5,1,5
TRBV11-2,TRBJ2-3,CASSSTTDKQYF,0,5,1,5
TRBV2,TRBJ2-7,RASRDSSYEQYF,0,5,1,5
TRBV12-5,TRBJ2-2,CASGLALTCGRVATNTGELFF,0,4,1,4
TRBV27,TRBJ2-2,CASSLARAGIQDVTVPEELFF,0,4,1,4
TRBV12-5,TRBJ2-1,CASGVKAGEPSPKRPSEQFF,0,4,1,4
TRBV6-2/3/5/6,TRBJ2-6,CASSYSPRTSSFSGANVLTF,0,4,1,4
TRBV5-6,TRBJ2-5,CASSRRYAGLAGGGGGTQYF,0,4,1,4
TRBV3-1,TRBJ2-2,CASSQGGLAGDDDDPGELFF,0,4,1,4
TRBV24-1,TRBJ2-6,CATSDFASKSDSGANVLTF,0,4,1,4
TRBV19,TRBJ2-2,CASIPRDYPPYRYTGELFF,0,4,1,4
TRBV19,TRBJ2-2,CASSRSGIRDSQITGELFF,0,4,1,4
TRBV19,TRBJ2-1,CASSIDQYYGQGQNNEQFF,0,4,1,4
TRBV6-2/3/5/6,TRBJ2-3,CASSPLGARARPPTDTQYF,0,4,1,4
TRBV7-2,TRBJ2-1,CASSIAGVLAGGTHNEQFF,0,4,1,4
TRBV5-5,TRBJ2-7,CASSNRGGLTSGISYEQYS,0,4,1,4
TRBV19,TRBJ2-1,CASSHWTSGSMRNNEQFF,0,4,1,4
TRBV2,TRBJ2-6,CASRVPPGQGTGANVLTF,0,4,1,4
TRBV6-4,TRBJ2-1,CASTEGRASGRDYNEQFF,0,4,1,4
TRBV28,TRBJ2-6,CASSLRREKPPGANVLTF,0,4,1,4
TRBV6-2/3/5/6,TRBJ1-1,CASSYFGGAVWMNTEAFF,0,4,1,4
TRBV6-2/3/5/6,TRBJ2-3,CASSYSVGQKYSTDTQYF,0,4,1,4
TRBV6-1,TRBJ1-5,CASSYRDRDYSGNQPQHF,0,4,1,4
TRBV28,TRBJ2-5,CASSLNRLQGRALETQYF,0,4,1,4
TRBV27,TRBJ1-6,CASSRWARGRGLGSPLHF,0,4,1,4
TRBV6-1,TRBJ2-2,CASSDEAAGRGVNGELFF,0,4,1,4
TRBV5-6,TRBJ2-1,CASSFDYIGTSGRDEQFF,0,4,1,4
TRBV5-4,TRBJ2-5,CASSFPRGSGRATETQYF,0,4,1,4
TRBV7-2,TRBJ2-7,CASSLARILGTGTYEQYF,0,4,1,4
TRBV3-1,TRBJ2-7,CASSQVLAGGPPTYEQYF,0,4,1,4
TRBV3-1,TRBJ2-1,CASSQGAPRTTIYNEQFF,0,4,1,4
TRBV3-1,TRBJ2-3,CASSQDLRLAGSTDTQYF,0,4,1,4
TRBV9,TRBJ1-1,CASSVGGDSYYMNTEAFF,0,4,1,4
TRBV5-1,TRBJ2-3,CASSFTSGSPRSTDTQYF,0,4,1,4
TRBV4-1,TRBJ2-7,CASSRQGLAGDSSYEEYF,0,4,1,4
TRBV20-1,TRBJ2-1,CSAPIWGGSSGLYNEQFF,0,4,1,4
TRBV20-1,TRBJ2-2,CSAGLLAGLGPNTGELFF,0,4,1,4
TRBV29-1,TRBJ2-3,CSVEDRGSALFSTDTQYF,0,4,1,4
TRBV29-1,TRBJ2-1,CSVTGTSGRGGSYNEQFF,0,4,1,4
TRBV12-5,TRBJ2-1,CASGRPLRVSSYNEQFF,0,4,1,4
TRBV24-1,TRBJ2-1,CATSDLPGQGSGSEQFS,0,4,1,4
TRBV24-1,TRBJ2-3,CATSDPVGDLSTDTQYF,0,4,1,4
TRBV24-1,TRBJ2-3,CATSDPASPPFTDTQYF,0,4,1,4
TRBV19,TRBJ1-4,CASSKEGQVSYDEKLFF,0,4,1,4
TRBV19,TRBJ2-1,CASSSPLQEEGYNEQFF,0,4,1,4
TRBV28,TRBJ2-3,CASSLRAAPSRGDTQYF,0,4,1,4
TRBV18,TRBJ2-2,CASSLPAGTGRTGELSF,0,4,1,4
TRBV9,TRBJ2-1,CASTHQGGRYRYNEQFF,0,4,1,4
TRBV6-2/3/5/6,TRBJ2-2,CASSFFGLAEHTGELFF,0,4,1,4
TRBV6-2/3/5/6,TRBJ2-2,CASSLSGQNANTGELFF,0,4,1,4
TRBV6-2/3/5/6,TRBJ2-1,CASSLYGDQSSYNGPFF,0,4,1,4
TRBV27,TRBJ2-1,CASSLYGDQSSYNGQFF,0,4,1,4
TRBV28,TRBJ2-3,CASSLTVSGGLTDTQYF,0,4,1,4
TRBV12-3/4,TRBJ2-1,CASSLTTSGTPRNEQFF,0,4,1,4
TRBV28,TRBJ2-7,CASSLNWGTSGHYEQYF,0,4,1,4
TRBV6-2/3/5/6,TRBJ2-7,CASSPRFFGQNPYEQYF,0,4,1,4
TRBV2,TRBJ2-5,CASSETGPLSAQETQYF,0,4,1,4
TRBV11-2,TRBJ2-5,CASSFRFLGARGETQYF,0,4,1,4
TRBV5-4,TRBJ2-1,CASSLLTSGLSYNEQFF,0,4,1,4
TRBV5-4,TRBJ2-4,CASSLGTSGRAKNIQYF,0,4,1,4
TRBV7-8,TRBJ2-7,CASSLYLSSGSAYEQYF,0,4,1,4
TRBV6-2/3/5/6,TRBJ1-1,CASSLNDPTGDPTEAFF,0,4,1,4
TRBV7-6,TRBJ2-4,CASSLKGKGQGENIQYF,0,4,1,4
TRBV7-9,TRBJ2-1,CASSSSGLAGVVNEQFF,0,4,1,4
TRBV5-5,TRBJ1-1,CASSSVRLPALNTEAFF,0,4,1,4
TRBV7-2,TRBJ2-2,CASSSTRGQVYTGELFF,0,4,1,4
TRBV7-6,TRBJ2-1,CASSLGLAGGPVNEQFS,0,4,1,4
TRBV3-1,TRBJ2-5,CASSPPRLALNQETQYF,0,4,1,4
TRBV7-9,TRBJ2-3,CASSPTQRERGTDTQYF,0,4,1,4
TRBV4-2,TRBJ2-1,CASSQDTRTSGRNEQFF,0,4,1,4
TRBV28,TRBJ2-1,CASRDETAGVGYNEQFF,0,4,1,4
TRBV5-6,TRBJ2-3,CASRTYTGTTFTDTQYF,0,4,1,4
TRBV6-2/3/5/6,TRBJ2-1,CASKRSPQPSFYNEQFF,0,4,1,4
TRBV5-1,TRBJ2-3,CASSFRSGVDSTDTQYF,0,4,1,4
TRBV4-1,TRBJ2-3,CASSFRLAGESTDSQYF,0,4,1,4
TRBV5-1,TRBJ1-5,CASSADRVLDSNQPQHF,0,4,1,4
TRBV5-1,TRBJ2-7,CASSETIPGGASYEQYF,0,4,1,4
TRBV20-1,TRBJ2-1,CSAGPLVRREGHNEQFF,0,4,1,4
TRBV20-1,TRBJ2-5,CSARGTSGSRRGETQYF,0,4,1,4
TRBV20-1,TRBJ1-2,CSARDLLSGAGISGYTF,0,4,1,4
TRBV29-1,TRBJ2-1,CSVGGLAGGRTYNEQFF,0,4,1,4
TRBV29-1,TRBJ2-7,CSVEDYSERDRSYEQYF,0,4,1,4
TRBV29-1,TRBJ1-1,CSVERTGGGGRNTEAFF,0,4,1,4
TRBV29-1,TRBJ2-3,CSAVPPGRGPFLDTQYF,0,4,1,4
TRBV9,TRBJ2-7,RASSVGPGLKYSYEQYF,0,4,1,4
TRBV10-3,TRBJ1-3,CAISGDRASSGNTIYF,0,4,1,4
TRBV10-3,TRBJ2-2,CAISRASGTNTGELFF,0,4,1,4
TRBV24-1,TRBJ2-4,CATSEESDRGENIQYF,0,4,1,4
TRBV15,TRBJ2-1,CATSRARTGVYNEQFY,0,4,1,4
TRBV19,TRBJ2-5,CASTPGGLAGQETQYF,0,4,1,4
TRBV19,TRBJ2-7,CASSMPGGLNDYEQYF,0,4,1,4
TRBV19,TRBJ2-3,CASSIARTSSTDTQYF,0,4,1,4
TRBV19,TRBJ1-4,CASSTTGRTTNEKLFF,0,4,1,4
TRBV19,TRBJ2-2,CASSTGLAGSVGELFF,0,4,1,4
TRBV19,TRBJ1-2,CASSDRDRRANYGYTF,0,4,1,4
TRBV19,TRBJ2-3,CASRGWDVRFTDTQYF,0,4,1,4
TRBV18,TRBJ2-1,CASSPVRLETYNEQFF,0,4,1,4
TRBV18,TRBJ2-7,CASSPRGRGLVSEQYF,0,4,1,4
TRBV18,TRBJ2-5,CASSPRGQGALETQYF,0,4,1,4
TRBV18,TRBJ2-2,CASSGLAGLNTGELFF,0,4,1,4
TRBV19,TRBJ2-6,CASLPRKASGANVLTF,0,4,1,4
TRBV10-3,TRBJ2-5,CASGYRQGGVQETQYF,0,4,1,4
TRBV6-2/3/5/6,TRBJ2-1,CASGSLTENSYNEQFF,0,4,1,4
TRBV6-2/3/5/6,TRBJ2-1,CASTYDSGIPTNEQFF,0,4,1,4
TRBV11-2,TRBJ1-4,CASTPGRVSTNGKLFF,0,4,1,4
TRBV18,TRBJ1-2,CASTPQPGASLVRYTF,0,4,1,4
TRBV28,TRBJ2-4,CASSFRRGSGKNIQYF,0,4,1,4
TRBV12-3/4,TRBJ1-1,CASSLWADERNTEAFF,0,4,1,4
TRBV28,TRBJ2-4,CASSLLAGLAKNIQYF,0,4,1,4
TRBV28,TRBJ2-1,CASSLQGVFSYNEQFF,0,4,1,4
TRBV12-3/4,TRBJ1-2,CASSLVAGHGAYGYTF,0,6,1,6
TRBV6-2/3/5/6,TRBJ1-4,CASSYPTGATNEKLFF,0,4,1,4
TRBV12-3/4,TRBJ1-5,CASSLSTGTNNQPQHF,0,4,1,4
TRBV6-2/3/5/6,TRBJ2-7,CASSPSLGTGPYEQYF,0,4,1,4
TRBV27,TRBJ2-7,CASSPMTGERLYEQYF,0,4,1,4
TRBV7-2,TRBJ1-1,CASSRPVTGLNTEAFF,0,4,1,4
TRBV6-1,TRBJ1-3,CASSEHWSGSGITIYF,0,4,1,4
TRBV2,TRBJ2-1,CASSERAGGSYNEQFF,0,4,1,4
TRBV5-5,TRBJ2-1,CASSLVGPRKYNEQFF,0,4,1,4
TRBV5-5,TRBJ2-2,CASSLAGGRYTGELFF,0,4,1,4
TRBV7-2,TRBJ2-3,CASSLSRDIGADTQYF,0,4,1,4
TRBV7-2,TRBJ1-2,CASSLVPGRINYGYTF,0,4,1,4
TRBV7-2,TRBJ1-3,CASSLALNSAGNTIYF,0,4,1,4
TRBV7-9,TRBJ2-5,CASSLAGGAFWETQYF,0,4,1,4
TRBV7-6,TRBJ2-2,CASSLGLAGTTGELFF,0,4,1,4
TRBV5-6,TRBJ2-5,CASSLDRGGMKETQYF,0,4,1,4
TRBV5-8,TRBJ2-3,CASSSRTSVFTDTQYF,0,4,1,4
TRBV7-6,TRBJ2-3,CASSSLRGEHTDTQYF,0,4,1,4
TRBV7-2,TRBJ2-7,CASSSVSGRTSYEQYF,0,4,1,4
TRBV7-9,TRBJ2-3,CASSSGTGVEMDTQYF,0,4,1,4
TRBV11-2,TRBJ2-2,CASSLGASANTGELFF,0,4,1,4
TRBV7-9,TRBJ2-3,CASSLGQGLITDTQYF,0,4,1,4
TRBV11-2,TRBJ1-1,CASSLDPVDPNTEAFF,0,4,1,4
TRBV14,TRBJ2-4,CASSPRGTSGQNIQYF,0,4,1,4
TRBV28,TRBJ2-3,CASSPGDSGRTDTQYF,0,4,1,4
TRBV5-4,TRBJ2-7,CASSPGSGTSGYEQYF,0,4,1,4
TRBV5-4,TRBJ2-7,CASSPRGTGANYEQYF,0,4,1,4
TRBV6-2/3/5/6,TRBJ1-2,CASSRTTGTANYGYTF,0,4,1,4
TRBV3-1,TRBJ2-6,CASSRGTGFEANVLTF,0,4,1,4
TRBV3-1,TRBJ2-3,CASSQSPSSFRDTQYF,0,4,1,4
TRBV14,TRBJ2-1,CASSQVAGGRWNEQFF,0,4,1,4
TRBV4-2,TRBJ2-1,CASSQDGRGDLNEQFF,0,4,1,4
TRBV25-1,TRBJ2-2,CASSVRGRKTAGELFF,0,4,1,4
TRBV9,TRBJ1-1,CASSVDDRFVATEAFF,0,4,1,4
TRBV7-3,TRBJ2-7,CASSAQGTGRFHEQYF,0,4,1,4
TRBV2,TRBJ2-7,CASSAAGQGAPYEQYF,0,4,1,4
TRBV7-2,TRBJ2-5,CASSDPGQGARETQYF,0,4,1,4
TRBV6-4,TRBJ2-1,CASSDRDRVIYNEQFF,0,4,1,4
TRBV27,TRBJ2-7,CASRGQTNAAVGEQYF,0,4,1,4
TRBV27,TRBJ2-1,CASRDGSGSSYNEQFF,0,4,1,4
TRBV6-2/3/5/6,TRBJ1-5,CASRPGTAGADQPQHF,0,4,1,4
TRBV3-1,TRBJ2-2,CASRPTSGVNTGELFF,0,4,1,4
TRBV12-3/4,TRBJ1-5,CASNSGSVAGNQPQHF,0,4,1,4
TRBV2,TRBJ2-7,CASKALTSGRPYEQYF,0,4,1,4
TRBV5-1,TRBJ2-1,CASTLAGTSGSNEQFF,0,4,1,4
TRBV4-1,TRBJ2-2,CASSHTPGVGTGELFF,0,4,1,4
TRBV10-2,TRBJ2-3,CASSELPAGGPDTQYF,0,4,1,4
TRBV5-1,TRBJ2-3,CASSLLGQGAPDTQYF,0,4,1,4
TRBV5-1,TRBJ2-1,CASSLGLAGGSYEQFF,0,4,1,4
TRBV5-1,TRBJ1-1,CASSLGPGEMNTEAFF,0,4,1,4
TRBV5-1,TRBJ2-3,CASSLGRTGGADTQYF,0,4,1,4
TRBV5-1,TRBJ2-7,CASSLPGLGLLHEQYF,0,4,1,4
TRBV5-1,TRBJ1-1,CASSLGLLGRNTEAFF,0,4,1,4
TRBV5-1,TRBJ1-1,CASSSGGGIPETEAFF,0,4,1,4
TRBV5-1,TRBJ1-2,CASSSDIGPTTTAYTF,0,4,1,4
TRBV5-1,TRBJ2-2,CASSPLQGANTGELFF,0,4,1,4
TRBV5-1,TRBJ2-7,CASSPYIGTSGAEQYF,0,4,1,4
TRBV4-1,TRBJ2-4,CASSHALRGTKNIQYF,0,4,1,4
TRBV4-1,TRBJ2-7,CASSQPVQGLGYEQYF,0,4,1,4
TRBV4-1,TRBJ2-7,CASSQDWASGYYEQYF,0,4,1,4
TRBV20-1,TRBJ2-5,CSARGTSAEGRETQYF,0,4,1,4
TRBV20-1,TRBJ2-1,CSARDMGPSSYNGQFF,0,4,1,4
TRBV20-1,TRBJ2-3,CSAFKRLISSTDTQYF,0,4,1,4
TRBV20-1,TRBJ2-3,CSAHSSGRANTDTQYF,0,4,1,4
TRBV20-1,TRBJ2-3,CSGGSTSRRGTDTQYF,0,4,1,4
TRBV20-1,TRBJ2-6,CSLSQWGGNGANVLTF,0,4,1,4
TRBV29-1,TRBJ1-1,CSVVSQQGTPNTEAFF,0,4,1,4
TRBV29-1,TRBJ2-1,CSVGGLASSSYNEQFF,0,4,1,4
TRBV29-1,TRBJ2-1,CSVDDPRQGGPNEQFF,0,4,1,4
TRBV29-1,TRBJ2-6,CSVEDLSSSGANVLTF,0,4,1,4
TRBV7-4,TRBJ1-5,RASTPGRVWSNQPQHF,0,4,1,4
TRBV5-6,TRBJ2-5,RASSLEQAGFGETQYF,0,4,1,4
TRBV12-5,TRBJ2-3,CASGLVYTDTDTQYF,0,4,1,4
TRBV12-5,TRBJ1-5,CASGPPGQSNQPQHF,0,4,1,4
TRBV12-3/4,TRBJ2-4,CASSTTSGRTNIQYF,0,4,1,4
TRBV28,TRBJ2-3,CASQRGRGSTDTQYF,0,4,1,4
TRBV10-3,TRBJ2-1,CAISASGSSYNEQFF,0,4,1,4
TRBV28,TRBJ2-1,CATLWTSGRRDEQFF,0,4,1,4
TRBV12-3/4,TRBJ2-3,CATVEGGSGTDTQYF,0,4,1,4
TRBV28,TRBJ2-3,CATIPSGLQADTQYF,0,4,1,4
TRBV24-1,TRBJ1-3,CATSDPDRESNTIYF,0,4,1,4
TRBV24-1,TRBJ2-3,CATSDRDFPTDTQYF,0,4,1,4
TRBV24-1,TRBJ2-3,CATSESGANTDTQYF,0,4,1,4
TRBV19,TRBJ2-7,CASSVTSYDSYEQYF,0,4,1,4
TRBV19,TRBJ2-6,CASSDPGAGANVLTF,0,4,1,4
TRBV19,TRBJ2-7,CASSEQISGRYEQYF,0,4,1,4
TRBV19,TRBJ1-5,CASSIGQVSNQPQHF,0,4,1,4
TRBV19,TRBJ1-6,CASSIGHRSATPLHF,0,4,1,4
TRBV19,TRBJ2-6,CASSSGTAGANVLTF,0,4,1,4
TRBV19,TRBJ2-3,CASSRGTTPGDTQYF,0,4,1,4
TRBV19,TRBJ2-1,CASSKLAGGNNEQFF,0,4,1,4
TRBV19,TRBJ1-1,CASNPTGQGRTEAFF,0,4,1,4
TRBV18,TRBJ1-6,CASSPQEISQSPLHF,0,4,1,4
TRBV18,TRBJ2-3,CASSSTSGGEDTQYF,0,4,1,4
TRBV18,TRBJ1-4,CASSPLGQVNEKLFF,0,4,1,4
TRBV18,TRBJ2-2,CASSPPGTYTGELFF,0,4,1,4
TRBV18,TRBJ2-7,CASSTTGTGIYEQYF,0,4,1,4
TRBV3-1,TRBJ2-5,CASCQGSGSVETQYF,0,4,1,4
TRBV27,TRBJ2-1,CASQSLAGGYNEQFF,0,4,1,4
TRBV9,TRBJ2-1,CASGRTSHSYNEQFF,0,4,1,4
TRBV6-2/3/5/6,TRBJ1-3,CASILGGSSGNTIYF,0,4,1,4
TRBV5-8,TRBJ2-3,CASILLGGKTDTQYF,0,4,1,4
TRBV5-6,TRBJ1-2,CASTLGPGMNYGYTF,0,4,1,4
TRBV28,TRBJ2-7,CASTSGADPRYEQYF,0,4,1,4
TRBV6-2/3/5/6,TRBJ2-1,CASTRAPWAGGEQFF,0,4,1,4
TRBV28,TRBJ2-1,CASTKTSPSYNEQFF,0,4,1,4
TRBV2,TRBJ1-1,CASTTEGVGSGPVFF,0,4,1,4
TRBV12-3/4,TRBJ2-1,CASSFRSGTYNEQFF,0,4,1,4
TRBV6-2/3/5/6,TRBJ2-3,CASSFQGTVCRSQYF,0,4,1,4
TRBV28,TRBJ2-7,CASSLRLNKWDEQYF,0,4,1,4
TRBV12-3/4,TRBJ2-1,CASSLMGRIGNEQFF,0,4,1,4
TRBV28,TRBJ2-1,CASSLREPANNEQFF,0,4,1,4
TRBV12-3/4,TRBJ2-7,CASSLNSGTTYEQYF,0,4,1,4
TRBV28,TRBJ1-2,CASSSPGTGGYGYTF,0,4,1,4
TRBV6-2/3/5/6,TRBJ2-1,CASSSPWLRGNEQFF,0,4,1,4
TRBV12-3/4,TRBJ1-6,CASSSQGYYNSPLHF,0,4,1,4
TRBV28,TRBJ2-3,CASSSGQGVVDTQYF,0,4,1,4
TRBV6-2/3/5/6,TRBJ1-3,CASSSMDRVGNTIYF,0,4,1,4
TRBV6-2/3/5/6,TRBJ1-6,CASSYSVQGSSPLHF,0,4,1,4
TRBV6-2/3/5/6,TRBJ2-3,CASSYSGDSTDTQYF,0,4,1,4
TRBV6-2/3/5/6,TRBJ2-2,CASSYSGPNTGELFF,0,4,1,4
TRBV6-2/3/5/6,TRBJ2-3,CASSYSMRNTDTQYF,0,4,1,4
TRBV12-3/4,TRBJ2-7,CASSPTSGSTYEQYF,0,4,1,4
TRBV28,TRBJ2-4,CASSPTGTQGNIQYF,0,4,1,4
TRBV6-2/3/5/6,TRBJ2-1,CASSPVAGVDNEQFF,0,4,1,4
TRBV7-2,TRBJ1-5,CASSRDRGGQQPQHF,0,4,1,4
TRBV28,TRBJ1-4,CASSRADRLREKLFF,0,4,1,4
TRBV6-4,TRBJ1-5,CASSQGTTSNQPQHF,0,4,1,4
TRBV12-3/4,TRBJ2-5,CASSQVSTLGETQYF,0,4,1,4
TRBV6-1,TRBJ2-3,CASSGQGSLPDTQYF,0,4,1,4
TRBV12-3/4,TRBJ2-7,CASSGGTGVFYEQYF,0,4,1,4
TRBV2,TRBJ2-7,CASSEPGGRNYEQYF,0,4,1,4
TRBV28,TRBJ2-3,CASSEPGPRWGTQYF,0,4,1,4
TRBV6-1,TRBJ2-1,CASSEGPGDRNEQFY,0,4,1,4
TRBV6-1,TRBJ2-3,CASSEGTSTTDTQYF,0,4,1,4
TRBV11-2,TRBJ2-4,CASSFLGGAKNIQYF,0,4,1,4
TRBV6-2/3/5/6,TRBJ2-5,CASSFNPGGAETQYF,0,4,1,4
TRBV13,TRBJ2-7,CASSFGGTGLLEQYF,0,4,1,4
TRBV7-2,TRBJ1-2,CASSLSYSHIYGYTF,0,4,1,4
TRBV5-4,TRBJ2-1,CASSLLTSFSNEQFF,0,4,1,4
TRBV11-3,TRBJ2-5,CASSLGLAGTETQYF,0,4,1,4
TRBV5-4,TRBJ2-1,CASSLDRAGYNEQFF,0,4,1,4
TRBV5-6,TRBJ2-1,CASSLTDRVWGEQFF,0,4,1,4
TRBV7-9,TRBJ2-7,CASSLRRDVLYEQYF,0,4,1,4
TRBV11-2,TRBJ2-3,CASSLVGTSGDTQYF,0,4,1,4
TRBV7-9,TRBJ1-4,CASSLGGTTNEKLFF,0,4,1,4
TRBV7-2,TRBJ2-2,CASSLGPSFGGELFF,0,4,1,4
TRBV7-9,TRBJ1-4,CASSLGDSLNEGLFF,0,4,1,4
TRBV7-6,TRBJ2-7,CASSLELGASYEQYF,0,4,1,4
TRBV7-2,TRBJ2-2,CASSLEGSDTGELFF,0,4,1,4
TRBV7-9,TRBJ2-1,CASSLRGGGDNEQFF,0,4,1,4
TRBV7-3,TRBJ2-5,CASSLNGRAQETQYF,0,4,1,4
TRBV7-9,TRBJ1-2,CASSSYLGTGNGYTF,0,4,1,4
TRBV11-2,TRBJ2-3,CASSSGQAYTDTQYF,0,4,1,4
TRBV7-2,TRBJ1-2,CASSSRLGGKEGYTF,0,4,1,4
TRBV28,TRBJ2-3,CASSCDSSSTDTQYF,0,4,1,4
TRBV7-2,TRBJ2-1,CASSYTSGSKNEQFF,0,4,1,4
TRBV11-2,TRBJ2-1,CASSYPQRGDSEQFF,0,4,1,4
TRBV7-9,TRBJ2-1,CASSPPGRLGNEQFF,0,4,1,4
TRBV7-8,TRBJ1-2,CASSPRDSYNYGYTF,0,4,1,4
TRBV7-2,TRBJ2-1,CASSPSGTRGNEQSF,0,4,1,4
TRBV5-4,TRBJ1-2,CASSPAGRANYGYTF,0,4,1,4
TRBV6-4,TRBJ1-5,CASSPDRDPNQPQHF,0,4,1,4
TRBV3-1,TRBJ2-7,CASSPNYRDAYEQYF,0,4,1,4
TRBV12-3/4,TRBJ2-4,CASSPPREGRDIQYF,0,4,1,4
TRBV5-4,TRBJ2-5,CASSPGGQQQETQYF,0,4,1,4
TRBV5-4,TRBJ2-7,CASSPGGPNDYEQYF,0,4,1,4
TRBV6-2/3/5/6,TRBJ2-3,CASSRRDNPTDTQYF,0,4,1,4
TRBV2,TRBJ2-2,CASSRGPQNTGELFF,0,4,1,4
TRBV28,TRBJ2-7,CASSRGGDMLDEQYF,0,4,1,4
TRBV7-2,TRBJ2-4,CASSREELAKNIQYF,0,4,1,4
TRBV6-2/3/5/6,TRBJ2-1,CASSRQGGSYNEQFF,0,4,1,4
TRBV14,TRBJ2-1,CASSQVPSSYNEQFF,0,4,1,4
TRBV4-2,TRBJ2-5,CASSQEEGLKGTQYF,0,4,1,4
TRBV7-2,TRBJ1-1,CASSQRGRENTEAFF,0,4,1,4
TRBV6-2/3/5/6,TRBJ2-1,CASSVGLGDRNEQFF,0,4,1,4
TRBV7-9,TRBJ2-1,CASSVLRDRSNEQFF,0,4,1,4
TRBV9,TRBJ2-5,CASSVSGDSAETQYF,0,4,1,4
TRBV9,TRBJ2-1,CASSVRQELYNEQFF,0,4,1,4
TRBV7-9,TRBJ1-6,CASSAGDRANSPLHF,0,4,1,4
TRBV2,TRBJ2-3,CASSAQGAHTDTQYF,0,4,1,4
TRBV5-4,TRBJ2-3,CASSDAASGRDTQYF,0,4,1,4
TRBV5-6,TRBJ2-5,CASSIRAGVGETQYF,0,4,1,4
TRBV7-2,TRBJ2-1,CASSIYSRSYNEQFF,0,4,1,4
TRBV7-2,TRBJ2-5,CASSNRLAGKETQYF,0,4,1,4
TRBV2,TRBJ1-6,CASRSTWGGSSPLHF,0,4,1,4
TRBV6-2/3/5/6,TRBJ2-1,CASRGVSGRANEQFP,0,4,1,4
TRBV6-2/3/5/6,TRBJ1-1,CASRIPGTGFTEAFF,0,4,1,4
TRBV12-3/4,TRBJ2-3,CANRRLAGWADTQYF,0,4,1,4
TRBV5-1,TRBJ2-2,CASTSTLANTGEPFF,0,4,1,4
TRBV27,TRBJ2-1,CASSLDTRGYGEQFF,0,4,1,4
TRBV10-1,TRBJ2-1,CASSESGTGVNEQFF,0,4,1,4
TRBV10-1,TRBJ2-1,CASSESLAGVNEQFF,0,4,1,4
TRBV7-2,TRBJ2-5,CASSFRDRSEETQYF,0,4,1,4
TRBV5-1,TRBJ2-1,CASSLVGVSYNEQFF,0,4,1,4
TRBV5-1,TRBJ2-1,CASSLVTGTMNEQFF,0,4,1,4
TRBV5-1,TRBJ2-7,CASSLAGDSHYEQYF,0,4,1,4
TRBV5-1,TRBJ2-3,CASSLAGNMADTQYF,0,4,1,4
TRBV5-1,TRBJ1-1,CASSLGGTGVTEAFF,0,4,1,4
TRBV5-1,TRBJ2-7,CASSLDPGVSYEQYF,0,4,1,4
TRBV5-1,TRBJ1-1,CASSLDVGKGTEAFF,0,4,1,4
TRBV5-1,TRBJ2-1,CASSLDESSYNEQFF,0,4,1,4
TRBV5-1,TRBJ2-2,CASSLEGDFTGELFF,0,4,1,4
TRBV5-1,TRBJ2-3,CASSLLEGAADTQYF,0,4,1,4
TRBV5-1,TRBJ2-2,CASSLRGRNTGELFF,0,4,1,4
TRBV5-1,TRBJ2-3,CASSSSGRNTDTQYF,0,4,1,4
TRBV5-1,TRBJ2-1,CASSSRQGEDNEQFF,0,4,1,4
TRBV5-1,TRBJ2-7,CASSYDSGSRYEQYF,0,4,1,4
TRBV5-1,TRBJ2-7,CASSLGWTSGGEQYF,0,4,1,4
TRBV5-1,TRBJ2-7,CASSPIPGLSYEQYF,0,4,1,4
TRBV4-1,TRBJ2-1,CASSRIHREHNEQFF,0,4,1,4
TRBV4-1,TRBJ1-1,CASSQATGKGTEAFF,0,4,1,4
TRBV4-1,TRBJ2-2,CASSQDPVLTGELFF,0,4,1,4
TRBV5-1,TRBJ2-7,CASSGGTSRVGEQYF,0,4,1,4
TRBV5-1,TRBJ2-2,CASSGLQGNTGELFF,0,4,1,4
TRBV5-1,TRBJ2-3,CASSDSASAADTQYF,0,4,1,4
TRBV5-1,TRBJ2-7,CASSERLAGTYEQYF,0,4,1,4
TRBV5-1,TRBJ2-1,CASSMAGAVGNEQFF,0,4,1,4
TRBV5-1,TRBJ1-1,CASNPGRIWGAEAFF,0,4,1,4
TRBV5-1,TRBJ2-1,CASNPGTGIYNEQFF,0,4,1,4
TRBV5-1,TRBJ1-1,CASNPGRRVNTEASF,0,4,1,4
TRBV20-1,TRBJ2-1,CSALPRDRGFDEQFF,0,4,1,4
TRBV20-1,TRBJ2-1,CSAYTSGRLYNEQFF,0,4,1,4
TRBV20-1,TRBJ2-3,CSALQSTGSTDTQYF,0,4,1,4
TRBV20-1,TRBJ1-1,CSAGAGGVGDTEAFF,0,4,1,4
TRBV20-1,TRBJ1-4,CSAIGSGGSPEKLFF,0,4,1,4
TRBV20-1,TRBJ2-3,CSAINPGARTDTQYF,0,4,1,4
TRBV20-1,TRBJ2-5,CSASGPAGRQETQYF,0,4,1,4
TRBV20-1,TRBJ1-5,CSARVAGLYNQPQHF,0,4,1,4
TRBV20-1,TRBJ1-4,CSARDSRDVNEKLFF,0,4,1,4
TRBV20-1,TRBJ2-5,CSARDPRTELGTQYF,0,4,1,4
TRBV20-1,TRBJ2-7,CSARDPQGGPYEEYF,0,4,1,4
TRBV20-1,TRBJ2-7,CSARDPRERQDEQYF,0,4,1,4
TRBV20-1,TRBJ1-2,CSARDPGTPNYGYTF,0,4,1,4
TRBV20-1,TRBJ2-1,CSARDHGTGGNEQFF,0,4,1,4
TRBV20-1,TRBJ2-1,CSAREREGPGGEQFF,0,4,1,4
TRBV20-1,TRBJ2-5,CSARPRQGSQETQYF,0,4,1,4
TRBV20-1,TRBJ2-7,CSASRTTKSSYEQYF,0,4,1,4
TRBV29-1,TRBJ2-3,CSVVASPNNADTQYF,0,4,1,4
TRBV29-1,TRBJ2-7,CSVDGETSGRYEQYF,0,4,1,4
TRBV29-1,TRBJ2-1,CSVEVAGDSYNEQFF,0,4,1,4
TRBV29-1,TRBJ2-7,CSVEDGQGPTYEQYF,0,4,1,4
TRBV29-1,TRBJ2-3,CSVGGQTKSTDTQYF,0,4,1,4
TRBV29-1,TRBJ2-3,CSVAPTSGGTDTQYF,0,4,1,4
TRBV29-1,TRBJ2-2,CSALYGTGHTGELFF,0,4,1,4
TRBV30,TRBJ2-6,CAWAKSPGANVLTF,0,4,1,4
TRBV30,TRBJ1-1,CAWTEGARDTEAFF,0,4,1,4
TRBV30,TRBJ2-1,CAWSGDRGYNEQFF,0,4,1,4
TRBV7-2,TRBJ2-1,CAGSPRLEANEQFF,0,4,1,4
TRBV10-3,TRBJ1-1,CAISETQGNTEAFF,0,4,1,4
TRBV10-3,TRBJ2-1,CAISTSGYYNEQFF,0,4,1,4
TRBV10-3,TRBJ2-1,CAIKSLSSYNEQFF,0,4,1,4
TRBV10-3,TRBJ2-7,CATYEASGTYEQYF,0,4,1,4
TRBV24-1,TRBJ2-7,CATSLGHRGDEQYF,0,4,1,4
TRBV15,TRBJ2-7,CATSLATPGREQYF,0,4,1,4
TRBV7-8,TRBJ2-1,CATGLLLSYNEQFF,0,4,1,4
TRBV19,TRBJ1-1,CASSIQGRGTEAFF,0,4,1,4
TRBV19,TRBJ2-4,CASSIGQGGNIQYF,0,4,1,4
TRBV19,TRBJ2-3,CASSMGDSTDTQYF,0,4,1,4
TRBV19,TRBJ1-5,CASSMTGGNQPQHF,0,4,1,4
TRBV19,TRBJ2-5,CASSIIGSQETQYF,0,4,1,4
TRBV19,TRBJ2-1,CASSSGGGYNEQFF,0,4,1,4
TRBV19,TRBJ1-1,CASSNGQGQAEAFF,0,4,1,4
TRBV19,TRBJ2-3,CASNQGSSTDTQYF,0,4,1,4
TRBV2,TRBJ2-3,CASSPGQPRTTQYF,0,4,1,4
TRBV18,TRBJ1-3,CASSPPAAGNTIYF,0,4,1,4
TRBV9,TRBJ2-3,CASLPRDRGGTQYF,0,4,1,4
TRBV6-2/3/5/6,TRBJ2-5,CASRRDIRKGTQYF,0,4,1,4
TRBV27,TRBJ2-1,CASHPGAHYNEQFF,0,4,1,4
TRBV12-3/4,TRBJ1-1,CASGFGQGGTEAFF,0,4,1,4
TRBV3-1,TRBJ2-2,CASGRREYTGELFF,0,4,1,4
TRBV5-5,TRBJ2-5,CASGGGGWQETQYF,0,4,1,4
TRBV28,TRBJ2-1,CASIPSGSYNEQFF,0,4,1,4
TRBV11-2,TRBJ1-1,CASTTGNSRAEAFF,0,4,1,4
TRBV7-9,TRBJ1-1,CASTGQGAGTEAFF,0,4,1,4
TRBV3-1,TRBJ2-3,CASTFSRRTDTQYF,0,4,1,4
TRBV12-3/4,TRBJ2-1,CASSFVWGHNEQFF,0,4,1,4
TRBV27,TRBJ2-1,CASSFGGSYNEQFF,0,4,1,4
TRBV12-3/4,TRBJ2-7,CASSFEGLAGEQYF,0,4,1,4
TRBV12-3/4,TRBJ1-1,CASSLGSVNTEAFF,0,4,1,4
TRBV6-2/3/5/6,TRBJ2-7,CASSLGTSANRQYF,0,4,1,4
TRBV28,TRBJ2-7,CASSLETGSYEQYF,0,4,1,4
TRBV6-2/3/5/6,TRBJ1-1,CASSLNIARGEAFF,0,4,1,4
TRBV7-9,TRBJ1-5,CASSSTGVNQPQHF,0,4,1,4
TRBV6-2/3/5/6,TRBJ1-4,CASSYRENNEKLVY,0,4,1,4
TRBV12-3/4,TRBJ2-1,CASSLTPDRNEQFF,0,4,1,4
TRBV28,TRBJ2-1,CASSLRGGGNEQFF,0,4,1,4
TRBV12-3/4,TRBJ2-1,CASSPLTGGNEQFF,0,4,1,4
TRBV6-2/3/5/6,TRBJ2-1,CASSRREGRGEQFF,0,4,1,4
TRBV6-2/3/5/6,TRBJ2-6,CASSQVSGANVLTF,0,4,1,4
TRBV6-1,TRBJ1-5,CASSQKASNQPQHF,0,4,1,4
TRBV6-1,TRBJ1-1,CASSVAGQNTEVFF,0,4,1,4
TRBV6-1,TRBJ2-7,CASSVDRHSYEQYF,0,4,1,4
TRBV6-2/3/5/6,TRBJ2-1,CASSVLRSYNEQFF,0,4,1,4
TRBV2,TRBJ1-2,CASSAGQGNYGYTF,0,4,1,4
TRBV6-1,TRBJ2-3,CASSASYVPDTQYF,0,4,1,4
TRBV28,TRBJ2-1,CASSAAHLAGEQFF,0,4,1,4
TRBV6-1,TRBJ1-1,CASSGGQGNTEAFF,0,4,1,4
TRBV2,TRBJ1-5,CASSDRVGNQPQHF,0,4,1,4
TRBV2,TRBJ2-1,CASSEASTVSEQFF,0,4,1,4
TRBV6-2/3/5/6,TRBJ2-3,CASSTGKVADTQYF,0,4,1,4
TRBV28,TRBJ2-3,CASSTRGGTDTQYF,0,4,1,4
TRBV7-3,TRBJ1-1,CASSFSTGGTEAFF,0,4,1,4
TRBV7-9,TRBJ1-4,CASSFFGGSEKLFF,0,4,1,4
TRBV11-2,TRBJ1-3,CASSFETGGNTIYF,0,4,1,4
TRBV7-6,TRBJ2-5,CASSLQVRQETQYF,0,4,1,4
TRBV5-4,TRBJ2-5,CASSLGDSQETQYF,0,4,1,4
TRBV5-6,TRBJ2-7,CASSLGGTGYEQYF,0,4,1,4
TRBV5-5,TRBJ1-1,CASSLEGPMVQAFF,0,4,1,4
TRBV5-6,TRBJ2-5,CASSLSYKPETQYF,0,4,1,4
TRBV11-2,TRBJ2-3,CASSLPGTADTQYF,0,4,1,4
TRBV7-3,TRBJ2-1,CASSLVGGGDEQFF,0,4,1,4
TRBV7-2,TRBJ2-5,CASSLGPIQETQYF,0,4,1,4
TRBV7-2,TRBJ1-1,CASSLGTGARVTFF,0,4,1,4
TRBV11-2,TRBJ2-1,CASSLDGSYNEQFF,0,4,1,4
TRBV7-2,TRBJ2-7,CASSLERLAAEQYF,0,4,1,4
TRBV7-9,TRBJ1-2,CASSLTVADGGYTF,0,4,1,4
TRBV5-6,TRBJ2-5,CASSSGMELGTQYF,0,4,1,4
TRBV7-9,TRBJ2-7,CASSSSALNYEQYF,0,4,1,4
TRBV7-3,TRBJ2-3,CASSSAGGASSQYF,0,4,1,4
TRBV7-2,TRBJ2-1,CASSSSTGPYEQFF,0,4,1,4
TRBV7-9,TRBJ2-1,CASSLGAGPNEQFF,0,4,1,4
TRBV14,TRBJ2-1,CASSPMGGGNEQFF,0,4,1,4
TRBV6-2/3/5/6,TRBJ1-1,CASSPSDGNTEAFF,0,4,1,4
TRBV7-9,TRBJ1-2,CASSPLSMGDGYTF,0,4,1,4
TRBV7-2,TRBJ2-5,CASSPGGRQETQYF,0,4,1,4
TRBV7-3,TRBJ2-2,CASSPNGGTGELFF,0,4,1,4
TRBV6-2/3/5/6,TRBJ2-1,CASSRDSERLGQFF,0,4,1,4
TRBV7-9,TRBJ1-3,CASSRDRGQDTIYF,0,4,1,4
TRBV3-1,TRBJ1-1,CASSHPPGSTEAFF,0,4,1,4
TRBV3-1,TRBJ2-2,CASSQLRNTGELFF,0,4,1,4
TRBV3-1,TRBJ2-7,CASSQAGVSYEQYF,0,4,1,4
TRBV3-1,TRBJ2-2,CASSQGRVGGELFF,0,4,1,4
TRBV4-2,TRBJ2-1,CASSQDGGSDEQFF,0,4,1,4
TRBV9,TRBJ2-2,CASSVEIDTGELFF,0,4,1,4
TRBV11-3,TRBJ2-3,CASSVQSGSDTQYF,0,4,1,4
TRBV9,TRBJ2-7,CASSVAEGLGQQYF,0,4,1,4
TRBV3-1,TRBJ2-7,CASSAGTGPYEQYF,0,4,1,4
TRBV2,TRBJ2-1,CASSGLAGFGEQFF,0,4,1,4
TRBV7-2,TRBJ2-7,CASSTVGAGAEQYF,0,4,1,4
TRBV7-2,TRBJ2-3,CASSTDSSTDTQYF,0,4,1,4
TRBV5-4,TRBJ2-1,CASSKREGDNEQFF,0,4,1,4
TRBV6-2/3/5/6,TRBJ2-3,CASRWSTSTDTQYF,0,4,1,4
TRBV7-9,TRBJ2-1,CASRLGPNHNEQFF,0,4,1,4
TRBV12-3/4,TRBJ2-7,CASRPGTFRGEQYF,0,4,1,4
TRBV2,TRBJ2-7,CASRPGLLTYEQYF,0,4,1,4
TRBV5-4,TRBJ1-2,CASRPGQPNYGYTF,0,4,1,4
TRBV12-3/4,TRBJ2-3,CASRGDYSTDTQYF,0,4,1,4
TRBV28,TRBJ2-7,CASRGTGGPYEQYF,0,4,1,4
TRBV7-2,TRBJ2-5,CASRLGGLEETQYF,0,4,1,4
TRBV6-2/3/5/6,TRBJ2-1,CASRPRPPGNEQFF,0,4,1,4
TRBV27,TRBJ1-2,CASRDRGSYYGYTF,0,4,1,4
TRBV12-3/4,TRBJ2-5,CASRRDRGGETQYF,0,4,1,4
TRBV6-2/3/5/6,TRBJ1-4,CASKPGATNEKLFF,0,4,1,4
TRBV12-3/4,TRBJ2-1,CAIRGGNAYNEQFF,0,4,1,4
TRBV5-1,TRBJ2-2,CASSGTSGTGELFF,0,4,1,4
TRBV10-2,TRBJ1-5,CASTDRDRNQPQHF,0,4,1,4
TRBV5-1,TRBJ2-1,CASSRLAEGNEQFF,0,4,1,4
TRBV10-2,TRBJ2-2,CASSENPNTGELFF,0,4,1,4
TRBV5-1,TRBJ1-2,CASSLSPTREGYTF,0,4,1,4
TRBV5-1,TRBJ1-2,CASSLVTGGYGYTF,0,4,1,4
TRBV5-1,TRBJ2-3,CASSLDGGPDTQYF,0,4,1,4
TRBV5-1,TRBJ2-5,CASSLDSGSETQYF,0,4,1,4
TRBV5-1,TRBJ2-1,CASSLETVYNEQFF,0,4,1,4
TRBV5-1,TRBJ2-7,CASSLKPPDLEQYF,0,4,1,4
TRBV5-1,TRBJ2-1,CASSLLAGGGEQFF,0,4,1,4
TRBV7-9,TRBJ2-7,CASSLPRDTYEQYF,0,4,1,4
TRBV5-1,TRBJ1-5,CASSLQGAGQPQHF,0,4,1,4
TRBV5-1,TRBJ2-7,CASSSASGNHEQYF,0,4,1,4
TRBV5-1,TRBJ1-6,CASSSTGRNSPLHF,0,4,1,4
TRBV5-1,TRBJ2-3,CASSSGTRTDTQYF,0,4,1,4
TRBV5-1,TRBJ1-1,CASSSGTVNTEAFF,0,4,1,4
TRBV5-1,TRBJ1-5,CASSSGQGGQPQHF,0,4,1,4
TRBV5-1,TRBJ2-7,CASSWATGTYEQYF,0,4,1,4
TRBV5-1,TRBJ2-1,CASSYSGTRDEQFF,0,4,1,4
TRBV5-1,TRBJ2-5,CASSLSTDSETQYF,0,4,1,4
TRBV5-1,TRBJ2-3,CASSPGLHTDTQYF,0,4,1,4
TRBV5-1,TRBJ2-7,CASSPQVGGDEQYF,0,4,1,4
TRBV5-1,TRBJ1-3,CASSPGAVGNTIYS,0,4,1,4
TRBV5-1,TRBJ2-1,CASSRLGVNDEQFF,0,4,1,4
TRBV5-1,TRBJ2-7,CASSKGQGAHEQYF,0,4,1,4
TRBV28,TRBJ2-2,CASRLRQITGELFF,0,4,1,4
TRBV5-1,TRBJ2-5,CARKGLGGQETQYF,0,4,1,4
TRBV20-1,TRBJ2-1,CSAFPGLASNEQFF,0,4,1,4
TRBV20-1,TRBJ2-3,CSALGGSGTDTQYF,0,4,1,4
TRBV20-1,TRBJ2-5,CSAQSPQGQETQYF,0,4,1,4
TRBV20-1,TRBJ2-5,CSAGAGTGGRTQYF,0,4,1,4
TRBV20-1,TRBJ2-2,CSAISGGRGRELFF,0,4,1,4
TRBV20-1,TRBJ2-1,CSASSLDYYNEQFF,0,4,1,4
TRBV20-1,TRBJ2-3,CSARGELATDTQYF,0,4,1,4
TRBV20-1,TRBJ2-3,CSARTRGVMDTQYF,0,4,1,4
TRBV20-1,TRBJ2-5,CSARGQEGRETQYF,0,4,1,4
TRBV20-1,TRBJ2-7,CSANKVDGPYEQYF,0,4,1,4
TRBV20-1,TRBJ2-3,CSAPSSGSPDTQYF,0,4,1,4
TRBV20-1,TRBJ2-7,CSATDLSGSDEQYF,0,4,1,4
TRBV20-1,TRBJ2-3,CSAGDQGGTDTQYF,0,4,1,4
TRBV29-1,TRBJ1-1,CSVQRTVVNTEAFF,0,4,1,4
TRBV29-1,TRBJ2-2,CSVVPANQGGELFF,0,4,1,4
TRBV29-1,TRBJ2-1,CSVEGGRRNNEQFF,0,4,1,4
TRBV29-1,TRBJ2-7,CSVLVAGISYEQYF,0,4,1,4
TRBV29-1,TRBJ2-3,CSAGAGGGTDTQYF,0,4,1,4
TRBV29-1,TRBJ1-1,CSAKTGTSNTEAFF,0,4,1,4
TRBV7-4,TRBJ2-7,RASSQKRGGYEQYF,0,4,1,4
TRBV29-1,TRBJ1-2,RSVTDRGAIYGHTS,0,4,1,4
TRBV5-6,TRBJ1-2,GASSRDRVLGGYTF,0,4,1,4
TRBV19,TRBJ2-1,CAFGTSGIGEQFF,0,4,1,4
TRBV30,TRBJ2-1,CAWSVWLGNEQFF,0,4,1,4
TRBV30,TRBJ1-5,CAWSVRSGQPQHY,0,4,1,4
TRBV30,TRBJ2-7,CAWSAGRTYEQYF,0,4,1,4
TRBV30,TRBJ1-2,CAWSRDFWVPYTF,0,4,1,4
TRBV30,TRBJ1-2,CAWNEGMNYGYTF,0,4,1,4
TRBV30,TRBJ1-5,CALSQGDNQPQHF,0,4,1,4
TRBV19,TRBJ2-1,CAGNGGLDNEQFF,0,4,1,4
TRBV10-3,TRBJ2-7,CAISGGTTSEQYF,0,4,1,4
TRBV24-1,TRBJ2-1,CATQDSSYNGQFF,0,4,1,4
TRBV7-9,TRBJ2-3,CATDSGSTDTQYF,0,4,1,4
TRBV24-1,TRBJ2-2,CATSDLNTGELFF,0,4,1,4
TRBV24-1,TRBJ2-3,CATSEPATDTQYF,0,4,1,4
TRBV10-3,TRBJ2-1,CATGTSGNNEQFF,0,4,1,4
TRBV19,TRBJ2-2,CASTIRTAGELFF,0,4,1,4
TRBV19,TRBJ2-7,CASSGYGIREQYI,0,4,1,4
TRBV19,TRBJ2-7,CASSYRASYEQYF,0,4,1,4
TRBV19,TRBJ2-5,CASSRLTQETQYF,0,4,1,4
TRBV3-1,TRBJ2-5,CASSQRNQETQYF,0,4,1,4
TRBV19,TRBJ2-1,CASSGSSYNEQFF,0,4,1,4
TRBV19,TRBJ2-1,CASSNPGGNEQFF,0,4,1,4
TRBV18,TRBJ2-1,CASSPLEYNEQFF,0,4,1,4
TRBV18,TRBJ2-1,CASSPPGENEQFF,0,4,1,4
TRBV6-2/3/5/6,TRBJ2-1,CASHPQDNNEQFF,0,4,1,4
TRBV7-9,TRBJ1-3,CASAPGTGNTIYF,0,4,1,4
TRBV5-5,TRBJ2-7,CASGYVLGDEKYF,0,4,1,4
TRBV12-3/4,TRBJ1-4,CASGLQNSEKLFF,0,4,1,4
TRBV7-6,TRBJ1-5,CASGKEPNQPQHF,0,4,1,4
TRBV2,TRBJ2-1,CASDRDFNNEQFF,0,4,1,4
TRBV6-2/3/5/6,TRBJ2-7,CASIHPGSYEQYF,0,4,1,4
TRBV6-2/3/5/6,TRBJ2-3,CASISGSTDTQHF,0,4,1,4
TRBV14,TRBJ2-7,CASTLAGGGEQYF,0,4,1,4
TRBV7-9,TRBJ2-2,CASTNRGDGELFF,0,4,1,4
TRBV2,TRBJ1-1,CASTGQPNTEAFF,0,4,1,4
TRBV28,TRBJ2-5,CASTSFVPETQYF,0,4,1,4
TRBV28,TRBJ2-3,CASSFYSTPTQYF,0,4,1,4
TRBV27,TRBJ2-1,CASSFGLANEQFF,0,4,1,4
TRBV12-3/4,TRBJ1-2,CASSLGGIYGYTF,0,4,1,4
TRBV28,TRBJ2-7,CASSSQGSYEQYF,0,4,1,4
TRBV11-3,TRBJ1-1,CASSSPGNTEAFF,0,6,1,6
TRBV6-1,TRBJ2-2,CASSGVNTGELFF,0,4,1,4
TRBV7-2,TRBJ2-7,CASSFGLAYEQYF,0,4,1,4
TRBV7-6,TRBJ2-7,CASSLGTSAQQYF,0,4,1,4
TRBV7-9,TRBJ2-3,CASSLDLAATQYF,0,4,1,4
TRBV11-2,TRBJ2-1,CASSLVPNNEQFF,0,4,1,4
TRBV7-6,TRBJ2-7,CASSLGRTYEQYF,0,4,1,4
TRBV7-9,TRBJ2-5,CASSLGVQETQYF,0,4,1,4
TRBV11-2,TRBJ2-1,CASSLGTGGEQFF,0,4,1,4
TRBV6-2/3/5/6,TRBJ1-1,CASSLTANTEAFF,0,4,1,4
TRBV11-2,TRBJ2-1,CASSLNPKNEQFF,0,4,1,4
TRBV5-4,TRBJ2-1,CASSSGTIDEQFF,0,4,1,4
TRBV7-7,TRBJ1-1,CASSSTENTEAFF,0,4,1,4
TRBV7-9,TRBJ2-1,CASSSTANDEQFF,0,4,1,4
TRBV7-9,TRBJ2-1,CASSYRESSEQFF,0,4,1,4
TRBV3-1,TRBJ1-5,CASSLNSDQPQHF,0,4,1,4
TRBV6-4,TRBJ2-7,CASSPGKIYEQYF,0,4,1,4
TRBV7-9,TRBJ2-7,CASSPRGPYEQYF,0,4,1,4
TRBV5-6,TRBJ2-5,CASSPLATETQYF,0,4,1,4
TRBV7-9,TRBJ1-2,CASSQETGIGYTF,0,4,1,4
TRBV3-1,TRBJ1-5,CASSQDELSRQHF,0,4,1,4
TRBV11-2,TRBJ2-7,CASSQTEGGEQYF,0,4,1,4
TRBV2,TRBJ2-1,CASSGDSDNEQFF,0,4,1,4
TRBV14,TRBJ2-5,CASSGQNQETQYF,0,4,1,4
TRBV12-3/4,TRBJ2-5,CASSRTGKETQYF,0,4,1,4
TRBV6-2/3/5/6,TRBJ1-2,CASRQDRRYGYTF,0,4,1,4
TRBV6-2/3/5/6,TRBJ2-5,CASRGRFRETQYF,0,4,1,4
TRBV7-2,TRBJ2-4,CASRGGDKNIQYF,0,4,1,4
TRBV6-2/3/5/6,TRBJ2-1,CASRLSQGGEQFF,0,4,1,4
TRBV6-4,TRBJ2-3,CASRRLSTDTQYF,0,4,1,4
TRBV6-2/3/5/6,TRBJ2-2,CASNRGVPGELFF,0,4,1,4
TRBV5-1,TRBJ2-7,CASFEAGAPEQYF,0,4,1,4
TRBV5-1,TRBJ1-4,CASRRAGKEKLFF,0,4,1,4
TRBV5-1,TRBJ1-2,CASSLVSSYGYTF,0,4,1,4
TRBV5-1,TRBJ2-6,CASSSIGANVLTF,0,4,1,4
TRBV5-1,TRBJ2-7,CASSSIGAYEQYF,0,4,1,4
TRBV5-1,TRBJ2-1,CASSRLLNHEQFF,0,4,1,4
TRBV5-1,TRBJ2-5,CASSNPTKETQYF,0,4,1,4
TRBV29-1,TRBJ2-2,CMGGQGGYGELFF,0,4,1,4
TRBV20-1,TRBJ1-5,CSVNQGSGQPQHF,0,4,1,4
TRBV20-1,TRBJ2-7,CSAGSDYVSEQYF,0,4,1,4
TRBV20-1,TRBJ2-5,CSAEGRTPETQYF,0,4,1,4
TRBV20-1,TRBJ2-3,CSASAYQGDTQYF,0,4,1,4
TRBV20-1,TRBJ2-3,CSARDRTADTQYF,0,4,1,4
TRBV20-1,TRBJ1-2,CSARDTGKGWGTF,0,4,1,4
TRBV20-1,TRBJ2-3,CSAKSGNTDTQYF,0,4,1,4
TRBV20-1,TRBJ2-7,CSAGQGAGYEQYF,0,4,1,4
TRBV20-1,TRBJ2-1,CSALTDRDNEQFF,0,4,1,4
TRBV29-1,TRBJ2-1,CSWGGGFYNEQFF,0,4,1,4
TRBV29-1,TRBJ2-1,CSVEAYPGNEQFF,0,4,1,4
TRBV29-1,TRBJ2-5,CSVEGGQSETQYF,0,4,1,4
TRBV29-1,TRBJ1-5,CSVSPTLEQPQHF,0,4,1,4
TRBV29-1,TRBJ2-2,CSGGQGRRGELFF,0,4,1,4
TRBV20-1,TRBJ2-1,CRASRGARLEHFF,0,4,1,4
TRBV6-4,TRBJ2-5,SASNKREETQYF,0,4,1,4
TRBV30,TRBJ1-1,CAWMPQVAEAFF,0,4,1,4
TRBV10-3,TRBJ2-5,CAISDSGETQYF,0,4,1,4
TRBV24-1,TRBJ2-7,CATESKVYEQYF,0,4,1,4
TRBV19,TRBJ1-2,CASSKGASGYTF,0,4,1,4
TRBV18,TRBJ2-2,CASSPSIGELFF,0,4,1,4
TRBV12-3/4,TRBJ2-7,CASGSRVGEQYF,0,4,1,4
TRBV28,TRBJ2-7,CASGVAGYEQYF,0,4,1,4
TRBV7-2,TRBJ2-7,CASTWGSREQYF,0,4,1,4
TRBV12-3/4,TRBJ2-7,CASSFLGDEQYF,0,4,1,4
TRBV12-3/4,TRBJ2-7,CASSFWRGEQYS,0,4,1,4
TRBV12-3/4,TRBJ1-5,CASSLNDQPQHF,0,4,1,4
TRBV6-2/3/5/6,TRBJ2-3,CASSYEGDTQYF,0,4,1,4
TRBV6-2/3/5/6,TRBJ2-7,CASSYSGHEQYF,0,4,1,4
TRBV6-2/3/5/6,TRBJ1-1,CASSLDRAEAFF,0,4,1,4
TRBV12-3/4,TRBJ2-3,CASSQSLDTQYF,0,4,1,4
TRBV28,TRBJ2-7,CASSGLIYEQYF,0,4,1,4
TRBV27,TRBJ2-5,CASSGERGTQYF,0,4,1,4
TRBV2,TRBJ2-7,CASSERDYEQYF,0,4,1,4
TRBV7-8,TRBJ2-7,CASSFSTSDGYF,0,4,1,4
TRBV5-4,TRBJ1-1,CASSLEAGEAFF,0,4,1,4
TRBV7-9,TRBJ2-7,CASSLSSYEQYF,0,4,1,4
TRBV7-9,TRBJ2-7,CASSLVPGGQYF,0,4,1,4
TRBV7-9,TRBJ1-1,CASSLVGGEAFF,0,4,1,4
TRBV11-2,TRBJ1-1,CASSLVGDEAFF,0,4,1,4
TRBV7-3,TRBJ2-3,CASSSQGSPQYF,0,4,1,4
TRBV3-1,TRBJ2-3,CASSPHRDTQYF,0,4,1,4
TRBV7-9,TRBJ2-1,CASSPSAYEQFF,0,4,1,4
TRBV7-2,TRBJ2-7,CASSPNLYEQYF,0,4,1,4
TRBV3-1,TRBJ2-2,CASSGDPGELFF,0,4,1,4
TRBV13,TRBJ2-3,CASSGSPDTQFF,0,4,1,4
TRBV7-9,TRBJ2-3,CASSMITDTQYF,0,4,1,4
TRBV5-5,TRBJ2-2,CASSTVSGELFF,0,4,1,4
TRBV12-3/4,TRBJ1-1,CASRYRNTEAFF,0,4,1,4
TRBV28,TRBJ2-2,CASRFQSGELFF,0,4,1,4
TRBV5-1,TRBJ2-2,CASSFSSGELFF,0,4,1,4
TRBV4-1,TRBJ1-1,CASSQPSTEAFF,0,4,1,4
TRBV5-1,TRBJ2-5,CASRASEETQYF,0,4,1,4
TRBV20-1,TRBJ2-1,CSARGDFDEQFF,0,4,1,4
TRBV29-1,TRBJ1-1,CSVRDRNTEAFF,0,4,1,4
TRBV29-1,TRBJ2-7,CSVAGRLHEQYF,0,4,1,4
TRBV29-1,TRBJ1-1,CSVGLGLTEAFF,0,4,1,4
TRBV29-1,TRBJ2-3,CSVGGGTDTQYF,0,4,1,4
TRBV29-1,TRBJ1-1,CSVGTDNTEAFF,0,4,1,4
TRBV29-1,TRBJ2-7,CSVELTDYEQYF,0,4,1,4
TRBV29-1,TRBJ2-7,CSVERQGYEQYF,0,4,1,4
TRBV29-1,TRBJ2-5,CSVTGGQETQYF,0,4,1,4
TRBV29-1,TRBJ1-2,CSAGEGNYGYTF,0,4,1,4
TRBV29-1,TRBJ2-1,CSATDFYNEQFF,0,4,1,4
TRBV30,TRBJ2-4,CASGGRAIQYF,0,4,1,4
TRBV30,TRBJ1-2,CAWSVGSGYTF,0,4,1,4
TRBV30,TRBJ1-1,CAWRSTGRAFL,0,4,1,4
TRBV2,TRBJ2-3,CAGASTDTQYY,0,4,1,4
TRBV10-3,TRBJ2-5,CAISEGETQYF,0,4,1,4
TRBV10-3,TRBJ2-1,CAINAGTGQFF,0,4,1,4
TRBV2,TRBJ2-7,CASRMGAEQYF,0,4,1,4
TRBV28,TRBJ2-4,CASTLGGIQYF,0,4,1,4
TRBV6-2/3/5/6,TRBJ2-5,CASSSQETQYF,0,4,1,4
TRBV11-2,TRBJ1-1,CASSFHWAAIF,0,4,1,4
TRBV7-9,TRBJ2-5,CASSLRETQYF,0,4,1,4
TRBV13,TRBJ2-7,CASSLVDEQYF,0,4,1,4
TRBV5-6,TRBJ2-7,CASSSRFEQYF,0,4,1,4
TRBV7-2,TRBJ2-3,CASSPHDTQYF,0,4,1,4
TRBV12-3/4,TRBJ2-1,CASSTWDEQFF,0,4,1,4
TRBV12-3/4,TRBJ1-2,CASRGDYGYTF,0,4,1,4
TRBV29-1,TRBJ2-1,CHVGGGGEQFF,0,4,1,4
TRBV20-1,TRBJ2-7,CSLQSSYEQYF,0,4,1,4
TRBV29-1,TRBJ2-5,CSALQGETQYF,0,4,1,4
TRBV20-1,TRBJ2-5,CSARPGETQYF,0,4,1,4
TRBV20-1,TRBJ2-1,CSAEGVNEQFF,0,4,1,4
TRBV29-1,TRBJ2-1,CSVVWGNEQFF,0,4,1,4
TRBV29-1,TRBJ2-1,CSVNPYNEQFF,0,4,1,4
TRBV20-1,TRBJ2-1,CSATQNNEQFF,0,4,1,4
TRBV25-1,TRBJ2-1,CATSRGEQFF,0,4,1,4
TRBV6-4,TRBJ1-4,CASSDRALFF,0,4,1,4
TRBV6-2/3/5/6,TRBJ2-1,CASSSSGTSGRYYSFDEQFF,0,4,1,4
TRBV18,TRBJ2-1,CASSPRGLAGDSHNEQFF,0,4,1,4
TRBV18,TRBJ2-1,CASSPPGTRTSYNEQFF,0,4,1,4
TRBV9,TRBJ2-1,CASSVDAGGSSYNEQFF,0,4,1,4
TRBV7-9,TRBJ2-2,CASSTTGTGVRTGELFF,0,4,1,4
TRBV7-2,TRBJ2-7,CASSLTVGSGRYGQYF,0,4,1,4
TRBV7-9,TRBJ2-3,CASSLGGVPWTDTQYF,0,4,1,4
TRBV9,TRBJ2-1,CASSVRLAGEGSEQFF,0,4,1,4
TRBV27,TRBJ1-1,CASRNYRDTLGTEAFF,0,4,1,4
TRBV19,TRBJ2-3,CASSRGNINPDTQYF,0,4,1,4
TRBV19,TRBJ2-6,CASRTGFPGANVLTF,0,4,1,4
TRBV18,TRBJ1-1,CASSPPPVGNTESFF,0,4,1,4
TRBV12-3/4,TRBJ1-6,CASSPGRGNNSPLHF,0,4,1,4
TRBV11-2,TRBJ2-2,CASSTRVYYVGELFF,0,4,1,4
TRBV5-4,TRBJ1-1,CASSSLGGMVAEAFF,0,4,1,4
TRBV4-1,TRBJ1-3,CASSRRTGTGNTIYF,0,4,1,4
TRBV4-1,TRBJ1-2,CASSQESSEVYGYAF,0,4,1,4
TRBV29-1,TRBJ2-4,CSVEGGRGVGNIQYF,0,4,1,4
TRBV5-1,TRBJ2-3,CASSLRADSDTQYF,0,4,1,4
TRBV29-1,TRBJ2-3,CSVEADGNTDTQYF,0,4,1,4
TRBV12-3/4,TRBJ2-1,RASRTSGSFDEQFF,0,4,1,4
TRBV10-3,TRBJ2-5,CAISGAGQETQYF,0,4,1,4
TRBV2,TRBJ2-1,CASGLGVRNEQFF,0,4,1,4
TRBV7-9,TRBJ2-7,CASSLRESGEQYF,0,4,1,4
TRBV28,TRBJ2-7,CASSSAGGREQYF,0,4,1,4
TRBV20-1,TRBJ2-1,CSARRGDNEQFF,0,4,1,4
TRBV5-6,TRBJ2-7,CASSPWSRRGTGAFSTSGTSYEQYF,0,3,1,3
TRBV3-1,TRBJ2-1,CASSPAGDEAPGLAGFSFGEQFF,0,3,1,3
TRBV29-1,TRBJ2-1,CSVEDFHPRTSGSLESYNEQFF,0,3,1,3
TRBV6-2/3/5/6,TRBJ2-3,CASSYRPGLAGGPRSTDTQYF,0,3,1,3
TRBV7-9,TRBJ2-6,CASSLPVHQGTSGGANVLTF,0,3,1,3
TRBV6-1,TRBJ2-2,CASRENPGTVREAGPGELFF,0,3,1,3
TRBV20-1,TRBJ2-6,CSAPTSGRASAGSGANVLTF,0,3,1,3
TRBV20-1,TRBJ2-1,CSASPGLAATTRLNLYEQFF,0,3,1,3
TRBV7-2,TRBJ2-1,CAGSTSGVLAGGTHNEQFF,0,3,1,3
TRBV19,TRBJ2-7,CASSRKDSGLAGSSYEQYF,0,3,1,3
TRBV18,TRBJ2-1,CASSSQGWLAGDSYNEQFF,0,3,1,3
TRBV27,TRBJ2-1,CASMKGLAGYSGTINEQFF,0,3,1,3
TRBV5-6,TRBJ2-1,CASSFFGTSGRTRDNEQFF,0,3,1,3
TRBV7-9,TRBJ2-3,CASSFPAGEGRTSTDTQYF,0,3,1,3
TRBV11-2,TRBJ2-4,CASSLEALTSRVAKNIQYF,0,3,1,3
TRBV11-2,TRBJ2-3,CASSSTGASGRAGADTQYF,0,3,1,3
TRBV5-1,TRBJ2-2,CASSLMTGGPRGNTGELFF,0,3,1,3
TRBV20-1,TRBJ2-3,CSARDPGLAGGRSTDTQYF,0,3,1,3
TRBV30,TRBJ2-1,CAWRNDRAGTSGYNEQFF,0,3,1,3
TRBV24-1,TRBJ2-1,CATSVPSGQGAGEHEQFF,0,3,1,3
TRBV24-1,TRBJ2-2,CATSDLGLAGGGTGELFF,0,3,1,3
TRBV15,TRBJ2-2,CATSSLGGKRPNTGELFF,0,3,1,3
TRBV19,TRBJ1-5,CASSPGRDRGYSNQPQHF,0,3,1,3
TRBV18,TRBJ2-3,CASSPPWDRPRQADTQYF,0,3,1,3
TRBV18,TRBJ2-1,CASSPRQEAGGPVGEQFF,0,3,1,3
TRBV9,TRBJ2-1,CASTRSGSGWGNLNEQFF,0,3,1,3
TRBV28,TRBJ2-7,CASSPKITTGAFSYEQYF,0,3,1,3
TRBV7-9,TRBJ2-1,CASSSGLAGLSSYNEQFF,0,3,1,3
TRBV5-6,TRBJ2-1,CASSWWGPSGRKANEQFF,0,3,1,3
TRBV5-6,TRBJ2-2,CASSPSLRGVWDTGELLF,0,3,1,3
TRBV3-1,TRBJ2-2,CASSQGGLAAINTGELFF,0,3,1,3
TRBV7-9,TRBJ2-2,CASSDSTSGRRRTGELFF,0,3,1,3
TRBV5-1,TRBJ2-7,CASSLAPKRTSGGYEQYF,0,3,1,3
TRBV5-1,TRBJ2-5,CASSLAGGSGAFQETQYF,0,3,1,3
TRBV4-1,TRBJ2-1,CASSQVGGQGLSYNEQFF,0,3,1,3
TRBV5-1,TRBJ2-1,CASSTGLAGDLSVDEQFF,0,3,1,3
TRBV29-1,TRBJ2-1,CSVEDPLERGLLGNEQFF,0,3,1,3
TRBV29-1,TRBJ2-5,CSVEDTAPDTVALGTQYF,0,3,1,3
TRBV30,TRBJ1-5,CAWSDGGGGVGNQPQHF,0,3,1,3
TRBV30,TRBJ1-1,CAWRVGQGIFVNTEAFF,0,3,1,3
TRBV28,TRBJ2-7,CALPRSSDGTGTYEQYF,0,3,1,3
TRBV10-3,TRBJ2-6,CAISETGGNSGANVLTF,0,3,1,3
TRBV19,TRBJ2-3,CASSEGGLAMSTDTQYF,0,3,1,3
TRBV19,TRBJ2-1,CASSISRSGGAYNVQFF,0,3,1,3
TRBV19,TRBJ2-2,CASSADRAAENTRELFF,0,3,1,3
TRBV19,TRBJ1-1,CASRDPLSQGANTEAFF,0,3,1,3
TRBV18,TRBJ1-5,CASSPRERGQGTQPQHF,0,3,1,3
TRBV18,TRBJ2-5,CASSPPSRRRVGETQYF,0,3,1,3
TRBV18,TRBJ2-3,CASSPVMGEPSTDTQYF,0,3,1,3
TRBV19,TRBJ1-1,CASLKKRPGTGVGEAFF,0,3,1,3
TRBV18,TRBJ2-2,CASALGMVSTNTGELFF,0,3,1,3
TRBV2,TRBJ2-1,CASIKGLAGARHNEQFF,0,3,1,3
TRBV6-2/3/5/6,TRBJ2-1,CASSFSPGTGVQDEQFF,0,3,1,3
TRBV6-2/3/5/6,TRBJ2-7,CASSFPQGGRIFYEQYF,0,3,1,3
TRBV27,TRBJ2-1,CASSFTSGSSTYNEQFF,0,3,1,3
TRBV28,TRBJ2-3,CASSLVSSGRQGDTQYF,0,3,1,3
TRBV27,TRBJ2-3,CASSLWWSGKNTDTQYF,0,3,1,3
TRBV28,TRBJ2-5,CASSSRRLAGGWETQYF,0,3,1,3
TRBV3-1,TRBJ1-2,CASSLTSTGRFFYGYTF,0,3,1,3
TRBV6-2/3/5/6,TRBJ1-1,CASSPGQGLGMGTEAFF,0,3,1,3
TRBV6-1,TRBJ2-6,CASSAFGVLTGANVLTF,0,3,1,3
TRBV6-4,TRBJ2-1,CASSDLVGGPSNNEQFF,0,3,1,3
TRBV7-2,TRBJ2-1,CASSTLPSGSSYNEQFF,0,3,1,3
TRBV6-2/3/5/6,TRBJ2-1,CASSRGLAGGGYNEQFF,0,3,1,3
TRBV11-2,TRBJ2-2,CASSLVGRRRSTGELFF,0,3,1,3
TRBV7-2,TRBJ2-2,CASSLVAGVRYTGELFF,0,3,1,3
TRBV7-6,TRBJ2-7,CASSLAPGTGSSYEQYF,0,3,1,3
TRBV7-9,TRBJ2-7,CASSLAKGSGRIDEQYF,0,3,1,3
TRBV7-6,TRBJ2-7,CASSLGIGASGNYEQYF,0,3,1,3
TRBV7-6,TRBJ1-1,CASSLEPPTPGNTEAFF,0,3,1,3
TRBV6-2/3/5/6,TRBJ2-7,CASSSDGLAGRAYEQYF,0,3,1,3
TRBV13,TRBJ2-2,CASSPPRTSGNTGELFF,0,3,1,3
TRBV5-6,TRBJ1-2,CASSPDGFKGANYGYTF,0,3,1,3
TRBV3-1,TRBJ2-1,CASSPGLAGAAYNEQFF,0,3,1,3
TRBV9,TRBJ2-7,CASSPAPGLASSYEQYF,0,3,1,3
TRBV14,TRBJ1-1,CASSRQPGLKSDTEAFF,0,3,1,3
TRBV3-1,TRBJ1-4,CASSQSHARLSNEKLFF,0,3,1,3
TRBV4-2,TRBJ2-7,CASSQEGLAGGTYEQYF,0,3,1,3
TRBV14,TRBJ2-1,CASSQESRLPLYNEQFF,0,3,1,3
TRBV9,TRBJ2-3,CASSVLAGQKSTGTQYF,0,3,1,3
TRBV7-2,TRBJ2-7,CASSVAAGATPGYEQYF,0,3,1,3
TRBV13,TRBJ2-3,CASSASGTSGITDTQYF,0,3,1,3
TRBV6-4,TRBJ2-5,CASSTSRAAGGQETQYF,0,3,1,3
TRBV6-2/3/5/6,TRBJ2-3,CASRHRGADTSTDTQYF,0,3,1,3
TRBV28,TRBJ2-5,CTSSPAWGTSGRETQYF,0,3,1,3
TRBV29-1,TRBJ2-3,CRVEDLYAPRHADTQYF,0,3,1,3
TRBV5-1,TRBJ2-5,CASSFRGQLLHQETQYF,0,3,1,3
TRBV5-1,TRBJ2-7,CASSLGQGLHLSYEQYF,0,3,1,3
TRBV4-1,TRBJ2-1,CASSQGLTSGSPSEQFF,0,3,1,3
TRBV4-1,TRBJ1-2,CASSQDSLTGANYGYTF,0,3,1,3
TRBV4-1,TRBJ2-1,CASSEVLAGVPYNEQFF,0,3,1,3
TRBV5-1,TRBJ2-5,CASRLEGSSKYQETQYF,0,3,1,3
TRBV20-1,TRBJ2-6,CSASPLQGIAGANVLTF,0,3,1,3
TRBV20-1,TRBJ2-3,CSASPGLAGDLTDTQYF,0,3,1,3
TRBV20-1,TRBJ2-1,CSARVLPSSGRYNEQFF,0,3,1,3
TRBV20-1,TRBJ2-7,CSARGGEDGGRRGRQYF,0,3,1,3
TRBV20-1,TRBJ2-1,CSARDQGASGRYGEQFF,0,3,1,3
TRBV20-1,TRBJ2-3,CSAPPRGAKSSTDTQYF,0,3,1,3
TRBV29-1,TRBJ2-7,CSVVASGRSTWNYEQYF,0,3,1,3
TRBV29-1,TRBJ2-1,CSVDWPGTSGFYNEQFF,0,3,1,3
TRBV29-1,TRBJ2-7,CSVEDQLAGAGAYERYF,0,3,1,3
TRBV29-1,TRBJ2-7,CSAVGPPGTGISYEQYF,0,3,1,3
TRBV5-1,TRBJ2-5,RASSSGQGGISGETQYF,0,3,1,3
TRBV4-1,TRBJ2-1,RASSQDVRVDSYNEQFF,0,3,1,3
TRBV28,TRBJ1-3,CVSSALIGYSGNTIYF,0,3,1,3
TRBV12-5,TRBJ2-3,CASGQTSGRAIDTQYF,0,3,1,3
TRBV30,TRBJ2-4,CAWSVRVGTGENIQYF,0,3,1,3
TRBV28,TRBJ2-3,CAGSTQDREVADTQYF,0,3,1,3
TRBV10-3,TRBJ2-7,CAIFPLAGAPSGEQYF,0,3,1,3
TRBV10-3,TRBJ2-1,CAISPRGGPLFNEQFF,0,3,1,3
TRBV24-1,TRBJ2-5,CATSGVLAGSQETQYF,0,3,1,3
TRBV24-1,TRBJ2-1,CATSDSSGRAYNEQFF,0,3,1,3
TRBV24-1,TRBJ2-6,CATSDSRSSGANVLTF,0,3,1,3
TRBV24-1,TRBJ2-5,CATSEPGTGDEETQYF,0,3,1,3
TRBV18,TRBJ2-5,CASSPGVGSTVETQYF,0,3,1,3
TRBV19,TRBJ1-5,CASRVRDRDSNQPQHF,0,3,1,3
TRBV19,TRBJ2-3,CASSGIADGSPDTQYF,0,3,1,3
TRBV19,TRBJ2-2,CASSILAGVVGGELFF,0,3,1,3
TRBV19,TRBJ1-6,CASSIEYRVENSPLHF,0,3,1,3
TRBV19,TRBJ2-1,CASRTLRTSGDNEQFF,0,3,1,3
TRBV19,TRBJ1-5,CASRKETGGINQPQHF,0,3,1,3
TRBV6-2/3/5/6,TRBJ2-7,CASSRPPRDRDYEQYF,0,3,1,3
TRBV18,TRBJ2-1,CASSLSSVSSYNEQFF,0,3,1,3
TRBV18,TRBJ1-5,CASSPQGRGGEQPQHF,0,3,1,3
TRBV18,TRBJ2-5,CASSPVGTGGKETQYF,0,3,1,3
TRBV18,TRBJ2-7,CASSPTGVGSSYEQYF,0,3,1,3
TRBV18,TRBJ2-1,CASSPPGAVVGNEQFF,0,3,1,3
TRBV18,TRBJ2-7,CASSVFTGTASYEQYF,0,3,1,3
TRBV6-2/3/5/6,TRBJ1-4,CASGYSLQGMVEKLFF,0,3,1,3
TRBV12-3/4,TRBJ2-1,CASTLVWGIGGNEQFF,0,3,1,3
TRBV7-6,TRBJ2-1,CASTGSETSSYNEQFF,0,3,1,3
TRBV12-3/4,TRBJ2-2,CASSFWTDENAGELFF,0,3,1,3
TRBV28,TRBJ2-7,CASSFKHPFGTYEQYF,0,3,1,3
TRBV10-2,TRBJ2-3,CASSFGSGRAADTQYF,0,3,1,3
TRBV12-3/4,TRBJ1-2,CASSLSSRQGSAGYTF,0,3,1,3
TRBV27,TRBJ2-5,CASSLSCPTEKETQYF,0,3,1,3
TRBV28,TRBJ2-7,CASSLGGGWSSYEQYF,0,3,1,3
TRBV12-3/4,TRBJ2-2,CASSLEGAANTGELFF,0,3,1,3
TRBV28,TRBJ2-1,CASSLISGDRANEQFF,0,3,1,3
TRBV28,TRBJ2-5,CASSSYRPTGEETQYF,0,3,1,3
TRBV28,TRBJ2-5,CASSSPGGPFGETQYF,0,3,1,3
TRBV28,TRBJ2-3,CASSSSGTGWADTQYF,0,3,1,3
TRBV28,TRBJ2-1,CASSSGPGLLANEQFF,0,3,1,3
TRBV6-2/3/5/6,TRBJ2-1,CASSYPTGRSYNEQFF,0,3,1,3
TRBV6-2/3/5/6,TRBJ2-1,CASSYSGLAGGREQFF,0,3,1,3
TRBV6-2/3/5/6,TRBJ2-1,CASSYSGTGVTNEQFF,0,3,1,3
TRBV6-2/3/5/6,TRBJ2-3,CASSYAGQGFRDTQYF,0,3,1,3
TRBV7-7,TRBJ2-1,CASSLRAVSGSNEQFF,0,3,1,3
TRBV28,TRBJ1-4,CASSPGEGLRREKLFF,0,3,1,3
TRBV6-2/3/5/6,TRBJ2-7,CASSPTGLAGGRVQYF,0,3,1,3
TRBV6-2/3/5/6,TRBJ2-2,CASSHSAGTDAGELFF,0,3,1,3
TRBV6-1,TRBJ2-4,CASSGGQAIAKNIQYF,0,3,1,3
TRBV25-1,TRBJ2-1,CASSGQTSGVYNEQFF,0,3,1,3
TRBV6-2/3/5/6,TRBJ2-2,CASSIVTGPNTGELFF,0,3,1,3
TRBV28,TRBJ2-2,CASSTIAGAQGGELLF,0,3,1,3
TRBV28,TRBJ2-5,CASSTLTGARKETQYF,0,3,1,3
TRBV5-4,TRBJ2-3,CASSLVSGSGADTQYF,0,3,1,3
TRBV5-8,TRBJ2-1,CASSLALQGRHNEQFF,0,3,1,3
TRBV5-6,TRBJ2-7,CASSLALAGMSYEQYF,0,3,1,3
TRBV11-2,TRBJ2-2,CASSLVGGPWAGELFF,0,3,1,3
TRBV7-9,TRBJ2-7,CASSLVGGTATYEQYF,0,3,1,3
TRBV7-9,TRBJ2-3,CASSLAQGTSTDTQYF,0,3,1,3
TRBV7-9,TRBJ2-1,CASSLGSGNLNDEQFF,0,3,1,3
TRBV7-2,TRBJ2-7,CASSLGVPSGPYEQYF,0,3,1,3
TRBV11-3,TRBJ2-1,CASSLGASGTTNEQFF,0,3,1,3
TRBV13,TRBJ2-2,CASSLGLAENTGELFF,0,3,1,3
TRBV11-2,TRBJ2-1,CASSLDLTLGYNEQFF,0,3,1,3
TRBV7-9,TRBJ1-2,CASSLRSGVKIYGYTF,0,3,1,3
TRBV11-1,TRBJ2-3,CASSLRRRRADGPQYF,0,3,1,3
TRBV11-3,TRBJ2-1,CASSSRTSGPYNEQFF,0,3,1,3
TRBV7-6,TRBJ2-5,CASSSIGDRGRETQYF,0,3,1,3
TRBV3-1,TRBJ2-1,CASSSKSGIVSREQFF,0,3,1,3
TRBV7-8,TRBJ2-7,CASSSVGGSAAYEQYF,0,3,1,3
TRBV5-4,TRBJ2-7,CASSSTTSGRSYEQYF,0,3,1,3
TRBV7-9,TRBJ2-5,CASSSTAGTSGETQYF,0,3,1,3
TRBV7-9,TRBJ2-7,CASSWGQAVTRGEQYF,0,3,1,3
TRBV5-4,TRBJ2-6,CASSYSGGAGANVLTF,0,3,1,3
TRBV14,TRBJ2-5,CASSLRPGLGQETQYF,0,3,1,3
TRBV7-2,TRBJ2-3,CASSLYRLAGADTQYF,0,3,1,3
TRBV11-2,TRBJ2-5,CASSLSGLAGEETQYF,0,3,1,3
TRBV11-2,TRBJ2-3,CASSPGTTVRTDTQYF,0,3,1,3
TRBV7-9,TRBJ2-3,CASSPSQGLGTDTQYF,0,3,1,3
TRBV7-2,TRBJ2-4,CASSPRRRGAKNIQYF,0,3,1,3
TRBV4-2,TRBJ1-1,CASSPRGTGVGAEAFF,0,3,1,3
TRBV7-6,TRBJ1-4,CASSPTGRSANEKLFF,0,3,1,3
TRBV28,TRBJ2-3,CASSPAVRQTTDTQYF,0,3,1,3
TRBV7-9,TRBJ1-2,CASSPGQGYKNYGYTF,0,3,1,3
TRBV11-2,TRBJ1-1,CASSPSGGRKNTEAFF,0,3,1,3
TRBV5-8,TRBJ2-7,CASSREGTSGSYEQYF,0,3,1,3
TRBV3-1,TRBJ2-3,CASSHVEGVGTDTQYL,0,3,1,3
TRBV3-1,TRBJ2-1,CASSHTGTGTYNEQFF,0,3,1,3
TRBV3-1,TRBJ1-5,CASSQPFRQGDQPQHF,0,3,1,3
TRBV4-2,TRBJ2-1,CASSQPFTSGNVEQFF,0,3,1,3
TRBV3-1,TRBJ2-4,CASSQVFGLAKDIQYF,0,3,1,3
TRBV3-1,TRBJ2-1,CASSQVETSANNEQFF,0,3,1,3
TRBV3-1,TRBJ1-1,CASSQDSPTGDTEAFF,0,3,1,3
TRBV3-1,TRBJ2-1,CASSQDRRASYNEQFF,0,3,1,3
TRBV9,TRBJ2-5,CASSVAATVHQETQYF,0,3,1,3
TRBV6-1,TRBJ2-1,CASRDRDLSSYNEQFF,0,3,1,3
TRBV6-1,TRBJ2-5,CASREPGPSGQETQYF,0,3,1,3
TRBV28,TRBJ2-1,CASRRGRTSYHNEQFF,0,3,1,3
TRBV6-2/3/5/6,TRBJ2-7,CASRPITGTGTNEQYF,0,3,1,3
TRBV2,TRBJ2-1,CASRALAGSSYNEQFF,0,3,1,3
TRBV27,TRBJ2-3,CASRTYRGLRTDTQYF,0,3,1,3
TRBV28,TRBJ2-7,CASNPGTGGVFGEQYF,0,3,1,3
TRBV20-1,TRBJ1-5,CRGRSGTHLMDQPQHF,0,3,1,3
TRBV5-1,TRBJ2-3,CVSSPNTGSLGDTQYF,0,3,1,3
TRBV5-1,TRBJ2-1,CASVPRPSGAYNEQFF,0,3,1,3
TRBV5-1,TRBJ2-7,CASTFTQRTVPYEQYF,0,3,1,3
TRBV5-1,TRBJ2-1,CASSFRGTSGYNEQFF,0,3,1,3
TRBV5-1,TRBJ2-2,CASSLVTSPNTGELFF,0,3,1,3
TRBV5-6,TRBJ2-5,CASSLAFGTSGETQYF,0,3,1,3
TRBV5-1,TRBJ2-1,CASSLALGGGYNEQFF,0,3,1,3
TRBV5-1,TRBJ2-7,CASSLAKTSGSYEQYF,0,3,1,3
TRBV5-1,TRBJ2-7,CASSLLPGQGNYEQYF,0,3,1,3
TRBV5-1,TRBJ2-1,CASSSLGPVGVNEQFF,0,3,1,3
TRBV5-1,TRBJ2-1,CASSYSGPGGINEQFF,0,3,1,3
TRBV5-1,TRBJ2-1,CASSPSGGSSYNEQFF,0,3,1,3
TRBV11-2,TRBJ2-3,CASSHSLAGYTDTQYF,0,3,1,3
TRBV4-1,TRBJ2-1,CASSHRGQTLYNEQFF,0,3,1,3
TRBV4-1,TRBJ1-2,CASSQSDSDANYGYTF,0,3,1,3
TRBV4-1,TRBJ1-1,CASSQVGRGKGTEAFF,0,3,1,3
TRBV5-1,TRBJ1-4,CASSDDLSATNEKLFF,0,3,1,3
TRBV5-1,TRBJ2-7,CASSTDPGQSIYEQYF,0,3,1,3
TRBV20-1,TRBJ2-1,CSPQAREGPSYSEQFF,0,3,1,3
TRBV20-1,TRBJ2-7,CSARGERGADSYEQYF,0,3,1,3
TRBV20-1,TRBJ1-3,CSAREGPAISGNTIYF,0,3,1,3
TRBV20-1,TRBJ2-7,CSARTRGLGNSYEQYF,0,3,1,3
TRBV29-1,TRBJ2-1,CSVVSGSDTFFNEQFF,0,3,1,3
TRBV29-1,TRBJ2-1,CSVAVGGTGGYNEKFF,0,3,1,3
TRBV29-1,TRBJ2-5,CSVDTVGGRWGETQYF,0,3,1,3
TRBV29-1,TRBJ2-7,CSVEGPGAGLSYEQYF,0,3,1,3
TRBV29-1,TRBJ2-1,CSVEDAGTSGIGEQFF,0,3,1,3
TRBV20-1,TRBJ2-5,CRALGLAGAGQETQYF,0,3,1,3
TRBV18,TRBJ2-4,YASSPGGAWTKNIQYF,0,3,1,3
TRBV12-5,TRBJ2-2,CASGLCQGNTGELFF,0,3,1,3
TRBV12-5,TRBJ2-7,CASGGNRGLTYEQYF,0,3,1,3
TRBV12-3/4,TRBJ2-3,CASSHTTDITDTQYF,0,3,1,3
TRBV30,TRBJ1-1,CACPPPGGLETEAFF,0,3,1,3
TRBV30,TRBJ1-5,CAWSVQGLGNQPQHF,0,3,1,3
TRBV10-3,TRBJ2-5,CAISDSQGSQETQYF,0,3,1,3
TRBV10-3,TRBJ2-1,CAISESARLNNEQFF,0,3,1,3
TRBV15,TRBJ1-5,CATADRLVGNQPQHF,0,3,1,3
TRBV24-1,TRBJ2-7,CATSAGTSGSYEQYF,0,3,1,3
TRBV24-1,TRBJ2-6,CATSGTATGANVLTF,0,3,1,3
TRBV24-1,TRBJ2-2,CATSDSGVNTGELFF,0,3,1,3
TRBV7-2,TRBJ2-5,CASLPTGPGGETQYF,0,3,1,3
TRBV19,TRBJ1-1,CASRSDRAETTEAFF,0,3,1,3
TRBV19,TRBJ2-1,CASTTGTSGNNEQFF,0,3,1,3
TRBV19,TRBJ2-7,CASTPSGRGGPEQYF,0,3,1,3
TRBV19,TRBJ2-3,CASTRSGGFGNTQYF,0,3,1,3
TRBV19,TRBJ2-5,CASSPGLAGAETQYF,0,3,1,3
TRBV19,TRBJ2-7,CASSITGQGIYEQYF,0,3,1,3
TRBV19,TRBJ1-2,CASSMGRAEYYGYTF,0,3,1,3
TRBV19,TRBJ1-3,CASSISWSSGNTIYF,0,3,1,3
TRBV19,TRBJ1-1,CASSTPGQGTFEAFF,0,3,1,3
TRBV19,TRBJ2-1,CASSNWTDAYNEQFF,0,3,1,3
TRBV19,TRBJ2-7,CASSLGTQLYYEQYF,0,3,1,3
TRBV19,TRBJ2-1,CASSLTSGNYNERFF,0,3,1,3
TRBV19,TRBJ2-1,CASSRGPSSYYEQFF,0,3,1,3
TRBV19,TRBJ1-5,CASNREGLGNQPQHF,0,3,1,3
TRBV18,TRBJ2-7,CASSSEGQASYEQYF,0,3,1,3
TRBV9,TRBJ2-1,CASSGRGDSYNEQFF,0,3,1,3
TRBV27,TRBJ2-1,CASSKAGAIHHEQFF,0,3,1,3
TRBV18,TRBJ2-5,CASSPRTAAQETQYF,0,3,1,3
TRBV18,TRBJ2-7,CASSPNARRSYEQYF,0,3,1,3
TRBV18,TRBJ2-7,CASSPASGILDEQYF,0,3,1,3
TRBV18,TRBJ2-5,CASSPLKSSGETQYF,0,3,1,3
TRBV18,TRBJ2-7,CASSPPRGPAYEQYF,0,3,1,3
TRBV18,TRBJ1-6,CASSPQENRGSPLHF,0,3,1,3
TRBV18,TRBJ1-6,CASSPVPVYNSPLHF,0,3,1,3
TRBV18,TRBJ2-1,CASSPGSGRVNEQSF,0,3,1,3
TRBV18,TRBJ1-1,CASSPGRAWDTEAFF,0,3,1,3
TRBV18,TRBJ1-5,CASSPGAGGNQPQHF,0,3,1,3
TRBV2,TRBJ2-1,CASWVGTAGPGGQFF,0,3,1,3
TRBV2,TRBJ2-7,CASLTPGQGRREQYF,0,3,1,3
TRBV27,TRBJ2-1,CASRRTAGRYNEQFF,0,3,1,3
TRBV12-3/4,TRBJ1-5,CASGLGTGPGQPQHF,0,3,1,3
TRBV28,TRBJ2-4,CASGPTGGYKNIQYF,0,3,1,3
TRBV6-2/3/5/6,TRBJ2-2,CASGGQETNTGELFF,0,3,1,3
TRBV28,TRBJ2-1,CASTGGGMDYNEQFF,0,3,1,3
TRBV12-3/4,TRBJ2-7,CASTLLGQGTYEQYF,0,3,1,3
TRBV11-1,TRBJ2-2,CASTRTGVNTGELFF,0,3,1,3
TRBV27,TRBJ2-1,CASTVVGSSYNEQFF,0,3,1,3
TRBV28,TRBJ2-5,CASSLYGTGQETQYF,0,3,1,3
TRBV6-2/3/5/6,TRBJ2-2,CASSLLGGNTGELFF,0,3,1,3
TRBV28,TRBJ2-7,CASSLVGRVNYEQYF,0,3,1,3
TRBV28,TRBJ2-1,CASSLAGGPLNEQFF,0,3,1,3
TRBV12-3/4,TRBJ2-5,CASSLAAGGLETQYF,0,3,1,3
TRBV6-2/3/5/6,TRBJ2-1,CASSLGLAVYNEQFF,0,3,1,3
TRBV12-3/4,TRBJ2-2,CASSLGAANTGELFF,0,3,1,3
TRBV6-2/3/5/6,TRBJ2-7,CASSLGDRVSYEQYF,0,3,1,3
TRBV12-3/4,TRBJ2-7,CASSLGGTGDNEQYF,0,3,1,3
TRBV27,TRBJ2-5,CASSLTSGNQETQYF,0,3,1,3
TRBV6-2/3/5/6,TRBJ2-1,CASSLSQGAYNEQFF,0,3,1,3
TRBV12-3/4,TRBJ2-5,CASSLRWSGGETQYF,0,3,1,3
TRBV12-3/4,TRBJ2-3,CASSSLGNSADTQYF,0,3,1,3
TRBV28,TRBJ1-2,CASSSRSTDYYGYTF,0,3,1,3
TRBV6-2/3/5/6,TRBJ2-5,CASSSGTSGQETQYF,0,3,1,3
TRBV12-3/4,TRBJ2-7,CASSSNRKTDYEQYF,0,3,1,3
TRBV6-2/3/5/6,TRBJ2-7,CASSWSGLAAYEQYF,0,3,1,3
TRBV6-2/3/5/6,TRBJ2-3,CASSYSTSGTHTQYF,0,3,1,3
TRBV6-2/3/5/6,TRBJ2-1,CASSYSTGGYNEQFF,0,3,1,3
TRBV6-2/3/5/6,TRBJ1-2,CASSLGQGDKNGYTF,0,3,1,3
TRBV11-1,TRBJ2-5,CASSLTGVLQETQYF,0,3,1,3
TRBV2,TRBJ2-1,CASSPRTSGGGEQFF,0,3,1,3
TRBV6-2/3/5/6,TRBJ2-1,CASSRGTSGPPEQFF,0,3,1,3
TRBV6-1,TRBJ2-7,CASSDEGRRPYEQYF,0,3,1,3
TRBV2,TRBJ2-7,CASSDRQGGSYEQYF,0,3,1,3
TRBV6-1,TRBJ1-1,CASSEQGAVFSEAFF,0,3,1,3
TRBV6-1,TRBJ2-1,CASSEVGLAGGGQFF,0,3,1,3
TRBV6-1,TRBJ1-2,CASSEASSRNYGYTF,0,3,1,3
TRBV6-1,TRBJ2-3,CASSESGGRADTQYF,0,3,1,3
TRBV2,TRBJ2-6,CASSRQISGANVLTF,0,3,1,3
TRBV11-2,TRBJ2-1,CASSFGGAGDTEQFF,0,3,1,3
TRBV11-2,TRBJ2-5,CASSFSGGGEETQYF,0,3,1,3
TRBV7-3,TRBJ2-5,CASSFGTSISETQYF,0,3,1,3
TRBV7-3,TRBJ2-3,CASSFTSGSTDTQYF,0,3,1,3
TRBV5-6,TRBJ2-7,CASSLVVGNSYEQYF,0,3,1,3
TRBV5-4,TRBJ2-1,CASSLAYGRHNEQFF,0,3,1,3
TRBV13,TRBJ2-2,CASSLGTGYTGELFF,0,3,1,3
TRBV5-4,TRBJ2-1,CASSLEDRGDNEQFF,0,3,1,3
TRBV7-8,TRBJ1-3,CASSLTGGFGNTIYF,0,3,1,3
TRBV5-4,TRBJ2-1,CASSLRLDAYNEQFF,0,3,1,3
TRBV7-6,TRBJ2-3,CASSLVGGSTDTQYF,0,3,1,3
TRBV7-9,TRBJ2-7,CASSLVASGRDEQYF,0,3,1,3
TRBV11-2,TRBJ2-7,CASSLAPDTSYEQYF,0,3,1,3
TRBV7-6,TRBJ2-1,CASSLGGINYNEQFF,0,3,1,3
TRBV7-2,TRBJ2-2,CASSLGAGTTGELFF,0,3,1,3
TRBV11-3,TRBJ2-5,CASSLGDSLRETQYF,0,3,1,3
TRBV7-6,TRBJ2-7,CASSLGTENTYEQYF,0,3,1,3
TRBV7-2,TRBJ2-1,CASSLGAGGFNEQFF,0,3,1,3
TRBV7-9,TRBJ2-1,CASSLGNDSVAPQFF,0,3,1,3
TRBV11-2,TRBJ2-5,CASSLEQGRGETQYF,0,3,1,3
TRBV5-4,TRBJ1-1,CASSLTGDGNTEAFF,0,3,1,3
TRBV7-2,TRBJ2-3,CASSLSLTGTDTQYF,0,3,1,3
TRBV7-6,TRBJ2-1,CASSLRTAPPNEQFF,0,3,1,3
TRBV7-2,TRBJ2-3,CASSLRQGLTDTQYF,0,3,1,3
TRBV5-4,TRBJ2-5,CASSSPTGSQETQYF,0,3,1,3
TRBV5-4,TRBJ2-5,CASSSPTDSQETQHY,0,3,1,3
TRBV12-3/4,TRBJ2-3,CASSSTSGVTDTQYF,0,3,1,3
TRBV6-2/3/5/6,TRBJ2-7,CASSSVAGVFNEQYF,0,3,1,3
TRBV7-9,TRBJ2-3,CASSSDSVSTDTQYF,0,3,1,3
TRBV7-9,TRBJ2-7,CASSSEDSHSYEQYF,0,3,1,3
TRBV11-2,TRBJ2-3,CASSSQGLATDTQYF,0,3,1,3
TRBV5-4,TRBJ2-3,CASSSGQGQIDTQYF,0,3,1,3
TRBV7-9,TRBJ2-2,CASSSTGRTTGELFF,0,3,1,3
TRBV11-2,TRBJ2-7,CASSSRTASSYEQYF,0,3,1,3
TRBV7-9,TRBJ2-2,CASSSQIEGAGELFF,0,3,1,3
TRBV7-2,TRBJ2-1,CASSSSGRAGDEQFF,0,3,1,3
TRBV3-1,TRBJ2-7,CASSLRQENSYEQYF,0,3,1,3
TRBV3-1,TRBJ2-7,CASSLTSVRSYEQYF,0,3,1,3
TRBV4-2,TRBJ2-5,CASSPGTSGDETQYF,0,3,1,3
TRBV7-2,TRBJ2-2,CASSPDGWNTGELFF,0,3,1,3
TRBV7-2,TRBJ1-2,CASSPPDRVTSGYTF,0,3,1,3
TRBV3-1,TRBJ1-5,CASSPRGLGNQPQHF,0,3,1,3
TRBV7-2,TRBJ2-3,CASSPRTGLTDTQYF,0,3,1,3
TRBV13,TRBJ2-6,CASSPVWAGANVLTF,0,3,1,3
TRBV11-2,TRBJ2-5,CASSPGLAEQETQYF,0,3,1,3
TRBV7-2,TRBJ2-1,CASSPTGLAGDEQFF,0,3,1,3
TRBV3-1,TRBJ2-7,CASSPRAGQGYEQYF,0,3,1,3
TRBV3-1,TRBJ2-7,CASSPLAASSYEQYF,0,3,1,3
TRBV7-9,TRBJ2-7,CASSPPGLAGYEQYF,0,3,1,3
TRBV7-2,TRBJ2-1,CASSPGLALGNEQFF,0,3,1,3
TRBV9,TRBJ2-7,CASSPRGTGPYEQYF,0,3,1,3
TRBV9,TRBJ2-3,CASSRMGVSTDTQYF,0,3,1,3
TRBV3-1,TRBJ2-7,CASSHTGTGGSEQYF,0,3,1,3
TRBV6-2/3/5/6,TRBJ2-3,CASSQGGRESDTQYF,0,3,1,3
TRBV3-1,TRBJ2-2,CASSQGLANTRELFF,0,3,1,3
TRBV14,TRBJ2-1,CASSQFGRGSNEQFF,0,3,1,3
TRBV3-1,TRBJ1-1,CASSQVGRADTEAFF,0,3,1,3
TRBV4-2,TRBJ2-7,CASSQVGSVTYEQYF,0,3,1,3
TRBV3-1,TRBJ2-7,CASSQGPMEPAEQYF,0,3,1,3
TRBV4-2,TRBJ2-4,CASSQGGTSMNIQYF,0,3,1,3
TRBV14,TRBJ1-2,CASSQELGAYYGFTF,0,3,1,3
TRBV9,TRBJ2-5,CASSVDGQGVETQYF,0,3,1,3
TRBV11-2,TRBJ2-3,CASSVLRTNTDTQYF,0,3,1,3
TRBV9,TRBJ2-3,CASSVGDTATDTQYF,0,3,1,3
TRBV9,TRBJ2-3,CASSAGTHSTDTQYF,0,3,1,3
TRBV5-4,TRBJ2-1,CASSADLGSYNEQFF,0,3,1,3
TRBV6-2/3/5/6,TRBJ2-7,CASSGDSFVEAEQYF,0,3,1,3
TRBV7-6,TRBJ2-3,CASSGDRSSTDTQYF,0,3,1,3
TRBV7-8,TRBJ2-1,CASSIYSRPYNEQFF,0,3,1,3
TRBV7-8,TRBJ2-7,CASSISGRPLREQYF,0,3,1,3
TRBV5-4,TRBJ1-1,CASSINRGLSTEAFF,0,3,1,3
TRBV7-6,TRBJ2-1,CASSTGLASGNEQFF,0,3,1,3
TRBV27,TRBJ2-1,CASRGYPGSYNEQFF,0,3,1,3
TRBV6-4,TRBJ1-4,CASRTGGGGNEKLFF,0,3,1,3
TRBV25-1,TRBJ2-3,CASRRGGGDTDTQYF,0,3,1,3
TRBV7-6,TRBJ2-5,CASRPTRLVGETQYF,0,3,1,3
TRBV3-1,TRBJ2-7,CASRPDGGGSNEQYF,0,3,1,3
TRBV7-9,TRBJ2-7,CASNLPGQGIYEQYF,0,3,1,3
TRBV11-2,TRBJ1-6,CASNKRGAYNSPLHF,0,3,1,3
TRBV6-2/3/5/6,TRBJ2-1,CASKVGTGGYNEQFF,0,3,1,3
TRBV6-2/3/5/6,TRBJ2-3,CASKLSGSVADTQYF,0,3,1,3
TRBV28,TRBJ2-5,CANSLSSGGQETQYF,0,3,1,3
TRBV5-1,TRBJ2-5,CASGLSGEREETQYF,0,3,1,3
TRBV5-1,TRBJ2-2,CASSFTAGLTGELFF,0,3,1,3
TRBV5-1,TRBJ2-1,CASSQSEVGGNEQFF,0,3,1,3
TRBV10-2,TRBJ2-7,CASSESASGTYEQYF,0,3,1,3
TRBV10-1,TRBJ2-3,CASSEGLAVTDTQYF,0,3,1,3
TRBV5-1,TRBJ2-1,CASSFTSSSYNEQFF,0,3,1,3
TRBV5-1,TRBJ1-1,CASSLLTGGEGEAFF,0,3,1,3
TRBV5-1,TRBJ2-7,CASSLVGPNSYEQYF,0,3,1,3
TRBV5-1,TRBJ2-3,CASSLAPGGTDTQYF,0,3,1,3
TRBV5-1,TRBJ1-3,CASSLARDSGDTIYF,0,3,1,3
TRBV5-1,TRBJ2-5,CASSLARNLEETQYF,0,3,1,3
TRBV5-1,TRBJ2-7,CASSLGGTNAYEQYF,0,3,1,3
TRBV5-1,TRBJ2-2,CASSLGQEGTGELFF,0,3,1,3
TRBV5-1,TRBJ1-5,CASSLGAGGNQPQHF,0,3,1,3
TRBV5-1,TRBJ2-1,CASSLEGEFYNEQFF,0,3,1,3
TRBV7-3,TRBJ2-7,CASSLGGAGGHEQYF,0,3,1,3
TRBV5-1,TRBJ2-7,CASSSGSGPRDEQYF,0,3,1,3
TRBV5-1,TRBJ2-5,CASSSSRQAQETQYF,0,3,1,3
TRBV5-1,TRBJ2-7,CASSWEGLAGLEQYF,0,3,1,3
TRBV5-1,TRBJ2-1,CASSYITSGSNEQFF,0,3,1,3
TRBV4-1,TRBJ2-1,CASSLQQNTYNEQFF,0,3,1,3
TRBV5-1,TRBJ2-3,CASSPPLAVTDTQYF,0,3,1,3
TRBV5-1,TRBJ2-1,CASSQTEGLYNEQFF,0,3,1,3
TRBV4-1,TRBJ2-5,CASSQDPDLFGTQYF,0,3,1,3
TRBV4-1,TRBJ2-1,CASSQDPTSGNEQFF,0,3,1,3
TRBV4-1,TRBJ1-3,CASSQDLSGGNTIYL,0,3,1,3
TRBV4-1,TRBJ2-7,CASSQDGGPSYEQYF,0,3,1,3
TRBV5-1,TRBJ2-5,CASSAQAGRGETQYF,0,3,1,3
TRBV5-1,TRBJ2-1,CASSARDATYNEQFF,0,3,1,3
TRBV5-1,TRBJ2-6,CASSGDPPGANVLTF,0,3,1,3
TRBV5-1,TRBJ2-1,CASSILAGGINEQFF,0,3,1,3
TRBV5-1,TRBJ2-1,CASSKLAGDSNEQFF,0,3,1,3
TRBV5-1,TRBJ2-4,CASRFSGTGDNIQYF,0,3,1,3
TRBV29-1,TRBJ2-3,CGVPNSGRLTDTQYF,0,3,1,3
TRBV20-1,TRBJ2-5,CSAFGLAGLVETQYF,0,3,1,3
TRBV20-1,TRBJ1-5,CSAVGQLNSNQPQHF,0,3,1,3
TRBV20-1,TRBJ2-3,CSATLGLAGADTQYF,0,3,1,3
TRBV20-1,TRBJ2-1,CSASSLAGEINEQFF,0,3,1,3
TRBV20-1,TRBJ2-3,CSASALAARTDTQYF,0,3,1,3
TRBV20-1,TRBJ2-7,CSARGLAGDSYEQYF,0,3,1,3
TRBV20-1,TRBJ2-1,CSARHTSGSGNEQFF,0,3,1,3
TRBV20-1,TRBJ2-5,CSARGGVHGGETQYF,0,3,1,3
TRBV20-1,TRBJ2-7,CSARDLGDGTGANRF,0,3,1,3
TRBV20-1,TRBJ2-7,CSARDLELASYEQYF,0,3,1,3
TRBV20-1,TRBJ2-3,CSARDPGEGTDTQYF,0,3,1,3
TRBV20-1,TRBJ2-5,CSARDNQAVRETQYF,0,3,1,3
TRBV20-1,TRBJ2-1,CSAREPLAGRYEQFF,0,3,1,3
TRBV20-1,TRBJ2-3,CSAREWSGGRDTQYF,0,3,1,3
TRBV20-1,TRBJ1-4,CSAKRDGTTNEKLFF,0,3,1,3
TRBV20-1,TRBJ1-4,CSAAKTGNLNEKLFF,0,3,1,3
TRBV20-1,TRBJ2-5,CSARRAGGNQETQYF,0,3,1,3
TRBV20-1,TRBJ2-7,CSANPGEREAGEQYF,0,3,1,3
TRBV29-1,TRBJ2-3,CSVRTDYSSADTQYF,0,3,1,3
TRBV29-1,TRBJ2-5,CSVDLGDSQQETQYF,0,3,1,3
TRBV29-1,TRBJ2-3,CSVDGVVLAADTQYF,0,3,1,3
TRBV29-1,TRBJ1-3,CSVDSDGDSGNTIYF,0,3,1,3
TRBV29-1,TRBJ2-3,CSVEESGQGEDTQYF,0,3,1,3
TRBV29-1,TRBJ2-2,CSVHRDRGQGGELFF,0,3,1,3
TRBV29-1,TRBJ2-1,CSVLREGWSYNEQFF,0,3,1,3
TRBV29-1,TRBJ2-2,CSVALGNPNTGELFF,0,3,1,3
TRBV29-1,TRBJ2-1,CSAYGQGATHNEQFF,0,3,1,3
TRBV29-1,TRBJ1-2,CSTRDREVGNYGYTF,0,3,1,3
TRBV7-2,TRBJ2-1,RASSFRWDSYNEQFF,0,3,1,3
TRBV18,TRBJ1-1,CAVESTSGTYKYIF,0,3,1,3
TRBV30,TRBJ2-7,CAWSVLGMSDEQYF,0,3,1,3
TRBV30,TRBJ1-5,CAWSEGAHNQPQHF,0,3,1,3
TRBV30,TRBJ2-5,CAWSTPGHGETQYF,0,3,1,3
TRBV18,TRBJ1-1,CAGSISSTATEAFF,0,3,1,3
TRBV12-3/4,TRBJ1-4,CAGSFWQNNEKLFF,0,3,1,3
TRBV7-3,TRBJ2-3,CAGSSSASTDTQYF,0,3,1,3
TRBV10-3,TRBJ2-1,CAISEGTTGNEQFF,0,3,1,3
TRBV10-3,TRBJ2-1,CAISERAGSNEQFF,0,3,1,3
TRBV10-3,TRBJ2-5,CATSGLAGAEIQYF,0,3,1,3
TRBV12-3/4,TRBJ2-1,CATQGWELNNEQFF,0,3,1,3
TRBV2,TRBJ2-7,CATDRWDRGHEQYF,0,3,1,3
TRBV15,TRBJ2-3,CATSRASLADTQYF,0,3,1,3
TRBV15,TRBJ2-3,CATSRDRFTDTQYF,0,3,1,3
TRBV24-1,TRBJ2-1,CATKASGSSYEQFF,0,3,1,3
TRBV6-2/3/5/6,TRBJ2-3,CASLSSYSTDTQYF,0,3,1,3
TRBV19,TRBJ1-1,CASIRSGRGSEAFL,0,3,1,3
TRBV19,TRBJ2-7,CASSRRDTDYEQYF,0,3,1,3
TRBV19,TRBJ2-1,CASSIGTGEYEQFF,0,3,1,3
TRBV19,TRBJ2-5,CASSIGLQELSQYF,0,3,1,3
TRBV19,TRBJ2-1,CASSKGQGANEQFF,0,3,1,3
TRBV12-3/4,TRBJ1-3,CASRPLTAGNTIYF,0,3,1,3
TRBV5-6,TRBJ2-1,CASSAGRAGDEQFF,0,3,1,3
TRBV18,TRBJ1-5,CASSPTGAYQPQHF,0,3,1,3
TRBV18,TRBJ1-1,CASSSNPWYTEAFF,0,3,1,3
TRBV18,TRBJ2-5,CASSLWDRRGTQYF,0,3,1,3
TRBV6-2/3/5/6,TRBJ2-1,CASSLAGHYNEQFF,0,3,1,3
TRBV18,TRBJ2-7,CASSPRTGRHGQYF,0,3,1,3
TRBV18,TRBJ2-3,CASSPVGETDTQYF,0,3,1,3
TRBV18,TRBJ1-5,CASSPGQGGQPQHF,0,3,1,3
TRBV18,TRBJ2-7,CASSPSGFGYEQYF,0,3,1,3
TRBV18,TRBJ2-2,CASSPQVNTGELFF,0,3,1,3
TRBV18,TRBJ2-3,CASSPEGRSDTQYF,0,3,1,3
TRBV18,TRBJ2-1,CASSQTSGTSEQFF,0,3,1,3
TRBV7-2,TRBJ2-5,CASCLGGRGETQYF,0,3,1,3
TRBV28,TRBJ2-7,CASPLSGTSYEQYF,0,3,1,3
TRBV6-2/3/5/6,TRBJ2-2,CASRQGVDTGELFF,0,3,1,3
TRBV7-9,TRBJ2-2,CASGADPNTGELFF,0,3,1,3
TRBV7-2,TRBJ2-5,CASIQTSGTGTQYF,0,3,1,3
TRBV28,TRBJ2-1,CASTLAGPNNEQFF,0,3,1,3
TRBV5-4,TRBJ1-2,CASTSGVAGYGYTF,0,3,1,3
TRBV11-2,TRBJ2-7,CASTSTGGLDEQYF,0,3,1,3
TRBV6-2/3/5/6,TRBJ2-7,CASTPGVGAYEQYF,0,3,1,3
TRBV5-4,TRBJ2-6,CASTRPSGANVLTF,0,3,1,3
TRBV3-1,TRBJ1-1,CASTQRGTNTEAFF,0,3,1,3
TRBV12-3/4,TRBJ2-3,CASTQTENADTQYF,0,3,1,3
TRBV9,TRBJ2-3,CASTASTSTDTQYF,0,3,1,3
TRBV5-6,TRBJ2-3,CASTGTGSTDTQYF,0,3,1,3
TRBV12-3/4,TRBJ1-4,CASSFSTGDEKLFF,0,3,1,3
TRBV28,TRBJ2-7,CASSFDQGAYEQYF,0,3,1,3
TRBV6-2/3/5/6,TRBJ2-7,CASSLAGIKNEQYF,0,3,1,3
TRBV6-2/3/5/6,TRBJ2-1,CASSLDPEVDEQFF,0,3,1,3
TRBV28,TRBJ1-2,CASSLEGVNYGYTF,0,3,1,3
TRBV6-2/3/5/6,TRBJ2-1,CASSLLAGVVEQFF,0,3,1,3
TRBV12-3/4,TRBJ2-1,CASSLAGGNNEQFF,0,3,1,3
TRBV12-3/4,TRBJ2-7,CASSLGLGGDEQYF,0,3,1,3
TRBV12-3/4,TRBJ2-1,CASSLTPLHNEQFF,0,3,1,3
TRBV28,TRBJ2-1,CASSSGLRDNEQFF,0,3,1,3
TRBV6-2/3/5/6,TRBJ1-6,CASSYGQGDSPLHF,0,3,1,3
TRBV6-2/3/5/6,TRBJ2-7,CASSYSILADEQYF,0,3,1,3
TRBV6-2/3/5/6,TRBJ2-7,CASSYADRAYEQYF,0,3,1,3
TRBV6-2/3/5/6,TRBJ2-7,CASSYNPPPYEQYF,0,3,1,3
TRBV3-1,TRBJ2-1,CASSLLTGLHEQFF,0,3,1,3
TRBV6-2/3/5/6,TRBJ2-3,CASSPYRGRNTQYF,0,3,1,3
TRBV6-2/3/5/6,TRBJ2-7,CASSPGTGRYEQYF,0,3,1,3
TRBV6-2/3/5/6,TRBJ2-1,CASSPALVYDEQFF,0,3,1,3
TRBV28,TRBJ2-7,CASSPGLAGKGQYF,0,3,1,3
TRBV6-2/3/5/6,TRBJ2-7,CASSRPTGSYEQYF,0,3,1,3
TRBV6-4,TRBJ1-1,CASSVSPGNTEAFF,0,3,1,3
TRBV6-1,TRBJ2-3,CASSADIRTDTQYF,0,3,1,3
TRBV6-4,TRBJ2-7,CASSAELGYYEQYF,0,3,1,3
TRBV2,TRBJ2-7,CASSGQGVPYEQYF,0,3,1,3
TRBV28,TRBJ2-1,CASSGQGVRDEQFF,0,3,1,3
TRBV2,TRBJ2-1,CASSDGQGYNEQFF,0,3,1,3
TRBV6-1,TRBJ2-3,CASSEALPRDTQYF,0,3,1,3
TRBV2,TRBJ2-1,CASSEGLGSGEQFF,0,3,1,3
TRBV2,TRBJ1-1,CASSEDSQTAEAFF,0,3,1,3
TRBV6-1,TRBJ2-7,CASSEVGGLHEQYF,0,3,1,3
TRBV2,TRBJ2-3,CASSERLKADTQYF,0,3,1,3
TRBV11-2,TRBJ2-2,CASSMDYNTGELFF,0,3,1,3
TRBV12-3/4,TRBJ1-2,CASSTPGVNYGYTF,0,3,1,3
TRBV28,TRBJ2-4,CASSTGTEKNIQYF,0,3,1,3
TRBV6-4,TRBJ1-1,CASSTFDRVTEAFF,0,3,1,3
TRBV28,TRBJ2-5,CASSRSDRQETQYF,0,3,1,3
TRBV6-4,TRBJ1-3,CASSRQGVGNTIYF,0,3,1,3
TRBV11-3,TRBJ2-3,CASSFSGSGDTQYF,0,3,1,3
TRBV7-2,TRBJ2-7,CASSFPGDLYEQYF,0,3,1,3
TRBV7-9,TRBJ2-7,CASSFGRPPYEQYF,0,3,1,3
TRBV7-9,TRBJ2-3,CASSLGSSTDTQYF,0,3,1,3
TRBV5-6,TRBJ2-1,CASSLGGGEGEQFF,0,3,1,3
TRBV5-4,TRBJ2-1,CASSLISDYNEQFF,0,3,1,3
TRBV7-2,TRBJ2-5,CASSLIQGWQTQYF,0,3,1,3
TRBV5-4,TRBJ2-5,CASSLTGAWETQYF,0,3,1,3
TRBV7-9,TRBJ2-3,CASSLFSGTDTQYF,0,3,1,3
TRBV7-2,TRBJ2-1,CASSLQDRLPRQFF,0,3,1,3
TRBV7-9,TRBJ2-7,CASSLAVGAYEQYF,0,3,1,3
TRBV7-9,TRBJ2-6,CASSLGSGANVLTF,0,3,1,3
TRBV7-3,TRBJ2-2,CASSLGGSTGELFF,0,3,1,3
TRBV7-6,TRBJ1-5,CASSLGGSGQPQHF,0,3,1,3
TRBV7-9,TRBJ2-1,CASSLDRAYNEQFF,0,3,1,3
TRBV11-2,TRBJ2-7,CASSLMRSRDEQYF,0,3,1,3
TRBV7-3,TRBJ2-1,CASSLTSHGDEQFF,0,3,1,3
TRBV7-3,TRBJ2-7,CASSLNGGDYEQYF,0,3,1,3
TRBV7-2,TRBJ2-3,CASSLNLASDTQYF,0,3,1,3
TRBV7-9,TRBJ2-6,CASSSGTGANVLTF,0,3,1,3
TRBV7-6,TRBJ2-7,CASSSSGMPWEQYS,0,3,1,3
TRBV7-9,TRBJ1-1,CASSSGSENTEAFF,0,3,1,3
TRBV13,TRBJ2-3,CASSLPTLGDTQYF,0,3,1,3
TRBV7-9,TRBJ1-1,CASSLLATNTEAFF,0,3,1,3
TRBV3-1,TRBJ2-7,CASSLGGGEDEQYF,0,3,1,3
TRBV3-1,TRBJ1-1,CASSLRTMNTEAFF,0,3,1,3
TRBV7-9,TRBJ2-4,CASSPGQGAFIQYF,0,3,1,3
TRBV7-9,TRBJ1-2,CASSPRAVFYGYTF,0,3,1,3
TRBV11-2,TRBJ2-1,CASSPRQDHHEQFF,0,3,1,3
TRBV7-9,TRBJ2-3,CASSPTESTDTQYF,0,3,1,3
TRBV9,TRBJ2-7,CASSPGGSPYEQYF,0,3,1,3
TRBV7-9,TRBJ2-1,CASSRPAATNEQFF,0,3,1,3
TRBV7-9,TRBJ2-1,CASSRGGRNNEQFF,0,3,1,3
TRBV7-9,TRBJ2-7,CASSRDGTLYEQYF,0,3,1,3
TRBV7-9,TRBJ1-1,CASSRDSANTEAFF,0,3,1,3
TRBV9,TRBJ1-1,CASSRTGMNTEAFF,0,3,1,3
TRBV7-3,TRBJ2-3,CASSQGLVTDTQYF,0,3,1,3
TRBV28,TRBJ2-5,CASSQTTTSETQYF,0,3,1,3
TRBV3-1,TRBJ2-5,CASSQWDTQETQYF,0,3,1,3
TRBV14,TRBJ2-7,CASSQVGTTYEQYF,0,3,1,3
TRBV14,TRBJ1-1,CASSQGTGARRAFF,0,3,1,3
TRBV4-2,TRBJ2-3,CASSQDGAGGTQYF,0,3,1,3
TRBV3-1,TRBJ1-5,CASSQDRVRQPQHF,0,3,1,3
TRBV3-1,TRBJ2-5,CASSQDKSRETQYF,0,3,1,3
TRBV3-1,TRBJ2-3,CASSQETSGRTQYF,0,3,1,3
TRBV9,TRBJ2-7,CASSVGEGFYEQYF,0,3,1,3
TRBV7-9,TRBJ2-7,CASSVGQSSYEQYF,0,3,1,3
TRBV9,TRBJ1-1,CASSARTGGTEAFF,0,3,1,3
TRBV9,TRBJ2-1,CASSAQLAGDEQFF,0,3,1,3
TRBV9,TRBJ2-7,CASSGSGSINEQYF,0,3,1,3
TRBV9,TRBJ2-7,CASSGRDNSYEQYF,0,3,1,3
TRBV5-4,TRBJ2-7,CASSDGLGQSEQYF,0,3,1,3
TRBV7-2,TRBJ2-5,CASSETTLPETQYF,0,3,1,3
TRBV7-2,TRBJ2-5,CASSMTGNQETQYF,0,3,1,3
TRBV5-4,TRBJ2-3,CASSSGMSTDTQYF,0,3,1,3
TRBV6-2/3/5/6,TRBJ2-7,CASRPKREVYEQYF,0,3,1,3
TRBV6-2/3/5/6,TRBJ2-2,CASRFTGGTGELFF,0,3,1,3
TRBV6-2/3/5/6,TRBJ2-1,CASRLAGGTMRQFF,0,3,1,3
TRBV12-3/4,TRBJ2-7,CASRRWGVGGEQYF,0,3,1,3
TRBV11-2,TRBJ2-7,CASRIQGAGYEQYF,0,3,1,3
TRBV7-9,TRBJ1-1,CASNNYRDDTEAFF,0,3,1,3
TRBV7-9,TRBJ1-2,CASNPSVVDYGYTF,0,3,1,3
TRBV5-4,TRBJ2-3,CASNGRTGEDTQYF,0,3,1,3
TRBV4-1,TRBJ2-3,CAAGSGRASDTQYF,0,3,1,3
TRBV5-1,TRBJ2-1,CASTREGAYNEQFF,0,3,1,3
TRBV5-1,TRBJ2-1,CASSPGTSYNEQFF,0,3,1,3
TRBV10-2,TRBJ2-3,CASSTNGRTDTQYF,0,3,1,3
TRBV5-1,TRBJ2-3,CASSKTSNPNTQYF,0,3,1,3
TRBV5-1,TRBJ2-5,CASSFGQTQETQYF,0,3,1,3
TRBV5-1,TRBJ2-7,CASSLRTGINEQYF,0,3,1,3
TRBV5-1,TRBJ2-7,CASSLVAGSCEQYF,0,3,1,3
TRBV5-1,TRBJ1-1,CASSLATGNTEAFF,0,3,1,3
TRBV5-1,TRBJ2-3,CASSLAGNADTQYF,0,3,1,3
TRBV5-1,TRBJ2-7,CASSLGQSLYEQYF,0,3,1,3
TRBV5-1,TRBJ2-7,CASSLGGTPGEQYF,0,3,1,3
TRBV5-1,TRBJ2-4,CASSLSQGANIQYF,0,3,1,3
TRBV5-1,TRBJ2-1,CASSLPGLAHEQFF,0,3,1,3
TRBV5-1,TRBJ2-7,CASSLREPSYEQYF,0,3,1,3
TRBV5-1,TRBJ2-7,CASSSTGGPYEQYF,0,3,1,3
TRBV5-1,TRBJ2-1,CASSPVGADNEQFF,0,3,1,3
TRBV5-1,TRBJ1-5,CASSPGTGNQPQHF,0,3,1,3
TRBV5-1,TRBJ2-5,CASSPGLAGETQYF,0,3,1,3
TRBV28,TRBJ1-2,CASSPGQPSGGYTF,0,3,1,3
TRBV4-1,TRBJ1-5,CASSHREINQPQHF,0,3,1,3
TRBV4-1,TRBJ1-1,CASSQTNLNTEAFF,0,3,1,3
TRBV5-1,TRBJ2-1,CASSTGGRNNEQFF,0,3,1,3
TRBV5-1,TRBJ2-7,CASSKDRVKNEQYF,0,3,1,3
TRBV5-1,TRBJ2-3,CASRGGGPTDTQYF,0,3,1,3
TRBV10-1,TRBJ2-3,CASKNSVWTDTQYF,0,3,1,3
TRBV29-1,TRBJ2-7,CGVSRPGSSYEQYF,0,3,1,3
TRBV20-1,TRBJ2-1,CSVGGTKSYNEQFF,0,3,1,3
TRBV20-1,TRBJ2-1,CSAPGLAGVREQFF,0,3,1,3
TRBV20-1,TRBJ2-1,CSARTSGSRNEQFF,0,3,1,3
TRBV20-1,TRBJ2-3,CSAQEDRGTDTQYF,0,3,1,3
TRBV20-1,TRBJ2-7,CSAGGRAGDLEQYF,0,3,1,3
TRBV20-1,TRBJ2-7,CSASPTGRFNEQYF,0,3,1,3
TRBV20-1,TRBJ2-1,CSASENQIINEQFF,0,3,1,3
TRBV20-1,TRBJ2-7,CSARGQGHSYEQYF,0,3,1,3
TRBV20-1,TRBJ2-7,CSAREGGSFYEQYF,0,3,1,3
TRBV20-1,TRBJ2-1,CSARSNEGLNEQFF,0,3,1,3
TRBV20-1,TRBJ2-7,CSARVLWGNYEPYF,0,3,1,3
TRBV20-1,TRBJ2-4,CSARGAVAKNIQYF,0,3,1,3
TRBV20-1,TRBJ2-5,CSARGGTGQETQYF,0,3,1,3
TRBV20-1,TRBJ2-1,CSARDSGSYNEQFF,0,3,1,3
TRBV20-1,TRBJ2-1,CSANPRLSRNEQFF,0,3,1,3
TRBV20-1,TRBJ2-3,CSAKESGRGDTQYF,0,3,1,3
TRBV20-1,TRBJ2-5,CSALAGQGRETQYF,0,3,1,3
TRBV20-1,TRBJ2-7,CSAETSGSSYEQYF,0,3,1,3
TRBV20-1,TRBJ2-1,CSAREPKGANEQFF,0,3,1,3
TRBV20-1,TRBJ2-1,CSAPSSGRDNEQFF,0,3,1,3
TRBV29-1,TRBJ2-5,CSLRLAANPETQYF,0,3,1,3
TRBV29-1,TRBJ1-1,CSVHTGTANTEAFF,0,3,1,3
TRBV29-1,TRBJ2-7,CSVVVQGAHDEQYF,0,3,1,3
TRBV29-1,TRBJ2-3,CSVAQGSGEDTQYF,0,3,1,3
TRBV29-1,TRBJ2-7,CSVGGGQGSREQYF,0,3,1,3
TRBV29-1,TRBJ1-2,CSVEPRDRENGYTF,0,3,1,3
TRBV29-1,TRBJ2-1,CSVEGSGKGYEQFF,0,3,1,3
TRBV29-1,TRBJ2-3,CSVRLAGGVDTQYF,0,3,1,3
TRBV29-1,TRBJ2-2,CSVGETGGVVPLFF,0,3,1,3
TRBV29-1,TRBJ2-7,CSVIPASLTYEQYF,0,3,1,3
TRBV29-1,TRBJ2-1,CSVITSATYNEQFF,0,3,1,3
TRBV29-1,TRBJ2-3,CSVGPGQGTDTQYF,0,3,1,3
TRBV29-1,TRBJ2-2,CSAPAGGPSGELFF,0,3,1,3
TRBV19,TRBJ1-5,CVSSRQEIQPQHF,0,3,1,3
TRBV3-1,TRBJ2-7,CVSGPDRGYEQYF,0,3,1,3
TRBV12-5,TRBJ2-7,CASALDRAYEQYF,0,3,1,3
TRBV12-5,TRBJ1-2,CASGLAGPHGYTF,0,3,1,3
TRBV30,TRBJ2-5,CAWGPRLGETQYF,0,3,1,3
TRBV30,TRBJ1-1,CAWSVTPNTEAFF,0,3,1,3
TRBV30,TRBJ2-5,CAWSVSDRETQYF,0,3,1,3
TRBV30,TRBJ2-7,CAWSIDRAYEQYF,0,3,1,3
TRBV30,TRBJ2-7,CAWSLTGNYEQYF,0,3,1,3
TRBV30,TRBJ1-4,CAWKTGGNEKLFF,0,3,1,3
TRBV12-3/4,TRBJ1-3,CAGLQGSGNTIYF,0,3,1,3
TRBV5-6,TRBJ2-5,CAGSFGSQETQYF,0,3,1,3
TRBV19,TRBJ2-1,CAIRDSLRNEQFF,0,3,1,3
TRBV10-3,TRBJ2-5,CAISESSGETQYF,0,3,1,3
TRBV10-3,TRBJ2-3,CAIRGQLTDTQYF,0,3,1,3
TRBV27,TRBJ2-7,CATTGTGSYEQYF,0,3,1,3
TRBV28,TRBJ2-5,CATGGPGQETQYF,0,3,1,3
TRBV24-1,TRBJ2-5,CATSRAGGETQYF,0,3,1,3
TRBV24-1,TRBJ2-1,CATSGYLDNEQFF,0,3,1,3
TRBV24-1,TRBJ2-7,CATSEDIRDEQYF,0,3,1,3
TRBV19,TRBJ2-7,CASATGGEYEQYF,0,3,1,3
TRBV19,TRBJ2-3,CASSVRPTDTQYF,0,3,1,3
TRBV19,TRBJ2-3,CASSIDNTDTQYF,0,3,1,3
TRBV19,TRBJ1-1,CASSIQGFTEAFF,0,3,1,3
TRBV19,TRBJ2-5,CASSIAREETQYF,0,3,1,3
TRBV19,TRBJ2-1,CASSKGGNNEQFL,0,3,1,3
TRBV18,TRBJ2-7,CASSPRHRDEQYF,0,3,1,3
TRBV18,TRBJ2-7,CASSPVDRGEQHF,0,3,1,3
TRBV28,TRBJ2-1,CASLGAGGREQFF,0,3,1,3
TRBV7-9,TRBJ2-3,CASRPSSTDTQYF,0,3,1,3
TRBV6-2/3/5/6,TRBJ2-7,CASGPGQGYEQYF,0,3,1,3
TRBV4-2,TRBJ2-3,CASDKTPTDTQYF,0,3,1,3
TRBV11-2,TRBJ2-1,CASERDSYNEQFF,0,3,1,3
TRBV6-2/3/5/6,TRBJ2-5,CASIPGLQETQYF,0,3,1,3
TRBV6-2/3/5/6,TRBJ2-3,CASMVAGADTQYF,0,3,1,3
TRBV6-2/3/5/6,TRBJ2-1,CASIGTGPNEQFF,0,3,1,3
TRBV6-2/3/5/6,TRBJ2-7,CASTSPARSEQYF,0,3,1,3
TRBV7-2,TRBJ2-3,CASTSWDGDTQYF,0,3,1,3
TRBV7-9,TRBJ2-1,CASTRNRDLEQFF,0,3,1,3
TRBV2,TRBJ1-6,CASTGLGNSPLHF,0,3,1,3
TRBV28,TRBJ1-2,CASSFGKVDGYTF,0,3,1,3
TRBV12-3/4,TRBJ2-1,CASSLTSYNKQFF,0,3,1,3
TRBV6-2/3/5/6,TRBJ2-7,CASSLNGIYEQYF,0,3,1,3
TRBV28,TRBJ2-5,CASSSGQQETQYF,0,3,1,3
TRBV12-3/4,TRBJ2-2,CASSSRQHGELFF,0,3,1,3
TRBV12-3/4,TRBJ2-1,CASSWGGYNEQFF,0,3,1,3
TRBV6-2/3/5/6,TRBJ2-1,CASSYASNYEQFF,0,3,1,3
TRBV7-2,TRBJ2-7,CASSYPTTREQYF,0,3,1,3
TRBV12-3/4,TRBJ2-7,CASSLGQGYEQYF,0,3,1,3
TRBV12-3/4,TRBJ2-7,CASSLTRGYEQYF,0,3,1,3
TRBV2,TRBJ1-2,CASSLQGADGYTF,0,3,1,3
TRBV6-2/3/5/6,TRBJ1-1,CASSRQVNTEAFF,0,3,1,3
TRBV27,TRBJ2-1,CASSRGLSWEQFF,0,3,1,3
TRBV6-4,TRBJ2-5,CASSRQGRGTQYF,0,3,1,3
TRBV27,TRBJ2-4,CASSQGIRGIQYF,0,3,1,3
TRBV25-1,TRBJ1-2,CASSGLGLHGYTF,0,3,1,3
TRBV6-1,TRBJ2-4,CASSGTLSDVQYF,0,3,1,3
TRBV6-1,TRBJ2-5,CASSEGSSGTQYF,0,3,1,3
TRBV2,TRBJ2-7,CASSEQASNEQYF,0,3,1,3
TRBV2,TRBJ2-7,CASSEALRLEQYF,0,3,1,3
TRBV6-1,TRBJ1-1,CASSEGAGAEAFL,0,3,1,3
TRBV6-1,TRBJ1-2,CASSEDRRYGYTF,0,3,1,3
TRBV7-2,TRBJ2-7,CASSNSGLDEQYF,0,3,1,3
TRBV7-2,TRBJ2-3,CASSFGGPDTQYF,0,3,1,3
TRBV7-9,TRBJ2-5,CASSFQGWETQYF,0,3,1,3
TRBV5-4,TRBJ1-2,CASSFGGGGGYTF,0,3,1,3
TRBV7-3,TRBJ2-3,CASSFGPGDTQYF,0,3,1,3
TRBV7-6,TRBJ2-5,CASSFDSQETQYF,0,3,1,3
TRBV13,TRBJ2-5,CASSFTGLETQYF,0,3,1,3
TRBV5-4,TRBJ2-3,CASSLDPSRTQYF,0,3,1,3
TRBV7-2,TRBJ2-7,CASSLTGAYEQYF,0,3,1,3
TRBV7-6,TRBJ1-1,CASSLFPYTEAFF,0,3,1,3
TRBV11-2,TRBJ1-1,CASSLQGDTEAFF,0,3,1,3
TRBV7-6,TRBJ2-3,CASSLVLADTQYF,0,3,1,3
TRBV11-2,TRBJ2-3,CASSLGSSDTQYF,0,3,1,3
TRBV11-2,TRBJ2-3,CASSLGGADTQYF,0,3,1,3
TRBV11-2,TRBJ2-1,CASSLDPNYEQFI,0,3,1,3
TRBV11-2,TRBJ1-1,CASSLRRNTEAFF,0,3,1,3
TRBV7-2,TRBJ2-1,CASSSPALARQFF,0,3,1,3
TRBV7-2,TRBJ2-5,CASSSRTGETQYF,0,3,1,3
TRBV7-2,TRBJ2-1,CASSSGQYNEQFF,0,3,1,3
TRBV7-2,TRBJ2-3,CASSSNQGDTQYF,0,3,1,3
TRBV7-2,TRBJ2-5,CASSSYREETQYF,0,3,1,3
TRBV11-2,TRBJ2-5,CASSSRLGETQYF,0,3,1,3
TRBV13,TRBJ2-7,CASSSRLADEQYF,0,3,1,3
TRBV13,TRBJ1-1,CASSLPANTEAFF,0,3,1,3
TRBV7-9,TRBJ1-1,CASSLDRTTEAFF,0,3,1,3
TRBV11-2,TRBJ2-1,CASSLGQGYEQFF,0,3,1,3
TRBV11-2,TRBJ2-1,CASSPPGGDEQFF,0,3,1,3
TRBV5-4,TRBJ2-1,CASSPGTFNEQFF,0,3,1,3
TRBV14,TRBJ2-1,CASSPGTHNEQFF,0,3,1,3
TRBV7-7,TRBJ2-5,CASSPRQQETQYF,0,3,1,3
TRBV11-2,TRBJ1-2,CASSRRGISGDTF,0,3,1,3
TRBV11-3,TRBJ2-1,CASSQGLAGGQFF,0,3,1,3
TRBV3-1,TRBJ2-1,CASSQKSNNEQFF,0,3,1,3
TRBV3-1,TRBJ2-7,CASSQGSYSEQYF,0,3,1,3
TRBV3-1,TRBJ2-3,CASSQNRPDTQYF,0,3,1,3
TRBV6-2/3/5/6,TRBJ2-7,CASSVGQVYEQYF,0,3,1,3
TRBV9,TRBJ2-3,CASSVQITDTQYF,0,3,1,3
TRBV9,TRBJ2-1,CASSVGHYNEQFF,0,3,1,3
TRBV7-2,TRBJ2-3,CASSGPDRNTQYF,0,3,1,3
TRBV7-8,TRBJ2-3,CASSGSYTDTQYL,0,3,1,3
TRBV7-9,TRBJ1-1,CASSGTENAEAFS,0,3,1,3
TRBV12-3/4,TRBJ2-5,CASSDRVEETQYF,0,3,1,3
TRBV12-3/4,TRBJ2-3,CASRLGRTDTQYF,0,3,1,3
TRBV2,TRBJ1-1,CASRVGRYTEAFF,0,3,1,3
TRBV6-2/3/5/6,TRBJ2-7,CASRRQGADEQYF,0,3,1,3
TRBV6-1,TRBJ2-1,CASKGSGRNEQFF,0,3,1,3
TRBV4-1,TRBJ1-5,CASSRQANQPQHF,0,3,1,3
TRBV10-1,TRBJ2-1,CASSGGVGSEQFF,0,5,1,5
TRBV5-1,TRBJ2-5,CASSFLATKTQYF,0,3,1,3
TRBV5-1,TRBJ2-2,CASSLVVEGELFF,0,3,1,3
TRBV5-1,TRBJ2-1,CASSLGLQNEQFF,0,3,1,3
TRBV5-1,TRBJ2-1,CASSLGIENEQFF,0,3,1,3
TRBV5-1,TRBJ2-5,CASSLTGRETQYF,0,3,1,3
TRBV5-1,TRBJ2-1,CASSLNPGNEQFF,0,3,1,3
TRBV5-1,TRBJ1-1,CASSLRVNTEAFF,0,3,1,3
TRBV5-1,TRBJ2-1,CASSPVQRNEQFF,0,3,1,3
TRBV4-1,TRBJ1-2,CASSQSANYGYTF,0,3,1,3
TRBV20-1,TRBJ2-1,CSAYSSGLDEQFF,0,3,1,3
TRBV20-1,TRBJ2-3,CSAPQGAADTQYF,0,3,1,3
TRBV20-1,TRBJ2-3,CSAVSLGTDTQYF,0,3,1,3
TRBV20-1,TRBJ1-1,CSAMPGQNTEAFF,0,3,1,3
TRBV20-1,TRBJ2-1,CSASRTTNNEQFF,0,3,1,3
TRBV20-1,TRBJ2-3,CSASRQVPDTQYF,0,3,1,3
TRBV20-1,TRBJ2-7,CSASAGPSYEQYF,0,3,1,3
TRBV20-1,TRBJ2-3,CSARAAGLSTQYF,0,3,1,3
TRBV20-1,TRBJ2-1,CSARTSSYNEQFF,0,3,1,3
TRBV20-1,TRBJ2-1,CSARPGGYNEQFF,0,3,1,3
TRBV20-1,TRBJ1-5,CSARGGGYQPQHF,0,3,1,3
TRBV20-1,TRBJ2-7,CSARDYGEDAEYF,0,3,1,3
TRBV20-1,TRBJ2-4,CSARDGAKNIQYF,0,3,1,3
TRBV20-1,TRBJ1-1,CSARDYSFYEAFF,0,3,1,3
TRBV20-1,TRBJ1-5,CSAALTGNQPQHF,0,3,1,3
TRBV20-1,TRBJ2-1,CSAGSGRYNEQFF,0,3,1,3
TRBV20-1,TRBJ2-7,CSGTQGGTYVQYF,0,3,1,3
TRBV29-1,TRBJ2-5,CSHTGGSQETQYF,0,3,1,3
TRBV29-1,TRBJ1-1,CSVVETVNTEAFF,0,3,1,3
TRBV29-1,TRBJ2-7,CSVVLAGDYEQYF,0,3,1,3
TRBV29-1,TRBJ2-3,CSVVGILTDTQYF,0,3,1,3
TRBV29-1,TRBJ2-2,CSVAPWNTGELFF,0,3,1,3
TRBV29-1,TRBJ2-5,CSVGRGEKETQYF,0,3,1,3
TRBV29-1,TRBJ2-3,CSVDAGGSDTQYF,0,3,1,3
TRBV29-1,TRBJ2-2,CSVIDNYTGELFF,0,3,1,3
TRBV29-1,TRBJ2-1,CSVTLSSYNEQFF,0,3,1,3
TRBV29-1,TRBJ2-7,CSVSRGAVYEQYF,0,3,1,3
TRBV29-1,TRBJ1-2,CSVQLTGGYGYTF,0,3,1,3
TRBV29-1,TRBJ2-7,CSVQLNRAYEQYF,0,3,1,3
TRBV20-1,TRBJ2-3,CSAGGLWGGTQYF,0,3,1,3
TRBV29-1,TRBJ2-7,CSASFGGGYEQYF,0,3,1,3
TRBV29-1,TRBJ2-5,CSAAGTGAETQYF,0,3,1,3
TRBV29-1,TRBJ1-5,CSAAADSNQPQHF,0,3,1,3
TRBV29-1,TRBJ2-1,CSATGGSYNEQFF,0,3,1,3
TRBV19,TRBJ2-4,RASSIGDGLRRYF,0,3,1,3
TRBV30,TRBJ1-4,CAWSYRAGKLFF,0,3,1,3
TRBV30,TRBJ2-1,CAQTKPQNEQFF,0,3,1,3
TRBV10-3,TRBJ1-6,CAISEQDSPLHF,0,3,1,3
TRBV15,TRBJ2-3,CATSNLGDTQYF,0,3,1,3
TRBV7-2,TRBJ2-1,CASQPGGSEQFF,0,3,1,3
TRBV19,TRBJ1-5,CASSVSRQPQHF,0,3,1,3
TRBV19,TRBJ2-1,CASKGSSNEQFF,0,3,1,3
TRBV18,TRBJ2-1,CASATSSNEQFS,0,3,1,3
TRBV5-6,TRBJ2-7,CASGEGAGVQYF,0,3,1,3
TRBV12-3/4,TRBJ2-2,CASSLVAGELFF,0,3,1,3
TRBV27,TRBJ2-5,CASSLKGETQYF,0,3,1,3
TRBV6-2/3/5/6,TRBJ2-1,CASSSPDGRQFF,0,3,1,3
TRBV7-9,TRBJ1-3,CASSSERNTIYF,0,3,1,3
TRBV6-2/3/5/6,TRBJ2-7,CASSYAGYEQYF,0,3,1,3
TRBV6-2/3/5/6,TRBJ2-7,CASSLLGDEQYF,0,3,1,3
TRBV2,TRBJ2-1,CASSPRSGEQFF,0,3,1,3
TRBV6-2/3/5/6,TRBJ1-1,CASSRTVTEAFF,0,3,1,3
TRBV7-3,TRBJ2-3,CASSDLADTQYF,0,3,1,3
TRBV6-1,TRBJ2-2,CASSEFVGELFF,0,3,1,3
TRBV6-2/3/5/6,TRBJ1-1,CASSNSTGYAFF,0,3,1,3
TRBV5-6,TRBJ2-1,CASSLANNEQFF,0,3,1,3
TRBV5-4,TRBJ2-5,CASSLGGETQYF,0,3,1,3
TRBV5-5,TRBJ1-2,CASSLGNYGYTF,0,3,1,3
TRBV5-6,TRBJ1-2,CASSLDRTGGTF,0,3,1,3
TRBV5-4,TRBJ2-7,CASSLDRFEQYF,0,3,1,3
TRBV7-9,TRBJ2-7,CASSLQGYEQYF,0,3,1,3
TRBV7-9,TRBJ1-1,CASSLAQTQAFF,0,3,1,3
TRBV7-9,TRBJ2-3,CASSLEVDTQYF,0,3,1,3
TRBV7-6,TRBJ2-7,CASSSTESEQYF,0,3,1,3
TRBV13,TRBJ2-1,CASSLSANEQFF,0,3,1,3
TRBV7-9,TRBJ2-3,CASSPGPDTQYF,0,3,1,3
TRBV7-9,TRBJ2-1,CASSPMVNEQFF,0,3,1,3
TRBV14,TRBJ2-3,CASSQAGPSQYF,0,3,1,3
TRBV3-1,TRBJ2-7,CASSQDWDRVYF,0,3,1,3
TRBV7-9,TRBJ2-7,CASSANSYEQYF,0,3,1,3
TRBV5-4,TRBJ1-2,CASSGPPGGYTF,0,3,1,3
TRBV6-2/3/5/6,TRBJ2-2,CASSNSPGELFF,0,3,1,3
TRBV6-1,TRBJ1-5,CASRDSNQPQHF,0,3,1,3
TRBV6-4,TRBJ2-7,CASRDPSYEQYF,0,3,1,3
TRBV5-4,TRBJ2-1,CASRNGLNEQFF,0,3,1,3
TRBV28,TRBJ2-2,CASRPSPGELFF,0,3,1,3
TRBV12-3/4,TRBJ2-7,CASNIQGLGQYF,0,3,1,3
TRBV19,TRBJ1-1,CASKARGTEAFF,0,3,1,3
TRBV7-9,TRBJ2-1,CANSPWGDEQFF,0,3,1,3
TRBV5-1,TRBJ2-5,CASSGGQETQYF,0,3,1,3
TRBV5-1,TRBJ2-7,CASSLIPREQYF,0,3,1,3
TRBV5-1,TRBJ1-2,CASSPDGYGYTF,0,3,1,3
TRBV4-1,TRBJ1-2,CASSQAGYGYTF,0,3,1,3
TRBV5-1,TRBJ2-1,CASSVNRGGEFF,0,3,1,3
TRBV5-1,TRBJ2-1,CASSITGTLVFF,0,3,1,3
TRBV20-1,TRBJ1-1,CSASVPSSEAFF,0,3,1,3
TRBV20-1,TRBJ1-2,CSARADSYGYTF,0,3,1,3
TRBV20-1,TRBJ2-7,CSASTGPGEQYF,0,3,1,3
TRBV20-1,TRBJ2-5,CSAGGGGETQYF,0,3,1,3
TRBV20-1,TRBJ2-3,CSASPGGHTQYF,0,3,1,3
TRBV20-1,TRBJ1-2,CSAQAGQTVPVA,0,3,1,3
TRBV20-1,TRBJ1-1,CSAAGGHTEAFF,0,3,1,3
TRBV20-1,TRBJ2-3,CSGWQKRDTQYF,0,3,1,3
TRBV29-1,TRBJ1-1,CSYAGINTEAFF,0,3,1,3
TRBV29-1,TRBJ2-1,CSVGWGDNVQFF,0,3,1,3
TRBV29-1,TRBJ2-3,CSVGGGGNTLYF,0,3,1,3
TRBV29-1,TRBJ2-3,CSVEAETNTQYF,0,3,1,3
TRBV29-1,TRBJ2-1,CSVEEGGAEQFF,0,3,1,3
TRBV29-1,TRBJ2-5,CSVRDSQETQYF,0,3,1,3
TRBV29-1,TRBJ2-1,CSARNPSGEQFF,0,3,1,3
TRBV29-1,TRBJ1-1,CSAQAGFTEAFF,0,3,1,3
TRBV29-1,TRBJ1-5,CSAEGGGQPQHF,0,3,1,3
TRBV30,TRBJ2-2,CAWTGTGELFF,0,3,1,3
TRBV30,TRBJ2-1,CAWSRATEQFF,0,3,1,3
TRBV28,TRBJ2-7,CAIQSTYEQYF,0,3,1,3
TRBV28,TRBJ2-3,CASGRGETQYF,0,3,1,3
TRBV28,TRBJ2-5,CASGGRETQYF,0,3,1,3
TRBV7-9,TRBJ2-5,CASDSQETQYF,0,3,1,3
TRBV28,TRBJ2-7,CASTNRYEQYF,0,3,1,3
TRBV28,TRBJ2-5,CASSFGTGGYF,0,3,1,3
TRBV6-2/3/5/6,TRBJ2-7,CASSLADEQYF,0,3,1,3
TRBV6-2/3/5/6,TRBJ2-3,CASSLTDTQYF,0,3,1,3
TRBV2,TRBJ2-5,CASSVEETQYF,0,3,1,3
TRBV7-9,TRBJ2-5,CASSRDTILYF,0,3,1,3
TRBV11-2,TRBJ2-7,CASSGQGEQYF,0,3,1,3
TRBV7-9,TRBJ2-7,CASSNHYEQYF,0,3,1,3
TRBV12-3/4,TRBJ2-5,CASSNGETQYF,0,3,1,3
TRBV12-3/4,TRBJ2-1,CASRQEGEQFF,0,3,1,3
TRBV2,TRBJ2-3,CASRGTDTQYF,0,3,1,3
TRBV6-2/3/5/6,TRBJ1-2,CASRRDYGYTF,0,3,1,3
TRBV5-1,TRBJ2-3,CASAETDTQYF,0,3,1,3
TRBV10-1,TRBJ1-2,CASSGQGGYTF,0,3,1,3
TRBV5-1,TRBJ2-7,CASREGSEQYF,0,3,1,3
TRBV5-1,TRBJ2-3,CASRTGNTQYF,0,3,1,3
TRBV20-1,TRBJ1-1,CSALRDSEAFF,0,3,1,3
TRBV29-1,TRBJ2-1,CSVGEQHEQFF,0,3,1,3
TRBV29-1,TRBJ2-7,CSVESGAGQYF,0,3,1,3
TRBV29-1,TRBJ2-1,CSVWTGNEQFF,0,3,1,3
TRBV29-1,TRBJ2-5,CSVGGGETQYF,0,3,1,3
TRBV29-1,TRBJ2-5,CSAGTGETQYF,0,3,1,3
TRBV29-1,TRBJ2-7,CSAGSSYEQYF,0,3,1,3
TRBV12-3/4,TRBJ2-1,CASSYNEQFF,0,3,1,3
TRBV29-1,TRBJ1-1,CSAGEEAFF,0,3,1,3
TRBV20-1,TRBJ2-1,CSARSTRRGLGLAGGLSYNEQFF,0,2,1,2
TRBV15,TRBJ2-1,CATSRETGSRLAGGMGYNEQFF,0,2,1,2
TRBV25-1,TRBJ2-4,CASTLNRDGKGVSGQAKNIQYF,0,2,1,2
TRBV12-5,TRBJ2-4,CASGFGGGYLDSSPKKNVQYF,0,2,1,2
TRBV6-2/3/5/6,TRBJ2-2,CASSSYPPGLAGGPEAGELFF,0,2,1,2
TRBV11-2,TRBJ2-3,CASSLSLYSGTSGRVTDTQYF,0,2,1,2
TRBV14,TRBJ2-1,CASSLTRPGTSGRTPYNEQFF,0,2,1,2
TRBV7-9,TRBJ2-1,CASSPRVGLAGGGGLNNEQFF,0,2,1,2
TRBV30,TRBJ2-3,CAWPVRSSGRRIGSTDTQYF,0,2,1,2
TRBV19,TRBJ2-6,CASSPGGEGQGHSGANVLTF,0,2,1,2
TRBV11-3,TRBJ1-5,CASSSYPRLGPSTTTQPQHF,0,2,1,2
TRBV20-1,TRBJ2-1,CSALRPVGAYNSPAYNEQFF,0,2,1,2
TRBV12-3/4,TRBJ2-1,CALIGVGKRTGGSGNEQFF,0,2,1,2
TRBV7-9,TRBJ2-1,CASSLMRYVSTSGVNEQFF,0,2,1,2
TRBV7-8,TRBJ2-7,CASSPSRTGTSQKAYEQYF,0,2,1,2
TRBV7-9,TRBJ2-2,CASSNRRPLAGGVTGELFF,0,2,1,2
TRBV28,TRBJ2-3,CASRPTSGTSSDSTDTQYF,0,2,1,2
TRBV7-2,TRBJ2-1,CASRKSALGVSWLGNEQFF,0,2,1,2
TRBV5-1,TRBJ2-7,CASSLADRFGGRTPYEQYF,0,2,1,2
TRBV20-1,TRBJ2-6,CSATLPKGASSSGANVLTF,0,2,1,2
TRBV20-1,TRBJ2-1,CSARGLIGLAQTTYNEQFF,0,2,1,2
TRBV20-1,TRBJ2-5,CSARGYRLAGVPRGETQYF,0,2,1,2
TRBV29-1,TRBJ2-1,CSVAGGLAGVFSSYNEQFF,0,2,1,2
TRBV29-1,TRBJ2-5,CSVTFGGLAGVVREETQYF,0,2,1,2
TRBV19,TRBJ2-6,CASSLTSGRTTGANVLTF,0,2,1,2
TRBV19,TRBJ2-1,CASSIPTMGLVGSNEQFF,0,2,1,2
TRBV19,TRBJ1-5,CASSIGVRGARSNQPQHF,0,2,1,2
TRBV18,TRBJ1-1,CASSPGMGQGEENTEAFF,0,2,1,2
TRBV18,TRBJ1-1,CASSRLFRDSQLNTEAFL,0,2,1,2
TRBV28,TRBJ2-3,CASSSTGTSGRPTISQYF,0,2,1,2
TRBV6-2/3/5/6,TRBJ2-7,CASSSRVLAGRGAYEQYF,0,2,1,2
TRBV6-2/3/5/6,TRBJ2-2,CASSYSPGTGKGTGELFF,0,2,1,2
TRBV6-2/3/5/6,TRBJ2-3,CASSYSGSRGDPTDTQYF,0,2,1,2
TRBV6-2/3/5/6,TRBJ2-7,CASSYSRTPSGSIAEQYF,0,2,1,2
TRBV7-2,TRBJ2-1,CASSFPPHSGRAIGEQFF,0,2,1,2
TRBV7-8,TRBJ2-7,CASSFQVLAGETSYEQYF,0,2,1,2
TRBV11-2,TRBJ2-6,CASSFRQRGQSGANVLTF,0,2,1,2
TRBV7-9,TRBJ2-6,CASSFVPGWLFGANVLTF,0,2,1,2
TRBV5-4,TRBJ2-5,CASSLGLAGGRGQETQYF,0,2,1,2
TRBV7-9,TRBJ2-1,CASSLAFRLAGGRNEQFF,0,2,1,2
TRBV7-2,TRBJ2-4,CASSLGTGRNLAKNIQYF,0,2,1,2
TRBV7-9,TRBJ2-2,CASSSTRTSGRDTGELFF,0,2,1,2
TRBV6-2/3/5/6,TRBJ2-3,CASSWDRDGMGITDTQYF,0,2,1,2
TRBV11-2,TRBJ2-1,CASSYKGRADRSYNEQFF,0,2,1,2
TRBV7-2,TRBJ2-1,CASSPRTRGWNSYNEQFF,0,2,1,2
TRBV4-2,TRBJ2-3,CASSQDRHRGTSPDTQYF,0,2,1,2
TRBV14,TRBJ2-3,CASSQDLVSGTSTDTQYF,0,2,1,2
TRBV9,TRBJ2-2,CASSVGLAGGSVTGELFF,0,2,1,2
TRBV3-1,TRBJ2-1,CASSVRLAVSWGYNEQFF,0,2,1,2
TRBV5-4,TRBJ2-1,CASSGGASGSVGYNEQFF,0,2,1,2
TRBV6-2/3/5/6,TRBJ2-1,CASRGGFHGSAQDNEQFF,0,2,1,2
TRBV5-1,TRBJ2-3,CASSFGAAGGSLTDTQYF,0,2,1,2
TRBV5-1,TRBJ2-7,CASSSGLAGAIYYIEQYF,0,2,1,2
TRBV5-1,TRBJ2-3,CASSWQAGGAGGTDTQYF,0,2,1,2
TRBV20-1,TRBJ2-1,CSARKGGRARRNYNEQFF,0,2,1,2
TRBV20-1,TRBJ2-4,CSARDPWASGMAKNIQYF,0,2,1,2
TRBV20-1,TRBJ2-7,CSARDERGGTDDHYEQYF,0,2,1,2
TRBV15,TRBJ2-3,CVTSKAFSGEATDTQYF,0,2,1,2
TRBV12-5,TRBJ2-1,CASGLPFLRESYNEQFF,0,2,1,2
TRBV30,TRBJ1-5,CAWSVKRTGGSYQPQHF,0,2,1,2
TRBV10-3,TRBJ2-6,CAISEGAGSSGANVLTF,0,2,1,2
TRBV12-3/4,TRBJ2-1,CATSWSPTASSYNEQFF,0,2,1,2
TRBV24-1,TRBJ2-2,CATSDLSGSGYTGELFF,0,2,1,2
TRBV15,TRBJ2-6,CATSRVTGAAGANVLTF,0,2,1,2
TRBV15,TRBJ2-2,CATSRDRLAVNTGELFY,0,2,1,2
TRBV9,TRBJ2-2,CASSLASGTMNTGELFF,0,2,1,2
TRBV19,TRBJ1-1,CASSRTRRQGINTEAFF,0,2,1,2
TRBV18,TRBJ2-1,CASSSLLASTTGNEQFF,0,2,1,2
TRBV18,TRBJ2-5,CASSPGTASGDQETQYF,0,2,1,2
TRBV18,TRBJ2-5,CASSPISLDSAWETQYF,0,2,1,2
TRBV18,TRBJ2-2,CASSPSLGEGGTGELFF,0,2,1,2
TRBV18,TRBJ2-7,CASSPPTSGDGFHEQYF,0,2,1,2
TRBV18,TRBJ2-1,CASSPRQGTSSYNEQFF,0,2,1,2
TRBV18,TRBJ2-6,CASSRFNGYSGANVLTF,0,2,1,2
TRBV7-8,TRBJ2-3,CASASGTTTFSTDTQYF,0,2,1,2
TRBV2,TRBJ2-3,CASGRGLAGGFGDTQYF,0,2,1,2
TRBV5-4,TRBJ2-6,CASTLGQTPSGANVLTF,0,2,1,2
TRBV28,TRBJ2-5,CASSFRAGHRTQETQYF,0,2,1,2
TRBV28,TRBJ2-2,CASSLLLAGGGTGELFF,0,2,1,2
TRBV27,TRBJ2-1,CASSLGGLAGGVNEQFF,0,2,1,2
TRBV27,TRBJ2-1,CASSLDLAGVGGNEQFF,0,2,1,2
TRBV28,TRBJ1-2,CASSLESVITVQYGYTF,0,2,1,2
TRBV6-2/3/5/6,TRBJ2-2,CASSSALTSGNTGELFF,0,2,1,2
TRBV6-2/3/5/6,TRBJ2-1,CASSYSHGVGSVDEQFF,0,2,1,2
TRBV6-2/3/5/6,TRBJ2-1,CASSYYPPGGPYNEQFF,0,2,1,2
TRBV12-3/4,TRBJ2-1,CASSPPHREIPYNEQFF,0,2,1,2
TRBV6-1,TRBJ2-1,CASSQGQAGSSYNEQFF,0,2,1,2
TRBV6-4,TRBJ2-1,CASSDVFFGTLKNEQFF,0,2,1,2
TRBV25-1,TRBJ2-2,CASSEFGTSGSDGELFF,0,2,1,2
TRBV6-1,TRBJ2-7,CASSEMGLAGGTYEQYF,0,2,1,2
TRBV6-1,TRBJ2-7,CASSETETSGRRYEQYF,0,2,1,2
TRBV5-6,TRBJ2-7,CASSFSLAGRDSYEQYF,0,2,1,2
TRBV5-6,TRBJ2-1,CASSFRPQVPPYNEQFF,0,2,1,2
TRBV5-4,TRBJ2-2,CASSLGGRTGSSGELFF,0,2,1,2
TRBV11-1,TRBJ2-1,CASSLGRGRFQSNEQFF,0,2,1,2
TRBV5-6,TRBJ2-7,CASSLDGPGASSYEQYF,0,2,1,2
TRBV7-2,TRBJ2-5,CASSLVLSGRVLETQYF,0,2,1,2
TRBV11-3,TRBJ2-5,CASSLGLAGADGETQYF,0,2,1,2
TRBV7-9,TRBJ2-5,CASSLGSSSGFQETQYF,0,2,1,2
TRBV9,TRBJ2-1,CASSSEGLAEAYNEQFF,0,2,1,2
TRBV7-9,TRBJ2-5,CASSSSRLSGTQETQYF,0,2,1,2
TRBV11-2,TRBJ2-1,CASSSQFTGNSYNEQSF,0,2,1,2
TRBV7-9,TRBJ2-3,CASSWGLFGAGADTQYF,0,2,1,2
TRBV13,TRBJ1-2,CASSLGTGRTLNYGYTF,0,2,1,2
TRBV4-2,TRBJ2-2,CASSLKEGTGADGELFF,0,2,1,2
TRBV6-2/3/5/6,TRBJ1-1,CASSLRQGGTGGTEAFF,0,2,1,2
TRBV13,TRBJ2-6,CASSPPGGVSGANVLTF,0,2,1,2
TRBV6-2/3/5/6,TRBJ2-3,CASSPEPAGGPRDTQYF,0,2,1,2
TRBV7-2,TRBJ2-1,CASSPRTLKGAYNEQFF,0,2,1,2
TRBV9,TRBJ2-4,CASSPHPDRPPKNIQYF,0,2,1,2
TRBV28,TRBJ2-6,CASSPPGVGTGANVLTF,0,2,1,2
TRBV7-2,TRBJ2-1,CASSPGALAGRYNEQFF,0,2,1,2
TRBV6-2/3/5/6,TRBJ2-1,CASSQQPGTSGHNEQFF,0,2,1,2
TRBV4-2,TRBJ2-7,CASSQVATSGIAYEQYF,0,2,1,2
TRBV4-2,TRBJ2-7,CASSQDPVGGSHYEQYF,0,2,1,2
TRBV3-1,TRBJ2-3,CASSQETSDLFGDTQYF,0,2,1,2
TRBV7-9,TRBJ2-3,CASSVFRDRWDTDTQYF,0,2,1,2
TRBV5-1,TRBJ2-1,CASSLEGSLSSYNEQFF,0,2,1,2
TRBV4-1,TRBJ2-5,CASSQDGLAGVRETQYF,0,2,1,2
TRBV5-1,TRBJ2-1,CASSLVSGSASYNEQFF,0,2,1,2
TRBV5-1,TRBJ2-3,CASSLVLAGSGTDTQYF,0,2,1,2
TRBV5-1,TRBJ2-3,CASSLAYAGGGADTQYF,0,2,1,2
TRBV5-1,TRBJ2-2,CASSLAVDRINTGELFF,0,2,1,2
TRBV5-1,TRBJ2-6,CASSLAGQGSGANVLTF,0,2,1,2
TRBV5-1,TRBJ1-5,CASSLGGTLGSNQPQHF,0,2,1,2
TRBV5-1,TRBJ2-4,CASSLEPGHPTGNIQYF,0,2,1,2
TRBV5-1,TRBJ2-1,CASSLEGPAASYNEQYF,0,2,1,2
TRBV5-1,TRBJ2-4,CASSSQLGLAGGNIQYF,0,2,1,2
TRBV5-1,TRBJ2-1,CASSWRTGGPGANEQFF,0,2,1,2
TRBV4-1,TRBJ2-1,CASSLTSGTGPYNEQFF,0,2,1,2
TRBV5-1,TRBJ2-1,CASSPGTSGREYNEQFF,0,2,1,2
TRBV4-1,TRBJ2-7,CASSPSSRGGGTYEQYF,0,2,1,2
TRBV4-1,TRBJ1-5,CASSQEGLGQRNQPQHF,0,2,1,2
TRBV4-1,TRBJ2-1,CASSQPSTSGRDNEQFF,0,2,1,2
TRBV4-1,TRBJ2-1,CASSQDPSTSDHNEQFF,0,2,1,2
TRBV20-1,TRBJ2-3,CSAFSGGAGGPEDTQYF,0,2,1,2
TRBV29-1,TRBJ2-1,CSVLLRVPYDSYNEQFF,0,2,1,2
TRBV5-1,TRBJ2-1,YASSLGGTGGAYNEQFF,0,2,1,2
TRBV4-1,TRBJ1-2,RASSQLTKDYGNYGYTF,0,2,1,2
TRBV30,TRBJ2-1,CAWSVHIGLSENEQFF,0,2,1,2
TRBV24-1,TRBJ2-1,CATTTSGANSYNEQFF,0,2,1,2
TRBV24-1,TRBJ2-2,CATSDLRDDAAGELFF,0,2,1,2
TRBV24-1,TRBJ2-1,CATSDSGTSGRDEQFF,0,2,1,2
TRBV24-1,TRBJ2-5,CATSETGLAGQETQYF,0,2,1,2
TRBV5-5,TRBJ2-6,CASCSPMAHGANVLTF,0,2,1,2
TRBV19,TRBJ2-2,CASSIWSGRAFGELFL,0,2,1,2
TRBV19,TRBJ2-1,CASSRGLADSYNEQFF,0,2,1,2
TRBV6-2/3/5/6,TRBJ2-1,CASLPPLGESYNEQFF,0,2,1,2
TRBV18,TRBJ1-2,CASSPLRDRVGDGYTF,0,2,1,2
TRBV18,TRBJ2-1,CASSPAGQGSYNEQFF,0,2,1,2
TRBV18,TRBJ1-1,CASSPLSEGVNTEAFL,0,2,1,2
TRBV18,TRBJ2-3,CASSPKEGGGADTQYF,0,2,1,2
TRBV6-2/3/5/6,TRBJ2-3,CASRPGYSGSKDTQYF,0,2,1,2
TRBV19,TRBJ2-7,CASRDGAGEGSYEQCF,0,2,1,2
TRBV27,TRBJ2-7,CASGPLGAGVNYEQYF,0,2,1,2
TRBV12-3/4,TRBJ2-2,CASTLPGLAVKGELFF,0,2,1,2
TRBV12-3/4,TRBJ2-3,CASTPRGGGGTDTQYF,0,2,1,2
TRBV12-3/4,TRBJ2-1,CASTPGGSTKGGEQFF,0,2,1,2
TRBV7-9,TRBJ2-2,CASSFPGLAITGELFF,0,2,1,2
TRBV28,TRBJ2-7,CASSFTPTHISYEQYF,0,2,1,2
TRBV28,TRBJ2-7,CASSFHLRDLNYEQYF,0,2,1,2
TRBV12-3/4,TRBJ2-5,CASSLWASSTQETQYF,0,2,1,2
TRBV28,TRBJ2-1,CASSLPAVVLIGEQFF,0,2,1,2
TRBV6-2/3/5/6,TRBJ2-1,CASSLARSGRRNEQFF,0,2,1,2
TRBV12-3/4,TRBJ2-7,CASSSPSGSGVYEQYF,0,2,1,2
TRBV10-3,TRBJ2-1,CASSSFGTSGHNEQFF,0,2,1,2
TRBV27,TRBJ2-1,CASSSTTPLDYNEQFF,0,2,1,2
TRBV6-2/3/5/6,TRBJ2-1,CASSYFGATSLNEQFF,0,2,1,2
TRBV6-2/3/5/6,TRBJ1-1,CASSYSPAAPNTEAFF,0,2,1,2
TRBV6-2/3/5/6,TRBJ1-6,CASSYSGRPVNSPLHF,0,2,1,2
TRBV6-2/3/5/6,TRBJ2-3,CASSYQLAGVADTQYF,0,2,1,2
TRBV6-2/3/5/6,TRBJ2-2,CASSYGGVPNTGELFF,0,2,1,2
TRBV2,TRBJ2-2,CASSYGRGGGTGELFF,0,2,1,2
TRBV11-2,TRBJ1-1,CASSPRGGSMNAEAFF,0,2,1,2
TRBV6-1,TRBJ2-2,CASSVLDRTNTGELFF,0,2,1,2
TRBV5-4,TRBJ2-3,CASSASTSGNTDTQYF,0,2,1,2
TRBV2,TRBJ2-7,CASSEGPTSGKREQYF,0,2,1,2
TRBV25-1,TRBJ2-7,CASSEYTATSSYEQYF,0,2,1,2
TRBV2,TRBJ2-7,CASSEAVAGAPYKQYL,0,2,1,2
TRBV2,TRBJ2-5,CASSEGLSRHQETQYF,0,2,1,2
TRBV2,TRBJ2-5,CASSEGLAGGGETQYF,0,2,1,2
TRBV7-2,TRBJ2-3,CASSFVAGTSANTQYF,0,2,1,2
TRBV7-2,TRBJ2-2,CASSFGSDRATGELFF,0,2,1,2
TRBV5-4,TRBJ2-3,CASSLPGLTRTDTQYF,0,2,1,2
TRBV4-2,TRBJ2-1,CASSLHVREPRNEQFF,0,2,1,2
TRBV5-4,TRBJ1-1,CASSLGPAGVNTEAFF,0,2,1,2
TRBV5-4,TRBJ2-2,CASSLEAGANTGELFF,0,2,1,2
TRBV5-8,TRBJ2-1,CASSLTPDRADDEQFF,0,2,1,2
TRBV7-2,TRBJ1-2,CASSLLGQSTVYGYTF,0,2,1,2
TRBV7-9,TRBJ2-1,CASSLVSLAGVHEQFF,0,2,1,2
TRBV7-2,TRBJ2-7,CASSLVYSGRGSEQYF,0,2,1,2
TRBV7-2,TRBJ2-1,CASSLAGTSSYNEQFF,0,2,1,2
TRBV7-9,TRBJ1-1,CASSLAGAGVGTEAFF,0,2,1,2
TRBV11-3,TRBJ2-1,CASSLGMGSSYNEQFF,0,2,1,2
TRBV7-2,TRBJ2-2,CASSLDSGRAAGELFF,0,2,1,2
TRBV7-6,TRBJ2-1,CASSLNGGGSYNEQFF,0,2,1,2
TRBV6-2/3/5/6,TRBJ2-7,CASSYGLGLPNYEQYF,0,2,1,2
TRBV7-9,TRBJ2-1,CASSYETGVLLNEQFF,0,2,1,2
TRBV7-9,TRBJ2-3,CASSYTSGILGDTQYF,0,2,1,2
TRBV3-1,TRBJ2-1,CASSPLPSGSRNEQFF,0,2,1,2
TRBV7-9,TRBJ2-3,CASSPGPGEGTDTQYF,0,2,1,2
TRBV6-2/3/5/6,TRBJ2-1,CASSPPGTRKYNEQFF,0,2,1,2
TRBV14,TRBJ2-1,CASSPRFTTISNEQFF,0,2,1,2
TRBV7-3,TRBJ2-1,CASSPRGGGSYNEQFF,0,2,1,2
TRBV9,TRBJ2-1,CASSPRTSGRRNEQFF,0,2,1,2
TRBV7-2,TRBJ2-7,CASSPGLAGASYEQYF,0,2,1,2
TRBV7-9,TRBJ2-2,CASSPRSGRVTGELFF,0,2,1,2
TRBV7-9,TRBJ2-3,CASSPKREGFTDTQYF,0,2,1,2
TRBV7-9,TRBJ1-4,CASSPLQTGRGEKLFF,0,2,1,2
TRBV7-3,TRBJ2-7,CASSPRDCTSSYEQYF,0,2,1,2
TRBV11-2,TRBJ2-1,CASSPLAGNSYNEQFF,0,2,1,2
TRBV7-9,TRBJ1-3,CASSPLRPSSGNTIYF,0,2,1,2
TRBV3-1,TRBJ2-1,CASSPGTSGRRNEQFF,0,2,1,2
TRBV3-1,TRBJ2-3,CASSRRAGVGTDTQYF,0,2,1,2
TRBV12-3/4,TRBJ1-5,CASSRSTRGENQPQHF,0,2,1,2
TRBV5-6,TRBJ2-5,CASSRRQFSGQETQYF,0,2,1,2
TRBV7-6,TRBJ2-7,CASSHEISGSSYEQYF,0,2,1,2
TRBV6-4,TRBJ2-1,CASSHRGLAMNNEQFF,0,2,1,2
TRBV7-9,TRBJ2-1,CASSQPGQGANNERFF,0,2,1,2
TRBV7-2,TRBJ2-3,CASSQRSSGSTDTQYF,0,2,1,2
TRBV14,TRBJ1-2,CASSQQRTSGAHGYTF,0,2,1,2
TRBV3-1,TRBJ2-1,CASSQVVLAGVREQFF,0,2,1,2
TRBV4-2,TRBJ2-7,CASSQAQDPGGSEQYF,0,2,1,2
TRBV16,TRBJ2-1,CASSQALAGAYNEQFF,0,2,1,2
TRBV4-2,TRBJ2-2,CASSQAPGPLTGELFF,0,2,1,2
TRBV14,TRBJ2-1,CASSQATSAINNEQFF,0,2,1,2
TRBV3-1,TRBJ1-4,CASSQGDRSSNEKLFF,0,2,1,2
TRBV4-2,TRBJ2-7,CASSQGEGLGLYEQYF,0,2,1,2
TRBV7-2,TRBJ2-1,CASSQGGQRSYNEQFF,0,2,1,2
TRBV4-2,TRBJ1-2,CASSQDRTISLDGYTF,0,2,1,2
TRBV9,TRBJ2-7,CASSVASGRAISEQYF,0,2,1,2
TRBV9,TRBJ2-7,CASSVEGQVGFYEQYF,0,2,1,2
TRBV5-6,TRBJ2-5,CASSAKLAGIQETQYF,0,2,1,2
TRBV6-4,TRBJ2-3,CASSDPVSFRANTQYF,0,2,1,2
TRBV6-1,TRBJ2-5,CASSEVSRWGRETQYF,0,2,1,2
TRBV7-8,TRBJ2-5,CASSIRDPHRRETQYF,0,2,1,2
TRBV5-5,TRBJ2-1,CASSTLAGVGYNEQFF,0,2,1,2
TRBV7-6,TRBJ2-2,CASSTIRGLAPGELFF,0,2,1,2
TRBV7-8,TRBJ1-6,CASRDRGSSYNSPLHF,0,2,1,2
TRBV12-3/4,TRBJ2-1,CASNVHRGPGGNEQFF,0,2,1,2
TRBV5-1,TRBJ2-1,CASCPMGEPGGNEQFF,0,2,1,2
TRBV5-1,TRBJ2-7,CASSLQRGGRSYEQYF,0,2,1,2
TRBV5-1,TRBJ2-7,CASSFLVPSGSYEQYF,0,2,1,2
TRBV5-1,TRBJ2-7,CASSFGTSGLSYEQYF,0,2,1,2
TRBV5-1,TRBJ2-1,CASSLVLLAAAREQFF,0,2,1,2
TRBV5-1,TRBJ2-3,CASSLDLQRGGDTQYF,0,2,1,2
TRBV5-1,TRBJ1-4,CASSLTGQTTNEKLFF,0,2,1,2
TRBV5-1,TRBJ2-7,CASSLRLAGELREQYF,0,2,1,2
TRBV5-1,TRBJ2-3,CASSLRTGESTDTQYL,0,2,1,2
TRBV5-1,TRBJ2-2,CASSPLGLTGIGELFF,0,2,1,2
TRBV4-1,TRBJ1-6,CASSRDRGLNDSHLHF,0,2,1,2
TRBV5-1,TRBJ1-2,CASSRGDRGPNYGYTF,0,2,1,2
TRBV4-1,TRBJ2-1,CASSHGPSGRLNEQFF,0,2,1,2
TRBV4-1,TRBJ2-2,CASSQASGPNTGELFF,0,2,1,2
TRBV4-1,TRBJ1-1,CASSQETTLQATEAFF,0,2,1,2
TRBV10-2,TRBJ2-1,CASSAPREPPYNEQFF,0,2,1,2
TRBV5-1,TRBJ2-6,CASSTGQGSGANVLTF,0,2,1,2
TRBV5-1,TRBJ2-1,CASRLAPSGAYNEQFF,0,2,1,2
TRBV5-1,TRBJ2-1,CGSSSGTSGSYNEQFF,0,2,1,2
TRBV20-1,TRBJ2-2,CSAIPFGGVSTGELFF,0,2,1,2
TRBV20-1,TRBJ2-5,CSASMLAGVGQETQNF,0,2,1,2
TRBV20-1,TRBJ2-6,CSARGRGKPGANVLTF,0,2,1,2
TRBV20-1,TRBJ2-3,CSARATGGRGTDTQYF,0,2,1,2
TRBV20-1,TRBJ2-5,CSARDSGREAGETQYF,0,2,1,2
TRBV20-1,TRBJ2-4,CSARDRARTSKNIQYF,0,2,1,2
TRBV20-1,TRBJ2-1,CSAQNPTSGDYNEQFF,0,2,1,2
TRBV20-1,TRBJ1-3,CSAIGPPEAGGNTIYF,0,2,1,2
TRBV20-1,TRBJ2-1,CSARVQAAGAYNEQFF,0,2,1,2
TRBV29-1,TRBJ2-3,CSVASRQGVSTDTQYF,0,2,1,2
TRBV29-1,TRBJ2-3,CSVALAGVGRTDTQYF,0,2,1,2
TRBV29-1,TRBJ2-1,CSVDASAKGGRNEQFF,0,2,1,2
TRBV19,TRBJ1-5,RASKGSAFNSNQPQHF,0,2,1,2
TRBV30,TRBJ1-1,CAWSAGPIQYTEAFF,0,2,1,2
TRBV30,TRBJ1-3,CAWSAGALPGNTIYF,0,2,1,2
TRBV30,TRBJ1-1,CAWRGIGEMNTEAFF,0,2,1,2
TRBV30,TRBJ1-1,CAWRTLGQGAGEAFF,0,2,1,2
TRBV19,TRBJ2-3,CAAGPQRGDGDTQYF,0,2,1,2
TRBV5-6,TRBJ2-1,CAGSFLLAANNEQFF,0,2,1,2
TRBV28,TRBJ2-7,CAIRGETGNSYEQYF,0,2,1,2
TRBV10-3,TRBJ2-1,CAIRGDHAGDNEQFF,0,2,1,2
TRBV24-1,TRBJ1-1,CATSDGGTVFSEAFF,0,2,1,2
TRBV15,TRBJ2-1,CATSLRTGQGNEQFF,0,2,1,2
TRBV19,TRBJ2-7,CASSLQGGYSYEQYF,0,2,1,2
TRBV19,TRBJ1-2,CASSPPGGWSYGYTF,0,2,1,2
TRBV19,TRBJ1-5,CASSHDGQGKQPQHF,0,2,1,2
TRBV19,TRBJ2-1,CASSITSGGLNEQFF,0,2,1,2
TRBV19,TRBJ2-7,CASSIVPTSRYEQYF,0,2,1,2
TRBV19,TRBJ2-7,CASSTWTSGIHEQYF,0,2,1,2
TRBV19,TRBJ2-7,CASSTQLAGAVEQYF,0,2,1,2
TRBV19,TRBJ2-1,CASSRLAGVNNEQFF,0,2,1,2
TRBV19,TRBJ2-3,CASSNPRAALDTQYF,0,2,1,2
TRBV19,TRBJ1-2,CASRPGPNEGDGYTF,0,2,1,2
TRBV19,TRBJ2-1,CASRRTSGGYNEQFL,0,2,1,2
TRBV19,TRBJ1-2,CASKTTGDFNYGYTF,0,2,1,2
TRBV6-2/3/5/6,TRBJ2-1,CASLTGLAGGNEQFF,0,2,1,2
TRBV18,TRBJ2-7,CASSLRDTRLYEQYF,0,2,1,2
TRBV18,TRBJ2-1,CASSPITSGRNEQFF,0,2,1,2
TRBV18,TRBJ2-1,CASSDVQGGYNEQFF,0,2,1,2
TRBV18,TRBJ2-2,CASSPPSGGTGELFF,0,2,1,2
TRBV18,TRBJ1-6,CASSPRQGLNSPLHF,0,2,1,2
TRBV18,TRBJ1-1,CASSPQNPLNTEAFF,0,2,1,2
TRBV18,TRBJ2-7,CASSPRRRGEYEQYF,0,2,1,2
TRBV18,TRBJ2-3,CASSEGWASTDKQYF,0,2,1,2
TRBV28,TRBJ1-4,CASLNPSGRDEKLFF,0,2,1,2
TRBV11-2,TRBJ2-4,CASRTWGLGETIQYF,0,2,1,2
TRBV2,TRBJ2-3,CASHGGPPGTDTQYF,0,2,1,2
TRBV27,TRBJ2-3,CASQGTSDSTDTQYF,0,2,1,2
TRBV5-4,TRBJ2-5,CASGERLAGQETQCF,0,2,1,2
TRBV6-2/3/5/6,TRBJ1-2,CASGRQGRANYGYTF,0,2,1,2
TRBV2,TRBJ2-2,CASDTSGVNTGELFF,0,2,1,2
TRBV6-2/3/5/6,TRBJ2-1,CASELVGQGYNEQFF,0,2,1,2
TRBV28,TRBJ2-7,CASIGTGGLSYEQYF,0,2,1,2
TRBV7-2,TRBJ2-1,CASTRGSSGTNEQFF,0,2,1,2
TRBV6-2/3/5/6,TRBJ2-3,CASSFVAGGGDTQYF,0,2,1,2
TRBV6-2/3/5/6,TRBJ1-2,CASSFGDRGRSGYTF,0,2,1,2
TRBV28,TRBJ2-7,CASSLGVLSWYEQYF,0,2,1,2
TRBV6-2/3/5/6,TRBJ2-5,CASSLSSGGQETQYF,0,2,1,2
TRBV12-3/4,TRBJ2-2,CASSLIGGGTGELFF,0,2,1,2
TRBV28,TRBJ2-3,CASSLTSGQTDTQYF,0,2,1,2
TRBV28,TRBJ2-1,CASSSGGRSYNEQFF,0,2,1,2
TRBV6-2/3/5/6,TRBJ1-2,CASSSPGRGDYGYTF,0,2,1,2
TRBV5-5,TRBJ1-4,CASSSGGGTNEKLFF,0,2,1,2
TRBV28,TRBJ2-1,CASSSSGAGYNEQFF,0,2,1,2
TRBV6-2/3/5/6,TRBJ2-1,CASSSPSGRGDEQFF,0,2,1,2
TRBV6-2/3/5/6,TRBJ1-4,CASSSGRGVNEKLFF,0,2,1,2
TRBV6-2/3/5/6,TRBJ2-7,CASSYATGETYEQYF,0,2,1,2
TRBV6-2/3/5/6,TRBJ2-7,CASSYAGQLPYEQYF,0,2,1,2
TRBV6-2/3/5/6,TRBJ2-7,CASSYGGGDLREQYF,0,2,1,2
TRBV6-2/3/5/6,TRBJ2-7,CASSYTMARAYEQYF,0,2,1,2
TRBV6-2/3/5/6,TRBJ2-5,CASSPHRGLDETQYF,0,2,1,2
TRBV27,TRBJ2-1,CASSPFRPDGDEQFF,0,2,1,2
TRBV28,TRBJ2-7,CASSQTGAPSYEQYF,0,2,1,2
TRBV6-1,TRBJ2-1,CASSAGGPPSDEQFF,0,2,1,2
TRBV6-1,TRBJ2-1,CASSDFGTSEDEQFF,0,2,1,2
TRBV25-1,TRBJ2-3,CASSDPSGRTDTQYF,0,2,1,2
TRBV6-4,TRBJ2-2,CASSDQGTDSGELFF,0,2,1,2
TRBV2,TRBJ2-5,CASSELSLASVTQYF,0,2,1,2
TRBV25-1,TRBJ2-5,CASSEWIGRVETQYF,0,2,1,2
TRBV6-1,TRBJ2-7,CASSEVVTPSYEQYF,0,2,1,2
TRBV2,TRBJ2-3,CASSEAGAGGDTQYF,0,2,1,2
TRBV6-1,TRBJ2-2,CASSEALGNTGELFF,0,2,1,2
TRBV2,TRBJ2-1,CASSEEGQGADEQFF,0,2,1,2
TRBV5-4,TRBJ2-1,CASSFSSGWANEQFF,0,2,1,2
TRBV7-3,TRBJ2-1,CASSFGSGPRGEQFF,0,2,1,2
TRBV5-4,TRBJ2-6,CASSFNRESPNVLTF,0,2,1,2
TRBV5-6,TRBJ2-5,CASSLALGTLVTQYF,0,2,1,2
TRBV5-5,TRBJ2-6,CASSLAGSGANVLTF,0,2,1,2
TRBV5-5,TRBJ2-3,CASSLAQGGTDTQYF,0,2,1,2
TRBV7-9,TRBJ1-2,CASSLGVAGAYGYTF,0,2,1,2
TRBV5-6,TRBJ2-1,CASSLGWTSPNEQFF,0,2,1,2
TRBV5-4,TRBJ2-1,CASSLDSGTYNEQFF,0,2,1,2
TRBV5-6,TRBJ2-7,CASSLERQNRNEQYF,0,2,1,2
TRBV5-5,TRBJ1-5,CASSLERQGTQPQHF,0,2,1,2
TRBV5-4,TRBJ2-1,CASSLSGRPGNEQFF,0,2,1,2
TRBV7-2,TRBJ2-1,CASSLAGSSYNEQFF,0,2,1,2
TRBV7-9,TRBJ2-7,CASSLALAGINEQYF,0,2,1,2
TRBV7-9,TRBJ2-1,CASSLAGGSDNEQFF,0,2,1,2
TRBV7-8,TRBJ2-5,CASSLGAGRQETQYF,0,2,1,2
TRBV11-2,TRBJ2-7,CASSLGGGMPYEQYF,0,2,1,2
TRBV7-9,TRBJ2-5,CASSLGSGGQETQYF,0,2,1,2
TRBV7-2,TRBJ2-3,CASSLGLWGRDTQYF,0,2,1,2
TRBV7-9,TRBJ2-5,CASSLGPRSKETQYF,0,2,1,2
TRBV11-3,TRBJ2-2,CASSLDQQGGGELFF,0,2,1,2
TRBV7-2,TRBJ1-5,CASSLDGGGGQPQHF,0,2,1,2
TRBV11-2,TRBJ2-5,CASSLSGTKQETQYF,0,2,1,2
TRBV7-6,TRBJ2-1,CASSLNQATHNEQFF,0,2,1,2
TRBV5-4,TRBJ2-7,CASSSTSGDFYEQYF,0,2,1,2
TRBV6-2/3/5/6,TRBJ2-7,CASSSLSGGFREQYF,0,2,1,2
TRBV7-2,TRBJ2-1,CASSSQAGGYNEQFF,0,2,1,2
TRBV11-3,TRBJ2-1,CASSSGTSGSHEQFF,0,2,1,2
TRBV7-9,TRBJ2-7,CASSSRPGPSYEQYF,0,2,1,2
TRBV7-2,TRBJ2-7,CASSSNGRISYEQYF,0,2,1,2
TRBV11-2,TRBJ1-1,CASSSWPDSDTEAFF,0,2,1,2
TRBV7-9,TRBJ2-7,CASSSGPRVTYEQYF,0,2,1,2
TRBV5-4,TRBJ2-7,CASSWAGTGTFEQYF,0,2,1,2
TRBV7-3,TRBJ2-1,CASSYLAGVSNEQFF,0,2,1,2
TRBV11-2,TRBJ1-1,CASSYNQGPYTEAFF,0,2,1,2
TRBV7-2,TRBJ2-6,CASSLDHSGANVLTF,0,2,1,2
TRBV13,TRBJ2-3,CASSLRDGSTDTQYF,0,2,1,2
TRBV11-3,TRBJ2-2,CASSLGLAGTGELFF,0,2,1,2
TRBV7-2,TRBJ2-3,CASSLDPLSTDTQYF,0,2,1,2
TRBV27,TRBJ2-1,CASSLDWDSYNEQFF,0,2,1,2
TRBV7-9,TRBJ1-1,CASSPLGGPGAEAFF,0,2,1,2
TRBV7-8,TRBJ2-3,CASSPRPRAPDTQYF,0,2,1,2
TRBV7-6,TRBJ2-5,CASSPNRDSQETQYF,0,2,1,2
TRBV3-1,TRBJ1-1,CASSPQQGEGLQAFF,0,2,1,2
TRBV9,TRBJ2-3,CASSPPGSYTDTQYF,0,2,1,2
TRBV5-4,TRBJ2-7,CASSRGGGVSYEQYF,0,2,1,2
TRBV5-4,TRBJ2-7,CASSRGVVAPYEQYF,0,2,1,2
TRBV14,TRBJ2-3,CASSRDRGWPDTQYF,0,2,1,2
TRBV6-2/3/5/6,TRBJ2-5,CASSRDRREAETQYF,0,2,1,2
TRBV5-5,TRBJ2-7,CASSRTSGAPYEQYF,0,2,1,2
TRBV7-2,TRBJ1-5,CASSRAGGGNQPQHF,0,2,1,2
TRBV13,TRBJ2-5,CASSHRTSNQETQYF,0,2,1,2
TRBV5-4,TRBJ2-7,CASSQELGSSYEQYF,0,2,1,2
TRBV7-9,TRBJ2-1,CASSQIRPTDNEQFF,0,2,1,2
TRBV3-1,TRBJ2-5,CASSQNVGGPETQYF,0,2,1,2
TRBV4-2,TRBJ1-2,CASSQPGQSHYGYTF,0,2,1,2
TRBV3-1,TRBJ2-1,CASSQVGLAGSKQFF,0,2,1,2
TRBV4-2,TRBJ2-5,CASSQAGRQQETQYF,0,2,1,2
TRBV3-1,TRBJ1-5,CASSQGALGDQPQHF,0,2,1,2
TRBV4-2,TRBJ2-7,CASSQGAAGAYEQYF,0,2,1,2
TRBV3-1,TRBJ2-5,CASSQDGNSWETQYF,0,2,1,2
TRBV4-2,TRBJ1-2,CASSQEEGLSYGYTF,0,2,1,2
TRBV9,TRBJ2-3,CASSVGTGTTDTQYF,0,2,1,2
TRBV11-2,TRBJ2-2,CASSVDRGNAGELFF,0,2,1,2
TRBV7-9,TRBJ2-1,CASSVIASSYNEQFF,0,2,1,2
TRBV9,TRBJ2-1,CASSVVDSPYNEQFF,0,2,1,2
TRBV9,TRBJ2-5,CASSVGVSPHETQYF,0,2,1,2
TRBV9,TRBJ2-5,CASSVDPGQQETQYF,0,2,1,2
TRBV9,TRBJ2-3,CASSVEDRGSNTQYF,0,2,1,2
TRBV9,TRBJ2-4,CASSVEGARKNIQYF,0,2,1,2
TRBV14,TRBJ2-7,CASSAHRGSPYEQYF,0,2,1,2
TRBV9,TRBJ2-3,CASSGTSGGADTQYF,0,2,1,2
TRBV6-1,TRBJ2-1,CASSEQGASYNEQFF,0,2,1,2
TRBV7-9,TRBJ1-3,CASSMTALAGNTIYF,0,2,1,2
TRBV6-2/3/5/6,TRBJ2-7,CASSTGLADSYEQYF,0,2,1,2
TRBV6-2/3/5/6,TRBJ2-5,CASRRLAGSQETQYF,0,2,1,2
TRBV6-2/3/5/6,TRBJ1-5,CASRVTGGVNQPQYF,0,2,1,2
TRBV2,TRBJ2-1,CASRERVLGSNEQFF,0,2,1,2
TRBV13,TRBJ2-7,CASRFGTASHYEQYF,0,2,1,2
TRBV27,TRBJ1-5,CASRPGRRSNQPQHF,0,2,1,2
TRBV12-3/4,TRBJ2-2,CASRPTGQNTGELFF,0,2,1,2
TRBV7-6,TRBJ2-5,CASRRATGGRVTQYF,0,2,1,2
TRBV6-2/3/5/6,TRBJ1-6,CASRQGVVQDSPLHF,0,2,1,2
TRBV2,TRBJ2-1,CASRVAGGSFNEQFF,0,2,1,2
TRBV6-2/3/5/6,TRBJ2-7,CASRTLRGDGYEQYF,0,2,1,2
TRBV2,TRBJ2-2,CASNDYPYNTGELFF,0,2,1,2
TRBV2,TRBJ2-1,CASKRASGSMGEQFF,0,2,1,2
TRBV12-3/4,TRBJ1-1,CASKHRGMTNTEAFF,0,2,1,2
TRBV6-2/3/5/6,TRBJ2-2,CASKGAGGSTGELFF,0,2,1,2
TRBV25-1,TRBJ2-1,CASKEDLAGANEQFF,0,2,1,2
TRBV7-9,TRBJ2-1,CGSSVGLAGYNEQFF,0,2,1,2
TRBV5-6,TRBJ2-7,CDSSLESRPSDEQYF,0,2,1,2
TRBV5-1,TRBJ1-1,CASYPGTGKGTEAFF,0,2,1,2
TRBV5-1,TRBJ2-3,CASRVAGGPVDTQYF,0,2,1,2
TRBV5-1,TRBJ2-3,CASTSSGRASDTQYF,0,2,1,2
TRBV5-1,TRBJ2-3,CASTTQGQSTDTQYF,0,2,1,2
TRBV5-1,TRBJ2-5,CASSFYGSTQETQYF,0,2,1,2
TRBV5-1,TRBJ2-5,CASSFGGTRQETQYY,0,2,1,2
TRBV5-1,TRBJ2-5,CASSFGGDVQETQYF,0,2,1,2
TRBV5-1,TRBJ2-1,CASSFEGESYNEQFF,0,2,1,2
TRBV5-1,TRBJ2-3,CASSFPGQITDTQYF,0,2,1,2
TRBV5-1,TRBJ2-7,CASSFGTGVVYEQYF,0,2,1,2
TRBV5-1,TRBJ1-1,CASSLVGGFNTEAFF,0,2,1,2
TRBV5-1,TRBJ2-7,CASSLAAGEGYEQYF,0,2,1,2
TRBV5-1,TRBJ1-3,CASSLGLGLGNTIYF,0,2,1,2
TRBV5-1,TRBJ1-6,CASSLGGTGESPLHF,0,2,1,2
TRBV5-1,TRBJ1-5,CASSLDGGSNQPQHF,0,2,1,2
TRBV5-1,TRBJ2-5,CASSLEGARRETQYF,0,2,1,2
TRBV5-1,TRBJ2-2,CASSLRQMNTGELFF,0,2,1,2
TRBV7-6,TRBJ2-6,CASSSPKSGANVLTF,0,2,1,2
TRBV5-1,TRBJ2-1,CASSSTGGFVNEQFF,0,2,1,2
TRBV5-1,TRBJ2-1,CASSWGGTRVNEQFF,0,2,1,2
TRBV4-1,TRBJ2-1,CASSLDRGSRSEQFF,0,2,1,2
TRBV5-1,TRBJ2-1,CASSLTGDSYNEQFF,0,2,1,2
TRBV5-1,TRBJ2-1,CASSPQGGSYNEQFF,0,2,1,2
TRBV5-1,TRBJ2-7,CASSPSSGDLYEQYF,0,2,1,2
TRBV4-1,TRBJ2-1,CASSPYYPSYNEQFF,0,2,1,2
TRBV4-1,TRBJ2-7,CASSPRDSKIYEQYF,0,2,1,2
TRBV5-1,TRBJ2-6,CASSPRGGGANVLTF,0,2,1,2
TRBV5-1,TRBJ1-2,CASSPRTGGDYGYTF,0,2,1,2
TRBV5-1,TRBJ2-5,CASSPTSGEQETQYF,0,2,1,2
TRBV5-1,TRBJ2-1,CASSPREGPYNEQFF,0,2,1,2
TRBV5-1,TRBJ1-2,CASSPNRGRGYGYTF,0,2,1,2
TRBV4-1,TRBJ2-1,CASSHGPRDINEQFF,0,2,1,2
TRBV4-1,TRBJ2-1,CASSQGRLAGNEQFF,0,2,1,2
TRBV4-1,TRBJ1-5,CASSQDGQGKQPQHF,0,2,1,2
TRBV5-1,TRBJ2-2,CASSGTSGSTGELFF,0,2,1,2
TRBV5-1,TRBJ2-1,CASSDLAGAVNEQFF,0,2,1,2
TRBV5-1,TRBJ2-1,CASSRGTVAANEQFF,0,2,1,2
TRBV10-2,TRBJ2-7,CASRGTKSSLYEQYF,0,2,1,2
TRBV5-1,TRBJ2-5,CASRSGTAGRETQYF,0,2,1,2
TRBV5-1,TRBJ2-7,CASRPRRIRDYEQYF,0,2,1,2
TRBV5-1,TRBJ2-7,CARSSIAGPTYEQYF,0,2,1,2
TRBV20-1,TRBJ2-1,CSVPLLAPIHNEQFF,0,2,1,2
TRBV20-1,TRBJ1-5,CSASASTGSGQPQHF,0,2,1,2
TRBV20-1,TRBJ2-7,CSATLPDRASYEQYF,0,2,1,2
TRBV20-1,TRBJ2-1,CSASSGIRVYNEQFF,0,2,1,2
TRBV20-1,TRBJ2-7,CSAREGKRGTYEQYF,0,2,1,2
TRBV20-1,TRBJ2-2,CSARPSGKNTGELFF,0,2,1,2
TRBV20-1,TRBJ2-3,CSARPAGGYADTQYF,0,2,1,2
TRBV20-1,TRBJ2-7,CSARADGEVLYEQYF,0,2,1,2
TRBV20-1,TRBJ2-7,CSANAPGGTSYEQYF,0,2,1,2
TRBV20-1,TRBJ2-7,CSANPSGPSTYEQYF,0,2,1,2
TRBV20-1,TRBJ2-7,CSANDPTSGIGEQYF,0,2,1,2
TRBV20-1,TRBJ2-3,CSAPQGANSGDTQYF,0,2,1,2
TRBV20-1,TRBJ1-1,CSASTGGMMNTEAFF,0,2,1,2
TRBV20-1,TRBJ2-5,CSARSGGGAGETQYF,0,2,1,2
TRBV29-1,TRBJ2-1,CSVSSGDPQYNEQFF,0,2,1,2
TRBV29-1,TRBJ1-1,CSVAGGTASNTEAFF,0,2,1,2
TRBV29-1,TRBJ2-3,CSVGMRDTGTDTQYF,0,2,1,2
TRBV29-1,TRBJ2-7,CSVERIQGGVYEQYF,0,2,1,2
TRBV29-1,TRBJ2-3,CSVNPLGGNTDTQYF,0,2,1,2
TRBV7-4,TRBJ1-5,RASSWSAGSNQPQHF,0,2,1,2
TRBV5-1,TRBJ2-7,GASSLARVGAYEQYF,0,2,1,2
TRBV5-1,TRBJ2-1,SASSLVGDSNNEQFF,0,2,1,2
TRBV12-5,TRBJ2-7,CASGWASGMREQYF,0,2,1,2
TRBV7-9,TRBJ2-3,CACSLRLAADTQYF,0,2,1,2
TRBV30,TRBJ2-7,CAWNTGGGSYEQYF,0,2,1,2
TRBV30,TRBJ2-7,CARSEGGSSYEQYF,0,2,1,2
TRBV3-1,TRBJ2-1,CAGSQEAGDNEQFF,0,2,1,2
TRBV10-3,TRBJ2-3,CAISAKVEADTQYF,0,2,1,2
TRBV10-3,TRBJ2-3,CAISDGSSTDTQYF,0,2,1,2
TRBV10-3,TRBJ2-5,CAISEGRVRETQYF,0,2,1,2
TRBV10-3,TRBJ2-1,CAISQREGRYEQFF,0,2,1,2
TRBV10-3,TRBJ2-7,CAISKSDGDYEQYF,0,2,1,2
TRBV7-9,TRBJ2-1,CATLPNVFYNGQFF,0,2,1,2
TRBV28,TRBJ2-2,CATIAPGDTGELFF,0,2,1,2
TRBV24-1,TRBJ2-1,CATSDPPLYNEQFF,0,2,1,2
TRBV24-1,TRBJ2-1,CATSDSGTSGEQFF,0,2,1,2
TRBV24-1,TRBJ2-7,CATSDSSSKYEQYF,0,2,1,2
TRBV15,TRBJ2-5,CATSRTGGQETQYF,0,2,1,2
TRBV19,TRBJ2-5,CASSKADIQETQYF,0,2,1,2
TRBV19,TRBJ2-3,CASSWAQVTDTQYF,0,2,1,2
TRBV19,TRBJ2-1,CASSYLGPNNEQFF,0,2,1,2
TRBV19,TRBJ2-5,CASSLQGDQETQYF,0,2,1,2
TRBV19,TRBJ2-2,CASSGTPNTGELFF,0,2,1,2
TRBV19,TRBJ2-5,CASSIYQGRETQYF,0,2,1,2
TRBV19,TRBJ2-3,CASSKTSGVDTQYF,0,2,1,2
TRBV19,TRBJ1-2,CASRAHGPDYGYTF,0,2,1,2
TRBV19,TRBJ2-3,CASRRRGPTDTQYF,0,2,1,2
TRBV19,TRBJ2-4,CASRGTGTKNIQYF,0,2,1,2
TRBV28,TRBJ2-7,CASNPGQALYEQNF,0,2,1,2
TRBV18,TRBJ2-5,CASSLDSFHETQYF,0,2,1,2
TRBV18,TRBJ2-3,CASSPFAGADTQYF,0,2,1,2
TRBV18,TRBJ2-3,CASSPADFTDTQYF,0,2,1,2
TRBV18,TRBJ2-1,CASSPPSELDEQFF,0,2,1,2
TRBV18,TRBJ1-1,CASSPPGGGTEAFF,0,2,1,2
TRBV18,TRBJ2-5,CASSPRTGKETQHF,0,2,1,2
TRBV18,TRBJ1-1,CASSPTALNTEAFF,0,2,1,2
TRBV28,TRBJ2-2,CASCDYANTGELFF,0,2,1,2
TRBV6-2/3/5/6,TRBJ2-7,CASLPEGLPYEQYF,0,2,1,2
TRBV10-3,TRBJ2-3,CASRAGLTTDTQYF,0,2,1,2
TRBV6-2/3/5/6,TRBJ2-1,CASRGAGGANEQFF,0,2,1,2
TRBV18,TRBJ2-6,CASRGGARANILTF,0,2,1,2
TRBV7-9,TRBJ2-2,CASQGLSDTGELFF,0,2,1,2
TRBV12-3/4,TRBJ2-1,CASVREGSYNEQFF,0,2,1,2
TRBV6-2/3/5/6,TRBJ1-1,CASARGFLNTEAFF,0,2,1,2
TRBV12-3/4,TRBJ1-2,CASTVLEASDLGTF,0,2,1,2
TRBV7-2,TRBJ1-2,CASTVQGLGYGYTF,0,2,1,2
TRBV7-9,TRBJ2-5,CASTAGGAEETQYF,0,2,1,2
TRBV28,TRBJ1-5,CASTVAGPNQPQHF,0,2,1,2
TRBV12-3/4,TRBJ2-1,CASSLAGGGGEQFF,0,2,1,2
TRBV12-3/4,TRBJ2-5,CASSLSGEEETQYF,0,2,1,2
TRBV12-3/4,TRBJ1-4,CASSLGGTNEKLFF,0,2,1,2
TRBV12-3/4,TRBJ2-7,CASSLGGAVDEQYF,0,2,1,2
TRBV6-2/3/5/6,TRBJ2-7,CASSLGGARYEQYF,0,2,1,2
TRBV28,TRBJ2-1,CASSLGQPYNEQFF,0,2,1,2
TRBV6-2/3/5/6,TRBJ1-5,CASSLGNQGQPQHF,0,2,1,2
TRBV6-2/3/5/6,TRBJ2-3,CASSLEDDTDAQYF,0,2,1,2
TRBV6-2/3/5/6,TRBJ2-7,CASSLTGGTYEQYF,0,2,1,2
TRBV6-2/3/5/6,TRBJ1-2,CASSLRGGSYGYTF,0,2,1,2
TRBV6-2/3/5/6,TRBJ1-2,CASSSLSNRGGYTF,0,2,1,2
TRBV28,TRBJ2-3,CASSSGLATDTQYF,0,2,1,2
TRBV28,TRBJ2-3,CASSSGAPTDTQYF,0,2,1,2
TRBV27,TRBJ2-5,CASSSNNRGETQYF,0,2,1,2
TRBV6-2/3/5/6,TRBJ2-3,CASSYGPLEDTQYF,0,2,1,2
TRBV6-2/3/5/6,TRBJ1-5,CASSYERPNQPQHF,0,2,1,2
TRBV6-2/3/5/6,TRBJ2-2,CASSLDQNTGELFF,0,2,1,2
TRBV12-3/4,TRBJ1-5,CASSPDYSNQPQHF,0,2,1,2
TRBV7-3,TRBJ2-5,CASSPAGERETQYF,0,2,1,2
TRBV6-4,TRBJ2-7,CASSRTSGSIEQYF,0,2,1,2
TRBV28,TRBJ2-7,CASSHRTDPYEQYF,0,2,1,2
TRBV7-9,TRBJ2-1,CASSQSEGFSVQFF,0,2,1,2
TRBV6-1,TRBJ2-3,CASSVPGLTDTQYF,0,2,1,2
TRBV6-1,TRBJ2-5,CASSAVGGQETQYF,0,2,1,2
TRBV28,TRBJ2-7,CASSGGWRAYEQYF,0,2,1,2
TRBV25-1,TRBJ2-1,CASSDGDKDNEQFF,0,2,1,2
TRBV6-4,TRBJ2-3,CASSDRQGADTQYF,0,2,1,2
TRBV6-4,TRBJ2-1,CASSDESPGNEQFF,0,2,1,2
TRBV6-1,TRBJ2-7,CASSETGGSYEQYF,0,2,1,2
TRBV25-1,TRBJ2-7,CASSEPGSSYEQYF,0,2,1,2
TRBV2,TRBJ2-2,CASSEVAATGELFF,0,2,1,2
TRBV6-1,TRBJ1-1,CASSENQMNTEAFF,0,2,1,2
TRBV2,TRBJ1-1,CASSENQMNNEAFF,0,2,1,2
TRBV28,TRBJ2-7,CASSIRAVGAEQYF,0,2,1,2
TRBV25-1,TRBJ2-3,CASSTSGSTDTQYF,0,2,1,2
TRBV2,TRBJ2-7,CASSNKRDSLEQYF,0,2,1,2
TRBV11-2,TRBJ2-1,CASSFRNSYNEQFF,0,2,1,2
TRBV5-4,TRBJ2-1,CASSFTGPYNEQFF,0,2,1,2
TRBV7-2,TRBJ2-7,CASSLAGTDYEQYF,0,2,1,2
TRBV7-2,TRBJ1-1,CASSLGGFSTEAFF,0,2,1,2
TRBV5-5,TRBJ2-7,CASSLEGTNYEQYF,0,2,1,2
TRBV7-7,TRBJ2-2,CASSLLMNTGELFF,0,2,1,2
TRBV11-2,TRBJ2-1,CASSLVQGSSEQFF,0,2,1,2
TRBV7-9,TRBJ2-7,CASSLGAGYFEQYF,0,2,1,2
TRBV7-9,TRBJ2-7,CASSLTDSNYEQYF,0,2,1,2
TRBV7-2,TRBJ1-5,CASSLRGANQPQHF,0,2,1,2
TRBV7-6,TRBJ2-1,CASSLREGRNEQFI,0,2,1,2
TRBV7-3,TRBJ2-5,CASSLNRNQEAQYF,0,2,1,2
TRBV7-2,TRBJ2-3,CASSSGRSTDTQYF,0,2,1,2
TRBV28,TRBJ2-7,CASSSGTGPGEQYF,0,2,1,2
TRBV11-1,TRBJ2-5,CASSSTEGRETQYF,0,2,1,2
TRBV5-4,TRBJ2-5,CASSSPTGGETQHF,0,2,1,2
TRBV5-4,TRBJ1-4,CASSSGTPGEKLFF,0,2,1,2
TRBV7-9,TRBJ2-1,CASSSGQSYNEQFF,0,2,1,2
TRBV7-3,TRBJ2-3,CASSSTGDTDTQYF,0,2,1,2
TRBV7-6,TRBJ2-3,CASSSTSSTDTQYF,0,2,1,2
TRBV5-4,TRBJ2-2,CASSWLLNTGELFF,0,2,1,2
TRBV5-4,TRBJ2-1,CASSLAGLNNEQFF,0,2,1,2
TRBV11-2,TRBJ2-3,CASSLGLEGRTQYF,0,2,1,2
TRBV12-3/4,TRBJ2-1,CASSLPQGNNEQFF,0,2,1,2
TRBV11-3,TRBJ2-1,CASSLRQGVNEQFF,0,2,1,2
TRBV6-2/3/5/6,TRBJ2-2,CASSLNFNTGELFF,0,2,1,2
TRBV12-3/4,TRBJ2-5,CASSPLQGAETQYF,0,2,1,2
TRBV6-2/3/5/6,TRBJ1-5,CASSPRGSNQPQHF,0,2,1,2
TRBV9,TRBJ2-4,CASSPEGTKNIQYF,0,2,1,2
TRBV7-9,TRBJ2-7,CASSPTGATYEQYF,0,2,1,2
TRBV7-2,TRBJ2-5,CASSPQPTGDNQYF,0,2,1,2
TRBV3-1,TRBJ2-1,CASSPGLAYNEQFF,0,2,1,2
TRBV5-4,TRBJ2-7,CASSPGQGDYEQYF,0,2,1,2
TRBV7-3,TRBJ2-3,CASSPGDRGDTQYF,0,2,1,2
TRBV7-9,TRBJ1-4,CASSPGQGDEKLFF,0,2,1,2
TRBV11-2,TRBJ2-3,CASSPRGTTDTQYF,0,2,1,2
TRBV12-3/4,TRBJ1-1,CASSPGGGSTEAFF,0,2,1,2
TRBV5-5,TRBJ2-7,CASSPIPNGYEQYF,0,2,1,2
TRBV7-2,TRBJ2-4,CASSRGGAKNIQYF,0,2,1,2
TRBV28,TRBJ2-7,CASSRSGSTYEQYF,0,2,1,2
TRBV6-2/3/5/6,TRBJ1-4,CASSRTGNNEKLFF,0,2,1,2
TRBV6-2/3/5/6,TRBJ2-1,CASSRLAGVREQFF,0,2,1,2
TRBV7-9,TRBJ2-1,CASSRPTLYNEQFF,0,2,1,2
TRBV7-9,TRBJ2-7,CASSRRGTGGFQYF,0,2,1,2
TRBV3-1,TRBJ1-1,CASSQSTGGRGAFF,0,2,1,2
TRBV11-1,TRBJ2-5,CASSQRTGQENQYF,0,2,1,2
TRBV3-1,TRBJ2-3,CASSQGASSDTQYF,0,2,1,2
TRBV5-4,TRBJ2-1,CASSQGGGYNEQFF,0,2,1,2
TRBV3-1,TRBJ1-3,CASSQDGFRNTIYF,0,2,1,2
TRBV4-2,TRBJ2-7,CASSQEAGFGEQYF,0,2,1,2
TRBV7-8,TRBJ2-3,CASSVGQAGGTQYF,0,2,1,2
TRBV7-6,TRBJ2-7,CASSARDFSYEQYF,0,2,1,2
TRBV28,TRBJ2-4,CASSATLAKNIQYF,0,2,1,2
TRBV2,TRBJ2-2,CASSANRNTGELFF,0,2,1,2
TRBV27,TRBJ2-3,CASSGWTSTDTQYF,0,2,1,2
TRBV11-2,TRBJ2-1,CASSGRVSYNEQFF,0,2,1,2
TRBV5-4,TRBJ2-1,CASSGGSSYNEQFF,0,2,1,2
TRBV4-2,TRBJ2-7,CASSEASGRYEQYF,0,2,1,2
TRBV7-9,TRBJ1-2,CASSMGQGAGGYTF,0,2,1,2
TRBV2,TRBJ2-5,CASSTLAGQETQYF,0,2,1,2
TRBV7-2,TRBJ2-5,CASSTQGAGETQYF,0,2,1,2
TRBV2,TRBJ2-5,CASSTEGGQETQYF,0,2,1,2
TRBV7-2,TRBJ2-3,CASSTIAGEDTQYF,0,2,1,2
TRBV7-9,TRBJ2-3,CASSRGLGSDTQYF,0,2,1,2
TRBV7-9,TRBJ2-1,CASSKGQNYNEQFF,0,2,1,2
TRBV3-1,TRBJ2-5,CASSKPTGEETQYF,0,2,1,2
TRBV7-2,TRBJ2-5,CASSKMVGEETQYF,0,2,1,2
TRBV6-2/3/5/6,TRBJ2-7,CASRGLGPSYEQYF,0,2,1,2
TRBV28,TRBJ2-3,CASRIAGATDTQYF,0,2,1,2
TRBV12-3/4,TRBJ2-7,CASRIAGISYEQYF,0,2,1,2
TRBV6-2/3/5/6,TRBJ1-3,CASRTGTTGNTIYF,0,2,1,2
TRBV7-2,TRBJ2-2,CASRNRVDTGELFF,0,2,1,2
TRBV6-2/3/5/6,TRBJ2-7,CASRSDRFFHEQYF,0,2,1,2
TRBV7-3,TRBJ2-1,CASRPGGPGNEQFF,0,2,1,2
TRBV3-1,TRBJ2-1,CASRQGAWYNEQFF,0,2,1,2
TRBV6-2/3/5/6,TRBJ1-5,CASRVTGGGQPQHF,0,2,1,2
TRBV28,TRBJ2-5,CASNTGSSQETQYF,0,2,1,2
TRBV7-3,TRBJ2-1,CASKRGGGHNEQFF,0,2,1,2
TRBV10-2,TRBJ2-7,CASGPYRVGYEQYF,0,2,1,2
TRBV5-1,TRBJ2-3,CASGGGRAGDTQYF,0,2,1,2
TRBV4-1,TRBJ2-1,CASTGTAASNEQFF,0,2,1,2
TRBV10-1,TRBJ1-2,CASSAGTNTGGYTF,0,2,1,2
TRBV5-1,TRBJ1-1,CASSFGGGDTEAFF,0,2,1,2
TRBV5-1,TRBJ2-3,CASSLATGADTQYF,0,2,1,2
TRBV5-1,TRBJ2-7,CASSLGVSSYEQYF,0,2,1,2
TRBV5-1,TRBJ2-3,CASSLGLTADTQYF,0,2,1,2
TRBV5-1,TRBJ1-5,CASSLDQGNQPQHF,0,2,1,2
TRBV5-1,TRBJ2-3,CASSLTSGSDTQYF,0,2,1,2
TRBV5-1,TRBJ2-1,CASSLVGRENEQFF,0,2,1,2
TRBV5-1,TRBJ2-7,CASSLGGVWDEQYF,0,2,1,2
TRBV5-1,TRBJ2-3,CASSSTGYTDTQYF,0,2,1,2
TRBV5-1,TRBJ2-5,CASSSGSTKETQYF,0,2,1,2
TRBV5-1,TRBJ2-1,CASSWGVDRGEQFF,0,2,1,2
TRBV5-1,TRBJ2-2,CASSPREATGELFF,0,2,1,2
TRBV5-1,TRBJ2-7,CASSPGTGNYEQYF,0,2,1,2
TRBV5-1,TRBJ2-3,CASSPGQITDTQYF,0,2,1,2
TRBV5-1,TRBJ2-1,CASSRGRAEDEQFF,0,2,1,2
TRBV4-1,TRBJ2-1,CASSREYSYNEQFF,0,2,1,2
TRBV5-1,TRBJ2-7,CASSQQGTTYEQYF,0,2,1,2
TRBV4-1,TRBJ1-5,CASSQQGVGQPQHF,0,2,1,2
TRBV4-1,TRBJ2-5,CASSQETAHETQYF,0,2,1,2
TRBV5-1,TRBJ2-3,CASSAQESGVRQYF,0,2,1,2
TRBV5-1,TRBJ2-7,CASSAGQPESEQYF,0,2,1,2
TRBV4-1,TRBJ1-5,CASSGSGGDQPQHF,0,2,1,2
TRBV10-2,TRBJ2-7,CASSGAGVSYEQYF,0,2,1,2
TRBV5-1,TRBJ2-5,CASSIGQGQETQYF,0,2,1,2
TRBV5-1,TRBJ2-2,CASSIHNFGGELFF,0,2,1,2
TRBV5-1,TRBJ2-7,CASSTGGRSYEQYF,0,2,1,2
TRBV5-1,TRBJ2-3,CASSTGTVTDTQYF,0,2,1,2
TRBV5-1,TRBJ1-1,CASRGMAENTEAFF,0,2,1,2
TRBV5-1,TRBJ2-7,CASRSGPIELEQYF,0,2,1,2
TRBV5-1,TRBJ2-4,CTSSPTGGLNIQYF,0,2,1,2
TRBV20-1,TRBJ2-5,CSVRGGALQETQYF,0,2,1,2
TRBV20-1,TRBJ2-3,CSAPVSGSTDTQYF,0,2,1,2
TRBV20-1,TRBJ2-5,CSARGTGGMETQYF,0,2,1,2
TRBV20-1,TRBJ2-1,CSARAGVSYNEQFF,0,2,1,2
TRBV20-1,TRBJ2-3,CSAGRDRGTDTQYF,0,2,1,2
TRBV20-1,TRBJ2-3,CSASQVLGTDTQYF,0,2,1,2
TRBV20-1,TRBJ2-1,CSARPSGPQGEQFF,0,2,1,2
TRBV20-1,TRBJ2-1,CSARPVGGYNEQFF,0,2,1,2
TRBV20-1,TRBJ2-7,CSARRQGGSYEQYF,0,2,1,2
TRBV20-1,TRBJ2-7,CSARGSLLSGEQYF,0,2,1,2
TRBV20-1,TRBJ2-3,CSARPRDKTDTQYF,0,2,1,2
TRBV20-1,TRBJ2-1,CSAKKSTGYNEQFF,0,2,1,2
TRBV20-1,TRBJ2-3,CSASPGGRTDTQYF,0,2,1,2
TRBV20-1,TRBJ2-1,CSAPAGAPSNEQFF,0,2,1,2
TRBV20-1,TRBJ1-1,CSAQVPDGNTEAFF,0,2,1,2
TRBV20-1,TRBJ2-1,CSAAYSVVYNEQFF,0,2,1,2
TRBV29-1,TRBJ2-7,CSLKICALSYEQYF,0,2,1,2
TRBV29-1,TRBJ2-4,CSVREPGPKNIQYF,0,2,1,2
TRBV29-1,TRBJ2-1,CSVASARSYNEQFF,0,2,1,2
TRBV29-1,TRBJ1-5,CSVAPGGGGQPQHF,0,2,1,2
TRBV29-1,TRBJ2-3,CSVGIAGVGDTQYF,0,2,1,2
TRBV29-1,TRBJ2-5,CSVGGTSGEETQYF,0,2,1,2
TRBV29-1,TRBJ2-1,CSVEWDTRTNEQFF,0,2,1,2
TRBV29-1,TRBJ2-1,CSVEAGEKGNEQFF,0,2,1,2
TRBV29-1,TRBJ2-7,CSVEDKATSYEQYF,0,2,1,2
TRBV29-1,TRBJ2-3,CSVRRGRTSDTQYF,0,2,1,2
TRBV29-1,TRBJ2-5,CSVVNYKESETQYF,0,2,1,2
TRBV29-1,TRBJ2-3,CSVAGTGSPDTQYF,0,2,1,2
TRBV20-1,TRBJ2-3,CSRPREGSTDTQYF,0,2,1,2
TRBV19,TRBJ2-3,RASKRASGSNTQYF,0,2,1,2
TRBV20-1,TRBJ2-7,RSAPSGTINYEQYF,0,2,1,2
TRBV12-5,TRBJ1-5,CASGLSYGQPQHF,0,2,1,2
TRBV30,TRBJ1-1,CAWSGTGNTEAFF,0,2,1,2
TRBV30,TRBJ1-5,CAWGAGTDQPQHF,0,2,1,2
TRBV30,TRBJ1-2,CAWSSPNNYGYTF,0,2,1,2
TRBV30,TRBJ2-7,CAWSVRSAYEQYF,0,2,1,2
TRBV30,TRBJ1-2,CAWSRGPPSGYTF,0,2,1,2
TRBV30,TRBJ1-1,CAWNPGGDTEAFF,0,2,1,2
TRBV2,TRBJ2-1,CAYGGRSYNEQFF,0,2,1,2
TRBV2,TRBJ2-7,CAAAGGGLGEQYF,0,2,1,2
TRBV7-2,TRBJ1-6,CAIGDSGNSPLHF,0,2,1,2
TRBV18,TRBJ2-7,CATSTGTGSEQYF,0,2,1,2
TRBV24-1,TRBJ2-3,CATGTGPTDTQYF,0,2,1,2
TRBV15,TRBJ2-5,CATSLNVQETQYF,0,2,1,2
TRBV24-1,TRBJ2-1,CATSGRYYNEQFF,0,2,1,2
TRBV15,TRBJ2-5,CATSRDQGENQYF,0,2,1,2
TRBV27,TRBJ1-1,CATRVRVTGEAFF,0,2,1,2
TRBV19,TRBJ2-3,CASSVGERDTQYF,0,2,1,2
TRBV19,TRBJ2-1,CASSGQGVDEQFF,0,2,1,2
TRBV19,TRBJ2-7,CASSISFRGEQYF,0,2,1,2
TRBV19,TRBJ2-7,CASSIGTGTEQYF,0,2,1,2
TRBV19,TRBJ2-7,CASRRAGGYEQYF,0,2,1,2
TRBV25-1,TRBJ2-3,CASRGGGTDTQYF,0,2,1,2
TRBV19,TRBJ2-2,CASKNDGAGELFF,0,2,1,2
TRBV6-2/3/5/6,TRBJ2-7,CASSQGPAYEQYF,0,2,1,2
TRBV9,TRBJ2-7,CASSTSGTLEQYF,0,2,1,2
TRBV18,TRBJ2-1,CASSAPMRNEQFF,0,2,1,2
TRBV2,TRBJ2-2,CASWGLATGELFF,0,2,1,2
TRBV28,TRBJ2-7,CASWTRGSPEQYF,0,2,1,2
TRBV3-1,TRBJ2-7,CASRPRGTYEQYF,0,2,1,2
TRBV12-3/4,TRBJ2-1,CASRQGTYNEQFF,0,2,1,2
TRBV28,TRBJ2-2,CASRQGNTGELFF,0,2,1,2
TRBV11-1,TRBJ2-7,CASGRDRVYEQYF,0,2,1,2
TRBV12-3/4,TRBJ2-5,CASTPGGRETQYS,0,2,1,2
TRBV6-2/3/5/6,TRBJ2-2,CASTKRNTGELFF,0,2,1,2
TRBV6-2/3/5/6,TRBJ2-3,CASSFSGSLTQYF,0,2,1,2
TRBV6-2/3/5/6,TRBJ2-3,CASSFGSTDTQYF,0,2,1,2
TRBV6-2/3/5/6,TRBJ2-4,CASSFTSGLIQYF,0,2,1,2
TRBV6-2/3/5/6,TRBJ1-5,CASSFNSNQPQHF,0,2,1,2
TRBV27,TRBJ2-1,CASSFSSSGSRVF,0,2,1,2
TRBV27,TRBJ2-3,CASSFPGADTQYF,0,2,1,2
TRBV12-3/4,TRBJ1-2,CASSLPPGPASSF,0,2,1,2
TRBV28,TRBJ2-7,CASSLGSFYEQYF,0,2,1,2
TRBV12-3/4,TRBJ2-2,CASSLSIPGELFF,0,2,1,2
TRBV6-2/3/5/6,TRBJ1-1,CASSLRGTGEALF,0,2,1,2
TRBV6-2/3/5/6,TRBJ2-7,CASSLFGTSEQYF,0,2,1,2
TRBV12-3/4,TRBJ2-3,CASSLAGGDTQYF,0,2,1,2
TRBV12-3/4,TRBJ1-5,CASSLGGDQPQHF,0,2,1,2
TRBV12-3/4,TRBJ2-3,CASSLGGTDTQYF,0,2,1,2
TRBV12-3/4,TRBJ2-7,CASSYVGGYEQYF,0,2,1,2
TRBV6-2/3/5/6,TRBJ2-1,CASSYSRDGEQFF,0,2,1,2
TRBV12-3/4,TRBJ2-7,CASSPSRGGEQYF,0,2,1,2
TRBV6-1,TRBJ2-7,CASSASGRNEQYF,0,2,1,2
TRBV6-1,TRBJ1-5,CASSGTDNQPQHF,0,2,1,2
TRBV6-1,TRBJ1-5,CASSEGGPGPQHF,0,2,1,2
TRBV6-1,TRBJ2-1,CASSEERGSPQFF,0,2,1,2
TRBV6-2/3/5/6,TRBJ2-7,CASSTGSSYEQYF,0,2,1,2
TRBV12-3/4,TRBJ1-3,CASSTDRGVSIYF,0,2,1,2
TRBV5-4,TRBJ2-1,CASSFSSNNEQFF,0,2,1,2
TRBV7-2,TRBJ2-5,CASSFRLQEIQYF,0,2,1,2
TRBV7-3,TRBJ2-1,CASSFTDRDQQFF,0,2,1,2
TRBV5-4,TRBJ1-1,CASSFREGTEAFF,0,2,1,2
TRBV7-2,TRBJ2-4,CASSFQRQNIQYF,0,2,1,2
TRBV7-2,TRBJ2-4,CASSFGGGNIQYF,0,2,1,2
TRBV5-4,TRBJ1-2,CASSFGQGGGYTF,0,2,1,2
TRBV5-6,TRBJ1-5,CASSLSTLGSQHF,0,2,1,2
TRBV5-6,TRBJ2-5,CASSLDGVKTQYF,0,2,1,2
TRBV7-2,TRBJ1-3,CASSLKSGNTIYF,0,2,1,2
TRBV7-2,TRBJ2-1,CASSLSSLDEQFF,0,2,1,2
TRBV7-2,TRBJ2-7,CASSLVTPPRSYF,0,2,1,2
TRBV7-9,TRBJ1-5,CASSLALNQPQHF,0,2,1,2
TRBV11-2,TRBJ1-1,CASSLARNTEAFF,0,2,1,2
TRBV7-9,TRBJ2-1,CASSLADRAREFF,0,2,1,2
TRBV7-9,TRBJ1-1,CASSLGEGTEAFF,0,2,1,2
TRBV7-3,TRBJ2-4,CASSLGDSNIQYF,0,2,1,2
TRBV7-9,TRBJ1-2,CASSLDRAHGYTF,0,2,1,2
TRBV7-3,TRBJ2-1,CASSLIGNNEQFF,0,2,1,2
TRBV7-9,TRBJ2-7,CASSLRGFYEQYF,0,2,1,2
TRBV7-9,TRBJ2-3,CASSSRGPDTQYF,0,2,1,2
TRBV7-9,TRBJ2-5,CASSSAGRETQYF,0,2,1,2
TRBV5-4,TRBJ2-3,CASSSGTEDTQYF,0,2,1,2
TRBV7-9,TRBJ1-1,CASSSGQGTEAFF,0,2,1,2
TRBV7-2,TRBJ2-1,CASSSAPANEQFF,0,2,1,2
TRBV27,TRBJ2-4,CASSSTGGIIQYF,0,2,1,2
TRBV2,TRBJ2-5,CASSLGLQETQYF,0,2,1,2
TRBV3-1,TRBJ2-5,CASSLPGTETQYF,0,2,1,2
TRBV12-3/4,TRBJ2-5,CASSLGQGGTQYF,0,2,1,2
TRBV6-2/3/5/6,TRBJ2-1,CASSLSPIDEQFF,0,2,1,2
TRBV3-1,TRBJ2-4,CASSLAVGNIQYF,0,2,1,2
TRBV11-2,TRBJ2-3,CASSPHPGMTQYF,0,2,1,2
TRBV7-2,TRBJ2-1,CASSPGLAFGQFF,0,2,1,2
TRBV7-2,TRBJ2-7,CASSPQPTDEQYF,0,2,1,2
TRBV12-3/4,TRBJ2-3,CASSPGFGDTQYF,0,2,1,2
TRBV28,TRBJ2-7,CASSPGTPYEQYF,0,2,1,2
TRBV7-9,TRBJ2-7,CASSPGTGVEQYF,0,2,1,2
TRBV6-2/3/5/6,TRBJ2-5,CASSPGQLETQYF,0,2,1,2
TRBV12-3/4,TRBJ2-5,CASSPLRSGAQYF,0,2,1,2
TRBV3-1,TRBJ2-3,CASSPREQGTQYF,0,2,1,2
TRBV14,TRBJ2-3,CASSPTRGDTQYF,0,2,1,2
TRBV11-1,TRBJ2-1,CASSRWGGREQFF,0,2,1,2
TRBV28,TRBJ2-1,CASSRTSRNEQFF,0,2,1,2
TRBV11-2,TRBJ2-3,CASSRTETDTQYF,0,2,1,2
TRBV3-1,TRBJ1-1,CASSHQMNTEACF,0,2,1,2
TRBV3-1,TRBJ1-1,CASSQGVNTEAFF,0,2,1,2
TRBV3-1,TRBJ2-3,CASSQVSSDTQYF,0,2,1,2
TRBV3-1,TRBJ2-1,CASSQGQGPEQFF,0,2,1,2
TRBV11-3,TRBJ2-2,CASSQRDPGELFF,0,2,1,2
TRBV14,TRBJ2-1,CASSQNLAGGQFF,0,2,1,2
TRBV9,TRBJ1-1,CASSVEQGSEAFF,0,2,1,2
TRBV7-8,TRBJ2-4,CASSAGQGYIQYF,0,2,1,2
TRBV11-2,TRBJ1-1,CASSGTGVTEAFF,0,2,1,2
TRBV7-6,TRBJ1-5,CASSGQGNQPQHF,0,2,1,2
TRBV7-3,TRBJ2-3,CASSIREGDTQYF,0,2,1,2
TRBV14,TRBJ2-3,CASSTRPPDTQYF,0,2,1,2
TRBV28,TRBJ2-5,CASSRTSSQTQYF,0,2,1,2
TRBV6-2/3/5/6,TRBJ1-4,CASSNGTPGKLFF,0,2,1,2
TRBV27,TRBJ2-7,CASRAEWSGEQYF,0,2,1,2
TRBV6-2/3/5/6,TRBJ2-7,CASRLTASYEQYF,0,2,1,2
TRBV6-2/3/5/6,TRBJ2-5,CASRPGRGETQYF,0,2,1,2
TRBV28,TRBJ2-1,CASKEGNYNEQFF,0,2,1,2
TRBV5-1,TRBJ2-7,CASSLGSNYEQYF,0,2,1,2
TRBV5-1,TRBJ2-1,CASSPGGSNEQFF,0,2,1,2
TRBV10-2,TRBJ2-2,CASSESFTRELFF,0,2,1,2
TRBV10-2,TRBJ2-3,CASSEVVPDTQYF,0,2,1,2
TRBV5-1,TRBJ2-5,CASSFEGEETQYF,0,2,1,2
TRBV5-1,TRBJ2-7,CASSLQDQSEQYF,0,2,1,2
TRBV5-1,TRBJ2-7,CASSLADEYEQYF,0,2,1,2
TRBV5-1,TRBJ2-7,CASSLGESYEQYF,0,2,1,2
TRBV5-1,TRBJ2-7,CASSSTANYEQYF,0,2,1,2
TRBV5-1,TRBJ2-7,CASSLGRVGEQYF,0,2,1,2
TRBV5-1,TRBJ2-4,CASSPGDGNIQYF,0,2,1,2
TRBV5-1,TRBJ2-4,CASSRDRDGIQHF,0,2,1,2
TRBV5-1,TRBJ2-7,CASSRDGTYEQYF,0,2,1,2
TRBV5-1,TRBJ2-4,CASSTWTSDIQYF,0,2,1,2
TRBV5-1,TRBJ2-7,CASSTDGYGEQYF,0,2,1,2
TRBV3-1,TRBJ1-2,CASSKGQGHGYTF,0,2,1,2
TRBV5-1,TRBJ1-1,CASRSLIQGEAFF,0,2,1,2
TRBV20-1,TRBJ2-3,CSVLNGLTDTQYF,0,2,1,2
TRBV20-1,TRBJ2-5,CSAPWRDRKTQYF,0,2,1,2
TRBV20-1,TRBJ2-3,CSAAAGGTDTQYF,0,2,1,2
TRBV20-1,TRBJ2-1,CSAEIGQTTEQFF,0,2,1,2
TRBV20-1,TRBJ1-4,CSASWARGGKLFF,0,2,1,2
TRBV20-1,TRBJ2-1,CSASGRGSFEQFF,0,2,1,2
TRBV20-1,TRBJ2-7,CSASRDIPYEQYF,0,2,1,2
TRBV20-1,TRBJ2-5,CSASKVEQETQYF,0,2,1,2
TRBV20-1,TRBJ2-3,CSARSYRTDTQYF,0,2,1,2
TRBV20-1,TRBJ2-1,CSARRGLGDEQFF,0,2,1,2
TRBV20-1,TRBJ2-1,CSARYDSGPLQFF,0,2,1,2
TRBV20-1,TRBJ1-1,CSARRGSGTEAFF,0,2,1,2
TRBV20-1,TRBJ1-2,CSARDQDRYGYTF,0,2,1,2
TRBV20-1,TRBJ1-1,CSARDGRRTEAFF,0,2,1,2
TRBV20-1,TRBJ1-1,CSARDRRVWGAFF,0,2,1,2
TRBV20-1,TRBJ2-5,CSALRTVQETQYF,0,2,1,2
TRBV20-1,TRBJ2-5,CSAPGPGGETQYF,0,2,1,2
TRBV20-1,TRBJ2-5,CSAGTSRGETQYF,0,2,1,2
TRBV20-1,TRBJ2-3,CSGTSGATDTQYF,0,2,1,2
TRBV29-1,TRBJ1-4,CSVSGAGNEKLFF,0,2,1,2
TRBV29-1,TRBJ2-7,CSVQQRSSYEQYF,0,2,1,2
TRBV29-1,TRBJ2-1,CSVAILLDNEQFF,0,2,1,2
TRBV29-1,TRBJ2-3,CSVASGNTDTQYF,0,2,1,2
TRBV29-1,TRBJ2-1,CSVGGQPYNEQSF,0,2,1,2
TRBV29-1,TRBJ1-1,CSVESDKRTEAFF,0,2,1,2
TRBV29-1,TRBJ1-1,CSVEAGRNTEAFF,0,2,1,2
TRBV29-1,TRBJ2-7,CSVETQRPYEQYF,0,2,1,2
TRBV29-1,TRBJ2-1,CSVALMPGNEQFF,0,2,1,2
TRBV29-1,TRBJ2-5,CSVLAGVWETQYF,0,2,1,2
TRBV29-1,TRBJ2-5,CSVQRQDQETQYF,0,2,1,2
TRBV29-1,TRBJ2-7,CSVTRDNTYEQYF,0,2,1,2
TRBV5-4,TRBJ2-7,RASSSEGRYEQYF,0,2,1,2
TRBV12-3/4,TRBJ1-1,RASRPDLYTEAFF,0,2,1,2
TRBV30,TRBJ2-2,CAWGLLGGELFF,0,2,1,2
TRBV30,TRBJ1-1,CAWSLGNTEAFF,0,2,1,2
TRBV30,TRBJ2-1,CAWSRVAIEQFF,0,2,1,2
TRBV6-2/3/5/6,TRBJ2-3,CAARIVTDTQYF,0,2,1,2
TRBV10-3,TRBJ1-1,CAISDGTGRAFF,0,2,1,2
TRBV2,TRBJ2-5,CATARFIETQYF,0,2,1,2
TRBV2,TRBJ1-5,CASGDRDQPQHF,0,2,1,2
TRBV19,TRBJ2-3,CASSPGLDTQYF,0,2,1,2
TRBV19,TRBJ2-1,CASSITGSEQFF,0,2,1,2
TRBV19,TRBJ2-3,CASRLAGERQYF,0,2,1,2
TRBV18,TRBJ2-7,CASSGGQYEQYF,0,2,1,2
TRBV19,TRBJ1-1,CASGRDSRPAFF,0,2,1,2
TRBV28,TRBJ1-1,CASIRGGTEAFF,0,2,1,2
TRBV12-3/4,TRBJ2-3,CASTSQRDTQYF,0,2,1,2
TRBV2,TRBJ1-5,CASTRGNQPQHL,0,2,1,2
TRBV6-1,TRBJ2-3,CASTTGTDTQYF,0,2,1,2
TRBV28,TRBJ2-7,CASSFSVYEQYF,0,2,1,2
TRBV28,TRBJ2-3,CASSLYGDTQYS,0,2,1,2
TRBV6-2/3/5/6,TRBJ2-3,CASSLRIDTQYF,0,2,1,2
TRBV6-2/3/5/6,TRBJ1-4,CASSSGGRKLFF,0,2,1,2
TRBV6-2/3/5/6,TRBJ2-3,CASSYASEAQYF,0,2,1,2
TRBV6-2/3/5/6,TRBJ2-7,CASSYRDDEQYF,0,2,1,2
TRBV12-3/4,TRBJ2-1,CASSLVYNEQFF,0,2,1,2
TRBV6-1,TRBJ2-5,CASSAWEKTQYF,0,2,1,2
TRBV2,TRBJ2-1,CASSEDSGSSFF,0,2,1,2
TRBV3-1,TRBJ2-7,CASSISSYEQYF,0,2,1,2
TRBV5-6,TRBJ2-1,CASSLLGNEQFF,0,2,1,2
TRBV5-8,TRBJ1-4,CASSLAGDRLFF,0,2,1,2
TRBV7-9,TRBJ2-5,CASSLVVETQYF,0,2,1,2
TRBV7-9,TRBJ2-1,CASSLVAFGGFF,0,2,1,2
TRBV11-2,TRBJ2-7,CASSLAAGNPYF,0,2,1,2
TRBV7-9,TRBJ2-4,CASSLGDRGLYF,0,2,1,2
TRBV7-8,TRBJ2-3,CASSLMVDTQYF,0,2,1,2
TRBV7-2,TRBJ2-7,CASSLTLDEQYF,0,2,1,2
TRBV7-2,TRBJ2-3,CASSSPRDTQYF,0,2,1,2
TRBV5-4,TRBJ2-2,CASSLNTGELFF,0,2,1,2
TRBV3-1,TRBJ2-5,CASSPLTETQYF,0,2,1,2
TRBV12-3/4,TRBJ2-1,CASSPSRNEQFF,0,2,1,2
TRBV7-2,TRBJ2-7,CASSPQGYEQYF,0,2,1,2
TRBV7-9,TRBJ2-5,CASSREGETQYF,0,4,1,4
TRBV2,TRBJ2-7,CASSQGSYEQYF,0,2,1,2
TRBV3-1,TRBJ1-1,CASSQYTNEAFF,0,2,1,2
TRBV5-4,TRBJ2-7,CASSGDSYEQYF,0,2,1,2
TRBV7-2,TRBJ2-1,CASSKRPNEQFF,0,2,1,2
TRBV6-2/3/5/6,TRBJ2-7,CASRLQGGEQYF,0,2,1,2
TRBV2,TRBJ2-3,CASRGLDSTQYF,0,2,1,2
TRBV6-2/3/5/6,TRBJ2-5,CASNKREETQYF,0,2,1,2
TRBV2,TRBJ2-5,CASKGQGETQYF,0,2,1,2
TRBV5-1,TRBJ2-1,CASKLEGDEQFF,0,2,1,2
TRBV10-2,TRBJ2-2,CASSGVAGELFF,0,2,1,2
TRBV5-1,TRBJ2-1,CASSMGLNEQFF,0,2,1,2
TRBV5-1,TRBJ2-1,CASSFGGDEQFF,0,2,1,2
TRBV5-1,TRBJ1-1,CASSLGGDRTFF,0,2,1,2
TRBV5-1,TRBJ2-1,CASSLDVLEQFF,0,2,1,2
TRBV5-1,TRBJ2-7,CASSLTAYEQYF,0,2,1,2
TRBV4-1,TRBJ1-2,CASSQAGYGYTS,0,2,1,2
TRBV4-1,TRBJ2-1,CASSQGGQEQFF,0,2,1,2
TRBV5-1,TRBJ2-1,CASSTAGIEQFF,0,2,1,2
TRBV20-1,TRBJ2-4,CSATVPPGIQYF,0,2,1,2
TRBV20-1,TRBJ2-7,CSARDHSYEQYF,0,2,1,2
TRBV20-1,TRBJ2-1,CSAREGTYEQFF,0,2,1,2
TRBV20-1,TRBJ2-1,CSTRQGYNEQFF,0,2,1,2
TRBV29-1,TRBJ2-2,CSVGGEAGELFF,0,2,1,2
TRBV29-1,TRBJ2-5,CSVEVEGETQYF,0,2,1,2
TRBV29-1,TRBJ2-5,CSVEASGRTQYF,0,2,1,2
TRBV29-1,TRBJ2-5,CSVEGASKTQYF,0,2,1,2
TRBV29-1,TRBJ2-5,CSVEGRPETQYF,0,2,1,2
TRBV29-1,TRBJ2-7,CSVASRGNEQYF,0,2,1,2
TRBV20-1,TRBJ2-7,CSVGDREGEQYF,0,2,1,2
TRBV5-6,TRBJ2-7,CPPGSRNEQYF,0,2,1,2
TRBV30,TRBJ2-1,CAWSVPNEQFF,0,2,1,2
TRBV24-1,TRBJ2-1,CATRQNNEQFF,0,2,1,2
TRBV3-1,TRBJ2-7,CASGVSYEQYF,0,2,1,2
TRBV19,TRBJ1-1,CASGTNTEAFF,0,2,1,2
TRBV28,TRBJ2-7,CASAGPYEQYF,0,2,1,2
TRBV28,TRBJ2-7,CASGRPYEQYF,0,2,1,2
TRBV12-3/4,TRBJ2-1,CASSFLEEKFF,0,2,1,2
TRBV12-3/4,TRBJ2-1,CASSLGREQFF,0,2,1,2
TRBV6-4,TRBJ2-5,CASSSVGAQYF,0,2,1,2
TRBV7-9,TRBJ1-2,CASSLEDGYTF,0,2,1,2
TRBV7-2,TRBJ2-1,CASSLVNEQFF,0,2,1,2
TRBV7-9,TRBJ2-1,CASSLNHEQFF,0,2,1,2
TRBV7-6,TRBJ1-4,CASSSREKLFF,0,2,1,2
TRBV5-6,TRBJ2-3,CASSLLDTQYF,0,2,1,2
TRBV7-9,TRBJ2-5,CASSPTETQYF,0,2,1,2
TRBV14,TRBJ2-1,CASSQYNEQFF,0,2,1,2
TRBV28,TRBJ2-2,CASRETGELFF,0,2,1,2
TRBV2,TRBJ2-7,CASNTPYEQYF,0,2,1,2
TRBV5-1,TRBJ2-2,CASSASGELFF,0,2,1,2
TRBV20-1,TRBJ2-3,CSVAGTDTQYF,0,2,1,2
TRBV20-1,TRBJ1-4,CSAPGEEKLFF,0,2,1,2
TRBV20-1,TRBJ1-1,CSASRAAEAFF,0,2,1,2
TRBV20-1,TRBJ2-7,CSASPSHEQYF,0,2,1,2
TRBV29-1,TRBJ1-2,CSVHLNYGYTF,0,2,1,2
TRBV29-1,TRBJ2-7,CSVESGDEQYF,0,2,1,2
TRBV29-1,TRBJ2-7,CSAAGGYEQYF,0,2,1,2
TRBV11-2,TRBJ1-1,SASRLVSEAFF,0,2,1,2
TRBV19,TRBJ2-3,CASESDTQYF,0,2,1,2
TRBV7-9,TRBJ2-1,CASSSRTQFF,0,2,1,2
TRBV2,TRBJ2-3,CARGVDTQYF,0,2,1,2
TRBV20-1,TRBJ2-5,CSAGSETQYF,0,2,1,2
TRBV29-1,TRBJ1-1,CSVKNTEAFF,0,2,1,2
