v_hit,j_hit,cdr3,S4-10ng_S9,S4-10ng_S21,freq,count_sum
TRAV26-2,TRAJ39,CIPLDGNAGNMLTF,50,75,2,125
TRAV13-1,TRAJ54,CASPPLQGAQKLVF,41,58,2,99
TRAV41,TRAJ52,CAVSTSYGKLTF,18,27,2,45
TRAV41,TRAJ54,CAVSRPRDLIIQGAQKLVF,18,40,2,58
TRAV12-2,TRAJ20,CAVRPNDYKLSF,21,18,2,39
TRAV26-2,TRAJ57,CILSPRGGQGGSEKLVF,16,26,2,42
TRAV12-1,TRAJ3,CVVNKGRDLYSSASKIIF,11,11,2,22
TRAV9-2,TRAJ29,CALSDRSGNTPLVF,2,0,1,2
TRAV21,TRAJ57,CAVRRPRDFITQGGSEKLVF,6,14,2,20
TRAV24,TRAJ4,CASGGYNKLIF,8,14,2,22
TRAV8-6,TRAJ58,CAASETSGSRLTF,7,8,2,15
TRAV12-2,TRAJ52,CAVKRARDAGGTSYGKLTF,6,10,2,16
TRAV10,TRAJ38,CVVSGNNAGNNRKLIW,3,0,1,3
TRAV13-1,TRAJ22,CAAPTTGSARQLTF,1,0,1,1
TRAV30,TRAJ31,CGTEKHNARLMF,2,0,1,2
TRAV41,TRAJ22,CAVKPPRDQISSGSARQLTF,5,11,2,16
TRAV14DV4,TRAJ8,CAMRESREKGFQKLVF,6,9,2,15
TRAV29DV5,TRAJ17,CAASAREIAGNKLTF,6,4,2,10
TRAV16,TRAJ37,CALSRSNTGKLIF,1,0,1,1
TRAV9-2,TRAJ52,CALANAGGTSYGKLTF,2,0,1,2
TRAV34,TRAJ57,CGADPEGGSEKLVF,5,5,2,10
TRAV12-2,TRAJ53,CAVNEGRDSGGSNYKLTF,5,20,2,25
TRAV38-1,TRAJ35,CAFMAIGFGNVLHC,1,0,1,1
TRAV20,TRAJ48,CAVRFGNEKLTF,3,0,1,3
TRAV12-2,TRAJ6,CAARGGSYIPTF,5,11,2,16
TRAV13-1,TRAJ11,CAASTRYSTLTF,2,0,1,2
TRAV10,TRAJ47,CVVSVGREYGNKLVF,3,6,2,9
TRAV38-2DV8,TRAJ56,CAYRREGHYTGANSKLTF,1,0,1,1
TRAV35,TRAJ52,CAGQPPGGGTSYGKLTF,1,0,1,1
TRAV19,TRAJ42,CALSEARDGGSQGNLIF,1,0,1,1
TRAV17,TRAJ49,CATDAGNQFYF,1,0,1,1
TRAV14DV4,TRAJ5,CAMRESQDTGRRALTF,3,1,2,4
TRAV36DV7,TRAJ29,CAVGTFSYSGNTPLVF,2,0,1,2
TRAV4,TRAJ30,CLVVENRDDKIIF,1,0,1,1
TRAV19,TRAJ45,CALSEYIGGGGADGLTF,5,0,1,5
TRAV13-1,TRAJ6,CAASSSGGSYIPTF,2,0,1,2
TRAV38-2DV8,TRAJ49,CAYHTGNQFYF,2,0,1,2
TRAV12-2,TRAJ12,CAVLMDSSYKLIF,1,0,1,1
TRAV26-1,TRAJ27,CIVRVSTNAGKSTF,2,0,1,2
TRAV14DV4,TRAJ32,CAMRVRENYGGATNKLIF,3,0,1,3
TRAV4,TRAJ37,CLVGLQLPSNTGKLIF,1,0,1,1
TRAV9-2,TRAJ42,CALSSGGSQGNLIF,1,0,1,1
TRAV21,TRAJ36,CAVSWRPGANNLFF,1,0,1,1
TRAV12-1,TRAJ29,CVVTFSGNTPLVF,1,0,1,1
TRAV19,TRAJ34,CALRGYNTDKLIF,1,0,1,1
TRAV21,TRAJ36,CAVPGANNLFF,1,0,1,1
TRAV17,TRAJ20,CATDDYKLSF,2,0,1,2
TRAV38-1,TRAJ28,CAFLNSGAGSYQLTF,2,0,1,2
TRAV2,TRAJ9,CAVEDQGAGGFKTIF,2,0,1,2
TRAV8-3,TRAJ48,CAVGRTF,1,0,1,1
TRAV9-2,TRAJ9,CALSSNTGGFKTIF,4,0,1,4
TRAV12-1,TRAJ48,CVVTINFGNEKLTF,2,0,1,2
TRAV41,TRAJ45,CAVRKYSGGGADGLTF,2,7,2,9
TRAV12-1,TRAJ52,CVVKRGRDAGGTSYGKLTF,2,6,2,8
TRAV30,TRAJ23,CGTEIPSGIYNQGGKLIF,2,3,2,5
TRAV12-2,TRAJ58,CAVNRGRETSGSRLTF,3,7,2,10
TRAV38-1,TRAJ10,CAFMTAGGGNKLTF,1,0,1,1
TRAV8-3,TRAJ34,CAVGAFGNTDKLIF,1,0,1,1
TRAV16,TRAJ3,CALSGRSSASKIIF,2,0,1,2
TRAV13-1,TRAJ47,CAAETEYGNKLVF,2,0,1,2
TRAV27,TRAJ58,CAGEETSGSRLTF,1,0,1,1
TRAV13-1,TRAJ30,CAASTGDDKIIF,1,0,1,1
TRAV19,TRAJ37,CALSFHSSNTGKLIF,1,0,1,1
TRAV20,TRAJ44,CAVPLNTGTASKLTF,1,0,1,1
TRAV14DV4,TRAJ27,CAMRGPNAGKSTF,1,0,1,1
TRAV9-2,TRAJ29,CALDSGNTPLVF,3,1,2,4
TRAV16,TRAJ53,CALGGSNYKLTF,2,0,1,2
TRAV16,TRAJ43,CALRVLNDMRF,1,0,1,1
TRAV38-2DV8,TRAJ29,CAYRSKSGNTPLVF,2,0,1,2
TRAV27,TRAJ16,CAGAVSDGQKLLF,1,0,1,1
TRAV9-2,TRAJ7,YALSPYGNNRLAF,3,0,1,3
TRAV9-2,TRAJ10,CALTPGSILTGGGNKLTF,2,0,1,2
TRAV26-2,TRAJ53,CILRDGANSGGSNYKLTF,1,0,1,1
TRAV41,TRAJ52,CADPNAGGTSYGKLTF,1,0,1,1
TRAV19,TRAJ15,CALSEANQAGTALIF,1,0,1,1
TRAV21,TRAJ15,CAVRRPNQAGTALIF,1,2,2,3
TRAV19,TRAJ29,CALSGEGGNTPLVF,3,2,2,5
TRAV12-3,TRAJ57,CAMSAQGGSEKLVF,3,0,1,3
TRAV19,TRAJ13,CALLIGGYQKVTF,2,0,1,2
TRAV17,TRAJ33,CATGLLGNYQLIW,2,0,1,2
TRAV13-1,TRAJ34,CAASRGNTDKLIF,1,0,1,1
TRAV25,TRAJ48,CAGRGFGNEKLTF,1,0,1,1
TRAV30,TRAJ42,CGTPERSQGNLIF,1,0,1,1
TRAV12-1,TRAJ27,CVVNTNAGKSTF,1,0,1,1
TRAV16,TRAJ11,CALSDEYSTLTF,2,0,1,2
TRAV20,TRAJ21,CAVRDNFNKFYF,2,1,2,3
TRAV13-1,TRAJ36,CAASDWANNLFF,1,0,1,1
TRAV24,TRAJ48,CAFSKEKLTF,1,0,1,1
TRAV26-2,TRAJ13,CILRDAGGYQKVTF,3,2,2,5
TRAV12-2,TRAJ18,CAVISDDRGSTLGRLYF,2,0,1,2
TRAV21,TRAJ37,CAVRMKSSNTGKLIF,1,0,1,1
TRAV13-1,TRAJ18,CAADDRGSTLGRLYF,1,0,1,1
TRAV38-1,TRAJ56,CAYGGEGANSKLTF,2,0,1,2
TRAV9-2,TRAJ38,CALHNAGNNRKLIW,1,0,1,1
TRAV5,TRAJ38,CARDNAGNNRKLIW,1,0,1,1
TRAV36DV7,TRAJ48,CAVELNFGNEKLTF,2,0,1,2
TRAV12-1,TRAJ42,CASHRGGSQGNLIF,1,0,1,1
TRAV12-3,TRAJ4,CAMTFSGGYNKLIF,2,0,1,2
TRAV10,TRAJ23,CVVSPNQGGKLIF,1,0,1,1
TRAV10,TRAJ49,CVVSGSTGNQFYF,1,0,1,1
TRAV13-1,TRAJ10,CAPGRGGGNKLTF,1,0,1,1
TRAV3,TRAJ6,CAVREGGSYIPTF,2,5,2,7
TRAV12-2,TRAJ9,CAAPNTGGFKTIF,1,0,1,1
TRAV24,TRAJ6,CAILEGGSYIPTF,2,0,1,2
TRAV12-1,TRAJ40,CVVRRGTYKYIF,1,0,1,1
TRAV38-2DV8,TRAJ32,CAYSGATNKLIF,1,1,2,2
TRAV10,TRAJ6,CVVSRSYIPTF,1,0,1,1
TRAV8-1,TRAJ45,CAVTSGGGADGLTF,2,0,1,2
TRAV12-2,TRAJ52,CAVIIRGKLTF,1,0,1,1
TRAV16,TRAJ10,CAPLGGLTGGGNKLTF,1,0,1,1
TRAV38-2DV8,TRAJ42,CAFNNYGGSQGNLIF,2,1,2,3
TRAV19,TRAJ26,CALSEGSYGQNFVF,1,0,1,1
TRAV12-3,TRAJ29,CAMSANSGNTPLVF,2,0,1,2
TRAV9-2,TRAJ36,CALVQTGANNLFF,1,0,1,1
TRAV12-1,TRAJ5,CVVGGGRRALTF,4,7,2,11
TRAV12-1,TRAJ9,CVVNIRTGGFKTIF,2,0,1,2
TRAV16,TRAJ57,CALSGRRGGSEKLVF,1,0,1,1
TRAV19,TRAJ48,CALSAPRSNFGNEKLTF,1,0,1,1
TRAV41,TRAJ53,CAVRGWNSGGSNYKLTF,3,2,2,5
TRAV12-2,TRAJ56,CAVNNPGAGANSKLTF,1,0,1,1
TRAV38-1,TRAJ40,CAFMKIDSGTYKYIF,1,0,1,1
TRAV16,TRAJ54,CALRDPIQGAQKLVF,1,0,1,1
TRAV35,TRAJ32,CAGRSYGGATNKLIF,1,0,1,1
TRAV26-1,TRAJ23,CIVRVLYNQGGKLIF,1,0,1,1
TRAV13-1,TRAJ6,CAAWESGGSYIPTF,1,0,1,1
TRAV13-1,TRAJ4,CAASNTGGYNKLIF,1,2,2,3
TRAV12-3,TRAJ37,CAMSRSSNTGKLIF,2,0,1,2
TRAV12-1,TRAJ36,CVVIPTGANNLFF,2,0,1,2
TRAV41,TRAJ34,CAVSQYNTDKLIF,1,0,1,1
TRAV17,TRAJ13,CATDGGGYQKVTF,2,0,1,2
TRAV24,TRAJ11,CAFPDSGYSTLTF,1,0,1,1
TRAV13-1,TRAJ9,CAASKPGGFKTIF,2,0,1,2
TRAV27,TRAJ44,CAGETGTASKLTF,1,0,1,1
TRAV30,TRAJ36,CGTDPAGANNLFF,1,0,1,1
TRAV38-2DV8,TRAJ31,CAYRVNNARLMF,1,0,1,1
TRAV3,TRAJ21,CAVRDIFNKFYF,1,0,1,1
TRAV27,TRAJ26,CAGDNYGQNFVF,3,5,2,8
TRAV13-1,TRAJ43,CAASVNDMRF,1,0,1,1
TRAV30,TRAJ5,YGTEREDTGRRALTF,1,0,1,1
TRAV12-3,TRAJ58,CAMKETSGSRLTF,1,0,1,1
TRAV35,TRAJ47,CAGRHPRDDMEYGNKLVF,2,0,1,2
TRAV8-3,TRAJ7,CAVGAILERGNNRLAF,3,0,1,3
TRAV9-2,TRAJ13,CALSGGSGGYQKVTF,1,0,1,1
TRAV16,TRAJ52,CVLGGGTSYGKLTF,2,0,1,2
TRAV36DV7,TRAJ52,CAVEAPRKAGGTSYGKLTF,2,0,1,2
TRAV38-2DV8,TRAJ57,CAYKGEDQGGSEKLVF,1,0,1,1
TRAV12-2,TRAJ16,CAVNPKPFSDGQKLLF,1,0,1,1
TRAV13-1,TRAJ53,CAASIQSGGSNYKLTF,1,0,1,1
TRAV29DV5,TRAJ37,CAASSMRGGNTGKLIF,1,0,1,1
TRAV19,TRAJ53,CALSDLGGSNYKLTF,1,0,1,1
TRAV21,TRAJ22,CAGSISSGSARQLTF,1,0,1,1
TRAV9-2,TRAJ27,CALSSNTNAGKSTF,1,0,1,1
TRAV9-2,TRAJ27,CALSANTNAGKSTF,1,0,1,1
TRAV9-2,TRAJ27,CALSGGTNAGKSTF,1,0,1,1
TRAV20,TRAJ13,CAVQPSGGYQKVTF,2,0,1,2
TRAV22,TRAJ31,CAVEQSYNNARLMF,2,0,1,2
TRAV3,TRAJ27,CAVRVNTNAGKSTF,2,3,2,5
TRAV23DV6,TRAJ58,CAARKETSGSRLTF,1,0,1,1
TRAV13-2,TRAJ10,CAERTTGGGNKLTF,1,0,1,1
TRAV13-2,TRAJ10,CAENPGGGGNKLTF,1,0,1,1
TRAV12-3,TRAJ48,CAMTTLFGNEKLTF,1,0,1,1
TRAV14DV4,TRAJ54,CAMREIQGAQKLVF,1,0,1,1
TRAV4,TRAJ8,CLVGGRTGFQKLVF,1,0,1,1
TRAV9-2,TRAJ47,CALSDRYGNKLVF,1,0,1,1
TRAV8-3,TRAJ10,CAVESGGGNKLTF,1,0,1,1
TRAV3,TRAJ3,CAVRDSSASKIIF,2,0,1,2
TRAV39,TRAJ26,CAVDKDYGQNFVF,1,0,1,1
TRAV5,TRAJ33,CAERRDSNYQLIW,1,0,1,1
TRAV4,TRAJ30,CLVVGNRDDKIIF,1,0,1,1
TRAV16,TRAJ26,CVLRDYGQNFVF,1,0,1,1
TRAV2,TRAJ16,CAVEEDGQKLLF,1,0,1,1
TRAV20,TRAJ30,CAARNRDDKIIF,2,0,1,2
TRAV17,TRAJ53,CADGGSNYKLTF,1,0,1,1
TRAV5,TRAJ39,CAEYDAGNMLTF,3,0,1,3
TRAV13-2,TRAJ40,CAETTGTYKYIF,1,0,1,1
TRAV9-2,TRAJ27,CALPPRGKSTF,1,0,1,1
TRAV13-1,TRAJ27,CAASRAGKSTF,1,0,1,1
TRAV12-2,TRAJ20,CAAFGGQLSF,2,1,2,3
TRAV19,TRAJ16,CALSGLLF,1,0,1,1
TRAV22,TRAJ56,CPTLAF,1,0,1,1
TRAV14DV4,TRAJ52,CAMRESGRNAGGTSYGKLTF,1,0,1,1
TRAV13-1,TRAJ13,CAASRNSGGYQKVTF,3,0,1,3
TRAV26-1,TRAJ13,CIVRVVNSGGYQKVTF,1,0,1,1
TRAV13-1,TRAJ13,CAAIPNSGGYQKVTF,2,0,1,2
TRAV4,TRAJ42,CLVGEHGGSQGNLIF,1,0,1,1
TRAV9-2,TRAJ8,CALSDPTGFQKLVF,2,0,1,2
TRAV41,TRAJ53,CAVRLNSGGSNYKLTL,1,0,1,1
TRAV9-2,TRAJ54,CALSDRGGAQRLVF,1,0,1,1
TRAV3,TRAJ9,CAVRANTGGFKTIF,3,0,1,3
TRAV4,TRAJ13,CLVGTSGGYQKVTF,2,1,2,3
TRAV4,TRAJ30,CLVGENRDDKIIF,2,0,1,2
TRAV41,TRAJ40,CAVTSGTYKYIL,1,0,1,1
TRAV2,TRAJ31,CAVEDNNARLMF,3,0,1,3
TRAV23DV6,TRAJ13,CAASNSRLGNSGGYQKVTF,2,0,1,2
TRAV38-2DV8,TRAJ28,CAYLAYSGAGSYQLTF,1,0,1,1
TRAV36DV7,TRAJ54,CAVVNREIQGAQKLVF,1,0,1,1
TRAV21,TRAJ42,CAVSSGYGGSQGNLIF,1,0,1,1
TRAV17,TRAJ52,CATDGTGGTSYGKLTF,1,0,1,1
TRAV12-1,TRAJ24,CVVNGEPDSWGKFQF,1,0,1,1
TRAV12-1,TRAJ30,CVVNKGRNRDDKIIF,1,0,1,1
TRAV38-2DV8,TRAJ38,CAYPYNAGNNRKLIW,1,0,1,1
TRAV9-2,TRAJ49,CALSSGTNTGNQFYF,2,0,1,2
TRAV41,TRAJ26,CAVRSGDNYGQNFVF,1,0,1,1
TRAV3,TRAJ13,CAVSGYSGGYQKVTF,1,0,1,1
TRAV17,TRAJ4,CATDLSSGGYNKLIF,1,0,1,1
TRAV8-1,TRAJ36,CAVNRPLTGANNLFF,1,0,1,1
TRAV12-2,TRAJ10,CAVKGVTGGGNKLTF,2,0,1,2
TRAV13-1,TRAJ17,CAASPAWGAGNKLTF,1,0,1,1
TRAV13-2,TRAJ52,CAENAGGTSYGKLTF,1,0,1,1
TRAV12-3,TRAJ29,CAMTDASSGNTPLVF,1,0,1,1
TRAV14DV4,TRAJ49,CAMREGANTGNQFYF,1,0,1,1
TRAV30,TRAJ29,CGTEIIGSGNTPLVF,1,0,1,1
TRAV10,TRAJ4,CVVSPQGGYSKLIF,1,0,1,1
TRAV12-1,TRAJ48,CVVRGNFGNEKLTF,3,5,2,8
TRAV9-2,TRAJ39,CALGRNNAGNMLTF,1,0,1,1
TRAV21,TRAJ21,CAVWDIDNFNKFYF,2,3,2,5
TRAV17,TRAJ37,CATVYLGNTGKLIF,1,0,1,1
TRAV8-1,TRAJ38,CAVLNAGNNRKLIW,1,1,2,2
TRAV39,TRAJ47,CAVDLMEYGNKLVF,2,0,1,2
TRAV5,TRAJ22,CAEKSSGSARQLTF,1,0,1,1
TRAV12-3,TRAJ56,CAMSATGANSKLTF,1,0,1,1
TRAV26-2,TRAJ27,CPWGLEANAGKSTF,1,0,1,1
TRAV19,TRAJ57,CVPPQGGSEKLVF,1,0,1,1
TRAV9-2,TRAJ54,CALSDQGAQKLVF,1,1,2,2
TRAV16,TRAJ23,CALSIYQGGKLIF,1,0,1,1
TRAV6,TRAJ11,CAPEGAGYSTLTF,1,0,1,1
TRAV20,TRAJ29,CAVKNSGNTPLVF,1,0,1,1
TRAV8-3,TRAJ8,CAVAPPGFQKLVF,1,0,1,1
TRAV8-1,TRAJ4,CAVFSGGYNKLIF,2,0,1,2
TRAV26-2,TRAJ58,CILRETSGSRLTF,1,0,1,1
TRAV19,TRAJ20,CALRIPDYKLSF,1,0,1,1
TRAV9-2,TRAJ26,CALKGYGQNFVF,2,0,1,2
TRAV8-3,TRAJ43,CAVVRGNNDMRF,1,0,1,1
TRAV24,TRAJ48,CAFNFGNEKLTF,1,0,1,1
TRAV13-1,TRAJ41,CAASTSGYALNF,1,0,1,1
TRAV27,TRAJ21,CAGVYNFNKFYF,1,0,1,1
TRAV4,TRAJ33,CLVGDSNYQLIW,1,0,1,1
TRAV22,TRAJ40,CAVLRTYKYIF,1,0,1,1
TRAV34,TRAJ43,CGAAPRNDMRF,2,0,1,2
TRAV4,TRAJ43,CLVGERDMRF,1,0,1,1
TRAV13-1,TRAJ22,CAARGVGSSGSARQLTF,1,0,1,1
TRAV8-3,TRAJ6,CAVGASGGSYIPTF,2,0,1,2
TRAV12-3,TRAJ49,CAMSSNTGNQFYF,3,0,1,3
TRAV21,TRAJ57,CAVMLLRDASAITQGGSEKLVF,2,2,2,4
TRAV17,TRAJ45,CATDDGGYSGGGADGLTF,1,0,1,1
TRAV2,TRAJ32,CAVGGATNKLIF,1,0,1,1
TRAV8-4,TRAJ6,CAVSVLSGGSYLPTF,1,0,1,1
TRAV12-2,TRAJ9,CAARVITGGFKTIF,1,0,1,1
TRAV8-4,TRAJ48,CAVLNFGNEKLTF,1,0,1,1
TRAV13-2,TRAJ9,CAENTRGFKTIF,2,0,1,2
TRAV12-3,TRAJ49,CAMSAAGNQFYF,1,0,1,1
TRAV5,TRAJ44,CAEYNAGTASNLTF,2,0,1,2
TRAV13-2,TRAJ45,CAEKVGYSGGGADGLTF,1,0,1,1
TRAV12-3,TRAJ39,CAMSEARFSNAGNMLTF,1,0,1,1
TRAV9-2,TRAJ52,CALYEAGGTSYGELTF,1,0,1,1
TRAV23DV6,TRAJ32,CAARGNYGGATNKLIF,1,0,1,1
TRAV38-1,TRAJ39,CAFMSANNAGNMLTF,1,0,1,1
TRAV38-2DV8,TRAJ52,CAYLAGGTSYGKLTF,1,0,1,1
TRAV9-2,TRAJ54,CALSDSGQGAQKLVF,1,0,1,1
TRAV9-2,TRAJ39,CALSDRSNAGNMLTF,2,0,1,2
TRAV9-2,TRAJ56,CALSDDSGANSKLTF,1,0,1,1
TRAV8-3,TRAJ5,CAVGAGDTGRRALTF,1,0,1,1
TRAV2,TRAJ17,CAVEDPRAAGNKLTF,1,0,1,1
TRAV21,TRAJ53,CAVNPRGGSNYKLTF,1,0,1,1
TRAV17,TRAJ47,CATDAMAEYGNKLVF,1,0,1,1
TRAV13-1,TRAJ53,CAASNSGGSNYKLTF,1,0,1,1
TRAV25,TRAJ37,CAGHPETGNTGKLIF,1,0,1,1
TRAV14DV4,TRAJ13,CAMSEHGRGYQKVTF,1,0,1,1
TRAV14DV4,TRAJ15,CAMREPNQAGTALIF,1,0,1,1
TRAV26-1,TRAJ40,CIVRGTTSGTYKYIF,1,0,1,1
TRAV38-2DV8,TRAJ28,CAYIPGAGSYQLTF,1,0,1,1
TRAV9-2,TRAJ5,CALYGGTGRRALTF,1,0,1,1
TRAV16,TRAJ3,CALSGHSSASKIIF,1,0,1,1
TRAV19,TRAJ49,CALSEANTGNQFYF,1,2,2,3
TRAV20,TRAJ22,CAVRVSGSARQLTF,1,0,1,1
TRAV20,TRAJ15,CAVQWPVAGTALIF,1,0,1,1
TRAV8-3,TRAJ39,CAVGAHNAGNMLTF,1,0,1,1
TRAV23DV6,TRAJ42,CAVKDGGSQGNLIF,1,0,1,1
TRAV13-1,TRAJ27,CAASIGTNAGKSTF,1,0,1,1
TRAV13-1,TRAJ38,CAASNAGNNRKLIW,2,0,1,2
TRAV23DV6,TRAJ58,CAAKGETSGSRLTF,1,0,1,1
TRAV30,TRAJ33,CGTDNMDSNYQLIW,1,0,1,1
TRAV26-2,TRAJ57,CILRDVGGSEKLAF,1,0,1,1
TRAV9-2,TRAJ29,CALIISGNTPPVF,1,0,1,1
TRAV38-2DV8,TRAJ22,CAQIRGSARQLTF,1,3,2,4
TRAV20,TRAJ23,CAVQPNQGGKLIF,1,0,1,1
TRAV19,TRAJ5,CAQEATGRRALTF,1,0,1,1
TRAV39,TRAJ38,CAVNAGNNRKLIW,1,1,2,2
TRAV12-2,TRAJ22,CAVRSGSARQLTF,1,0,1,1
TRAV39,TRAJ49,CAVSYTTGNEFYF,1,0,1,1
TRAV13-1,TRAJ40,CAATTSGTYKYIF,1,0,1,1
TRAV13-1,TRAJ36,CAASITGANNLFF,1,0,1,1
TRAV29DV5,TRAJ48,CAASPFGNEKLTF,1,0,1,1
TRAV23DV6,TRAJ33,CAASKGSNYQLIW,1,0,1,1
TRAV29DV5,TRAJ54,CAANLQGAQKLVF,1,0,1,1
TRAV13-2,TRAJ40,CAEWVSGTYKYIF,1,0,1,1
TRAV12-3,TRAJ42,CAMGGGSQGNLIF,1,0,1,1
TRAV12-3,TRAJ23,CAMRVNQGGKLIF,1,3,2,4
TRAV26-2,TRAJ29,CILRGGRNTPLVF,1,0,1,1
TRAV16,TRAJ16,CALYSDGQKLLF,1,0,1,1
TRAV38-1,TRAJ54,CAPHQGAQKLVF,1,0,1,1
TRAV17,TRAJ8,CAPPTGFQKLVF,1,0,1,1
TRAV36DV7,TRAJ31,CAVEKVIARLMF,1,0,1,1
TRAV21,TRAJ49,CAVRDTGNQFYF,1,0,1,1
TRAV2,TRAJ15,CAASEGGTALIF,1,0,1,1
TRAV39,TRAJ32,CAVVSATNKLIF,1,0,1,1
TRAV29DV5,TRAJ36,CAASPRANNLFF,1,0,1,1
TRAV19,TRAJ34,CALKNTDKLIF,1,1,2,2
TRAV12-3,TRAJ27,CAVRHAGKSTF,1,0,1,1
TRAV13-2,TRAJ43,CAEKGVNDTRF,1,0,1,1
TRAV13-1,TRAJ34,CAANTDKLIF,3,0,1,3
TRAV12-1,TRAJ50,CVVMDKVIF,1,0,1,1
TRAV13-1,TRAJ43,CAATNDMRF,1,0,1,1
TRAV13-1,TRAJ4,CAARDLIF,1,0,1,1
TRAV17,TRAJ52,CATDGLRDAGGTSYGKLTF,3,3,2,6
TRAV26-1,TRAJ23,CIVRVAGGNQGRKLIF,1,0,1,1
TRAV12-2,TRAJ23,CAVPSLYNQGGKLIF,1,0,1,1
TRAV29DV5,TRAJ45,CAASSGGGADGLTF,2,0,1,2
TRAV2,TRAJ13,CAVVSGGYQKVTF,1,0,1,1
TRAV12-2,TRAJ57,CAVDNRARGGSEKLVF,1,0,1,1
TRAV3,TRAJ29,CAVRDKTGNTPLVF,2,0,1,2
TRAV3,TRAJ36,CPKTGANSLFF,1,0,1,1
TRAV12-3,TRAJ30,CATGRGDKIIF,1,0,1,1
TRAV8-3,TRAJ42,CAVGARSGRYGGSQGNLIF,1,0,1,1
TRAV16,TRAJ22,CALSGDLNSSGSARQLTF,1,0,1,1
TRAV38-1,TRAJ45,CAFMIGHVGGGADGLTF,1,0,1,1
TRAV16,TRAJ52,CALSPRFGGTSYGKLTF,1,0,1,1
TRAV25,TRAJ28,CAGPQAYSGAGSYQLTF,1,0,1,1
TRAV12-3,TRAJ28,CAMSPAYSGAGSYQLTF,1,0,1,1
TRAV4,TRAJ9,CLVVRPRGNTGGFKTIF,1,1,2,2
TRAV26-1,TRAJ27,CIVRAPKLESNAGKSTF,1,0,1,1
TRAV38-1,TRAJ52,CAFMKQGGTSYGKLTF,1,0,1,1
TRAV21,TRAJ41,CAVRDPNSNSGYALNF,1,0,1,1
TRAV35,TRAJ56,CAGHVPLGGANSKLTF,1,0,1,1
TRAV17,TRAJ49,CATGSHSPNTGNQFYF,1,0,1,1
TRAV12-2,TRAJ47,CAVNGIISEYGNKLVF,1,0,1,1
TRAV12-2,TRAJ44,CAVNMFYTGIASKLTF,1,0,1,1
TRAV29DV5,TRAJ22,CAPYLISSGSARQLTF,2,0,1,2
TRAV13-2,TRAJ3,CAENLAGYSSASKIIF,2,0,1,2
TRAV14DV4,TRAJ42,CAMRDYYGGSQGNLIF,1,0,1,1
TRAV26-1,TRAJ42,CIVRSDYGGSQGNLIF,2,0,1,2
TRAV12-1,TRAJ27,CVVIPPNTNAGKSTF,1,0,1,1
TRAV38-1,TRAJ49,CAFMKPLITGNQFYF,1,0,1,1
TRAV38-2DV8,TRAJ20,CAYRSANSPDYKLSF,1,0,1,1
TRAV38-1,TRAJ45,CALLLTGGGADGLTF,1,0,1,1
TRAV19,TRAJ47,CALSPSREYGNKLVF,1,0,1,1
TRAV19,TRAJ27,CALSEARANAGKSTF,2,0,1,2
TRAV6,TRAJ16,CALDIAGSDGQKLLF,1,0,1,1
TRAV22,TRAJ32,CAVVTRGGATNKLIF,1,0,1,1
TRAV22,TRAJ8,CAVVVMNTGFQKLVF,1,0,1,1
TRAV29DV5,TRAJ6,CAASGATGGSYIPTF,1,0,1,1
TRAV27,TRAJ45,CAGAKSGGGADGLTF,1,0,1,1
TRAV5,TRAJ13,CAEWIYSGGYQKVTF,1,0,1,1
TRAV5,TRAJ15,CAEIPLNQAGTALIF,1,0,1,1
TRAV13-2,TRAJ37,CAENPGSSNTGKLIF,1,0,1,1
TRAV14DV4,TRAJ15,CAMRDFGGAGTALIF,1,0,1,1
TRAV4,TRAJ13,CLVGLVSGGYQKVTF,1,0,1,1
TRAV26-2,TRAJ45,CIPLYSGGGADGLTF,1,0,1,1
TRAV10,TRAJ40,CVVSLSRGTYKYIF,1,0,1,1
TRAV9-2,TRAJ54,CALSGSQGAQKLVF,1,0,1,1
TRAV9-2,TRAJ17,CALSERAAGNKLTF,1,0,1,1
TRAV16,TRAJ40,CALPSTSGTYKYIF,1,0,1,1
TRAV41,TRAJ22,CAVDFSGSARQLTF,1,0,1,1
TRAV22,TRAJ40,CAVRTTSGTYKYIF,1,0,1,1
TRAV36DV7,TRAJ49,CAVGPGNTGNQFYF,1,0,1,1
TRAV8-3,TRAJ56,CAVGADGANSKLTF,1,0,1,1
TRAV36DV7,TRAJ27,CAVEANTNAGKSTS,1,0,1,1
TRAV2,TRAJ21,CAVEDRDNFNKFYF,1,0,1,1
TRAV12-2,TRAJ11,CAVRPGSGYSTLTL,1,0,1,1
TRAV3,TRAJ27,CAVRDATNAGKSTF,1,0,1,1
TRAV3,TRAJ23,CAVREDNQGGKLIF,1,0,1,1
TRAV12-2,TRAJ12,CAVGGMDSSYKLIF,1,0,1,1
TRAV13-1,TRAJ42,CAATSGGSQGNLIF,1,0,1,1
TRAV29DV5,TRAJ13,CAATLSGGYQKVTF,1,0,1,1
TRAV13-1,TRAJ13,CAASISGGYQKVTF,1,0,1,1
TRAV13-1,TRAJ16,CAASKFSDGQKLLF,1,0,1,1
TRAV29DV5,TRAJ53,CAAREGGSNYKLTF,1,0,1,1
TRAV25,TRAJ13,CAGGFAGGYQKVTF,1,1,2,2
TRAV5,TRAJ45,CADKGGGGADGLTF,1,0,1,1
TRAV5,TRAJ18,CAESRGSTLGRLYF,1,0,1,1
TRAV13-2,TRAJ12,CAENPMDSSYKLIF,1,0,1,1
TRAV12-3,TRAJ10,CAMITAGGGNKPTF,1,0,1,1
TRAV30,TRAJ20,CGTEFFSNDYKLSF,1,0,1,1
TRAV12-1,TRAJ11,CVVISSGYSTLTF,1,0,1,1
TRAV10,TRAJ9,CVVSETGGFKTIF,1,0,1,1
TRAV12-1,TRAJ29,CVASNSGNTPLVY,1,0,1,1
TRAV41,TRAJ42,CAFKRGSQGNLIF,1,0,1,1
TRAV38-2DV8,TRAJ50,CAYRKTSYDKVIF,1,0,1,1
TRAV19,TRAJ21,CALAPYNFNKFYF,1,0,1,1
TRAV19,TRAJ43,CALSEVNNNDMRF,1,0,1,1
TRAV6,TRAJ5,CALDPPGRRALTF,1,0,1,1
TRAV36DV7,TRAJ32,CAVRIGATNKLIF,1,0,1,1
TRAV8-3,TRAJ45,CAVPGGGADGLTF,1,0,1,1
TRAV17,TRAJ13,CAARSGGYQKVTF,1,0,1,1
TRAV20,TRAJ15,CAAPNQAGTALIF,2,1,2,3
TRAV8-3,TRAJ37,CAATSSNTGKLIL,1,0,1,1
TRAV35,TRAJ40,CAGPGSGAYKYIF,1,0,1,1
TRAV35,TRAJ40,CAGFLRGTYKYIF,1,0,1,1
TRAV17,TRAJ23,CATGYNQGGKLIF,1,0,1,1
TRAV17,TRAJ5,CATDNTGRRALTF,1,0,1,1
TRAV12-2,TRAJ17,CAVRKAAGNKLTF,1,0,1,1
TRAV12-2,TRAJ47,CAVKVGYGNKLVF,1,0,1,1
TRAV12-2,TRAJ53,CAAGGGSNYKLTF,1,0,1,1
TRAV5,TRAJ42,CAPSGGSQGNLIF,1,0,1,1
TRAV13-1,TRAJ12,CAASWQSSYKLIF,1,0,1,1
TRAV25,TRAJ34,CAGGDYNTDKLIF,1,0,1,1
TRAV25,TRAJ37,CADPSSNTGKLIF,1,0,1,1
TRAV5,TRAJ20,CAEVPSNDYKLSF,1,0,1,1
TRAV5,TRAJ13,CAEVTGGYQKVTF,1,0,1,1
TRAV12-3,TRAJ9,CAMSETGGFKTIF,1,0,1,1
TRAV17,TRAJ5,GAPMDTGRRALTF,1,0,1,1
TRAV23DV6,TRAJ9,CALLGGGFKTIF,1,0,1,1
TRAV16,TRAJ23,CALGNQGGKLIF,1,0,1,1
TRAV20,TRAJ34,CAVQDGDDKLIF,1,0,1,1
TRAV8-3,TRAJ49,CAVGARGNQFYF,1,0,1,1
TRAV8-6,TRAJ34,CAVTGNTDKLIF,1,0,1,1
TRAV17,TRAJ20,CATDEGDYKLSF,1,0,1,1
TRAV24,TRAJ20,CASSSNDYKLSF,1,0,1,1
TRAV36DV7,TRAJ53,CAPGGSNYKLTF,2,0,1,2
TRAV12-2,TRAJ22,CAVGGSARQLTF,1,0,1,1
TRAV13-1,TRAJ8,CAVSEGFQKLVF,1,0,1,1
TRAV29DV5,TRAJ40,CAAMGKTYKYIF,2,0,1,2
TRAV13-1,TRAJ11,CAASNGYSTLSF,1,0,1,1
TRAV13-1,TRAJ21,CAASNNFNKFYF,1,0,1,1
TRAV29DV5,TRAJ49,CAASAGDGQFYF,1,0,1,1
TRAV27,TRAJ26,CAGETDGQNFVF,1,0,1,1
TRAV26-2,TRAJ26,CILARMGQNFVF,1,0,1,1
TRAV26-2,TRAJ42,CILRGSQGNLIF,2,0,1,2
TRAV12-1,TRAJ52,CVVKNRQWVTF,1,1,2,2
TRAV9-2,TRAJ49,CAPNTSNQFYF,1,0,1,1
TRAV17,TRAJ29,CAPGGNTPLVF,1,0,1,1
TRAV41,TRAJ29,CAVRGNTPLVF,1,0,1,1
TRAV12-2,TRAJ49,CAVNWSNQFYF,1,0,1,1
TRAV13-2,TRAJ34,CAERGTDKLIF,1,0,1,1
TRAV13-1,TRAJ20,CAAGNDYKLSF,1,0,1,1
TRAV2,TRAJ31,CAVGNARLMF,1,0,1,1
TRAV8-3,TRAJ31,CAVGPARLMF,1,0,1,1
TRAV2,TRAJ44,CAVGANTGTASKLTF,1,0,1,1
TRAV14DV4,TRAJ50,CAMRGSRETSYDKVVF,2,0,1,2
TRAV20,TRAJ28,CATGRAGAGSYQLTF,1,0,1,1
TRAV9-2,TRAJ16,CALSEGSDGQKLLF,1,0,1,1
TRAV12-1,TRAJ45,CVVKGAESGGGADGLTF,1,0,1,1
TRAV20,TRAJ53,CAVQAGSSGGSNYKLTF,1,0,1,1
TRAV21,TRAJ22,CAVRPLQSSGSARQLTF,1,0,1,1
TRAV35,TRAJ52,CAAAGPPGGTSYGKLTF,1,0,1,1
TRAV9-2,TRAJ40,CALTPPRRPGTYKYIF,1,0,1,1
TRAV9-2,TRAJ50,CALSARVKTSYDKVIF,1,0,1,1
TRAV9-2,TRAJ10,CALSGVLTGGGNKLTS,1,0,1,1
TRAV29DV5,TRAJ53,CALSEGSGGSNYKLTF,1,0,1,1
TRAV16,TRAJ52,CALSGDGGTSYGKLTF,1,0,1,1
TRAV8-3,TRAJ28,CAVGAYSGAGSYQLTF,1,1,2,2
TRAV20,TRAJ44,CAVGVMDTGTASKLTF,1,0,1,1
TRAV8-3,TRAJ10,CAVGGPREGGGNKLTF,1,0,1,1
TRAV17,TRAJ26,CATFVSWDNYGQNFVF,1,0,1,1
TRAV12-2,TRAJ3,CAVNPRTGSSASKIIF,1,1,2,2
TRAV12-2,TRAJ52,CAVKGTGGTSYGKLTF,1,0,1,1
TRAV29DV5,TRAJ40,CAASGGDTTGAYKYIF,1,0,1,1
TRAV29DV5,TRAJ52,CAASALSGTSYGKLTF,1,0,1,1
TRAV29DV5,TRAJ53,CAASGNSGGSNYKLTF,1,0,1,1
TRAV4,TRAJ32,CLVGERKGGATNKLIF,1,0,1,1
TRAV26-2,TRAJ30,CILRGGIMNRDDKIIF,1,0,1,1
TRAV9-2,TRAJ47,CSTESPMEYGNKLVF,1,0,1,1
TRAV10,TRAJ12,CVVSDDEDSSYKLIF,1,0,1,1
TRAV19,TRAJ34,CALSEAAYNTDKLIF,1,0,1,1
TRAV16,TRAJ13,CALSLYSGGYQKVTF,1,0,1,1
TRAV8-3,TRAJ9,CAVAPPGAGGFKTIF,1,0,1,1
TRAV21,TRAJ53,CAVEGSGGSNYKLTF,1,0,1,1
TRAV8-4,TRAJ45,CAVSGGREGADGLTF,1,0,1,1
TRAV21,TRAJ49,CAVRELSNTGNQFYF,1,0,1,1
TRAV3,TRAJ36,CAVRAVQTGANNLFF,1,0,1,1
TRAV3,TRAJ35,CAVRDLRSFGNVLHC,2,0,1,2
TRAV3,TRAJ9,CAVRDIGAGGFKTIF,1,0,1,1
TRAV3,TRAJ9,CAVREGSTGGFKTIF,1,0,1,1
TRAV35,TRAJ52,CAGRLSGTSYGKLTF,1,0,1,1
TRAV24,TRAJ44,CARCRNTGTASKLTF,1,0,1,1
TRAV8-1,TRAJ44,CAVGPSTGTASKLTF,1,0,1,1
TRAV12-2,TRAJ42,CAVTNYGGSQGNLIF,1,0,1,1
TRAV23DV6,TRAJ6,CAARFPAGGSYIPTF,1,0,1,1
TRAV13-1,TRAJ52,CAARTGGTSYGKLTF,2,0,1,2
TRAV12-3,TRAJ33,CAMEESADSNYQLIW,1,0,1,1
TRAV14DV4,TRAJ17,CAMTVDKAAGNKLTF,1,0,1,1
TRAV12-3,TRAJ57,CAMRETQGGSEKLVF,1,1,2,2
TRAV34,TRAJ29,CGADKRNSGNTPLVF,1,0,1,1
TRAV26-1,TRAJ36,CIVPSTQTGANNLFF,1,0,1,1
TRAV10,TRAJ17,CVVSVKAAGNKLTF,1,0,1,1
TRAV12-1,TRAJ3,CVVNLYSSASKIIF,1,0,1,1
TRAV38-1,TRAJ54,CAFMSFQGAQKLVF,1,0,1,1
TRAV38-2DV8,TRAJ49,CAYRSPLTGNQFYF,1,0,1,1
TRAV38-2DV8,TRAJ22,CAYRSMGSARQLTF,1,1,2,2
TRAV38-2DV8,TRAJ29,CAYRRIGLGTPLVF,1,0,1,1
TRAV9-2,TRAJ37,CALSLASNTGKLIF,1,0,1,1
TRAV16,TRAJ42,CALSGRGSQGNLIF,1,0,1,1
TRAV2,TRAJ37,CAVTISSNTGKLIF,1,0,1,1
TRAV8-3,TRAJ3,CAVALYSSASKIIF,1,0,1,1
TRAV8-3,TRAJ17,CAVGAGAAGNKLTF,1,0,1,1
TRAV21,TRAJ38,CAVGYAGNNRKLIW,1,0,1,1
TRAV22,TRAJ7,CAVGRAYGNNRLAF,1,0,1,1
TRAV2,TRAJ13,CAVEPPVGYQKVTF,1,0,1,1
TRAV21,TRAJ56,CAVRRTGANSKLTF,1,0,1,1
TRAV21,TRAJ12,CAVKDEDSSYKLIF,1,0,1,1
TRAV21,TRAJ26,CAAPRDNYGQNFVF,2,0,1,2
TRAV29DV5,TRAJ52,CATAGGTSYGKLTF,1,0,1,1
TRAV17,TRAJ17,CATDAWAAGNKLTF,1,1,2,2
TRAV17,TRAJ26,CATDAWNYGQNFVF,1,0,1,1
TRAV24,TRAJ22,CAFAIRGSARQLTF,1,0,1,1
TRAV12-2,TRAJ42,CAVISVGSQGNLIF,1,0,1,1
TRAV8-1,TRAJ48,CAVNANFGNEKLTF,1,0,1,1
TRAV8-1,TRAJ42,CAVNEKGSQGNLIF,1,0,1,1
TRAV12-2,TRAJ39,CAVNPANAGNMLTF,1,0,1,1
TRAV13-1,TRAJ22,CAALRGGSARQLTF,1,0,1,1
TRAV13-1,TRAJ47,CAARRGLYGNKLVF,1,0,1,1
TRAV29DV5,TRAJ28,CAATSGAGSYQLTF,1,0,1,1
TRAV13-1,TRAJ20,CAATDSSNDYKLSF,1,0,1,1
TRAV23DV6,TRAJ40,CAATTLSGTYKYIF,1,0,1,1
TRAV13-1,TRAJ37,CAASSSGNTGKLIF,1,0,1,1
TRAV23DV6,TRAJ44,CAASEAGTASKLTF,1,0,1,1
TRAV12-3,TRAJ54,CAMRLIQGAQKLVF,1,0,1,1
TRAV14DV4,TRAJ26,CAMRERNYGQNFVF,1,0,1,1
TRAV12-3,TRAJ10,CAMRITGGGNKLTF,1,0,1,1
TRAV12-3,TRAJ42,CATQTWGSQGNLIF,1,0,1,1
TRAV4,TRAJ8,CLVGEGTGFQKLVF,1,0,1,1
TRAV4,TRAJ9,CLVGINTGGFKTIF,1,0,1,1
TRAV30,TRAJ40,CGTERIRGTYKYIF,1,0,1,1
TRAV26-2,TRAJ27,CILRDWANAGKSTF,1,0,1,1
TRAV12-1,TRAJ40,CVVRGRGTYKYIF,1,0,1,1
TRAV10,TRAJ40,CVVRSSGTYKYIF,1,0,1,1
TRAV9-2,TRAJ22,CALLSGSARQLTF,1,0,1,1
TRAV9-2,TRAJ5,CALEDTGRRALTF,1,0,1,1
TRAV9-2,TRAJ5,CALIDTGRRALTF,1,0,1,1
TRAV9-2,TRAJ22,CALSNGSARQLTF,1,0,1,1
TRAV16,TRAJ27,CALQGTNAGKSTF,1,0,1,1
TRAV21,TRAJ56,CAVVTGANSKLTF,1,0,1,1
TRAV41,TRAJ45,CAVGFGGADGLTF,1,0,1,1
TRAV36DV7,TRAJ27,CAVPNTNAGKSTF,1,1,2,2
TRAV36DV7,TRAJ21,CAVRGYNFNKFYF,1,0,1,1
TRAV20,TRAJ13,CAVQEGGYQKVTF,1,0,1,1
TRAV36DV7,TRAJ43,CAVDLYDNNDMRF,1,0,1,1
TRAV36DV7,TRAJ37,CAVSSGNTGKLIF,1,0,1,1
TRAV36DV7,TRAJ41,CAVKGNSGYALNF,1,0,1,1
TRAV35,TRAJ40,CAGQEGGTYKYIF,1,0,1,1
TRAV17,TRAJ56,CATGTGANSKLTF,1,0,1,1
TRAV17,TRAJ57,CATDQGGSEKLVF,1,1,2,2
TRAV17,TRAJ32,CATDAGGWNKLIF,1,0,1,1
TRAV17,TRAJ8,CATDDTGFQKLVF,1,0,1,1
TRAV12-2,TRAJ20,CAVRFSNDYKISF,1,0,1,1
TRAV12-2,TRAJ11,CAVRDSGYSTLTF,1,0,1,1
TRAV8-1,TRAJ5,CAVNRVGRRALTF,1,0,1,1
TRAV12-2,TRAJ3,CAVKGSSASKIIF,1,0,1,1
TRAV5,TRAJ13,CAAFSGGYQKVTF,1,0,1,1
TRAV23DV6,TRAJ44,CAAPLGTASKLTF,1,0,1,1
TRAV29DV5,TRAJ56,CAAGTGANSKLTF,1,0,1,1
TRAV13-1,TRAJ39,CAASGGAGNMLTF,1,0,1,1
TRAV23DV6,TRAJ33,CAAAMDSNYQLIW,1,0,1,1
TRAV13-1,TRAJ44,CAATTGTASKLTF,1,0,1,1
TRAV13-1,TRAJ13,CAASMGGYQKVTF,1,2,2,3
TRAV13-1,TRAJ11,CAASLSGYSTLTF,1,0,1,1
TRAV13-1,TRAJ35,CAAKGGFGNVLHC,1,0,1,1
TRAV27,TRAJ44,CAGAPGTASKLTF,1,0,1,1
TRAV13-2,TRAJ9,CAEILTGGFKTIF,1,0,1,1
TRAV14DV4,TRAJ22,CAMIPPLARQLTF,1,0,1,1
TRAV12-3,TRAJ7,CAMSPYGNNRLAF,1,0,1,1
TRAV12-3,TRAJ57,CAMSAGGSEKLVF,1,0,1,1
TRAV12-3,TRAJ10,CAMSAGGGNKLTF,1,0,1,1
TRAV12-3,TRAJ35,CAMSGSFGNVLHC,1,0,1,1
TRAV30,TRAJ17,CGTEKAAGNKLTF,1,0,1,1
TRAV26-1,TRAJ53,CISRGGSNYKLTF,1,0,1,1
TRAV26-1,TRAJ42,CIVRGGSQGNLIF,2,0,1,2
TRAV12-1,TRAJ9,CVVNNRGFKTIF,1,0,1,1
TRAV34,TRAJ20,CVVNPSDYKLSF,1,0,1,1
TRAV9-2,TRAJ15,CALREAGTALIF,1,0,1,1
TRAV36DV7,TRAJ33,CAVPDSNYQLIW,1,0,1,1
TRAV36DV7,TRAJ20,CAVEEADYKLSF,1,0,1,1
TRAV36DV7,TRAJ54,CAVEKGAQKLVF,1,0,1,1
TRAV8-3,TRAJ44,CATTGTASKLTF,1,0,1,1
TRAV20,TRAJ15,CATNQAGTALVF,1,0,1,1
TRAV17,TRAJ28,CATLGGSYQLTF,1,0,1,1
TRAV12-2,TRAJ16,CAVNSDGQKLLF,1,0,1,1
TRAV13-1,TRAJ30,CAASYQDDKIIF,1,0,1,1
TRAV25,TRAJ6,CAGAGGSYIPTF,1,0,1,1
TRAV25,TRAJ56,CAGAGANSKLTF,1,0,1,1
TRAV25,TRAJ56,CAGEGANSKLTF,1,0,1,1
TRAV14DV4,TRAJ20,CAMKPNDYKLSF,1,0,1,1
TRAV12-1,TRAJ33,SRRDSNYQLIW,1,0,1,1
TRAV38-2DV8,TRAJ30,CALNRDDKIIF,1,0,1,1
TRAV21,TRAJ26,CAPLYGQNFVF,1,1,2,2
TRAV2,TRAJ20,CAVFNDYKLSF,1,0,1,1
TRAV21,TRAJ34,CAVSNTDKLIF,1,0,1,1
TRAV8-3,TRAJ9,CAVGGGFKTIF,1,3,2,4
TRAV35,TRAJ32,CAGRVTNRLIF,1,0,1,1
TRAV39,TRAJ31,CAVAKNARLMF,1,0,1,1
TRAV13-1,TRAJ33,CAASSNYQLIW,1,0,1,1
TRAV25,TRAJ8,CAGSRFQKLVF,2,0,1,2
TRAV26-2,TRAJ39,CPQQAGNMLTF,1,0,1,1
TRAV5,TRAJ34,CAEADKLIF,1,0,1,1
TRAV12-2,TRAJ31,SSGARLMF,1,0,1,1
TRAV12-2,TRAJ4,CAVKKAGGYNKLIF,2,0,1,2
TRAV13-1,TRAJ9,CAASETGGFKTIF,1,0,1,1
TRAV12-1,TRAJ3,CVVMDSSASKIIF,1,0,1,1
TRAV36DV7,TRAJ52,CAVRLSANAGGTSYGKLTF,1,0,1,1
TRAV29DV5,TRAJ45,CAAIPGQRRRGGGADGLTF,1,0,1,1
TRAV12-1,TRAJ45,CVVNPPHPSGGGADGLTF,1,0,1,1
TRAV9-2,TRAJ52,CALSDQYAGGTSYGKLTF,1,0,1,1
TRAV26-2,TRAJ52,CILNHEVAGGTSYGKLTF,1,0,1,1
TRAV12-1,TRAJ42,CVVNRGFYGGSQGNLIF,1,0,1,1
TRAV38-2DV8,TRAJ32,CAYRSGGGGGATNKLIF,1,0,1,1
TRAV9-2,TRAJ52,CALLANAGGTSYGKLTF,1,0,1,1
TRAV9-2,TRAJ42,CALRSWDYGGSQGDLIF,1,0,1,1
TRAV21,TRAJ58,CAVIGGREETSGSRLTF,1,2,2,3
TRAV29DV5,TRAJ22,CAASGAFSSGSARQLTF,1,0,1,1
TRAV14DV4,TRAJ17,CAMREGPVKAAGNKLTF,1,0,1,1
TRAV10,TRAJ32,CVVSENRDGATNKLIF,1,0,1,1
TRAV38-2DV8,TRAJ45,CAYTQYSGGGADGLTF,1,0,1,1
TRAV9-2,TRAJ32,CALSDQGGGATNKLIF,1,0,1,1
TRAV19,TRAJ40,CALRGSGGSGTYKYIF,1,0,1,1
TRAV38-2DV8,TRAJ39,CAHRPGINNAGNMLTF,1,0,1,1
TRAV20,TRAJ13,CAVQAPRSGGYQKVTF,1,0,1,1
TRAV20,TRAJ46,CAVQAEKKSSGDKLTF,1,0,1,1
TRAV20,TRAJ28,CAVQAYSGAGSYQLTF,1,0,1,1
TRAV3,TRAJ3,CAVSPSPYSSASKIIF,1,0,1,1
TRAV21,TRAJ28,CAVRLYSGAGSYQLTF,1,1,2,2
TRAV21,TRAJ21,CAVRPPRESSFNKFYF,1,0,1,1
TRAV3,TRAJ6,CAVRRLSSGGSYIPTF,1,0,1,1
TRAV3,TRAJ4,CAVRDPISGGYNKLIF,1,0,1,1
TRAV35,TRAJ28,CAGSAYSGAGSYKLTF,1,0,1,1
TRAV12-2,TRAJ5,CAVMPRGDTGRRALTF,1,0,1,1
TRAV12-2,TRAJ42,CAVRRQSGGSQGNLIF,1,0,1,1
TRAV23DV6,TRAJ58,CAASIAGETSGSRLTF,1,0,1,1
TRAV14DV4,TRAJ45,CAMRLYSGGGADGLTF,1,0,1,1
TRAV4,TRAJ18,CLVGDNGGSTLGRLYF,1,0,1,1
TRAV4,TRAJ29,CLVGDTLYSGNTPLVF,1,0,1,1
TRAV26-2,TRAJ52,CILANAGGTSYGKLTF,1,0,1,1
TRAV8-3,TRAJ45,SHLASSGGGADGLTF,1,0,1,1
TRAV38-2DV8,TRAJ39,CVHGGVGNAGNMLTF,1,0,1,1
TRAV12-1,TRAJ12,CVVNGDTNSSYKLIF,1,0,1,1
TRAV12-1,TRAJ13,CVVNRHSGGHQKVTF,1,0,1,1
TRAV12-1,TRAJ37,CVVKPPPGNTGKLIF,1,0,1,1
TRAV16,TRAJ27,CALPLTHTNAGKSTF,1,0,1,1
TRAV9-2,TRAJ47,CALTRGREYGNKLVF,1,3,2,4
TRAV9-2,TRAJ12,CALSDRGDSSYKLIF,1,0,1,1
TRAV9-2,TRAJ8,CALSDRDTGFQKLVF,1,0,1,1
TRAV19,TRAJ38,CALSRQAGNNRKLIW,1,0,1,1
TRAV19,TRAJ3,CALRDLYSSASKIIF,1,0,1,1
TRAV19,TRAJ47,CALKRSREYGNKLVF,1,1,2,2
TRAV2,TRAJ3,CAVSSGYSSASKIIF,1,0,1,1
TRAV23DV6,TRAJ20,CAVPGMRANDYKLSF,1,0,1,1
TRAV20,TRAJ16,CAVQPNLGNGQKLLF,1,0,1,1
TRAV8-3,TRAJ36,CAVGARRTGANNLFF,1,0,1,1
TRAV2,TRAJ30,CAVEDGMNRDDKIIF,1,0,1,1
TRAV22,TRAJ48,CAVEGRGFGNEKLTF,1,0,1,1
TRAV12-2,TRAJ44,CAVIRWTGTASKLTF,1,0,1,1
TRAV21,TRAJ38,CAVRRRAGNNCKLIW,1,0,1,1
TRAV41,TRAJ42,CAANPLRGSQGNLIF,1,0,1,1
TRAV17,TRAJ6,CATVKGSGGSYIPTF,1,0,1,1
TRAV8-3,TRAJ45,CARTNSGGGADGLTF,1,0,1,1
TRAV38-2DV8,TRAJ45,CAVLITGGGADGLTF,1,4,2,5
TRAV12-2,TRAJ22,CAVSARSGSARQLTF,1,0,1,1
TRAV12-2,TRAJ13,CAVILGSGGYQKVTY,1,0,1,1
TRAV20,TRAJ13,CAIHPYSGGYQKVTF,1,0,1,1
TRAV29DV5,TRAJ42,CAATELGGSQGNLIF,1,0,1,1
TRAV29DV5,TRAJ40,CAASEWFSGTYKYIF,1,0,1,1
TRAV29DV5,TRAJ21,CAASETGNNFNKFYF,1,0,1,1
TRAV23DV6,TRAJ22,CAASTPSGSARQLTF,1,0,1,1
TRAV23DV6,TRAJ44,CAASKNTGTASKLTF,1,0,1,1
TRAV12-3,TRAJ7,CAMSLEPYGNNRLAF,1,0,1,1
TRAV12-3,TRAJ6,CAMSPAAGGSYIPTF,1,0,1,1
TRAV12-3,TRAJ5,CAMSARGTGRRALTF,1,0,1,1
TRAV12-3,TRAJ10,CAMSESTGGGNKLTF,1,0,1,1
TRAV30,TRAJ31,CGTEKGPGNNARLMF,1,0,1,1
TRAV4,TRAJ37,CLVGGGSGNTGKLIF,1,0,1,1
TRAV4,TRAJ32,CLVGNPSGATNKLIF,1,0,1,1
TRAV26-2,TRAJ42,CILRDPGGSQGNLIF,1,0,1,1
TRAV26-1,TRAJ20,CIVRAVSSNDYKLSF,1,0,1,1
TRAV12-1,TRAJ42,CVLNYGGSQGNLIS,1,0,1,1
TRAV12-1,TRAJ16,CVVIVFSDGQKLLF,1,0,1,1
TRAV12-1,TRAJ40,CVVITTSGTYKYIF,1,0,1,1
TRAV12-1,TRAJ17,CVVNRKAAGNKLTF,1,0,1,1
TRAV38-1,TRAJ40,CAFMKHSGTYKYIF,1,0,1,1
TRAV12-2,TRAJ3,CALPEGSSASKIIF,1,0,1,1
TRAV19,TRAJ27,CALSPPLHAGKSTF,1,0,1,1
TRAV19,TRAJ6,CALSEAGGSYIPTF,1,0,1,1
TRAV2,TRAJ36,CAVLDQTGANNLFF,1,0,1,1
TRAV22,TRAJ29,CAVPWNSGNTPLVF,1,0,1,1
TRAV22,TRAJ56,CAVDDTGANSKLTF,1,0,1,1
TRAV21,TRAJ24,CAVSGTDSWGKFQF,1,0,1,1
TRAV20,TRAJ15,CAVLINQAGTALIF,1,0,1,1
TRAV20,TRAJ10,CAVPVTGGGNKLTF,1,0,1,1
TRAV20,TRAJ36,CAVQSQTGANNLFF,1,0,1,1
TRAV8-3,TRAJ9,CAVVPNTGGFKTIF,1,0,1,1
TRAV8-3,TRAJ31,CAVGGLNNNARLMS,1,0,1,1
TRAV8-3,TRAJ27,CAVGDNTNAGKSTF,1,0,1,1
TRAV36DV7,TRAJ37,CAVEAASNTGKLIF,1,0,1,1
TRAV3,TRAJ37,CAVSRPSNTGKLIF,1,0,1,1
TRAV3,TRAJ30,CAVRAPGGDDKIIF,1,0,1,1
TRAV35,TRAJ45,CAGRTGGGADGLTF,1,0,1,1
TRAV35,TRAJ42,CAGQKGGSQGNLIF,1,0,1,1
TRAV35,TRAJ44,CAGGNTGTASKLTF,1,0,1,1
TRAV17,TRAJ15,CATDVYPAGTALIF,1,0,1,1
TRAV9-2,TRAJ52,CARAGGTSYGKLTF,1,0,1,1
TRAV20,TRAJ52,CAFAGGTSYGKLTF,1,0,1,1
TRAV24,TRAJ42,CAFINGGSQGNLIF,1,0,1,1
TRAV39,TRAJ33,CAVDGMDSNYQLIW,1,0,1,1
TRAV8-1,TRAJ32,CAVNGGGATNKLIF,1,0,1,1
TRAV12-2,TRAJ47,CAVNAVEYGNKLVF,1,0,1,1
TRAV13-1,TRAJ42,CAASYGGSQGNLIF,1,1,2,2
TRAV12-2,TRAJ27,CAAPPHTNAGKSTF,1,0,1,1
TRAV12-2,TRAJ13,CAADITGGYQKVTF,1,0,1,1
TRAV29DV5,TRAJ58,CARSFETSGSRLTF,1,0,1,1
TRAV12-2,TRAJ44,CAVTNTGTASKLTF,1,0,1,1
TRAV13-2,TRAJ52,CAATGGTSYGKLTF,1,0,1,1
TRAV23DV6,TRAJ4,CAAAASGGYNKLIF,1,0,1,1
TRAV13-1,TRAJ16,CAATSFSDGQKLLF,1,0,1,1
TRAV13-1,TRAJ11,CAASANSGYSTLTF,1,0,1,1
TRAV13-1,TRAJ17,CAASMEAAGNKLTF,1,0,1,1
TRAV13-1,TRAJ48,CAASKNFGNEKLTF,1,0,1,1
TRAV13-1,TRAJ47,CAASKGEYGNKLVY,1,0,1,1
TRAV29DV5,TRAJ40,CAASPPSGTYKYIF,2,0,1,2
TRAV13-1,TRAJ29,CAASPNSGNTPLVF,1,0,1,1
TRAV29DV5,TRAJ22,CAASHSGSARQLTF,1,0,1,1
TRAV29DV5,TRAJ56,CAASETGANSKLTF,1,0,1,1
TRAV29DV5,TRAJ58,CAASEETSGSRLTF,1,0,1,1
TRAV13-1,TRAJ35,CAANLIGFGNVLHC,1,0,1,1
TRAV25,TRAJ43,CAGPKSYNNNDMRF,1,0,1,1
TRAV27,TRAJ17,CAGWDKAAGNKLTF,1,0,1,1
TRAV27,TRAJ53,CAGHPGGSNYKLTF,1,0,1,1
TRAV5,TRAJ33,CAERGPDSNYQLIW,1,0,1,1
TRAV13-2,TRAJ57,CAENRQGGSEKLVF,1,0,1,1
TRAV12-3,TRAJ40,CAMSVTSGTYKYIF,1,0,1,1
TRAV12-3,TRAJ4,CAMSASGGYNKLIF,1,0,1,1
TRAV12-3,TRAJ56,CAMSEGGANSKLTF,1,0,1,1
TRAV12-3,TRAJ24,CAMKSPDSWGKFQF,1,0,1,1
TRAV4,TRAJ45,CLVGSGGGADGLTF,1,0,1,1
TRAV4,TRAJ5,RLVANDTGRRALTF,1,0,1,1
TRAV12-1,TRAJ8,CVVEGTGFQKLVF,1,0,1,1
TRAV12-1,TRAJ49,CVVISPTGNQFYF,1,0,1,1
TRAV10,TRAJ4,CVVSPGGYNKLIF,1,0,1,1
TRAV38-2DV8,TRAJ36,CAYHLGRANNLFF,1,0,1,1
TRAV38-2DV8,TRAJ44,CAYGPGTASKLTF,1,0,1,1
TRAV9-2,TRAJ23,CALSLRQGGQLIF,1,0,1,1
TRAV9-2,TRAJ27,CALSDTNAGKSTF,1,0,1,1
TRAV9-2,TRAJ17,CALSRAAGNKLTF,1,0,1,1
TRAV9-2,TRAJ57,CALNQGGSEKLVF,1,0,1,1
TRAV6,TRAJ12,CALVKDSSYKLIF,1,0,1,1
TRAV16,TRAJ29,CALIGTGNTPLVF,1,0,1,1
TRAV41,TRAJ33,CAVRFISNYQLIW,1,0,1,1
TRAV41,TRAJ17,CAVKRAAGNKLTF,1,0,1,1
TRAV20,TRAJ49,CAVQGPTGNQFYF,1,0,1,1
TRAV22,TRAJ28,CAVVVAGSYQLTF,1,0,1,1
TRAV8-3,TRAJ40,CAVGLSGTYKYIF,1,0,1,1
TRAV8-3,TRAJ49,CAVGRITGNQFYF,1,0,1,1
TRAV8-6,TRAJ7,CAVGAYGNNRLAF,1,0,1,1
TRAV8-3,TRAJ49,CAVGTNTGNQFYF,1,0,1,1
TRAV8-4,TRAJ9,CAVTYTGGFKTIF,1,0,1,1
TRAV21,TRAJ49,CAVRPNTGNQFYF,1,0,1,1
TRAV21,TRAJ20,CAVRPINDYKLSF,1,0,1,1
TRAV36DV7,TRAJ27,CAVFNTNAGKSTF,1,0,1,1
TRAV35,TRAJ6,CAGRQGGSYIPTF,1,0,1,1
TRAV17,TRAJ53,CATERGSNYKLTF,1,0,1,1
TRAV24,TRAJ47,CAFPQEYGNKLVF,1,0,1,1
TRAV39,TRAJ49,CAVSYTTGNQFYF,1,0,1,1
TRAV39,TRAJ30,CAVGLGRDDKIIF,1,0,1,1
TRAV12-2,TRAJ26,CAVRRGYGQNFVF,1,0,1,1
TRAV12-2,TRAJ9,CAVNGAGGFKTIF,1,0,1,1
TRAV12-2,TRAJ28,CAVKGAGSYQLTF,1,0,1,1
TRAV12-2,TRAJ48,CAGGDFGNEKLTF,1,0,1,1
TRAV27,TRAJ15,CAARNQAGTALIF,1,1,2,2
TRAV13-1,TRAJ53,CAASAGSNYKLTL,1,0,1,1
TRAV13-1,TRAJ43,CAASIRGNNDMRF,1,0,1,1
TRAV29DV5,TRAJ39,CAASEDAGNMLTF,1,0,1,1
TRAV29DV5,TRAJ6,CAASIGGSYIPTF,1,0,1,1
TRAV13-1,TRAJ11,CAGIISGYSTLTF,1,0,1,1
TRAV25,TRAJ27,CAGGNTNAGKSTF,1,0,1,1
TRAV13-2,TRAJ38,CAENAGNNRKLIW,1,0,1,1
TRAV13-2,TRAJ32,CAEKHGATNKLIF,1,0,1,1
TRAV12-3,TRAJ56,CAMYTGANSKLTF,1,1,2,2
TRAV12-3,TRAJ39,CAMGNNAGNMLTF,1,0,1,1
TRAV12-3,TRAJ41,CAMSSNSGYALNF,1,0,1,1
TRAV12-3,TRAJ28,CAMSRAGSYQLSF,1,0,1,1
TRAV12-3,TRAJ29,CAMSASGNTPLVF,1,0,1,1
TRAV12-3,TRAJ7,CAMSAGGNNRLAF,1,0,1,1
TRAV30,TRAJ18,CGTRGSTLGRLYF,1,0,1,1
TRAV12-1,TRAJ20,LDGGEDDYKLSF,1,0,1,1
TRAV12-1,TRAJ6,CVVMGGSYIPTF,1,0,1,1
TRAV12-1,TRAJ20,CVVKRDDYKLSF,1,0,1,1
TRAV12-1,TRAJ23,CVGPWQGGKLIF,1,0,1,1
TRAV3,TRAJ40,CALPSGTYKYIF,1,0,1,1
TRAV9-2,TRAJ37,CALTSNTGKLIF,1,0,1,1
TRAV9-2,TRAJ3,CALYSSASKIIF,2,0,1,2
TRAV6,TRAJ5,CALDTGRRALTF,2,1,2,3
TRAV9-1,TRAJ5,CALTQGRRALTF,1,0,1,1
TRAV16,TRAJ45,CALGGGADGLTF,1,0,1,1
TRAV6,TRAJ20,CALGGEDYKLSF,1,2,2,3
TRAV38-2DV8,TRAJ48,CAPNFGNEKLTF,1,0,1,1
TRAV41,TRAJ30,CAPDRADDKIIF,1,0,1,1
TRAV20,TRAJ27,CAVQSNAGKSTF,1,0,1,1
TRAV20,TRAJ49,CAVGNTGNQFYF,1,0,1,1
TRAV29DV5,TRAJ48,CAANFGNEKLTF,1,2,2,3
TRAV12-3,TRAJ39,CAAVNAGNMLTF,1,0,1,1
TRAV2,TRAJ31,CAAGNNNARLMF,1,0,1,1
TRAV27,TRAJ31,CADRNNNARLMF,1,0,1,1
TRAV17,TRAJ40,CATQTGTYKYIF,1,0,1,1
TRAV17,TRAJ34,CATDWGTDKLIF,1,0,1,1
TRAV8-1,TRAJ13,CAVNLGYQKVTF,1,0,1,1
TRAV8-1,TRAJ47,CAVNEGGNKLVF,1,0,1,1
TRAV12-2,TRAJ13,CAVNARYQKVTF,1,0,1,1
TRAV23DV6,TRAJ15,CAAREAGTALIF,1,0,1,1
TRAV21,TRAJ40,CATNSGTYKYIF,1,0,1,1
TRAV29DV5,TRAJ57,CAVQGGSEKLVF,1,0,1,1
TRAV13-2,TRAJ57,CAAEGGSEKLVF,1,0,1,1
TRAV25,TRAJ21,CAGRYNFNKFYF,2,0,1,2
TRAV27,TRAJ36,CAGDSGANNLLF,1,0,1,1
TRAV12-3,TRAJ13,CAMSGGYQKVTF,1,0,1,1
TRAV12-1,TRAJ40,HVVHSGTYKYIF,1,0,1,1
TRAV27,TRAJ26,CVKENGQNFVF,1,0,1,1
TRAV9-2,TRAJ43,CALSDRGDMRF,1,0,1,1
TRAV16,TRAJ34,CAPPNTDKLIF,1,0,1,1
TRAV36DV7,TRAJ43,CAVYNNNDMRF,1,0,1,1
TRAV20,TRAJ36,CAVQVPNNLFF,1,0,1,1
TRAV8-3,TRAJ57,CAVGGSEKPVF,1,0,1,1
TRAV12-2,TRAJ31,CAVKGNARLMF,1,0,1,1
TRAV25,TRAJ43,CAGPRNNDMRF,1,0,1,1
TRAV21,TRAJ42,YEPGSQGNLIF,1,0,1,1
TRAV9-2,TRAJ24,CALSWGKFQF,1,0,1,1
TRAV21,TRAJ27,CAVTAGKSTF,1,0,1,1
TRAV12-2,TRAJ4,CAASYNKLIF,1,0,1,1
TRAV12-2,TRAJ49,CAVIEGQFYF,1,0,1,1
TRAV2,TRAJ31,CAVNNARLMF,2,0,1,2
TRAV12-2,TRAJ48,CAALVEKLTF,1,0,1,1
TRAV13-2,TRAJ47,CAESANKLVF,1,0,1,1
TRAV13-2,TRAJ31,CAEGRLMF,1,0,1,1
TRAV5,TRAJ6,CAENVGGGSYIPTF,2,0,1,2
TRAV8-1,TRAJ20,CSVKGDYKLSF,1,0,1,1
TRAV38-2DV8,TRAJ34,CAYRSIRDPRSYNTDKLIF,1,0,1,1
TRAV38-2DV8,TRAJ52,CAYRTVNAGGTSYGKLTF,1,0,1,1
TRAV17,TRAJ45,CATGEGRSPGGGADGLTF,1,0,1,1
TRAV13-2,TRAJ10,CAETQPLILTGGGNKLTF,1,1,2,2
TRAV4,TRAJ45,CLVGDPTYSGGGADGLTF,1,0,1,1
TRAV12-1,TRAJ8,CVVNGSPWDTGFQKLVF,1,0,1,1
TRAV9-2,TRAJ10,CALSDVGVTGGGNKLTF,1,0,1,1
TRAV20,TRAJ4,CAVQADYLSGGYNKLIF,1,0,1,1
TRAV21,TRAJ39,CAATPDRSYNAGNMLTF,1,0,1,1
TRAV38-2DV8,TRAJ52,CASSGNAGGTSYGKLTF,1,0,1,1
TRAV29DV5,TRAJ52,CAASARAGGTSYGKLTF,1,0,1,1
TRAV12-3,TRAJ4,CAMRATMFSGGYNKLIF,1,0,1,1
TRAV30,TRAJ52,CGTELGAGGTSYGKLTF,1,0,1,1
TRAV38-2DV8,TRAJ30,CAYRSSSMNRDDRIIF,1,0,1,1
TRAV9-2,TRAJ10,CALSDRLTGGGNKLTF,1,0,1,1
TRAV9-2,TRAJ39,CALSDQARDAGNMLTF,1,1,2,2
TRAV19,TRAJ17,CALSEAREAAGNKLTF,1,0,1,1
TRAV19,TRAJ8,CALSEEFGTGFQKLVF,1,0,1,1
TRAV16,TRAJ42,CALTQNYGGSQGNLIF,1,0,1,1
TRAV21,TRAJ41,CAVTSMNSNSGYALNF,1,0,1,1
TRAV12-2,TRAJ12,CAVVGAVMDSSYKLIF,1,1,2,2
TRAV41,TRAJ42,CAVSEGYGGSQGNLIF,1,0,1,1
TRAV8-3,TRAJ32,CAVVTTGGGATNKLIF,1,0,1,1
TRAV2,TRAJ52,CAVEGAGGTSYGKLTF,1,1,2,2
TRAV2,TRAJ10,CAVEDRITGGGNKLTF,1,0,1,1
TRAV8-6,TRAJ13,CAVSPPTGGGYQKVTF,1,0,1,1
TRAV8-6,TRAJ6,CAVSDLLNGGSYIPTF,1,0,1,1
TRAV8-4,TRAJ15,CAVSDPFNQAGTALIF,1,0,1,1
TRAV3,TRAJ15,CAVRDLSNQAGTALIF,1,0,1,1
TRAV17,TRAJ37,CATVPSGSGNTGKLIF,1,0,1,1
TRAV17,TRAJ49,CATAAYAWNTGNQFYF,1,0,1,1
TRAV39,TRAJ22,CAVDMYPSGSARQLTF,1,0,1,1
TRAV8-1,TRAJ28,CAVIHGSGAGSYQLTF,1,0,1,1
TRAV13-1,TRAJ52,CAASNRGGTSYGKLTF,1,0,1,1
TRAV29DV5,TRAJ32,CAASPPYGGATNKLIF,1,0,1,1
TRAV29DV5,TRAJ32,CAASTSYGGATSKLIF,1,0,1,1
TRAV12-3,TRAJ44,CAMSEWIAGTASKLTF,1,0,1,1
TRAV12-3,TRAJ27,CAMRPRINTNAGKSTF,1,0,1,1
TRAV12-1,TRAJ15,CVVSAFNQAGTALIF,1,0,1,1
TRAV10,TRAJ47,CVVSAGREYGNKLVF,1,0,1,1
TRAV12-1,TRAJ27,CVVNKLFGNAGKSTF,1,0,1,1
TRAV38-2DV8,TRAJ48,CAYRSPNFGNEKLTF,1,0,1,1
TRAV38-2DV8,TRAJ29,CAYRSARRGNTPLVF,1,0,1,1
TRAV38-2DV8,TRAJ15,CAYRRANQAGTALIF,1,0,1,1
TRAV38-1,TRAJ37,CAYRSYSGNTGKLIF,1,0,1,1
TRAV19,TRAJ24,CALGRTTDSWGKFQF,1,1,2,2
TRAV9-2,TRAJ4,CALTRFSGGYNKLIF,1,0,1,1
TRAV9-2,TRAJ57,CALSLTQGGSEKLVL,1,0,1,1
TRAV16,TRAJ17,CALRGSKAAGNELTF,1,0,1,1
TRAV20,TRAJ37,CAVQGSSGNTGKLIF,1,0,1,1
TRAV8-3,TRAJ40,CAVGASTSGTYKYIF,1,0,1,1
TRAV2,TRAJ27,CAVDSLNTNAGKSTF,1,0,1,1
TRAV2,TRAJ12,CAVEDRKDSSYKLIF,1,0,1,1
TRAV12-2,TRAJ50,CAVRRLRTSYDKVIF,1,0,1,1
TRAV3,TRAJ6,CAVRDQAGGSYIPTF,1,0,1,1
TRAV3,TRAJ7,CAVRDAISGNNRLAF,1,0,1,1
TRAV41,TRAJ58,CAADPKETSGSRLTF,1,0,1,1
TRAV35,TRAJ42,CAGPNYGGSQGNLIF,1,0,1,1
TRAV35,TRAJ50,CAGPYMKTSYDKVIF,1,0,1,1
TRAV17,TRAJ37,CATAIGSSNTGKLIF,1,0,1,1
TRAV17,TRAJ18,CATDGRGSTLGRLYF,1,0,1,1
TRAV12-2,TRAJ18,CAVRSRGSTLGRLYF,1,0,1,1
TRAV39,TRAJ56,CAVETKTGANSKLTF,1,0,1,1
TRAV12-2,TRAJ49,CAVMRIGRTGNQFYF,1,0,1,1
TRAV8-1,TRAJ17,CAVNERKAAGNKLTF,1,0,1,1
TRAV12-2,TRAJ9,CAVNGLDTGGFKTIF,1,0,1,1
TRAV12-2,TRAJ37,CAVNISGGNTGKLIL,1,0,1,1
TRAV13-1,TRAJ53,CAAPNSGGSNYKLTF,1,0,1,1
TRAV13-1,TRAJ20,CAASPIRSNDYKLSF,1,0,1,1
TRAV29DV5,TRAJ30,CAASAVEGRDDKIIF,1,0,1,1
TRAV29DV5,TRAJ44,CAARNWGGTASKLTF,1,0,1,1
TRAV5,TRAJ23,CAEVPLGNQGGKPIF,1,0,1,1
TRAV12-3,TRAJ37,CAMSYGSGNTGKPIF,1,0,1,1
TRAV12-3,TRAJ48,CAMSAEVRGNEKLTF,1,0,1,1
TRAV12-3,TRAJ37,CAMSATGGNTGKLIF,1,0,1,1
TRAV12-3,TRAJ45,CAMSGWGGGADGLTF,1,0,1,1
TRAV14DV4,TRAJ17,CAMREPRAAGNKLTF,1,0,1,1
TRAV14DV4,TRAJ15,CAMREKRQAGTALIF,1,0,1,1
TRAV4,TRAJ30,CLVGDVRRRDDKIIF,1,0,1,1
TRAV26-1,TRAJ44,CIVRPGVGTASKLTF,1,0,1,1
TRAV26-1,TRAJ5,CIVRVPDTGRRALTF,1,0,1,1
TRAV26-1,TRAJ37,CIVRGSSGNTGKLIF,1,0,1,1
TRAV12-1,TRAJ22,CPNRREGSARQLTF,1,0,1,1
TRAV12-1,TRAJ3,CVVSSGSSASKIIF,1,0,1,1
TRAV12-1,TRAJ15,CVVVPFGAGTALIF,1,0,1,1
TRAV12-1,TRAJ43,CVVNGFNNNNDMRF,1,0,1,1
TRAV12-1,TRAJ27,CVVNGPTNAGKSTF,1,0,1,1
TRAV12-1,TRAJ20,CVVNTRSNDYKLSF,1,0,1,1
TRAV12-1,TRAJ4,CVALVSGGYNKLIL,1,0,1,1
TRAV12-1,TRAJ15,CVAKGFEAGTALIF,1,0,1,1
TRAV21,TRAJ45,CASDSGGGADGLTF,1,0,1,1
TRAV16,TRAJ12,CALQTRDSSYKLIF,1,0,1,1
TRAV9-2,TRAJ10,CALAVTGGGNKLTF,1,0,1,1
TRAV9-2,TRAJ50,CALMSQTSYDKVIF,1,0,1,1
TRAV9-2,TRAJ4,CALSDRGGYNKLIF,1,0,1,1
TRAV9-2,TRAJ6,CALSDKGGSYIPTF,1,0,1,1
TRAV9-2,TRAJ30,CALSEIGRDDKIIF,1,0,1,1
TRAV19,TRAJ41,CALSNGDSGYALNF,1,0,1,1
TRAV9-2,TRAJ26,CALRSGNYGQNFVF,1,0,1,1
TRAV16,TRAJ29,CALSGGSGNTPLVF,1,0,1,1
TRAV16,TRAJ58,CALNQETSGSRLTF,1,0,1,1
TRAV16,TRAJ6,CAPLSSGGSYIPTF,1,0,1,1
TRAV41,TRAJ42,CAVYYGGSQGNLIF,1,0,1,1
TRAV20,TRAJ13,CAVLPSGGYQKVTF,1,0,1,1
TRAV20,TRAJ38,CAVQYAGNNRKLIW,1,0,1,1
TRAV20,TRAJ34,CAVQAGGDTDKLIF,1,0,1,1
TRAV8-3,TRAJ47,CAVGAMEYGNKLVF,1,0,1,1
TRAV2,TRAJ37,CAVGGPSNTGKLIF,1,0,1,1
TRAV8-6,TRAJ32,CAVSYGGATNKLIF,1,0,1,1
TRAV8-6,TRAJ27,CAVSDAANAGKSTF,1,0,1,1
TRAV8-6,TRAJ9,CAVSDGTGGFKTIF,1,0,1,1
TRAV21,TRAJ11,CAVRPGSGYSTLTF,1,0,1,1
TRAV3,TRAJ42,CAVRGRRSQGNLIF,1,0,1,1
TRAV3,TRAJ31,CAVRDGNNNARLMF,1,0,1,1
TRAV3,TRAJ31,CAVRDRRNNARLMF,1,0,1,1
TRAV12-2,TRAJ41,CAVREKNSGYALNF,1,0,1,1
TRAV3,TRAJ32,CAVKGGGATNKPIF,1,0,1,1
TRAV3,TRAJ21,CAARPNINFNKFYF,1,0,1,1
TRAV2,TRAJ36,CAAGCQTGANNLFF,1,0,1,1
TRAV17,TRAJ10,CATAVTGGGNKLTF,1,1,2,2
TRAV17,TRAJ45,CATEAGGGADGLTF,1,0,1,1
TRAV16,TRAJ6,CALRRGGGSYIPTF,1,0,1,1
TRAV22,TRAJ45,CAPNSGGGADGLTF,1,0,1,1
TRAV8-1,TRAJ3,CAVTRYSSASKIIF,1,0,1,1
TRAV8-1,TRAJ36,CAVRGQTGANNLFF,1,0,1,1
TRAV12-2,TRAJ49,CAVNEGVAGNQFYF,1,0,1,1
TRAV12-2,TRAJ17,CAVKNKAAGNKLTF,1,0,1,1
TRAV25,TRAJ45,CAVLRGGGADGLTF,1,0,1,1
TRAV29DV5,TRAJ47,CAAERMEYGNKLVF,1,0,1,1
TRAV23DV6,TRAJ16,CAAEGGQDGQKLLF,1,0,1,1
TRAV13-1,TRAJ37,CAAIVVSNTGKLIF,1,0,1,1
TRAV23DV6,TRAJ32,CAAMMGGATNKLIF,1,0,1,1
TRAV13-1,TRAJ3,CAASRGSSASKIIF,1,0,1,1
TRAV29DV5,TRAJ58,CAASVETSGSRLTF,1,0,1,1
TRAV13-1,TRAJ42,CAASMTGSQGNLIF,1,0,1,1
TRAV13-1,TRAJ10,CAASTPGGGNKLTF,1,0,1,1
TRAV29DV5,TRAJ49,CAASAPGTGNQFYF,1,0,1,1
TRAV13-1,TRAJ42,CAASSGGSQGNLIF,1,0,1,1
TRAV27,TRAJ44,CAGDKAGTASKLTF,1,0,1,1
TRAV5,TRAJ13,CAEAATGGYQKVTF,1,0,1,1
TRAV12-3,TRAJ10,CAMILTGGGNKLTF,1,0,1,1
TRAV12-3,TRAJ44,CAMSKAGTASKLTF,1,0,1,1
TRAV12-3,TRAJ27,CAMSSNTNAGKSTF,1,0,1,1
TRAV12-3,TRAJ26,CAMSARNYGQNFVF,1,0,1,1
TRAV12-3,TRAJ33,CAMSGRDSNYQLIW,1,0,1,1
TRAV12-3,TRAJ48,CAMRVEFGNEKLTF,1,0,1,1
TRAV12-3,TRAJ34,CAMRRPYNTDKLIF,1,0,1,1
TRAV14DV4,TRAJ58,CAMREGSWGSRLTF,1,0,1,1
TRAV12-3,TRAJ7,CAMNTLYGNNRLAF,1,0,1,1
TRAV34,TRAJ22,CGADYSGSARQLTF,1,0,1,1
TRAV39,TRAJ6,CTMTLSGGSYIPTF,1,0,1,1
TRAV4,TRAJ29,CLVGPNSGNTPLVF,1,0,1,1
TRAV26-2,TRAJ45,CILYSGGGADGLTF,1,0,1,1
TRAV26-2,TRAJ35,CILRVIGFGNVLHC,1,1,2,2
TRAV12-1,TRAJ8,CVVMDTGFQKLVF,1,0,1,1
TRAV12-1,TRAJ13,CVVRSGGYQKVTF,1,1,2,2
TRAV12-1,TRAJ4,CVVNGGGYNKLIF,1,0,1,1
TRAV3,TRAJ26,CASASNYGQNFVF,1,0,1,1
TRAV38-2DV8,TRAJ17,CAYETSAGNKLTF,1,0,1,1
TRAV9-2,TRAJ24,CALPTDSWGKFQF,1,0,1,1
TRAV16,TRAJ13,CALNSGGYQKVTF,1,0,1,1
TRAV9-2,TRAJ13,CALLSGGYQKVTF,1,0,1,1
TRAV19,TRAJ20,CALSEPNDYKLSF,1,0,1,1
TRAV6,TRAJ8,CALSDTGFQKLVF,1,0,1,1
TRAV16,TRAJ57,CALTQGGSEKLVF,1,1,2,2
TRAV17,TRAJ12,CAPEMDSSYKLIF,1,0,1,1
TRAV41,TRAJ49,CAVIPNTGNQFYF,1,0,1,1
TRAV41,TRAJ31,CAVSTRNNARLMF,1,0,1,1
TRAV20,TRAJ6,CAVLKGGSYIPTF,1,0,1,1
TRAV2,TRAJ4,CAVLSGGYNKLIF,1,0,1,1
TRAV21,TRAJ53,CAVLRGSNYKLTF,1,0,1,1
TRAV21,TRAJ15,CAVPHQAGTALIF,1,0,1,1
TRAV8-3,TRAJ47,CAVQREYGNKLVF,1,0,1,1
TRAV20,TRAJ26,CAVQASDGQNFVF,1,0,1,1
TRAV8-3,TRAJ7,CAVVSYGNNRLAF,1,0,1,1
TRAV2,TRAJ42,CAVVGGSQGNLIF,1,0,1,1
TRAV8-3,TRAJ7,CAVAPYGNNRLAF,1,0,1,1
TRAV2,TRAJ6,CAVAAGGSYIPTF,1,0,1,1
TRAV2,TRAJ10,CAVEERGGIKLTF,1,0,1,1
TRAV8-3,TRAJ27,CAVMDTNAGKSTF,1,1,2,2
TRAV12-2,TRAJ20,CAAFSSNDYKLSF,1,0,1,1
TRAV41,TRAJ34,CAAYVSNTDKLIF,1,0,1,1
TRAV17,TRAJ45,CATRRGGADGLTF,1,0,1,1
TRAV17,TRAJ16,CATLSGDGQKLLF,1,0,1,1
TRAV17,TRAJ34,CATDAGFTDKLIF,1,0,1,1
TRAV17,TRAJ23,CATDGNQGGKLIF,1,0,1,1
TRAV24,TRAJ23,CAFSDHQGGKLIF,1,0,1,1
TRAV12-2,TRAJ3,CASSKSSASKIIF,1,0,1,1
TRAV6,TRAJ44,CAPQTGTASKLTF,1,0,1,1
TRAV12-2,TRAJ29,CAVVSSGNTPLVF,1,0,1,1
TRAV12-2,TRAJ29,CAVKVDGNTPLVF,1,0,1,1
TRAV26-2,TRAJ40,CASEVSGTYKYIF,1,0,1,1
TRAV12-3,TRAJ22,CALLGGSARQLTF,1,0,1,1
TRAV5,TRAJ36,CAALREGANNLFF,1,0,1,1
TRAV23DV6,TRAJ32,CAALGGATNKLIF,1,0,1,1
TRAV13-1,TRAJ13,CAATPGGYQKVTF,1,0,1,1
TRAV13-1,TRAJ22,CAASQGSARQLTF,1,0,1,1
TRAV29DV5,TRAJ34,CAASKYRTDKLIF,1,0,1,1
TRAV13-1,TRAJ21,CAARPGGFNKFYF,1,0,1,1
TRAV29DV5,TRAJ36,CAARRTGANNLFF,1,0,1,1
TRAV27,TRAJ24,CAGATDSWGKFQF,1,0,1,1
TRAV27,TRAJ49,CAGGRYTGNQFYF,1,0,1,1
TRAV5,TRAJ16,CAEGFSDGQKLLF,1,0,1,1
TRAV5,TRAJ40,CAESTSGTYKYIF,1,0,1,1
TRAV13-2,TRAJ5,CAENRAGRRALTF,1,1,2,2
TRAV12-3,TRAJ47,CAMGPRGGNKLVF,1,0,1,1
TRAV12-3,TRAJ17,CAMIKAAGNKLTF,1,2,2,3
TRAV12-3,TRAJ17,CAMSQAAGNKLTF,1,0,1,1
TRAV12-3,TRAJ58,CAMSKTSGSRLTF,1,0,1,1
TRAV12-3,TRAJ21,CAMSVYNFNKFYF,1,0,1,1
TRAV12-3,TRAJ22,CAMSGGSARQLTF,1,0,1,1
TRAV12-3,TRAJ37,CAMSEGNTGKLIF,1,0,1,1
TRAV14DV4,TRAJ49,CAMREGTGNQFYF,1,0,1,1
TRAV12-3,TRAJ8,CAMKNTGFQKLVF,1,0,1,1
TRAV12-3,TRAJ13,CATSRAGYQKVTF,1,0,1,1
TRAV4,TRAJ11,CLVGPSGYSTLTF,1,0,1,1
TRAV4,TRAJ21,CLVGEYNFNKFYF,1,0,1,1
TRAV4,TRAJ34,CLVDAYNTDELIF,1,0,1,1
TRAV16,TRAJ50,CLEAKTSYDKVIF,1,0,1,1
TRAV26-2,TRAJ46,CILRKSSGDKLTF,1,0,1,1
TRAV25,TRAJ41,WRGVSSSGYALNF,1,0,1,1
TRAV23DV6,TRAJ18,FRRGSTLGRLYF,1,0,1,1
TRAV8-2,TRAJ43,CVVSDLVRDMRF,1,0,1,1
TRAV12-1,TRAJ36,CVVNPGANNLFF,1,0,1,1
TRAV9-2,TRAJ4,CALSGGYNKLIF,1,0,1,1
TRAV9-2,TRAJ9,CALCTGGFKTIF,1,0,1,1
TRAV16,TRAJ10,CALTGGGNKLTF,2,0,1,2
TRAV16,TRAJ20,CALSDNDYKLSF,1,0,1,1
TRAV16,TRAJ34,CALRANTDKLIF,1,0,1,1
TRAV22,TRAJ44,CAVGRAASKLTF,1,0,1,1
TRAV8-3,TRAJ5,CAVGAPARALTF,1,0,1,1
TRAV12-2,TRAJ27,CAVIGSAGKSTF,1,0,1,1
TRAV35,TRAJ21,CAGLYNFNKFYF,1,0,1,1
TRAV35,TRAJ33,CAGRRSNYQLIW,1,0,1,1
TRAV35,TRAJ49,CAGINTGNQFYF,1,0,1,1
TRAV41,TRAJ49,CADPLTGNQFYF,1,0,1,1
TRAV17,TRAJ20,CATDLNDYKLSF,1,0,1,1
TRAV12-2,TRAJ8,CARGTGFQKLVF,1,0,1,1
TRAV21,TRAJ3,CAVYSSASKIIF,2,0,1,2
TRAV39,TRAJ39,CAVDGWSNMLTF,1,0,1,1
TRAV8-1,TRAJ30,CAVTPWDDKIIF,1,0,1,1
TRAV39,TRAJ21,CAVRNNFNKFYF,1,1,2,2
TRAV12-2,TRAJ43,CAVNEFLDDMRF,1,0,1,1
TRAV12-2,TRAJ9,CAVNEGGFKTIF,1,0,1,1
TRAV12-2,TRAJ20,CAVNENDYKLSF,1,0,1,1
TRAV12-2,TRAJ27,CAVKANAGKSTF,1,0,1,1
TRAV8-1,TRAJ5,CAVKAGRRALTF,1,0,1,1
TRAV8-1,TRAJ43,CAVKPEGNDMRF,1,0,1,1
TRAV8-1,TRAJ42,CAARGSQGNLIF,1,0,1,1
TRAV25,TRAJ31,CAVKNNNARLMF,1,0,1,1
TRAV13-1,TRAJ49,CAAITSGNQFYF,1,0,1,1
TRAV13-1,TRAJ49,CAASITGNQFYF,1,0,1,1
TRAV13-1,TRAJ30,CAASRGDDKIIF,1,0,1,1
TRAV13-1,TRAJ48,CAASGPSEKLTF,1,0,1,1
TRAV13-1,TRAJ3,CAARGSASKIIF,1,0,1,1
TRAV27,TRAJ22,CAGAGSARQLTF,1,0,1,1
TRAV27,TRAJ54,CAGGKGAQKLVF,1,0,1,1
TRAV5,TRAJ41,CAERRTGYALNF,1,0,1,1
TRAV14DV4,TRAJ43,CATPRENNDMRF,1,0,1,1
TRAV4,TRAJ30,CLVPRGEDKIIF,1,0,1,1
TRAV1-1,TRAJ33,CAVRDSNYQLIW,1,0,1,1
TRAV30,TRAJ27,CGTGTNAGKSTF,1,0,1,1
TRAV30,TRAJ40,CGTERGTYKYIF,1,0,1,1
TRAV8-2,TRAJ24,CVVPSWGKFQF,1,0,1,1
TRAV12-1,TRAJ49,CVVRTGNQFYF,1,1,2,2
TRAV19,TRAJ7,CALSGNNRLAF,1,0,1,1
TRAV12-2,TRAJ23,CAVFPGGKLIF,1,0,1,1
TRAV13-1,TRAJ30,CAASKTDKIIF,1,0,1,1
TRAV13-2,TRAJ31,CAEGDNARLMF,1,0,1,1
TRAV12-3,TRAJ20,CAMWDDYKLSF,1,0,1,1
TRAV12-3,TRAJ20,CAMSAGYKLSF,1,0,1,1
TRAV26-2,TRAJ33,CILYSNYQLIW,1,0,1,1
TRAV8-2,TRAJ33,CVVSNYQLIW,1,0,1,1
TRAV13-2,TRAJ20,CVEGDYKLSF,1,0,1,1
TRAV21,TRAJ30,CAVRDDKIIF,1,0,1,1
TRAV12-2,TRAJ23,CAAQGGKLIF,1,0,1,1
TRAV13-1,TRAJ27,CAASRGKSTF,1,0,1,1
TRAV12-1,TRAJ52,CVVKRARDAGGTSYGKLTF,1,0,1,1
TRAV38-1,TRAJ53,CAFMKLIRPGGSNYKLTF,1,0,1,1
TRAV38-2DV8,TRAJ32,CAYRSAFSGGGATNKLIF,1,0,1,1
TRAV8-6,TRAJ28,CAVRGPTYSGAGSYQLTF,1,0,1,1
TRAV3,TRAJ45,CAVRDPPYSGGGADGLTF,1,1,2,2
TRAV17,TRAJ53,CATDAGDFSGGSNYKLTF,1,0,1,1
TRAV23DV6,TRAJ11,CAAHPPGEVNSGYSTLTF,1,0,1,1
TRAV13-1,TRAJ53,CAASKGGNSGGSNYKLTF,1,0,1,1
TRAV29DV5,TRAJ45,CAASGVRGSGGGADGLTF,1,0,1,1
TRAV8-2,TRAJ5,CVVSDTYMDTGRRALTF,1,0,1,1
TRAV10,TRAJ48,CVVSDLISNFGNEKLTF,1,0,1,1
TRAV19,TRAJ44,CALSEARNTGTASKLTF,1,0,1,1
TRAV8-3,TRAJ42,CAVGPMNYGGSQGNLIF,1,0,1,1
TRAV3,TRAJ5,CAVREPPRPAGRRALTF,1,0,1,1
TRAV17,TRAJ18,CATPPADRGSTLGRLYF,1,0,1,1
TRAV12-2,TRAJ28,CAVNKGRTGAGSYQLTF,1,0,1,1
TRAV12-1,TRAJ42,CVVNKPRGGSQGNLIF,1,0,1,1
TRAV38-2DV8,TRAJ54,CAFSRGRFQGAQKLVF,1,0,1,1
TRAV23DV6,TRAJ18,CAVPADRGSTLGRLYF,1,0,1,1
TRAV2,TRAJ32,CAVESSNGGATNKLIF,1,0,1,1
TRAV36DV7,TRAJ45,CAVEIYSGGGADGLTF,1,0,1,1
TRAV8-4,TRAJ37,CAVSLVVTSNTGKLIF,1,0,1,1
TRAV17,TRAJ28,CATVPYSGAGSYQLTF,1,0,1,1
TRAV8-1,TRAJ13,CAVNAAGSGGYQKVTF,1,0,1,1
TRAV29DV5,TRAJ40,CAASAGGTSGTYKYIF,1,0,1,1
TRAV29DV5,TRAJ42,CAASGGYGGSQGNLIF,1,0,1,1
TRAV23DV6,TRAJ47,CAASDTGAEYGNKLVF,1,0,1,1
TRAV13-2,TRAJ57,CAERVPSQGGSERLVF,1,0,1,1
TRAV8-2,TRAJ40,CVVSDRASGTYKYIF,1,0,1,1
TRAV12-1,TRAJ17,CVQLTLRAAGNKLTF,1,0,1,1
TRAV10,TRAJ40,CVVSPQTSGTYKYIF,1,0,1,1
TRAV38-2DV8,TRAJ57,CAYRPSQGGSEKLVF,1,0,1,1
TRAV9-2,TRAJ12,CALISSGDSSYKLIF,1,0,1,1
TRAV19,TRAJ47,CALSEVMEYGNKLVF,1,0,1,1
TRAV19,TRAJ3,CALSEADSSASKIIF,1,0,1,1
TRAV9-2,TRAJ50,CALRMMKTSYDKVIF,1,0,1,1
TRAV9-2,TRAJ53,CALRASGGSNYKLTF,1,0,1,1
TRAV9-2,TRAJ18,CALKGGGSTLGRLYF,1,0,1,1
TRAV16,TRAJ18,CALTPRGSTLGRLYF,1,0,1,1
TRAV16,TRAJ28,CALSGHGAGSYQLTF,1,0,1,1
TRAV23DV6,TRAJ42,CAVGGYGGSQGNLIF,1,0,1,1
TRAV3,TRAJ5,CAVGGMDTGRRALTF,1,0,1,1
TRAV3,TRAJ48,CAVRDPNFGNEKLTF,1,0,1,1
TRAV3,TRAJ15,CAVRDMRQAGTALIF,1,0,1,1
TRAV17,TRAJ44,CATASLTGTASKLTF,1,0,1,1
TRAV17,TRAJ12,CATDPLMDSSYKLIF,1,0,1,1
TRAV17,TRAJ24,CATEMTTDSWGKFQF,1,0,1,1
TRAV8-1,TRAJ45,CAVSASGGGADGLTF,1,0,1,1
TRAV8-1,TRAJ27,CAVNGGGTNAGKSTF,1,0,1,1
TRAV12-2,TRAJ11,CAVNGGYSGYSTLTF,1,0,1,1
TRAV12-2,TRAJ42,CAVNMRTGSQGNLIF,1,0,1,1
TRAV29DV5,TRAJ28,CAAARSGAGSYQLTF,1,0,1,1
TRAV13-1,TRAJ32,CAATDYGGATNKLIF,1,0,1,1
TRAV13-1,TRAJ36,CAASGVGTGANNLFF,1,0,1,1
TRAV13-1,TRAJ17,CAASIPRAAGNKLTF,1,0,1,1
TRAV29DV5,TRAJ21,CAASDSRGNFNKFYF,1,0,1,1
TRAV29DV5,TRAJ37,CAASEPGSNTGKLIF,1,0,1,1
TRAV23DV6,TRAJ32,CAASMDGGATNKLIF,1,0,1,1
TRAV23DV6,TRAJ37,CAAKSPPSNTGKLIF,1,0,1,1
TRAV5,TRAJ3,CAETGSYSSPSKIIF,1,0,1,1
TRAV5,TRAJ22,CAESITLGSARQLTF,1,0,1,1
TRAV12-3,TRAJ38,CAMRGPAGNNRKLIW,1,0,1,1
TRAV4,TRAJ6,CLVGSTSGGSYIPTF,1,0,1,1
TRAV4,TRAJ12,CLVGAGMDSSYKLIF,1,0,1,1
TRAV12-1,TRAJ11,CVVNWNSGYSTLTF,1,0,1,1
TRAV38-2DV8,TRAJ56,CAFLSTGANSKLTF,1,0,1,1
TRAV38-1,TRAJ42,CAFGFGGSQGNLIF,1,0,1,1
TRAV38-1,TRAJ43,CAFMKVQGNNDMRF,1,0,1,1
TRAV38-2DV8,TRAJ43,CAYRSVYNNNDMRF,1,0,1,1
TRAV9-2,TRAJ31,CALSDRNNNARLMF,1,0,1,1
TRAV9-2,TRAJ54,CALSDFQGAQKLVF,1,0,1,1
TRAV9-2,TRAJ12,CALSDEDSSYKLIF,1,0,1,1
TRAV9-2,TRAJ39,CALSEPNAGNMLTF,1,0,1,1
TRAV19,TRAJ39,CALRFGNAGNMLTF,1,0,1,1
TRAV29DV5,TRAJ9,CALRADTGGFKTIF,1,0,1,1
TRAV9-2,TRAJ10,CALILTGGGNKLTF,1,0,1,1
TRAV16,TRAJ23,CALTSYNRGGKLIF,1,0,1,1
TRAV16,TRAJ35,CAPPPIGFGNVLHC,1,0,1,1
TRAV9-2,TRAJ23,CAPLSGNQGGKLIF,1,0,1,1
TRAV21,TRAJ58,CAVYKETSGSRLTF,1,0,1,1
TRAV20,TRAJ13,CAVQTTGGYQKVTF,1,0,1,1
TRAV21,TRAJ10,CAVGLTGGGNKLTF,1,0,1,1
TRAV8-3,TRAJ20,CAVGGRSNDYKLSF,1,0,1,1
TRAV36DV7,TRAJ52,CAVDRGTSYGKLTF,1,0,1,1
TRAV22,TRAJ58,CAVERGLGDSRLTF,1,0,1,1
TRAV8-4,TRAJ10,CAVSVGGGGNKLTF,1,0,1,1
TRAV8-4,TRAJ56,CAVSGGGANSRLTF,1,0,1,1
TRAV8-4,TRAJ42,CAVSERGSQGNLVF,1,0,1,1
TRAV8-3,TRAJ40,CAVSTTSGTYKYIF,1,0,1,1
TRAV12-2,TRAJ12,CAVRRLDSSYKLIF,1,0,1,1
TRAV21,TRAJ11,CAVRQASGYSTLTF,1,0,1,1
TRAV36DV7,TRAJ7,CAAQTRYGNNRLAF,1,0,1,1
TRAV8-4,TRAJ12,CAAGWMDSSYKLIF,1,0,1,1
TRAV35,TRAJ53,CAGPRGGSNYKLTF,1,0,1,1
TRAV17,TRAJ29,CATARNSGNTPLVF,1,0,1,1
TRAV17,TRAJ39,CATDEDNAGNMLTF,1,0,1,1
TRAV17,TRAJ31,CATDLPVNNARLMF,1,0,1,1
TRAV17,TRAJ53,CATDVGGSNYKLTF,1,0,1,1
TRAV17,TRAJ13,CATDRRGGYQKVTF,1,0,1,1
TRAV39,TRAJ17,CALSPGAAGNKLTF,1,0,1,1
TRAV39,TRAJ17,CAPDRGAAGNKLTF,1,0,1,1
TRAV12-2,TRAJ6,CAVRGTGGSYIPTF,1,0,1,1
TRAV12-2,TRAJ45,CAVASGGGADGLTF,1,0,1,1
TRAV8-1,TRAJ30,CAVESMNRDDKIIF,1,0,1,1
TRAV8-1,TRAJ17,CAVIWEAAGNKLTF,1,0,1,1
TRAV8-1,TRAJ48,CAVIPSFGNEKLTF,1,0,1,1
TRAV8-1,TRAJ8,CAVTLNTGFQKLVF,1,0,1,1
TRAV8-1,TRAJ46,CAVNAESSGDKLTF,1,0,1,1
TRAV12-2,TRAJ29,CAVNLGSGNTPLVF,1,0,1,1
TRAV12-2,TRAJ8,CAVKRNTGFQKLVF,1,0,1,1
TRAV25,TRAJ17,CARSLKAAGNKLTF,1,0,1,1
TRAV13-1,TRAJ6,CAALGGGGSYIPTF,1,0,1,1
TRAV13-1,TRAJ32,CAAGDGGATNKLIF,1,0,1,1
TRAV13-1,TRAJ8,CAASRLAGFQKLVF,1,0,1,1
TRAV13-1,TRAJ20,CAASEWSNDYKLSF,1,5,2,6
TRAV29DV5,TRAJ3,CAASVYSSASKIIF,1,0,1,1
TRAV29DV5,TRAJ13,CAASGSGGYQKVTF,1,0,1,1
TRAV29DV5,TRAJ22,CAASGPGSARQLTF,1,0,1,1
TRAV29DV5,TRAJ27,CAASTVPNAGKSTF,1,0,1,1
TRAV27,TRAJ58,CAGPRETSGSRLTF,1,0,1,1
TRAV27,TRAJ26,CAGARNNYGQNFVF,1,0,1,1
TRAV27,TRAJ37,CAGEMGSNTGKLIF,1,0,1,1
TRAV27,TRAJ3,CAGTLYSSASKIIF,1,0,1,1
TRAV5,TRAJ27,CAERAYTNAGKSTF,1,0,1,1
TRAV13-2,TRAJ23,CAENINNQGGKLIF,1,0,1,1
TRAV12-3,TRAJ54,CAMTPAWGAQKLVF,1,0,1,1
TRAV12-3,TRAJ54,CAMSFIQGAQKLVF,1,0,1,1
TRAV12-3,TRAJ6,CAMSGAGGSYIPTF,1,0,1,1
TRAV12-3,TRAJ53,CAMNSGGSNYKLTF,1,0,1,1
TRAV12-3,TRAJ8,CAMKGNTGFQKLVF,1,0,1,1
TRAV4,TRAJ39,CLVGPNNAGNMLTF,1,0,1,1
TRAV39,TRAJ32,WAGALGGATNKLIF,1,0,1,1
TRAV8-2,TRAJ20,CVVSDRFDYKLSF,1,0,1,1
TRAV12-1,TRAJ26,CVVNSFYGQNFVF,1,0,1,1
TRAV12-1,TRAJ17,CVAWEAAGNKLTF,1,0,1,1
TRAV38-2DV8,TRAJ44,CALDTGTASKLTF,1,0,1,1
TRAV9-2,TRAJ56,CASLTGANSKLTF,1,2,2,3
TRAV9-2,TRAJ20,CALSDPSDYKLSF,1,0,1,1
TRAV9-2,TRAJ11,CALSGSGYSTLTF,1,0,1,1
TRAV9-2,TRAJ49,CALRENTGNQFYF,1,0,1,1
TRAV6,TRAJ36,CALVGTGANNLFF,1,1,2,2
TRAV21,TRAJ34,CAVDLYNTDKLIF,1,0,1,1
TRAV8-4,TRAJ8,CAVVGTGFQKLVF,1,0,1,1
TRAV8-3,TRAJ43,CAVASYNNNDMRF,1,0,1,1
TRAV22,TRAJ48,CAVADFGNEKLTF,1,0,1,1
TRAV36DV7,TRAJ40,CAVEASGTYKYIF,1,0,1,1
TRAV2,TRAJ33,CAVEDGGNYQLIW,1,0,1,1
TRAV36DV7,TRAJ53,CAVEGGSNYKLTF,1,0,1,1
TRAV8-4,TRAJ17,CAVIGAAGNKLTF,1,0,1,1
TRAV8-6,TRAJ49,CAVTSNTGNQFYF,1,0,1,1
TRAV8-4,TRAJ22,CAVSSGSARQLTF,1,0,1,1
TRAV8-6,TRAJ20,CAVSDRNDYKLSL,1,0,1,1
TRAV8-4,TRAJ9,CAVSETGGFKTIF,1,0,1,1
TRAV8-6,TRAJ39,CAVSPLGGNMLTF,1,0,1,1
TRAV3,TRAJ40,CAVRDGGTYKYIF,1,0,1,1
TRAV12-2,TRAJ56,CAVRTGANSKLTF,1,1,2,2
TRAV35,TRAJ44,CAGPTGTASKLTF,1,0,1,1
TRAV17,TRAJ40,CATEGQGTYKYIF,1,0,1,1
TRAV17,TRAJ11,CATDATGYSTLTF,1,0,1,1
TRAV17,TRAJ11,CATDGRGYSTLTF,1,0,1,1
TRAV17,TRAJ13,CATVPEGYQKVTF,1,0,1,1
TRAV24,TRAJ37,CAFSVSNTGKLIF,1,0,1,1
TRAV24,TRAJ30,CAFPMNRDDKIIF,1,0,1,1
TRAV24,TRAJ28,CAFTRAGSYQLTF,1,0,1,1
TRAV12-2,TRAJ40,CAVFTSGTYKYIF,1,0,1,1
TRAV8-3,TRAJ15,CAVINQAGTALIF,1,0,1,1
TRAV8-1,TRAJ8,CAVLGQGFQKLVF,1,0,1,1
TRAV12-2,TRAJ28,CAVGRAGSYQLTF,1,0,1,1
TRAV12-2,TRAJ31,CAVMPPSRARLMF,1,0,1,1
TRAV8-1,TRAJ7,CAVTSYGNNRLAF,1,0,1,1
TRAV8-1,TRAJ10,CAVRAGGGNKLTF,1,0,1,1
TRAV12-2,TRAJ6,CAVNVGGSYIPTF,1,0,1,1
TRAV8-1,TRAJ9,CAVKGTGGFKTIF,1,0,1,1
TRAV12-2,TRAJ10,CAVFTGGGNKLTF,1,0,1,1
TRAV12-2,TRAJ54,CAALIQGAQKLVF,1,0,1,1
TRAV29DV5,TRAJ20,CAAEPYNDYKLSF,1,0,1,1
TRAV13-1,TRAJ22,CAAYSGSARQLTF,1,0,1,1
TRAV29DV5,TRAJ46,CAAIESSGDKLTF,1,0,1,1
TRAV13-1,TRAJ5,CAATDTGRRALTF,1,0,1,1
TRAV13-1,TRAJ6,CAASKGGSYIPTF,1,0,1,1
TRAV13-1,TRAJ56,CAASKGANSKLTF,1,0,1,1
TRAV13-1,TRAJ50,CAASKTSYDKVIF,1,0,1,1
TRAV13-1,TRAJ6,CAARPGGSYIPTF,1,0,1,1
TRAV27,TRAJ3,CAGRYSSASKIIF,1,0,1,1
TRAV13-2,TRAJ15,CAERSQAGTALIF,1,0,1,1
TRAV12-3,TRAJ5,CAMADTGRRALTF,1,0,1,1
TRAV12-3,TRAJ9,CAMGDTGGFKTIF,1,0,1,1
TRAV12-3,TRAJ42,CAMIGGSQGNLIS,1,0,1,1
TRAV12-3,TRAJ32,CAMSGGATNKLIF,1,0,1,1
TRAV12-3,TRAJ37,CAIDTGNTGKLIF,1,0,1,1
TRAV34,TRAJ40,CGADASGTYKYIF,1,0,1,1
TRAV4,TRAJ4,CLVISGGYNKLIF,1,0,1,1
TRAV4,TRAJ41,CLVGLNSGYALNF,1,0,1,1
TRAV26-2,TRAJ22,CILRGGSARQLTF,1,0,1,1
TRAV26-1,TRAJ44,CIGYTGTASKLTF,1,0,1,1
TRAV8-2,TRAJ20,CVVSFNDYKLSF,1,0,1,1
TRAV8-2,TRAJ7,CVVSEGNNRLAF,1,0,1,1
TRAV12-1,TRAJ22,CVASGSARQLTF,1,0,1,1
TRAV8-3,TRAJ17,CVEGAAGNKLTF,1,0,1,1
TRAV9-2,TRAJ49,CALSDPGNQFYF,1,0,1,1
TRAV1-2,TRAJ33,CAVQDSNYQLIW,1,0,1,1
TRAV41,TRAJ44,CAVPGTASKLTF,1,0,1,1
TRAV1-2,TRAJ33,CAVRDRNYQLIW,1,0,1,1
TRAV21,TRAJ23,CAGGNQGGKLIF,1,0,1,1
TRAV12-2,TRAJ6,CAVSGGSYIPTF,1,0,1,1
TRAV8-1,TRAJ29,CAVSAGNTPLVF,1,0,1,1
TRAV12-2,TRAJ49,CAVRWTGNQFYF,1,0,1,1
TRAV12-2,TRAJ43,CAVRVGNNDMRF,1,0,1,1
TRAV12-2,TRAJ5,CAVNQGRRALTF,1,0,1,1
TRAV12-2,TRAJ26,CAVKPYGQNFVF,1,0,1,1
TRAV25,TRAJ37,CAPASNTGKLIF,1,0,1,1
TRAV23DV6,TRAJ8,CAATTGFQKLVF,1,0,1,1
TRAV13-1,TRAJ36,CAASIRRDNLFF,1,0,1,1
TRAV29DV5,TRAJ43,CAASVNNNDMRF,1,0,1,1
TRAV23DV6,TRAJ36,CAARPGANNLFF,1,0,1,1
TRAV27,TRAJ39,CAGENAGNMLTF,1,0,1,1
TRAV13-2,TRAJ20,CAEFPIRYKLSF,1,0,1,1
TRAV5,TRAJ34,CAEILNTDKLIF,1,0,1,1
TRAV12-3,TRAJ56,CAMSFREGKLTF,1,0,1,1
TRAV12-3,TRAJ20,CAMSANDYKLSF,1,0,1,1
TRAV30,TRAJ29,CGTETGNTPLVF,1,0,1,1
TRAV26-1,TRAJ49,CIVRVRGNQFYF,1,0,1,1
TRAV26-1,TRAJ31,CIVRVVYARLMF,1,0,1,1
TRAV26-1,TRAJ23,CIKENQGGKLFF,1,0,1,1
TRAV24,TRAJ26,CVNNYGQNFVF,1,1,2,2
TRAV12-1,TRAJ40,CVFRPTDKYIF,1,0,1,1
TRAV12-1,TRAJ40,CVVSGTYKYIF,1,0,1,1
TRAV6,TRAJ11,CALVGYSTLTF,1,0,1,1
TRAV1-2,TRAJ20,CAVANDYKLSF,1,0,1,1
TRAV8-6,TRAJ43,CAVIINNDMRF,1,0,1,1
TRAV35,TRAJ43,CAGSLNNDLRF,1,0,1,1
TRAV17,TRAJ29,CATEGNTPLVF,1,0,1,1
TRAV26-2,TRAJ49,CILITGNQFYF,1,0,1,1
TRAV8-6,TRAJ10,WTSGGGNKLTF,1,0,1,1
TRAV41,TRAJ49,CAVTGNQFYF,1,1,2,2
TRAV13-1,TRAJ22,CAAKRVQLTF,1,0,1,1
TRAV27,TRAJ13,PSGGYQKVTF,1,0,1,1
TRAV8-4,TRAJ18,CASTGRLYF,1,0,1,1
TRAV36DV7,TRAJ54,CALAKKLVF,1,0,1,1
TRAV8-1,TRAJ30,CASPVKIIF,1,0,1,1
TRAV13-1,TRAJ26,RLRGQNFVF,1,0,1,1
TRAV27,TRAJ16,GSGQKLLF,1,0,1,1
TRAV17,TRAJ56,CATGANSKLTF,0,3,1,3
TRAV9-2,TRAJ4,CALTLYGGFNKLIF,0,2,1,2
TRAV21,TRAJ6,CAVLGGSYIPTF,0,1,1,1
TRAV13-1,TRAJ18,CAASRLGGSTLGRLYF,0,4,1,4
TRAV17,TRAJ48,CATSWAASARNFGNEKLTF,0,1,1,1
TRAV38-2DV8,TRAJ39,CAYNNAGNMLTF,0,1,1,1
TRAV8-3,TRAJ48,CAVDPISNFGNEKLTF,0,2,1,2
TRAV20,TRAJ3,CAVQGLYSSASKIIF,0,1,1,1
TRAV41,TRAJ49,CAVKNTGNQFYF,0,3,1,3
TRAV8-1,TRAJ6,CAVNRLSGGSYIPTF,0,2,1,2
TRAV8-3,TRAJ17,CAVGARAAGNKLTF,0,2,1,2
TRAV26-2,TRAJ37,CILHGSSNTGKLIF,0,2,1,2
TRAV12-3,TRAJ22,CAFRASSGSARQLTF,0,3,1,3
TRAV10,TRAJ18,CVVSDRGSTLVRLYF,0,4,1,4
TRAV9-2,TRAJ18,CALSDRESTLGRLYF,0,3,1,3
TRAV14DV4,TRAJ50,CAMRGSRETSYDKVIF,0,4,1,4
TRAV4,TRAJ29,CLVGGRFSGNTPLVF,0,1,1,1
TRAV5,TRAJ29,CAESPFSGNTPLVF,0,3,1,3
TRAV17,TRAJ15,CATDDPNQAGTALIF,0,1,1,1
TRAV41,TRAJ32,CAVLGGATNKLIF,0,1,1,1
TRAV23DV6,TRAJ45,CAEGGGGADGLTF,0,1,1,1
TRAV12-2,TRAJ52,CAAGGTSYGKLTF,0,2,1,2
TRAV9-2,TRAJ31,CALSGNARLMF,0,1,1,1
TRAV26-2,TRAJ49,CILRDWRSNTGNQFYF,0,2,1,2
TRAV12-2,TRAJ23,CAVNIGNQGGKLIF,0,3,1,3
TRAV12-2,TRAJ49,CAVNIGNQFYF,0,3,1,3
TRAV14DV4,TRAJ52,CAMREVAGGTSYGKLTF,0,1,1,1
TRAV13-1,TRAJ13,CAATAGGYQKVTF,0,2,1,2
TRAV38-2DV8,TRAJ45,CAYTRTGGGADGLTF,0,2,1,2
TRAV38-2DV8,TRAJ28,CAYIDAGAGSYQLTF,0,1,1,1
TRAV9-2,TRAJ3,CAFPAPYSSASKIIF,0,1,1,1
TRAV17,TRAJ30,CATDKMGSRDDKIIF,0,1,1,1
TRAV17,TRAJ15,CATDDNQAGTALIF,0,1,1,1
TRAV12-3,TRAJ58,CAFLQETSGSRLTF,0,1,1,1
TRAV20,TRAJ17,CAVQGAAGNKLTF,0,1,1,1
TRAV20,TRAJ42,CAVEGGSQGNLIF,0,1,1,1
TRAV19,TRAJ12,CALSEPRMDSSYKLIF,0,1,1,1
TRAV12-3,TRAJ22,CAMSGWSSGSARQLTF,0,1,1,1
TRAV17,TRAJ5,CAPRGREEGRRALTF,0,5,1,5
TRAV12-2,TRAJ22,CAVPHFSGSARQLTF,0,1,1,1
TRAV27,TRAJ37,CAGHGSSNTGKLIF,0,1,1,1
TRAV19,TRAJ49,CALRTNTGNQFYF,0,2,1,2
TRAV13-2,TRAJ11,CAAPNSGYSTLTF,0,3,1,3
TRAV27,TRAJ37,CAGGSNTGKLIF,0,1,1,1
TRAV29DV5,TRAJ34,CAANSLVKLIF,0,3,1,3
TRAV12-2,TRAJ45,CAVRGYHSGGGADGLTF,0,2,1,2
TRAV2,TRAJ9,CAVEALTGGFKTIF,0,1,1,1
TRAV13-1,TRAJ6,CAASRSGGSYIPTF,0,2,1,2
TRAV13-1,TRAJ39,CAAQDAGNMLTF,0,1,1,1
TRAV14DV4,TRAJ9,CAMREDNTGGFKTIF,0,4,1,4
TRAV4,TRAJ9,CLVGDDDTGGFRTIF,0,3,1,3
TRAV20,TRAJ21,CAVQAGYNFNKFYF,0,1,1,1
TRAV12-3,TRAJ26,CAMRDNYGQNFVF,0,1,1,1
TRAV26-2,TRAJ40,CILYPASGTYKYIF,0,1,1,1
TRAV8-3,TRAJ6,CAVGAEGGSYIPTF,0,2,1,2
TRAV17,TRAJ9,CATVSTGGFKTIF,0,3,1,3
TRAV17,TRAJ45,CATDEGRSPGGGADGLTF,0,2,1,2
TRAV13-1,TRAJ4,CAAFPRSGGYNKLIF,0,1,1,1
TRAV12-1,TRAJ9,CVVNIYTGGFKTIF,0,2,1,2
TRAV17,TRAJ15,CATDANQAGTALIF,0,1,1,1
TRAV10,TRAJ33,CVVSADSNYQLIW,0,2,1,2
TRAV12-2,TRAJ30,CAVRGRRDDKIIF,0,1,1,1
TRAV12-3,TRAJ6,CAMSARGSYIPTF,0,2,1,2
TRAV2,TRAJ29,CAGGSGNTPLVF,0,2,1,2
TRAV9-2,TRAJ11,CAQGGYSTLTF,0,1,1,1
TRAV38-2DV8,TRAJ43,CAYYNNDMRF,0,2,1,2
TRAV17,TRAJ52,CATDEDFNAGGTSYGKLTF,0,2,1,2
TRAV20,TRAJ58,CAVARRWETSGSRLTF,0,1,1,1
TRAV3,TRAJ42,CAVSPAYGGSQGNLIF,0,1,1,1
TRAV4,TRAJ8,CLVGDGMNTGFQKLVF,0,1,1,1
TRAV16,TRAJ34,CALGGSYNTDKLIF,0,3,1,3
TRAV17,TRAJ16,CATAPWTDGQKLLF,0,1,1,1
TRAV19,TRAJ29,CAQGRNSGNTPLVF,0,2,1,2
TRAV9-2,TRAJ15,CALSDQAGTALIF,0,1,1,1
TRAV9-2,TRAJ20,CAPERSNDYKLSF,0,2,1,2
TRAV21,TRAJ41,CAVRQRSGYALNF,0,2,1,2
TRAV13-1,TRAJ5,CALSGPGRRALTF,0,1,1,1
TRAV13-2,TRAJ15,CAATNQAGTALIF,0,1,1,1
TRAV13-1,TRAJ13,CAASPGGYQKVTF,0,2,1,2
TRAV27,TRAJ27,CAGMVTNAGKSTF,0,1,1,1
TRAV9-2,TRAJ58,CALGNMEETSASRLTF,0,2,1,2
TRAV26-2,TRAJ44,CILQMTGTASKLTF,0,2,1,2
TRAV14DV4,TRAJ13,CAMGSSGGYQKVTF,0,1,1,1
TRAV17,TRAJ12,CATAGEWTRMDSSYKLIF,0,3,1,3
TRAV35,TRAJ53,CAGQTLNSGGSNYKLTF,0,1,1,1
TRAV9-2,TRAJ32,CALSHGGATNKLIF,0,2,1,2
TRAV19,TRAJ37,CALSVLHGSSNTGKLIF,0,1,1,1
TRAV20,TRAJ53,CAVQARSGGSNYKLTF,0,2,1,2
TRAV16,TRAJ23,CALSGGANQGGKLIF,0,1,1,1
TRAV21,TRAJ58,CAVRLGETSGSRLTF,0,2,1,2
TRAV13-1,TRAJ6,CAASKGPGGSYIPTF,0,1,1,1
TRAV27,TRAJ37,CAGVFLGSNTGKLIF,0,1,1,1
TRAV14DV4,TRAJ5,CAMREGTSGRRALTF,0,2,1,2
TRAV22,TRAJ22,CAVVESGSARQLTF,0,3,1,3
TRAV8-1,TRAJ11,CAVTRNSGYSTLTF,0,1,1,1
TRAV9-2,TRAJ40,CALGHSGTYKYIF,0,2,1,2
TRAV8-1,TRAJ26,CAVSASSGQNFVF,0,1,1,1
TRAV8-1,TRAJ30,CAVNAPRDDKIIF,0,2,1,2
TRAV13-1,TRAJ16,CAASISDGQKLLF,0,1,1,1
TRAV27,TRAJ22,CAGAGGSARQLTF,0,1,1,1
TRAV13-2,TRAJ13,CAENKGGYQKVTF,0,1,1,1
TRAV20,TRAJ15,CAVNQAGTALIF,0,1,1,1
TRAV26-1,TRAJ39,CIVNVPGNMLTF,0,1,1,1
TRAV3,TRAJ13,CAVVGYQKVTF,0,1,1,1
TRAV12-2,TRAJ8,CAVTGFQKLVF,0,1,1,1
TRAV16,TRAJ42,CALGMARNYGGSQGNLIF,0,1,1,1
TRAV13-1,TRAJ20,CAATLDYKLSF,0,2,1,2
TRAV6,TRAJ45,CALGGSGGGADGLTF,0,1,1,1
TRAV30,TRAJ41,CGSERNSGYALNF,0,1,1,1
TRAV38-2DV8,TRAJ47,RAYRPRGVYGNKLVF,0,1,1,1
TRAV38-1,TRAJ57,CAFMKHGWTQGGSEKLVF,0,1,1,1
TRAV12-2,TRAJ45,CAVNPPRGGADGLTF,0,2,1,2
TRAV24,TRAJ42,CASYYGGSQGNLIF,0,2,1,2
TRAV12-2,TRAJ9,CAVNNEGGGFKTIF,0,1,1,1
TRAV17,TRAJ26,CATDADYGQNFVF,0,2,1,2
TRAV5,TRAJ34,CAESGGNTDKLIF,0,3,1,3
TRAV26-2,TRAJ30,CILRDPRDDKIIF,0,2,1,2
TRAV2,TRAJ36,CAVETGANSLFF,0,1,1,1
TRAV13-1,TRAJ32,CAASATNKLIF,0,1,1,1
TRAV12-3,TRAJ30,CAMRRDDKIIF,0,3,1,3
TRAV9-2,TRAJ12,CALSARDSSYKLIF,0,2,1,2
TRAV4,TRAJ9,CLVGDNTGGFKTIF,0,2,1,2
TRAV21,TRAJ35,CAGIGFGNVLHC,0,2,1,2
TRAV27,TRAJ42,CAGGSQGNLIF,0,3,1,3
TRAV14DV4,TRAJ30,CAMREGLRRDDEIIF,0,1,1,1
TRAV29DV5,TRAJ42,CAASARGGSQGNLIF,0,2,1,2
TRAV17,TRAJ40,CATDHALVFTSGTYKYIF,0,1,1,1
TRAV21,TRAJ22,CAVRSLFVGGSARQLTF,0,1,1,1
TRAV20,TRAJ32,CAVQGAYGGATNKLIF,0,1,1,1
TRAV2,TRAJ27,CAVEARRRANAGKSTF,0,2,1,2
TRAV10,TRAJ47,CVVTRGREYGNKLVF,0,2,1,2
TRAV9-2,TRAJ47,CALSANMEYGNKLVF,0,2,1,2
TRAV17,TRAJ16,CATDGLYSDGQKLLF,0,2,1,2
TRAV12-2,TRAJ53,CAVPNSGGSNYKLTF,0,1,1,1
TRAV29DV5,TRAJ40,CAAHPVTSGTYKYIF,0,1,1,1
TRAV19,TRAJ45,CALPSGGGADGLTF,0,1,1,1
TRAV9-2,TRAJ15,CALSDPQAGTALIF,0,2,1,2
TRAV17,TRAJ23,CATDPLGQGGKLIF,0,2,1,2
TRAV12-3,TRAJ26,CAMRGNNYGQNFVF,0,2,1,2
TRAV34,TRAJ50,CGADFPTSYDKVIF,0,2,1,2
TRAV38-1,TRAJ31,CAFMNRNNARLMF,0,1,1,1
TRAV38-1,TRAJ30,CAFMKKRDDKIIF,0,1,1,1
TRAV9-2,TRAJ17,CALIKAAGNKLTF,0,2,1,2
TRAV8-3,TRAJ13,CAVAYGGYQKVTF,0,1,1,1
TRAV23DV6,TRAJ34,CAAKREDTDKLIF,0,2,1,2
TRAV9-2,TRAJ21,CALSGDFNKFYF,0,1,1,1
TRAV2,TRAJ39,CAVGNAGNMLTF,0,2,1,2
TRAV6,TRAJ3,CGVYSASKIIF,0,2,1,2
TRAV12-2,TRAJ45,CAVNLNSGGGADGLTF,0,2,1,2
TRAV35,TRAJ42,CAGQYYGGSQGNLIF,0,2,1,2
TRAV13-1,TRAJ47,CAASKGQKGNKLVF,0,1,1,1
TRAV12-3,TRAJ6,CAMSGRGGSYIPTF,0,2,1,2
TRAV12-1,TRAJ42,CVPYGGSQGNLIF,0,1,1,1
TRAV3,TRAJ30,CAVRDPRDDKIIF,0,2,1,2
TRAV27,TRAJ48,CAGANFGNEKLTF,0,2,1,2
TRAV14DV4,TRAJ11,CAMRPGYSTLTF,0,1,1,1
TRAV12-3,TRAJ38,CAFGNAGNNRKLIG,0,1,1,1
TRAV8-3,TRAJ49,CAVGANTGNQFYF,0,1,1,1
TRAV12-3,TRAJ42,CAMSGYGGSRGNLIF,0,2,1,2
TRAV6,TRAJ15,CARGEAGTALIF,0,1,1,1
TRAV13-1,TRAJ13,CAASRGGGYQKVTF,0,1,1,1
TRAV12-2,TRAJ39,CAPKGNAGNMLTF,0,2,1,2
TRAV19,TRAJ58,CALRGDRETSGSRLTF,0,1,1,1
TRAV13-1,TRAJ37,CAPWVTSSNTGKLIF,0,1,1,1
TRAV13-1,TRAJ13,CAATLNSGGYQKVTF,0,1,1,1
TRAV29DV5,TRAJ27,CAATDYNTNAGKSTF,0,1,1,1
TRAV9-2,TRAJ38,CTLHNAGNNRKLIW,0,2,1,2
TRAV41,TRAJ57,CAVKTQGGSEKLVF,0,2,1,2
TRAV13-2,TRAJ12,CAEIPMDSSYKLIF,0,2,1,2
TRAV35,TRAJ45,CAGRATHSGGGADGLAF,0,1,1,1
TRAV29DV5,TRAJ45,CAARPGSSGGGADGLTF,0,1,1,1
TRAV41,TRAJ48,CAVRSSLGFGNEKLTF,0,1,1,1
TRAV20,TRAJ40,CAVQPRTTSGTYKYIF,0,1,1,1
TRAV8-3,TRAJ32,CAVAPGDGGATNKLIF,0,2,1,2
TRAV26-2,TRAJ45,CILRDVSGGGADGLTF,0,1,1,1
TRAV20,TRAJ8,CAVQAGNTGFQKLVF,0,2,1,2
TRAV21,TRAJ57,CAVKVREGGSEKLVF,0,2,1,2
TRAV21,TRAJ21,CAAPPGGDNFNKFYF,0,1,1,1
TRAV2,TRAJ30,CADTLLMNRDDKIIF,0,1,1,1
TRAV24,TRAJ18,CAFMKRGSTLGRLYF,0,1,1,1
TRAV13-2,TRAJ10,CAEKILTGGGNKLTF,0,1,1,1
TRAV10,TRAJ16,CVVGARERGQKLLF,0,1,1,1
TRAV38-1,TRAJ44,CAFTSTGTASKLTF,0,1,1,1
TRAV22,TRAJ27,CAVEPNTNAGKSTF,0,1,1,1
TRAV3,TRAJ7,CAVRDEWGNNRLAF,0,1,1,1
TRAV21,TRAJ57,CAALTQGGSEKLVF,0,1,1,1
TRAV17,TRAJ57,CATPFRGGSEKLVF,0,1,1,1
TRAV17,TRAJ41,CATDFSNSGYALNF,0,2,1,2
TRAV17,TRAJ56,CATELTGANSKLTF,0,2,1,2
TRAV39,TRAJ15,CAVDTNQAGTALIF,0,1,1,1
TRAV13-1,TRAJ38,CAAKGGGNNRKLIW,0,1,1,1
TRAV23DV6,TRAJ32,CAASAGGATNKLIF,0,2,1,2
TRAV5,TRAJ40,CAESVPSGTYKYIF,0,2,1,2
TRAV6,TRAJ3,CALFYSSASKIIF,0,1,1,1
TRAV16,TRAJ53,CALGGGSNYKLTF,0,1,1,1
TRAV8-3,TRAJ20,CAVGSTNDYKLSF,0,2,1,2
TRAV8-3,TRAJ30,CAVGGDRDDKIIF,0,1,1,1
TRAV8-3,TRAJ32,CAAGGGATNKLIF,0,3,1,3
TRAV25,TRAJ23,CAGPNDQGGKLIF,0,2,1,2
TRAV13-2,TRAJ40,CAEMDSGTYKYIF,0,1,1,1
TRAV14DV4,TRAJ48,CAMNGFGNEKLTF,0,1,1,1
TRAV30,TRAJ30,CGTESFSRGKIIF,0,1,1,1
TRAV20,TRAJ54,CAVQALPQKLVF,0,1,1,1
TRAV21,TRAJ37,CAVTPNTGKLIF,0,1,1,1
TRAV12-2,TRAJ43,CAVTNNNNDMRF,0,2,1,2
TRAV13-1,TRAJ7,CAASIGRSRLAF,0,1,1,1
TRAV13-1,TRAJ20,CAASSNDYKLSF,0,1,1,1
TRAV38-1,TRAJ45,CAFMKRMSGGGADGLTF,0,1,1,1
TRAV13-1,TRAJ17,CAARGVVIKAAGNKLTF,0,1,1,1
TRAV14DV4,TRAJ41,CAMREYVNSNSGYALNF,0,2,1,2
TRAV10,TRAJ13,CVVSSTNSGGYQKVTF,0,1,1,1
TRAV19,TRAJ8,CALSEARNTGFQKLVF,0,2,1,2
TRAV16,TRAJ58,CALNRTKETSGSRLTF,0,1,1,1
TRAV8-3,TRAJ13,CAVGAGLSGGYQKVTF,0,1,1,1
TRAV21,TRAJ41,CAVRDQNSNSGYALNF,0,2,1,2
TRAV13-1,TRAJ52,CAASRPGGTSYGKLTF,0,2,1,2
TRAV27,TRAJ52,CADINAGGTSYGKLTF,0,2,1,2
TRAV25,TRAJ24,CASRVMTTDSWGKFQF,0,1,1,1
TRAV38-2DV8,TRAJ48,CAYRTPNFGNEKLTF,0,1,1,1
TRAV9-2,TRAJ50,CALSEEATSYDKVIF,0,1,1,1
TRAV6,TRAJ4,CALDPVSGGYNKLIF,0,2,1,2
TRAV19,TRAJ21,CALTKGRDNFNKFYF,0,1,1,1
TRAV20,TRAJ37,CAVIWSSSNTGKLIF,0,1,1,1
TRAV21,TRAJ37,CAVSLGSSNTGKLIF,0,2,1,2
TRAV12-3,TRAJ15,CAVRLANQAGTALIF,0,1,1,1
TRAV35,TRAJ52,CAGQLGGTSYGKLTF,0,1,1,1
TRAV13-1,TRAJ22,CAASNPSGSARQLTF,0,1,1,1
TRAV12-3,TRAJ10,CAMSEPLGGGNKLTF,0,1,1,1
TRAV10,TRAJ28,CVHEVGAGSYQLTF,0,1,1,1
TRAV12-1,TRAJ33,CVVYAPGSNYQLIW,0,2,1,2
TRAV10,TRAJ29,CVVSGNSGNTPLVF,0,1,1,1
TRAV38-2DV8,TRAJ49,CAYRSALSGNQFYF,0,1,1,1
TRAV9-2,TRAJ31,CALSDRGNNARLMF,0,1,1,1
TRAV9-2,TRAJ50,CALRRETSYDKVIF,0,1,1,1
TRAV21,TRAJ10,CAVGPPGGGNKLTF,0,1,1,1
TRAV8-3,TRAJ6,CAVGATGGGYIPTF,0,1,1,1
TRAV3,TRAJ26,CAVRDTGHGQNFVF,0,1,1,1
TRAV2,TRAJ40,CAAGPYSGTYKYIF,0,2,1,2
TRAV38-2DV8,TRAJ32,CARPYGGATNKLIF,0,2,1,2
TRAV29DV5,TRAJ57,CAASGKGGSEKLVF,0,1,1,1
TRAV4,TRAJ4,CLVGDVRGYNKLIF,0,1,1,1
TRAV12-1,TRAJ4,CVVNLGGYNKLIF,0,1,1,1
TRAV6,TRAJ33,CAPPMDSNYQLIW,0,2,1,2
TRAV20,TRAJ34,CAVHPYNTDKLIF,0,1,1,1
TRAV8-4,TRAJ15,CAVSYQAGTALIF,0,2,1,2
TRAV21,TRAJ39,CAVRPNAGNMLTF,0,1,1,1
TRAV20,TRAJ32,CAVRGGATNKLIF,0,1,1,1
TRAV35,TRAJ57,CAGQLGGSEKLVF,0,1,1,1
TRAV35,TRAJ30,CAGPMNRDDKIIF,0,2,1,2
TRAV12-2,TRAJ6,CAVSSGGSYIPTF,0,1,1,1
TRAV13-1,TRAJ6,CAATSGGSYIPTF,0,1,1,1
TRAV4,TRAJ29,CLVGGSGNTPLVF,0,1,1,1
TRAV26-1,TRAJ49,CIVRFHTGNQFYF,0,1,1,1
TRAV12-1,TRAJ11,CVVNRGYSTLTF,0,1,1,1
TRAV9-2,TRAJ49,CALKHTGNQFYF,0,1,1,1
TRAV16,TRAJ29,CAPDSGNTPLVF,0,1,1,1
TRAV8-1,TRAJ20,CAVNGGDYKLSF,0,1,1,1
TRAV29DV5,TRAJ46,CAARGSGDKLTF,0,1,1,1
TRAV41,TRAJ49,CAVKFGNQFYF,0,1,1,1
TRAV8-3,TRAJ21,CAVGDFNKFYF,0,1,1,1
TRAV13-1,TRAJ33,CAANSNYQLIW,0,1,1,1
TRAV22,TRAJ20,CAVNDYKLSF,0,2,1,2
TRAV41,TRAJ42,CAVTTMNYGGSQGNLIF,0,1,1,1
TRAV12-1,TRAJ3,CVVQYSSASKIIF,0,1,1,1
TRAV20,TRAJ37,CAGISGNTGKLIF,0,1,1,1
TRAV13-1,TRAJ16,CAASKKVGFSDGQKLLF,0,2,1,2
TRAV38-1,TRAJ48,CAFMNLLYFGNEKLTF,0,1,1,1
TRAV12-2,TRAJ42,CAVRRYGGSQGNLIF,0,1,1,1
TRAV12-2,TRAJ42,CAVRNYGGSQGNLIF,0,2,1,2
TRAV23DV6,TRAJ53,CAASRSGGSNYKLTF,0,1,1,1
TRAV9-2,TRAJ8,CALSDTTGFQKLVF,0,2,1,2
TRAV17,TRAJ9,CATVRNTGGFKTIF,0,1,1,1
TRAV12-2,TRAJ33,CAVNPPDSNYQLIW,0,1,1,1
TRAV3,TRAJ9,CDVRPNTGGFKTIF,0,2,1,2
TRAV12-3,TRAJ52,CAYAHAGGTSYGKLTF,0,2,1,2
TRAV27,TRAJ52,CAGEAGGTSYGKLTF,0,1,1,1
TRAV14DV4,TRAJ37,CAMREGSGNTGKLIF,0,2,1,2
TRAV12-1,TRAJ49,CVVNRNTGNQFYF,0,2,1,2
TRAV21,TRAJ57,CAVTPLSERLVF,0,2,1,2
TRAV39,TRAJ34,CAVGNTDKLIF,0,2,1,2
TRAV38-1,TRAJ52,CAFRGPSAGGTSYGKLTF,0,1,1,1
TRAV12-2,TRAJ18,CAVKEVDRGSTLGRLYF,0,2,1,2
TRAV26-2,TRAJ42,CILRGMNYGGSQGNLIF,0,1,1,1
TRAV12-1,TRAJ48,CVVTAGGNFGNEKLTF,0,1,1,1
TRAV13-1,TRAJ52,CVASNAGGTSYGKLTF,0,1,1,1
TRAV38-2DV8,TRAJ52,CAYLKGGGTSYGKLTF,0,1,1,1
TRAV8-3,TRAJ52,CAVADAGGTSYGKLTF,0,2,1,2
TRAV21,TRAJ18,CAVRDDRGSTLGRLYF,0,1,1,1
TRAV17,TRAJ18,CATDRDRGSTLGRLYF,0,1,1,1
TRAV12-3,TRAJ42,CAMSGNYGGSQGNLIF,0,1,1,1
TRAV12-1,TRAJ15,CVVNRGREAGTALIF,0,1,1,1
TRAV38-2DV8,TRAJ57,CAYRSGWGGSEKLVF,0,2,1,2
TRAV9-2,TRAJ49,CALSPGRNTGSQFYF,0,1,1,1
TRAV9-2,TRAJ17,CALSGRRAAGNKLTF,0,1,1,1
TRAV19,TRAJ10,CALSEGTGGGNKLTF,0,1,1,1
TRAV9-2,TRAJ13,CALSENSGGYQKVTF,0,1,1,1
TRAV21,TRAJ37,CAVPPPPGNTGKLIF,0,1,1,1
TRAV36DV7,TRAJ53,CAVSYSGGSNYILTF,0,1,1,1
TRAV20,TRAJ28,CAVQASGAGSYQLTF,0,1,1,1
TRAV20,TRAJ44,CAVQDPTGTASKLTF,0,1,1,1
TRAV8-3,TRAJ7,CAVALGAHGNNRLAF,0,1,1,1
TRAV3,TRAJ38,CAVRGFRGNNRKLIW,0,1,1,1
TRAV3,TRAJ17,CAVRDIKAAGNKLTF,0,1,1,1
TRAV17,TRAJ45,CATEESGGGADGLTF,0,1,1,1
TRAV19,TRAJ37,CAQGDGSSNTGKLIF,0,1,1,1
TRAV29DV5,TRAJ53,CAASVSGGSNYKPTF,0,1,1,1
TRAV25,TRAJ29,CAGKYAYSGNTPLVF,0,1,1,1
TRAV13-2,TRAJ13,CAENNTPGGYQKVTF,0,1,1,1
TRAV12-3,TRAJ18,CAMIGRGSTLGRLYF,0,1,1,1
TRAV14DV4,TRAJ58,CAMREGETSGSRLTF,0,1,1,1
TRAV26-2,TRAJ20,CILRSARSNDYKLSF,0,1,1,1
TRAV38-2DV8,TRAJ21,CAYRSLIYFNKFYF,0,1,1,1
TRAV38-2DV8,TRAJ57,CALAPQGGSEKLVF,0,1,1,1
TRAV9-2,TRAJ44,CAPSRAGTASKLTF,0,1,1,1
TRAV21,TRAJ37,CAVPTSSNTGKLIF,0,1,1,1
TRAV8-3,TRAJ47,CAVVIMEYGNKLVF,0,1,1,1
TRAV8-3,TRAJ17,CAVGAMAAGNKLTF,0,1,1,1
TRAV8-3,TRAJ21,CAVGAPPDFNKFYF,0,1,1,1
TRAV8-3,TRAJ17,CAVGARAAGNKLTS,0,1,1,1
TRAV8-3,TRAJ26,CAVGPYGYGQNFVF,0,1,1,1
TRAV21,TRAJ26,CAVGSLVGGQNFVF,0,1,1,1
TRAV3,TRAJ24,CAVSPTDSWGKFQF,0,1,1,1
TRAV3,TRAJ27,CAVRDGTNAGKSTF,0,2,1,2
TRAV17,TRAJ16,CATKPFSDGQKLLF,0,1,1,1
TRAV8-1,TRAJ42,CAVNKAGSQGNLIF,0,1,1,1
TRAV13-1,TRAJ4,CAAPGTGGYNKLIF,0,1,1,1
TRAV13-1,TRAJ44,CAATLTGTASKLTF,0,1,1,1
TRAV13-1,TRAJ48,CAASSYFGNEKLTF,0,1,1,1
TRAV13-1,TRAJ7,CAASILDGNNRLAF,0,1,1,1
TRAV25,TRAJ21,CAGQRGDNFNKFYF,0,1,1,1
TRAV13-2,TRAJ53,CAEISGGSNYKLTF,0,1,1,1
TRAV12-3,TRAJ40,CAMAITSGTYKYIF,0,1,1,1
TRAV12-3,TRAJ6,CAMRESGGSYIPTF,0,2,1,2
TRAV30,TRAJ24,CGTGLTDSWGKFQF,0,1,1,1
TRAV12-1,TRAJ10,CVVLSGGGNKLTF,0,1,1,1
TRAV38-2DV8,TRAJ20,CAYRTSNDYKLSF,0,2,1,2
TRAV9-2,TRAJ24,CALLTDSWGKFQF,0,1,1,1
TRAV41,TRAJ57,CAVGEGGSEKLVF,0,1,1,1
TRAV21,TRAJ34,CAVRSYNTDKLIF,0,1,1,1
TRAV17,TRAJ49,CATAPPGGNQFYF,0,3,1,3
TRAV12-2,TRAJ15,CAVVNQAGTALIF,0,1,1,1
TRAV12-2,TRAJ42,CAVNIRVQGNLIF,0,1,1,1
TRAV12-2,TRAJ22,CAVNTGSARQLTF,0,1,1,1
TRAV29DV5,TRAJ49,CAAPTSTGNQFYF,0,1,1,1
TRAV23DV6,TRAJ33,CAARGASNYQLIW,0,1,1,1
TRAV27,TRAJ38,CAGGAGNNRKLIW,0,1,1,1
TRAV5,TRAJ4,CAEIRGGFNKLIF,0,1,1,1
TRAV12-3,TRAJ29,CAMIASGNTPLVF,0,1,1,1
TRAV30,TRAJ23,CGSLYNQGGKLIF,0,2,1,2
TRAV25,TRAJ48,CSPDTFGNEKLTF,0,1,1,1
TRAV30,TRAJ54,CGPSPGGAQKLVF,0,1,1,1
TRAV12-1,TRAJ27,CVVNWGAGKSTF,0,1,1,1
TRAV12-1,TRAJ34,CVVNRGTDKLIF,0,1,1,1
TRAV9-2,TRAJ21,CALPLNFNKFYF,0,1,1,1
TRAV9-2,TRAJ34,CALLYNTDKLIF,0,1,1,1
TRAV6,TRAJ40,CALSSGTYKYIF,0,1,1,1
TRAV13-2,TRAJ52,CALGGSYGKLTF,0,1,1,1
TRAV9-2,TRAJ20,CALIANDYKLSF,0,1,1,1
TRAV19,TRAJ27,CALSGNAGKSTF,0,1,1,1
TRAV21,TRAJ28,CAVSAGSYQLTF,0,1,1,1
TRAV8-3,TRAJ48,CAVDPGNEKLTF,0,1,1,1
TRAV22,TRAJ3,CAVDSSASKIIF,0,1,1,1
TRAV17,TRAJ41,CATPHSGYALNF,0,1,1,1
TRAV17,TRAJ54,CATAQGAQKLVF,0,1,1,1
TRAV8-1,TRAJ6,CAVTGGSYIPTF,0,1,1,1
TRAV12-2,TRAJ16,CAVRRDGQKLLF,0,1,1,1
TRAV25,TRAJ39,CAGGNAGNMLTF,0,2,1,2
TRAV27,TRAJ20,CAGARGDYKLSF,0,1,1,1
TRAV13-2,TRAJ31,CAETPNNARLMF,0,1,1,1
TRAV13-2,TRAJ20,CAENMGDYKLSF,0,1,1,1
TRAV26-2,TRAJ54,CILRARAQKLVF,0,1,1,1
TRAV20,TRAJ16,CAVERAQKLLF,0,2,1,2
TRAV35,TRAJ27,CAAFNAGKSTF,0,1,1,1
TRAV21,TRAJ41,CASSSGYALNF,0,1,1,1
TRAV13-1,TRAJ31,CAASVNARLMF,0,1,1,1
TRAV13-1,TRAJ20,CAATDGYKLSF,0,2,1,2
TRAV25,TRAJ30,CAGYRDDKIIF,0,1,1,1
TRAV25,TRAJ23,CAGPPGGKLIF,0,1,1,1
TRAV26-1,TRAJ29,CTHSGNTPLVF,0,1,1,1
TRAV38-2DV8,TRAJ43,CAYFDNDMRF,0,1,1,1
TRAV17,TRAJ49,CAPAGNQFYF,0,1,1,1
TRAV12-2,TRAJ31,CAVNNAGLMF,0,1,1,1
TRAV17,TRAJ30,PLTPNDKIIF,0,1,1,1
TRAV38-2DV8,TRAJ33,CPRDYQLIW,0,1,1,1
TRAV3,TRAJ34,CAVHKLIF,0,1,1,1
TRAV9-2,TRAJ35,CAPSDPQGFGNVLHC,0,1,1,1
TRAV41,TRAJ49,CAVGNQFYF,0,1,1,1
TRAV12-1,TRAJ49,CVVNIGRDVGHFQDTGNQFYF,0,2,1,2
TRAV41,TRAJ32,CAVRSVSSLLGGATNKLIF,0,1,1,1
TRAV8-3,TRAJ44,CAVGPLPINTGTASKLTF,0,1,1,1
TRAV8-1,TRAJ38,CAVTINAGNNRKLIW,0,2,1,2
TRAV9-2,TRAJ4,CALRASGGYNKLIF,0,1,1,1
TRAV9-2,TRAJ13,CARVNSGGYPKVTF,0,1,1,1
TRAV41,TRAJ57,CAVLTQGGSEKLVF,0,1,1,1
TRAV3,TRAJ34,CAVRDIKNTDKLIF,0,1,1,1
TRAV19,TRAJ29,CALSEAGNTPLVF,0,1,1,1
TRAV3,TRAJ5,CAVSYTGRRALTF,0,2,1,2
TRAV4,TRAJ3,CLVGGESASKIIF,0,1,1,1
TRAV36DV7,TRAJ40,CAVISGTYKYIF,0,1,1,1
TRAV12-3,TRAJ13,CAIQGGYQKVTF,0,2,1,2
TRAV22,TRAJ45,CAVRTAYRTGGGADGLTF,0,1,1,1
TRAV9-2,TRAJ57,CALSDPFVQGGSEELVF,0,1,1,1
TRAV9-2,TRAJ50,CALKGRKGKTSYDEVIF,0,1,1,1
TRAV36DV7,TRAJ37,CAVERGTGSSNTGKLIF,0,2,1,2
TRAV13-1,TRAJ52,CAASMSAGGTSYGKLTF,0,1,1,1
TRAV38-1,TRAJ20,CAFMKRAGSYDYKLSF,0,1,1,1
TRAV38-2DV8,TRAJ58,CAYRRATITSGSRLTF,0,1,1,1
TRAV8-3,TRAJ38,CAVGAFWAGNNRKLIW,0,1,1,1
TRAV8-3,TRAJ48,CAVGPISNFGNERLTF,0,1,1,1
TRAV21,TRAJ21,CAVRPPRESNFNKFYF,0,2,1,2
TRAV35,TRAJ42,CAGQGNYGGSQGNLIF,0,1,1,1
TRAV12-2,TRAJ38,CAVNHYNAGNNRMLIW,0,1,1,1
TRAV12-2,TRAJ21,CAVKGSREYNFNKFYF,0,1,1,1
TRAV5,TRAJ37,CAVITHGSSNTGKLIF,0,1,1,1
TRAV12-3,TRAJ37,CAMSAFPSGNTGKLIF,0,1,1,1
TRAV4,TRAJ42,CLVGDPSGGSQGNLIF,0,1,1,1
TRAV19,TRAJ11,CALSGPLSGYSTLTF,0,1,1,1
TRAV41,TRAJ35,CAVRSGGGFGNVLHC,0,1,1,1
TRAV41,TRAJ33,CAVRRGMDSNYQLIW,0,1,1,1
TRAV20,TRAJ36,CAVQARVGGANNLFS,0,1,1,1
TRAV8-3,TRAJ10,CAVGILTGGGNKLTF,0,1,1,1
TRAV21,TRAJ3,CAVDEGESSASKIIF,0,1,1,1
TRAV3,TRAJ16,CAVRGVFSDGQKLLF,0,2,1,2
TRAV3,TRAJ7,CAVRDMYYGNNRLAF,0,1,1,1
TRAV22,TRAJ32,CAATNYGGATNKLIF,0,1,1,1
TRAV17,TRAJ58,CATDEVGTSGSRLTF,0,1,1,1
TRAV29DV5,TRAJ15,CAASVINQAGTALIF,0,1,1,1
TRAV12-3,TRAJ58,CAMLYWETSGSRLTF,0,1,1,1
TRAV14DV4,TRAJ4,CAMRGFSGGYNKLIF,0,1,1,1
TRAV12-3,TRAJ8,CAMSGSNTGFQKLVF,0,1,1,1
TRAV26-2,TRAJ45,CIRMYSGGGADGLTF,0,1,1,1
TRAV10,TRAJ34,CVVSDTGNGDKLIF,0,2,1,2
TRAV12-1,TRAJ48,CVVNSNFGNEKLTF,0,1,1,1
TRAV38-1,TRAJ40,CAFMKQSGTYKYIF,0,1,1,1
TRAV6,TRAJ13,CALPPSGGYQKVTF,0,2,1,2
TRAV9-2,TRAJ13,CALIPSGGYQKVTF,0,1,1,1
TRAV9-2,TRAJ9,CALSDITGGFKTIF,0,1,1,1
TRAV9-2,TRAJ9,CALSDEDGGFKTIF,0,1,1,1
TRAV19,TRAJ23,CALSESNQGGKLIF,0,1,1,1
TRAV19,TRAJ54,CALSSFQGAQKLVF,0,1,1,1
TRAV9-2,TRAJ13,CALRDPGGYQKVTF,0,2,1,2
TRAV19,TRAJ32,CALKNGGATNKLIF,0,1,1,1
TRAV16,TRAJ52,CALARGTSYGKLTF,0,1,1,1
TRAV3,TRAJ41,CAVRDPNSGYALNF,0,1,1,1
TRAV3,TRAJ42,CAAPKGGSQGNLIF,0,2,1,2
TRAV17,TRAJ48,CATDYNFGNEKLTF,0,1,1,1
TRAV17,TRAJ37,CATDETGNTGKLIF,0,1,1,1
TRAV17,TRAJ22,CATDRGGSARQLTF,0,1,1,1
TRAV12-2,TRAJ29,CAVNLDSGNTPLVF,0,1,1,1
TRAV12-2,TRAJ15,CAAGIGQAGTALIF,0,1,1,1
TRAV13-1,TRAJ22,CAASLAGSARQLIF,0,1,1,1
TRAV13-1,TRAJ17,CAASIKAAGNKLTF,0,1,1,1
TRAV13-1,TRAJ49,CAASWRTTGNQFYF,0,1,1,1
TRAV29DV5,TRAJ6,CAASGSGGSYIPTF,0,1,1,1
TRAV29DV5,TRAJ42,CAAKIGRSQGNLIF,0,1,1,1
TRAV5,TRAJ22,CADASDVSARQLTF,0,1,1,1
TRAV5,TRAJ5,CAETPDTGRRALTF,0,1,1,1
TRAV13-2,TRAJ45,CAENLRGGADGLTF,0,1,1,1
TRAV13-2,TRAJ17,CAENSGAAGNKLTF,0,1,1,1
TRAV12-3,TRAJ56,CAMSDTGANSKLTF,0,1,1,1
TRAV26-2,TRAJ52,CFHAGGTSYGKLTF,0,1,1,1
TRAV26-2,TRAJ52,CIPPGGTSYGKLTF,0,1,1,1
TRAV26-1,TRAJ39,CIVSVYNAGNMLTF,0,1,1,1
TRAV9-2,TRAJ22,CSISSGSARQLTF,0,1,1,1
TRAV9-2,TRAJ13,CALFSGGYQKVTF,0,1,1,1
TRAV9-2,TRAJ8,CALSDKGFQKLVF,0,1,1,1
TRAV41,TRAJ58,CAVSRTSGSRLTF,0,1,1,1
TRAV8-3,TRAJ23,CAVLYNQGGKLIF,0,1,1,1
TRAV20,TRAJ30,CAVRSSRDDKIIF,0,1,1,1
TRAV8-3,TRAJ11,CAVAPYQYSTLTF,0,1,1,1
TRAV36DV7,TRAJ7,CAVGHHGNNRLAF,0,1,1,1
TRAV21,TRAJ15,CAVTHQAGTALIF,0,1,1,1
TRAV35,TRAJ26,CAGSDNYGQNFVF,0,1,1,1
TRAV2,TRAJ26,CAGFHNYGQNFVF,0,1,1,1
TRAV17,TRAJ13,CATDAKGYQKVTF,0,1,1,1
TRAV21,TRAJ32,CAPGGGATNKLIF,0,1,1,1
TRAV17,TRAJ9,CAVAYTGGFKTIF,0,1,1,1
TRAV12-2,TRAJ48,CAVNMSGNEKLTF,0,1,1,1
TRAV12-2,TRAJ13,CAVKRGGYQKVTF,0,1,1,1
TRAV5,TRAJ12,CAARVGSSYKLIF,0,1,1,1
TRAV12-2,TRAJ11,CAGNIEGYSTLTF,0,1,1,1
TRAV23DV6,TRAJ32,CAGYGGATNKLIF,0,1,1,1
TRAV38-2DV8,TRAJ57,CAHREGGSEKLVF,0,1,1,1
TRAV13-1,TRAJ9,CAASMAGGFKTIF,0,1,1,1
TRAV13-1,TRAJ49,CAASMESGNQFYF,0,1,1,1
TRAV13-1,TRAJ36,CAASKSGANNLFF,0,1,1,1
TRAV23DV6,TRAJ13,CAASKGGYQKVTF,0,1,1,1
TRAV13-1,TRAJ11,CAAREGGYSTLTF,0,2,1,2
TRAV13-1,TRAJ5,CAARSPGRRALTF,0,1,1,1
TRAV5,TRAJ40,CAGGFSGTYKYIF,0,1,1,1
TRAV13-2,TRAJ9,CAENINGGFKTIF,0,1,1,1
TRAV12-3,TRAJ26,CAMRGAYGQNFVF,0,1,1,1
TRAV39,TRAJ27,CAMKEGNAGKSTF,0,1,1,1
TRAV12-1,TRAJ54,CVVNKGAQKLVF,0,1,1,1
TRAV41,TRAJ53,CASPGSNYKLTF,0,1,1,1
TRAV38-2DV8,TRAJ37,CAYASNTGKLIF,0,1,1,1
TRAV19,TRAJ27,CALSSNAGKSTF,0,1,1,1
TRAV41,TRAJ48,CAVFFGNEKLTF,0,1,1,1
TRAV21,TRAJ49,CAVFATGNQFYF,0,1,1,1
TRAV21,TRAJ29,CAVYSGNTPLVF,0,1,1,1
TRAV20,TRAJ42,CAVRGYQGNLIF,0,1,1,1
TRAV2,TRAJ21,CAVEYNFNKFYF,0,1,1,1
TRAV12-2,TRAJ39,CAVNDAGDMLTF,0,1,1,1
TRAV17,TRAJ29,CATQPGNTPLVF,0,1,1,1
TRAV17,TRAJ17,CATGAAGNKLTF,0,1,1,1
TRAV24,TRAJ16,CAFFSDGQKLLF,0,1,1,1
TRAV12-2,TRAJ21,CAVGHNFNKFYF,0,2,1,2
TRAV27,TRAJ49,CAPWGTGNQFYF,0,1,1,1
TRAV13-1,TRAJ44,CAAAGTASKLTF,0,1,1,1
TRAV13-1,TRAJ5,CAASAGRRALTF,0,1,1,1
TRAV13-1,TRAJ11,CAASKGYSTLTF,0,1,1,1
TRAV12-1,TRAJ5,CRVDTGRRALTF,0,1,1,1
TRAV12-1,TRAJ29,CVVDINTPLVF,0,1,1,1
TRAV38-2DV8,TRAJ38,CAYRPRKKLIW,0,1,1,1
TRAV12-2,TRAJ11,CAVNTYSTLTF,0,2,1,2
TRAV13-1,TRAJ48,CAAGGNEKLTF,0,1,1,1
TRAV13-1,TRAJ23,CAAISGGKLIF,0,1,1,1
TRAV23DV6,TRAJ9,CGYTRGFKTIF,0,1,1,1
TRAV3,TRAJ23,CAFQGGKLIF,0,1,1,1
TRAV41,TRAJ43,CAVSNNDMRF,0,1,1,1
TRAV13-2,TRAJ27,CAEHAGKSTF,0,1,1,1
TRAV27,TRAJ6,CQGSYIPTF,0,1,1,1
TRAV12-1,TRAJ41,CVVNPRPNSGYALNF,0,1,1,1
TRAV8-3,TRAJ9,CAVGLNTGGFKTIF,0,2,1,2
TRAV2,TRAJ31,CAVEESNARLMF,0,2,1,2
TRAV26-1,TRAJ20,CIVLGRGYKLSF,0,2,1,2
TRAV26-1,TRAJ34,CIVSSKTDKLIF,0,2,1,2
TRAV26-2,TRAJ53,CILRDRGGSIYKLTF,0,2,1,2
TRAV26-1,TRAJ37,CITLIGSGNTGKLIF,0,1,1,1
TRAV9-2,TRAJ9,CALSVPGGGFKTIF,0,2,1,2
TRAV8-4,TRAJ7,CAVSERGNNRLAF,0,2,1,2
TRAV30,TRAJ45,CGTELGRRVYSGGGADGLTF,0,1,1,1
TRAV36DV7,TRAJ42,CAVLRGPKFYGGSQGNLIF,0,2,1,2
TRAV12-2,TRAJ16,CAPLPTCRGCRDGQKLLF,0,1,1,1
TRAV14DV4,TRAJ18,CAILLAERRGSTLGRLYF,0,1,1,1
TRAV12-3,TRAJ28,CAMSARGNSGAGSYQLTF,0,1,1,1
TRAV17,TRAJ57,CASPSRDPQGGSEKLVF,0,1,1,1
TRAV16,TRAJ45,CALGLRGAGGGADGLTF,0,1,1,1
TRAV41,TRAJ42,CAVRPGNYGGSQGNLIF,0,1,1,1
TRAV20,TRAJ4,CAVQADYLSGGYNMLIF,0,1,1,1
TRAV29DV5,TRAJ52,CAARVDAGGTSYGKLTF,0,1,1,1
TRAV30,TRAJ38,CGTEKNPSAGNNRKLIW,0,1,1,1
TRAV12-1,TRAJ37,CVVNNDSASNTGKLIF,0,1,1,1
TRAV38-1,TRAJ42,CAFPMNYGGSQGNLIF,0,1,1,1
TRAV38-2DV8,TRAJ28,CAYTRYSGAGSYQLTF,0,1,1,1
TRAV38-2DV8,TRAJ56,CAYRSARTGANSKLTF,0,1,1,1
TRAV9-2,TRAJ52,CALKRAGGTSYGKLTF,0,1,1,1
TRAV16,TRAJ10,CALSGRQAGGGNKLTF,0,1,1,1
TRAV22,TRAJ28,CAVAAYSGAGSYQLTF,0,1,1,1
TRAV8-3,TRAJ28,CAVGAPPGAGSYQLTF,0,1,1,1
TRAV8-3,TRAJ10,CAVGEVLTGGGNKLTF,0,1,1,1
TRAV2,TRAJ28,CAVEKGSGAGSYQLTF,0,1,1,1
TRAV3,TRAJ3,CAVRREAGSSASKIIF,0,1,1,1
TRAV3,TRAJ5,CAVRPTFDTGRRALTF,0,1,1,1
TRAV12-2,TRAJ53,CAVRGSGGGSNYKLTF,0,1,1,1
TRAV12-2,TRAJ18,CAARGRRGSTLGRLYF,0,1,1,1
TRAV27,TRAJ42,CAGLMNYGGSQGNLIF,0,1,1,1
TRAV29DV5,TRAJ42,CAATKTLGGSQGNLIF,0,2,1,2
TRAV29DV5,TRAJ49,CAASQRSPSTGNQFYF,0,1,1,1
TRAV29DV5,TRAJ39,CAASARFANAGNMLTF,0,1,1,1
TRAV27,TRAJ42,CAGDEDYGGSQGNLIF,0,1,1,1
TRAV12-3,TRAJ42,CAMSPYYGGSQGNLIF,0,1,1,1
TRAV26-2,TRAJ38,CILRDVGAGNNRKLIW,0,1,1,1
TRAV26-2,TRAJ49,CILRDIPRKAGNQFYF,0,1,1,1
TRAV26-1,TRAJ5,CIVRVGEDTGRRALTF,0,1,1,1
TRAV10,TRAJ13,CVVSFDSGGYQKVTF,0,1,1,1
TRAV38-1,TRAJ23,CAFMKPGNQGGKLIF,0,1,1,1
TRAV38-2DV8,TRAJ47,CAYRSAVYNGNKLVF,0,1,1,1
TRAV19,TRAJ6,CALSEPKGGSYIPTF,0,1,1,1
TRAV19,TRAJ31,CALSEARNNNARLMF,0,1,1,1
TRAV19,TRAJ27,CALSEGSTNAGKSTF,0,1,1,1
TRAV9-2,TRAJ45,CALRDSGGGADGLTF,0,1,1,1
TRAV16,TRAJ17,CALSSIKAAGNKLTF,0,1,1,1
TRAV17,TRAJ18,CAHFDRGSTLGRLYF,0,1,1,1
TRAV2,TRAJ27,CAVSGSDTNAGKSTF,0,1,1,1
TRAV20,TRAJ39,CAVQPVRGTGNMVTF,0,1,1,1
TRAV20,TRAJ13,CAVQVRSGGYQKVTF,0,1,1,1
TRAV20,TRAJ15,CAVQAVNQAGTALIF,0,1,1,1
TRAV2,TRAJ36,CAVEQYQTGANNLFF,0,1,1,1
TRAV8-1,TRAJ48,CAVRITNFGNEKLTF,0,1,1,1
TRAV12-2,TRAJ39,CAVNLNNNAGNMLTF,0,1,1,1
TRAV12-2,TRAJ13,CAVKRDSGGYQKVTF,0,1,1,1
TRAV29DV5,TRAJ42,CAASVYGGSQGNLIF,0,1,1,1
TRAV14DV4,TRAJ16,CAPKEGFSDGQKLLF,0,1,1,1
TRAV23DV6,TRAJ58,CAAALQETSGSRLTF,0,1,1,1
TRAV13-2,TRAJ45,CAEKESGGGADGLTF,0,1,1,1
TRAV12-3,TRAJ11,CAMSLMNSGYSTLTF,0,1,1,1
TRAV12-3,TRAJ52,CAMSAGGTSYGKLTF,0,1,1,1
TRAV12-3,TRAJ48,CAMSASNFGNEKLTF,0,1,1,1
TRAV26-1,TRAJ56,CIVSSETGANSKLTF,0,1,1,1
TRAV12-1,TRAJ23,CVVIFYNQGGKLIF,0,1,1,1
TRAV12-1,TRAJ8,CVVNLNTGFQKLVF,0,1,1,1
TRAV12-1,TRAJ4,CVVKFSGGYNKLIF,0,2,1,2
TRAV12-1,TRAJ26,CVTFRDNYGQNFVF,0,1,1,1
TRAV38-1,TRAJ27,CAFMKHTNAGKSTF,0,1,1,1
TRAV38-2DV8,TRAJ54,CAYRSALGAQKLVF,0,1,1,1
TRAV9-2,TRAJ10,CALTHTGGGNKLTF,0,1,1,1
TRAV19,TRAJ20,CALSYPSGDYKLSF,0,1,1,1
TRAV9-2,TRAJ45,CALSDEGGADGLTF,0,1,1,1
TRAV19,TRAJ20,CALSEVSNDYKLCF,0,1,1,1
TRAV9-2,TRAJ9,CALNKNTGGFKTIF,0,1,1,1
TRAV9-2,TRAJ57,CALNREGGSEKLVF,0,1,1,1
TRAV6,TRAJ5,CALEPDTGRRALTF,0,1,1,1
TRAV41,TRAJ45,CAVYSGGGADGLTF,0,1,1,1
TRAV2,TRAJ10,CAVGGTGGGNKLTF,0,1,1,1
TRAV41,TRAJ45,CAVKIGGGADGLTF,0,1,1,1
TRAV8-3,TRAJ38,CAVGGAGNNRKLIW,0,1,1,1
TRAV36DV7,TRAJ30,CAVGGLTGDDKIIF,0,1,1,1
TRAV2,TRAJ29,CAVERGGGNTPLVF,0,1,1,1
TRAV12-2,TRAJ36,CAVMGRAGANNLFF,0,1,1,1
TRAV3,TRAJ36,CAVRDRPGANNLFF,0,1,1,1
TRAV35,TRAJ10,CAGHTTGGGNKLTF,0,2,1,2
TRAV17,TRAJ28,CATLSGAGSYQLTF,0,1,1,1
TRAV17,TRAJ40,CATDSASGTYKYIF,0,1,1,1
TRAV8-1,TRAJ48,CAVNPPFGNEKLTF,0,1,1,1
TRAV12-2,TRAJ53,CAGNSGGSNYKLTF,0,1,1,1
TRAV13-1,TRAJ49,CAASLSDTGNQFYF,0,1,1,1
TRAV13-1,TRAJ52,CAASLDTSYGKLTF,0,1,1,1
TRAV13-1,TRAJ32,CAASVGGATNKLIF,0,1,1,1
TRAV29DV5,TRAJ13,CAASAAGGYQKVTF,0,1,1,1
TRAV29DV5,TRAJ58,CAASARTSGSRLTF,0,1,1,1
TRAV13-1,TRAJ9,CAARGNTGGFKTIF,0,1,1,1
TRAV27,TRAJ13,CAGATGGGYQKVTF,0,1,1,1
TRAV13-2,TRAJ54,CAEIPPSGAQKLVF,0,1,1,1
TRAV5,TRAJ9,CAETSSTGGFKTIF,0,1,1,1
TRAV14DV4,TRAJ37,CAMLGSSNTGKLIF,0,1,1,1
TRAV12-3,TRAJ53,CAMSGGGSNYKLTF,0,1,1,1
TRAV12-3,TRAJ15,CAMSLNQAGTALIF,0,1,1,1
TRAV12-3,TRAJ3,CAMSGDSSASKIIF,0,1,1,1
TRAV4,TRAJ9,CLVGDLNGGFKTIF,0,1,1,1
TRAV4,TRAJ26,CLVGDRDYGQNFVF,0,1,1,1
TRAV4,TRAJ5,CLVERPTGRRALTF,0,1,1,1
TRAV17,TRAJ10,CATAPTGGGNKLTF,0,1,1,1
TRAV26-2,TRAJ44,CILRPTGTASKLTF,0,1,1,1
TRAV26-2,TRAJ23,CILREYNQGGKLIF,0,1,1,1
TRAV26-2,TRAJ41,CILNSLDSGYALNF,0,1,1,1
TRAV8-3,TRAJ3,RAVGGYSSASKIIF,0,1,1,1
TRAV8-2,TRAJ54,CVVTPKGAQKLVF,0,1,1,1
TRAV12-1,TRAJ49,CVVLDPSGNQFYF,0,1,1,1
TRAV12-1,TRAJ9,CVVTQTGGFKTIF,0,1,1,1
TRAV12-1,TRAJ23,CVVNNNQGGKLIF,0,1,1,1
TRAV38-2DV8,TRAJ42,CAYYGGSQGNLIF,0,1,1,1
TRAV38-2DV8,TRAJ47,CAYRVGYGNELVF,0,1,1,1
TRAV6,TRAJ3,CALLNSSASKIIF,0,1,1,1
TRAV6,TRAJ15,CALVNQAGTALIF,0,1,1,1
TRAV12-2,TRAJ44,CALSTGTASKLTF,0,1,1,1
TRAV9-2,TRAJ57,CALSKGGSEKLVF,0,1,1,1
TRAV19,TRAJ36,CALRLIGANNLFF,0,1,1,1
TRAV16,TRAJ58,CALKETSGSRLTF,0,1,1,1
TRAV22,TRAJ4,CAVPSGGYNKLIF,0,1,1,1
TRAV36DV7,TRAJ40,CAVLGSGTYKYVF,0,1,1,1
TRAV3,TRAJ9,CAVYHTGGFKTIF,0,1,1,1
TRAV22,TRAJ3,CAVPYSSASKIIF,0,1,1,1
TRAV2,TRAJ16,CAVEDRSGQKLLF,0,1,1,1
TRAV22,TRAJ39,CAVNNNAGNMLTF,0,1,1,1
TRAV20,TRAJ24,CAVKADSWGKFQF,0,1,1,1
TRAV35,TRAJ39,CAGQDNAGNMLTF,0,1,1,1
TRAV17,TRAJ8,CATLNTGFQKLVF,0,1,1,1
TRAV17,TRAJ58,CATGSSSGSRLTF,0,1,1,1
TRAV24,TRAJ52,CAFIGTSYGKLTF,0,1,1,1
TRAV23DV6,TRAJ4,CAPGAGGYNKLIF,0,1,1,1
TRAV12-2,TRAJ26,CAVYDNYGQNFVF,0,1,1,1
TRAV12-2,TRAJ40,CAVASSGTYKYIF,0,1,1,1
TRAV12-2,TRAJ21,CAVRGGNFNKFYF,0,1,1,1
TRAV12-2,TRAJ39,CAVRNNAGNVVTF,0,1,1,1
TRAV12-2,TRAJ22,CAVNSGSARQLTF,0,1,1,1
TRAV8-1,TRAJ47,CAVNARGGNKLVL,0,1,1,1
TRAV12-2,TRAJ23,CAVNINPRGKLIF,0,1,1,1
TRAV12-3,TRAJ35,CAAGKGFGNMLHC,0,1,1,1
TRAV23DV6,TRAJ34,CAAHHDQTDKLIF,0,1,1,1
TRAV23DV6,TRAJ16,CAARTADGQKLLF,0,1,1,1
TRAV27,TRAJ30,CAGLSNRDDKIIF,0,1,1,1
TRAV27,TRAJ29,CAGRDSGNTPLVF,0,1,1,1
TRAV13-2,TRAJ54,CAENHQGAQKLAF,0,1,1,1
TRAV12-3,TRAJ33,CAIYMDSNYQLIW,0,1,1,1
TRAV12-3,TRAJ53,CAMPGGSNYKLTF,0,1,1,1
TRAV12-3,TRAJ26,CAMIGSYGQNFVF,0,1,1,1
TRAV12-3,TRAJ11,CAMKNSGYSTLTF,0,1,1,1
TRAV12-3,TRAJ13,CATESGGYQKVTF,0,1,1,1
TRAV4,TRAJ7,CLVGEWGNNRLAF,0,1,1,1
TRAV30,TRAJ40,CGTRTSGTYKYIL,0,1,1,1
TRAV26-1,TRAJ4,CIVPRGGYNKLIF,0,1,1,1
TRAV26-1,TRAJ44,CIVNTGTASKLTF,0,1,1,1
TRAV34,TRAJ10,CCLTGGGNKLTF,0,2,1,2
TRAV12-1,TRAJ37,CVVRSNTGKLIF,0,1,1,1
TRAV12-1,TRAJ9,CVVTQGGFKTIF,0,1,1,1
TRAV12-1,TRAJ26,CVVNNYGQNFVF,0,1,1,1
TRAV12-1,TRAJ21,CVALYNFNKFYF,0,1,1,1
TRAV9-2,TRAJ26,CALHNYGQNFVF,0,1,1,1
TRAV9-2,TRAJ29,CALFSGNTPLVF,0,1,1,1
TRAV9-2,TRAJ31,CALMDLGARLMF,0,1,1,1
TRAV16,TRAJ17,CALGAAGNKLTF,0,1,1,1
TRAV2,TRAJ11,CAVVKGYSTLTF,0,1,1,1
TRAV22,TRAJ58,CAVGTSGSRLTF,0,1,1,1
TRAV2,TRAJ34,CAVEDGSDKLIF,0,1,1,1
TRAV21,TRAJ37,CAVMGNTGKLIF,0,1,1,1
TRAV21,TRAJ22,CAAPGSARQLTF,0,1,1,1
TRAV20,TRAJ10,CAATGGGNKLTF,0,1,1,1
TRAV17,TRAJ10,CATGGGGNKLTF,0,1,1,1
TRAV17,TRAJ11,CATDTGYSTLTF,0,1,1,1
TRAV17,TRAJ58,CATETSGSRLTF,0,2,1,2
TRAV41,TRAJ58,CALQTSGSRLTF,0,1,1,1
TRAV12-2,TRAJ26,CAVRGYGQNFVF,0,1,1,1
TRAV12-2,TRAJ45,CAVRGGADGLTF,0,1,1,1
TRAV8-1,TRAJ20,CAADPNDYKLSF,0,1,1,1
TRAV13-1,TRAJ26,CAARDYGQNFVF,0,1,1,1
TRAV29DV5,TRAJ43,CAASMNGNDMRF,0,1,1,1
TRAV29DV5,TRAJ30,CAASKRDVKIIF,0,1,1,1
TRAV27,TRAJ37,CAGDADTGKLIF,0,1,1,1
TRAV12-3,TRAJ29,CAIHSGNTPLVF,0,1,1,1
TRAV9-2,TRAJ45,CARGGGADGLTF,0,1,1,1
TRAV20,TRAJ31,SAVLTNNARLMF,0,1,1,1
TRAV4,TRAJ43,SLVGYNNNDMRF,0,1,1,1
TRAV9-2,TRAJ49,CALNLRDQFYF,0,1,1,1
TRAV23DV6,TRAJ9,CAHTGGFKTIF,0,1,1,1
TRAV8-3,TRAJ50,CAVGVRDKVIF,0,1,1,1
TRAV22,TRAJ20,CAEFNDYKLSF,0,1,1,1
TRAV17,TRAJ49,CATNTGNQFYF,0,1,1,1
TRAV8-1,TRAJ23,CAVNWRGKLIF,0,1,1,1
TRAV23DV6,TRAJ15,CAAGRGTALIF,0,1,1,1
TRAV17,TRAJ57,CTQGGSEKLVF,0,1,1,1
TRAV4,TRAJ12,CRRDSSYKLIF,0,1,1,1
TRAV17,TRAJ30,CATVAGDKIIF,0,1,1,1
TRAV38-2DV8,TRAJ49,CASRGNQFYF,0,1,1,1
TRAV6,TRAJ34,CALPSHRLIF,0,1,1,1
TRAV16,TRAJ31,CALSSGRLMF,0,1,1,1
TRAV13-2,TRAJ27,CAEHAGKSTL,0,1,1,1
TRAV14DV4,TRAJ48,CAIVNEKLTF,0,1,1,1
TRAV38-2DV8,TRAJ17,CAYMIKAAGNKLTF,0,2,1,2
TRAV6,TRAJ5,CALSEYTGGRALTF,0,1,1,1
TRAV17,TRAJ18,CATDRGSTLGRLYF,0,2,1,2
TRAV39,TRAJ30,CAVDTKNRDDKIIF,0,1,1,1
TRAV12-3,TRAJ4,CAIRFSGAYNKLIF,0,1,1,1
TRAV26-1,TRAJ17,CIVRVKAAGNKLTF,0,2,1,2
TRAV23DV6,TRAJ10,RAVRLTGGGNKLTF,0,1,1,1
TRAV12-2,TRAJ42,CAVTGGYGGSQGDLIF,0,1,1,1
TRAV13-1,TRAJ42,CAASPYGGSQGNLIF,0,2,1,2
TRAV6,TRAJ9,CALPNTGGFKTIF,0,1,1,1
TRAV12-2,TRAJ31,CAVNDNARLMF,0,2,1,2
TRAV41,TRAJ45,CAVRSLFGNEKLTFGTGTRLTIIPRGGADGLTF,0,1,1,1
TRAV29DV5,TRAJ45,CAASEFDRVLTRSGGGADGLTF,0,1,1,1
TRAV12-3,TRAJ52,CAMSAGRDAGGTSYGKLTF,0,1,1,1
TRAV12-3,TRAJ52,CAMSDGANAGGTSYGKLTF,0,1,1,1
TRAV19,TRAJ52,CALSEPGSRGTSYGKLTF,0,1,1,1
TRAV20,TRAJ52,CAVAHNNAGGTSYGKLTF,0,1,1,1
TRAV21,TRAJ45,CAVKRPRDSGGGADGLTF,0,1,1,1
TRAV35,TRAJ47,CAGRHPRDDMESGNKLVF,0,1,1,1
TRAV12-1,TRAJ13,CVVPHDYNSGGYQKVTF,0,1,1,1
TRAV12-1,TRAJ52,CVVKSNAGGTSYGKLTF,0,1,1,1
TRAV38-2DV8,TRAJ22,CAYRSTVSSGSARQLTF,0,1,1,1
TRAV38-2DV8,TRAJ42,CAYRSAYYGGSQGNLIF,0,1,1,1
TRAV38-2DV8,TRAJ53,CAYRRLNSGGSNYKLTF,0,1,1,1
TRAV19,TRAJ35,CALSEAPGGGFGNVLHC,0,1,1,1
TRAV19,TRAJ32,CALSEGLYGGATNKLIF,0,1,1,1
TRAV8-1,TRAJ42,CAVNEMNYGGSQGNLIF,0,1,1,1
TRAV30,TRAJ28,CGTAHSYSGAGSYQLAF,0,1,1,1
TRAV26-1,TRAJ53,CIVRVANSGGSNYKLTF,0,1,1,1
TRAV26-1,TRAJ44,CIVRASRITGTASKLTF,0,1,1,1
TRAV38-1,TRAJ53,CAFMKPSGGSNYKLTF,0,1,1,1
TRAV38-2DV8,TRAJ35,CAYRSGVGGFGNVLHC,0,1,1,1
TRAV38-2DV8,TRAJ53,CAYRRGGGGSNYKLTF,0,1,1,1
TRAV19,TRAJ56,CALTPRDTGANSKLTF,0,1,1,1
TRAV19,TRAJ58,CALRAREETSGSRLTF,0,1,1,1
TRAV16,TRAJ48,CALSDISNFGNEKLTF,0,1,1,1
TRAV41,TRAJ54,CAVRPFGIQGAQKLVF,0,1,1,1
TRAV41,TRAJ53,CAVRRRSGGSNYKLTF,0,1,1,1
TRAV41,TRAJ42,CAVKRNYGGSQGNLIF,0,1,1,1
TRAV8-3,TRAJ40,CAVGTLTTSGTYKYIF,0,1,1,1
TRAV8-4,TRAJ13,CAVSAGNSGGYQKVTF,0,1,1,1
TRAV12-2,TRAJ28,CAVRLYSEAGSYQLTF,0,1,1,1
TRAV21,TRAJ9,CAVRPPARTGGFKTIF,0,1,1,1
TRAV3,TRAJ10,CAVRDSLTGGGNKLTF,0,1,1,1
TRAV3,TRAJ28,CAVRDMTGAGSYQLTF,0,1,1,1
TRAV17,TRAJ53,CATPGRSGGSNYKLTF,0,1,1,1
TRAV16,TRAJ42,CALGYLGGGSQGNLIF,0,1,1,1
TRAV20,TRAJ23,CAQAGVSKDQGGKLIF,0,1,1,1
TRAV12-2,TRAJ28,CAVTLSSGTGSYQLTF,0,1,1,1
TRAV13-1,TRAJ10,CAASSRGTEGGNKLTF,0,1,1,1
TRAV23DV6,TRAJ36,CAASPQRQTGANNLFF,0,1,1,1
TRAV29DV5,TRAJ53,CAASMRSGGSNYKLTF,0,1,1,1
TRAV23DV6,TRAJ18,CAASTVRGSTLGRLYF,0,1,1,1
TRAV12-3,TRAJ10,CAMSARLTGGGNKLTF,0,1,1,1
TRAV12-3,TRAJ53,CAMSAHSGGSNYKLTF,0,1,1,1
TRAV14DV4,TRAJ23,CAMREGIHNQGGKLIF,0,1,1,1
TRAV4,TRAJ38,CLVGDGSAGNNRKLIW,0,1,1,1
TRAV26-2,TRAJ28,CILRSHPGAGSYQLTF,0,1,1,1
TRAV26-2,TRAJ61,CILRNHRYRVNRKLTF,0,1,1,1
TRAV26-1,TRAJ10,CIVSRILTGGGNKLTF,0,1,1,1
TRAV8-2,TRAJ41,CVVSANSNSGYALNF,0,1,1,1
TRAV10,TRAJ17,CVVGHQQAAGNKLTF,0,1,1,1
TRAV12-1,TRAJ47,CVVNPSREYGNKLVF,0,1,1,1
TRAV12-1,TRAJ18,CVVNDGGSTLGRLYF,0,1,1,1
TRAV12-1,TRAJ15,CVVNIPNQAGTALIF,0,1,1,1
TRAV12-1,TRAJ38,CVVNTHAGNNRKLIW,0,1,1,1
TRAV9-2,TRAJ24,CALQRSTDSWGKFQF,0,1,1,1
TRAV9-2,TRAJ13,CALIPLSGGYQKVTF,0,1,1,1
TRAV19,TRAJ37,CALTEGSSNTGKLIF,0,1,1,1
TRAV9-2,TRAJ56,CALSDSPGANSKPTF,0,1,1,1
TRAV9-2,TRAJ20,CALSDQQLNDYKLSF,0,1,1,1
TRAV19,TRAJ58,CALSERETSGSRLTF,0,1,1,1
TRAV9-2,TRAJ10,CALSSFTGGGNKLTF,0,1,1,1
TRAV23DV6,TRAJ42,CALLNYGGSQGNLIF,0,1,1,1
TRAV16,TRAJ52,CALMKGGTSYGKLTF,0,1,1,1
TRAV19,TRAJ38,CAPLPNAGNNRKLIW,0,1,1,1
TRAV2,TRAJ23,CAVPPIYNQGGKLIF,0,1,1,1
TRAV20,TRAJ57,CAVPPAQGGSEKLVF,0,1,1,1
TRAV20,TRAJ22,CAVRGDGGSARQLTF,0,1,1,1
TRAV20,TRAJ30,CAVQYLMNRDDKIIF,0,1,1,1
TRAV20,TRAJ9,CAVQPEWTGGFKTIF,0,1,1,1
TRAV8-3,TRAJ4,CAVGSFSGGYNKLIF,0,1,1,1
TRAV8-3,TRAJ3,CAVGGLYSSASKIIF,0,1,1,1
TRAV8-3,TRAJ34,CAVGEESYNTDKLIF,0,1,1,1
TRAV8-3,TRAJ45,CAVGTSGGGADGLTF,0,1,1,1
TRAV22,TRAJ7,CAVERSLYGNNRLAF,0,1,1,1
TRAV2,TRAJ15,CAVEQTNQAGTALIF,0,1,1,1
TRAV2,TRAJ29,CAVEDENSGNTPLVF,0,1,1,1
TRAV21,TRAJ28,CAVTLTGAGSYQLTF,0,1,1,1
TRAV3,TRAJ5,CAVRVSDTGRRALTF,0,1,1,1
TRAV3,TRAJ9,CAVRDAGSPHFKTIF,0,1,1,1
TRAV3,TRAJ6,CAVRDIRGGSYIPTF,0,1,1,1
TRAV3,TRAJ7,CAVRDTALGNNRLAF,0,1,1,1
TRAV3,TRAJ9,CAVRERETGGFKTIF,0,1,1,1
TRAV2,TRAJ26,CAGHHRDNYGQNLVF,0,1,1,1
TRAV35,TRAJ22,CAGRTSSGSARQLTF,0,1,1,1
TRAV35,TRAJ38,CAGHHNAGNNRKLIW,0,1,1,1
TRAV35,TRAJ43,CAGHIRPYNNNDMRF,0,1,1,1
TRAV17,TRAJ3,CATDTGLSSASKIIF,0,1,1,1
TRAV17,TRAJ16,CATESPFSDGQKLLF,0,1,1,1
TRAV12-2,TRAJ28,CASLFAGAGSYQLTF,0,1,1,1
TRAV12-2,TRAJ3,CAVPEGYSSASKIIF,0,1,1,1
TRAV8-1,TRAJ38,CAVNALAGNNRKLIW,0,1,1,1
TRAV8-1,TRAJ28,CAVNAVGAGSYQLTF,0,1,1,1
TRAV12-2,TRAJ33,CAVKDRMDSNYQLIW,0,1,1,1
TRAV12-1,TRAJ12,CAAAVLMDSSYKLIF,0,1,1,1
TRAV5,TRAJ32,CAAWLSGGATNKLIF,0,1,1,1
TRAV13-1,TRAJ41,CAASTASNSGYALNF,0,2,1,2
TRAV13-1,TRAJ13,CAASKRSGGYQKVTF,0,1,1,1
TRAV23DV6,TRAJ44,CAASAPAGTAGKLTF,0,1,1,1
TRAV29DV5,TRAJ22,CAASRDPGSARQLTF,0,1,1,1
TRAV27,TRAJ18,CAGRYRGSTLGRLYF,0,1,1,1
TRAV27,TRAJ53,CAGARSGGSNYKLAF,0,1,1,1
TRAV27,TRAJ53,CAGEGGGGSNYKLTF,0,1,1,1
TRAV12-3,TRAJ6,CAMSGEAGGSYIPTF,0,1,1,1
TRAV12-3,TRAJ36,CAMSGIRTGANNLFF,0,1,1,1
TRAV14DV4,TRAJ3,CAMRDGYSSASKIIF,0,1,1,1
TRAV14DV4,TRAJ27,CAMREGKTNAGKSTF,0,1,1,1
TRAV4,TRAJ22,CLVAPTFGSARQLTF,0,1,1,1
TRAV4,TRAJ23,CLVGALYNQGGKLIF,0,1,1,1
TRAV4,TRAJ20,CLVGALSSNDYKLSF,0,1,1,1
TRAV4,TRAJ27,CLVGDGATNAGKSTF,0,1,1,1
TRAV4,TRAJ26,CLVGDIRNYGQNFVF,0,1,1,1
TRAV26-1,TRAJ18,CIVRVRGSTLGRLYF,0,1,1,1
TRAV26-1,TRAJ27,CIVNTRNTNAGKSTF,0,1,1,1
TRAV26-1,TRAJ13,CIARRFSGGYQKVTF,0,1,1,1
TRAV12-1,TRAJ13,CVVESSGGYQKVTF,0,1,1,1
TRAV12-1,TRAJ41,CVVTLSNSGYALNF,0,1,1,1
TRAV10,TRAJ4,CVAAFSGGYNKLIF,0,1,1,1
TRAV6,TRAJ9,CALHTLTGGFKTIF,0,1,1,1
TRAV9-2,TRAJ30,CALTGPNRDDKIIF,0,1,1,1
TRAV9-2,TRAJ26,CALSTLNYGQNFVF,0,1,1,1
TRAV19,TRAJ7,CALKEEKGNNRLAF,0,1,1,1
TRAV16,TRAJ36,CALSAYAGANNLFF,0,1,1,1
TRAV16,TRAJ37,CALKGSGNTGKLIF,0,1,1,1
TRAV41,TRAJ49,CAVPPLNTGNQFYF,0,1,1,1
TRAV41,TRAJ31,CAVRTGANNARLMF,0,1,1,1
TRAV8-3,TRAJ26,CAVVFDNYGQNFVF,0,1,1,1
TRAV8-3,TRAJ48,CAVGVGFGNEKLTF,0,1,1,1
TRAV8-3,TRAJ4,CAVGVTGGYNKLIF,0,1,1,1
TRAV8-3,TRAJ33,CAVGPMDSNYQLIW,0,1,1,1
TRAV22,TRAJ13,CAVERAGGYQKVTF,0,1,1,1
TRAV2,TRAJ17,CAVEDRAAGNKLTF,0,1,1,1
TRAV2,TRAJ37,CAVEDGGNTGKLIF,0,1,1,1
TRAV21,TRAJ56,CAVIPTGANSKLTF,0,1,1,1
TRAV8-6,TRAJ12,CAVSFDDSSYKLIF,0,1,1,1
TRAV8-4,TRAJ40,CAVSVASGTYKYIF,0,1,1,1
TRAV8-6,TRAJ6,CAVSDRGGSYIPTF,0,1,1,1
TRAV12-2,TRAJ9,CAVRRNTGGFKTIF,0,1,1,1
TRAV8-6,TRAJ57,CAVRTGGGSEKLVF,0,1,1,1
TRAV3,TRAJ3,CAVRGGSSASKIIF,0,1,1,1
TRAV3,TRAJ9,CAVRDPTGGFKTIF,0,1,1,1
TRAV36DV7,TRAJ36,CAAPRPTGANNLFF,0,1,1,1
TRAV35,TRAJ48,CAGQLNFGNEKLTF,0,1,1,1
TRAV12-2,TRAJ18,CAVSRGSTLGRLYF,0,1,1,1
TRAV12-2,TRAJ49,CAVNKPNTGNQFYF,0,1,1,1
TRAV29DV5,TRAJ45,CAARGGGGADGLTF,0,1,1,1
TRAV23DV6,TRAJ42,CAVSQGGSQGNLIF,0,1,1,1
TRAV27,TRAJ28,CAAYSGAGSYQLTF,0,1,1,1
TRAV29DV5,TRAJ12,CAARRRDSSYKLIF,0,1,1,1
TRAV13-1,TRAJ23,CAAVAYNQGGKLIF,0,1,1,1
TRAV13-1,TRAJ34,CAASSSYNTDKLIF,0,1,1,1
TRAV13-1,TRAJ48,CAASRAFGNEKLTF,0,1,1,1
TRAV29DV5,TRAJ48,CAASSDFGNEKLTF,0,1,1,1
TRAV13-1,TRAJ47,CAANPTEYGNKLVF,0,1,1,1
TRAV27,TRAJ42,CAGAGAGSQGNLIS,0,1,1,1
TRAV27,TRAJ22,CAGISSGSARQLTF,0,1,1,1
TRAV13-2,TRAJ48,CAENKNFGNEKLTF,0,1,1,1
TRAV13-2,TRAJ44,CAENHTGTASKLTF,0,1,1,1
TRAV12-3,TRAJ20,CAMCRSPNDYKLSF,0,1,1,1
TRAV14DV4,TRAJ3,CAMSPYSSASKIIF,0,1,1,1
TRAV12-3,TRAJ22,CAMSGSGSARQLTF,0,1,1,1
TRAV12-3,TRAJ12,CAMRRMDSSYKSIF,0,1,1,1
TRAV14DV4,TRAJ6,CAMREEGGSYIPTF,0,1,1,1
TRAV14DV4,TRAJ49,CAMRERNTGNQFYF,0,1,1,1
TRAV12-3,TRAJ50,CATQRGTSYDKVIF,0,1,1,1
TRAV34,TRAJ44,CGADSAGTASKLTF,0,2,1,2
TRAV4,TRAJ37,CLVDAPGNTGKLIF,0,1,1,1
TRAV4,TRAJ30,CLVGVMNRDDKIIF,0,1,1,1
TRAV30,TRAJ53,CGTEMRGSNYKLTF,0,1,1,1
TRAV2,TRAJ37,RAVYGSSNTGKLIF,0,1,1,1
TRAV10,TRAJ50,CVCLKTSYDKVIF,0,1,1,1
TRAV38-2DV8,TRAJ42,CASSSGSQGNLIF,0,1,1,1
TRAV2,TRAJ6,CASQGGGSYIPTF,0,1,1,1
TRAV38-2DV8,TRAJ34,CACYGDNTDKLIF,0,1,1,1
TRAV9-2,TRAJ6,CALLYRGSYIPTF,0,1,1,1
TRAV19,TRAJ7,CALSEAGNNRLAF,0,1,1,1
TRAV19,TRAJ11,CALSEAGYSTLTF,0,1,1,1
TRAV9-2,TRAJ50,CALSTPSYDKVIF,0,1,1,1
TRAV9-2,TRAJ40,CALSQSGTYKYIF,0,1,1,1
TRAV6,TRAJ5,CALVGTGRRALTF,0,1,1,1
TRAV41,TRAJ54,CAVRSSGAQKLVF,0,1,1,1
TRAV20,TRAJ49,CAVLPNTGNQFYF,0,1,1,1
TRAV20,TRAJ49,CAVHSNTGNQFYF,0,1,1,1
TRAV8-3,TRAJ42,CAVARGSQGNLIF,0,1,1,1
TRAV8-3,TRAJ13,CAVGPPGYQKVTF,0,1,1,1
TRAV2,TRAJ23,CAVGDNQGGKLIF,0,1,1,1
TRAV2,TRAJ7,CAVEEWGNNRLAF,0,1,1,1
TRAV2,TRAJ4,CAVEIGGYNKLIF,0,1,1,1
TRAV21,TRAJ56,CAVETGANSKLTF,0,1,1,1
TRAV8-4,TRAJ49,CAVSEGTGNQFYF,0,1,1,1
TRAV8-6,TRAJ48,CAVSVFGNEKLTF,0,1,1,1
TRAV8-3,TRAJ28,CAASGAGSYQLTF,0,1,1,1
TRAV22,TRAJ36,CAASLSWANNLFF,0,1,1,1
TRAV35,TRAJ37,CAGRSSNTGKLIF,0,1,1,1
TRAV17,TRAJ34,CATASYNTDKLIF,0,1,1,1
TRAV17,TRAJ6,CATDSRGSYIPTF,0,2,1,2
TRAV24,TRAJ57,CAFREGGSEKLVF,0,1,1,1
TRAV24,TRAJ50,CAFERASYDKVIF,0,1,1,1
TRAV12-2,TRAJ29,CAVPNSGNTPLVF,0,1,1,1
TRAV12-2,TRAJ41,CAVSSNSGYALNF,0,1,1,1
TRAV39,TRAJ27,CAVDRTNAGKSTF,0,1,1,1
TRAV12-2,TRAJ5,CAVEDTGRRALTF,0,1,1,1
TRAV12-2,TRAJ20,CAVSFSNDYKLSF,0,1,1,1
TRAV12-2,TRAJ48,CAVRAFGNEKLTF,0,1,1,1
TRAV8-1,TRAJ13,CAVNAWGYQKVTF,0,1,1,1
TRAV12-2,TRAJ39,CAVNKDAGNMLTF,0,1,1,1
TRAV12-2,TRAJ28,CAGSGAGSYQLTF,0,1,1,1
TRAV12-2,TRAJ10,CAIPTGGGNKLTF,0,1,1,1
TRAV13-1,TRAJ11,CAASIGGYSTLTF,0,1,1,1
TRAV13-1,TRAJ37,CAASKGNTGKLIF,0,1,1,1
TRAV29DV5,TRAJ29,CAARGSGNTPLVF,0,1,1,1
TRAV5,TRAJ41,CAEISNSGYALNF,0,1,1,1
TRAV13-2,TRAJ28,CAEIPHPGYQLTF,0,1,1,1
TRAV13-2,TRAJ41,CAERSNSGYALNF,0,1,1,1
TRAV12-3,TRAJ49,CAMNSNTGNRFYF,0,1,1,1
TRAV4,TRAJ43,CLGGGYNNNDMRF,0,1,1,1
TRAV26-1,TRAJ49,CIVRVNTGNQFYF,0,1,1,1
TRAV12-1,TRAJ22,CVVSGSARQLTF,0,1,1,1
TRAV12-1,TRAJ29,CVVVSGNTPLVF,0,1,1,1
TRAV12-1,TRAJ5,CVVNTGRRALTF,0,1,1,1
TRAV12-1,TRAJ42,CVARGSQGNLIF,0,1,1,1
TRAV22,TRAJ20,CAFPHNDYKLSF,0,1,1,1
TRAV38-1,TRAJ20,CAFMKRDYKLSF,0,1,1,1
TRAV38-2DV8,TRAJ49,CAYRSAGNQFYF,0,1,1,1
TRAV9-2,TRAJ23,CALNNQGGKLIF,0,1,1,1
TRAV9-2,TRAJ22,CALRGSARQLTF,0,1,1,1
TRAV9-2,TRAJ31,CALSDANARLMF,0,1,1,1
TRAV9-2,TRAJ49,CALSPTGNQFYF,0,1,1,1
TRAV12-2,TRAJ9,CARQAGGFKTIF,0,1,1,1
TRAV12-2,TRAJ36,CAVQTGANNLFF,0,1,1,1
TRAV41,TRAJ35,CAVRGFGNVLHC,0,1,1,1
TRAV12-2,TRAJ49,CAVVNTGNQFYF,0,2,1,2
TRAV8-3,TRAJ49,CAVGAGGNQFYF,0,1,1,1
TRAV8-3,TRAJ4,CAVGPRNNKLIF,0,1,1,1
TRAV2,TRAJ21,CAVERDFNKFYF,0,1,1,1
TRAV36DV7,TRAJ36,CAVEVGANNLFF,0,1,1,1
TRAV21,TRAJ37,CAVTSNTGKLIF,0,1,1,1
TRAV3,TRAJ8,CAVNTGFQKLVF,0,1,1,1
TRAV17,TRAJ26,CATDTGGQNFVF,0,1,1,1
TRAV17,TRAJ6,CATEGGSYIPTF,0,1,1,1
TRAV12-2,TRAJ27,CAVSTNAGKSTF,0,1,1,1
TRAV8-1,TRAJ43,CAVNRNNNDMRF,0,1,1,1
TRAV12-2,TRAJ9,CAVYTGGFKTIF,0,1,1,1
TRAV14DV4,TRAJ11,CAFFSGYSTLTF,0,1,1,1
TRAV23DV6,TRAJ17,CAAKAAGNKLTF,0,1,1,1
TRAV23DV6,TRAJ33,CAALDSNYQLIW,0,1,1,1
TRAV13-1,TRAJ21,CAARKDFNKFYF,0,1,1,1
TRAV13-1,TRAJ30,CAASYGGDKIIF,0,1,1,1
TRAV29DV5,TRAJ31,CAASGNNARLMF,0,1,1,1
TRAV13-2,TRAJ26,CAESISGQNFVF,0,1,1,1
TRAV13-2,TRAJ49,CAEKRTGNQFYF,0,1,1,1
TRAV12-3,TRAJ37,CAMSGNTGKLIF,0,1,1,1
TRAV4,TRAJ33,CLVGFSNYQLIW,0,1,1,1
TRAV4,TRAJ34,CLVGVDTDKLIF,0,1,1,1
TRAV26-2,TRAJ40,CIHTSGTYKYIF,0,1,1,1
TRAV10,TRAJ31,CVVRAGARLMF,0,1,1,1
TRAV12-1,TRAJ34,CVEEDTDKLIF,0,1,1,1
TRAV41,TRAJ33,CAVYSNYQLIW,0,1,1,1
TRAV22,TRAJ20,CAVVNDYKLSF,0,1,1,1
TRAV22,TRAJ20,CAGGVDYKLSF,0,1,1,1
TRAV17,TRAJ58,CATGSGSRLTF,0,1,1,1
TRAV17,TRAJ16,CATLDGQKLLF,0,1,1,1
TRAV36DV7,TRAJ43,CASYNNNDMRF,0,1,1,1
TRAV12-2,TRAJ31,CAVRDNARLMF,0,1,1,1
TRAV13-1,TRAJ20,CAAMGDYKLSF,0,1,1,1
TRAV38-2DV8,TRAJ48,CACSKGKLTF,0,1,1,1
TRAV8-3,TRAJ34,CAVATDKLIF,0,1,1,1
TRAV13-1,TRAJ37,CAPFAGKLIF,0,1,1,1
TRAV8-1,TRAJ34,CAAYTDKLIF,0,1,1,1
TRAV26-2,TRAJ61,CISVNRKLTF,0,1,1,1
TRAV34,TRAJ49,CVVWNQFYF,0,1,1,1
TRAV9-2,TRAJ58,CALGRLTF,0,1,1,1
TRAV35,TRAJ58,CAGQLPYPSLSPYGVGSGSRLTS,0,1,1,1
TRAV13-1,TRAJ52,CVAPNPPRWAGGTSYGKLTF,0,1,1,1
TRAV2,TRAJ45,CAATRPKGDGARGGADGLTF,0,1,1,1
TRAV4,TRAJ28,CLVGVLSPAYSGAGSYQLTF,0,1,1,1
TRAV17,TRAJ52,CATDLLFNAGGTSYGKLTF,0,1,1,1
TRAV12-1,TRAJ45,CVVTGRSGSGGGADGLAF,0,1,1,1
TRAV13-1,TRAJ40,CAASIIGLGASGTYKYIF,0,1,1,1
TRAV5,TRAJ42,CAESIKGNYGGSQGNLIF,0,1,1,1
TRAV12-3,TRAJ52,CAMSASNAGGTSYGKLTF,0,1,1,1
TRAV26-2,TRAJ52,CILSRHNAGGTSYGKLTF,0,1,1,1
TRAV26-1,TRAJ32,CIVRPRGEYGGATNKLIF,0,1,1,1
TRAV10,TRAJ38,CVVSLLCVAGNNRKLIW,0,1,1,1
TRAV38-2DV8,TRAJ42,CAYGGLPDGGSQGNLIF,0,1,1,1
TRAV19,TRAJ45,CALSEGYSGGGADGLTF,0,1,1,1
TRAV16,TRAJ28,CALMESYSGAGSYQLTF,0,1,1,1
TRAV16,TRAJ53,CALSGLGSGGSNYKLTF,0,1,1,1
TRAV21,TRAJ47,CAVYPDGIMEYGNKLVF,0,1,1,1
TRAV34,TRAJ28,CAVPPGRSGAGSYQLTF,0,1,1,1
TRAV29DV5,TRAJ22,CAATGGLSSGSARQLTF,0,1,1,1
TRAV29DV5,TRAJ28,CAATTPYSGAGSYQLTF,0,1,1,1
TRAV13-2,TRAJ42,CADSSPNYGGSQGNLIF,0,1,1,1
TRAV5,TRAJ13,CAENPPSSSGGYQEVTF,0,1,1,1
TRAV12-3,TRAJ22,CAMRGDPLRGSARQLTF,0,1,1,1
TRAV4,TRAJ18,CLVGDGDRGSTLGRLYF,0,1,1,1
TRAV12-1,TRAJ9,CVVGGGRNTGGFKTIF,0,1,1,1
TRAV12-1,TRAJ10,CVVNSILTGGGNKLTF,0,1,1,1
TRAV12-1,TRAJ9,CVVNMLINTGGFKTIF,0,1,1,1
TRAV12-1,TRAJ42,CVVNMDYGGSQGNLIF,0,1,1,1
TRAV12-1,TRAJ3,CVVSEPGYSSASKIIF,0,1,1,1
TRAV9-2,TRAJ45,CALSEGSGGGADGLTF,0,1,1,1
TRAV16,TRAJ57,CALSPQFQGGSEKLVF,0,1,1,1
TRAV41,TRAJ35,CAVMLRGGSFGSVLHC,0,1,1,1
TRAV41,TRAJ45,CAVRRDPGGGADGLTF,0,1,1,1
TRAV21,TRAJ53,CAVSSNSGGSNYKLTF,0,1,1,1
TRAV3,TRAJ5,CAVRDSPHTGRRALTF,0,1,1,1
TRAV3,TRAJ9,CAVRDQTNTGGFKTIF,0,1,1,1
TRAV3,TRAJ38,CAVREANAGNNRKLIW,0,1,1,1
TRAV17,TRAJ37,CATDGKGSSNTGKLIF,0,1,1,1
TRAV13-1,TRAJ42,CALRVNYGGSQGNLIF,0,1,1,1
TRAV12-2,TRAJ37,CAVKITGSGNTGKLIF,0,1,1,1
TRAV12-2,TRAJ52,CAPRNAGGTSYGKLTF,0,1,1,1
TRAV23DV6,TRAJ18,CAVPPDRGSTLGRLYF,0,1,1,1
TRAV13-1,TRAJ38,CAAPGRNAGNNRKLIW,0,1,1,1
TRAV27,TRAJ22,CAAHSVSSGSARQLTF,0,1,1,1
TRAV23DV6,TRAJ45,CAASTYSGGGADGLTF,0,1,1,1
TRAV29DV5,TRAJ45,CAASEWGGGGADGLTF,0,1,1,1
TRAV5,TRAJ32,CAESMGYGGATNKLIF,0,1,1,1
TRAV12-3,TRAJ52,CAMIREGGTSYGKLTF,0,1,1,1
TRAV12-3,TRAJ45,CAMSPYSGGGADGLTF,0,1,1,1
TRAV12-3,TRAJ4,CAMSAAISGGYNKLIF,0,1,1,1
TRAV14DV4,TRAJ22,CAMRTFSSGSARQLTF,0,1,1,1
TRAV14DV4,TRAJ4,CAMRGIFSGGYNKLIS,0,1,1,1
TRAV14DV4,TRAJ16,CAMREGRGFDGQKLLF,0,1,1,1
TRAV4,TRAJ37,CLVGDIGGGELGKLIF,0,1,1,1
TRAV10,TRAJ44,CVVSAGSGTASKLTF,0,1,1,1
TRAV38-1,TRAJ42,CAFVNYGGSQGNLIF,0,1,1,1
TRAV38-1,TRAJ34,CAFMRSFYNTDKLIF,0,1,1,1
TRAV16,TRAJ32,CASRDYGGATSKLIF,0,1,1,1
TRAV38-1,TRAJ4,CAWTTVSGGYNKLIF,0,1,1,1
TRAV38-2DV8,TRAJ48,CAYRTSNFGNEKLTF,0,1,1,1
TRAV38-2DV8,TRAJ50,CAYSDSGTSYDKVIF,0,1,1,1
TRAV38-2DV8,TRAJ15,CAYRGDNQAGTALIF,0,1,1,1
TRAV6,TRAJ45,CALPHSGGGADGLTF,0,1,1,1
TRAV19,TRAJ22,CALGGLSGSARQLTF,0,1,1,1
TRAV9-2,TRAJ27,CALSDPRTNAGKSTF,0,1,1,1
TRAV6,TRAJ52,CALGRGGTSYGKLTF,0,1,1,1
TRAV6,TRAJ40,CALDDPGSGTYKYIF,0,1,1,1
TRAV16,TRAJ40,CALMQATSGTYKYIF,0,1,1,1
TRAV16,TRAJ53,CALRNSGGSNYKLTF,0,1,1,1
TRAV35,TRAJ42,CAPSNYGGSQGNLIF,0,1,1,1
TRAV22,TRAJ38,CAVLKYAGNNRKLIW,0,1,1,1
TRAV2,TRAJ16,CAVAGFLADGQKLLF,0,1,1,1
TRAV21,TRAJ33,CAVIPEEWSNYQLIW,0,1,1,1
TRAV21,TRAJ57,CAVIRREGGSEKLVF,0,1,1,1
TRAV3,TRAJ37,CAVSPGSGNTGKLIF,0,1,1,1
TRAV3,TRAJ13,CAVRGALVGYQKVTF,0,1,1,1
TRAV21,TRAJ10,CAVRGLAGGGNKLTF,0,1,1,1
TRAV3,TRAJ8,CAVRDINTGFQKLVF,0,1,1,1
TRAV41,TRAJ42,CAAPRGGGSQGNLIF,0,1,1,1
TRAV17,TRAJ10,CATGPPTGGGNKLTF,0,1,1,1
TRAV17,TRAJ42,CATDGDGGSQGNLIF,0,1,1,1
TRAV12-2,TRAJ28,CAVSLSGAGSYQLTF,0,1,1,1
TRAV12-2,TRAJ28,CAVRRDGAGSYQLTF,0,1,1,1
TRAV12-2,TRAJ8,CAVNARNTGFQKLVF,0,1,1,1
TRAV12-2,TRAJ42,CAVNKRGGSQGNLIF,0,1,1,1
TRAV12-2,TRAJ22,CAVKFPSGSARQLTF,0,1,1,1
TRAV12-3,TRAJ52,CAAPRGGTSYGKLTF,0,1,1,1
TRAV13-2,TRAJ53,CAQAQGMGSNYKLTF,0,1,1,1
TRAV13-1,TRAJ28,CAAGPSGAGSYQLTF,0,1,1,1
TRAV13-1,TRAJ12,CAAISWMDSSYKLIF,0,1,1,1
TRAV13-1,TRAJ32,CAASIEGGATNKLIF,0,1,1,1
TRAV13-1,TRAJ43,CAASRRLRNNNDMRF,0,1,1,1
TRAV25,TRAJ53,CAGRRSGGSNYKLTF,0,1,1,1
TRAV27,TRAJ48,CAGGLSNFGNEKLTF,0,1,1,1
TRAV13-2,TRAJ5,CAERLMNTGRRALTF,0,1,1,1
TRAV13-2,TRAJ6,CAENKKAGGSYIPTF,0,1,1,1
TRAV12-3,TRAJ3,CAMRGGYSSASKIIF,0,1,1,1
TRAV12-3,TRAJ28,CAMTSSGAGSYQLTF,0,1,1,1
TRAV14DV4,TRAJ45,CAMREGGRGADGLTF,0,1,1,1
TRAV30,TRAJ26,CGTETPDNYGQNFVF,0,1,1,1
TRAV4,TRAJ6,CLVVRPTGGSYIPTF,0,1,1,1
TRAV4,TRAJ13,CLVGDGPGGYQKVTF,0,1,1,1
TRAV26-2,TRAJ44,CILSANTGTASKLTF,0,1,1,1
TRAV26-1,TRAJ29,CIVRSGPSGNTPLVF,0,1,1,1
TRAV12-1,TRAJ42,CVLNYGGSQGNLIF,0,1,1,1
TRAV12-1,TRAJ40,CVVTPTSGTYKYIF,0,1,1,1
TRAV12-1,TRAJ16,CVVTLLSDGQKLLF,0,1,1,1
TRAV10,TRAJ12,CVVRRMDSSYKLIF,0,1,1,1
TRAV12-1,TRAJ6,CVVNSAGGSYIPTF,0,1,1,1
TRAV12-1,TRAJ4,CVVNLSGGYNKLIF,0,1,1,1
TRAV38-1,TRAJ41,CAFATPNSGYALNF,0,1,1,1
TRAV38-1,TRAJ26,CAFMRGSYGQNFVF,0,1,1,1
TRAV38-2DV8,TRAJ49,CAYRSRNTGNQFYF,0,1,1,1
TRAV38-2DV8,TRAJ30,CAYRSGYRDDKIIF,0,1,1,1
TRAV38-2DV8,TRAJ30,CAYKFRNRDNKIIF,0,1,1,1
TRAV38-2DV8,TRAJ57,CAYVPPGGSEKPVF,0,1,1,1
TRAV9-2,TRAJ23,CALRSYNQGGKLIF,0,1,1,1
TRAV9-2,TRAJ27,CALFRGTNAGKSTF,0,1,1,1
TRAV9-2,TRAJ6,CALSLLGGSYIPTF,0,1,1,1
TRAV19,TRAJ23,CALSGHNQGGKLIF,0,1,1,1
TRAV9-2,TRAJ29,CALSGRSGNTPLVF,0,1,1,1
TRAV19,TRAJ30,CALSEVRRDDKIIF,0,1,1,1
TRAV19,TRAJ11,CALSEASGYSTLTF,0,1,1,1
TRAV19,TRAJ12,CALSEAGSSYKLIF,0,1,1,1
TRAV9-2,TRAJ52,CALSEGPSYGKLTF,0,1,1,1
TRAV9-2,TRAJ53,CALSEGGSNYKLTF,0,1,1,1
TRAV9-2,TRAJ17,CALRGKAAGNKLTF,0,1,1,1
TRAV19,TRAJ58,CALRKGTSGSRLTF,0,1,1,1
TRAV19,TRAJ11,CALKPNSGYSTLTF,0,1,1,1
TRAV9-2,TRAJ26,CALKDGNYGQHFVF,0,1,1,1
TRAV22,TRAJ40,CALSLVLGTYKYIF,0,1,1,1
TRAV16,TRAJ32,CALSRGGATNKLIF,0,1,1,1
TRAV12-2,TRAJ28,CAVSSGAGSYQLTF,0,1,1,1
TRAV36DV7,TRAJ34,CAVLKASNTDKLIF,0,1,1,1
TRAV3,TRAJ5,CAVVKDTGRRALTF,0,1,1,1
TRAV8-3,TRAJ45,CAVSIPGGADGLTL,0,1,1,1
TRAV8-3,TRAJ5,CAVVMDTGRRALTF,0,1,1,1
TRAV20,TRAJ10,CAVVETGGGNKLTF,0,1,1,1
TRAV8-3,TRAJ47,CAVGAEDYGNKLVF,0,1,1,1
TRAV8-3,TRAJ49,CAVGAMGTGNQFYF,0,1,1,1
TRAV8-3,TRAJ27,CAVGGRTNAGKSTF,0,1,1,1
TRAV2,TRAJ29,CAVDRNSGSTPLVF,0,1,1,1
TRAV36DV7,TRAJ32,CAVEYGGATNKLIF,0,1,1,1
TRAV2,TRAJ20,CAVELLGNDYKLSF,0,1,1,1
TRAV21,TRAJ6,CAVSGPGGSYIPTF,0,1,1,1
TRAV8-4,TRAJ22,CAVSESGSARQLTF,0,1,1,1
TRAV8-4,TRAJ5,CAVRVDTGRRALTF,0,1,1,1
TRAV3,TRAJ39,CAVRPYNAGNMLTF,0,1,1,1
TRAV3,TRAJ11,CAVRANSGYSTLTF,0,1,1,1
TRAV3,TRAJ17,CAVRDLAAGNKLTF,0,1,1,1
TRAV3,TRAJ31,CAVRDGRNNARLMF,0,1,1,1
TRAV3,TRAJ10,CAVRDKGGGNKLTF,0,1,1,1
TRAV3,TRAJ5,CAVKGRAGRRALTF,0,1,1,1
TRAV12-2,TRAJ29,CAVKDDSGNTPLVF,0,1,1,1
TRAV35,TRAJ24,CAGPAPDSWGKFQF,0,1,1,1
TRAV35,TRAJ3,CAGTGSSSASKIIF,0,1,1,1
TRAV17,TRAJ13,CATSDSGGYQKVTF,0,1,1,1
TRAV17,TRAJ40,CATEGMSGTYKYIF,0,1,1,1
TRAV12-2,TRAJ13,CAVWNSGGYQKVTF,0,1,1,1
TRAV12-2,TRAJ22,CAVEESGSARQLTF,0,1,1,1
TRAV12-2,TRAJ9,CAVNPDTGSFKTIF,0,1,1,1
TRAV12-2,TRAJ44,CAVNMRGTASKLTF,0,1,1,1
TRAV12-2,TRAJ35,CAVNMRGFGNVLHC,0,1,1,1
TRAV12-2,TRAJ11,CAVNRDSGYSTLTF,0,1,1,1
TRAV12-2,TRAJ28,CAVLFGAGSYQLTF,0,1,1,1
TRAV12-1,TRAJ3,CAVNMYSSASKIIF,0,1,1,1
TRAV13-1,TRAJ37,CAAPGESNTGKLIF,0,1,1,1
TRAV13-1,TRAJ48,CAASTNFGNEKLTF,0,1,1,1
TRAV29DV5,TRAJ13,CAAMNSGGYQKVTF,0,1,1,1
TRAV13-1,TRAJ34,CAASVRRNTDKLIF,0,1,1,1
TRAV13-1,TRAJ16,CAASIESDGQKLLF,0,1,1,1
TRAV13-1,TRAJ23,CAASKGNQGGKLIF,0,1,1,1
TRAV13-1,TRAJ13,CAASLSGGYQKVTF,0,1,1,1
TRAV29DV5,TRAJ37,CAASVPGNTGKLIF,0,1,1,1
TRAV29DV5,TRAJ27,CAASASTNAGKSTF,0,1,1,1
TRAV29DV5,TRAJ12,CAASGADSSYKLIF,0,1,1,1
TRAV27,TRAJ39,CAGALKDAGNMLTF,0,1,1,1
TRAV5,TRAJ39,CAERWDNAGNMLTF,0,1,1,1
TRAV13-2,TRAJ38,CAEKRAGNNRKLIW,0,1,1,1
TRAV12-3,TRAJ45,CAMYSGGGADGLTF,0,1,1,1
TRAV12-3,TRAJ57,CAMVPQGGSEKLVF,0,1,1,1
TRAV12-3,TRAJ26,CAMMEGGYGQNFVF,0,1,1,1
TRAV12-3,TRAJ10,CAMSFTGGGNKLTF,0,1,1,1
TRAV12-3,TRAJ21,CAMSAGYNFNKFYF,0,1,1,1
TRAV12-3,TRAJ21,CAMSGLYNFNKFYF,0,1,1,1
TRAV12-3,TRAJ3,CAMSDRSSASKIIF,0,1,1,1
TRAV14DV4,TRAJ5,CAMRERTGRRALAF,0,1,1,1
TRAV14DV4,TRAJ43,CAMREAQGNNDMRF,0,1,1,1
TRAV26-1,TRAJ49,CFVRVQNTGNQFYF,0,1,1,1
TRAV4,TRAJ9,CLVGDLGGGFKTIF,0,1,1,1
TRAV26-2,TRAJ22,CILMPQGSARQLTF,0,1,1,1
TRAV26-2,TRAJ54,CILRGYQGAQKLVF,0,1,1,1
TRAV38-2DV8,TRAJ28,CFYSGAGSYQLTF,0,1,1,1
TRAV12-1,TRAJ10,CVVFTGGGNKLTF,0,1,1,1
TRAV12-1,TRAJ6,CVVLAGGSYIPTF,0,1,1,1
TRAV12-1,TRAJ4,CVVLSGGYNKLIF,0,1,1,1
TRAV12-1,TRAJ47,CVVIRLDGNKLVF,0,1,1,1
TRAV12-1,TRAJ34,CVVTPYNTDKLIF,0,1,1,1
TRAV12-1,TRAJ34,CVVTPMDTDKLIF,0,1,1,1
TRAV12-1,TRAJ6,CVVNRRGSYIPTF,0,1,1,1
TRAV12-1,TRAJ49,CVATKGGGNQFYF,0,1,1,1
TRAV38-1,TRAJ20,CAFRPPNDYKLSF,0,1,1,1
TRAV38-1,TRAJ49,CAFMKNTGNQFYF,0,1,1,1
TRAV38-2DV8,TRAJ49,CAYRRETGNQFYF,0,1,1,1
TRAV38-2DV8,TRAJ56,CAYRAGANSKLTF,0,1,1,1
TRAV38-2DV8,TRAJ48,CAYKNFGNEKLTF,0,1,1,1
TRAV16,TRAJ25,CALSEGQGFSFIF,0,1,1,1
TRAV9-2,TRAJ49,CALSAPTGGQFYF,0,1,1,1
TRAV9-2,TRAJ9,CALSEPGGFKTIF,0,1,1,1
TRAV9-2,TRAJ8,CALRDTGFQKLVF,0,1,1,1
TRAV9-2,TRAJ12,CALRMDSSYKLIF,0,1,1,1
TRAV9-2,TRAJ27,CALRNTNAGKSTF,0,1,1,1
TRAV16,TRAJ58,CALGRVSGSRLTF,0,1,1,1
TRAV12-2,TRAJ44,CALGTGTASKLTF,0,1,1,1
TRAV16,TRAJ39,CALIRNAGNMLTF,0,1,1,1
TRAV16,TRAJ9,CAPTYTGGFKTIF,0,1,1,1
TRAV16,TRAJ4,CAPKGGGYNKLIF,0,1,1,1
TRAV6,TRAJ27,CARVNTNAGKSTF,0,1,1,1
TRAV21,TRAJ13,CAVDSGGYQKVTF,0,1,1,1
TRAV41,TRAJ45,CAVFGGGADGLTF,0,1,1,1
TRAV41,TRAJ57,CAVSKGGSEKLVF,0,1,1,1
TRAV21,TRAJ35,CAVFTGFGNVLHC,0,1,1,1
TRAV21,TRAJ22,CAVLSGSARQLTF,0,1,1,1
TRAV22,TRAJ50,CAVVETSYDKVIF,0,1,1,1
TRAV12-2,TRAJ54,CAVVIQGAQKLVF,0,1,1,1
TRAV8-3,TRAJ37,CAVGARGTGKLIF,0,1,1,1
TRAV8-3,TRAJ47,CAVGMEYGNKLVF,0,1,1,1
TRAV20,TRAJ7,CAVDSGGNNRLAF,0,1,1,1
TRAV12-2,TRAJ26,CAVDDNYGQNFVF,0,1,1,1
TRAV36DV7,TRAJ38,CAVEAGNNRKLIW,0,1,1,1
TRAV21,TRAJ10,CAVETGGGNKLTF,0,1,1,1
TRAV8-4,TRAJ36,CAVSPTGANNLFF,0,1,1,1
TRAV8-4,TRAJ9,CAVSHTGGFKTIF,0,1,1,1
TRAV3,TRAJ21,CAVRPLDFNKFYF,0,1,1,1
TRAV8-4,TRAJ49,CAVNYRTGNQFYF,0,1,1,1
TRAV41,TRAJ35,CAATIGFGNVLHC,0,1,1,1
TRAV20,TRAJ6,CAGEGGGSYIPTF,0,1,1,1
TRAV35,TRAJ54,CAGRFQGAQKLVF,0,1,1,1
TRAV36DV7,TRAJ39,CAEGYNAGNMLTF,0,1,1,1
TRAV17,TRAJ16,CATALSDGQKLLF,0,1,1,1
TRAV24,TRAJ10,CAFPAGGGNKLTF,0,1,1,1
TRAV38-2DV8,TRAJ44,CASRAGTASKLTF,0,1,1,1
TRAV36DV7,TRAJ35,CALGGGFGNVLHC,0,1,1,1
TRAV12-2,TRAJ16,CAVSTPHGQKLLF,0,1,1,1
TRAV12-2,TRAJ42,CAVTRGSQGNLIF,0,1,1,1
TRAV12-2,TRAJ6,CAVTSEGSYIPTF,0,1,1,1
TRAV12-2,TRAJ28,CAVTGAGSYQLTF,0,1,1,1
TRAV12-2,TRAJ8,CAVRITGFQKLVF,0,1,1,1
TRAV8-1,TRAJ30,CAVNAPSDDKIIL,0,1,1,1
TRAV12-2,TRAJ41,CAVKSNSGYALNF,0,1,1,1
TRAV8-4,TRAJ12,CAAVMDSSYKLIF,0,1,1,1
TRAV12-2,TRAJ6,CAATRGGSYIPTF,0,1,1,1
TRAV12-2,TRAJ33,CAAGMDSNYQLIW,0,1,1,1
TRAV13-1,TRAJ17,CAEGGAAGNKLTF,0,1,1,1
TRAV12-3,TRAJ3,CASLVSSASKIIF,0,1,1,1
TRAV13-1,TRAJ13,CAAYSGGYQKVTF,0,1,1,1
TRAV13-1,TRAJ4,CAALPGGYNKLIF,0,1,1,1
TRAV29DV5,TRAJ45,CAAAGGGADGLTF,0,1,1,1
TRAV13-1,TRAJ30,CAAILNRDDKIIF,0,1,1,1
TRAV13-1,TRAJ5,CAAMDTGRRALTF,0,1,1,1
TRAV13-1,TRAJ24,CAATIDSWGKFQF,0,1,1,1
TRAV13-1,TRAJ7,CAASEEGNNRLAF,0,1,1,1
TRAV13-1,TRAJ34,CAASIWNTDKLIF,0,1,1,1
TRAV13-1,TRAJ49,CAASINTGNQFYF,0,1,1,1
TRAV13-1,TRAJ7,CAASKPGNNRLAF,0,1,1,1
TRAV23DV6,TRAJ48,CAASSGGNEKLTF,0,1,1,1
TRAV23DV6,TRAJ10,CAASPGGGNKLTV,0,1,1,1
TRAV23DV6,TRAJ57,CAASKGGSEKLVF,0,1,1,1
TRAV29DV5,TRAJ40,CAARTSGTYKYIF,0,1,1,1
TRAV27,TRAJ23,CAGHDNQGGKLIF,0,1,1,1
TRAV13-2,TRAJ4,CAETSGGYNKLIF,0,1,1,1
TRAV13-2,TRAJ4,CAENIGGYNKLIF,0,1,1,1
TRAV13-2,TRAJ58,CAEKETSGSRLTF,0,1,1,1
TRAV12-3,TRAJ52,CAMGLTSYGKLTF,0,1,1,1
TRAV12-3,TRAJ13,CAMSDTSYQKVTF,0,1,1,1
TRAV12-3,TRAJ48,CAMSEQGNEKLTF,0,1,1,1
TRAV12-3,TRAJ10,CAMKTGGGNKLTF,0,1,1,1
TRAV27,TRAJ20,CASGPYNDYKLSF,0,1,1,1
TRAV30,TRAJ34,CGTETPNTDKLIF,0,1,1,1
TRAV4,TRAJ40,CLVVASGTYKYIF,0,1,1,1
TRAV4,TRAJ17,CLVAQAAGNKLTF,0,1,1,1
TRAV30,TRAJ48,CGSASFGNEKLTL,0,1,1,1
TRAV26-2,TRAJ40,CILYTSGTYKYIF,0,1,1,1
TRAV26-2,TRAJ34,CILRDMRADKLIF,0,1,1,1
TRAV26-2,TRAJ5,CILKGTGRRALTF,0,1,1,1
TRAV26-1,TRAJ20,CIVRVANDYKLSF,0,1,1,1
TRAV26-1,TRAJ40,CIVRIPGTYKYIF,0,1,1,1
TRAV26-1,TRAJ37,CIAPSGNTGKLIF,0,1,1,1
TRAV12-3,TRAJ35,YASVKGFGNVLHC,0,1,1,1
TRAV12-1,TRAJ36,RVVIPTGANNLFF,0,1,1,1
TRAV20,TRAJ4,CVVSGGYNKLIF,0,1,1,1
TRAV12-1,TRAJ39,CVVRVAGNMLTF,0,1,1,1
TRAV12-1,TRAJ21,CVVGYDFNKFYF,0,1,1,1
TRAV10,TRAJ20,CVVSAVDYKLSF,0,1,1,1
TRAV12-1,TRAJ16,CVVNADGQKLLF,0,1,1,1
TRAV12-1,TRAJ36,CVVKPPIGNLFF,0,1,1,1
TRAV38-2DV8,TRAJ34,CAYRSAADKLIF,0,1,1,1
TRAV6,TRAJ31,CALEPNNARLMF,0,1,1,1
TRAV16,TRAJ49,CALNRTGNQFYF,0,1,1,1
TRAV36DV7,TRAJ41,CAVGGSGYALNF,0,1,1,1
TRAV21,TRAJ56,CAVSGANSKLTF,0,1,1,1
TRAV2,TRAJ16,CAVGSDGQKLLF,0,1,1,1
TRAV22,TRAJ11,CAVERRYSTLTF,0,1,1,1
TRAV8-6,TRAJ30,CAVTNRDDKIIF,0,2,1,2
TRAV36DV7,TRAJ39,CAVHNAGNMLTF,0,1,1,1
TRAV8-3,TRAJ36,CAVETGANNLFF,0,1,1,1
TRAV20,TRAJ58,CAAETSGSRLTS,0,1,1,1
TRAV20,TRAJ5,CAAITGRRALTF,0,1,1,1
TRAV21,TRAJ6,CAAVGGSYIPTF,0,1,1,1
TRAV35,TRAJ27,CAGQLYAGKSTF,0,1,1,1
TRAV17,TRAJ34,CATDHNTDKLIF,0,1,1,1
TRAV17,TRAJ4,CATDGGYNKLIF,0,1,1,1
TRAV6,TRAJ9,CALGAGGFKTIF,0,1,1,1
TRAV12-2,TRAJ34,CAPRGNTDKLIF,0,1,1,1
TRAV8-1,TRAJ22,CAVSGTARQLTF,0,1,1,1
TRAV12-2,TRAJ6,CAVVPGSYIPTF,0,1,1,1
TRAV12-3,TRAJ31,CAVGQGSARLMF,0,1,1,1
TRAV12-2,TRAJ30,CAVMGRDDKIIF,0,1,1,1
TRAV12-2,TRAJ43,CAVNPQRNDMRF,0,1,1,1
TRAV12-2,TRAJ34,CAAMRNTDKLIF,0,1,1,1
TRAV12-2,TRAJ24,CAGADSWGKFQF,0,1,1,1
TRAV13-1,TRAJ49,CAASNTGNQFYF,0,1,1,1
TRAV29DV5,TRAJ36,CAASGGANNLFF,0,1,1,1
TRAV23DV6,TRAJ37,CAASKNTGKLIF,0,1,1,1
TRAV29DV5,TRAJ9,CAANTGGFKTIF,0,1,1,1
TRAV25,TRAJ49,CAGPNTGNQFYF,0,1,1,1
TRAV27,TRAJ20,CAGHRDDYKLSF,0,1,1,1
TRAV5,TRAJ34,CAESIGTDKLIF,0,1,1,1
TRAV12-3,TRAJ7,CAMAYGNNRLAF,0,1,1,1
TRAV12-3,TRAJ20,CAMREDDYKLSF,0,1,1,1
TRAV26-2,TRAJ47,CILSAYGNKLVF,0,1,1,1
TRAV26-1,TRAJ49,CIVRLTGNQFYF,0,1,1,1
TRAV25,TRAJ29,SIPGGNTPLVF,0,1,1,1
TRAV10,TRAJ20,CVVSVDYKLSF,0,1,1,1
TRAV38-1,TRAJ21,CAFINFNKFYF,0,1,1,1
TRAV38-1,TRAJ54,CASRRAQKLVF,0,1,1,1
TRAV9-2,TRAJ3,CALGVASKIIF,0,1,1,1
TRAV16,TRAJ23,CALTSTGKLIF,0,1,1,1
TRAV21,TRAJ49,CAVFDPNQFYF,0,1,1,1
TRAV8-3,TRAJ26,CAVGVGQNFVF,0,1,1,1
TRAV2,TRAJ36,CAVSGANNLFF,0,1,1,1
TRAV21,TRAJ21,CAVYNFNKFYF,0,1,1,1
TRAV21,TRAJ35,CAVGFGNVLHC,0,1,1,1
TRAV3,TRAJ6,CAAGGSYIPTF,0,1,1,1
TRAV39,TRAJ42,CAVDILGNLIF,0,1,1,1
TRAV12-2,TRAJ20,CAVNPNYKLSF,0,1,1,1
TRAV12-2,TRAJ15,CAAQAGTALIF,0,1,1,1
TRAV13-1,TRAJ34,CAAWNTDKLIF,0,1,1,1
TRAV13-1,TRAJ20,CAAGGDYKLSF,0,1,1,1
TRAV13-1,TRAJ38,CAARMDRKLIW,0,1,1,1
TRAV27,TRAJ16,CAGAGGQKLLF,0,1,1,1
TRAV27,TRAJ53,CAGGSNYKLTL,0,1,1,1
TRAV13-2,TRAJ16,CAEADGQKLLF,0,1,1,1
TRAV12-3,TRAJ31,CAMTYNARLMF,0,1,1,1
TRAV12-3,TRAJ43,CAMRDNNDMRF,0,1,1,1
TRAV12-3,TRAJ47,CATRYGNKLVF,0,1,1,1
TRAV12-2,TRAJ11,CGTSGYSTLTF,0,1,1,1
TRAV29DV5,TRAJ50,CTKTSYDKVIF,0,1,1,1
TRAV17,TRAJ3,CGYSSASKIIF,0,1,1,1
TRAV27,TRAJ49,SSNTGNQFYF,0,1,1,1
TRAV38-2DV8,TRAJ34,CAYSSDELIF,0,1,1,1
TRAV21,TRAJ20,CALNDYKLSF,0,1,1,1
TRAV1-2,TRAJ31,CAVGGARLMF,0,1,1,1
TRAV8-3,TRAJ33,CAASNYQLIW,0,1,1,1
TRAV13-2,TRAJ21,CADNFNKFYF,0,1,1,1
TRAV25,TRAJ31,CAQYNARLTF,0,1,1,1
TRAV27,TRAJ30,CAGDAGKIIF,0,1,1,1
TRAV5,TRAJ27,CAESISKSTF,0,1,1,1
TRAV12-1,TRAJ32,CSGATNKLIF,0,1,1,1
TRAV4,TRAJ11,CLEGYSTLTF,0,1,1,1
TRAV12-2,TRAJ21,CAVWVKFYF,0,1,1,1
TRAV39,TRAJ34,CAVEDKLIF,0,1,1,1
TRAV13-1,TRAJ16,LGGQKLLF,0,1,1,1
TRAV4,TRAJ35,CLVVVLHC,0,1,1,1
TRAV23DV6,TRAJ33,CAASNG,0,1,1,1
TRAV8-1,TRAJ35,CAAG,0,1,1,1
TRAV12-2,TRAJ44,CAVRAYPSSTGTASKLTF,0,1,1,1
TRAV35,TRAJ53,CAGQFRGNSGGSNYKLTF,0,1,1,1
TRAV12-2,TRAJ45,CAVNNRGRGGGGADGLTF,0,1,1,1
TRAV13-2,TRAJ52,CAEIQSYAGGTSYGKLTF,0,1,1,1
TRAV26-2,TRAJ42,CILRDKINYGGSQGNLIF,0,1,1,1
TRAV26-1,TRAJ52,CIVSLTLGGGTSYGKLTF,0,1,1,1
TRAV38-1,TRAJ10,CAFMKRRGTGGGNKLTF,0,1,1,1
TRAV38-2DV8,TRAJ42,CAYLYMNYGGSQGNLIF,0,1,1,1
TRAV38-2DV8,TRAJ32,CAYRSADYGGATNKLIF,0,1,1,1
TRAV9-2,TRAJ52,CALTPNAGGTSYGKLTF,0,1,1,1
TRAV19,TRAJ45,CALSEPYSGGGADGLTF,0,1,1,1
TRAV19,TRAJ11,CALSEAIMNSGYSTLTF,0,1,1,1
TRAV16,TRAJ10,CAHSCRVLTGGGNKLTF,0,1,1,1
TRAV8-3,TRAJ39,CAVGPPGLNNAGNMLTF,0,1,1,1
TRAV3,TRAJ18,CAVGDYDRGSTLGRLYF,0,1,1,1
TRAV3,TRAJ38,CAVRDINNAGNNRKLIW,0,1,1,1
TRAV12-2,TRAJ28,CAARGRNSGAGSYQLTF,0,1,1,1
TRAV39,TRAJ54,CAVDFILSDQGAQKLVF,0,1,1,1
TRAV29DV5,TRAJ52,CAASPNAGGTSYGKLTF,0,1,1,1
TRAV29DV5,TRAJ28,CAASAAYSGAGSYQLTF,0,1,1,1
TRAV23DV6,TRAJ30,CAASICRVSNRDDKIIF,0,1,1,1
TRAV12-3,TRAJ10,CATTWAILTGGGNKLTF,0,1,1,1
TRAV30,TRAJ48,CGTERRASNFGNEKLTF,0,1,1,1
TRAV4,TRAJ38,CLVGDVTNAGNNRKLIW,0,1,1,1
TRAV26-2,TRAJ40,CILRDPLEGPGTYKYIF,0,1,1,1
TRAV26-1,TRAJ29,CIVRVARTVSGNTPLVF,0,1,1,1
TRAV8-2,TRAJ47,CVVSEKRREYGNKLVF,0,1,1,1
TRAV8-2,TRAJ32,CVESDNYGGATNKLIF,0,1,1,1
TRAV10,TRAJ28,CVVSADSEAGSYQLTF,0,1,1,1
TRAV12-1,TRAJ3,CVVNNRERSSASKIIF,0,1,1,1
TRAV38-1,TRAJ42,CAFMKPSQGSQGNLIF,0,1,1,1
TRAV38-2DV8,TRAJ28,CAYYLYSGAGSYQLTF,0,1,1,1
TRAV9-2,TRAJ22,CALTPISSGSARQLTF,0,1,1,1
TRAV9-2,TRAJ22,CALSDADSGSVRQLTF,0,1,1,1
TRAV16,TRAJ42,CALSVGWGGSQGNLIF,0,1,1,1
TRAV2,TRAJ13,CAVEDLDSGGYQKVTF,0,1,1,1
TRAV2,TRAJ42,CAVEDLYGGSQGNLIF,0,1,1,1
TRAV8-6,TRAJ22,CAVISTSSGSARQLTF,0,1,1,1
TRAV8-4,TRAJ52,CAVSASGGTSYGKLTL,0,1,1,1
TRAV8-4,TRAJ49,CAVSDFFSNTGNQFYF,0,1,1,1
TRAV3,TRAJ40,CAVRDYYTSGTYEYIF,0,1,1,1
TRAV3,TRAJ17,CAVRDITKAAGNKLTF,0,1,1,1
TRAV17,TRAJ37,CATAAHGSGNTGKLIF,0,1,1,1
TRAV24,TRAJ52,CASSNAGGTSYGKLTF,0,1,1,1
TRAV8-1,TRAJ42,CAVNAGYGGSQGNLIL,0,1,1,1
TRAV12-2,TRAJ48,CAVNRYTDFGNEKLTF,0,1,1,1
TRAV13-1,TRAJ45,CAARSGSRGGADGLTF,0,1,1,1
TRAV23DV6,TRAJ37,CAARKPGSGNTGKLIF,0,1,1,1
TRAV29DV5,TRAJ52,CAATTIGGTSYGKLTF,0,1,1,1
TRAV13-1,TRAJ42,CAASEGYGGSQGNLIF,0,1,1,1
TRAV13-1,TRAJ53,CAASKGRGGSNYILTF,0,1,1,1
TRAV13-1,TRAJ30,CAASKIVGNRDDKIIF,0,1,1,1
TRAV13-1,TRAJ40,CAASKGRLSGTYKYIF,0,1,1,1
TRAV27,TRAJ52,CAGAEVGGTSYGKLTF,0,1,1,1
TRAV12-3,TRAJ6,CAMSAPPSGGSYIPTF,0,1,1,1
TRAV23DV6,TRAJ13,CTAGPPNSGGYQKVTF,0,1,1,1
TRAV4,TRAJ11,CLVAPGGDSGYSTLTF,0,1,1,1
TRAV4,TRAJ37,CLVGDEYSGNTGKLIF,0,1,1,1
TRAV4,TRAJ22,CLVGDQRSGSARQLTF,0,1,1,1
TRAV30,TRAJ49,CGTEGGIIDTGNQFYF,0,1,1,1
TRAV12-1,TRAJ4,CVPLRSAGGYNKLIF,0,1,1,1
TRAV12-1,TRAJ23,CVVRAGNNQGGKLIF,0,1,1,1
TRAV12-1,TRAJ40,CVVNIQVVGTYKYIF,0,1,1,1
TRAV38-1,TRAJ26,CAFMKGGNYGQNFVF,0,1,1,1
TRAV38-2DV8,TRAJ39,CAYRSAEGAGNMLTF,0,1,1,1
TRAV38-2DV8,TRAJ29,CAYRSASSGNTPLVF,0,1,1,1
TRAV38-2DV8,TRAJ45,CAYRREGGGADGLTF,0,1,1,1
TRAV9-2,TRAJ40,CALIEPTSGTYKYIF,0,1,1,1
TRAV9-2,TRAJ53,CALSDRGGSNYKLTF,0,1,1,1
TRAV19,TRAJ4,CALSEALGGYNKLIF,0,1,1,1
TRAV17,TRAJ5,CALSPGGTGRRALTF,0,1,1,1
TRAV9-2,TRAJ16,CAPRAPFSDGQKLLF,0,1,1,1
TRAV22,TRAJ32,CAVRSYGGATNKLIF,0,1,1,1
TRAV41,TRAJ58,CAVSTKETSGSRLTF,0,1,1,1
TRAV20,TRAJ39,CAVQAGRNAGNMLTF,0,1,1,1
TRAV20,TRAJ3,CAVQPGYSSASKIIF,0,1,1,1
TRAV8-3,TRAJ10,CAVGAVTGGGNKLTS,0,1,1,1
TRAV36DV7,TRAJ42,CAVEALGGSQGNLIF,0,1,1,1
TRAV2,TRAJ28,CAVEDRGARSYQLTL,0,1,1,1
TRAV2,TRAJ8,CAVEDQGTGFQKLVF,0,1,1,1
TRAV8-6,TRAJ42,CAVTTLGGSQGNLIF,0,1,1,1
TRAV8-4,TRAJ9,CAVSEPGTGGFKTIF,0,1,1,1
TRAV21,TRAJ42,CAVRSYGGSQGNLIF,0,1,1,1
TRAV3,TRAJ33,CAVRRDVDSNYQLIW,0,1,1,1
TRAV3,TRAJ29,CAVRPSIAGNTPLVF,0,1,1,1
TRAV3,TRAJ11,CAVRDLNSGYSTLTF,0,1,1,1
TRAV3,TRAJ9,CAVRDPRGGGFKTIF,0,1,1,1
TRAV3,TRAJ36,CAVRDPGTGANNLFF,0,1,1,1
TRAV3,TRAJ27,CAVRDRETNAGKSTF,0,1,1,1
TRAV3,TRAJ24,CAVRDGGDSWGKFQF,0,1,1,1
TRAV3,TRAJ4,CAVRTFSGGYNKLIF,0,1,1,1
TRAV21,TRAJ44,CAVNPATGTASKLTF,0,1,1,1
TRAV17,TRAJ22,CAAFLSSGSARQLTF,0,1,1,1
TRAV35,TRAJ38,CAGRDNAGNNRKLIW,0,1,1,1
TRAV8-1,TRAJ18,CATEDRGSTLGRLYF,0,1,1,1
TRAV17,TRAJ37,CATVMNSGNTGKLIF,0,1,1,1
TRAV17,TRAJ56,CATDQLTGAYSKLTF,0,1,1,1
TRAV17,TRAJ37,CATNGIPSNTGKLIF,0,1,1,1
TRAV17,TRAJ52,CATRAGGTSYGKLTF,0,1,1,1
TRAV38-2DV8,TRAJ53,CANRSGGGSNYKLTF,0,1,1,1
TRAV24,TRAJ18,CAFLGRGSTLGRLYF,0,1,1,1
TRAV12-2,TRAJ41,CAVHENSNSGYALNF,0,1,1,1
TRAV39,TRAJ22,CAVVASSGSARQLTF,0,1,1,1
TRAV39,TRAJ40,CAVDITLRGTYKYIF,0,1,1,1
TRAV12-2,TRAJ4,CAVSAFSGGYNKLIF,0,1,1,1
TRAV8-1,TRAJ10,CAVNAFTGGGNKLTF,0,1,1,1
TRAV12-2,TRAJ22,CAVNKPPGSARQLTF,0,1,1,1
TRAV12-2,TRAJ18,CAVKDRGSTLGRLYF,0,1,1,1
TRAV34,TRAJ10,CAAKGLTGGGNKLTF,0,1,1,1
TRAV29DV5,TRAJ18,CAATDKGSTLGRLYF,0,1,1,1
TRAV29DV5,TRAJ52,CAAAAGGTSYGKLTF,0,1,1,1
TRAV13-1,TRAJ48,CAAPISNFGNEKLTF,0,1,1,1
TRAV29DV5,TRAJ34,CAAPEGLGNTDKLIF,0,1,1,1
TRAV13-1,TRAJ38,CAASRRPGNNRKLIW,0,1,1,1
TRAV27,TRAJ52,CAGVGGGTSYGKLTF,0,1,1,1
TRAV27,TRAJ33,CAGDGGLDSNYQLIW,0,1,1,1
TRAV27,TRAJ53,CAGETSGGSNYKLTF,0,1,1,1
TRAV13-2,TRAJ9,CAEIEPHTGGFKTIF,0,1,1,1
TRAV13-2,TRAJ6,CAETEASGGSYIPTF,0,1,1,1
TRAV13-2,TRAJ34,CAENIPPDNTDKLIF,0,1,1,1
TRAV13-2,TRAJ30,CAENIPMNRDDKFIF,0,1,1,1
TRAV12-3,TRAJ22,CAMGMRLGSARQLTF,0,1,1,1
TRAV12-3,TRAJ10,CAMSSGTGGGNKLTF,0,1,1,1
TRAV12-3,TRAJ39,CAMSVGGNAGNMLTF,0,1,1,1
TRAV4,TRAJ26,CLVVTGDNYGQNFVF,0,1,1,1
TRAV4,TRAJ5,CLVGEGRTGRRALTF,0,1,1,1
TRAV8-1,TRAJ10,CAVDSVTGGGNKLTF,0,1,1,1
TRAV12-2,TRAJ42,CAAFYYGGSQGNLIF,0,1,1,1
TRAV26-1,TRAJ26,CIVRVKSGYGQNFVF,0,1,1,1
TRAV8-2,TRAJ40,CVVTEPSGTYKYIF,0,1,1,1
TRAV5,TRAJ33,CVLGGKDSNYQLIW,0,1,1,1
TRAV12-1,TRAJ45,CVVYSGGGADGLTF,0,1,1,1
TRAV12-1,TRAJ26,CVVTLDNYGQNFVF,0,1,1,1
TRAV10,TRAJ39,CVVSANNAGNMLTF,0,1,1,1
TRAV12-1,TRAJ39,CVVRSNNAGNMLTF,0,1,1,1
TRAV12-1,TRAJ8,CVGEMNTGFQKLVF,0,1,1,1
TRAV38-1,TRAJ44,CAFMNPGTASKLTF,0,1,1,1
TRAV38-2DV8,TRAJ27,CAYRSSGDAGKSTF,0,1,1,1
TRAV38-2DV8,TRAJ57,CAYRRGGGSEKLVF,0,1,1,1
TRAV6,TRAJ35,CALGALGFGNVLHC,0,1,1,1
TRAV9-2,TRAJ18,CALGGGSTLGRLYF,0,1,1,1
TRAV19,TRAJ22,CALTGPGSARQLTF,0,1,1,1
TRAV9-2,TRAJ53,CALTSGGSNYKLTF,0,1,1,1
TRAV9-2,TRAJ56,CALSGPGANSKLTF,0,1,1,1
TRAV19,TRAJ54,CALSEAWGAQKLVF,0,1,1,1
TRAV19,TRAJ12,CALSEAGSSYKSTL,0,1,1,1
TRAV9-2,TRAJ44,CALSTDGTASKLTF,0,1,1,1
TRAV19,TRAJ52,CALRGGTSYGKLTF,0,1,1,1
TRAV16,TRAJ6,CALSTTGGSYIPTF,0,1,1,1
TRAV16,TRAJ24,CALKGTDSWGKFQF,0,1,1,1
TRAV12-2,TRAJ57,CAVPSQGGSEKLVF,0,1,1,1
TRAV20,TRAJ4,CAVRLSGGYNKLIF,0,1,1,1
TRAV23DV6,TRAJ30,CAVHPMNRDDKIIF,0,1,1,1
TRAV20,TRAJ49,CAVQAFSTGNQFYF,0,1,1,1
TRAV20,TRAJ3,CAVQADSSASKIFF,0,1,1,1
TRAV20,TRAJ6,CAVQAAGGSYIPTF,0,1,1,1
TRAV20,TRAJ45,CAVQARGGADGLTF,0,1,1,1
TRAV22,TRAJ8,CAVVTNTGFQKLVF,0,1,1,1
TRAV8-3,TRAJ10,CAVAVTGGGNKLTF,0,1,1,1
TRAV29DV5,TRAJ42,CAVGIGGSQGNLIF,0,1,1,1
TRAV12-2,TRAJ17,CAVGIKAAGNKLTF,0,1,1,1
TRAV22,TRAJ45,CAVDPGGGADGLTF,0,1,1,1
TRAV8-6,TRAJ3,CAVTPYSSASKIIF,0,1,1,1
TRAV21,TRAJ34,CAVRPTYNTDKLIF,0,1,1,1
TRAV21,TRAJ20,CAVRPGSNDYKLSF,0,1,1,1
TRAV3,TRAJ5,CAVRPDTGRRALTF,0,1,1,1
TRAV3,TRAJ20,CAVRDRSNDYKLSF,0,1,1,1
TRAV3,TRAJ34,CAVRDAGRTDKLIL,0,1,1,1
TRAV3,TRAJ40,CAVRDDAGTYKYIF,0,1,1,1
TRAV3,TRAJ6,CAVRDIGGSYIPTF,0,1,1,1
TRAV3,TRAJ9,CAVRDITGGFKTIF,0,1,1,1
TRAV22,TRAJ17,CAVNPKAAGNKLTF,0,1,1,1
TRAV3,TRAJ23,CAVNHNNQGGKLIF,0,1,1,1
TRAV8-3,TRAJ26,CAATLTLYGQNFVF,0,1,1,1
TRAV17,TRAJ12,CATPRGDSSYKLIF,0,1,1,1
TRAV24,TRAJ3,CAFNEGSSASKIIF,0,1,1,1
TRAV12-2,TRAJ13,CAVSLSGGYQKVTF,0,1,1,1
TRAV12-2,TRAJ6,CAVLLSGGSYIPTF,0,1,1,1
TRAV12-2,TRAJ43,CAVGGRYNNNDMRF,0,1,1,1
TRAV8-1,TRAJ22,CAVTTSGSARQLTF,0,1,1,1
TRAV12-2,TRAJ56,CAVNLRGANSKLTF,0,1,1,1
TRAV12-2,TRAJ3,CAVNGYSSASKIIF,0,1,1,1
TRAV12-2,TRAJ48,CAVNEAGGNEKLTF,0,1,1,1
TRAV27,TRAJ45,CAFPGGGGADGLTF,0,1,1,1
TRAV12-3,TRAJ17,CASEPKAAGNKLTF,0,1,1,1
TRAV29DV5,TRAJ22,CAAITSGSARQLIF,0,1,1,1
TRAV13-1,TRAJ53,CAAISGGSNYKLTS,0,1,1,1
TRAV13-1,TRAJ26,CAATSDNYGQNFVF,0,1,1,1
TRAV29DV5,TRAJ46,CAASRGSSGDKLTF,0,1,1,1
TRAV29DV5,TRAJ57,CAASAPGGSEKLVF,0,1,1,1
TRAV29DV5,TRAJ50,CAASAETSYDKVIF,0,1,1,1
TRAV29DV5,TRAJ28,CAASARAGSYQLTF,0,1,1,1
TRAV23DV6,TRAJ18,CAASRGSTLGRLYF,0,1,1,1
TRAV23DV6,TRAJ44,CAARGTGTASKLTF,0,1,1,1
TRAV29DV5,TRAJ44,CAAKGRGTASKLTF,0,1,1,1
TRAV29DV5,TRAJ17,CAAKIKAAGNKLTF,0,1,1,1
TRAV13-1,TRAJ37,CAAKGSSNTGKLIF,0,1,1,1
TRAV25,TRAJ52,CAGPAGTTYGKLTF,0,1,1,1
TRAV12-3,TRAJ48,CAMGSGIGNEKLTF,0,1,1,1
TRAV12-3,TRAJ13,CAMTSSGGYQKVTF,0,1,1,1
TRAV12-3,TRAJ20,CAMSSGSNDYKLSF,0,1,1,1
TRAV12-3,TRAJ15,CAMSPGQAGTALIF,0,1,1,1
TRAV12-3,TRAJ53,CAMSAGGSNYKLTF,0,1,1,1
TRAV12-3,TRAJ9,CAMSADTGGFKTIF,0,1,1,1
TRAV12-3,TRAJ5,CAMSANTGRRALTF,0,1,1,1
TRAV12-3,TRAJ13,CAMSESGGYQKVTF,0,1,1,1
TRAV12-3,TRAJ27,CAMSEIGNAGKSTF,0,1,1,1
TRAV4,TRAJ34,CLVGDIGETDKLIF,0,1,1,1
TRAV8-2,TRAJ7,CVVSAPYGNNRLAF,0,1,1,1
TRAV5,TRAJ26,CAVNPPSFGQNFVF,0,1,1,1
TRAV26-1,TRAJ43,CIVRVLYNNNDMRF,0,1,1,1
TRAV22,TRAJ52,SAVPGGTSYGKLTF,0,1,1,1
TRAV8-1,TRAJ37,SSPFSGNTGKLIF,0,1,1,1
TRAV8-1,TRAJ37,CPVFPSNTGKLIF,0,1,1,1
TRAV8-2,TRAJ9,CVVSRGGGFKTIF,0,1,1,1
TRAV8-2,TRAJ40,CVVTGLRTYKYIF,0,1,1,1
TRAV12-1,TRAJ32,CVPTGGATNKLIF,0,1,1,1
TRAV12-1,TRAJ9,CVVFLGGGFKTIF,0,1,1,1
TRAV12-1,TRAJ32,CVVNGGATNKLIF,0,1,1,1
TRAV12-1,TRAJ17,CVVNYGAGNKLTF,0,1,1,1
TRAV12-1,TRAJ40,CVVNGPGTYKYIF,0,1,1,1
TRAV20,TRAJ24,CAFSTDSWGKFQF,0,1,1,1
TRAV38-1,TRAJ34,CAFMITNTDKLIF,0,1,1,1
TRAV41,TRAJ57,CAFTQGGSEKLVF,0,1,1,1
TRAV2,TRAJ5,CALFDTGRRALTF,0,1,1,1
TRAV22,TRAJ26,CASRDNYGQYFVF,0,1,1,1
TRAV38-1,TRAJ43,CASVLNNNNDMRF,0,1,1,1
TRAV38-2DV8,TRAJ33,CAYFPDSNYQLIW,0,1,1,1
TRAV38-2DV8,TRAJ43,CAYRGPSNNDMRF,0,1,1,1
TRAV9-2,TRAJ48,CALSNFGNEKLTF,0,1,1,1
TRAV16,TRAJ39,CALLPGAGNMLTF,0,1,1,1
TRAV29DV5,TRAJ39,CALLNNAGNMLTF,0,1,1,1
TRAV9-2,TRAJ15,CALFFEAGTALIF,0,1,1,1
TRAV9-2,TRAJ3,CALTDSSASKIIF,0,1,1,1
TRAV9-2,TRAJ34,CALSGYNTDKLIF,0,1,1,1
TRAV9-2,TRAJ30,CALSMNRDDKIIF,0,1,1,1
TRAV16,TRAJ13,CALKGGGYQKVTF,0,1,1,1
TRAV41,TRAJ57,CAVGEGGSGKLVF,0,1,1,1
TRAV2,TRAJ6,CAVGSGGSYIPTF,0,1,1,1
TRAV8-4,TRAJ29,CAVTLSGNTPLVF,0,1,1,1
TRAV41,TRAJ41,CAVSPNSGCALNF,0,1,1,1
TRAV20,TRAJ39,CAVRNNAGNMLTF,0,1,1,1
TRAV20,TRAJ29,CAVQAATDTPLVF,0,1,1,1
TRAV20,TRAJ40,CAVQASGTYKYIF,0,1,1,1
TRAV20,TRAJ36,CAVQGSGANNLFF,0,1,1,1
TRAV8-3,TRAJ29,CAVGASGNTPLVF,0,1,1,1
TRAV8-3,TRAJ34,CAVGNSNTDKLIF,0,1,1,1
TRAV2,TRAJ21,CAVGVNNFNKFYF,0,1,1,1
TRAV2,TRAJ33,CAVEDRSNYQLIW,0,1,1,1
TRAV8-6,TRAJ52,CAVTGGSYGKLTF,0,1,1,1
TRAV8-4,TRAJ40,CAVTPSGTYKYIF,0,1,1,1
TRAV8-4,TRAJ7,CAVSAGGNNRLAF,0,1,1,1
TRAV8-6,TRAJ21,CAVSEGNFNKFYF,0,1,1,1
TRAV12-2,TRAJ22,CAVSMGSARQLTF,0,1,1,1
TRAV3,TRAJ22,CAVRLGSARQLTF,0,1,1,1
TRAV3,TRAJ27,CAVRSFNAGKSTF,0,1,1,1
TRAV12-2,TRAJ26,CAVRGNYGQNFVF,0,1,1,1
TRAV1-2,TRAJ30,CAVRGGRDVKIIF,0,1,1,1
TRAV36DV7,TRAJ48,CAVSNFGNEKLTF,0,1,1,1
TRAV12-2,TRAJ22,CAATSGSARQLTF,0,1,1,1
TRAV2,TRAJ3,CAATYSSASKIIF,0,1,1,1
TRAV3,TRAJ6,CAAPGGGSYIPTF,0,1,1,1
TRAV8-6,TRAJ27,CAAKNTNAGKSTF,0,1,1,1
TRAV12-2,TRAJ10,CAADTGGGDKLTF,0,1,1,1
TRAV35,TRAJ40,CAGLTSGTYKYIF,0,1,1,1
TRAV35,TRAJ23,CAGRRNQGGKLIF,0,1,1,1
TRAV35,TRAJ44,CAGQAGTASKLTF,0,1,1,1
TRAV21,TRAJ57,CAGAQGGSEKLVF,0,1,1,1
TRAV17,TRAJ40,CATYTSGTYKYIF,0,1,1,1
TRAV17,TRAJ29,CATARPGNTPLVF,0,1,1,1
TRAV17,TRAJ49,CATDEDTGNQFYF,0,1,1,1
TRAV17,TRAJ57,CATDTGGSEKLVF,0,1,1,1
TRAV8-3,TRAJ42,CASRRGSQGNLIF,0,1,1,1
TRAV12-2,TRAJ16,CAPRYSDGQKLLF,0,1,1,1
TRAV8-1,TRAJ34,CAVLLYNTDKLIF,0,1,1,1
TRAV39,TRAJ43,CAVVEGGNNDMRF,0,1,1,1
TRAV8-1,TRAJ4,CAVGAGGYNKLIF,0,1,1,1
TRAV12-2,TRAJ37,CAVSPGNTGKLIF,0,1,1,1
TRAV8-1,TRAJ43,CAVNADWSNDMRF,0,1,1,1
TRAV8-1,TRAJ41,CAVNSNSGYALNF,0,1,1,1
TRAV12-2,TRAJ58,CAVNLDSGSRLTF,0,1,1,1
TRAV12-2,TRAJ57,CAAGQGGSEKLVF,0,1,1,1
TRAV12-2,TRAJ15,CAGANQAGTTLIF,0,1,1,1
TRAV13-1,TRAJ39,CAASNNAGNMLTF,0,1,1,1
TRAV25,TRAJ49,CAVITNTGNQFYF,0,1,1,1
TRAV5,TRAJ21,CAAPGYNFNKFYF,0,1,1,1
TRAV29DV5,TRAJ20,CAAIGSNDYKLSF,0,1,1,1
TRAV13-1,TRAJ20,CAATLFYDYKLSF,0,1,1,1
TRAV23DV6,TRAJ35,CAASRGFGNVLHC,0,1,1,1
TRAV13-1,TRAJ3,CAASGSSASKIIF,0,1,1,1
TRAV13-1,TRAJ11,CAASIPGYSTLTF,0,1,1,1
TRAV29DV5,TRAJ47,CAASALIGNKLVF,0,1,1,1
TRAV13-1,TRAJ4,CAARPGGYNKLIF,0,1,1,1
TRAV23DV6,TRAJ9,CAAKIGGGFKTIF,0,1,1,1
TRAV27,TRAJ6,CAGISGGSYIPTF,0,1,1,1
TRAV27,TRAJ17,CAGGWAADNKLTF,0,1,1,1
TRAV5,TRAJ8,CADLNTGFQKLVF,0,1,1,1
TRAV13-2,TRAJ20,CAEASRSDYKLSF,0,1,1,1
TRAV13-2,TRAJ24,CAENTDSWGKFQF,0,1,1,1
TRAV13-2,TRAJ37,CAENTGNTGKLIF,0,1,1,1
TRAV13-2,TRAJ12,CAEKGDSSYKLIF,0,1,1,1
TRAV13-2,TRAJ53,CAEKSGSNYKLTF,0,1,1,1
TRAV12-3,TRAJ20,CAMSTSNDYKLSF,0,1,1,1
TRAV12-3,TRAJ58,CAMEETSGSRLTF,0,1,1,1
TRAV14DV4,TRAJ9,CAMSYTGGFKTIF,0,1,1,1
TRAV12-3,TRAJ22,CAMSGISARQLTF,0,1,1,1
TRAV4,TRAJ34,CLVGPSYTDKLIF,0,1,1,1
TRAV30,TRAJ39,CGTGVNAGNMLTF,0,1,1,1
TRAV26-1,TRAJ40,CIVKKSGTYKYIS,0,1,1,1
TRAV26-1,TRAJ20,CIVRDSNDYKLSF,0,1,1,1
TRAV29DV5,TRAJ53,RAAGGGSNYKLTF,0,1,1,1
TRAV20,TRAJ12,CVLMDSSYKLIF,0,1,1,1
TRAV12-1,TRAJ21,CVVGYNFNKFYF,0,1,1,1
TRAV12-1,TRAJ31,CVVNNFNARLMF,0,1,1,1
TRAV12-1,TRAJ37,CVVNMVVGKLIF,0,1,1,1
TRAV38-1,TRAJ29,CAFIVGNTPLVF,0,1,1,1
TRAV38-2DV8,TRAJ43,CAYRSFVHDMRF,0,1,1,1
TRAV38-2DV8,TRAJ23,CALYNQGGKLIF,0,1,1,1
TRAV9-2,TRAJ20,CALRSNDYKLSF,0,1,1,1
TRAV6,TRAJ38,CALVPVNRKLIW,0,1,1,1
TRAV6,TRAJ3,CALGGSASKIIF,0,1,1,1
TRAV17,TRAJ40,CAPTSGTYKYIF,0,1,1,1
TRAV6,TRAJ26,CAPDNYGQNFVF,0,1,1,1
TRAV12-2,TRAJ6,CAQAGGSYIPTF,0,1,1,1
TRAV41,TRAJ49,CAVEQGSNQFYF,0,1,1,1
TRAV41,TRAJ49,CAVRSTGNQFYS,0,1,1,1
TRAV23DV6,TRAJ5,CAVGTGRRALTF,0,1,1,1
TRAV36DV7,TRAJ31,CAVGNNNARLMF,0,1,1,1
TRAV21,TRAJ45,CAVGGGADGLTF,0,1,1,1
TRAV2,TRAJ26,CAVEDKGQNFVL,0,1,1,1
TRAV22,TRAJ34,CAVEDNTDKLIF,0,1,1,1
TRAV22,TRAJ9,CAVITGGFKTIF,0,1,1,1
TRAV8-4,TRAJ20,CAVSHNDYKLSF,0,1,1,1
TRAV21,TRAJ20,CAVRQHDYKLSF,0,1,1,1
TRAV3,TRAJ26,CAVRVAGQNFVF,0,1,1,1
TRAV8-3,TRAJ34,CAVRAEGDKPIF,0,1,1,1
TRAV1-2,TRAJ33,CAVRDGNYQLIW,0,1,1,1
TRAV8-6,TRAJ5,CAVKSGRRALTF,0,1,1,1
TRAV21,TRAJ37,CAVKSNTGKLIF,0,1,1,1
TRAV17,TRAJ20,CATSRSDYKLSF,0,1,1,1
TRAV17,TRAJ31,CATVLGHARLMF,0,1,1,1
TRAV17,TRAJ40,CATVSGTYKYIF,0,1,1,1
TRAV23DV6,TRAJ37,CARSGNTGKLIF,0,1,1,1
TRAV12-2,TRAJ20,CAVTPNDYKLGF,0,1,1,1
TRAV8-1,TRAJ9,CAVNTGGFKTIF,0,1,1,1
TRAV8-6,TRAJ15,CAAQQAGTALIF,0,1,1,1
TRAV8-6,TRAJ12,CATMDSSYKLIF,0,1,1,1
TRAV13-1,TRAJ23,CAPRSEGGKLIL,0,1,1,1
TRAV13-1,TRAJ6,CAAPGGSYIPTF,0,1,1,1
TRAV23DV6,TRAJ49,CAATPNPNQFYF,0,1,1,1
TRAV13-1,TRAJ8,CAATPGFQKLVF,0,1,1,1
TRAV13-1,TRAJ22,CAATGSARQLTF,0,1,1,1
TRAV13-1,TRAJ20,CAASMKDYKLSF,0,1,1,1
TRAV29DV5,TRAJ29,CAASAGNTPLVF,0,1,1,1
TRAV25,TRAJ30,CAGLSRDDKIIF,0,1,1,1
TRAV13-2,TRAJ20,CAEKKYDYKLSF,0,1,1,1
TRAV9-2,TRAJ20,CTLNPNDYKLSF,0,1,1,1
TRAV35,TRAJ28,CFSGAGSYQLTF,0,1,1,1
TRAV4,TRAJ27,CLVSTNAGKSTF,0,1,1,1
TRAV26-2,TRAJ49,CILRDRVGQFYF,0,1,1,1
TRAV12-2,TRAJ42,CALGSQGNLIF,0,1,1,1
TRAV22,TRAJ20,CAVPGDYKLSF,0,1,1,1
TRAV20,TRAJ30,CAVQAGDKIIF,0,1,1,1
TRAV2,TRAJ43,CAVDVGPNMRF,0,1,1,1
TRAV12-2,TRAJ21,CAVDNFNKFYF,0,1,1,1
TRAV24,TRAJ54,CAFEGAQKLVF,0,1,1,1
TRAV17,TRAJ26,CALNYGQNFVF,0,1,1,1
TRAV12-2,TRAJ48,CAVSGNEKLTF,0,1,1,1
TRAV17,TRAJ39,CAGDAGNMLTF,0,1,1,1
TRAV12-3,TRAJ34,CASYKTDKLIF,0,1,1,1
TRAV13-1,TRAJ49,CAASIGNQFYF,0,1,1,1
TRAV29DV5,TRAJ43,CAASGAYDMRF,0,1,1,1
TRAV25,TRAJ49,CAGNTGNQFYF,0,1,1,1
TRAV13-2,TRAJ16,CAERRGQKLLF,0,1,1,1
TRAV36DV7,TRAJ32,CLGGATNKLIF,0,1,1,1
TRAV26-1,TRAJ20,CIVLGGYKLSF,0,1,1,1
TRAV27,TRAJ45,CRGGGADGLTF,0,1,1,1
TRAV41,TRAJ43,CAASTDDMRF,0,1,1,1
TRAV12-2,TRAJ23,CAVLGGKLIF,0,1,1,1
TRAV13-1,TRAJ18,CAAPLGRLYF,0,1,1,1
TRAV25,TRAJ27,CAGGAGKSTF,0,1,1,1
TRAV13-2,TRAJ34,CAEATDKLIY,0,1,1,1
TRAV12-2,TRAJ42,CAVGGNLIF,0,1,1,1
TRAV25,TRAJ29,CARDTPLVF,0,1,1,1
TRAV13-1,TRAJ43,CAALDDMRF,0,1,1,1
TRAV41,TRAJ49,CAPPF,0,1,1,1
