v_hit,j_hit,cdr3,S5-10ng_S10,S5-10ng_S22,freq,count_sum
TRBV7-2,TRBJ2-7,CASSLYYEQYF,69,44,2,113
TRBV5-6,TRBJ2-3,CASSSGLGSDTQYF,24,30,2,54
TRBV14,TRBJ1-2,CASSPGRNYGYTF,17,15,2,32
TRBV9,TRBJ1-1,CASSVSGAGRPEAFF,16,5,2,21
TRBV2,TRBJ1-2,CASSEERDYGYTF,13,12,2,25
TRBV15,TRBJ2-5,CATSRDISGETQYF,2,0,1,2
TRBV7-2,TRBJ2-7,CASSSYYEQYF,14,30,2,44
TRBV19,TRBJ2-7,CASSTTGGWSYEQYF,12,11,2,23
TRBV29-1,TRBJ2-6,CSVAERYRGLAGANVLTF,10,8,2,18
TRBV3-1,TRBJ1-5,CASSPGQGLYSNQPQHF,14,6,2,20
TRBV4-1,TRBJ1-1,CASSQGAGETEAFF,11,11,2,22
TRBV11-1,TRBJ1-1,CASSLTGDTEAFF,10,3,2,13
TRBV10-3,TRBJ2-2,CATEREGIGELFF,8,6,2,14
TRBV7-2,TRBJ2-7,CASSSSSYEQYF,3,0,1,3
TRBV28,TRBJ2-3,CASSPLETSTDTQYF,9,8,2,17
TRBV5-6,TRBJ2-3,CASSLGLGEDTQYF,8,9,2,17
TRBV2,TRBJ2-7,CASSGQGSSYEQYF,8,10,2,18
TRBV30,TRBJ1-1,CAWSVGSYVINTEAFF,10,4,2,14
TRBV14,TRBJ2-1,CASSQARSGRAGSEQFF,7,3,2,10
TRBV7-2,TRBJ2-3,CASSLAGSTDTQYF,8,1,2,9
TRBV19,TRBJ2-1,CASSILGFGEQFF,1,0,1,1
TRBV16,TRBJ1-1,CASSPFGGGNTEAFF,2,0,1,2
TRBV6-2/3/5/6,TRBJ2-5,CASSQDRNQETQYF,2,0,1,2
TRBV29-1,TRBJ2-5,CSVEAGETQYF,2,1,2,3
TRBV9,TRBJ1-5,CASSQGDSLRPQHF,7,4,2,11
TRBV7-3,TRBJ2-5,CASSLGGGTQYF,1,0,1,1
TRBV11-1,TRBJ1-1,CASSPRQGVTEAFF,5,3,2,8
TRBV3-1,TRBJ2-2,CASSPSNTGELFF,3,0,1,3
TRBV20-1,TRBJ2-1,CSARDLDSDYNEQFF,3,3,2,6
TRBV20-1,TRBJ2-1,CSARVSMGQFF,1,0,1,1
TRBV20-1,TRBJ2-1,CSAGRGADYNEQFF,4,3,2,7
TRBV5-4,TRBJ2-5,CSAGTGLAGYQETQYF,1,0,1,1
TRBV20-1,TRBJ2-3,CSARDRASTDTQYF,3,0,1,3
TRBV12-3/4,TRBJ1-2,CASSIPDRGPLSGYTF,1,0,1,1
TRBV18,TRBJ1-1,CASSLTDRGGTEAFF,1,0,1,1
TRBV14,TRBJ2-2,CASSLQGATGELFF,1,0,1,1
TRBV3-1,TRBJ2-1,CASSPSGPIGNEQFF,3,0,1,3
TRBV9,TRBJ1-5,CASSSGTTQNQPQHF,3,0,1,3
TRBV13,TRBJ2-2,CASNIAGRDTGELFF,6,7,2,13
TRBV3-1,TRBJ1-1,CASSQVSHTEAFF,1,1,2,2
TRBV3-1,TRBJ2-1,CASSQWKGAFSYNEQFF,4,3,2,7
TRBV19,TRBJ2-1,CASSITGQGAYNEQFF,1,0,1,1
TRBV3-1,TRBJ2-7,CASSLKRTGEYEQYF,2,4,2,6
TRBV4-1,TRBJ1-1,CASSPPGESPALF,2,0,1,2
TRBV5-6,TRBJ2-1,CASSNTGVYNEQFF,1,0,1,1
TRBV2,TRBJ1-3,CASRSRDAGNTIYF,5,4,2,9
TRBV11-2,TRBJ1-5,CASSSTGRNQPQHF,1,0,1,1
TRBV3-1,TRBJ2-7,CASSQTFSYEQYF,3,0,1,3
TRBV7-6,TRBJ2-1,CASSPPGGGAYNEQFF,1,0,1,1
TRBV7-2,TRBJ1-3,CASSFGVSGNTIYF,1,0,1,1
TRBV30,TRBJ2-1,CARSRGPYNEQFF,1,0,1,1
TRBV29-1,TRBJ2-3,CSVRGASTDTQYF,1,0,1,1
TRBV12-5,TRBJ1-2,CASGLVPQIPPANYGYTF,2,0,1,2
TRBV14,TRBJ1-4,CASSRKRTAVNEKLFF,1,0,1,1
TRBV29-1,TRBJ2-1,CSVNRGPNEQFF,1,0,1,1
TRBV19,TRBJ1-1,CASSKDRVNTEAFF,1,0,1,1
TRBV29-1,TRBJ2-7,CSVVGGQIYEQYF,3,0,1,3
TRBV3-1,TRBJ1-2,CASSQDVAGFGTPYGYTF,3,4,2,7
TRBV9,TRBJ2-7,CASSVGTSGRRAHEQYF,4,2,2,6
TRBV12-3/4,TRBJ1-5,CASSPPGQGFGQPQHF,3,3,2,6
TRBV3-1,TRBJ1-3,CASSREQGSSGNTIYF,2,0,1,2
TRBV2,TRBJ1-2,CASSEDSIYGYTF,1,0,1,1
TRBV5-4,TRBJ2-4,CASSFVEGNIQYF,1,0,1,1
TRBV30,TRBJ2-1,CAWSVPYQAYNEQFF,4,0,1,4
TRBV20-1,TRBJ1-1,CSARAGQGGTEAFF,2,0,1,2
TRBV19,TRBJ2-7,CASRAEATYEQYF,2,0,1,2
TRBV3-1,TRBJ2-4,CASSQSNTRVIAKNIQYF,1,0,1,1
TRBV6-4,TRBJ2-2,CASRTLPGVVGTGELFF,1,0,1,1
TRBV19,TRBJ2-7,CASSLSDWGEPYEQYF,1,0,1,1
TRBV29-1,TRBJ2-7,CSVRLGTVLFTYEQYF,2,0,1,2
TRBV3-1,TRBJ2-3,CASSLAGGGLDTQYF,1,1,2,2
TRBV9,TRBJ1-3,CASSATPHSGNTIYF,1,0,1,1
TRBV18,TRBJ1-5,CASSLSGGNQPQHF,1,0,1,1
TRBV5-4,TRBJ1-2,CASTPGSTNYGYTF,1,0,1,1
TRBV2,TRBJ1-2,CASSEASNYGYTF,3,1,2,4
TRBV20-1,TRBJ2-7,CSANLGGAYEQYF,1,0,1,1
TRBV7-2,TRBJ1-2,CASSLVPGSHYGYTF,1,0,1,1
TRBV6-2/3/5/6,TRBJ2-2,CASSLLPPSGSAGELFF,1,0,1,1
TRBV5-5,TRBJ1-6,CASSLGVRRPQDSPLHF,1,0,1,1
TRBV14,TRBJ2-3,CASSQVVSSTDTQYF,1,0,1,1
TRBV4-2,TRBJ2-7,CASSQEEGAYYEQYF,3,2,2,5
TRBV20-1,TRBJ2-1,CSARLDSGRINEQFF,1,0,1,1
TRBV5-1,TRBJ2-3,CASRGLGTDTQYF,3,0,1,3
TRBV7-9,TRBJ2-7,CASSPDGYEQYF,4,5,2,9
TRBV3-1,TRBJ2-7,CASSQVYEQYF,1,0,1,1
TRBV2,TRBJ2-1,CASDLTGNEQSF,1,0,1,1
TRBV29-1,TRBJ1-1,CSARTGKGTEAFF,5,6,2,11
TRBV7-6,TRBJ2-3,CASSLSKGHTDTQYF,1,0,1,1
TRBV12-3/4,TRBJ1-1,CASSLRGKNTEAFF,1,0,1,1
TRBV20-1,TRBJ2-5,CSATGGGETQYF,5,0,1,5
TRBV5-6,TRBJ1-5,CASSLSGQGSNQPQHF,1,0,1,1
TRBV12-3/4,TRBJ2-7,CASSFGGGFYEQYF,3,0,1,3
TRBV11-3,TRBJ2-5,CASSRALETQYF,1,0,1,1
TRBV6-1,TRBJ2-7,CASSEFGYEQYF,4,1,2,5
TRBV14,TRBJ1-4,CASRGQGTNEKLFF,1,0,1,1
TRBV7-9,TRBJ1-2,CASSFQQGASLSGYTF,1,0,1,1
TRBV28,TRBJ1-1,CASSLVRTTNTEAFF,2,1,2,3
TRBV7-2,TRBJ2-3,CASSLDRISTDTQYF,5,8,2,13
TRBV19,TRBJ1-2,CASTRQSYGYAF,1,0,1,1
TRBV29-1,TRBJ1-2,CSVEDQLGVLGYTF,2,0,1,2
TRBV12-3/4,TRBJ2-1,CASRLTDRDNEQFF,3,1,2,4
TRBV6-2/3/5/6,TRBJ2-1,CASSSGSSYNGQFF,3,0,1,3
TRBV3-1,TRBJ2-1,CASSPHRGSGVSNEQFF,1,0,1,1
TRBV12-3/4,TRBJ2-7,CASSFEGLADTYEQYF,1,0,1,1
TRBV14,TRBJ2-7,CASSPEDRAGAYEQYF,2,0,1,2
TRBV7-9,TRBJ2-7,CASSPSKDSNYEQYF,1,0,1,1
TRBV13,TRBJ1-1,CASSLLQGGTEAFF,1,0,1,1
TRBV28,TRBJ2-7,CASRSSGSSYEQYF,3,2,2,5
TRBV20-1,TRBJ2-3,CSAELAGGADTQYF,1,0,1,1
TRBV29-1,TRBJ2-7,CSVARSGSQDEQYF,1,0,1,1
TRBV19,TRBJ1-5,CASSLGEDQPQHF,1,1,2,2
TRBV6-2/3/5/6,TRBJ2-5,CASSLNRQETQYF,3,0,1,3
TRBV7-2,TRBJ1-1,CASSLGRDLEAFF,1,0,1,1
TRBV5-1,TRBJ2-7,CASSPGAAYEQYF,2,0,1,2
TRBV12-3/4,TRBJ2-3,CASGEGSDTQYF,1,0,1,1
TRBV5-6,TRBJ1-1,CASSFDRNTEAFF,1,0,1,1
TRBV12-3/4,TRBJ1-1,CASSWAGFGTEAFF,1,0,1,1
TRBV19,TRBJ2-5,CASSRQGGIQETQYF,2,0,1,2
TRBV18,TRBJ1-1,CASSRNRIENTEAFF,1,0,1,1
TRBV5-6,TRBJ2-3,CASSLERALLQTSTDTQYF,1,0,1,1
TRBV19,TRBJ1-1,CASSIDTGQQLDTEAFF,1,0,1,1
TRBV6-2/3/5/6,TRBJ2-1,CASSYRSWGSSYNEQFF,1,0,1,1
TRBV2,TRBJ1-1,CASSYPGNGANTEAFF,1,0,1,1
TRBV6-1,TRBJ2-3,CASSEAAGQGADTQYF,4,0,1,4
TRBV5-1,TRBJ2-2,CASSLYAGYNTGELFF,1,0,1,1
TRBV20-1,TRBJ2-2,CSARKQGLANTGELFF,2,0,1,2
TRBV7-9,TRBJ2-1,CASPHNGQGFVEQFF,1,0,1,1
TRBV6-2/3/5/6,TRBJ1-2,CASSPKRNLVNGYTF,1,0,1,1
TRBV2,TRBJ2-6,CASSAQGPGANVLTF,1,0,1,1
TRBV5-5,TRBJ1-4,CASSLVMDSNEKLFF,1,0,1,1
TRBV6-2/3/5/6,TRBJ2-3,CASSPRGASTDTQYF,1,0,1,1
TRBV7-2,TRBJ2-3,CASSRTSDSTDTQYF,1,0,1,1
TRBV7-3,TRBJ2-7,CASSETSGGSYEQYF,1,0,1,1
TRBV19,TRBJ2-1,CASSMEVAYNEQFF,1,0,1,1
TRBV6-2/3/5/6,TRBJ2-3,CASSYSGLTDTQYF,2,0,1,2
TRBV11-3,TRBJ1-1,CASSLSQGMTEAFF,1,0,1,1
TRBV5-4,TRBJ2-2,CASSRDPLAGELFF,1,0,1,1
TRBV5-6,TRBJ2-5,CASSLEFIETQYF,1,0,1,1
TRBV12-3/4,TRBJ2-3,CASSRDSQDTQYF,1,0,1,1
TRBV10-2,TRBJ2-5,CASSEPSQETQYF,1,0,1,1
TRBV5-4,TRBJ2-2,CASSFRLAGAGGELFF,4,2,2,6
TRBV7-9,TRBJ2-7,CASSLEGPTYEQYF,1,0,1,1
TRBV29-1,TRBJ1-1,CSVDSTGMNTEAFF,2,1,2,3
TRBV18,TRBJ2-3,CASSPDTDTQYF,5,2,2,7
TRBV19,TRBJ2-1,CASSIDYYNEQFF,2,0,1,2
TRBV5-5,TRBJ1-4,CASSFVNEKLFF,1,0,1,1
TRBV7-9,TRBJ1-4,CASSFPSTTNEKLFF,3,1,2,4
TRBV29-1,TRBJ1-1,CSTERDYEAFF,2,0,1,2
TRBV9,TRBJ2-1,CASSRRLAGGPYNEQFF,3,0,1,3
TRBV27,TRBJ2-1,CASSPSGLADYNEQFF,4,0,1,4
TRBV11-2,TRBJ1-5,CASSLGQVNSNQPQHF,1,0,1,1
TRBV5-6,TRBJ1-1,CASSFGGSTEAFF,1,0,1,1
TRBV29-1,TRBJ1-1,CSVVPDRGNTEAFF,1,0,1,1
TRBV11-3,TRBJ2-1,CASSLGSEQFF,1,0,1,1
TRBV12-3/4,TRBJ2-7,CASSSSSTGDEQYF,1,0,1,1
TRBV20-1,TRBJ2-2,CSARDPRGAGELFF,1,1,2,2
TRBV7-2,TRBJ2-5,CASSLASAGAGETQYF,1,2,2,3
TRBV28,TRBJ2-7,CASSAAPLYEQYF,1,0,1,1
TRBV3-1,TRBJ1-4,CASSQLDEKLFF,1,0,1,1
TRBV3-1,TRBJ2-6,CASSQGAGQGSGANVLTF,1,0,1,1
TRBV7-2,TRBJ2-7,CASSPWGGPSSYEQYF,2,0,1,2
TRBV19,TRBJ2-2,CASTKELANTGELFF,1,0,1,1
TRBV2,TRBJ2-1,CASTPTEGSYNEQFF,1,0,1,1
TRBV12-3/4,TRBJ2-3,CASSFLAGSADTQYF,2,2,2,4
TRBV7-8,TRBJ2-1,CASSSQPNSYNEQFF,3,0,1,3
TRBV24-1,TRBJ1-1,CATSDLVRDTEAFF,1,0,1,1
TRBV19,TRBJ2-1,CASSVGLANNEQFF,1,0,1,1
TRBV5-5,TRBJ2-7,CASSSGTSLYEQYF,1,0,1,1
TRBV12-3/4,TRBJ2-1,CASSRGGFYNEQFF,1,0,1,1
TRBV7-2,TRBJ2-7,CASSRNLGTYEQYF,2,0,1,2
TRBV3-1,TRBJ1-1,CASSQVGTKGEAFF,1,0,1,1
TRBV5-1,TRBJ1-4,CASSLDPGNEKPFF,1,0,1,1
TRBV27,TRBJ2-3,CASSLSHTDTQYF,1,0,1,1
TRBV5-1,TRBJ2-7,CASSSTGAYEQYF,2,0,1,2
TRBV20-1,TRBJ1-5,CSARLPGNQPQHF,1,0,1,1
TRBV20-1,TRBJ1-2,CSATDGTNYGYTF,1,0,1,1
TRBV29-1,TRBJ1-1,CSGARGKNTEAFF,1,0,1,1
TRBV5-1,TRBJ1-1,CASSSLGRTTEAFF,1,0,1,1
TRBV12-3/4,TRBJ2-2,CASSPGPNTGELFF,1,3,2,4
TRBV20-1,TRBJ1-5,CSASKPDEQIIPNQPQHF,1,0,1,1
TRBV27,TRBJ2-1,CASSLSGLADYNEQFF,2,2,2,4
TRBV5-8,TRBJ2-3,CASSPYRLVRTDTQYF,1,0,1,1
TRBV6-1,TRBJ2-5,CASSERGRRSETQYF,1,0,1,1
TRBV7-9,TRBJ1-1,CASSLEGGLNTEAFF,2,2,2,4
TRBV7-3,TRBJ2-3,CASSKRTGGTDTQYF,1,0,1,1
TRBV4-3,TRBJ1-6,CASSQNMKGGSPLHF,2,2,2,4
TRBV4-3,TRBJ2-1,CASSQERTGFREQFF,1,0,1,1
TRBV20-1,TRBJ2-5,CSARPGQGDQETQYF,1,0,1,1
TRBV20-1,TRBJ2-5,CSASAPLGRQETQYF,2,0,1,2
TRBV19,TRBJ1-1,CASSPGGMNTEAFF,1,0,1,1
TRBV19,TRBJ2-3,CASRPDRGTDTQYF,1,0,1,1
TRBV12-3/4,TRBJ2-3,CASSLWGKSDTQYF,1,0,1,1
TRBV28,TRBJ1-2,CASSLRGGAGGYTF,1,0,1,1
TRBV12-3/4,TRBJ1-1,CASSLGGGDTEAFF,1,0,1,1
TRBV7-3,TRBJ1-1,CASSRDSMNTEAFF,1,0,1,1
TRBV6-4,TRBJ1-5,CASSDEIGGQPQHF,1,0,1,1
TRBV5-1,TRBJ1-1,CASSFDRVSSEAFF,2,0,1,2
TRBV5-1,TRBJ1-1,CASSLLQGNTEAFF,1,0,1,1
TRBV5-1,TRBJ2-7,CASSLLGQGYERYF,1,0,1,1
TRBV20-1,TRBJ2-7,CSAREELEYGEQYF,1,0,1,1
TRBV29-1,TRBJ1-1,CSVLTGGVRTEAFF,1,0,1,1
TRBV12-3/4,TRBJ1-1,CASSLAVGWGAFF,1,0,1,1
TRBV5-5,TRBJ1-1,CASSLLGNTEAFF,1,0,1,1
TRBV7-6,TRBJ1-1,CASSLGVNTEAFF,1,0,1,1
TRBV7-3,TRBJ2-5,CASSLESQETQYF,2,1,2,3
TRBV7-2,TRBJ2-7,CASSSGRAVEQYF,3,0,1,3
TRBV14,TRBJ2-7,CASSHGFSAEQYF,1,0,1,1
TRBV29-1,TRBJ1-1,CSVDTGSRTEAFF,1,0,1,1
TRBV29-1,TRBJ2-1,CSALTGIWDEQFF,1,0,1,1
TRBV13,TRBJ1-1,CASSSRQGEAFF,1,0,1,1
TRBV14,TRBJ2-7,CASSQPGREQYF,1,0,1,1
TRBV20-1,TRBJ1-1,CSARDGDPEAFF,1,0,1,1
TRBV29-1,TRBJ1-2,CSVPDRVNGYTF,1,0,1,1
TRBV29-1,TRBJ1-2,CSVRDRNYGYTF,2,0,1,2
TRBV5-5,TRBJ1-5,CASSLAGDHSNQPQHF,1,0,1,1
TRBV5-1,TRBJ1-1,CASSLGGTKNTEAFF,1,0,1,1
TRBV5-1,TRBJ1-2,CASSDRDQPHYGYTF,1,0,1,1
TRBV7-2,TRBJ2-1,CASSLTSGGTYNEQFF,1,0,1,1
TRBV30,TRBJ1-1,CAWTTGQGLNTEAFF,1,0,1,1
TRBV20-1,TRBJ1-4,CSAQTGLISNEKLFF,1,0,1,1
TRBV12-5,TRBJ2-3,CASGTVSTDTQYF,1,0,1,1
TRBV2,TRBJ2-5,CASGRYQETQYF,1,0,1,1
TRBV7-9,TRBJ1-6,CASSLVGISSYNSPLHF,1,0,1,1
TRBV3-1,TRBJ1-1,CASSPDRVNTEAFF,2,0,1,2
TRBV20-1,TRBJ2-1,CSASAGTGDLYSSYNEQFF,1,0,1,1
TRBV11-3,TRBJ2-5,CASSPRTGLKGWKETQYF,1,0,1,1
TRBV3-1,TRBJ2-6,CASSQIRAQGVGANVLTF,1,0,1,1
TRBV5-1,TRBJ2-1,CASSLGTGVKNSYNEQFF,1,0,1,1
TRBV7-2,TRBJ2-3,CASAGVAGVFETDTQYF,2,0,1,2
TRBV13,TRBJ2-1,CASSLLYTGNSYNEQFF,1,0,1,1
TRBV3-1,TRBJ2-7,CGSSQDILAGDTYEQYF,1,0,1,1
TRBV3-1,TRBJ2-3,CASSPFEGGSTDTQYF,1,0,1,1
TRBV7-9,TRBJ1-1,CASSPRTGDMNTEAFF,1,0,1,1
TRBV3-1,TRBJ2-1,CASSQQGLALSDEQFF,1,0,1,1
TRBV7-2,TRBJ2-1,CASGVGLLGDNEQFF,1,0,1,1
TRBV11-3,TRBJ1-2,CASSFLTGDDGGYTF,1,0,1,1
TRBV9,TRBJ2-1,CASSPFSGRMNEQFF,1,0,1,1
TRBV12-3/4,TRBJ2-3,CASSRAGTGSDTQYF,1,0,1,1
TRBV11-2,TRBJ2-3,CASRRTSGSTDTQYF,1,0,1,1
TRBV5-1,TRBJ1-1,CASSLAAGLNTEAFF,2,0,1,2
TRBV5-1,TRBJ2-3,CASSSRDRGADTQYF,1,0,1,1
TRBV5-1,TRBJ1-1,CASSPVGLLNTEAFF,1,0,1,1
TRBV5-1,TRBJ2-7,CASSKASGRTHEQYF,1,0,1,1
TRBV19,TRBJ1-1,CASSIRGQDTEAFF,1,0,1,1
TRBV2,TRBJ2-7,CASIPGTGSYEQYF,1,0,1,1
TRBV12-3/4,TRBJ1-2,CASSLSDKTTGYTF,1,0,1,1
TRBV7-3,TRBJ2-1,CASSPGTNNNEQFF,1,0,1,1
TRBV5-6,TRBJ2-7,CASSSGGQPYEQYF,1,0,1,1
TRBV20-1,TRBJ2-7,CCARRTSELDEQYF,1,0,1,1
TRBV5-1,TRBJ1-1,CASSLVWSSTEAFF,1,0,1,1
TRBV20-1,TRBJ2-3,CSARASTNTDTQYF,1,0,1,1
TRBV20-1,TRBJ2-2,CSARALAETGELFF,2,0,1,2
TRBV6-2/3/5/6,TRBJ2-7,CASSLGGTYEQYF,1,0,1,1
TRBV2,TRBJ1-1,CASSPQANTEAFF,1,0,1,1
TRBV2,TRBJ1-5,CASSEWAPQPQHF,4,4,2,8
TRBV7-9,TRBJ1-5,CASSLAGRRPQHF,4,4,2,8
TRBV7-9,TRBJ2-7,CASSLGLTYEQYF,1,0,1,1
TRBV5-6,TRBJ1-2,CASSAGTAYGYTF,1,0,1,1
TRBV5-1,TRBJ1-1,CASRQGLNTEAFF,2,0,1,2
TRBV7-9,TRBJ2-1,CASSFGFGEQFF,1,1,2,2
TRBV20-1,TRBJ2-7,CSARVGSYEQYF,1,0,1,1
TRBV20-1,TRBJ2-7,CSARVTGYEQYF,1,0,1,1
TRBV20-1,TRBJ2-3,CSARGSTDTQYF,1,0,1,1
TRBV29-1,TRBJ1-1,CSVGTGLTEAFF,1,0,1,1
TRBV29-1,TRBJ1-4,CSFYNEKLFF,3,3,2,6
TRBV13,TRBJ1-6,CASSLETGINSPLHF,1,0,1,1
TRBV3-1,TRBJ1-1,CASSQVKMTNTEAFF,2,0,1,2
TRBV20-1,TRBJ1-1,CSARDFGGTEAFF,1,0,1,1
TRBV12-3/4,TRBJ1-5,CASSLSRWYSNQPQHF,1,0,1,1
TRBV12-3/4,TRBJ1-1,CASSPNQGARGNEAFF,1,0,1,1
TRBV11-2,TRBJ2-5,CASSFPDSQETQYF,1,0,1,1
TRBV5-1,TRBJ1-6,CASSLTGVDSPLHF,1,0,1,1
TRBV7-6,TRBJ2-1,CASSIMSGERSNEQFF,1,0,1,1
TRBV12-3/4,TRBJ2-3,CASSLVQTGLDTQHF,1,0,1,1
TRBV5-6,TRBJ2-3,CASSSLRGGRDTRYF,1,0,1,1
TRBV24-1,TRBJ1-5,CATGTVNQPQHF,2,0,1,2
TRBV5-1,TRBJ1-5,CASSEGQGGSNQPQHF,1,0,1,1
TRBV6-2/3/5/6,TRBJ2-2,CVSSYSGGGHTGELFF,1,0,1,1
TRBV18,TRBJ2-1,CASSPVETGGNEQFF,1,0,1,1
TRBV6-2/3/5/6,TRBJ1-5,CASSLQGAGNQPQHF,2,0,1,2
TRBV29-1,TRBJ1-1,CSVEDSGQGGTEAFF,1,0,1,1
TRBV15,TRBJ2-3,CATSRDTSGRSSESDTQYF,1,0,1,1
TRBV7-6,TRBJ1-5,CASSPRSGQGTINNQPQHF,1,1,2,2
TRBV7-2,TRBJ2-6,CASSVPEGQGRTGANVLTF,1,0,1,1
TRBV5-6,TRBJ2-3,CASSRPTSGDSTDTQYF,1,0,1,1
TRBV20-1,TRBJ2-3,CSARDSRAGGHTDTQYF,2,0,1,2
TRBV19,TRBJ2-1,CASSIGSREGYNEQFF,1,0,1,1
TRBV12-3/4,TRBJ2-1,CASSLARGYLDNEQFF,1,0,1,1
TRBV7-9,TRBJ2-2,CASSLVWTGVTGELFF,1,0,1,1
TRBV11-2,TRBJ1-2,CASSLEARGTLYGYTF,1,0,1,1
TRBV12-3/4,TRBJ1-5,CASSSTRQYSNQPQHF,2,0,1,2
TRBV10-1,TRBJ2-3,CASSARLAGDTDTQYF,1,0,1,1
TRBV5-1,TRBJ1-4,CASSLDPTAHNEKLFF,1,0,1,1
TRBV5-1,TRBJ2-1,CASSPGGTGSYNEQFF,1,0,1,1
TRBV19,TRBJ2-3,CASSIGGRRTDAQYF,1,0,1,1
TRBV7-9,TRBJ2-7,CASGMGGQPSYEQYF,1,0,1,1
TRBV28,TRBJ1-5,CASTSGGLGNQPQHF,3,0,1,3
TRBV27,TRBJ2-7,CASSTRTRESYEQYF,1,0,1,1
TRBV7-2,TRBJ2-3,CASSLAQGRGDTQYF,1,0,1,1
TRBV5-4,TRBJ2-4,CASSSPGRGLNIQYF,1,0,1,1
TRBV5-1,TRBJ1-2,CASSLARGLNYGYTF,2,0,1,2
TRBV20-1,TRBJ2-7,CSARIPAGLSYEQYF,1,0,1,1
TRBV29-1,TRBJ2-7,CSVDRLGTGELEQYF,2,0,1,2
TRBV19,TRBJ2-5,CASSIRHDQETQYF,1,0,1,1
TRBV27,TRBJ2-7,CASTPGGRFYEQYF,1,0,1,1
TRBV28,TRBJ2-7,CASTRGSFNYEQYF,1,0,1,1
TRBV12-3/4,TRBJ2-7,CASSLSGDSYEQYF,1,0,1,1
TRBV12-3/4,TRBJ1-6,CASSLSPTNSPLHF,1,0,1,1
TRBV12-3/4,TRBJ1-1,CASSLMGSRGGAFF,1,1,2,2
TRBV11-2,TRBJ2-1,CASSLGTLDYEQFF,1,0,1,1
TRBV7-2,TRBJ1-1,CASSLDSSNTEAFF,1,0,1,1
TRBV12-3/4,TRBJ2-7,CASSLGQGNYEQYF,2,0,1,2
TRBV11-2,TRBJ2-5,CASSLDRGAETQYF,2,0,1,2
TRBV12-3/4,TRBJ1-5,CASSLRQGIQPQHF,1,0,1,1
TRBV3-1,TRBJ1-1,CASSQVLGDTEAFF,1,0,1,1
TRBV9,TRBJ2-7,CASSVGGPSYEQYF,2,0,1,2
TRBV12-3/4,TRBJ2-7,CASRPGGQGDEQYF,1,0,1,1
TRBV6-2/3/5/6,TRBJ1-1,CASNPNRFHTEAFF,1,0,1,1
TRBV5-1,TRBJ1-1,CASRRTGENTEAFF,1,0,1,1
TRBV20-1,TRBJ1-1,CSAPPGTGSTEAFF,1,1,2,2
TRBV20-1,TRBJ1-1,CSANPRGGAGGAFF,1,0,1,1
TRBV2,TRBJ2-1,CATRTDPNNEQFF,1,0,1,1
TRBV12-3/4,TRBJ2-3,CASTATLGDTQYF,2,0,1,2
TRBV5-4,TRBJ1-1,CASSLAGGTEAFF,1,0,1,1
TRBV7-8,TRBJ2-7,CASSLGTTYEQYF,1,0,1,1
TRBV9,TRBJ1-1,CASSVEGNTEAFF,1,0,1,1
TRBV6-4,TRBJ1-5,CASRDTRNQPQHF,2,5,2,7
TRBV4-3,TRBJ2-7,CASSAGTSYEQYF,1,3,2,4
TRBV5-1,TRBJ2-5,CASRRGAEETQYF,1,0,1,1
TRBV20-1,TRBJ2-4,CSALTRDQNIQYF,1,0,1,1
TRBV20-1,TRBJ1-1,CSAQGLLNTEAFF,1,0,1,1
TRBV20-1,TRBJ2-5,CSASGGTQETQYF,2,0,1,2
TRBV29-1,TRBJ1-5,CSVGGYSNQPQHF,1,0,1,1
TRBV29-1,TRBJ2-1,CSVDRGPYNEQFF,1,0,1,1
TRBV19,TRBJ1-5,CASSIELKPQHF,1,0,1,1
TRBV12-3/4,TRBJ2-1,CASSTRFDEQFF,1,0,1,1
TRBV7-9,TRBJ1-1,CASSLAEGEAFF,1,0,1,1
TRBV29-1,TRBJ1-1,CSVNRGPTEAFF,1,2,2,3
TRBV20-1,TRBJ1-1,CSATGDTEAFF,2,0,1,2
TRBV20-1,TRBJ1-1,CSATNRTETNTEAFF,3,0,1,3
TRBV29-1,TRBJ1-2,CSDRLAGRYGYTF,1,0,1,1
TRBV2,TRBJ2-2,CASTTNTGELFF,2,1,2,3
TRBV14,TRBJ1-4,CASSQDAARKHEKLFF,1,0,1,1
TRBV12-3/4,TRBJ1-1,CASSPTYGGNTEAFF,1,0,1,1
TRBV28,TRBJ1-1,CASSPPGQWNTEAFF,1,1,2,2
TRBV2,TRBJ2-7,CASSELAESYEQYF,2,0,1,2
TRBV11-2,TRBJ2-1,CASSLVRRANEQFF,1,0,1,1
TRBV11-2,TRBJ2-2,CASSGSGYTGELFF,1,0,1,1
TRBV7-9,TRBJ2-1,CASRSGGSMDEQFF,1,0,1,1
TRBV4-2,TRBJ2-3,CASSQKGIGFSGIGTDTQYF,1,0,1,1
TRBV9,TRBJ2-1,CASSVGLAGGDEQFF,1,0,1,1
TRBV9,TRBJ1-2,CASSAGLTYGYTF,2,2,2,4
TRBV19,TRBJ2-6,CASSTRGTGHLSGANVLTF,1,0,1,1
TRBV18,TRBJ2-1,CASSPPVYQGNYWDEQFF,1,0,1,1
TRBV4-3,TRBJ2-6,CASSQDSVTGSGANVLTF,1,0,1,1
TRBV29-1,TRBJ1-3,CSAGPGQGAPYPAKTIYF,1,0,1,1
TRBV28,TRBJ1-5,CASSVRDSPYSNQPQHF,1,0,1,1
TRBV7-2,TRBJ2-7,CASSPSRSLAGEGEQYF,1,0,1,1
TRBV10-2,TRBJ1-5,CASSESRDRGLRQPQHF,1,0,1,1
TRBV15,TRBJ1-6,CATSRDRSSYNSPLHF,1,0,1,1
TRBV18,TRBJ2-7,CASSPLRAGGSYEQYF,1,0,1,1
TRBV18,TRBJ1-2,CASSPESRGANYGYTF,1,0,1,1
TRBV12-3/4,TRBJ1-5,CASSLARGYGNQPQHF,2,0,1,2
TRBV27,TRBJ2-7,CASSPDTTTASYEQYF,1,0,1,1
TRBV6-4,TRBJ1-5,CASSDPRWGSNQPQHF,1,0,1,1
TRBV7-2,TRBJ2-1,CASSLDGFSSYNEQFF,2,2,2,4
TRBV5-5,TRBJ1-6,CASSSRDLNYNSPLHF,1,0,1,1
TRBV7-8,TRBJ1-3,CASSLISSTFGNTIYF,1,0,1,1
TRBV7-9,TRBJ2-2,CASSPTSGRHTGELFF,1,0,1,1
TRBV11-3,TRBJ2-3,CASSRGTSGRTDTQYF,1,0,1,1
TRBV6-4,TRBJ2-7,CASSQDPGQSSYEQYF,1,0,1,1
TRBV7-9,TRBJ2-3,CASRLSSTGLADTQYF,1,0,1,1
TRBV5-1,TRBJ2-1,CASSPFSGRALNEQFF,2,3,2,5
TRBV12-5,TRBJ1-1,CASALRPQLGTEAFF,1,1,2,2
TRBV19,TRBJ2-4,CASSTLEFAKNIQYF,1,0,1,1
TRBV28,TRBJ2-1,CASSLPGILINEQFF,1,0,1,1
TRBV2,TRBJ2-2,CASSVKQGGTGELFF,1,0,1,1
TRBV25-1,TRBJ2-7,CASSDIAGGLYEQYF,2,0,1,2
TRBV11-2,TRBJ1-1,CASSLTGTGGTEAFF,1,0,1,1
TRBV7-9,TRBJ1-4,CASSLDRGWNEKLFF,1,0,1,1
TRBV5-5,TRBJ2-1,CASSPPDTGSREQFF,1,0,1,1
TRBV11-1,TRBJ2-1,CASSQAVPPLGEQFF,1,0,1,1
TRBV7-9,TRBJ2-1,CASSGLAGAYNEQFF,1,0,1,1
TRBV4-1,TRBJ2-3,CASSLWTSEGDTQYF,1,0,1,1
TRBV5-1,TRBJ2-1,CASSPPTSGGDEQFF,1,0,1,1
TRBV5-1,TRBJ1-4,CASSHRSASDEKLFF,1,0,1,1
TRBV20-1,TRBJ2-1,CSARGPGQGADEQFF,1,0,1,1
TRBV20-1,TRBJ1-4,CSAREVTGSNEKLFF,1,0,1,1
TRBV20-1,TRBJ2-7,CSAKGGTGGPYEQYF,1,0,1,1
TRBV29-1,TRBJ1-1,CSVGDRGEFDTEAFF,1,0,1,1
TRBV29-1,TRBJ2-1,CSVIITGGVHNEQFF,1,0,1,1
TRBV29-1,TRBJ1-1,CSVRTGAARNTEAFF,1,0,1,1
TRBV29-1,TRBJ2-1,CSVHPSDSSYNEQFF,2,0,1,2
TRBV12-5,TRBJ1-3,CASGLVAGGNTIYF,1,0,1,1
TRBV12-5,TRBJ1-5,CASGRQGVNQPQHF,1,0,1,1
TRBV19,TRBJ1-5,CASSIVASNQPQHF,1,0,1,1
TRBV5-5,TRBJ1-5,CASSLADSNQPQHF,1,0,1,1
TRBV12-3/4,TRBJ1-1,CASSLQGWNTEAFF,2,0,1,2
TRBV12-3/4,TRBJ1-4,CASSLQGVGEKLFF,1,0,1,1
TRBV12-3/4,TRBJ1-3,CASSSSTGRDTIYF,1,0,1,1
TRBV6-2/3/5/6,TRBJ1-5,CASSRDLSNQPQHF,1,0,1,1
TRBV6-4,TRBJ2-1,CASSELRGDNEQFF,1,0,1,1
TRBV7-9,TRBJ2-3,CASSFARSTDTQYF,1,0,1,1
TRBV7-9,TRBJ1-3,CASSPEGSGNTIYF,1,0,1,1
TRBV3-1,TRBJ2-5,CASSQWGGQETQYF,1,0,1,1
TRBV9,TRBJ2-5,CASSVGSREETQYF,1,0,1,1
TRBV3-1,TRBJ2-4,CASSARTSGGIQYF,1,0,1,1
TRBV5-1,TRBJ2-1,CASSLAVLAGEQFF,1,0,1,1
TRBV4-3,TRBJ2-3,CASSQDSSTDTQYF,1,0,1,1
TRBV5-1,TRBJ2-1,CASSARGVNNEQFF,1,0,1,1
TRBV20-1,TRBJ1-1,CSAESRGRWAEAFF,1,0,1,1
TRBV20-1,TRBJ1-1,CSARGGDIDTEAFF,1,0,1,1
TRBV29-1,TRBJ2-6,CSVLTGSGANVLTF,1,0,1,1
TRBV29-1,TRBJ2-3,CSVETGDRTDTQYF,1,0,1,1
TRBV29-1,TRBJ2-1,CSAPTSGSYNEQFF,1,0,1,1
TRBV12-5,TRBJ1-5,CASGLAIDRTWHF,2,0,1,2
TRBV19,TRBJ1-5,CASSSAGNQPQHF,2,0,1,2
TRBV12-3/4,TRBJ1-2,CASSPQGSYGYTF,1,0,1,1
TRBV7-3,TRBJ2-1,CASSFGTANEQFF,1,0,1,1
TRBV3-1,TRBJ2-1,CASSRAPGDEQFF,1,0,1,1
TRBV3-1,TRBJ2-1,CASSQVRAGEQFF,1,0,1,1
TRBV14,TRBJ2-7,CASSQGRFYEQYF,1,0,1,1
TRBV3-1,TRBJ2-7,CASSERHPWEQYF,1,0,1,1
TRBV27,TRBJ2-7,CASRLGGSGEQYF,1,0,1,1
TRBV12-3/4,TRBJ2-1,CASNVGGGTEQFF,1,0,1,1
TRBV5-1,TRBJ2-1,CASTGDSLFEQFF,2,0,1,2
TRBV20-1,TRBJ1-6,CSARGGEDSPLHF,1,2,2,3
TRBV29-1,TRBJ2-3,CSARDRARDTQYF,2,0,1,2
TRBV29-1,TRBJ1-1,CSGDRVANTEAFF,1,0,1,1
TRBV7-2,TRBJ2-1,CATGDSYNEQFF,1,0,1,1
TRBV12-3/4,TRBJ1-1,CASSFNYLGAFF,1,0,1,1
TRBV12-3/4,TRBJ2-7,CASSPRGYEQYF,1,0,1,1
TRBV7-9,TRBJ2-7,CASSAGGYEQYF,1,0,1,1
TRBV14,TRBJ2-1,CASRSGGNEQFF,1,0,1,1
TRBV29-1,TRBJ2-7,CSARDISYEQYF,1,0,1,1
TRBV20-1,TRBJ1-1,CSAREGQPAFF,1,0,1,1
TRBV29-1,TRBJ1-2,CSVGGLEGYTF,1,0,1,1
TRBV5-1,TRBJ1-3,CASSPRQESSGNTIYF,1,0,1,1
TRBV7-9,TRBJ2-1,CASSLGSSYNEQFF,1,0,1,1
TRBV27,TRBJ2-1,CASSWGAHNEQFF,1,0,1,1
TRBV5-1,TRBJ2-4,CASTGVEGLTLAKNIQYF,2,0,1,2
TRBV20-1,TRBJ2-1,CSARDAGGSVSYNEQFF,1,0,1,1
TRBV6-2/3/5/6,TRBJ2-1,CASSYSLAGANEQFF,1,0,1,1
TRBV11-2,TRBJ2-5,CASSLDIQETQYF,1,0,1,1
TRBV15,TRBJ2-1,CATSRDRGLAGVLSYNEQFF,1,0,1,1
TRBV7-9,TRBJ2-3,CASSQVAGGPGTDTQYF,1,1,2,2
TRBV4-1,TRBJ1-5,CVSSQDPGDGENQPQHF,1,0,1,1
TRBV5-1,TRBJ2-4,CASTPGGGRRKDIQYF,2,0,1,2
TRBV5-4,TRBJ2-2,CASSLDSTNTGELFF,1,0,1,1
TRBV28,TRBJ1-3,CASRPGTVRGNTIYF,1,0,1,1
TRBV7-2,TRBJ2-3,CASSLWTTDTEYF,1,0,1,1
TRBV12-3/4,TRBJ1-5,CASSFRALTGGVPTSYSNQPQHF,1,0,1,1
TRBV27,TRBJ2-7,CASSSNGLIGVSGRNYYSYEQYF,2,0,1,2
TRBV4-2,TRBJ2-6,CASSQDPLAGVGGANVLTF,1,0,1,1
TRBV20-1,TRBJ2-7,CSARGAWDYVTSGIGEQYF,1,0,1,1
TRBV18,TRBJ1-1,CASSPFNGVARSDTEAFF,1,0,1,1
TRBV7-8,TRBJ2-7,CASSLDTLDPLLSYEQYF,2,0,1,2
TRBV5-1,TRBJ2-1,CASSSNPRQGTFHNEQFF,1,0,1,1
TRBV7-9,TRBJ2-1,CASSSRTSGIVYNEQFF,1,0,1,1
TRBV5-1,TRBJ2-1,CASSLFTGRNSHNEQFF,1,0,1,1
TRBV20-1,TRBJ2-3,CSAREGVGLAATDTQYF,1,0,1,1
TRBV10-3,TRBJ2-1,CAISAGGVITYNEQFF,1,0,1,1
TRBV19,TRBJ2-3,CASGTMGQESTDTQYF,1,0,1,1
TRBV19,TRBJ1-1,CASSNRDRGAGTEAFF,1,0,1,1
TRBV18,TRBJ2-2,CASSPFRGVNTGELFF,2,0,1,2
TRBV2,TRBJ2-1,CASSDSGTGVINEQFF,1,0,1,1
TRBV2,TRBJ2-7,CASSDVSGGPPYEQYF,1,0,1,1
TRBV11-2,TRBJ1-1,CASSLWSGGSRTEAFF,1,0,1,1
TRBV7-2,TRBJ1-1,CASSLEGQGSPEKTFF,1,0,1,1
TRBV3-1,TRBJ2-6,CASSLVSGSGANVLTF,1,1,2,2
TRBV4-2,TRBJ1-2,CASSQGLADRGVGYTF,1,0,1,1
TRBV5-4,TRBJ2-1,CASSKEQTSGGNEQFF,1,0,1,1
TRBV7-8,TRBJ2-1,CASRPGTSGHYNEQFF,1,0,1,1
TRBV7-2,TRBJ2-1,CASRLVRGRGYNEQFF,1,0,1,1
TRBV5-1,TRBJ2-1,CASSRTPNNPYNEQFF,1,0,1,1
TRBV20-1,TRBJ2-3,CSAPRTSGGFTDTQYF,1,0,1,1
TRBV20-1,TRBJ1-2,CSARDRRQGQRKGYTF,1,0,1,1
TRBV30,TRBJ2-2,CAWSYSWTTTGELFF,1,0,1,1
TRBV30,TRBJ1-1,CAWSDRTGSNTEAFF,1,0,1,1
TRBV24-1,TRBJ2-5,CATSDPTGDQETQYF,1,0,1,1
TRBV19,TRBJ1-4,CASSIFPGGGEKLFF,1,0,1,1
TRBV19,TRBJ1-1,CASSTLQGAGTEAFF,1,0,1,1
TRBV19,TRBJ1-2,CASRPQGQGSYGYTF,1,0,1,1
TRBV18,TRBJ2-5,CASSPPGQPWETQYF,1,0,1,1
TRBV2,TRBJ2-1,CASTPGLGAYNEQFF,1,0,1,1
TRBV12-3/4,TRBJ2-7,CASSFPQGGSYEQYF,1,1,2,2
TRBV12-3/4,TRBJ1-1,CASSLGEGRNAEAFF,1,0,1,1
TRBV6-2/3/5/6,TRBJ2-4,CASSYRGGVRNIQYF,2,0,1,2
TRBV3-1,TRBJ2-1,CASSPTSTGEYEQFF,1,0,1,1
TRBV12-3/4,TRBJ2-1,CASSPDRPGYNEQFF,2,1,2,3
TRBV11-2,TRBJ1-3,CASSRTGDAGNTIYF,1,0,1,1
TRBV6-1,TRBJ2-1,CASSGTSGTYNEQFF,1,0,1,1
TRBV2,TRBJ2-1,CASSEGLAGDNEQFF,1,0,1,1
TRBV5-8,TRBJ1-1,CASSLGGTVDTEAFF,1,0,1,1
TRBV7-8,TRBJ1-6,CASSLGTGKASPLHF,1,2,2,3
TRBV5-4,TRBJ2-3,CASSSRAPSTDTQYF,1,0,1,1
TRBV3-1,TRBJ1-4,CASSSLSATNEKLFF,1,0,1,1
TRBV5-1,TRBJ2-5,CASSLRGGLGETQYF,1,0,1,1
TRBV5-1,TRBJ1-4,CASSLGGRANEKLFF,1,0,1,1
TRBV5-1,TRBJ2-7,CASSSTGLAAYEQYF,1,0,1,1
TRBV4-1,TRBJ2-5,CASSQGAGFQETQYF,1,0,1,1
TRBV20-1,TRBJ1-1,CSARDFQEVNTEAFF,1,0,1,1
TRBV20-1,TRBJ2-7,CSARDMGQNPYEQYF,1,0,1,1
TRBV20-1,TRBJ1-1,CSARESTGSHTEAFF,1,0,1,1
TRBV20-1,TRBJ2-3,CSAREAGGSTDTQYF,1,0,1,1
TRBV29-1,TRBJ2-3,CSVESLAGGTDTQYF,1,0,1,1
TRBV30,TRBJ1-2,CAWSPRGLARGYTF,1,0,1,1
TRBV19,TRBJ2-4,CASSSRTGLGIQYF,1,0,1,1
TRBV19,TRBJ1-1,CASSMIAGSAEAFF,1,0,1,1
TRBV7-3,TRBJ1-1,CASAHGGQNTEAFF,1,0,1,1
TRBV28,TRBJ2-2,CASTLADHTGELFF,1,0,1,1
TRBV12-3/4,TRBJ2-1,CASSFSAGVNEQFF,1,0,1,1
TRBV12-3/4,TRBJ2-5,CASSSDIREETQYF,1,0,1,1
TRBV12-3/4,TRBJ2-1,CASSYSSNPNEQFF,2,0,1,2
TRBV25-1,TRBJ1-1,CASSAPTGNTEAFF,1,0,1,1
TRBV2,TRBJ2-2,CASSENSDTGELFF,1,0,1,1
TRBV7-2,TRBJ2-2,CASSLDHGAGELFF,3,1,2,4
TRBV5-6,TRBJ2-1,CASSLTSGSNEQFF,2,0,1,2
TRBV7-2,TRBJ2-5,CASSLVAGEETQYF,1,0,1,1
TRBV7-2,TRBJ2-7,CASSPGGSKTEQYF,1,1,2,2
TRBV3-1,TRBJ2-4,CASSPTGLQNIQYF,1,0,1,1
TRBV12-3/4,TRBJ1-4,CASSEPTTNEKLFF,1,0,1,1
TRBV2,TRBJ2-7,CASSRTSGSYEQYF,1,1,2,2
TRBV12-3/4,TRBJ1-5,CASRGGQYNQPQHF,1,0,1,1
TRBV5-6,TRBJ2-7,CASRRSGGLYEQYF,1,0,1,1
TRBV5-1,TRBJ2-7,CASSRPDRYYEQYF,1,0,1,1
TRBV10-2,TRBJ1-2,CASSESPGIRGYTF,1,1,2,2
TRBV5-1,TRBJ1-1,CASSFSGRNTEAFF,1,0,1,1
TRBV5-1,TRBJ2-7,CASSSGGPSNEQYF,1,0,1,1
TRBV5-1,TRBJ2-1,CASSPYSGDNEQFF,1,0,1,1
TRBV4-3,TRBJ2-3,CASSQGPGTDTQYF,1,0,1,1
TRBV4-3,TRBJ1-5,CASSQEAHHQPQHF,1,0,1,1
TRBV20-1,TRBJ1-5,CSAITAIGRKPQHF,1,0,1,1
TRBV20-1,TRBJ2-1,CSASGSGSLNEQFF,1,0,1,1
TRBV20-1,TRBJ2-3,CSAREGQGTDTQYF,1,0,1,1
TRBV29-1,TRBJ2-7,CSVRRDIETYEQYF,1,0,1,1
TRBV29-1,TRBJ2-7,CSVELATHAYEQYF,1,0,1,1
TRBV29-1,TRBJ2-1,CSVNGRLAELPPFF,1,0,1,1
TRBV29-1,TRBJ2-3,CSAITRAGTDTQYF,1,0,1,1
TRBV30,TRBJ2-1,CAWSGHIGDLQFF,1,0,1,1
TRBV10-3,TRBJ1-1,CAISETGNTEAFF,1,0,1,1
TRBV18,TRBJ2-3,CASSLTAEDTQYF,1,0,1,1
TRBV12-3/4,TRBJ1-1,CASSLPPRTEAFF,1,0,1,1
TRBV12-3/4,TRBJ2-7,CASSLPGACEQYF,1,0,1,1
TRBV6-2/3/5/6,TRBJ2-1,CASSLQGVDEQFF,1,0,1,1
TRBV12-3/4,TRBJ1-2,CASSSDSYYGYTF,2,0,1,2
TRBV6-1,TRBJ1-4,CASSEVANEKLFF,1,0,1,1
TRBV7-9,TRBJ1-4,CASSLNLGEKLFF,1,0,1,1
TRBV5-6,TRBJ2-7,CASSWDSSYEQYF,1,0,1,1
TRBV7-9,TRBJ1-2,CASSPGQGNGYTF,1,0,1,1
TRBV7-3,TRBJ1-1,CASSVIRDTEAFF,1,0,1,1
TRBV3-1,TRBJ1-1,CASSRGPMTEAFF,1,0,1,1
TRBV19,TRBJ1-3,CGSKGGAGNTIYF,1,0,1,1
TRBV5-1,TRBJ2-2,CASRTGGTGELFF,1,0,1,1
TRBV20-1,TRBJ2-1,CSAYGGSYNEQFF,1,0,1,1
TRBV29-1,TRBJ1-2,CSVETGNNYGYTF,1,0,1,1
TRBV12-5,TRBJ2-7,CASNQGDNEQYF,1,0,1,1
TRBV3-1,TRBJ1-4,CACGGPNEKLFF,1,0,1,1
TRBV30,TRBJ1-1,CAWSVGGTEAFF,1,0,1,1
TRBV19,TRBJ2-1,CASSIGGHEQFF,1,0,1,1
TRBV7-9,TRBJ1-1,CASSLQNTEAFF,1,0,1,1
TRBV5-6,TRBJ2-3,CASSSTTDTQYF,1,0,1,1
TRBV3-1,TRBJ2-3,CASSLSTDTQYF,1,0,1,1
TRBV7-9,TRBJ2-1,CASSAGASEQFF,1,0,1,1
TRBV5-1,TRBJ2-1,CASSVDYNEQFF,1,0,1,1
TRBV20-1,TRBJ2-7,CSAVYGAYEQYF,1,0,1,1
TRBV29-1,TRBJ2-7,CSVSWGIHEQYF,1,0,1,1
TRBV29-1,TRBJ2-1,CSAAGTYNEQFF,1,0,1,1
TRBV12-3/4,TRBJ1-4,CASSNNEKLFF,1,0,1,1
TRBV7-9,TRBJ2-7,SASSKGYEQYF,1,0,1,1
TRBV5-1,TRBJ1-2,CASSLEGYTF,1,0,1,1
TRBV18,TRBJ2-1,CASSSGDKPYNEQFF,1,0,1,1
TRBV10-3,TRBJ2-3,CAISEGGGTDTQYF,1,0,1,1
TRBV19,TRBJ2-5,CASSINYQETQYF,1,0,1,1
TRBV29-1,TRBJ2-1,CSLRTSGRNGQFF,1,0,1,1
TRBV29-1,TRBJ1-1,CSGDRGMDTEAFF,1,0,1,1
TRBV12-3/4,TRBJ2-1,CASKTGDEQFF,1,0,1,1
TRBV12-3/4,TRBJ2-1,CASSLLGRLAGRNEQFF,1,0,1,1
TRBV19,TRBJ1-5,CASSTNRESNQPQHF,1,0,1,1
TRBV7-9,TRBJ1-6,CASSPPTGEGSPLHF,2,0,1,2
TRBV4-3,TRBJ1-1,CASSQTLGVYTEAFF,1,0,1,1
TRBV7-2,TRBJ2-7,CASSVTSGVYEQYF,2,0,1,2
TRBV5-6,TRBJ1-2,CASSFGDARGYTF,1,0,1,1
TRBV7-9,TRBJ2-7,CASSTESYEQYF,1,0,1,1
TRBV19,TRBJ1-1,CASSIDGGASSEAFF,1,0,1,1
TRBV7-9,TRBJ2-7,CASSGPGARAYEQYF,1,0,1,1
TRBV5-6,TRBJ1-2,CAGSLGWKANGYTF,1,0,1,1
TRBV9,TRBJ2-3,CASSATDTQYF,1,0,1,1
TRBV12-3/4,TRBJ2-1,CASSRAGTSALGAYNEQFF,1,0,1,1
TRBV6-2/3/5/6,TRBJ2-1,CASSPEARTSGGNYNEQFF,1,0,1,1
TRBV5-1,TRBJ2-6,CASSLYPDRPSRGANVLTF,1,0,1,1
TRBV2,TRBJ2-6,CASSENLIIQAGANVLTF,1,0,1,1
TRBV7-2,TRBJ1-1,CASSSKGGTGWFKTEAFF,1,0,1,1
TRBV19,TRBJ2-1,CASSSGPGQGYNSEQFF,1,1,2,2
TRBV12-3/4,TRBJ1-2,CASSFGAGGGLGYGYTF,1,0,1,1
TRBV7-9,TRBJ2-2,CASSLDGGRFDTGELFF,1,0,1,1
TRBV14,TRBJ1-3,CASSQVPQGVYGNTIYF,1,0,1,1
TRBV14,TRBJ2-1,CASSQGRLDRGKDEQFF,1,0,1,1
TRBV3-1,TRBJ2-6,CASSQDHRGAGANVLTF,1,0,1,1
TRBV30,TRBJ1-5,CAWSDGGLWSNQPQHF,1,0,1,1
TRBV10-3,TRBJ2-4,CAISESRWQGKNIQYF,1,0,1,1
TRBV19,TRBJ1-2,CASSIDPSGFSYGYTF,2,2,2,4
TRBV7-2,TRBJ2-1,CASLPQGALRGYEQFF,1,0,1,1
TRBV6-2/3/5/6,TRBJ2-1,CASSFVAGPRYNEQFF,1,0,1,1
TRBV12-3/4,TRBJ2-2,CASSATGTVFTGELFF,1,0,1,1
TRBV6-2/3/5/6,TRBJ2-1,CASSLMASGRSDEQFF,1,0,1,1
TRBV7-9,TRBJ2-1,CASSPDRGRAYNEQFF,1,0,1,1
TRBV9,TRBJ2-7,CASSVTETSGRYEQYF,1,0,1,1
TRBV7-2,TRBJ2-3,CASSARTARGADTQYF,1,0,1,1
TRBV7-2,TRBJ1-2,CASSTQQGTSNYGYTF,1,0,1,1
TRBV2,TRBJ2-3,CASRGLAGDRTDTQYF,2,0,1,2
TRBV2,TRBJ2-3,CASRGRGFFGTDTQYF,1,0,1,1
TRBV4-3,TRBJ2-7,CASSQDQTGEPYEQYF,1,0,1,1
TRBV10-1,TRBJ2-1,CASRLTSGLSYNEQFF,2,1,2,3
TRBV20-1,TRBJ2-1,CSAHGTGGSSYNEQFF,1,0,1,1
TRBV29-1,TRBJ2-1,CSVTSSVTGRDNEQFF,1,0,1,1
TRBV12-5,TRBJ2-1,CASAPPGVSYNEQFF,1,0,1,1
TRBV5-5,TRBJ2-5,CAGSAALGPVETQYF,1,0,1,1
TRBV10-3,TRBJ1-1,CAITKQGAGDTEAFF,1,0,1,1
TRBV10-3,TRBJ2-7,CAISEPGLLSHEQYF,1,0,1,1
TRBV24-1,TRBJ1-5,CATSDSRQADQPQHF,1,0,1,1
TRBV7-2,TRBJ2-1,CASFSGTGLWDEQFF,2,1,2,3
TRBV18,TRBJ2-7,CASSPSRASMVEQYF,1,0,1,1
TRBV27,TRBJ1-1,CASSLIGRGNTEAFF,1,0,1,1
TRBV6-2/3/5/6,TRBJ1-2,CASSYVDTGEYGYTF,1,0,1,1
TRBV9,TRBJ1-1,CASSPPGTGRPEAFF,1,0,1,1
TRBV6-4,TRBJ2-3,CASSDGPSSPDTQYF,1,0,1,1
TRBV6-1,TRBJ2-3,CASSEVAGGTDTQYF,1,0,1,1
TRBV6-1,TRBJ1-1,CASSEDRTLNTAAFF,1,0,1,1
TRBV11-3,TRBJ2-1,CASSLVLAGSNEQFF,1,0,1,1
TRBV7-2,TRBJ2-1,CASSLGGGDHNEQFF,1,0,1,1
TRBV7-2,TRBJ2-5,CASSLDLGFQETQYF,1,0,1,1
TRBV11-2,TRBJ2-1,CASSLEPSDRAEQFF,1,0,1,1
TRBV7-2,TRBJ2-3,CASSLERESTDTQYF,2,0,1,2
TRBV11-2,TRBJ2-3,CASSLNAGLADTQYF,1,0,1,1
TRBV5-6,TRBJ1-6,CASSRGQMGSSPLHF,1,0,1,1
TRBV13,TRBJ2-3,CASSHTSGGTDTQYF,1,0,1,1
TRBV3-1,TRBJ2-7,CASSQGQGGFYEQYF,1,0,1,1
TRBV14,TRBJ1-1,CASSQEGGQNTEAFF,1,0,1,1
TRBV5-8,TRBJ2-2,CASSQNRRGTGELFF,1,0,1,1
TRBV9,TRBJ2-2,CASSATGGNTGELFF,1,1,2,2
TRBV9,TRBJ2-5,CASSTGTVVGETQYF,2,0,1,2
TRBV3-1,TRBJ2-6,CASRLTGSGANVLTF,1,1,2,2
TRBV6-2/3/5/6,TRBJ1-3,CASRPGRVSGNTIYF,1,0,1,1
TRBV5-1,TRBJ2-5,CASSFSGLQGETQYF,1,0,1,1
TRBV5-1,TRBJ2-1,CASSLAEGGYNEQFF,1,0,1,1
TRBV5-1,TRBJ2-7,CASSLGTSGTYEQYF,1,0,1,1
TRBV5-1,TRBJ2-7,CASSPGQLDPYEQYF,1,1,2,2
TRBV5-1,TRBJ1-4,CASSRLGARNEKLFF,1,0,1,1
TRBV20-1,TRBJ2-1,CSARVGTGILNEQFF,1,0,1,1
TRBV20-1,TRBJ2-3,CSARDLAGGTDTQYF,1,5,2,6
TRBV29-1,TRBJ1-2,CSVAGQHFPNYGYTF,1,0,1,1
TRBV29-1,TRBJ1-2,CSVEDWGTEDYGYTF,1,0,1,1
TRBV30,TRBJ2-5,CAWSVGLARETQYF,1,0,1,1
TRBV19,TRBJ2-1,CATHSGTTYNEQFF,1,0,1,1
TRBV24-1,TRBJ2-1,CATSARESYNEQFF,1,0,1,1
TRBV15,TRBJ1-4,CATSRAVTNEKLFF,1,0,1,1
TRBV19,TRBJ2-4,CASSTSANKNIQYF,1,0,1,1
TRBV19,TRBJ2-3,CASTEAGDTDTQYF,1,0,1,1
TRBV19,TRBJ1-1,CASSSQGSNTEAFF,1,0,1,1
TRBV19,TRBJ1-1,CASSAQGGITEAFF,1,0,1,1
TRBV19,TRBJ2-1,CASRDGTINNEQFF,1,0,1,1
TRBV19,TRBJ2-4,CASRTRDSKNIQYF,1,2,2,3
TRBV18,TRBJ2-7,CASSRSGESGEQYF,1,0,1,1
TRBV6-2/3/5/6,TRBJ2-3,CASTSSLVVDTQYF,1,0,1,1
TRBV12-3/4,TRBJ1-5,CASSLWGGNQPQHF,1,0,1,1
TRBV12-3/4,TRBJ1-2,CASSYQPSNYGYTF,1,0,1,1
TRBV6-2/3/5/6,TRBJ1-5,CASSYTGRDQPQHF,1,0,1,1
TRBV12-3/4,TRBJ2-1,CASSDQERDNEQFF,1,0,1,1
TRBV7-2,TRBJ1-4,CASSFRDSNEKLFF,1,0,1,1
TRBV11-2,TRBJ2-7,CASSLHRFSYEQYF,1,0,1,1
TRBV5-4,TRBJ1-1,CASSLVGANTEAFF,1,0,1,1
TRBV7-9,TRBJ2-1,CASSLVPGIDEQFF,1,0,1,1
TRBV7-9,TRBJ1-2,CASSLAWGAYGYTF,1,0,1,1
TRBV13,TRBJ2-7,CASSLGRTTYEQYF,1,0,1,1
TRBV7-9,TRBJ2-5,CASSSTGGGETQYF,1,0,1,1
TRBV7-9,TRBJ2-1,CASSSPGLLWKEFF,1,0,1,1
TRBV9,TRBJ1-1,CASSLGQGASVAFF,1,0,1,1
TRBV6-2/3/5/6,TRBJ2-3,CASSRTGETDTQYF,1,0,1,1
TRBV12-3/4,TRBJ2-1,CASSHTATYNEQFF,1,0,1,1
TRBV9,TRBJ1-1,CASSVDLQNTEAFF,1,0,1,1
TRBV7-9,TRBJ1-1,CASSGQALNTEAFF,1,0,1,1
TRBV12-3/4,TRBJ1-2,CASRSRRRNYGYTF,1,0,1,1
TRBV11-2,TRBJ2-3,CASRYTGTTDTQYF,1,0,1,1
TRBV5-8,TRBJ2-1,CASRHRTGKNEQFF,1,0,1,1
TRBV10-2,TRBJ1-3,CASSESESGNTIYF,1,0,1,1
TRBV5-1,TRBJ2-5,CASSLWTGKETQYF,1,0,1,1
TRBV5-1,TRBJ1-4,CASSLYQGGEKLFF,1,0,1,1
TRBV5-1,TRBJ1-5,CASSLRRENQPQHF,1,0,1,1
TRBV5-1,TRBJ2-5,CASRPTGTEETQYF,1,0,1,1
TRBV20-1,TRBJ2-7,CSARGGGSSYEQYF,1,0,1,1
TRBV20-1,TRBJ2-7,CSAREAWTAYEQYF,1,0,1,1
TRBV29-1,TRBJ1-1,CSVFYRAEGTEAFF,1,0,1,1
TRBV29-1,TRBJ2-3,CSVLLAGGRDTQYF,1,0,1,1
TRBV29-1,TRBJ2-4,CSVVGGPFKNIQYF,1,0,1,1
TRBV29-1,TRBJ2-1,CSVLFGQGYNEQFF,2,2,2,4
TRBV30,TRBJ1-5,CACGQGAGQPQHF,1,0,1,1
TRBV19,TRBJ1-1,CASSSQGNTEAFF,1,0,1,1
TRBV19,TRBJ1-5,CASSIAPAQPQHF,1,0,1,1
TRBV9,TRBJ2-7,CASGHGTDYEQYF,1,0,1,1
TRBV7-9,TRBJ2-7,CASIPINSYEQYF,1,0,1,1
TRBV12-3/4,TRBJ1-1,CASSLGWDTEAFF,1,0,1,1
TRBV6-2/3/5/6,TRBJ2-1,CASSYPANLEQFF,1,0,1,1
TRBV6-2/3/5/6,TRBJ1-1,CASSYNRKTEAFF,1,0,1,1
TRBV6-1,TRBJ2-2,CASSDRDTGELFF,2,1,2,3
TRBV5-6,TRBJ2-2,CASSFGRAGELFF,1,0,1,1
TRBV5-4,TRBJ1-1,CASSFHPDGEAFF,1,0,1,1
TRBV5-6,TRBJ2-7,CASSLGPTYEQYF,1,0,1,1
TRBV7-9,TRBJ1-2,CASSLVSMNAYTF,1,0,1,1
TRBV11-2,TRBJ2-3,CASSLEPLSTQYF,1,0,1,1
TRBV11-2,TRBJ1-1,CASSYTRDSQSMF,1,0,1,1
TRBV11-3,TRBJ2-2,CASSPPPTGELFF,1,0,1,1
TRBV3-1,TRBJ2-7,CASSHGRYYEQYF,1,0,1,1
TRBV16,TRBJ2-1,CASSQFSGDEQFF,1,0,1,1
TRBV16,TRBJ1-2,CASSQSTTYGYTF,1,0,1,1
TRBV3-1,TRBJ2-7,CASSQDVYYEQYF,1,0,1,1
TRBV7-2,TRBJ2-1,CASSTPRNNEQFF,1,0,1,1
TRBV7-8,TRBJ1-2,CASRSDRDPGYTF,1,0,1,1
TRBV2,TRBJ1-5,CASKDSRNQPQHF,1,0,1,1
TRBV5-1,TRBJ2-7,CASSLDSSYEQYF,1,0,1,1
TRBV20-1,TRBJ1-5,CSATVSGGQPQHF,1,0,1,1
TRBV20-1,TRBJ1-1,CSAREGTRSEAFF,1,0,1,1
TRBV20-1,TRBJ1-2,CSADRRTNYGYTF,1,0,1,1
TRBV29-1,TRBJ2-1,CSVVRTGANEQFF,1,0,1,1
TRBV29-1,TRBJ2-7,CSVGLVAGYEQYF,1,0,1,1
TRBV29-1,TRBJ2-7,CSVLGGSSYEQYF,1,0,1,1
TRBV29-1,TRBJ2-5,CSADLAAQETQYF,1,0,1,1
TRBV12-3/4,TRBJ2-7,RASGQRHPYEQYF,1,0,1,1
TRBV30,TRBJ2-1,CAWTSRYNEQFF,1,0,1,1
TRBV30,TRBJ1-1,CACSGAYTEAFF,1,0,1,1
TRBV30,TRBJ1-1,CAWSYGRSEAFF,1,0,1,1
TRBV19,TRBJ2-1,CASSAGYNEQFF,1,0,1,1
TRBV25-1,TRBJ1-1,CASGRTPTEAFF,1,0,1,1
TRBV28,TRBJ1-5,CASGQVGQPQHF,1,0,1,1
TRBV27,TRBJ2-2,CASSFTTGELFF,1,0,1,1
TRBV28,TRBJ2-3,CASSLGQGTQYF,1,0,1,1
TRBV12-3/4,TRBJ1-5,CASSSGSQPQHF,1,0,1,1
TRBV5-6,TRBJ2-7,CASSFSGNEQYF,1,0,1,1
TRBV7-9,TRBJ2-1,CASSSISGWQFF,1,0,1,1
TRBV7-2,TRBJ2-7,CASSLDSYEQYF,1,3,2,4
TRBV13,TRBJ2-7,CASSLGQGEQYF,1,0,1,1
TRBV9,TRBJ2-7,CASSVGVGEQYF,1,0,1,1
TRBV6-4,TRBJ2-1,CASSGGYNEQSF,1,0,1,1
TRBV12-3/4,TRBJ1-2,CASRTGAYGYTF,1,0,1,1
TRBV5-1,TRBJ2-2,CASREGAGELFF,1,0,1,1
TRBV20-1,TRBJ1-1,CSATDRPTEAFF,1,0,1,1
TRBV20-1,TRBJ1-2,CSASGANYGYTF,1,0,1,1
TRBV29-1,TRBJ1-1,CSVEFRPAEAFF,1,0,1,1
TRBV29-1,TRBJ2-5,CSVEEGGETQYF,1,0,1,1
TRBV12-3/4,TRBJ2-3,CASTPGAVRYF,2,0,1,2
TRBV12-3/4,TRBJ2-5,CASSSQETQYF,2,0,1,2
TRBV5-6,TRBJ1-2,CASSFLYSYTF,1,0,1,1
TRBV7-2,TRBJ2-7,CASSTYYEQYF,1,0,1,1
TRBV27,TRBJ1-2,CASRTWWGYTF,1,0,1,1
TRBV29-1,TRBJ2-7,CSVGQTYEQYF,1,0,1,1
TRBV29-1,TRBJ2-2,CSASVGGELFF,1,0,1,1
TRBV29-1,TRBJ1-2,CSVAGDGYTF,1,0,1,1
TRBV5-4,TRBJ2-2,CASSWDRFTGELFF,1,0,1,1
TRBV6-2/3/5/6,TRBJ1-4,CASSIGQGGEKLFF,1,0,1,1
TRBV19,TRBJ2-1,CASSGDFYNEQIF,1,0,1,1
TRBV5-1,TRBJ2-2,CASKGALTGELFF,1,0,1,1
TRBV28,TRBJ1-1,CASSLPSGRANTEAFF,1,0,1,1
TRBV2,TRBJ1-5,CASGGQSGGNQPQHF,1,0,1,1
TRBV3-1,TRBJ2-7,CASSLQGLAAREQYF,1,0,1,1
TRBV4-1,TRBJ2-1,CASSRDRGAGNEQFF,1,0,1,1
TRBV30,TRBJ2-2,CAWDPVGNTGELFF,1,0,1,1
TRBV2,TRBJ2-6,CASSKSTGANVQTF,1,0,1,1
TRBV7-3,TRBJ2-1,CASSLAGEDNEQFF,1,0,1,1
TRBV3-1,TRBJ1-2,CASSQRWGAYGYTF,1,0,1,1
TRBV3-1,TRBJ2-3,CASSGSNSGRFAYF,1,0,1,1
TRBV4-1,TRBJ2-2,CASKAYRDTGELFF,2,0,1,2
TRBV20-1,TRBJ2-2,CSVLAGGNTGELFF,1,0,1,1
TRBV4-1,TRBJ2-3,CASSQKGTDTQHF,1,0,1,1
TRBV20-1,TRBJ1-4,CSARDQGYEKLFF,1,0,1,1
TRBV4-1,TRBJ1-2,CASSRDREVGYTF,1,0,1,1
TRBV5-1,TRBJ2-3,CASTPRTGNNGLTDTQYF,2,0,1,2
TRBV19,TRBJ2-1,CASNLRGQGGSYNEQFF,1,0,1,1
TRBV9,TRBJ2-3,CASSPRAGGGTDTQYF,1,0,1,1
TRBV30,TRBJ2-7,CAWQPTRPPYEQYF,1,0,1,1
TRBV19,TRBJ1-1,CASFRGGLNTEAFF,1,0,1,1
TRBV6-2/3/5/6,TRBJ2-3,CASSYGGATDTQYF,2,0,1,2
TRBV4-3,TRBJ2-1,CASSQEGWGGEQFF,1,0,1,1
TRBV7-2,TRBJ1-2,CASSVRGSLGYTF,1,0,1,1
TRBV5-6,TRBJ2-7,CASSAVGLQEQYF,1,0,1,1
TRBV7-9,TRBJ2-4,CASSNIAKNIQYF,1,0,1,1
TRBV7-9,TRBJ1-1,CASRQRQNTEAFF,2,0,1,2
TRBV7-2,TRBJ1-2,CASRPGGYGYTF,2,0,1,2
TRBV5-1,TRBJ2-1,CASSPGRVGLAGGGSSDEQFF,1,0,1,1
TRBV7-2,TRBJ2-6,CASSLALLTGLLSGANVLTF,1,0,1,1
TRBV20-1,TRBJ2-7,CSAGSSLADRGWLAGEEQYF,2,0,1,2
TRBV20-1,TRBJ2-1,CSARVTGAGGTRSSYNEQLF,2,0,1,2
TRBV2,TRBJ2-3,CASSQPRDRGRITDTQYF,1,0,1,1
TRBV5-6,TRBJ2-7,CASSSPFEGRLSSYEQYF,1,0,1,1
TRBV5-1,TRBJ2-1,CASSDGTSGYLSYNEQFF,1,0,1,1
TRBV24-1,TRBJ2-7,CATSDLQDRGLSYEQYF,1,0,1,1
TRBV19,TRBJ1-5,CASSIETTTHSNQPQHF,1,0,1,1
TRBV3-1,TRBJ2-1,CASSRRGGAAIYNEQFF,1,0,1,1
TRBV4-2,TRBJ2-1,CASSQSITSGAYNEQFF,1,1,2,2
TRBV3-1,TRBJ1-5,CASSGGTGPFSNQPQHF,1,0,1,1
TRBV12-3/4,TRBJ2-6,CAIPLDRVSGANVLTF,1,0,1,1
TRBV19,TRBJ1-5,CASSIRRGPSNQPQHF,1,0,1,1
TRBV19,TRBJ1-6,CASSILMGTENSPLHF,1,0,1,1
TRBV18,TRBJ1-5,CASSPGQGGFDQPQHF,1,0,1,1
TRBV18,TRBJ2-3,CASSPPGHPNTDTQYF,1,0,1,1
TRBV18,TRBJ1-1,CASSIGQGLENTEAFF,1,0,1,1
TRBV6-2/3/5/6,TRBJ1-5,CASSLARGYSNQPQHF,1,0,1,1
TRBV2,TRBJ1-6,CASSENGEGNNSPLHF,2,0,1,2
TRBV7-9,TRBJ2-7,CASSFNRRQGPYEQYF,1,0,1,1
TRBV7-9,TRBJ2-5,CASSLVWDSYQETQYF,1,0,1,1
TRBV7-9,TRBJ2-1,CASSLGPSGRIDEQFF,1,1,2,2
TRBV13,TRBJ1-6,CASSLGAGTSGSPLHF,2,0,1,2
TRBV11-2,TRBJ2-1,CASSLNGQGPYNEQFF,1,0,1,1
TRBV7-9,TRBJ2-3,CASSPRTSGATDTQYF,1,0,1,1
TRBV3-1,TRBJ2-1,CASSPGPPSSYNEQFF,1,0,1,1
TRBV3-1,TRBJ2-1,CASSHGVEGAGNEQFF,1,0,1,1
TRBV11-2,TRBJ1-2,CASSQFRDRASDGYTF,1,0,1,1
TRBV7-3,TRBJ1-1,CASSQEPGFMNTEAFF,1,0,1,1
TRBV5-1,TRBJ2-7,CASSLVPGGFSYEQYF,1,0,1,1
TRBV5-1,TRBJ2-5,CASSQEPGRLQETQYF,1,0,1,1
TRBV4-1,TRBJ1-4,CASSQVATGQGEKLFF,1,0,1,1
TRBV4-1,TRBJ1-5,CASSQDRTGAFQPQHF,1,0,1,1
TRBV5-1,TRBJ2-3,CASSITGTSGTDTQYF,1,0,1,1
TRBV20-1,TRBJ2-7,CSARSPGQGRTWEQYF,1,0,1,1
TRBV20-1,TRBJ1-5,CSARRQETDSNQPQHF,1,0,1,1
TRBV20-1,TRBJ2-3,CSARSGGAGGGDTQYF,1,0,1,1
TRBV20-1,TRBJ1-5,CSARDLMDRTAQPQHF,1,0,1,1
TRBV20-1,TRBJ2-7,CSARDGTSGTIYEQYF,1,0,1,1
TRBV20-1,TRBJ2-1,CSAREFGDRGNNEQFF,1,0,1,1
TRBV12-5,TRBJ1-6,CASGRDSGLNSPLHF,1,0,1,1
TRBV30,TRBJ1-1,CAWSHSADLNTEAFF,1,0,1,1
TRBV24-1,TRBJ2-7,CATSDVRTGDYEQYF,1,0,1,1
TRBV19,TRBJ1-5,CASSIRQGMHQPQHF,1,0,1,1
TRBV19,TRBJ2-7,CASSTSSAGAYEQYF,1,0,1,1
TRBV18,TRBJ2-3,CASSPLAATQDTQYF,1,0,1,1
TRBV6-2/3/5/6,TRBJ1-2,CASSFVHGVNYGYTF,1,0,1,1
TRBV12-3/4,TRBJ2-5,CASSLTDSRGETQYF,1,0,1,1
TRBV6-2/3/5/6,TRBJ2-7,CASSSEVGNFYEQYF,1,0,1,1
TRBV2,TRBJ2-1,CASSSGGPSYNEQFF,1,0,1,1
TRBV2,TRBJ1-1,CASSLRTGRNTEAFF,1,0,1,1
TRBV12-3/4,TRBJ2-5,CASSPNAGGQETQYF,1,0,1,1
TRBV6-2/3/5/6,TRBJ2-3,CASSPRGGPTDTQYF,1,0,1,1
TRBV12-3/4,TRBJ2-1,CASSETSGGYNEQFF,1,0,1,1
TRBV11-3,TRBJ2-3,CASSFLSTVTDTQYF,2,0,1,2
TRBV11-2,TRBJ2-1,CASSFRGGPGNEQFF,1,0,1,1
TRBV11-2,TRBJ2-7,CASSLPSGSFYEQYF,1,0,1,1
TRBV7-2,TRBJ1-1,CASSLVGRADTEAFF,1,0,1,1
TRBV7-2,TRBJ2-1,CASSLVGDTYNEQFF,1,0,1,1
TRBV7-9,TRBJ1-1,CASSLDGRGMDEAFF,1,0,1,1
TRBV11-2,TRBJ1-1,CASSLEPGQNTEAFF,1,0,1,1
TRBV7-2,TRBJ2-7,CASSLNLAGAYEQYF,2,0,1,2
TRBV7-2,TRBJ2-7,CASSLNGAGVDEQYF,1,0,1,1
TRBV7-2,TRBJ1-5,CASSSLGNSNQPQHF,1,0,1,1
TRBV9,TRBJ2-7,CASSSGTGGAYEQYF,1,0,1,1
TRBV11-2,TRBJ1-2,CASSWGHKANYGYTF,1,0,1,1
TRBV5-5,TRBJ2-1,CASSPEAGGPLEQFF,1,0,1,1
TRBV9,TRBJ2-7,CASSPAGTYPSEQYF,1,0,1,1
TRBV7-9,TRBJ2-5,CASSGTGGAAETQYF,1,0,1,1
TRBV7-2,TRBJ1-2,CASSIGRDGNYGYTF,1,0,1,1
TRBV11-2,TRBJ2-3,CASSNVGTGSNTQYF,2,0,1,2
TRBV28,TRBJ1-6,CASRRHQGLNSPLHF,1,0,1,1
TRBV7-2,TRBJ1-6,CASNEGSSNNSPLHF,1,0,1,1
TRBV5-1,TRBJ2-7,CVSSPGGARVKEQYF,1,0,1,1
TRBV5-1,TRBJ2-3,CASHQTSATTDTQYF,1,0,1,1
TRBV10-1,TRBJ2-7,CASSDLHRIPYEQYF,1,0,1,1
TRBV10-2,TRBJ1-4,CASSDGLTGYEKLFF,1,0,1,1
TRBV5-1,TRBJ2-1,CASSSGAGGYNEQFF,1,0,1,1
TRBV5-1,TRBJ2-1,CASSWTGLESNEQFF,1,0,1,1
TRBV4-3,TRBJ2-5,CASSPRWAPEETQYF,1,0,1,1
TRBV4-3,TRBJ2-4,CASSQEGTAKNIQYF,1,0,1,1
TRBV5-1,TRBJ2-6,CASRLRVAGANVLTF,1,0,1,1
TRBV5-1,TRBJ2-1,CASRIRNTQNNEQFF,1,0,1,1
TRBV20-1,TRBJ2-7,CSAHLGTSAAYEQYF,1,0,1,1
TRBV20-1,TRBJ2-7,CSAGGLAASSYEQYF,1,0,1,1
TRBV20-1,TRBJ2-3,CSASSRQPLTDTQYF,1,0,1,1
TRBV20-1,TRBJ2-7,CSARLGTGSGYEQYF,1,0,1,1
TRBV20-1,TRBJ1-6,CSARRGGSYNSPLHF,1,0,1,1
TRBV20-1,TRBJ2-1,CSARWVAGGLNEQFF,2,0,1,2
TRBV29-1,TRBJ2-7,CSVSPGQRIPYEQYF,1,0,1,1
TRBV12-5,TRBJ2-1,CASGPGQGSNEQFF,1,0,1,1
TRBV12-5,TRBJ2-1,CASGSLAGLNEQFF,1,0,1,1
TRBV10-3,TRBJ2-5,CAISEIGEGETQYF,1,0,1,1
TRBV19,TRBJ1-2,CASTSTGADYGYTF,1,0,1,1
TRBV19,TRBJ2-1,CASSIGYRVNEQFF,1,0,1,1
TRBV19,TRBJ1-2,CASSIGGQGGGYTF,1,0,1,1
TRBV19,TRBJ2-3,CASSIELAGDTQYF,1,0,1,1
TRBV18,TRBJ2-3,CASSQDWGTDTQYF,1,0,1,1
TRBV12-3/4,TRBJ1-2,CASCPTGIDYGYTF,1,0,1,1
TRBV12-3/4,TRBJ1-1,CASSLLEGFTEAFF,1,0,1,1
TRBV6-2/3/5/6,TRBJ1-5,CASSWTGGNQPQHF,1,0,1,1
TRBV6-2/3/5/6,TRBJ1-4,CASSYDPQVEKLFF,1,0,1,1
TRBV6-2/3/5/6,TRBJ1-1,CASSYSGGSTEAFF,1,0,1,1
TRBV6-2/3/5/6,TRBJ1-1,CASSYPGRGTEAFF,1,0,1,1
TRBV12-3/4,TRBJ1-5,CASSGRLGDQPQHF,1,0,1,1
TRBV6-1,TRBJ1-1,CASSEDPEGAEAFF,1,0,1,1
TRBV7-9,TRBJ2-5,CASSFSRLEETQYF,1,0,1,1
TRBV5-6,TRBJ2-7,CASSLGRSAYEQYF,1,0,1,1
TRBV12-3/4,TRBJ2-7,CASSSQDRGYEQYF,1,0,1,1
TRBV7-3,TRBJ2-5,CASSSSGRQETQYF,1,0,1,1
TRBV7-2,TRBJ2-7,CASSSRPFTYEQYF,1,0,1,1
TRBV6-1,TRBJ1-2,CASSWKTGGFGYTF,1,0,1,1
TRBV7-9,TRBJ2-5,CASSPRQGGETQYF,1,0,1,1
TRBV14,TRBJ2-7,CASSQVPFGGEQYF,1,0,1,1
TRBV9,TRBJ2-5,CASSVGTIQETQYF,2,0,1,2
TRBV6-2/3/5/6,TRBJ1-1,CASSKGQGNTEAFL,1,0,1,1
TRBV12-3/4,TRBJ1-4,CASRFDRGSEKLFF,1,0,1,1
TRBV12-3/4,TRBJ2-2,CASRLTSGTGELFF,1,0,1,1
TRBV2,TRBJ1-1,CASRGQGGNTEAFF,1,0,1,1
TRBV2,TRBJ2-1,CASRTHGNSNEQFF,1,0,1,1
TRBV14,TRBJ2-1,CASRMRGANNEQFF,1,0,1,1
TRBV5-1,TRBJ2-5,CASSFGTSEKTQYF,1,0,1,1
TRBV5-1,TRBJ2-7,CASSHRDGPYEQYF,1,0,1,1
TRBV20-1,TRBJ2-7,CSVASDTSSYEQYF,1,0,1,1
TRBV20-1,TRBJ2-1,CSARSRSSYNEQFF,1,1,2,2
TRBV20-1,TRBJ2-4,CSARDRGSKNIQYF,1,0,1,1
TRBV5-1,TRBJ2-7,SASSLASGQGEQYF,1,0,1,1
TRBV30,TRBJ2-1,CALTSGAYNEQFF,1,0,1,1
TRBV30,TRBJ2-5,CAWSVLSSETQYF,1,0,1,1
TRBV30,TRBJ1-5,CAWSGDPHQPQHF,1,0,1,1
TRBV6-2/3/5/6,TRBJ2-5,CAGSLNRQETRYF,1,0,1,1
TRBV15,TRBJ1-5,CATSRDHDQPQHF,1,0,1,1
TRBV19,TRBJ1-1,CASSIRHDTEAFF,1,0,1,1
TRBV19,TRBJ2-3,CASKERNTDTQYF,1,0,1,1
TRBV7-2,TRBJ1-2,CASLPQGLYGYTF,1,0,1,1
TRBV6-2/3/5/6,TRBJ2-1,CASSYTSNNEQFF,1,0,1,1
TRBV6-2/3/5/6,TRBJ1-1,CASSYLRQGIAFF,1,0,1,1
TRBV12-3/4,TRBJ1-1,CASSPNTGAEAFF,1,0,1,1
TRBV2,TRBJ1-1,CASSGDSWTEAFF,1,3,2,4
TRBV7-9,TRBJ2-5,CASSDDRKETQYF,1,0,1,1
TRBV11-2,TRBJ2-5,CASSFQSQETQYF,1,0,1,1
TRBV7-3,TRBJ1-1,CASSLVRVTEAFF,2,0,1,2
TRBV7-2,TRBJ2-2,CASSLGLAGELFF,1,0,1,1
TRBV7-3,TRBJ2-1,CASSLEGDNEQFF,1,0,1,1
TRBV5-6,TRBJ2-5,CASSSNFQETQYF,1,0,1,1
TRBV3-1,TRBJ1-6,CASSSTDNSPLHF,1,0,1,1
TRBV14,TRBJ2-3,CASSLGPGDTQYF,1,0,1,1
TRBV9,TRBJ2-7,CASSPRVIDEQYF,1,0,1,1
TRBV7-9,TRBJ2-3,CASSPQGGGHGYF,1,0,1,1
TRBV7-9,TRBJ1-1,CASSREELTEAFF,1,0,1,1
TRBV3-1,TRBJ1-5,CASSQDRGQPQHF,1,0,1,1
TRBV3-1,TRBJ2-1,CASSQGWQNEQFF,1,0,1,1
TRBV14,TRBJ2-7,CASSQDPGAEQYF,1,0,1,1
TRBV14,TRBJ1-1,CASSQDGNTEAFF,1,0,1,1
TRBV12-3/4,TRBJ1-5,CASSMVGRQPQHF,1,0,1,1
TRBV30,TRBJ2-1,CALNRVWGNEQFF,1,0,1,1
TRBV5-1,TRBJ2-3,CATASGGTDTQYF,1,0,1,1
TRBV5-1,TRBJ1-4,CASSFAGNEKLFF,1,0,1,1
TRBV5-1,TRBJ1-1,CASSLRMNTEAFF,1,0,1,1
TRBV5-1,TRBJ2-1,CASSGDSYNEQFF,1,0,1,1
TRBV20-1,TRBJ2-5,CSAGDYGRETQYF,1,0,1,1
TRBV29-1,TRBJ2-2,CSTRGGDTGELFF,1,0,1,1
TRBV29-1,TRBJ2-3,CSVYIRQTDTQYF,1,0,1,1
TRBV29-1,TRBJ2-3,CSVRTGDTDTQYF,1,0,1,1
TRBV29-1,TRBJ2-1,CSVGQGTYNEQFF,1,0,1,1
TRBV29-1,TRBJ1-1,CSVTQGVSTEAFF,1,0,1,1
TRBV29-1,TRBJ2-7,CSVKPGGEGEQYF,1,0,1,1
TRBV29-1,TRBJ2-3,CSVRGPSTDTQYF,1,0,1,1
TRBV29-1,TRBJ2-3,CSGGGTGTDTQYF,1,0,1,1
TRBV3-1,TRBJ2-7,RASSLDRSYEQYF,1,0,1,1
TRBV18,TRBJ1-1,CSSSPGNLDAFF,1,0,1,1
TRBV30,TRBJ1-5,CAWTQDHQPQHF,1,0,1,1
TRBV30,TRBJ1-1,CAWSVSLREAFF,1,0,1,1
TRBV9,TRBJ2-3,CAGSVSTDTQYF,1,0,1,1
TRBV28,TRBJ1-5,CAISTGDQPQHF,1,0,1,1
TRBV15,TRBJ2-7,CATSRDRNEQYF,1,0,1,1
TRBV15,TRBJ1-2,CATSREEGGYTF,1,0,1,1
TRBV19,TRBJ1-5,CASTGDNQPQHF,1,0,1,1
TRBV19,TRBJ2-5,CASSTGQETQYF,1,0,1,1
TRBV6-1,TRBJ2-1,CASGENTHEQFF,1,0,1,1
TRBV14,TRBJ2-1,CASSFQGVEQFF,1,0,1,1
TRBV7-6,TRBJ2-7,CASSFHGREQYF,1,0,1,1
TRBV7-2,TRBJ1-1,CASSLGPDKAFF,1,0,1,1
TRBV3-1,TRBJ2-4,CASSQRQNIQYF,1,0,1,1
TRBV20-1,TRBJ2-3,CSARLGPDTQYF,1,0,1,1
TRBV29-1,TRBJ1-2,CSVGTPNYGYTF,1,0,1,1
TRBV29-1,TRBJ2-1,CSVGGSKGEQFF,1,0,1,1
TRBV29-1,TRBJ1-5,CSARESNQPQHF,1,0,1,1
TRBV30,TRBJ1-1,CAGRDRSEAFF,1,0,1,1
TRBV7-2,TRBJ2-5,CASSLRETQYF,1,0,1,1
TRBV20-1,TRBJ2-1,CSALTYNEQFF,1,0,1,1
TRBV29-1,TRBJ2-5,CSTRAEETQYF,1,0,1,1
TRBV15,TRBJ2-7,CATSRDAKRGAPYEQYF,1,0,1,1
TRBV29-1,TRBJ2-3,CSVQGSRRSRTDTQYF,1,0,1,1
TRBV4-1,TRBJ2-1,CASSHPGDNEQFF,1,0,1,1
TRBV6-2/3/5/6,TRBJ2-5,CASSYLTVMGQLSLKREEMETQYF,1,0,1,1
TRBV10-3,TRBJ2-6,CAISEGLMGRSSGANVLTF,1,0,1,1
TRBV6-2/3/5/6,TRBJ2-1,CASSYSPRSLAGGPNEQFF,1,0,1,1
TRBV12-3/4,TRBJ1-2,CASSRRPFGRETTNYGYTF,1,0,1,1
TRBV7-9,TRBJ2-3,CASSSLALRLAGSTDTQYF,1,0,1,1
TRBV7-9,TRBJ2-2,CASSTPGLAGGQNTGELFF,1,0,1,1
TRBV10-3,TRBJ2-1,CAISEQGLAGGLYNEQFF,1,0,1,1
TRBV7-2,TRBJ2-1,CASSLPRGRSSSYNEQFF,2,0,1,2
TRBV12-3/4,TRBJ2-6,CASSRRGQGYSGANVLTF,1,0,1,1
TRBV7-9,TRBJ2-1,CASSESETSGRLYNEQFF,1,0,1,1
TRBV5-1,TRBJ2-7,CASSSPDGLSQTLYEQYF,1,0,1,1
TRBV4-1,TRBJ2-4,CASSQAHPGILSKNIQYF,2,0,1,2
TRBV20-1,TRBJ2-1,CSARDRLQGLAGADEQFF,1,0,1,1
TRBV29-1,TRBJ2-2,CSVRLAGVRVTNTGELFF,1,0,1,1
TRBV19,TRBJ1-5,CASSIPRGKGSNQPQHF,1,0,1,1
TRBV10-3,TRBJ1-1,CAISESWPGWKNTEAFF,1,0,1,1
TRBV19,TRBJ2-7,CASSHFSMGRTSYEQYF,1,0,1,1
TRBV19,TRBJ2-5,CASSIRGGQSIQETQYF,1,0,1,1
TRBV2,TRBJ2-4,CASRQNTLIEAKNIQYF,1,0,1,1
TRBV12-3/4,TRBJ2-4,CASSLEGALPAKNIQYF,1,0,1,1
TRBV6-1,TRBJ2-2,CASSGPGTGANTGELFF,2,0,1,2
TRBV11-3,TRBJ2-2,CASSLVFQSGHTGELFF,1,0,1,1
TRBV7-9,TRBJ1-3,CASSPVPLGYSGNTIYF,1,0,1,1
TRBV7-3,TRBJ2-1,CASSQNAQGTSRTEQFF,1,0,1,1
TRBV4-2,TRBJ2-7,CASSQALGLTNSYEQYF,1,0,1,1
TRBV5-1,TRBJ2-2,CASSLRVGRANTGELFF,1,0,1,1
TRBV20-1,TRBJ2-5,CSAPRQGAVITGETQYF,1,0,1,1
TRBV29-1,TRBJ2-6,CSVASQGSPSGANVLTF,1,0,1,1
TRBV12-5,TRBJ1-2,CASGLPGQGLGDGYTF,1,0,1,1
TRBV24-1,TRBJ2-2,CATSDFSTGFTGELFF,1,0,1,1
TRBV24-1,TRBJ2-3,CATSDLRLADTDTQYF,1,0,1,1
TRBV24-1,TRBJ2-6,CATSDSSGSGANVLTF,1,0,1,1
TRBV15,TRBJ1-1,CATSRPGQGKNTEAFF,1,1,2,2
TRBV19,TRBJ1-5,CASSIAANSREGPQHF,1,0,1,1
TRBV18,TRBJ2-5,CASSPSDRGIMKTQYF,1,0,1,1
TRBV18,TRBJ1-1,CASSPSRGTANTEAFF,1,0,1,1
TRBV18,TRBJ1-1,CASSPPGRTMNTEAFF,1,0,1,1
TRBV18,TRBJ2-1,CASSPPSSTINNEQFF,1,0,1,1
TRBV19,TRBJ2-1,CASAYPGHSSYNEQFF,1,0,1,1
TRBV2,TRBJ1-5,CASTPRHINSNQPQHF,1,0,1,1
TRBV28,TRBJ2-3,CASTPMNTYRTDTQYF,1,0,1,1
TRBV12-3/4,TRBJ1-5,CASSLVSGVGNQPQHF,1,2,2,3
TRBV28,TRBJ2-1,CASSLIAGWSYNEQFF,1,0,1,1
TRBV12-3/4,TRBJ1-5,CASSLSRQFLVQPQHF,1,0,1,1
TRBV6-2/3/5/6,TRBJ2-3,CASSSGLAGFTDTRYF,1,0,1,1
TRBV12-3/4,TRBJ2-7,CASSYGRGSDAYEQYF,1,0,1,1
TRBV12-3/4,TRBJ2-4,CASSQTGSLARNIQYL,1,0,1,1
TRBV6-1,TRBJ1-2,CASSVTETGNNYGYTF,1,0,1,1
TRBV6-1,TRBJ1-6,CASSAGTGARSSPLHF,1,0,1,1
TRBV2,TRBJ1-5,CASSGGPGSSNQPQHF,1,0,1,1
TRBV6-4,TRBJ2-5,CASSDSSSAGVETQYF,1,0,1,1
TRBV6-1,TRBJ2-5,CASSEVGQGHRETQYF,1,0,1,1
TRBV6-1,TRBJ2-7,CASSETGTGRTYEQYF,1,0,1,1
TRBV7-9,TRBJ2-7,CASSFGLAGPKDEQYF,1,0,1,1
TRBV5-6,TRBJ2-5,CASSLLNRQDQETQYF,1,0,1,1
TRBV5-5,TRBJ1-1,CASSLVRQTQNTEAFF,1,0,1,1
TRBV7-3,TRBJ2-1,CASSLYTFSSYNEQFF,1,0,1,1
TRBV28,TRBJ1-5,CASSLVGPRSNQPQHF,1,0,1,1
TRBV11-3,TRBJ2-1,CASSLGGRAGWNEQFF,1,0,1,1
TRBV11-3,TRBJ2-3,CASSLGNSGLTDTQYF,1,0,1,1
TRBV7-8,TRBJ2-7,CASSLGGLAGSYEQYF,1,0,1,1
TRBV7-3,TRBJ2-1,CASSLSSGGTYNEQFF,1,0,1,1
TRBV12-3/4,TRBJ1-2,CASSPLGEGGWGGYTF,1,0,1,1
TRBV5-4,TRBJ1-4,CASSRDRGLGDEKLFF,1,0,1,1
TRBV7-2,TRBJ2-2,CASSRVRTPNTGELFF,1,0,1,1
TRBV5-8,TRBJ2-1,CASSRPTGGPYNEQFF,1,0,1,1
TRBV7-2,TRBJ1-2,CASSRGGRGSNYGYTF,1,0,1,1
TRBV3-1,TRBJ2-6,CASSQDRVSGANVLTF,1,0,1,1
TRBV14,TRBJ2-3,CASSQDGTGNTDTQYF,2,0,1,2
TRBV2,TRBJ2-5,CASRPPGTGRRETQYF,1,0,1,1
TRBV7-9,TRBJ2-7,CTSSLDISAGYYEQYF,1,0,1,1
TRBV5-1,TRBJ2-3,CASSLGFRVSTDTQYF,1,0,1,1
TRBV5-1,TRBJ2-5,CASSLGVAAVQETQYF,1,0,1,1
TRBV5-1,TRBJ2-3,CASSLEVTGGTDTQYF,1,0,1,1
TRBV5-1,TRBJ1-1,CASSSINRDMNTEAFF,1,0,1,1
TRBV4-1,TRBJ2-1,CASSLPGTGPYNEQFF,1,0,1,1
TRBV20-1,TRBJ2-5,CSAAGTSGSPQETQYF,1,0,1,1
TRBV20-1,TRBJ2-1,CSARDARATLGDEQFF,1,0,1,1
TRBV29-1,TRBJ2-7,CSVENILRDHYHEQYF,1,0,1,1
TRBV29-1,TRBJ2-1,CSVVAPSEGYYNEQFF,1,0,1,1
TRBV29-1,TRBJ1-2,CSVLGPEPVGPYGYTF,1,0,1,1
TRBV10-3,TRBJ2-3,CAITQGRGETDTQYF,1,0,1,1
TRBV15,TRBJ2-5,CATSRENPSQETQYF,1,0,1,1
TRBV15,TRBJ1-5,CATGELNLSNQPQHF,1,0,1,1
TRBV19,TRBJ2-3,CASTPRDRRPNTQYF,1,0,1,1
TRBV19,TRBJ2-3,CASSISSLSTDTQYF,1,0,1,1
TRBV19,TRBJ2-7,CASSKRMWATYEQYF,1,0,1,1
TRBV19,TRBJ2-1,CASSPLAGDDNEQFF,1,0,1,1
TRBV19,TRBJ2-3,CASRVVAFYTDTQYF,1,0,1,1
TRBV7-2,TRBJ2-7,CASGLEGQGPYEQYF,1,0,1,1
TRBV18,TRBJ2-1,CASTPGTGGSNEQFF,2,0,1,2
TRBV6-2/3/5/6,TRBJ2-7,CASSSAPGQGYEQYF,1,0,1,1
TRBV6-2/3/5/6,TRBJ2-7,CASSYSGYRDYEQYF,1,0,1,1
TRBV6-2/3/5/6,TRBJ2-5,CASSYSGTSQETQYF,1,0,1,1
TRBV12-3/4,TRBJ1-5,CASSPDRGRDQPQHF,1,0,1,1
TRBV6-1,TRBJ2-3,CASSASSLLSNTQYF,1,0,1,1
TRBV2,TRBJ2-5,CASSGTSGVGKTQYF,1,0,1,1
TRBV6-1,TRBJ2-7,CASSESSGSSYEQYF,1,0,1,1
TRBV6-1,TRBJ2-3,CASSEASGGLDTQYF,1,0,1,1
TRBV2,TRBJ2-5,CASSEDWGGQETQYF,1,0,1,1
TRBV28,TRBJ1-1,CASSTPGLEDTEAFF,1,0,1,1
TRBV7-2,TRBJ2-3,CASSFGRVYTDTQYF,1,0,1,1
TRBV11-1,TRBJ2-2,CASSFSGTLTGELFF,1,0,1,1
TRBV11-2,TRBJ2-5,CASSFRTSSPKTLYF,1,0,1,1
TRBV7-9,TRBJ2-3,CASSLLAGGTDTQYF,1,0,1,1
TRBV5-6,TRBJ2-1,CASSLVTGGPDEQFF,1,0,1,1
TRBV5-5,TRBJ1-5,CASSLAGGGYQPQHF,1,0,1,1
TRBV7-9,TRBJ1-1,CASSLGDRMNTEAFF,1,0,1,1
TRBV5-4,TRBJ2-1,CASSLDGSVYNEQLF,1,0,1,1
TRBV5-6,TRBJ2-3,CASSLEEREADTQYF,1,0,1,1
TRBV11-3,TRBJ1-2,CASSLTPQGNYGYTF,1,0,1,1
TRBV5-4,TRBJ2-3,CASSLTEEYTDTQYF,1,0,1,1
TRBV5-6,TRBJ2-5,CASSLKGDIQETQYF,1,0,1,1
TRBV7-3,TRBJ1-6,CASSLFSGSNSPLHF,1,0,1,1
TRBV7-3,TRBJ2-3,CASSLAGGSTDTQYF,1,0,1,1
TRBV7-2,TRBJ1-4,CASSLGQGRVEKLFF,1,0,1,1
TRBV7-2,TRBJ2-2,CASSLDPQNTGELFF,1,0,1,1
TRBV7-2,TRBJ2-3,CASSLERGGTDTQYF,1,0,1,1
TRBV7-2,TRBJ2-3,CASSLMVGVQDTQYF,1,0,1,1
TRBV11-2,TRBJ1-6,CASSLTLWGNSPLHF,1,0,1,1
TRBV7-2,TRBJ2-3,CASSLTGVGPDTQYF,1,0,1,1
TRBV7-2,TRBJ2-1,CASSLRSASYNEQFF,1,0,1,1
TRBV7-2,TRBJ2-3,CASSSRAGGTDTQYF,1,0,1,1
TRBV7-2,TRBJ1-1,CASSSGQALNTEAFF,1,0,1,1
TRBV7-8,TRBJ2-5,CASSSDRIGGETQYF,1,0,1,1
TRBV13,TRBJ1-2,CASSWGRSSAPGYTF,1,0,1,1
TRBV5-6,TRBJ2-2,CASSWGHAKTGELFF,1,0,1,1
TRBV27,TRBJ1-4,CASSPLTTTNEKLFF,1,0,1,1
TRBV3-1,TRBJ1-1,CASSPLGEGDTEAFF,1,0,1,1
TRBV5-4,TRBJ2-3,CASSPPRGPTDTQYF,1,1,2,2
TRBV11-3,TRBJ1-1,CASSPRRKLNTEAFF,1,0,1,1
TRBV11-1,TRBJ2-1,CASSPTSGNYNEQFF,1,0,1,1
TRBV7-9,TRBJ2-1,CASSPVPGQYNEQFF,2,3,2,5
TRBV6-2/3/5/6,TRBJ1-3,CASSPGGNSGNTIYF,1,0,1,1
TRBV7-2,TRBJ2-6,CASSHSVSGANVLTF,1,0,1,1
TRBV14,TRBJ2-1,CASSQPSGSRNEQFF,1,0,1,1
TRBV3-1,TRBJ1-4,CASSQVGWTNEKLFF,1,0,1,1
TRBV3-1,TRBJ2-7,CASSQGTAGPYEQYF,1,0,1,1
TRBV3-1,TRBJ2-5,CASSQGGGGRETHYF,1,0,1,1
TRBV7-8,TRBJ2-7,CASSVLSTEAYEQYF,1,0,1,1
TRBV9,TRBJ2-3,CASSVDSDNTDTQYF,1,0,1,1
TRBV28,TRBJ2-3,CASRLGTSGTDTQYF,1,0,1,1
TRBV5-1,TRBJ1-2,CASSLVGGFNYGYTF,1,0,1,1
TRBV5-1,TRBJ2-7,CASSLVAGAAYEQYF,1,0,1,1
TRBV5-1,TRBJ2-3,CASSLGLAGTDTQYF,1,0,1,1
TRBV5-1,TRBJ2-1,CASSSGLAGNNEQFF,1,0,1,1
TRBV5-1,TRBJ1-1,CASSSEGQLNTEAFF,1,0,1,1
TRBV5-1,TRBJ2-1,CASSQMGGGNNEQFF,1,0,1,1
TRBV4-3,TRBJ1-4,CASSQDFPDGEKLFF,2,0,1,2
TRBV4-3,TRBJ1-2,CASSQRPGDLNGYTF,1,0,1,1
TRBV5-1,TRBJ2-1,CASSRPGISYNEQFF,1,0,1,1
TRBV20-1,TRBJ2-7,CSASAIDRDPYEQYF,1,0,1,1
TRBV20-1,TRBJ2-1,CSARTEQEGYNEQFF,1,0,1,1
TRBV20-1,TRBJ2-5,CSTSFPAGGGETQYF,1,0,1,1
TRBV29-1,TRBJ1-1,CSVEPLETGAAEAFF,1,0,1,1
TRBV29-1,TRBJ2-1,CSVEPGRLGRNEQFF,1,0,1,1
TRBV29-1,TRBJ1-1,CSVAVNPSAGTEAFF,1,0,1,1
TRBV29-1,TRBJ2-1,RSVAGGTGVHNEQFF,1,0,1,1
TRBV7-9,TRBJ2-7,CVSSSPGGSYEQYF,1,0,1,1
TRBV28,TRBJ2-7,CATYRGAGAYEQYF,1,0,1,1
TRBV30,TRBJ1-5,CACQSADSNQPQHF,1,1,2,2
TRBV12-3/4,TRBJ1-3,CACTRRDRRNTIYF,1,0,1,1
TRBV30,TRBJ1-2,CAWSVRGGVPPYTF,1,0,1,1
TRBV30,TRBJ2-6,CAWRGETGANVLTF,1,0,1,1
TRBV7-2,TRBJ2-3,CAGSLGTSTDTQYF,1,0,1,1
TRBV10-3,TRBJ1-5,CAISEGTGNQPQHF,1,0,1,1
TRBV10-3,TRBJ1-1,CAIRGTAEGTEAFF,1,0,1,1
TRBV15,TRBJ2-4,CATSPGSWGNIQYF,2,0,1,2
TRBV19,TRBJ1-1,CASSALQGNTEAFF,1,0,1,1
TRBV12-3/4,TRBJ1-2,CASSPRTVRSGYTF,1,0,1,1
TRBV18,TRBJ2-1,CASSLIDREGEQFF,1,0,1,1
TRBV18,TRBJ2-3,CASSPRQSTDTQYF,1,0,1,1
TRBV18,TRBJ2-1,CASSPRPTDNEQFF,1,0,1,1
TRBV12-3/4,TRBJ1-1,CASSFYPENTEAFF,1,0,1,1
TRBV12-3/4,TRBJ2-5,CASSLAGGQETQYF,1,0,1,1
TRBV12-3/4,TRBJ2-3,CASSLGGTADTQYF,1,0,1,1
TRBV27,TRBJ2-5,CASSSRGRQETQYF,1,0,1,1
TRBV2,TRBJ2-5,CASSVEGEGETQYF,1,0,1,1
TRBV2,TRBJ1-5,CASSELRAGQPQHF,1,0,1,1
TRBV25-1,TRBJ1-1,CASSEAGGRTEAFF,1,0,1,1
TRBV12-3/4,TRBJ2-3,CASSTTGGGGTQYF,1,0,1,1
TRBV9,TRBJ1-6,CASSRTGRGSPLHF,1,0,1,1
TRBV5-4,TRBJ2-3,CASSFGLATDTQYF,1,0,1,1
TRBV5-4,TRBJ2-7,CASSLFQGGYEQYF,1,0,1,1
TRBV5-4,TRBJ1-2,CASSLGLSNYGYTF,1,0,1,1
TRBV5-5,TRBJ1-1,CASSLEPANTEAFF,1,0,1,1
TRBV7-6,TRBJ1-1,CASSLASVNTEAFF,1,0,1,1
TRBV7-2,TRBJ2-7,CASSLAGSSYEQYF,1,0,1,1
TRBV7-2,TRBJ1-2,CASSLEYGNYGYTF,1,0,1,1
TRBV13,TRBJ1-1,CASSLEQPNTEAFF,1,0,1,1
TRBV7-3,TRBJ2-2,CASSLQGYTGELFF,1,0,1,1
TRBV11-2,TRBJ1-1,CASSPGPLNTEAVF,1,0,1,1
TRBV7-9,TRBJ1-5,CASSPGGYNQPQHF,1,0,1,1
TRBV7-9,TRBJ2-3,CASSPTGATDTQYF,1,0,1,1
TRBV7-9,TRBJ1-1,CASSPASPGAEAFF,1,0,1,1
TRBV7-2,TRBJ1-4,CASSHPTVAEKLFF,1,0,1,1
TRBV7-9,TRBJ1-1,CASSQGRKNTEAFF,1,0,1,1
TRBV3-1,TRBJ2-5,CASSQEPAGETQYF,1,0,1,1
TRBV11-2,TRBJ1-2,CASSVTGTAYGYTF,1,0,1,1
TRBV5-6,TRBJ2-7,CASSAQGNPYEQYF,1,1,2,2
TRBV7-9,TRBJ1-5,CASSIGQGGRPQHF,1,0,1,1
TRBV4-2,TRBJ1-1,CASSTRGLNTEAFF,1,0,1,1
TRBV6-2/3/5/6,TRBJ1-2,CASSRTGHAYGYTF,1,0,1,1
TRBV12-3/4,TRBJ1-5,CASSKGQGNQPQHF,1,0,1,1
TRBV7-9,TRBJ2-7,CASRAPENTHEQYF,1,0,1,1
TRBV6-2/3/5/6,TRBJ1-5,CASRGGQYDQPQHF,1,0,1,1
TRBV7-2,TRBJ2-7,CASRISSGVYEQYF,1,0,1,1
TRBV7-3,TRBJ1-5,CARPRGIGNQPQHF,1,0,1,1
TRBV5-1,TRBJ2-2,CASTALLGTGELFF,1,0,1,1
TRBV10-1,TRBJ2-1,CASSARPTYNEQFF,1,0,1,1
TRBV5-1,TRBJ1-2,CASSLGQGIYGYTF,1,0,1,1
TRBV5-1,TRBJ2-7,CASSLGDAPYEQYF,1,0,1,1
TRBV5-1,TRBJ2-1,CASSLGLIINEQFF,1,0,1,1
TRBV5-1,TRBJ2-7,CASSSSGLSYEQYF,1,0,1,1
TRBV5-1,TRBJ2-3,CASSPPQDLDTQYF,1,0,1,1
TRBV4-1,TRBJ2-7,CASSQDPQSYEQYF,1,0,1,1
TRBV4-3,TRBJ2-2,CASSQDSNTGELFF,1,0,1,1
TRBV20-1,TRBJ2-3,CSASQGVWTDTQYF,1,0,1,1
TRBV20-1,TRBJ1-1,CSASPPKGNTEAFF,1,0,1,1
TRBV20-1,TRBJ2-1,CSARGTSDYNEQFF,1,0,1,1
TRBV20-1,TRBJ2-6,CSARENSGANVLTF,1,0,1,1
TRBV20-1,TRBJ1-5,CSARKTGPNQPQHF,1,0,1,1
TRBV20-1,TRBJ1-2,CSAEINRLAMLYTF,1,0,1,1
TRBV20-1,TRBJ2-7,CSAASGAAGDLEYF,1,0,1,1
TRBV29-1,TRBJ2-5,CSVVLGGSPETQYF,1,0,1,1
TRBV29-1,TRBJ2-7,CSVARGTSSYEQYF,1,0,1,1
TRBV29-1,TRBJ1-3,CSVEYPGSGNTIYF,1,0,1,1
TRBV29-1,TRBJ1-4,CSVTKRATNEKLFF,1,0,1,1
TRBV29-1,TRBJ2-7,CSVNRSNFSNEQYF,1,0,1,1
TRBV29-1,TRBJ2-1,CSALPRQGEDEQFF,1,0,1,1
TRBV12-5,TRBJ2-7,CASGLVLGNEQYF,1,0,1,1
TRBV19,TRBJ2-4,CASSWGPKNIQYF,1,0,1,1
TRBV12-3/4,TRBJ2-1,CATGTTSHNEQFF,1,0,1,1
TRBV24-1,TRBJ2-7,CATSDPGTSEQYF,1,0,1,1
TRBV10-3,TRBJ1-2,CATKLGPGAGYTF,1,0,1,1
TRBV19,TRBJ1-5,CASSRGWGEPQHF,1,0,1,1
TRBV19,TRBJ2-7,CASSIQGGYEQYF,1,0,1,1
TRBV19,TRBJ1-5,CASSTGGHQPQHF,1,0,1,1
TRBV7-9,TRBJ2-5,CASTPGAGVPQYF,1,0,1,1
TRBV7-9,TRBJ2-5,CASTHKDGKTQYF,1,0,1,1
TRBV6-2/3/5/6,TRBJ1-1,CASSLTGVTEAFF,1,0,1,1
TRBV6-2/3/5/6,TRBJ2-7,CASSLSRGHEQYF,1,0,1,1
TRBV28,TRBJ2-3,CASSLSGSPTQYF,1,0,1,1
TRBV28,TRBJ1-1,CASSLQGYTEAFF,1,0,1,1
TRBV27,TRBJ1-2,CASSLGGGYGYTF,1,0,1,1
TRBV5-6,TRBJ1-2,CASSSGQGYGYTS,1,0,1,1
TRBV6-2/3/5/6,TRBJ1-1,CASSYTGSTEAFF,1,0,1,1
TRBV7-6,TRBJ1-6,CASSPGSSSPLHF,1,0,1,1
TRBV2,TRBJ1-1,CASSEEVGTEAFF,1,0,1,1
TRBV5-6,TRBJ1-1,CASSFYRGTEAFF,1,0,1,1
TRBV7-2,TRBJ2-2,CASSLGEAGELFF,1,0,1,1
TRBV7-2,TRBJ2-7,CASSLGQGREQYF,1,0,1,1
TRBV7-9,TRBJ1-2,CASSSRGLYGYTF,1,0,1,1
TRBV7-2,TRBJ2-7,CASSSRGGYEQYF,1,0,1,1
TRBV14,TRBJ1-5,CASSPLGGQPQHF,1,0,1,1
TRBV7-2,TRBJ2-1,CASSPRPGYEQFF,1,0,1,1
TRBV14,TRBJ2-7,CASSRGHFYEQYF,1,0,1,1
TRBV6-2/3/5/6,TRBJ2-1,CASSRDRFNEQFF,1,0,1,1
TRBV3-1,TRBJ2-1,CASSQDVNNEQFF,1,0,1,1
TRBV3-1,TRBJ2-1,CASSQDKVNEQFF,1,0,1,1
TRBV9,TRBJ2-1,CASSVGTDNEQFF,1,0,1,1
TRBV13,TRBJ2-2,CASSVRNTGELFF,1,0,1,1
TRBV6-2/3/5/6,TRBJ1-2,CASSAGTLYGYTF,1,0,1,1
TRBV7-3,TRBJ2-3,CASSDPGGGTQYF,1,0,1,1
TRBV7-9,TRBJ2-2,CASSDRGPGELFF,1,0,1,1
TRBV12-3/4,TRBJ2-7,CASSTPGQYEQYF,1,0,1,1
TRBV7-3,TRBJ2-7,CASSKDRSYEQYF,1,0,1,1
TRBV5-4,TRBJ2-1,CASRSGTHNEQFF,1,0,1,1
TRBV10-1,TRBJ2-7,CASSPGRAYEQYF,1,0,1,1
TRBV5-1,TRBJ2-7,CASRVEGRYEQYF,1,0,1,1
TRBV10-1,TRBJ1-1,CASSLTGEAEAFF,1,0,1,1
TRBV4-3,TRBJ2-1,CASSSLSSFEQFF,1,0,1,1
TRBV4-1,TRBJ2-1,CASSRDYRTEQFF,1,0,1,1
TRBV4-1,TRBJ2-7,CASSQDPRGEQYF,1,0,1,1
TRBV4-3,TRBJ2-3,CASSQDRESGQYF,1,0,1,1
TRBV5-1,TRBJ1-2,CASSRAQGYGYTF,1,0,1,1
TRBV20-1,TRBJ1-1,CSASPDRNTEAFF,1,0,1,1
TRBV20-1,TRBJ1-1,CSARDFTGTEAFF,1,0,1,1
TRBV20-1,TRBJ2-7,CSARDQGPREQYF,1,0,1,1
TRBV20-1,TRBJ1-1,CSARRGSDTEAFF,1,0,1,1
TRBV20-1,TRBJ1-1,CSATTTHRLEAFF,1,0,1,1
TRBV29-1,TRBJ2-1,CSVRLNWDNEQFF,1,0,1,1
TRBV29-1,TRBJ1-2,CSVVGDSWDGYTF,1,0,1,1
TRBV29-1,TRBJ1-2,CSVGGQGNYGYTF,1,0,1,1
TRBV29-1,TRBJ1-2,CSVLRELGYGYTF,1,0,1,1
TRBV29-1,TRBJ2-6,CSVPGPGANVLTF,1,0,1,1
TRBV29-1,TRBJ2-4,CSASGVAENIQYF,1,0,1,1
TRBV5-6,TRBJ2-1,RASSGGANNEQFF,1,0,1,1
TRBV7-2,TRBJ1-2,CASRGYSYGYTF,1,0,1,1
TRBV10-3,TRBJ2-7,CATEGGRIEQYF,1,0,1,1
TRBV11-1,TRBJ1-1,CATPGGPAEAFF,1,0,1,1
TRBV7-2,TRBJ2-1,CASISSYNEQLF,1,0,1,1
TRBV6-2/3/5/6,TRBJ2-7,CASFGPSYEQYF,1,0,1,1
TRBV7-6,TRBJ2-7,CASGFHGREQNF,1,0,1,1
TRBV7-6,TRBJ1-5,CASSFGQGPQHF,1,0,1,1
TRBV5-6,TRBJ2-7,CASSLRAGEQYF,1,0,1,1
TRBV11-2,TRBJ1-6,CASSPSAPDLHF,1,0,1,1
TRBV7-9,TRBJ1-2,CASSPPGVPHTF,1,0,1,1
TRBV3-1,TRBJ2-7,CASSQVRGDRCF,1,0,1,1
TRBV3-1,TRBJ1-5,CASSQEGKPQHF,1,0,1,1
TRBV9,TRBJ2-7,CASSVDSYEQYF,1,0,1,1
TRBV6-2/3/5/6,TRBJ1-1,CASRLGYTEAFF,1,0,1,1
TRBV5-1,TRBJ1-2,CASSLENYGYTF,1,0,1,1
TRBV4-1,TRBJ1-1,CASSQARRPAFF,1,0,1,1
TRBV5-1,TRBJ1-2,CASSGPAYGYTF,1,0,1,1
TRBV20-1,TRBJ2-7,CSARGQGNEQYF,1,0,1,1
TRBV20-1,TRBJ2-3,CSARVQTDTQYF,1,1,2,2
TRBV29-1,TRBJ2-7,CSVERESDEQYF,1,0,1,1
TRBV29-1,TRBJ1-2,CSVQAGAGGYTF,1,0,1,1
TRBV29-1,TRBJ1-1,CSAGVGLEEAFF,1,0,1,1
TRBV19,TRBJ2-1,CASNYYNEQFF,1,0,1,1
TRBV12-3/4,TRBJ1-1,CASSLGPEAFF,1,0,1,1
TRBV6-2/3/5/6,TRBJ1-1,CASSSRGGAFF,1,0,1,1
TRBV12-3/4,TRBJ1-1,CASSLGTEAFF,1,0,1,1
TRBV12-3/4,TRBJ1-1,CASSLRREAFF,1,0,1,1
TRBV7-2,TRBJ2-1,CASSFRNEQFF,1,0,1,1
TRBV7-9,TRBJ2-5,CASSLKETQYF,1,0,1,1
TRBV29-1,TRBJ2-2,CSVENTGELFF,1,0,1,1
TRBV29-1,TRBJ2-1,CSGRDGRGQFF,1,0,1,1
TRBV30,TRBJ2-7,CAWSGKEQYF,1,0,1,1
TRBV20-1,TRBJ2-3,CSATSDTQYF,1,0,1,1
TRBV29-1,TRBJ1-1,CSVEFRVAFF,1,0,1,1
TRBV20-1,TRBJ2-1,CSARDPSRSVSASGRRDEQFF,1,0,1,1
TRBV6-2/3/5/6,TRBJ2-2,CASSNGLARANTGELFF,1,0,1,1
TRBV11-2,TRBJ2-1,CASSLAGIAASYNEQFF,1,0,1,1
TRBV7-9,TRBJ2-3,CASSLERGTRDTQYF,1,0,1,1
TRBV9,TRBJ2-5,CASSVAPSAKETQYF,1,0,1,1
TRBV5-1,TRBJ1-1,CASSFRERANTEAFF,2,0,1,2
TRBV15,TRBJ2-7,CATSRDHGPYEQHF,1,0,1,1
TRBV3-1,TRBJ2-7,CASSQGRGRYEQYF,1,0,1,1
TRBV3-1,TRBJ1-2,CASSQGSGYDSYTF,2,0,1,2
TRBV9,TRBJ1-2,CASNSGQGRYGYTF,1,0,1,1
TRBV5-4,TRBJ2-3,CASSLPIGGAAVASSTDTQYF,1,0,1,1
TRBV12-3/4,TRBJ1-3,CASSLARGARQGAPGNTIYF,1,0,1,1
TRBV7-2,TRBJ2-7,CASSLVLRPTPGVSRGGQYF,1,0,1,1
TRBV7-2,TRBJ2-1,CASSLRPGAGGTTGYNEQFF,1,0,1,1
TRBV11-2,TRBJ2-6,CASRPLPGTGGSEGANVLTF,1,0,1,1
TRBV10-2,TRBJ2-3,CASSLSGQGIRAVNTDTQYF,1,0,1,1
TRBV20-1,TRBJ1-5,CSARPPGRAPPYSNQPQHF,1,0,1,1
TRBV20-1,TRBJ2-1,YSAVIPLAHVRSSYNEQFF,1,0,1,1
TRBV15,TRBJ2-5,CATSRPRRTSGGIETQYF,1,0,1,1
TRBV19,TRBJ1-5,CASSMGAGGMVSNQPQHF,1,0,1,1
TRBV7-6,TRBJ2-1,CASSSLKQAGASYNEQFF,1,0,1,1
TRBV7-9,TRBJ2-3,CASSSSRREATSTDTQYF,1,0,1,1
TRBV4-1,TRBJ1-2,CASSQDSKLTGTHYGYTF,1,0,1,1
TRBV20-1,TRBJ1-6,CSARDRSGRQGQRSPLHF,1,0,1,1
TRBV6-2/3/5/6,TRBJ2-1,YASSYVRGVRNSYNEQFF,1,0,1,1
TRBV24-1,TRBJ2-5,CATSDFVPGQIQETQYF,1,2,2,3
TRBV19,TRBJ2-1,CASSIPGHHSSYNEQFF,1,0,1,1
TRBV19,TRBJ1-3,CASSSRRQSLWRNTIYF,1,0,1,1
TRBV18,TRBJ2-6,CASSMTGSLSGANVLTF,1,0,1,1
TRBV18,TRBJ2-4,CASSPGTGRLAKNIQYF,1,0,1,1
TRBV18,TRBJ2-3,CASSPTPGTGESDTQYF,1,0,1,1
TRBV27,TRBJ2-7,CASSLSPAGTGGYEQYF,1,0,1,1
TRBV6-2/3/5/6,TRBJ2-5,CASSLRNRGTPSGTQYF,1,0,1,1
TRBV12-3/4,TRBJ2-1,CASSLRTDRNSYNEQFF,1,0,1,1
TRBV6-2/3/5/6,TRBJ1-5,CASSYSIFRDRVQPQHF,1,0,1,1
TRBV6-2/3/5/6,TRBJ2-6,CASSYSPPPSGANVLTF,1,0,1,1
TRBV6-1,TRBJ1-5,CASSEGGIWGVTQPQHF,1,0,1,1
TRBV6-4,TRBJ1-5,CASSEGGIWGVTQPQHL,1,0,1,1
TRBV27,TRBJ2-2,CASSTRTSGGVAGELFF,1,0,1,1
TRBV7-6,TRBJ2-2,CASSLPSTGLLTGELFF,1,0,1,1
TRBV7-2,TRBJ2-7,CASSLVGGRMLSYEQYF,1,0,1,1
TRBV11-2,TRBJ1-6,CASSLEVPGGWNSPLHF,1,0,1,1
TRBV7-2,TRBJ2-3,CASSLIGLAGITDTQYF,1,0,1,1
TRBV7-2,TRBJ2-1,CASSLGTGDPSYNEQFF,1,0,1,1
TRBV7-2,TRBJ2-3,CASSPFLDSLSTDTQYF,1,0,1,1
TRBV4-2,TRBJ2-7,CASSPLGQGERSYEQYF,1,0,1,1
TRBV7-2,TRBJ2-1,CASSPRGQMGKSNEQFF,1,0,1,1
TRBV7-2,TRBJ2-3,CASSPTRQGIGADTQYF,1,0,1,1
TRBV7-2,TRBJ2-1,CASSRGWTGGPVNEQFF,1,0,1,1
TRBV14,TRBJ1-2,CASSQVGLRGPNYGYTF,1,0,1,1
TRBV11-2,TRBJ2-1,CASSVRTASGGYNEQFF,1,0,1,1
TRBV5-4,TRBJ2-2,CASSDRAGGPYTGELFF,1,0,1,1
TRBV5-1,TRBJ2-3,CASSLVVSGGATDTQYF,1,0,1,1
TRBV20-1,TRBJ2-5,CSALSLGGTGAGETQYF,1,0,1,1
TRBV29-1,TRBJ1-1,CSVGPGQDWGINTEAFF,1,0,1,1
TRBV29-1,TRBJ2-6,CSVEDHPPGPGANVLTF,1,0,1,1
TRBV12-5,TRBJ2-4,CASGPRGTGGKNIQYF,1,0,1,1
TRBV19,TRBJ1-2,CASSSEPGTGIYGYTF,1,0,1,1
TRBV19,TRBJ2-4,CASSAADLVLTNIQYF,1,2,2,3
TRBV19,TRBJ1-5,CASSMGTEARDVPQHF,1,0,1,1
TRBV19,TRBJ2-1,CASSIALAGIRGEQFF,1,0,1,1
TRBV19,TRBJ2-3,CASSIGSGQGTDTQYF,1,0,1,1
TRBV19,TRBJ2-3,CASSIGRQGSTDTQYF,1,0,1,1
TRBV28,TRBJ1-5,CASTTPAWGLRQPQHF,1,0,1,1
TRBV11-2,TRBJ2-1,CASSFRGSGNYNEQFF,2,0,1,2
TRBV6-2/3/5/6,TRBJ2-1,CASSLSWTGRNNEQFF,1,0,1,1
TRBV12-3/4,TRBJ1-5,CASSLARQYSNQPQHF,1,0,1,1
TRBV5-6,TRBJ2-1,CASSSTRDFHLEEQFF,1,0,1,1
TRBV6-2/3/5/6,TRBJ1-3,CASSWGGAGIGNTIYF,1,0,1,1
TRBV6-2/3/5/6,TRBJ2-3,CASSYSDEPSTDTQYF,1,0,1,1
TRBV6-2/3/5/6,TRBJ1-5,CASSLFGTGSNQPQHF,1,0,1,1
TRBV6-1,TRBJ1-1,CASSGRKTGMNTEAFF,1,0,1,1
TRBV7-9,TRBJ2-3,CASSFPRGASTDTQYF,1,0,1,1
TRBV13,TRBJ1-6,CASSFRQGRGNSPLHF,1,0,1,1
TRBV7-8,TRBJ2-1,CASSLGRDYRNNEQFF,1,0,1,1
TRBV11-2,TRBJ2-5,CASSLVTSGDQETQYF,1,0,1,1
TRBV7-2,TRBJ2-5,CASSLGSSGKQETQYF,1,0,1,1
TRBV7-9,TRBJ2-1,CASSLGVLARCNEQFF,1,0,1,1
TRBV7-2,TRBJ2-7,CASSLGTSGLAYEQYF,1,0,1,1
TRBV13,TRBJ2-3,CASSLKTSGYTDTQYF,1,0,1,1
TRBV5-6,TRBJ2-3,CASSSLSRIPTDTQYF,1,0,1,1
TRBV7-9,TRBJ1-3,CASSSNRGFSGNTIHF,1,0,1,1
TRBV11-2,TRBJ2-5,CASSYGLEAGRETQYF,1,0,1,1
TRBV7-6,TRBJ2-7,CASSPETGTDSYEQYF,1,0,1,1
TRBV7-9,TRBJ1-1,CASSPRAAEYNTEAFF,1,0,1,1
TRBV5-5,TRBJ2-5,CASSPKVLAGEETQYF,1,0,1,1
TRBV14,TRBJ2-1,CASSQDTGGSYNEQFF,1,0,1,1
TRBV14,TRBJ2-7,CASSQDNAAGTYEQYF,1,1,2,2
TRBV3-1,TRBJ1-6,CASSQEGRARNSPLHF,1,0,1,1
TRBV7-9,TRBJ2-1,CASSVLQGMSYNELFF,1,0,1,1
TRBV5-6,TRBJ2-3,CASSDLQGGGTDTQYF,1,0,1,1
TRBV14,TRBJ1-1,CASSEGQGTENTEAFF,1,0,1,1
TRBV7-3,TRBJ2-1,CASSTQRPGTGDEQFF,1,0,1,1
TRBV7-9,TRBJ1-1,CASRGPGQGLSTGAFF,1,0,1,1
TRBV5-1,TRBJ2-1,CASSLGTSYRGGEQFF,1,0,1,1
TRBV5-1,TRBJ2-7,CASSLDRTSGGYEQYF,1,0,1,1
TRBV5-1,TRBJ2-5,CASSSEGLAGPETQYF,1,0,1,1
TRBV5-1,TRBJ2-1,CASSPVLGPPYNEQFF,1,0,1,1
TRBV4-1,TRBJ1-1,CASSPTGGTMNTEAFF,1,0,1,1
TRBV4-3,TRBJ2-5,CASSQGRPGGVETQYF,2,0,1,2
TRBV20-1,TRBJ2-5,CSAMGLAGGHQETQYF,1,0,1,1
TRBV20-1,TRBJ2-6,CSATASRGSGANVLTF,1,0,1,1
TRBV20-1,TRBJ1-3,CSARVPGQGDGNTIYF,1,0,1,1
TRBV20-1,TRBJ2-3,CSARDTSGRGTDTQYF,1,0,1,1
TRBV20-1,TRBJ2-5,CSARDPNSGGGETQYF,1,0,1,1
TRBV20-1,TRBJ2-3,CSARDVLAGNQDTQYF,1,0,1,1
TRBV29-1,TRBJ2-3,CSVDGTVAGGGYTQYF,1,0,1,1
TRBV29-1,TRBJ2-2,CSVEGSGRRRTGELFF,1,0,1,1
TRBV29-1,TRBJ2-2,RSVTNPRAKGAGELFF,1,0,1,1
TRBV12-5,TRBJ2-7,CASALRVSAHHEQYF,1,0,1,1
TRBV5-4,TRBJ2-5,CASSLTSGGEETQYF,1,0,1,1
TRBV10-3,TRBJ2-3,CAIGTDRDRTDTRYF,1,0,1,1
TRBV10-3,TRBJ1-1,CAISENGRSLAEAFF,1,0,1,1
TRBV15,TRBJ1-1,CATSRDRSVNTEAFF,1,0,1,1
TRBV15,TRBJ2-7,CATSRESSGSHEQYF,1,0,1,1
TRBV19,TRBJ1-5,CASSIGTGVDQPQHF,1,0,1,1
TRBV19,TRBJ2-1,CASSIASGIYNEQFF,1,0,1,1
TRBV19,TRBJ1-5,CASNSRTEGGQPQHF,1,0,1,1
TRBV7-9,TRBJ2-7,CASSRPGTGNYEQYF,1,0,1,1
TRBV18,TRBJ1-1,CASSPYRESNTEAFF,1,0,1,1
TRBV18,TRBJ1-1,CASSPNQGENTEAFF,1,0,1,1
TRBV12-3/4,TRBJ2-1,CASQPRQSSYNEQFF,1,0,1,1
TRBV7-2,TRBJ1-6,CASTLMDIQNSPLHF,1,0,1,1
TRBV27,TRBJ1-2,CASSLSPRGDYGYTF,1,0,1,1
TRBV28,TRBJ1-5,CASSLWDREDQPQHF,1,0,1,1
TRBV11-3,TRBJ2-6,CASSLVSSGANVLTF,1,0,1,1
TRBV27,TRBJ1-1,CASSSPGTGITEAFF,1,0,1,1
TRBV6-2/3/5/6,TRBJ1-1,CASSSNARTPPEAYF,1,0,1,1
TRBV6-2/3/5/6,TRBJ2-1,CASSPLAGGYNEQFF,1,0,1,1
TRBV12-3/4,TRBJ2-1,CASSPDRRALNEQFF,1,0,1,1
TRBV6-2/3/5/6,TRBJ1-3,CASSHRGGSGDTIYF,1,0,1,1
TRBV5-4,TRBJ2-1,CASSLPAGGWDEQFF,1,0,1,1
TRBV5-4,TRBJ1-6,CASSLQGIGYSPLHF,1,0,1,1
TRBV5-4,TRBJ2-3,CASSLVQGSTDTQYF,1,0,1,1
TRBV5-4,TRBJ2-5,CASSLGPGSKETQYF,1,0,1,1
TRBV5-4,TRBJ2-3,CASSLGGKIPDTQYF,1,0,1,1
TRBV5-6,TRBJ1-1,CASSLEVSGLTEAFF,1,0,1,1
TRBV7-3,TRBJ1-1,CASSLWGASNTEAFF,1,0,1,1
TRBV5-6,TRBJ2-7,CASSLPSGDSYEQYF,1,0,1,1
TRBV7-9,TRBJ2-3,CASSLVPSHQDTQYF,1,1,2,2
TRBV7-9,TRBJ1-4,CASSLAHRNNEKLFF,1,0,1,1
TRBV7-2,TRBJ1-2,CASSLGAGETYGYTF,1,0,1,1
TRBV5-4,TRBJ2-7,CASSLGTGGRYEQYF,1,0,1,1
TRBV7-9,TRBJ2-7,CASSLISASRDEQYF,1,0,1,1
TRBV7-9,TRBJ2-3,CASSLIRVRTDTQYF,1,0,1,1
TRBV7-2,TRBJ2-7,CASSLTSGRIYEQYF,1,0,1,1
TRBV11-1,TRBJ2-4,CASSLRGHSENIQYF,1,0,1,1
TRBV5-6,TRBJ2-6,CASSLKVSGANVLTF,1,0,1,1
TRBV7-9,TRBJ2-1,CASSSRVANYNEQFF,1,0,1,1
TRBV9,TRBJ2-6,CASSSAGSGANVLTF,1,0,1,1
TRBV7-9,TRBJ2-1,CASSSNPIGKNEQFF,1,0,1,1
TRBV7-9,TRBJ2-2,CASSSPFRDTGELFF,1,0,1,1
TRBV7-9,TRBJ1-5,CASSSYTGFGSPQHF,1,0,1,1
TRBV6-4,TRBJ2-7,CASSWTSGSSYEQYF,1,0,1,1
TRBV6-2/3/5/6,TRBJ2-7,CASSLGTGVPYEQYF,1,0,1,1
TRBV13,TRBJ2-1,CASSLSSGRYNEQFF,1,0,1,1
TRBV3-1,TRBJ2-1,CASSPPDRAYNEQFF,1,0,1,1
TRBV5-4,TRBJ1-4,CASSPRSGFNEKLFF,1,0,1,1
TRBV11-1,TRBJ2-1,CASSPTSISYNEQFF,1,1,2,2
TRBV7-9,TRBJ1-1,CASSPSAGGTTEAFF,1,0,1,1
TRBV9,TRBJ1-2,CASSPTATGPPGYTF,1,0,1,1
TRBV7-9,TRBJ1-3,CASSRRTITGNTIYF,1,0,1,1
TRBV5-5,TRBJ1-2,CASSRDSFLDYGYTF,1,0,1,1
TRBV16,TRBJ1-2,CASSQSHSGFYGYTF,1,0,1,1
TRBV3-1,TRBJ1-5,CASSQGKLTNQPQHF,1,0,1,1
TRBV4-2,TRBJ2-3,CASSQDPRQGNTQYF,1,0,1,1
TRBV14,TRBJ1-4,CASSQDKGANEKLFF,1,0,1,1
TRBV3-1,TRBJ2-6,CASSQDFSGANVLTF,1,0,1,1
TRBV3-1,TRBJ1-2,CASSQEWQGGDGYTF,1,0,1,1
TRBV9,TRBJ2-7,CASSVELAATYEQYF,1,0,1,1
TRBV9,TRBJ2-6,CASSAGGRTANVLTF,1,0,1,1
TRBV5-4,TRBJ2-7,CASRSDASISYEQYF,1,0,1,1
TRBV3-1,TRBJ2-7,CASRQGSEGGGEQYF,1,0,1,1
TRBV3-1,TRBJ2-7,CASRNRGTGPYEQYF,1,0,1,1
TRBV5-1,TRBJ2-1,CATLPGASSYNEQFF,1,0,1,1
TRBV10-1,TRBJ2-3,CASSSVTGATDTQYF,1,0,1,1
TRBV5-1,TRBJ2-2,CASTTGARDTGELFF,1,0,1,1
TRBV5-1,TRBJ2-3,CASSLRRSYTDTQYF,1,0,1,1
TRBV10-2,TRBJ2-3,CASSERTGLADTQYF,1,0,1,1
TRBV5-1,TRBJ1-2,CASSFRDRASDGYTF,1,0,1,1
TRBV5-1,TRBJ2-7,CASSLGGVLGYEQYF,1,0,1,1
TRBV5-1,TRBJ1-5,CASSLGQGANQPQHF,1,0,1,1
TRBV5-1,TRBJ1-1,CASSLQGPTNTEAFF,1,0,1,1
TRBV5-1,TRBJ2-7,CASSPRDRGKYEQYF,1,0,1,1
TRBV4-1,TRBJ2-5,CASSPMTGGRETQYF,1,0,1,1
TRBV5-1,TRBJ1-4,CASSPIPGGSEELFF,1,0,1,1
TRBV4-3,TRBJ2-5,CASSQSAGPRETQYF,1,0,1,1
TRBV4-1,TRBJ1-5,CASSQDWQGDQPQHF,1,0,1,1
TRBV4-3,TRBJ2-5,CASSQDRGESETQYF,1,0,1,1
TRBV13,TRBJ1-6,CTSSAGRAKNSPLHF,1,0,1,1
TRBV20-1,TRBJ2-7,CSARDPAGGPREQYF,1,0,1,1
TRBV20-1,TRBJ2-1,CSARDRSDGDNEQFF,1,0,1,1
TRBV29-1,TRBJ1-1,CSVAAPGGGVTEAFF,1,0,1,1
TRBV29-1,TRBJ2-1,CSVEDASGRVNEQFF,1,0,1,1
TRBV29-1,TRBJ1-4,CSVEDASSTNEKLFF,1,0,1,1
TRBV19,TRBJ2-7,RASSTAQGASGEQYF,1,0,1,1
TRBV30,TRBJ2-5,CAWRPPRGEETQYF,1,0,1,1
TRBV24-1,TRBJ2-2,CATASGTGLGELFF,1,0,1,1
TRBV24-1,TRBJ1-4,CATSESNSGEKLFF,1,0,1,1
TRBV19,TRBJ2-2,CASSPGVGTGELFF,1,0,1,1
TRBV19,TRBJ2-5,CASSIEASQETQYF,1,0,1,1
TRBV19,TRBJ2-5,CASSKLGQQETQYF,1,0,1,1
TRBV19,TRBJ2-7,CASKSQPATYEQYF,1,1,2,2
TRBV12-3/4,TRBJ2-7,CASSPGQGSYEQYF,1,0,1,1
TRBV11-1,TRBJ1-1,CASSRDRGNTEAFF,1,0,1,1
TRBV18,TRBJ2-1,CASSPGTGGNEQFF,1,0,1,1
TRBV18,TRBJ2-5,CASSRTTGSETQYF,1,1,2,2
TRBV2,TRBJ1-1,CASAIRLGNTEAFF,1,0,1,1
TRBV12-3/4,TRBJ1-1,CASTPANMNTEAYF,1,0,1,1
TRBV25-1,TRBJ2-3,CASTGRRFTDTQYF,1,0,1,1
TRBV6-2/3/5/6,TRBJ1-6,CASTPLQGNSPLHF,1,0,1,1
TRBV12-3/4,TRBJ2-1,CASSFERGYNEQFF,1,0,1,1
TRBV6-2/3/5/6,TRBJ2-7,CASSLSGQFYEQYF,1,0,1,1
TRBV12-3/4,TRBJ2-2,CASSLVAGVGELFF,1,2,2,3
TRBV12-3/4,TRBJ2-1,CASSLAPLYNEQFF,1,1,2,2
TRBV7-2,TRBJ2-3,CASSLAEGPDTQYF,1,0,1,1
TRBV6-2/3/5/6,TRBJ2-1,CASSSPDGYNEQFF,1,0,1,1
TRBV6-2/3/5/6,TRBJ2-7,CASSYSNGVYEQYF,1,0,1,1
TRBV6-2/3/5/6,TRBJ1-2,CASSYDRIPQQYTF,1,0,1,1
TRBV28,TRBJ1-1,CASSPGQGAWYAFS,1,0,1,1
TRBV28,TRBJ2-3,CASSRTSVADTQYF,1,0,1,1
TRBV2,TRBJ2-5,CASSGAGAQETQYF,1,0,1,1
TRBV7-9,TRBJ1-5,CASSGGQGSQPQHF,1,0,1,1
TRBV6-1,TRBJ2-2,CASSEGGGPGELFF,1,0,1,1
TRBV27,TRBJ2-7,CASSKDRGSYEQYF,1,0,1,1
TRBV5-5,TRBJ1-5,CASSFRREGQPQHF,1,0,1,1
TRBV2,TRBJ2-5,CASSFRDRVVTQYF,1,0,1,1
TRBV7-8,TRBJ1-1,CASSFRGANTEAFF,1,0,1,1
TRBV7-6,TRBJ1-1,CASSFRDQNTEAFF,1,0,1,1
TRBV5-6,TRBJ2-1,CASSLVGRVNEQFF,1,0,1,1
TRBV5-5,TRBJ2-7,CASSLGAGGYEQYF,1,0,1,1
TRBV7-2,TRBJ2-7,CASSLSSNRDEQYF,1,0,1,1
TRBV7-9,TRBJ2-7,CASSLSGISYEQYF,1,1,2,2
TRBV7-2,TRBJ2-3,CASSLAGTTDTQYF,1,0,1,1
TRBV5-6,TRBJ2-3,CASSLASSTDTQYF,1,0,1,1
TRBV7-2,TRBJ2-5,CASSLASGEETQYF,1,0,1,1
TRBV7-2,TRBJ1-1,CASSLGTGSTEAFF,1,0,1,1
TRBV7-6,TRBJ2-1,CASSLDVRYNEQFF,1,0,1,1
TRBV11-2,TRBJ1-1,CASSLETGNTEAFF,1,0,1,1
TRBV7-2,TRBJ1-1,CASSLRQGFTEAFF,1,0,1,1
TRBV7-9,TRBJ2-7,CASSSRGGSYEQYF,1,0,1,1
TRBV7-8,TRBJ2-5,CASSYTGNQETQYF,1,0,1,1
TRBV7-6,TRBJ2-1,CASSLFNRGNEQFF,1,0,1,1
TRBV5-6,TRBJ2-6,CASSLLSGANVLTF,1,0,1,1
TRBV6-2/3/5/6,TRBJ2-5,CASSLSWGQETQYF,1,0,1,1
TRBV7-3,TRBJ2-5,CASSLGTAQETQYF,1,0,1,1
TRBV9,TRBJ2-1,CASSPQGAPYLRFF,1,0,1,1
TRBV3-1,TRBJ1-2,CASSPGTGNYGYTF,1,0,1,1
TRBV2,TRBJ2-3,CASSRDRGSDTQYF,1,0,1,1
TRBV3-1,TRBJ2-7,CASSHPRQSYEQYF,1,0,1,1
TRBV7-2,TRBJ2-2,CASSQIGDTGELFF,1,0,1,1
TRBV14,TRBJ2-3,CASSQDLSVYTQYF,1,0,1,1
TRBV4-2,TRBJ2-1,CASSQEFTHNEQFF,1,0,1,1
TRBV7-2,TRBJ2-7,CASSQNRQGREQYF,1,0,1,1
TRBV9,TRBJ1-6,CASSVTDGYSPLHF,1,0,1,1
TRBV9,TRBJ2-3,CASSVDPSTDTQYF,1,0,1,1
TRBV7-9,TRBJ2-5,CASSATGVWETQYF,1,0,1,1
TRBV7-3,TRBJ1-1,CASSDYPGRTEAFF,1,0,1,1
TRBV9,TRBJ2-7,CASSEDRYSYEQYF,1,0,1,1
TRBV7-3,TRBJ2-3,CASSEGGSTDTQYF,1,0,1,1
TRBV6-2/3/5/6,TRBJ1-1,CASSTTGGRTEAFF,1,0,1,1
TRBV7-9,TRBJ1-6,CASSSGAGNSPLHF,1,0,1,1
TRBV2,TRBJ2-2,CASRLAVNTGELFF,1,0,1,1
TRBV6-2/3/5/6,TRBJ2-7,CASRQDSISYEQYF,1,0,1,1
TRBV5-1,TRBJ2-1,CASSLRGPYNEQFF,1,1,2,2
TRBV5-1,TRBJ2-7,CASSFGEEGYEQYF,1,0,1,1
TRBV5-1,TRBJ1-4,CASSLSGLNEKLFF,1,0,1,1
TRBV5-1,TRBJ1-1,CASSLSAGNTEAFF,1,0,1,1
TRBV5-1,TRBJ2-3,CASSLATGTDTQYF,1,0,1,1
TRBV5-1,TRBJ2-1,CASSLAQRGNEQFF,1,0,1,1
TRBV5-1,TRBJ2-1,CASSLAGQHNEQFF,1,0,1,1
TRBV5-1,TRBJ2-5,CASSLGVAEETQYF,1,0,1,1
TRBV5-1,TRBJ1-4,CASSSDRGREKLFF,1,0,1,1
TRBV5-1,TRBJ1-1,CASSLGQVNTEAFF,1,0,1,1
TRBV4-1,TRBJ2-1,CASSRTMQGNEQFF,1,0,1,1
TRBV4-1,TRBJ1-1,CASSQGLVNTEAFF,1,0,1,1
TRBV5-1,TRBJ1-4,CASSGQGTNEKPFF,1,0,1,1
TRBV5-1,TRBJ2-7,CASRTGTSGYEQCS,1,0,1,1
TRBV29-1,TRBJ1-1,CTAWAGGSNTEAFF,1,0,1,1
TRBV20-1,TRBJ2-3,CSAPGPGDTDTQYF,1,0,1,1
TRBV20-1,TRBJ2-2,CSASPRALKGELFF,1,0,1,1
TRBV20-1,TRBJ1-4,CSARVNREGGKLFF,1,0,1,1
TRBV20-1,TRBJ1-5,CSARVGGSNQPQHF,1,0,1,1
TRBV20-1,TRBJ2-5,CSARAGDRKETQYF,1,3,2,4
TRBV20-1,TRBJ2-7,CSARDSGTLYEQYF,1,0,1,1
TRBV20-1,TRBJ2-1,CSARELAGHNEQFF,1,0,1,1
TRBV29-1,TRBJ2-1,CSVLKGAVYSEQFF,1,0,1,1
TRBV29-1,TRBJ2-7,CSVWTSGSKYEQYF,1,0,1,1
TRBV29-1,TRBJ2-2,CSVVSRANTGELFF,1,0,1,1
TRBV29-1,TRBJ2-1,CSVVKSRGGNEQFF,1,0,1,1
TRBV29-1,TRBJ2-3,CSVVPRSGTDTQYF,1,0,1,1
TRBV29-1,TRBJ2-3,CSVVLFTSTDTQYF,1,0,1,1
TRBV29-1,TRBJ1-1,CSVAPPYATTEAFF,1,0,1,1
TRBV29-1,TRBJ1-4,CSVEVGQLGEKLFF,1,0,1,1
TRBV29-1,TRBJ2-1,CSVEPGQGYNEQFF,1,0,1,1
TRBV29-1,TRBJ2-3,CSALGQGRTDTQYF,1,0,1,1
TRBV29-1,TRBJ2-5,CSAPTSGGGETQYF,1,0,1,1
TRBV12-5,TRBJ1-1,CASGLGTNTEAFF,1,0,1,1
TRBV30,TRBJ1-1,CAWSRSMNTEAFF,1,0,1,1
TRBV30,TRBJ1-5,CAWSVSSNQPQHF,1,0,1,1
TRBV30,TRBJ1-5,CAWSDMGNQPQHF,1,0,1,1
TRBV30,TRBJ2-1,CAWSRDHYNEQFF,1,1,2,2
TRBV27,TRBJ2-7,CAGSHGPTYEQYF,1,0,1,1
TRBV10-3,TRBJ2-3,CAIDRVEKDTQYF,1,0,1,1
TRBV10-3,TRBJ1-2,CAISKDRDYGYTF,1,0,1,1
TRBV19,TRBJ2-5,CASSMGEEETQYF,1,0,1,1
TRBV19,TRBJ1-1,CASSISQGNEAFF,1,0,1,1
TRBV19,TRBJ2-3,CASSIQSTDTQYF,1,0,1,1
TRBV19,TRBJ2-3,CASSPGGADTQYF,1,0,1,1
TRBV19,TRBJ1-1,CASSIVEGTEAFF,1,0,1,1
TRBV19,TRBJ2-7,CASRDSGRSEQYF,1,0,1,1
TRBV18,TRBJ1-6,CASSPGPTSPLHF,1,0,1,1
TRBV18,TRBJ2-5,CASSPAGQETQYF,1,0,1,1
TRBV18,TRBJ2-3,CASSPGDVRPQYF,1,0,1,1
TRBV18,TRBJ1-1,CASSPSGGGGAFF,1,1,2,2
TRBV12-3/4,TRBJ1-5,CASYGAVGQPQHF,1,0,1,1
TRBV7-9,TRBJ1-4,CASGPRAGEKLFF,1,0,1,1
TRBV6-2/3/5/6,TRBJ2-5,CASSLDRQETQYF,1,0,1,1
TRBV6-2/3/5/6,TRBJ2-1,CASSLSVGEGQFF,1,0,1,1
TRBV7-2,TRBJ2-3,CASSSWSTDTQYF,1,0,1,1
TRBV6-2/3/5/6,TRBJ2-1,CASSYLGRKEQFF,1,0,1,1
TRBV6-2/3/5/6,TRBJ2-5,CASSYPFGETQYF,1,0,1,1
TRBV2,TRBJ2-7,CASSVGRDYEQYF,1,0,1,1
TRBV2,TRBJ2-4,CASSGLAKNIQYF,1,0,1,1
TRBV7-2,TRBJ1-1,CASSFQGGTEAFF,1,1,2,2
TRBV5-6,TRBJ2-5,CASSFDRAETQYF,1,0,1,1
TRBV11-3,TRBJ2-2,CASSFSGTGELFF,1,0,1,1
TRBV7-2,TRBJ2-2,CASSFGTTGELFF,1,0,1,1
TRBV9,TRBJ1-1,CASSFRGNTEAFF,1,0,1,1
TRBV5-6,TRBJ2-1,CASSLPGVWEQFF,1,0,1,1
TRBV5-5,TRBJ1-2,CASSLAGLYGYTF,1,0,1,1
TRBV7-2,TRBJ2-4,CASSLGRGDIQYF,1,0,1,1
TRBV11-2,TRBJ1-1,CASSLPGGRAAFF,1,0,1,1
TRBV7-2,TRBJ2-3,CASSLPESDTQYF,1,0,1,1
TRBV5-4,TRBJ1-1,CASSLQGGTEAFF,1,0,1,1
TRBV11-2,TRBJ1-1,CASSLAPSGEAFF,1,0,1,1
TRBV7-9,TRBJ1-1,CASSLAAGTEAFF,1,2,2,3
TRBV7-2,TRBJ2-1,CASSLGGDNGQFF,1,0,1,1
TRBV7-9,TRBJ2-7,CASSLDRSYEQYF,1,0,1,1
TRBV7-2,TRBJ2-1,CASSLRVLNEQFF,1,0,1,1
TRBV7-9,TRBJ1-1,CASSSQDNTEAFF,1,0,1,1
TRBV5-5,TRBJ2-3,CASSSGHTDTQYF,1,0,1,1
TRBV7-9,TRBJ1-1,CASSSDGNTEAFF,1,0,1,1
TRBV11-2,TRBJ2-1,CASSSGGEDEQFF,1,0,1,1
TRBV7-6,TRBJ2-5,CASSWGAGETQYF,1,0,1,1
TRBV5-8,TRBJ1-4,CASSWGSREKLFF,1,0,1,1
TRBV7-9,TRBJ2-1,CASSWGGTDEQFF,1,0,1,1
TRBV11-2,TRBJ2-1,CASSPGLYNEQLF,1,0,1,1
TRBV7-9,TRBJ2-7,CASSPTGSYEQYF,1,0,1,1
TRBV11-2,TRBJ2-5,CASSPDREETQYF,1,0,1,1
TRBV12-3/4,TRBJ2-7,CASSRIGGHEQYF,1,0,1,1
TRBV11-1,TRBJ2-7,CASSRDRGSEQYF,1,0,1,1
TRBV7-9,TRBJ1-1,CASSRTGVTEAFF,1,0,1,1
TRBV14,TRBJ2-1,CASSQLLAYEQFF,1,0,1,1
TRBV4-2,TRBJ2-5,CASSQDPGGTQYF,2,0,1,2
TRBV4-2,TRBJ1-2,CASSQDMARDYTF,1,0,1,1
TRBV9,TRBJ2-2,CASSVISTGELFF,2,0,1,2
TRBV6-2/3/5/6,TRBJ2-5,CASSSRGWGTQYF,1,0,1,1
TRBV12-3/4,TRBJ1-1,CASRLGIFTEAFF,1,0,1,1
TRBV12-3/4,TRBJ1-1,CASRAAQGGEAFF,1,0,1,1
TRBV2,TRBJ2-2,CASRAGATGELFF,1,0,1,1
TRBV28,TRBJ2-1,CASRLLAGNEQFF,1,0,1,1
TRBV6-1,TRBJ2-3,CASREGGTDTQYF,1,0,1,1
TRBV6-2/3/5/6,TRBJ1-1,CASKGTGSAEAFF,1,0,1,1
TRBV28,TRBJ2-5,CASKSGRPETQYF,1,0,1,1
TRBV14,TRBJ1-2,CASSQGGPGGYTF,1,0,1,1
TRBV19,TRBJ2-5,CAEDRGPQETQYF,1,0,1,1
TRBV5-1,TRBJ2-6,CASSLDTVNVLTF,1,0,1,1
TRBV10-2,TRBJ1-2,CASSESTREGYTF,1,0,1,1
TRBV5-1,TRBJ1-4,CASSIGTGEKLFF,1,0,1,1
TRBV5-1,TRBJ2-1,CASSLEPGFEQFF,1,0,1,1
TRBV5-1,TRBJ2-4,CASSPEPSGIQYF,1,0,1,1
TRBV4-3,TRBJ2-1,CASSQGGTGPISF,1,0,1,1
TRBV4-3,TRBJ2-7,CASSQESRAEQYF,1,0,1,1
TRBV20-1,TRBJ1-1,CSVTRGVDTEAFF,1,0,1,1
TRBV20-1,TRBJ2-5,CSATDWEVETQYF,1,0,1,1
TRBV20-1,TRBJ1-5,CSARPGGKQPQHF,1,0,1,1
TRBV29-1,TRBJ2-1,CSPYRTGENEQFF,1,0,1,1
TRBV29-1,TRBJ2-6,CSVRDSGANVLTF,1,0,1,1
TRBV29-1,TRBJ1-5,CSVAQGRDQPQHF,1,0,1,1
TRBV29-1,TRBJ2-1,CSVAGGRGGEQFF,1,0,1,1
TRBV29-1,TRBJ2-6,CSVGGTGANVLTF,1,0,1,1
TRBV29-1,TRBJ2-1,CSVGGTEYNEQFF,1,0,1,1
TRBV29-1,TRBJ1-1,CSVEEGADTEAFF,1,0,1,1
TRBV29-1,TRBJ1-5,CSVELRPDQPQHF,2,0,1,2
TRBV29-1,TRBJ2-1,CSVRPISNNEQFF,1,0,1,1
TRBV29-1,TRBJ1-2,CSVRQGGYYGYTF,1,0,1,1
TRBV29-1,TRBJ2-2,CSVQDRGLGELFF,1,0,1,1
TRBV29-1,TRBJ1-3,CSALGLRRNTIYF,1,0,1,1
TRBV29-1,TRBJ2-3,CSALREGPDTQYF,1,0,1,1
TRBV30,TRBJ1-1,CAWSPGGVEAFF,1,0,1,1
TRBV30,TRBJ1-1,CAWSGGHTEAFF,1,0,1,1
TRBV30,TRBJ1-2,CARVAGRYGYTF,1,0,1,1
TRBV7-2,TRBJ2-6,CAGTSGASVLTF,1,0,1,1
TRBV10-3,TRBJ1-2,CAISGDRRGYTF,1,0,1,1
TRBV15,TRBJ1-2,CATSRDQQASLF,1,0,1,1
TRBV24-1,TRBJ2-1,CATNDRYNEQFF,1,0,1,1
TRBV19,TRBJ1-6,CASSTTGRSLHF,1,0,1,1
TRBV19,TRBJ1-1,CASSKLNTEAFF,1,0,1,1
TRBV18,TRBJ2-5,CASSPPGETQYF,1,0,1,1
TRBV2,TRBJ1-2,CASIQGWGGYTF,1,0,1,1
TRBV12-3/4,TRBJ1-1,CASTLPATEAFF,1,0,1,1
TRBV2,TRBJ1-2,CASTLGTGKEAF,1,0,1,1
TRBV6-2/3/5/6,TRBJ1-1,CASSLLAAEAFL,1,0,1,1
TRBV12-3/4,TRBJ2-1,CASSSPPLEQFF,1,0,1,1
TRBV6-2/3/5/6,TRBJ2-1,CASSSQGDEQFF,1,0,1,1
TRBV6-2/3/5/6,TRBJ2-1,CASSYEGYEQFF,1,0,1,1
TRBV7-2,TRBJ1-1,CASSLFWTEAFF,1,0,1,1
TRBV5-6,TRBJ2-3,CASSSSTDTQYF,1,0,1,1
TRBV5-4,TRBJ1-1,CASSLGRTEAFF,1,0,1,1
TRBV6-2/3/5/6,TRBJ1-1,CASSPGNTEAFF,1,0,1,1
TRBV3-1,TRBJ1-2,CASSQGLYGYTF,1,0,1,1
TRBV11-3,TRBJ2-3,CASREGRDTQYL,1,0,1,1
TRBV30,TRBJ2-6,CARQVGANVLTF,1,0,1,1
TRBV5-1,TRBJ1-2,CASSFGRDGYTF,1,0,1,1
TRBV5-1,TRBJ2-7,CASSVGSYEQYF,2,0,1,2
TRBV20-1,TRBJ1-1,CSSGGRNTEAFF,1,0,1,1
TRBV20-1,TRBJ2-7,CSASNRVNEQYF,1,0,1,1
TRBV20-1,TRBJ2-1,CSARDSADEQFF,1,0,1,1
TRBV20-1,TRBJ1-1,CSGRTGYTEAFF,1,0,1,1
TRBV29-1,TRBJ2-5,CSVQRGGETQYF,1,0,1,1
TRBV29-1,TRBJ1-2,CSVAQEYYGYTF,1,0,1,1
TRBV29-1,TRBJ2-7,CSVGDGSYEQYF,1,0,1,1
TRBV29-1,TRBJ2-7,CSVGTVFYEQYF,1,0,1,1
TRBV10-3,TRBJ2-3,CAINAADTQYF,1,0,1,1
TRBV28,TRBJ2-5,CASSLGGTQYF,1,0,1,1
TRBV3-1,TRBJ2-3,CASSLENTQYF,1,0,1,1
TRBV5-6,TRBJ2-1,CASSLGREQFF,1,0,1,1
TRBV7-9,TRBJ2-7,CASSKGYKQYF,1,0,1,1
TRBV4-3,TRBJ1-4,CASRDSEKLFF,1,0,1,1
TRBV29-1,TRBJ1-2,CSVQGAGGYTF,1,0,1,1
TRBV29-1,TRBJ2-7,CSVPGDYEQYF,1,0,1,1
TRBV4-3,TRBJ2-7,CASSQYEQYF,1,0,1,1
TRBV29-1,TRBJ1-2,CGTTNYGYTF,2,0,1,2
TRBV20-1,TRBJ2-7,CSAASYEQYF,1,0,1,1
TRBV20-1,TRBJ2-7,CSARRDEQYF,1,0,1,1
TRBV29-1,TRBJ1-1,CSVGNTEAFF,1,0,1,1
TRBV29-1,TRBJ1-1,CSGENTEAFF,1,0,1,1
TRBV28,TRBJ1-1,CASSSNLLINAEAFF,1,0,1,1
TRBV20-1,TRBJ1-1,CSAFPDLTGNTDAFF,1,0,1,1
TRBV6-2/3/5/6,TRBJ2-7,CASTALGASYEQYF,1,0,1,1
TRBV20-1,TRBJ1-1,CSAEGQSDSTEAFF,2,0,1,2
TRBV12-3/4,TRBJ2-7,CASGQRYPYELYF,1,0,1,1
TRBV7-2,TRBJ2-4,CASSRSLNDIQYF,1,0,1,1
TRBV7-9,TRBJ2-2,CASTGETGELFF,1,0,1,1
TRBV3-1,TRBJ2-4,CASSNLGGLYF,1,0,1,1
TRBV25-1,TRBJ2-6,CASSEYRTGYIDGPGANVLTF,1,0,1,1
TRBV14,TRBJ2-1,CASSRRTPSGKGGFLYEQFF,1,0,1,1
TRBV30,TRBJ2-7,CAWSVQRANRDRSSYEQYF,1,0,1,1
TRBV30,TRBJ2-5,CAGFARDRGRRVAKETQYF,1,0,1,1
TRBV7-6,TRBJ2-3,CASSLAPAGAKSSTDTQYF,1,0,1,1
TRBV4-2,TRBJ1-1,CASSQDPDPRVFAGPEAFF,1,0,1,1
TRBV3-1,TRBJ2-4,CASSQDTIGTSGFENIQYF,1,0,1,1
TRBV4-3,TRBJ2-6,CASSQKPGQGMFGANVLTF,1,0,1,1
TRBV15,TRBJ2-6,CATSRDDRGLPGANVLTF,1,0,1,1
TRBV19,TRBJ2-1,CASSDPRGTSGSYNEQFF,1,0,1,1
TRBV12-3/4,TRBJ1-5,CASSLGRTGRGPNQPQHF,1,0,1,1
TRBV4-2,TRBJ2-3,CASSHRTNYGGDADTQYF,1,0,1,1
TRBV2,TRBJ2-7,CASSVALRLAGGAYEQYF,1,0,1,1
TRBV7-7,TRBJ2-2,CASSSERVGGGFTGELFF,1,0,1,1
TRBV7-2,TRBJ2-7,CASSLRDSQNRGSYEQYF,1,0,1,1
TRBV5-4,TRBJ2-6,CASSPRGAGNSGANVLTF,1,0,1,1
TRBV7-2,TRBJ1-6,CASSRKGQSQAFNSPLHF,1,0,1,1
TRBV9,TRBJ2-1,CASSVETDYLSSYNEQFF,1,0,1,1
TRBV7-9,TRBJ2-3,CASRPQGLRGFGTDTQYF,1,0,1,1
TRBV18,TRBJ2-3,CASSPPNRGLSTDTQYF,1,0,1,1
TRBV18,TRBJ2-7,CASSPRVWRGASYEQYF,1,0,1,1
TRBV12-3/4,TRBJ2-3,CASSFGSWLAATDTQYF,1,0,1,1
TRBV28,TRBJ2-1,CASSFGQSPYPYNEQFF,1,0,1,1
TRBV6-2/3/5/6,TRBJ2-1,CASSYLTGSWQNNEQLF,1,0,1,1
TRBV12-3/4,TRBJ2-1,CASSPVGLAGGINEQFF,1,0,1,1
TRBV7-3,TRBJ2-2,CASSFASGREDTGELFF,1,0,1,1
TRBV5-6,TRBJ1-1,CASSLSEEGAKNTEAFF,1,0,1,1
TRBV7-9,TRBJ1-1,CASSLRGDRGLGTEAFF,1,0,1,1
TRBV11-3,TRBJ2-7,CASSLFGGARASYEQYF,1,0,1,1
TRBV11-1,TRBJ1-2,CASSLGQGALAKKSYTF,1,0,1,1
TRBV7-9,TRBJ2-7,CASSLGGTSGSVDEQYF,1,0,1,1
TRBV11-2,TRBJ1-3,CASSLRFQGSSGNTIYF,1,0,1,1
TRBV7-9,TRBJ2-3,CASSSPLLAQLRDTQYF,1,0,1,1
TRBV4-2,TRBJ2-1,CASSLDGLAGGPNEQFF,1,0,1,1
TRBV7-3,TRBJ2-1,CASSPRTGPGSYNEQFF,1,0,1,1
TRBV7-2,TRBJ2-4,CASSRGTSSLAKNIQYF,1,0,1,1
TRBV3-1,TRBJ2-1,CASSQASRGTTDDEQFF,1,0,1,1
TRBV3-1,TRBJ2-3,CASSQGTSRQSTDTQYF,1,0,1,1
TRBV3-1,TRBJ1-3,CASSQGGTALSGNTIYF,1,0,1,1
TRBV4-2,TRBJ2-2,CASSQETSGRAAGELFS,1,0,1,1
TRBV14,TRBJ1-1,CASSTAGQGVVSTEAFF,1,0,1,1
TRBV2,TRBJ2-1,CASRPIPGLAVYNEQFF,1,0,1,1
TRBV3-1,TRBJ2-1,CASRQVYDSGSHNEQFF,1,0,1,1
TRBV6-2/3/5/6,TRBJ2-1,CASNPGLAGVHSNEQFF,1,0,1,1
TRBV7-9,TRBJ2-6,CANSPRQRNSGANVLTF,1,0,1,1
TRBV5-1,TRBJ2-1,CASSLVGGGNSYNEQFF,1,0,1,1
TRBV5-1,TRBJ1-5,CASSLAPTGSLDQPQHF,1,0,1,1
TRBV4-1,TRBJ2-2,CASSPFSTGGNTGELFF,1,0,1,1
TRBV4-3,TRBJ1-1,CASSQAIGTGANTEAFF,1,0,1,1
TRBV20-1,TRBJ1-4,CSARERSGCIENEKLFF,1,0,1,1
TRBV20-1,TRBJ2-6,YSALRDRGYTGANVLTF,1,0,1,1
TRBV20-1,TRBJ2-1,RSAVTSGGPLSYNEQFF,1,0,1,1
TRBV12-5,TRBJ2-4,CASGLVLGVGKNIQYF,1,0,1,1
TRBV14,TRBJ2-2,CAGSPKLGVNTGEPFF,1,0,1,1
TRBV24-1,TRBJ2-5,CATSDFGLAEEETQYF,1,0,1,1
TRBV24-1,TRBJ2-7,CATSDDGTSGEFEQYF,1,0,1,1
TRBV18,TRBJ2-1,CASSPIAGVRANEQFF,1,0,1,1
TRBV6-2/3/5/6,TRBJ1-6,CASSLDNSVPNSPLHF,1,0,1,1
TRBV6-2/3/5/6,TRBJ2-7,CASSSSGTGSSYEQYF,1,0,1,1
TRBV6-2/3/5/6,TRBJ2-3,CASSSGTSRIGDTQYF,1,0,1,1
TRBV6-2/3/5/6,TRBJ2-4,CASSYVGPMTKNIQYF,1,0,1,1
TRBV27,TRBJ1-5,CASSPFGQGIGQPQHF,1,0,1,1
TRBV6-2/3/5/6,TRBJ2-7,CASSPPVIRATYEQYF,1,0,1,1
TRBV25-1,TRBJ1-1,CASSAGTGQFDTEAFF,1,0,1,1
TRBV25-1,TRBJ2-3,CASSDRGKTGTDTQYF,1,0,1,1
TRBV6-2/3/5/6,TRBJ2-5,CASSTPYGQGKETQYF,1,0,1,1
TRBV5-6,TRBJ2-7,CASSFSRTTRGYEQYF,1,0,1,1
TRBV5-4,TRBJ2-2,CASSFEAGGSTGELFF,1,0,1,1
TRBV7-2,TRBJ2-1,CASSLGRAGENNEQFF,1,0,1,1
TRBV5-5,TRBJ2-7,CASSLELRTGAYEQYF,1,0,1,1
TRBV7-9,TRBJ2-7,CASSLRSGGASYEQYF,1,0,1,1
TRBV7-8,TRBJ2-5,CASSLVRLALQETQYF,1,0,1,1
TRBV7-2,TRBJ2-5,CASSLGTAPEQETQYF,1,0,1,1
TRBV7-3,TRBJ2-3,CASSLTGGADTDTQYF,1,1,2,2
TRBV5-4,TRBJ2-1,CASSSGLPHGGNEQFF,1,0,1,1
TRBV5-6,TRBJ2-1,CASSSSGTSGYNEQFF,1,0,1,1
TRBV7-9,TRBJ1-4,CASSSNQGAPNEKLFL,1,0,1,1
TRBV7-2,TRBJ2-5,CASSSSLAGGQETQYF,1,0,1,1
TRBV7-2,TRBJ1-6,CASSWGTGEEGSPLHF,1,0,1,1
TRBV2,TRBJ2-4,CASSWGPTVAKNIQYF,1,0,1,1
TRBV7-9,TRBJ2-1,CASSYGNREIYNEQFF,1,0,1,1
TRBV13,TRBJ2-7,CASSLSRDVPPYEQYF,1,0,1,1
TRBV4-2,TRBJ1-1,CASSLKFRQGNTEAFF,1,0,1,1
TRBV5-6,TRBJ1-2,CASSPEYRTGRYGYTF,1,0,1,1
TRBV9,TRBJ1-2,CASSPRQGQGGYGYTF,1,0,1,1
TRBV11-2,TRBJ2-1,CASSPRSDRTYNEQFF,1,0,1,1
TRBV6-2/3/5/6,TRBJ1-5,CASSPMRAYSNQPQHF,1,0,1,1
TRBV7-2,TRBJ1-2,CASSPQPGQGIEGYTF,1,0,1,1
TRBV11-3,TRBJ2-1,CASSPAGYSSYNEQFF,1,0,1,1
TRBV3-1,TRBJ2-1,CASSQLSGAIHNEQFF,1,0,1,1
TRBV7-3,TRBJ2-7,CASSQPLGQDSYEQYF,1,0,1,1
TRBV6-2/3/5/6,TRBJ2-1,CASSQVLGLVLNEQFF,1,0,1,1
TRBV4-2,TRBJ2-3,CASSQDIAAGADTQYF,1,0,1,1
TRBV4-2,TRBJ2-7,CASSQDLTSGSSEQYF,1,0,1,1
TRBV7-6,TRBJ1-1,CASSTKTREENTEAFF,1,0,1,1
TRBV7-2,TRBJ2-7,CASSTYGLQALGEQYF,1,0,1,1
TRBV7-9,TRBJ1-4,CASSTRQATTNEKLFF,1,0,1,1
TRBV28,TRBJ2-7,CASNSAVTATSYEQYF,1,0,1,1
TRBV7-9,TRBJ2-2,CASKRTGGLNTGELFF,1,0,1,1
TRBV6-4,TRBJ2-4,CANTVQGDRAKNIQYF,1,0,1,1
TRBV3-1,TRBJ2-6,CGSSQVVMAGANVLTF,1,0,1,1
TRBV5-1,TRBJ2-4,CASSSGQGIAKNIQYF,1,0,1,1
TRBV5-1,TRBJ2-2,CASSLVGTRRAGELFF,1,0,1,1
TRBV5-1,TRBJ2-1,CASSLTSGYAVNEQFF,1,0,1,1
TRBV4-1,TRBJ1-4,CASSSGVGQDNEKLSF,1,0,1,1
TRBV5-1,TRBJ2-1,CASSLVGGGPSGEQFF,1,0,1,1
TRBV5-1,TRBJ2-3,CASSPVGTGDTDTQYF,1,0,1,1
TRBV5-1,TRBJ1-5,CASSPGPWKSNQPQHF,1,0,1,1
TRBV5-1,TRBJ2-2,CASSPDRGLDTGELFF,1,0,1,1
TRBV4-1,TRBJ1-1,CASSPPDRALNTEAFF,1,0,1,1
TRBV4-1,TRBJ2-3,CASSHGSGGAIDTQYF,1,0,1,1
TRBV4-1,TRBJ1-2,CASSHLERGQAGGYTF,1,0,1,1
TRBV5-1,TRBJ2-7,CASSQSPGQGAYEQYF,1,0,1,1
TRBV4-1,TRBJ2-6,CASSQAEEPGANVLTF,1,0,1,1
TRBV4-3,TRBJ2-7,CASSQDYELAVYEQYF,1,0,1,1
TRBV4-3,TRBJ1-2,CASSQDHGREGYGYTF,1,0,1,1
TRBV4-3,TRBJ2-2,CASSQDRDYYTGELFF,1,0,1,1
TRBV5-1,TRBJ2-2,CASSAGQGQNTGELFF,1,0,1,1
TRBV20-1,TRBJ2-1,CSAPAMDRGDHNEQFF,1,0,1,1
TRBV20-1,TRBJ1-6,CSASSDGGAVNSPLHF,1,1,2,2
TRBV29-1,TRBJ2-3,CSVEPRTSGGTDTQYF,1,0,1,1
TRBV29-1,TRBJ2-1,CSVEGMSTLSNNEQFF,1,0,1,1
TRBV29-1,TRBJ2-3,CSVEKRRLATTDTQYF,1,0,1,1
TRBV29-1,TRBJ1-6,CSAALRDNPRNSPLHF,1,0,1,1
TRBV12-5,TRBJ2-1,CASGPELSSYNEQFF,1,0,1,1
TRBV30,TRBJ1-1,CAWSVMGEANTEAFF,1,0,1,1
TRBV12-3/4,TRBJ2-1,CAGSFGTSGYNEQFF,1,0,1,1
TRBV10-3,TRBJ2-7,CAIIKAGQGSYEQYF,1,0,1,1
TRBV10-3,TRBJ2-3,CAISGEDPSTDTQYF,1,0,1,1
TRBV5-4,TRBJ2-1,CATRVGANPYNEQFF,1,0,1,1
TRBV24-1,TRBJ2-3,CATSDLADSTDTQYF,1,0,1,1
TRBV24-1,TRBJ2-4,CATSEGTGKKNIQYF,1,0,1,1
TRBV15,TRBJ2-7,CATSRGQGLIYEQYF,1,0,1,1
TRBV19,TRBJ2-7,CASSVLTGGAYEQYF,1,0,1,1
TRBV19,TRBJ2-3,CASRSSSGGTDTQYF,1,0,1,1
TRBV19,TRBJ2-3,CASSPHQTSTDTQYF,1,0,1,1
TRBV18,TRBJ1-1,CASSPQGAPNTEAFF,1,0,1,1
TRBV18,TRBJ1-1,CASSPPMRANTEAFF,1,0,1,1
TRBV18,TRBJ1-5,CASSDQGASNQPQHF,1,0,1,1
TRBV18,TRBJ2-7,CASSNGGIGTYEQYF,1,0,1,1
TRBV28,TRBJ2-7,CASGDPANTAYEQYF,1,0,1,1
TRBV12-3/4,TRBJ2-2,CASMGGGLGPWELFF,1,0,1,1
TRBV28,TRBJ1-5,CASIWGAEGNQPQHF,1,0,1,1
TRBV6-2/3/5/6,TRBJ2-2,CASSFRQGGTGELFF,1,0,1,1
TRBV7-2,TRBJ1-1,CASSFLPQGGTEAFF,1,0,1,1
TRBV28,TRBJ2-7,CASSFPGTGIYEQYF,1,0,1,1
TRBV6-2/3/5/6,TRBJ1-1,CASSFEGLRGTEAFF,1,0,1,1
TRBV27,TRBJ1-6,CASSLGTVYNSPLHF,1,0,1,1
TRBV6-2/3/5/6,TRBJ2-7,CASSLGQGAGNEQYF,1,0,1,1
TRBV6-1,TRBJ1-5,CASSSSGGGGQPQHF,1,0,1,1
TRBV6-2/3/5/6,TRBJ2-7,CASSSPRSGGLEQYF,1,0,1,1
TRBV6-2/3/5/6,TRBJ1-1,CASSYSFEVNTEAFF,1,0,1,1
TRBV12-3/4,TRBJ1-5,CASSPRGIGNQPQHF,1,0,1,1
TRBV6-4,TRBJ2-1,CASSARQGFYNEQFF,1,0,1,1
TRBV2,TRBJ1-5,CASSELGGRNQPQHF,1,0,1,1
TRBV2,TRBJ2-2,CASSEIPSGAGELFF,1,0,1,1
TRBV6-2/3/5/6,TRBJ2-5,CASSTTGTLRETQYF,1,0,1,1
TRBV5-6,TRBJ2-7,CASSFYSGTTYEQYF,1,0,1,1
TRBV5-6,TRBJ1-2,CASSFRTKGDYGYTF,1,0,1,1
TRBV11-2,TRBJ2-2,CASSFRTGRTGELFF,1,0,1,1
TRBV7-9,TRBJ1-6,CASSLAGARGSPLHF,1,0,1,1
TRBV5-6,TRBJ1-1,CASSLGQGWNTEAFF,1,0,1,1
TRBV7-2,TRBJ2-7,CASSLRQGGSYEQYF,1,0,1,1
TRBV7-9,TRBJ2-5,CASSLLAGAGETQYF,1,0,1,1
TRBV13,TRBJ2-1,CASSLRGGGDNEQFF,1,0,1,1
TRBV7-9,TRBJ2-1,CASSLAGYQGNEQFF,1,0,1,1
TRBV7-2,TRBJ2-1,CASSLAGGHYNEQFF,1,0,1,1
TRBV7-6,TRBJ2-1,CASSLGQGSYNEQFF,1,0,1,1
TRBV7-9,TRBJ1-2,CASSLDRGTNYGYTF,1,0,1,1
TRBV5-4,TRBJ2-5,CASSLTAQEKETQYF,1,0,1,1
TRBV7-2,TRBJ1-5,CASSLTGNSNQPQHF,1,0,1,1
TRBV11-2,TRBJ1-1,CASSLRQIGQAEAFF,1,0,1,1
TRBV11-3,TRBJ2-1,CASSSRGAGANEQFS,1,0,1,1
TRBV7-3,TRBJ2-5,CASSSTGAGGETQYF,1,0,1,1
TRBV11-3,TRBJ2-3,CASSWWTESTDTQYF,1,0,1,1
TRBV7-9,TRBJ2-3,CASSLDGGFTDTQYF,1,0,1,1
TRBV7-9,TRBJ2-7,CASSPTETARPEQYF,1,0,1,1
TRBV4-2,TRBJ2-7,CASSPGLASAYEQYF,1,0,1,1
TRBV7-2,TRBJ2-2,CASSPRTGGTGELFF,1,0,1,1
TRBV5-4,TRBJ1-5,CASSPDRGVNQPQHF,1,0,1,1
TRBV6-2/3/5/6,TRBJ2-3,CASSPAGQFTDTQYF,1,0,1,1
TRBV14,TRBJ2-2,CASSHGDSGPGELFF,1,0,1,1
TRBV3-1,TRBJ2-7,CASSQDSSGTGEQYF,1,0,1,1
TRBV14,TRBJ2-1,CASSQDGRFTSGEFF,1,0,1,1
TRBV9,TRBJ2-7,CASSQKGGIPYEQYF,1,0,1,1
TRBV6-2/3/5/6,TRBJ2-6,CASSQQHSGANVLTF,1,0,1,1
TRBV4-2,TRBJ2-1,CASSQAPRAYNEQFF,1,0,1,1
TRBV3-1,TRBJ2-5,CASSQATRPRETQYF,1,0,1,1
TRBV4-2,TRBJ2-7,CASSQDHAETYEQYF,1,0,1,1
TRBV3-1,TRBJ1-6,CASSQEGQRNSPLHF,1,0,1,1
TRBV4-2,TRBJ2-3,CASSQEGDLADTQYF,1,0,1,1
TRBV9,TRBJ2-1,CASSVSDDSYNEQFF,1,0,1,1
TRBV9,TRBJ2-7,CASSVGRQPTYEQYF,1,0,1,1
TRBV5-4,TRBJ2-7,CASSVVGGARREQYF,1,0,1,1
TRBV9,TRBJ1-1,CASSVAAGGAAEAFF,1,0,1,1
TRBV9,TRBJ1-6,CASSVGDDDNSPLHF,1,0,1,1
TRBV9,TRBJ2-5,CASSVDAGPQETQYY,1,0,1,1
TRBV7-9,TRBJ2-5,CASSGTSGGQETQYF,1,0,1,1
TRBV12-3/4,TRBJ1-2,CASSETGTSNYGYTF,1,0,1,1
TRBV7-2,TRBJ1-2,CASSTRVVRGHGYTF,1,0,1,1
TRBV7-8,TRBJ1-4,CASSRTGVGNEKQFF,1,0,1,1
TRBV7-9,TRBJ2-1,CASRFRGGSYNEQFF,1,0,1,1
TRBV12-3/4,TRBJ2-6,CASRGQGSGANVLTF,1,0,1,1
TRBV7-2,TRBJ2-2,CASNLTGPNTGELFF,1,0,1,1
TRBV6-2/3/5/6,TRBJ1-2,CASNLQTDLGYGYTF,1,0,1,1
TRBV5-4,TRBJ2-7,CASNQGLAGAGEQYF,1,0,1,1
TRBV5-1,TRBJ2-1,CASGLGGALYNEQFF,1,0,1,1
TRBV5-1,TRBJ2-3,CASSFQPTSTDTQYF,1,0,1,1
TRBV5-1,TRBJ2-7,CASSLAGTDAYEQYF,1,0,1,1
TRBV5-1,TRBJ2-1,CASSLIETGGGEQFF,1,0,1,1
TRBV5-1,TRBJ2-1,CASSLNGNNYNEQFF,1,0,1,1
TRBV5-1,TRBJ2-1,CASSLGTSGGPRQFF,1,0,1,1
TRBV5-1,TRBJ1-6,CASSSWTEYNSPLHF,1,0,1,1
TRBV4-3,TRBJ1-3,CASSLARGLGNTIYF,1,0,1,1
TRBV5-1,TRBJ1-1,CASSLDYRESTEAFF,1,0,1,1
TRBV5-1,TRBJ2-7,CASSLEGLALYEQYF,1,0,1,1
TRBV5-1,TRBJ2-1,CASSPPRGGAYEQFF,1,0,1,1
TRBV4-1,TRBJ1-4,CASSPRGPTNEKLFF,1,0,1,1
TRBV4-3,TRBJ2-7,CASSPGLAAPYEQYF,1,0,1,1
TRBV5-1,TRBJ2-3,CASSPDKRAVDTQYF,1,0,1,1
TRBV5-1,TRBJ2-3,CASSPTSGGTDTQYF,1,1,2,2
TRBV4-1,TRBJ1-4,CASSQSEDSNEKLFF,1,1,2,2
TRBV4-3,TRBJ2-5,CASSQAAQGRETQYF,1,1,2,2
TRBV4-1,TRBJ1-2,CASSQDRRGNYGYTF,1,0,1,1
TRBV4-3,TRBJ1-1,CASSQDKVSNTEAFF,1,0,1,1
TRBV4-3,TRBJ2-1,CASSQEASPYNEQFF,1,0,1,1
TRBV5-1,TRBJ2-7,CASSVGQGLTYEQYF,1,0,1,1
TRBV5-1,TRBJ2-1,CASSALARTVAEQFF,1,0,1,1
TRBV5-1,TRBJ1-1,CASSKAGNMNTGAFF,1,0,1,1
TRBV2,TRBJ2-7,CASKREGGTSYEQYF,1,0,1,1
TRBV20-1,TRBJ2-3,CSAPHERGLTDTQYF,1,0,1,1
TRBV20-1,TRBJ2-1,CSARDRGTSYNEQFF,1,0,1,1
TRBV20-1,TRBJ2-7,CSARDQGKSSYEQYF,1,0,1,1
TRBV20-1,TRBJ1-1,CSARDTKSGPREAFF,1,0,1,1
TRBV20-1,TRBJ1-6,CSARDKLTGPDALHF,1,0,1,1
TRBV20-1,TRBJ2-1,CSADVGQVTYNEQFF,1,0,1,1
TRBV29-1,TRBJ2-1,CSVDKVAAAYNEQFF,1,0,1,1
TRBV29-1,TRBJ1-2,CSGASQVMDRGGYTF,1,0,1,1
TRBV7-3,TRBJ2-3,CSSSLESYTDTQYF,1,0,1,1
TRBV12-5,TRBJ1-1,CASGTGSHNTEAFF,1,0,1,1
TRBV30,TRBJ2-1,CAWSISGGREKQFF,1,0,1,1
TRBV10-3,TRBJ1-2,CAISEPTANYGYTF,1,0,1,1
TRBV10-3,TRBJ1-4,CAISEVGGHEKLFF,1,1,2,2
TRBV10-3,TRBJ2-7,CAIRMDRGRDEQYF,1,0,1,1
TRBV6-2/3/5/6,TRBJ2-2,CATTEGVRTGELFF,1,0,1,1
TRBV24-1,TRBJ1-2,CATSDFQMSYGYTF,1,0,1,1
TRBV24-1,TRBJ1-1,CATSDPGRDTEAFF,1,0,1,1
TRBV12-3/4,TRBJ1-5,CASQDREGNQPQHF,1,0,1,1
TRBV19,TRBJ1-1,CASSILQGNTEAFF,1,0,1,1
TRBV19,TRBJ2-1,CASSIEQGADEQFF,1,0,1,1
TRBV19,TRBJ2-5,CASSPPGGRETRYF,1,0,1,1
TRBV19,TRBJ1-3,CASRKEGTGNTIYF,1,0,1,1
TRBV18,TRBJ2-5,CASSPPGQGETQYF,1,0,1,1
TRBV6-2/3/5/6,TRBJ2-5,CASSPAGSRETQYF,1,0,1,1
TRBV18,TRBJ1-1,CASSPGQGEAEAFF,1,0,1,1
TRBV18,TRBJ1-1,CASSPTQENTEAFF,1,0,1,1
TRBV2,TRBJ1-6,CASRQGGTGSPLHF,1,0,1,1
TRBV9,TRBJ1-2,CASGNRGTDYGYTF,1,0,1,1
TRBV6-2/3/5/6,TRBJ1-4,CASILWATNEKLFF,1,0,1,1
TRBV7-2,TRBJ1-2,CASIPRTGSYGYTF,1,0,1,1
TRBV28,TRBJ2-2,CASMPGQPTGELFF,1,0,1,1
TRBV6-2/3/5/6,TRBJ2-3,CASIWPDGTDTQYF,1,0,1,1
TRBV6-2/3/5/6,TRBJ2-1,CASTSLKSYNEQFF,1,0,1,1
TRBV28,TRBJ2-5,CASSLLAGEETQYF,1,0,1,1
TRBV12-3/4,TRBJ2-1,CASSLGNSYNEQFF,1,2,2,3
TRBV3-1,TRBJ2-7,CASSLWTGSYEQYF,1,0,1,1
TRBV6-2/3/5/6,TRBJ2-7,CASSLRSGGGEQYF,1,0,1,1
TRBV12-3/4,TRBJ1-1,CASSLRPGNTEAFF,1,0,1,1
TRBV6-2/3/5/6,TRBJ1-6,CASSYRQDNSPLHF,1,0,1,1
TRBV11-2,TRBJ2-1,CASSYLAGGYEQFF,1,0,1,1
TRBV6-2/3/5/6,TRBJ2-7,CASSYREESYEQYF,1,0,1,1
TRBV7-6,TRBJ2-7,CASSLQAGPTEQYF,1,0,1,1
TRBV7-4,TRBJ2-7,CASSPLGNSYEQYF,1,0,1,1
TRBV6-1,TRBJ2-3,CASSAGRKSDTQYF,1,0,1,1
TRBV2,TRBJ2-7,CASSETGGPYEQYF,1,3,2,4
TRBV2,TRBJ2-7,CASSESPESYEQYF,1,0,1,1
TRBV2,TRBJ1-1,CASSEPQGNTEAFF,1,0,1,1
TRBV2,TRBJ1-1,CASSEDPEGAEAYF,1,0,1,1
TRBV7-2,TRBJ2-7,CASSFFSQALEQYF,1,0,1,1
TRBV5-5,TRBJ2-2,CASSFLYLGGELFF,1,0,1,1
TRBV7-9,TRBJ1-1,CASSFGQVNTEAFF,1,0,1,1
TRBV7-3,TRBJ2-1,CASSFSGGANEQFF,1,0,1,1
TRBV5-6,TRBJ2-7,CASSLWTASYEQYF,1,0,1,1
TRBV5-4,TRBJ2-7,CASSLVGGEREQYF,1,0,1,1
TRBV5-4,TRBJ1-1,CASSLAGRNTEAFF,1,0,1,1
TRBV5-4,TRBJ1-1,CASSLGDRANEAFF,1,0,1,1
TRBV11-2,TRBJ1-5,CASSLDGHNQPQHF,1,0,1,1
TRBV7-9,TRBJ2-7,CASSLTVLSYEQYF,1,0,1,1
TRBV7-2,TRBJ1-6,CASSLRQGSSPLHF,1,0,1,1
TRBV7-2,TRBJ1-2,CASSLSAGDYGYTF,1,0,1,1
TRBV7-2,TRBJ2-5,CASSLPGSAETQYF,1,0,1,1
TRBV7-2,TRBJ1-1,CASSLRTANTEAFF,1,0,1,1
TRBV11-2,TRBJ1-4,CASSLVYINEKLFF,1,0,1,1
TRBV7-9,TRBJ2-7,CASSLGAPGFQQYF,1,0,1,1
TRBV7-9,TRBJ1-1,CASSLGTVNTEAFF,1,0,1,1
TRBV7-2,TRBJ2-7,CASSLDGERGERYF,1,0,1,1
TRBV11-1,TRBJ2-7,CASSLERAGHEQYF,1,0,1,1
TRBV11-2,TRBJ2-6,CASSLERGANVLTF,1,0,1,1
TRBV7-6,TRBJ2-7,CASSSRTGDYEQYF,1,0,1,1
TRBV11-2,TRBJ1-2,CASSLSRGHDGYTF,1,0,1,1
TRBV7-2,TRBJ1-2,CASSLYDRSYGYTF,1,0,1,1
TRBV12-3/4,TRBJ1-1,CASSLQLFNTEAFF,1,0,1,1
TRBV7-9,TRBJ1-1,CASSLQGENTEAFF,1,1,2,2
TRBV3-1,TRBJ2-7,CASSPQAGGYEQYF,1,0,1,1
TRBV3-1,TRBJ2-1,CASSPSASSNEQFF,1,0,1,1
TRBV7-9,TRBJ2-5,CASSPYRVVKTQYF,1,0,1,1
TRBV3-1,TRBJ1-6,CASSPQRGSSPLHF,1,0,1,1
TRBV7-3,TRBJ2-4,CASSPGGVKNIQYF,1,0,1,1
TRBV7-9,TRBJ1-1,CASSPGRVNTEAFF,1,0,1,1
TRBV5-4,TRBJ1-1,CASSPDPGSTEAFF,1,0,1,1
TRBV7-9,TRBJ1-5,CASSPRGGNQPQHF,1,0,1,1
TRBV7-9,TRBJ2-7,CASSPSTSSYEQYF,1,0,1,1
TRBV3-1,TRBJ2-1,CASSPSGGWGEQFF,1,1,2,2
TRBV7-9,TRBJ2-7,CASSPPGQIFEQYF,1,0,1,1
TRBV6-2/3/5/6,TRBJ1-2,CASSPRTQNYGYTF,1,0,1,1
TRBV7-2,TRBJ2-7,CASSPGPPTYEQYF,1,0,1,1
TRBV7-2,TRBJ2-5,CASSPGQGQETQYF,1,0,1,1
TRBV7-2,TRBJ2-4,CASSPGQGLNIQYF,1,0,1,1
TRBV7-6,TRBJ2-7,CASSPGTGEGEQYF,1,0,1,1
TRBV7-9,TRBJ1-2,CASSRPGTGSGYTF,1,0,1,1
TRBV7-2,TRBJ2-7,CASSRRQGSYEQYF,1,0,1,1
TRBV3-1,TRBJ1-4,CASSRVDQGEKLFF,1,0,1,1
TRBV6-2/3/5/6,TRBJ2-7,CASSRDISSYEQYF,1,0,1,1
TRBV3-1,TRBJ2-2,CASSQGLVTGELFF,1,0,1,1
TRBV6-2/3/5/6,TRBJ1-1,CASSQEPGRLKAFF,1,0,1,1
TRBV3-1,TRBJ2-7,CASSQATGLYEQYF,1,0,1,1
TRBV3-1,TRBJ2-7,CASSQAGPSYEQYF,1,0,1,1
TRBV4-2,TRBJ2-7,CASSQGQLVYEQYF,1,0,1,1
TRBV3-1,TRBJ1-1,CASSQDSTSLEAFF,1,0,1,1
TRBV9,TRBJ2-3,CASSVIGVTDTQYF,1,0,1,1
TRBV9,TRBJ2-7,CASSVSDRSYEQYF,1,0,1,1
TRBV7-2,TRBJ1-2,CASSARQPSWGYTF,1,0,1,1
TRBV7-2,TRBJ2-7,CASSATRGGGEQYF,1,0,1,1
TRBV9,TRBJ2-3,CASSATVITDTQYF,1,0,1,1
TRBV9,TRBJ2-7,CASSGAGSSYEQYF,1,0,1,1
TRBV5-5,TRBJ1-5,CASSEASGNQPQHF,1,0,1,1
TRBV28,TRBJ1-2,CASSTRTGTGGYTF,1,0,1,1
TRBV7-9,TRBJ2-3,CASSTAGFTDTQYF,1,0,1,1
TRBV12-3/4,TRBJ1-1,CASSKGQGNTEAFF,1,1,2,2
TRBV9,TRBJ2-5,CASSKTSSQETQYF,1,0,1,1
TRBV2,TRBJ1-1,CASRLDRESAEAFF,1,0,1,1
TRBV12-3/4,TRBJ1-3,CASRPGEYGNTIYF,1,0,1,1
TRBV7-9,TRBJ1-4,CASRPGTGAEKLFF,1,0,1,1
TRBV7-2,TRBJ1-3,CASRQTFSGNTIYF,1,1,2,2
TRBV6-2/3/5/6,TRBJ2-3,CASRGRTSTDTQYF,1,0,1,1
TRBV2,TRBJ1-1,CASRGTLDETEAFF,1,0,1,1
TRBV2,TRBJ2-3,CANSRDRETDTQYF,1,0,1,1
TRBV5-1,TRBJ2-1,CASTPGGGWNEQFF,1,0,1,1
TRBV5-1,TRBJ1-1,CASSFEGTNTEAFF,1,0,1,1
TRBV5-1,TRBJ2-3,CASSLLLATDTQYF,1,0,1,1
TRBV5-1,TRBJ1-1,CASSLVAGNTEAFF,1,0,1,1
TRBV5-1,TRBJ2-7,CASSLDSLLYEQYF,1,0,1,1
TRBV5-1,TRBJ2-3,CASSLTVVRDTQYF,1,0,1,1
TRBV5-1,TRBJ2-7,CASSPDGHSYEQYF,1,0,1,1
TRBV4-1,TRBJ2-3,CASSPEPSTDTQYF,1,0,1,1
TRBV5-1,TRBJ2-1,CASSPNTGDDEQFF,1,0,1,1
TRBV4-1,TRBJ1-2,CASSQPDRGYGYTF,1,0,1,1
TRBV4-1,TRBJ1-1,CASSQVVRDPEAFF,1,0,1,1
TRBV4-1,TRBJ2-3,CASSQDQFADTQYF,1,0,1,1
TRBV5-1,TRBJ2-1,CASSTGTGGNEQFF,1,0,1,1
TRBV5-1,TRBJ1-2,CASSTGTERDGYTF,1,0,1,1
TRBV5-1,TRBJ1-2,CASSREGQGYGYTF,1,0,1,1
TRBV10-2,TRBJ1-5,CASSRQANNQPQHF,1,0,1,1
TRBV5-1,TRBJ2-7,CASRAGTGDYEQYF,1,0,1,1
TRBV20-1,TRBJ2-1,CSASVQGFYNEQFF,1,0,1,1
TRBV20-1,TRBJ2-5,CSARLAGVEETQYF,1,0,1,1
TRBV20-1,TRBJ2-7,CSARRLAGGGEQYF,1,0,1,1
TRBV20-1,TRBJ1-1,CSARVRTNPTEAFF,1,0,1,1
TRBV20-1,TRBJ2-7,CSARGGSGIYEQYF,1,0,1,1
TRBV20-1,TRBJ2-7,CSARDQRETYEQYF,1,0,1,1
TRBV20-1,TRBJ1-5,CSASQGYSNQPQHF,1,0,1,1
TRBV29-1,TRBJ1-5,CSVSYSDVFQPQHF,1,0,1,1
TRBV29-1,TRBJ2-7,CSVDVAGDPYEQYF,1,0,1,1
TRBV29-1,TRBJ2-4,CSVQQGVAKNIQYF,1,0,1,1
TRBV29-1,TRBJ2-1,CSVTTWTRYNEQFF,1,0,1,1
TRBV29-1,TRBJ1-6,CSAQWGDTYSPLHF,1,0,1,1
TRBV29-1,TRBJ2-1,CSAQTDYSYNEQFF,1,0,1,1
TRBV29-1,TRBJ1-1,CSAGQGDISTEAFF,1,0,1,1
TRBV19,TRBJ2-7,CASALRQGYEQYF,1,0,1,1
TRBV30,TRBJ2-3,CAWTLGEEDTQYF,1,0,1,1
TRBV30,TRBJ1-2,CAWSRQGAVGYTF,1,0,1,1
TRBV30,TRBJ1-1,CAWSDPMNTEAFF,1,1,2,2
TRBV9,TRBJ2-5,CAHDERSQETQYF,1,0,1,1
TRBV2,TRBJ2-1,CAILLAGAKEQFF,1,0,1,1
TRBV10-3,TRBJ2-7,CAISDPRTGVKYF,1,0,1,1
TRBV10-3,TRBJ1-4,CAIRQGGDEKLFF,1,0,1,1
TRBV7-9,TRBJ1-5,CATSQGSGEPQHF,1,0,1,1
TRBV24-1,TRBJ2-1,CATSGIADREEFF,1,0,1,1
TRBV15,TRBJ1-1,CATSSTGTTEAFF,1,0,1,1
TRBV3-1,TRBJ2-5,CATRTSGRETQYF,1,0,1,1
TRBV2,TRBJ2-1,CATIAGDYNEQFF,1,0,1,1
TRBV19,TRBJ1-1,CASIVRGGTEAFF,1,0,1,1
TRBV19,TRBJ1-1,CASSWLGFPEAFF,1,0,1,1
TRBV19,TRBJ1-1,CASSMRQDTEAFF,1,0,1,1
TRBV18,TRBJ2-2,CASSPPVTGELFF,1,0,1,1
TRBV18,TRBJ1-1,CASSPSGAFVAFF,1,0,1,1
TRBV7-9,TRBJ1-1,CASTSRRNTEAFF,1,0,1,1
TRBV27,TRBJ2-1,CASSFGGYNEQFF,1,0,1,1
TRBV12-3/4,TRBJ1-2,CASSFEGSYGYTF,1,0,1,1
TRBV6-2/3/5/6,TRBJ2-1,CASSLGGHNEQFF,1,0,1,1
TRBV28,TRBJ2-3,CASSLADGDTQYF,1,0,1,1
TRBV2,TRBJ1-5,CASSSGYNQPQHF,1,0,1,1
TRBV6-2/3/5/6,TRBJ1-1,CASSYSGDTEAFL,1,0,1,1
TRBV6-2/3/5/6,TRBJ1-2,CASSYGGRYGYTF,1,0,1,1
TRBV6-2/3/5/6,TRBJ1-6,CASSPSGAAVPHF,1,0,1,1
TRBV6-4,TRBJ1-5,CASSRQSNQPQHF,1,0,1,1
TRBV14,TRBJ1-5,CASSQGSRQPQHF,1,0,1,1
TRBV28,TRBJ2-7,CASSGPPTYEQYF,1,0,1,1
TRBV12-3/4,TRBJ2-7,CASSGQGSYEQYF,1,1,2,2
TRBV28,TRBJ2-7,CASSGTPVKEQYF,1,0,1,1
TRBV2,TRBJ1-4,CASSERLNEKLFF,1,0,1,1
TRBV6-1,TRBJ2-3,CASSEGRADTQYF,1,0,1,1
TRBV6-1,TRBJ2-7,CASSEDRAHEQYF,1,0,1,1
TRBV5-6,TRBJ2-1,CASSFWAYNEPFF,1,0,1,1
TRBV7-8,TRBJ2-7,CASSFHRTYEQYF,1,0,1,1
TRBV7-9,TRBJ2-3,CASSFGGTDTQYF,1,0,1,1
TRBV11-2,TRBJ2-7,CASSFHSPYEQYF,1,0,1,1
TRBV7-3,TRBJ2-1,CASSFGSYNEQFF,1,1,2,2
TRBV11-2,TRBJ1-5,CASSLGSNQPQHF,1,0,1,1
TRBV5-5,TRBJ1-1,CASSLGLGTEAFF,1,1,2,2
TRBV7-8,TRBJ1-5,CASSLYGEQPQHF,1,0,1,1
TRBV7-2,TRBJ1-1,CASSLPVNTEAFF,1,0,1,1
TRBV7-9,TRBJ2-1,CASSLAGGTEQFF,1,0,1,1
TRBV7-9,TRBJ2-2,CASSLARTGELFF,1,0,1,1
TRBV7-9,TRBJ2-5,CASSLGPQETQYF,1,0,1,1
TRBV7-2,TRBJ2-7,CASSLGRAYEQYF,1,0,1,1
TRBV7-6,TRBJ2-7,CASSLERDYEQYF,1,0,1,1
TRBV13,TRBJ1-1,CASSLMRGTEAFF,1,0,1,1
TRBV11-2,TRBJ2-7,CASSLRRDYEQYF,1,0,1,1
TRBV7-3,TRBJ1-5,CASSSDRYQPQHF,1,0,1,1
TRBV7-9,TRBJ1-2,CASSLQGADGYTF,1,0,1,1
TRBV11-2,TRBJ1-4,CASSPDRAEKLFF,1,0,1,1
TRBV28,TRBJ1-2,CASSPDRGGGYTF,1,0,1,1
TRBV7-2,TRBJ2-1,CASSPVQGYEQFF,1,0,1,1
TRBV4-2,TRBJ2-3,CASSHGQGRRQYF,1,0,1,1
TRBV7-9,TRBJ1-1,CASSQGYDTEAFF,1,1,2,2
TRBV3-1,TRBJ2-1,CASSQGLAGEQFF,1,0,1,1
TRBV4-2,TRBJ1-1,CASSQGGRTEAFF,1,0,1,1
TRBV3-1,TRBJ1-6,CASSQDRQRPLHF,1,0,1,1
TRBV4-2,TRBJ1-6,CASSQEFRGPLHF,1,0,1,1
TRBV3-1,TRBJ2-5,CASSQRGRETQYF,1,0,1,1
TRBV9,TRBJ1-2,CASSVGQAYGYTF,1,0,1,1
TRBV5-4,TRBJ2-3,CASSADSTDTQYF,1,0,1,1
TRBV9,TRBJ2-2,CASSGLTSGELFF,1,0,1,1
TRBV6-1,TRBJ1-5,CASSEAGHQPQHF,1,0,1,1
TRBV5-6,TRBJ1-1,CASRRDRNTEAFF,1,0,1,1
TRBV3-1,TRBJ2-7,CASRLAGSYEQYF,1,0,1,1
TRBV13,TRBJ2-5,CASRPARGETQYF,1,0,1,1
TRBV2,TRBJ2-5,CASRKDVEETQYI,1,0,1,1
TRBV6-2/3/5/6,TRBJ2-3,CASKFQGRDTQYF,1,0,1,1
TRBV15,TRBJ1-1,CTTSGRAFTEAFF,1,0,1,1
TRBV5-1,TRBJ2-5,CASSPGQIETQYF,1,0,1,1
TRBV5-1,TRBJ2-5,CASSRGTQETQYF,1,0,1,1
TRBV5-1,TRBJ2-7,CASSSGTTYEQYF,1,0,1,1
TRBV5-1,TRBJ2-7,CASSPGQGGEQYF,1,0,1,1
TRBV5-1,TRBJ1-1,CASSRQGAAEAFF,1,0,1,1
TRBV4-3,TRBJ2-1,CANSLGVKDEQFF,1,0,1,1
TRBV20-1,TRBJ1-3,CGARLLSGNTIYF,1,0,1,1
TRBV20-1,TRBJ2-1,CSAILAGGPEQFF,1,1,2,2
TRBV20-1,TRBJ1-5,CSAIRTGNQPQHF,1,0,1,1
TRBV20-1,TRBJ2-3,CSASGTSRDTQYF,1,0,1,1
TRBV20-1,TRBJ2-5,CSAREAGSSTQYF,1,0,1,1
TRBV20-1,TRBJ1-4,CSARIPGDEKLFF,1,0,1,1
TRBV20-1,TRBJ1-5,CSARPGGGQPQHF,1,0,1,1
TRBV29-1,TRBJ2-3,CSVVGWVTDTQYF,1,0,1,1
TRBV29-1,TRBJ2-3,CSVGKREADTQYF,1,0,1,1
TRBV29-1,TRBJ1-1,CSVDEDRNTEAFF,1,1,2,2
TRBV29-1,TRBJ1-3,CSVDTGDGNTIYF,1,0,1,1
TRBV29-1,TRBJ1-1,CSVEENPNTEAFF,1,0,1,1
TRBV29-1,TRBJ2-7,CSVRTGAWYEQYF,1,0,1,1
TRBV29-1,TRBJ2-7,CSVFRDRGVEQYF,1,0,1,1
TRBV29-1,TRBJ1-2,CSAVEDRAAGYTF,1,0,1,1
TRBV29-1,TRBJ1-5,CSATLDRNQPQHF,1,0,1,1
TRBV29-1,TRBJ2-5,CSGLFTGPETQYF,1,0,1,1
TRBV29-1,TRBJ2-5,CSGRGGRKETQYF,1,0,1,1
TRBV20-1,TRBJ2-5,CSGLPGPRETQYF,1,0,1,1
TRBV29-1,TRBJ2-2,CSEGLFYTGELFF,1,0,1,1
TRBV29-1,TRBJ2-7,CSTEGDSSYEQYF,1,0,1,1
TRBV30,TRBJ1-1,CAWSRQGAEAFF,1,0,1,1
TRBV30,TRBJ2-7,CAWRSGSYEQYF,1,1,2,2
TRBV15,TRBJ1-2,CATSVGANGYTF,1,0,1,1
TRBV27,TRBJ2-2,CASTHTPRELFF,1,0,1,1
TRBV12-3/4,TRBJ1-1,CASTPDSTEAFF,1,0,1,1
TRBV27,TRBJ1-1,CASSSLGTEAFF,1,0,1,1
TRBV6-2/3/5/6,TRBJ2-5,CASSRFQETQYF,1,0,1,1
TRBV7-9,TRBJ2-3,CASSLDRDTQYF,1,0,1,1
TRBV7-9,TRBJ1-2,CASSLEVGQGAF,1,0,1,1
TRBV7-9,TRBJ2-2,CASSLSTGELFF,1,0,1,1
TRBV3-1,TRBJ2-3,CASSYRADTQYF,1,0,1,1
TRBV12-3/4,TRBJ2-2,CASSLNTGELFF,1,1,2,2
TRBV7-3,TRBJ2-1,CASSPGPNEQFF,1,0,1,1
TRBV7-9,TRBJ1-2,CASSPQNYGYTF,1,0,1,1
TRBV7-9,TRBJ2-1,CASSRLAYGQFF,1,0,1,1
TRBV11-2,TRBJ1-4,CASSQVTGIPLF,1,0,1,1
TRBV9,TRBJ2-3,CASSVAGGAQYF,1,0,1,1
TRBV7-8,TRBJ2-2,CASRSIAGELFF,1,0,1,1
TRBV11-3,TRBJ2-3,CASREGRDTQYF,1,0,1,1
TRBV11-2,TRBJ2-7,CTSSSLSYEQYF,1,0,1,1
TRBV5-1,TRBJ1-1,CASSSSRQGTFF,1,0,1,1
TRBV4-1,TRBJ2-1,CASSQFGAEQFF,1,0,1,1
TRBV4-1,TRBJ2-7,CASSQDTREQYF,1,0,1,1
TRBV5-1,TRBJ2-1,CASSADLDEQFF,1,0,1,1
TRBV20-1,TRBJ1-2,CSAEGQDYGYTF,1,0,1,1
TRBV20-1,TRBJ2-7,CSASGSSCEQYF,1,0,1,1
TRBV20-1,TRBJ2-3,CSARQSADTQYF,1,0,1,1
TRBV20-1,TRBJ1-3,CSALGQSNTIYF,1,0,1,1
TRBV29-1,TRBJ1-2,CSVERQGYGYTF,1,0,1,1
TRBV29-1,TRBJ2-1,CSVVAGGNEQFF,1,0,1,1
TRBV29-1,TRBJ1-6,CSVGGESSPLHF,1,0,1,1
TRBV29-1,TRBJ2-1,CSVRRSYNEQFF,1,1,2,2
TRBV29-1,TRBJ2-7,CSANFGPAEQYF,1,0,1,1
TRBV29-1,TRBJ2-1,CSAGTSGNEQFF,1,0,1,1
TRBV29-1,TRBJ2-4,CSGIQGKDIQYF,1,0,1,1
TRBV30,TRBJ1-2,CAWSETYGYTF,1,0,1,1
TRBV30,TRBJ1-1,CAHLRATEAFF,1,0,1,1
TRBV10-3,TRBJ1-1,CAIRQGPEAFF,1,0,1,1
TRBV2,TRBJ2-5,CATDTGEAQYF,1,0,1,1
TRBV18,TRBJ2-7,CASSQDGQQYF,1,0,1,1
TRBV2,TRBJ2-7,CASTRGEEQYF,1,0,1,1
TRBV2,TRBJ2-5,CASTGVETQYF,1,0,1,1
TRBV7-2,TRBJ2-7,CASTRDVEQYF,1,0,1,1
TRBV12-3/4,TRBJ2-7,CASTNSYEQYF,1,0,1,1
TRBV7-9,TRBJ2-1,CASSYRNEQFF,1,0,1,1
TRBV7-2,TRBJ2-7,CASSPAYEQYF,1,0,1,1
TRBV3-1,TRBJ2-5,CASSQEKTQYF,1,0,1,1
TRBV11-2,TRBJ1-1,CASSAASGAFF,1,0,1,1
TRBV5-1,TRBJ1-2,CASGHNDGYTF,1,0,1,1
TRBV5-1,TRBJ2-3,CASSFTDTQCF,1,0,1,1
TRBV5-1,TRBJ1-1,CASRGRTEAFF,1,0,1,1
TRBV20-1,TRBJ2-3,CSAVSTDTQYF,1,0,1,1
TRBV20-1,TRBJ2-1,CSARLNNEQFF,1,0,1,1
TRBV20-1,TRBJ2-1,CSPARGNEQFF,1,0,1,1
TRBV29-1,TRBJ2-1,CSVTPYNEQFF,1,0,1,1
TRBV29-1,TRBJ2-7,CSADLAREQYF,1,0,1,1
TRBV12-5,TRBJ1-2,CASGLDRGTF,1,0,1,1
TRBV9,TRBJ1-1,CASSPTPAFF,1,0,1,1
TRBV4-3,TRBJ2-6,CAGSQVFLGQGAYGANVLTF,1,0,1,1
TRBV5-1,TRBJ2-1,CASSSPVSGTQGATYNEQFF,1,0,1,1
TRBV30,TRBJ2-3,CAWNLGLAGGSWGADTQYF,1,0,1,1
TRBV25-1,TRBJ1-1,CASSGGTWGRGSVNTEAFF,1,0,1,1
TRBV7-9,TRBJ1-4,CASSFGLRRPGELDEKLFF,1,0,1,1
TRBV7-9,TRBJ2-7,CASSFADGTGPTRGHEQYF,1,0,1,1
TRBV11-2,TRBJ2-1,CASSLRLAGSLGSYNEQFF,1,0,1,1
TRBV7-9,TRBJ2-3,CASSSNEARTSGFTDTQYF,1,0,1,1
TRBV5-1,TRBJ1-4,CASSLVPWEGLSVNEKLFF,1,0,1,1
TRBV4-3,TRBJ2-1,CASSQDGTSESSSYNEQFF,1,0,1,1
TRBV30,TRBJ2-7,CAWSSGPGRLAGAYEQYF,1,0,1,1
TRBV30,TRBJ2-2,CAWSVAPASGGDTGELFF,1,0,1,1
TRBV30,TRBJ1-6,CAWSTGTGSYLVDSPLHF,1,0,1,1
TRBV15,TRBJ1-5,CATSRDLKDRGGNQPQHF,1,0,1,1
TRBV9,TRBJ2-3,CASSPHRWQPSSTDTQYF,1,0,1,1
TRBV18,TRBJ1-2,CASSPPVLGKVPRGGYTF,1,0,1,1
TRBV13,TRBJ1-2,CASIESRSHREGIYGYTF,1,0,1,1
TRBV27,TRBJ1-4,CASSLSVSHRDRVEKLFF,1,0,1,1
TRBV12-3/4,TRBJ2-1,CASSLVRGSWGVHNEQFF,1,0,1,1
TRBV6-2/3/5/6,TRBJ1-1,CASSYSWRERFRNTEAFF,1,0,1,1
TRBV5-4,TRBJ2-7,CASSLEASGGLISYEQYF,1,0,1,1
TRBV7-8,TRBJ2-2,CASSSTMLADGNTGELFF,1,1,2,2
TRBV5-8,TRBJ1-2,CASSYDGGTGAPNYGYTF,1,0,1,1
TRBV4-3,TRBJ2-7,CASSQEVAGGVPTYEQYF,1,0,1,1
TRBV4-1,TRBJ1-6,CASSQRIGLVLDNSPLHF,1,0,1,1
TRBV7-7,TRBJ2-6,CASSPGQGDSGANVLTF,1,0,1,1
TRBV30,TRBJ2-2,CAWSSSGGIANTGELFF,1,0,1,1
TRBV24-1,TRBJ2-2,CATSDLMGQGISGELFF,1,0,1,1
TRBV19,TRBJ2-6,CASSAAGIRTGANVLTF,1,0,1,1
TRBV18,TRBJ1-1,CASSPATPKAMNTEAFF,1,0,1,1
TRBV6-2/3/5/6,TRBJ1-4,CASIHDRGRGTNEKLFF,1,0,1,1
TRBV28,TRBJ2-3,CASSSPVGGIRTDTQYF,1,0,1,1
TRBV6-2/3/5/6,TRBJ2-5,CASSTSRDRGPQETQYF,1,0,1,1
TRBV7-2,TRBJ2-1,CASSLAPGGLTGNEQFF,1,0,1,1
TRBV7-2,TRBJ2-3,CASSLGLTSGSADTQYF,1,0,1,1
TRBV7-8,TRBJ2-7,CASSLGDLGRSSYEQYF,1,0,1,1
TRBV7-2,TRBJ2-5,CASSLSLGTGIREIQYF,1,0,1,1
TRBV7-3,TRBJ2-5,CASSLRRSSGMQETQYF,1,0,1,1
TRBV7-9,TRBJ1-2,CASSSTRIQGTNYGYTF,1,0,1,1
TRBV7-9,TRBJ2-5,CASSLRTSGSGKETQYF,1,0,1,1
TRBV7-9,TRBJ1-3,CASSPPGEHLSGNTIYF,1,0,1,1
TRBV7-6,TRBJ1-5,CASSPGPGQLSNQPQHF,1,0,1,1
TRBV5-4,TRBJ2-5,CASSHRLAGGPGETQYF,1,0,1,1
TRBV12-3/4,TRBJ2-4,CASRASRGSLAKNIQYF,1,0,1,1
TRBV7-9,TRBJ2-3,CASNPGTSGGFWDTQYF,1,0,1,1
TRBV7-9,TRBJ1-3,CASKKGVRGISGNTIYF,1,0,1,1
TRBV5-1,TRBJ2-3,CASSLQGTEIFTDTQYF,1,0,1,1
TRBV4-1,TRBJ1-6,CASSRSRRTGDNSPLHF,1,0,1,1
TRBV4-3,TRBJ2-1,CASSQVPLAGDNNEQFF,1,0,1,1
TRBV4-3,TRBJ2-5,CASSQDSLVTAQETQYF,1,0,1,1
TRBV20-1,TRBJ2-7,CSAGISSGGAYSYEQYF,1,0,1,1
TRBV20-1,TRBJ2-1,CSARPRTSGSFYNEQFF,1,1,2,2
TRBV20-1,TRBJ1-6,CSARGSTGASYNSPLHF,1,0,1,1
TRBV5-4,TRBJ1-2,CVSSGKQGWAFKGYTF,1,0,1,1
TRBV30,TRBJ2-7,CAWSVPGSLPGHEQYF,1,0,1,1
TRBV5-4,TRBJ2-7,CAGSLGLREGTYEQYF,1,0,1,1
TRBV10-3,TRBJ1-6,CAISESRGYSPSPLHF,1,0,1,1
TRBV24-1,TRBJ2-1,CATSDNRVNSYNEQFF,1,0,1,1
TRBV15,TRBJ1-1,CATSRDLVSLNTEAFF,1,0,1,1
TRBV15,TRBJ2-4,CATSKLAGGRFDIQYF,1,0,1,1
TRBV19,TRBJ1-5,CASSPPKSDGNQPQHF,1,0,1,1
TRBV19,TRBJ1-2,CASSAHRGATNYGYTF,1,0,1,1
TRBV19,TRBJ2-5,CASSEGTSGGEETQYF,1,0,1,1
TRBV19,TRBJ1-1,CASSIFFGLMNTEAFF,1,0,1,1
TRBV19,TRBJ1-5,CASSIDRGIGNQPQHF,1,0,1,1
TRBV19,TRBJ2-2,CASSRVWTVLTGELFF,1,0,1,1
TRBV19,TRBJ1-3,CASSRQGPVSGNTIYF,1,0,1,1
TRBV19,TRBJ1-1,CASRTTRQDVDTEAFF,1,0,1,1
TRBV18,TRBJ2-7,CASSPLKGGGPGEQYF,1,0,1,1
TRBV11-3,TRBJ2-3,CASTSLAESGTDTQYF,1,0,1,1
TRBV12-3/4,TRBJ2-7,CASTRGLADRGHEQYF,1,0,1,1
TRBV6-2/3/5/6,TRBJ2-1,CASSFPYRGLEDEQFF,1,0,1,1
TRBV6-2/3/5/6,TRBJ1-2,CASSFGIWIANYGYTF,1,0,1,1
TRBV12-3/4,TRBJ1-2,CASSFGIWTANYGYTF,1,0,1,1
TRBV12-3/4,TRBJ2-7,CASSLFRTSGSYEQYF,1,0,1,1
TRBV12-3/4,TRBJ1-5,CASSLARGYSNQPRHF,1,0,1,1
TRBV6-2/3/5/6,TRBJ1-6,CASSLGEASYNSPLHF,1,0,1,1
TRBV6-2/3/5/6,TRBJ2-3,CASSYFKQSSTDTQYF,1,0,1,1
TRBV6-2/3/5/6,TRBJ2-7,CASSYGSLAGDGEQYF,1,0,1,1
TRBV27,TRBJ1-2,CASSPPRTGPDYGYTF,1,0,1,1
TRBV12-3/4,TRBJ2-3,CASSPGPGLRTDTQYF,1,0,1,1
TRBV6-4,TRBJ2-3,CASSPGQGGSTDTQYF,1,0,1,1
TRBV6-1,TRBJ1-1,CASSVSRGFMNTEAFF,1,0,1,1
TRBV6-1,TRBJ2-7,CASSEAGPPFSYEQYF,1,0,1,1
TRBV7-9,TRBJ2-1,CASSFSGTAVMGEQFF,1,0,1,1
TRBV5-6,TRBJ2-7,CASSFFRLLTLYEQYF,1,0,1,1
TRBV5-8,TRBJ1-5,CASSFIPDLRNQPQHF,1,0,1,1
TRBV11-2,TRBJ2-1,CASSLSSSGSKDEQFF,1,0,1,1
TRBV13,TRBJ2-4,CASSLGDRRAKNIQYF,1,0,1,1
TRBV11-2,TRBJ2-5,CASSLGAMGAQETQYF,1,0,1,1
TRBV7-6,TRBJ2-2,CASSLGFRTAGGELFF,1,0,1,1
TRBV13,TRBJ1-2,CASSLEGLTGGSGYTF,1,0,1,1
TRBV7-3,TRBJ1-2,CASSLNGGAANYGYTF,1,0,1,1
TRBV5-6,TRBJ2-7,CASSSPGLAGNYEQYF,1,0,1,1
TRBV7-2,TRBJ2-1,CASSSGVTRDANEQFF,1,0,1,1
TRBV7-2,TRBJ1-5,CASSLTGGSGNQPQHF,1,0,1,1
TRBV9,TRBJ2-7,CASSPWTGMSGDEQYF,1,0,1,1
TRBV11-2,TRBJ2-5,CASSPRLAGASETQYF,1,0,1,1
TRBV7-9,TRBJ2-1,CASSPRGGLAANEQFF,1,0,1,1
TRBV7-2,TRBJ2-1,CASSPTVGGYYNEQFF,1,0,1,1
TRBV14,TRBJ2-3,CASSQLSGRVADTQYF,1,0,1,1
TRBV4-2,TRBJ1-3,CASSQQAGTGDYTIYF,1,0,1,1
TRBV3-1,TRBJ2-7,CASSQVTPTISYEQYF,1,0,1,1
TRBV14,TRBJ2-7,CASSQDGGGGGDEQYF,1,0,1,1
TRBV7-8,TRBJ1-4,CASSQTGQGRNEKLFF,1,0,1,1
TRBV5-4,TRBJ2-3,CASSAGVASSTDTQYF,1,0,1,1
TRBV7-8,TRBJ2-6,CASSGSYRSGANVLTF,1,0,1,1
TRBV5-5,TRBJ2-3,CASSTRLAGSTDTQYF,1,0,1,1
TRBV2,TRBJ2-1,CASRGAMGSRNNEQFF,1,0,1,1
TRBV27,TRBJ1-2,CASKKRPGPTNYGYTF,1,0,1,1
TRBV5-1,TRBJ2-7,CASSLPSDSVSYEQYF,1,0,1,1
TRBV5-1,TRBJ2-1,CASSLRTSGGNNEQFF,1,0,1,1
TRBV5-1,TRBJ2-7,CASSRSGQGLSDEQYF,1,0,1,1
TRBV4-1,TRBJ2-3,CASSQLGLAGADTQYF,1,0,1,1
TRBV4-1,TRBJ2-1,CASSQGVGSSYNEQFF,1,0,1,1
TRBV4-1,TRBJ2-7,CASSQDSSGRLYEQYF,1,0,1,1
TRBV4-1,TRBJ2-7,CASSQDLTSGGYEQYF,1,0,1,1
TRBV4-3,TRBJ2-5,CASSQDVGRGQETQYF,1,0,1,1
TRBV4-3,TRBJ2-1,CASSQDGREAHNEQFF,1,0,1,1
TRBV5-1,TRBJ1-4,CASSVEPRGGDEKLFF,1,0,1,1
TRBV4-1,TRBJ2-3,CASSDRQGELADTQYF,1,0,1,1
TRBV20-1,TRBJ1-5,CSARDRQGVSNQPQHF,1,0,1,1
TRBV20-1,TRBJ1-5,CSARDLKGLNNQPQHF,1,0,1,1
TRBV20-1,TRBJ2-1,CSARDPILTNGNEQFF,1,0,1,1
TRBV12-5,TRBJ2-6,CASGPDSSGANVLTF,1,0,1,1
TRBV30,TRBJ1-1,CALLQGAMGITEAFF,1,0,1,1
TRBV15,TRBJ2-3,CASSRGDSETDTQYF,1,0,1,1
TRBV30,TRBJ1-5,CAWSKGTAYNQPQHF,1,0,1,1
TRBV2,TRBJ2-6,CATEPAFDGANVLTF,1,0,1,1
TRBV11-3,TRBJ1-1,CATSPTGVWDTEAFF,1,0,1,1
TRBV15,TRBJ1-4,CATSTLEAGKEKLFF,1,0,1,1
TRBV15,TRBJ2-7,CATSRDRDRLNEQYF,1,0,1,1
TRBV15,TRBJ1-4,CATSRDGSLNEKLFF,1,0,1,1
TRBV19,TRBJ2-5,CASMGTGTAQETQYF,1,0,1,1
TRBV19,TRBJ1-3,CASSPDSTSGNTIYF,1,0,1,1
TRBV19,TRBJ2-6,CASSVQGSGANVLTF,1,0,1,1
TRBV19,TRBJ2-7,CASSIGDRRIYEQYF,1,0,1,1
TRBV19,TRBJ1-5,CASSIGTYSNQPQHF,1,0,1,1
TRBV19,TRBJ1-2,CASSTRDTYNYGYTF,1,0,1,1
TRBV19,TRBJ2-2,CASRPLAGVTGELFF,1,0,1,1
TRBV6-2/3/5/6,TRBJ2-1,CASSWGRGTYNEQFF,1,0,1,1
TRBV18,TRBJ2-1,CASSPTGTGANEQFF,1,0,1,1
TRBV18,TRBJ2-6,CASSRDRSGANVLTF,1,0,1,1
TRBV12-3/4,TRBJ1-1,CASRRLLGRRTEAFF,1,0,1,1
TRBV2,TRBJ2-5,CASTYLGDRGETQYF,1,0,1,1
TRBV27,TRBJ2-7,CASSFGTGGSYEQYF,1,0,1,1
TRBV12-3/4,TRBJ2-7,CASSLLTGTPREQYF,1,0,1,1
TRBV27,TRBJ2-7,CASSLRTGSSYEQYF,1,0,1,1
TRBV6-2/3/5/6,TRBJ1-4,CASSSSRGRGEKLFF,1,0,1,1
TRBV6-2/3/5/6,TRBJ1-3,CASSSTGGSGNTIYF,1,0,1,1
TRBV12-3/4,TRBJ1-2,CASSWRDRAHYGYTF,1,0,1,1
TRBV6-2/3/5/6,TRBJ1-1,CASSYSAQGGTEAFF,1,0,1,1
TRBV6-2/3/5/6,TRBJ2-7,CASSYPAGVSYEQYF,1,0,1,1
TRBV6-2/3/5/6,TRBJ2-7,CASSYRPGFLYEQFF,1,0,1,1
TRBV7-9,TRBJ2-2,CASSLGTTNTGELFF,1,0,1,1
TRBV9,TRBJ2-1,CASSLSGRAENEQFF,1,0,1,1
TRBV12-3/4,TRBJ1-2,CASSPEAWGARGYTF,1,0,1,1
TRBV28,TRBJ1-2,CASSPEGSEGYGYTF,1,0,1,1
TRBV12-3/4,TRBJ2-7,CASSGLAGEGDEQYF,1,0,1,1
TRBV6-1,TRBJ2-2,CASSEDLRGTGELFF,1,0,1,1
TRBV2,TRBJ2-2,CASSEVEGGTGELFF,1,0,1,1
TRBV6-1,TRBJ1-1,CASSEDAGMNTEAFF,1,0,1,1
TRBV6-1,TRBJ1-5,CASSEEGNPRQPQHF,1,0,1,1
TRBV6-2/3/5/6,TRBJ1-1,CASSTGQIRTTEAFF,1,0,1,1
TRBV7-2,TRBJ1-1,CASSFGGGRNTEAFF,1,0,1,1
TRBV5-4,TRBJ1-1,CASSLSRHYNTEAFF,1,0,1,1
TRBV5-5,TRBJ2-1,CASSLLSGWDNEQFF,1,0,1,1
TRBV5-1,TRBJ2-7,CASSLVLAGGDEQYF,1,0,1,1
TRBV5-5,TRBJ2-2,CASSLTSANTGELFF,1,0,1,1
TRBV7-3,TRBJ2-6,CASSLTGVGANVLTF,1,0,1,1
TRBV5-4,TRBJ2-1,CASSLRTSGSVEQFF,1,0,1,1
TRBV7-3,TRBJ2-1,CASSLFSGGANEQFF,1,0,1,1
TRBV7-2,TRBJ2-7,CASSLVTNRRNEQYF,1,0,1,1
TRBV7-8,TRBJ2-3,CASSLVAGGTDTQYF,1,1,2,2
TRBV7-9,TRBJ2-7,CASSLALRGRLEQYF,1,0,1,1
TRBV13,TRBJ2-3,CASSLGSGVTDTQYF,1,0,1,1
TRBV7-2,TRBJ2-2,CASSLGQGAAGELFF,1,0,1,1
TRBV7-6,TRBJ2-1,CASSLGGTSYNEQFF,1,0,1,1
TRBV7-2,TRBJ2-7,CASSLGDSFFYEQYF,1,0,1,1
TRBV11-2,TRBJ1-1,CASSLGRSWGTEAFF,1,0,1,1
TRBV7-2,TRBJ2-2,CASSLDDSATGELFF,1,0,1,1
TRBV7-2,TRBJ2-7,CASSLDRTSGNKQYF,1,0,1,1
TRBV5-6,TRBJ1-1,CASSSRTTEGTEAFF,1,0,1,1
TRBV7-9,TRBJ2-5,CASSSDRANQETQYF,1,0,1,1
TRBV5-6,TRBJ1-1,CASSSETGYDTEAFF,1,0,1,1
TRBV7-9,TRBJ2-7,CASSYTDYVSYEQYF,1,0,1,1
TRBV7-2,TRBJ2-7,CASSLGQGEGYEQYF,1,0,1,1
TRBV7-9,TRBJ2-5,CASSLGIAGQETQYF,1,0,1,1
TRBV9,TRBJ1-1,CASSLAPGLNTEAFF,1,0,1,1
TRBV9,TRBJ2-2,CASSLGAFLTGELFF,1,0,1,1
TRBV7-6,TRBJ2-3,CASSPRDRGTDTQYF,1,0,1,1
TRBV7-6,TRBJ1-1,CASSPRGGMNTEAFF,1,0,1,1
TRBV9,TRBJ2-1,CASSRGTGGYNEQFF,1,0,1,1
TRBV2,TRBJ2-6,CASSREGGEANVLTF,1,0,1,1
TRBV7-9,TRBJ2-1,CASSRTSGTYNEQFF,1,0,1,1
TRBV7-3,TRBJ2-1,CASSRGGPSNNEQFF,1,0,1,1
TRBV3-1,TRBJ1-1,CASSQSGQRNTEAFF,1,0,1,1
TRBV14,TRBJ1-1,CASSQFQGENTVAFF,1,0,1,1
TRBV4-2,TRBJ2-7,CASSQAPSITLEQYF,1,0,1,1
TRBV14,TRBJ2-7,CASSQDIQGFYEQYF,1,0,1,1
TRBV14,TRBJ2-1,CASSQIGARVDEQFF,1,0,1,1
TRBV9,TRBJ2-3,CASSVQGGSTDTQYF,1,0,1,1
TRBV7-6,TRBJ2-7,CASSVGLAGVPEQYF,1,0,1,1
TRBV9,TRBJ2-3,CASSVDGRGPNTQYF,1,0,1,1
TRBV9,TRBJ1-4,CASSVEGGAGEKLFF,1,0,1,1
TRBV9,TRBJ2-5,CASSVRSSWGETQYF,1,2,2,3
TRBV9,TRBJ1-2,CASSAEGGDLYGYTF,1,0,1,1
TRBV7-9,TRBJ2-7,CASSETGSPLYEQYF,1,0,1,1
TRBV7-2,TRBJ1-1,CASSISGSVNTEAFF,1,0,1,1
TRBV12-3/4,TRBJ1-1,CASSTRPQAGPEAFF,1,0,1,1
TRBV12-3/4,TRBJ2-1,CASRSGGGVYNEQFF,1,0,1,1
TRBV6-2/3/5/6,TRBJ2-5,CASRYTSGDQETQYF,1,0,1,1
TRBV6-2/3/5/6,TRBJ1-4,CASRRAGGEDEKLFF,1,0,1,1
TRBV7-2,TRBJ2-1,CASRLGGGSEGEQFF,1,0,1,1
TRBV27,TRBJ2-6,CASRMGVSGANVLTF,1,0,1,1
TRBV6-2/3/5/6,TRBJ2-5,CASRISGGAGETQYF,1,0,1,1
TRBV6-1,TRBJ2-4,CASNGTELAKNIQYF,1,0,1,1
TRBV7-9,TRBJ1-2,CASNTRAPGAYGYTF,1,0,1,1
TRBV30,TRBJ1-4,CARSPSTGTNEKLFF,1,0,1,1
TRBV5-1,TRBJ2-3,CASSFQDRLRDTQYF,1,0,1,1
TRBV5-1,TRBJ2-1,CASSLGQGARNEQFF,1,0,1,1
TRBV5-1,TRBJ1-1,CASSLDVLMNTEAFF,1,0,1,1
TRBV5-1,TRBJ2-7,CASSLEVNRGCEQYF,1,0,1,1
TRBV5-1,TRBJ2-7,CASSLEAGGGYEQYF,1,0,1,1
TRBV5-1,TRBJ1-1,CASSLSSGQNTEAFF,1,0,1,1
TRBV5-1,TRBJ2-3,CASSSSGGRSDTQYF,1,0,1,1
TRBV5-1,TRBJ1-5,CASSSEGGGAEPQHF,1,0,1,1
TRBV5-1,TRBJ2-1,CASSLQGGTYNEQFF,1,0,1,1
TRBV4-3,TRBJ2-1,CASSPRGLAGYEQFF,1,0,1,1
TRBV5-1,TRBJ1-2,CASSPGPLVGYGYTF,1,0,1,1
TRBV5-1,TRBJ2-4,CASSPRQGAKNIQYF,1,1,2,2
TRBV4-3,TRBJ2-7,CASSQDIGGSYEQYF,1,0,1,1
TRBV4-3,TRBJ1-1,CASSQEAGANTEAFF,1,0,1,1
TRBV4-1,TRBJ1-1,CASSQEGTLNTEAFF,1,0,1,1
TRBV4-3,TRBJ1-2,CASSQEGQAVYGYTF,1,0,1,1
TRBV4-3,TRBJ2-3,CASSQRRSSTDTQYF,1,0,1,1
TRBV4-1,TRBJ2-5,CASSQRQGGMQTQYF,1,0,1,1
TRBV5-1,TRBJ2-2,CASSAWPSNTGELFF,1,0,1,1
TRBV5-1,TRBJ2-7,CASSTTPTDSYEQYF,1,0,1,1
TRBV5-1,TRBJ2-5,CASRNKPSYQETQYF,1,0,1,1
TRBV4-3,TRBJ2-2,CASRPLREGIGELFF,1,0,1,1
TRBV20-1,TRBJ2-7,CSAPTPSGRAGEQYF,1,0,1,1
TRBV20-1,TRBJ2-3,CSARDLFRGTDTQYF,1,0,1,1
TRBV20-1,TRBJ2-1,CSARDPRGTGYEQFF,1,0,1,1
TRBV20-1,TRBJ2-3,CSARDRQGAQDTQYF,1,0,1,1
TRBV20-1,TRBJ1-5,CSARENRGSAQPQHF,1,0,1,1
TRBV20-1,TRBJ2-3,CSANRLAVSTDTQYF,1,0,1,1
TRBV29-1,TRBJ1-4,CSVEGTTGENEKLFF,1,0,1,1
TRBV29-1,TRBJ2-1,CSVPEKGTKAWRQFF,1,0,1,1
TRBV29-1,TRBJ2-5,CSAARGGGAQETQYF,1,0,1,1
TRBV5-6,TRBJ2-5,SASSQGLAQETQYF,1,0,1,1
TRBV12-5,TRBJ2-7,CASGLHTGSYEQYF,1,0,1,1
TRBV7-7,TRBJ2-7,CASSSSDRAYEQYF,1,0,1,1
TRBV30,TRBJ2-1,CAWMLSGVHNEQFF,1,0,1,1
TRBV30,TRBJ2-7,CAWTPGQGPQEQYF,1,0,1,1
TRBV30,TRBJ2-3,CAWSRREDRDTQYF,1,0,1,1
TRBV19,TRBJ1-2,CAGIHPELDYGYTF,1,0,1,1
TRBV10-3,TRBJ2-7,CAISDGDVSYEQYF,1,0,1,1
TRBV10-3,TRBJ2-7,CAISNRDTSYEQYF,1,0,1,1
TRBV10-3,TRBJ2-3,CAISPSGSGDTQYF,1,0,1,1
TRBV10-3,TRBJ1-1,CAISGTGGNTEAFF,1,0,1,1
TRBV24-1,TRBJ2-3,CATFVDPGTDTQYF,1,0,1,1
TRBV19,TRBJ2-1,CATTRLHATGEQFF,1,0,1,1
TRBV15,TRBJ2-3,CATSRGQVTDTQYF,1,0,1,1
TRBV19,TRBJ2-2,CASERLAGAGELFF,1,0,1,1
TRBV19,TRBJ2-3,CASTKQGGTDTQYF,1,0,1,1
TRBV19,TRBJ2-3,CASSRTDGTDTQYF,1,0,1,1
TRBV19,TRBJ2-1,CASRRLAGVDEQFF,1,0,1,1
TRBV7-9,TRBJ1-4,CASGTSGVDEKLFF,1,0,1,1
TRBV3-1,TRBJ2-5,CASTWDRSQETQYF,1,0,1,1
TRBV6-2/3/5/6,TRBJ2-5,CASTTTGGQETQYF,1,0,1,1
TRBV7-2,TRBJ2-5,CASTTYRTGETQYF,1,0,1,1
TRBV6-2/3/5/6,TRBJ2-3,CASSFAGVTDTQYF,1,0,1,1
TRBV28,TRBJ2-2,CASSLPPDTGELFF,1,0,1,1
TRBV27,TRBJ2-5,CASSLDRGTETQYF,1,0,1,1
TRBV6-2/3/5/6,TRBJ1-6,CASSLEQYNSPLHF,1,0,1,1
TRBV6-2/3/5/6,TRBJ1-2,CASSSSPPNYGYTF,1,0,1,1
TRBV6-2/3/5/6,TRBJ2-7,CASSSSSTGDEQYS,1,0,1,1
TRBV6-2/3/5/6,TRBJ2-1,CASSYSTAYNEQFF,1,0,1,1
TRBV9,TRBJ2-7,CASSRNPSDYEQYF,1,0,1,1
TRBV4-2,TRBJ1-5,CASSQDGIGQPQHF,1,0,1,1
TRBV6-1,TRBJ2-3,CASSAHHRTDTQYF,1,0,1,1
TRBV6-1,TRBJ2-5,CASSGGTAFGTQYF,1,0,1,1
TRBV6-1,TRBJ2-1,CASSGTGQLNEQFF,1,0,1,1
TRBV27,TRBJ2-2,CASSGQGGTGELFF,1,0,1,1
TRBV6-1,TRBJ1-5,CASSEGDSNQPQHF,1,1,2,2
TRBV25-1,TRBJ2-1,CASSEPGEANEQFF,1,0,1,1
TRBV25-1,TRBJ2-7,CASSNSGTAYEQYF,1,0,1,1
TRBV12-3/4,TRBJ2-3,CASSNRLGTDTQYF,1,0,1,1
TRBV7-2,TRBJ2-5,CASSFGSGFETQYF,1,0,1,1
TRBV7-2,TRBJ1-1,CASSFGQVNTEALF,1,0,1,1
TRBV5-4,TRBJ2-5,CASSLPGAQETQYF,1,0,1,1
TRBV7-9,TRBJ2-1,CASSLVGPVHEQFF,1,0,1,1
TRBV7-6,TRBJ2-5,CASSLVQGRETQYF,1,0,1,1
TRBV7-8,TRBJ1-1,CASSLVVRNTEAFF,1,0,1,1
TRBV7-6,TRBJ2-3,CASSLALDTDTQYF,1,0,1,1
TRBV7-8,TRBJ2-7,CASSLGTSAYEQYF,1,0,1,1
TRBV7-2,TRBJ2-1,CASSLGGSLNEQFF,1,1,2,2
TRBV7-8,TRBJ2-3,CASSLMSLADTQYF,1,0,1,1
TRBV7-3,TRBJ1-1,CASSLTYKGTEAFF,1,0,1,1
TRBV7-3,TRBJ2-3,CASSLRSPLDTQYF,1,0,1,1
TRBV7-9,TRBJ2-7,CASSSNSGNYEQYF,1,0,1,1
TRBV7-9,TRBJ2-2,CASSSKLDTGELFF,1,0,1,1
TRBV11-2,TRBJ2-1,CASSSERAYNEQFF,1,6,2,7
TRBV7-6,TRBJ1-2,CASSSQGALYGYTF,1,0,1,1
TRBV6-2/3/5/6,TRBJ2-7,CASSLTGTIYEQYF,1,0,1,1
TRBV7-9,TRBJ2-3,CASSLTGRTDTQYF,1,0,1,1
TRBV7-9,TRBJ2-7,CASSLPGRTYEQYF,1,0,1,1
TRBV7-9,TRBJ2-7,CASSLTQATYEQYF,1,0,1,1
TRBV6-4,TRBJ2-1,CASSLKGQGTEQFF,1,0,1,1
TRBV5-6,TRBJ2-3,CASSPRGFTDTQYF,1,0,1,1
TRBV7-6,TRBJ2-3,CASSPSGPGDTQYF,1,0,1,1
TRBV7-9,TRBJ1-2,CASSPGTQDYGYTF,1,0,1,1
TRBV3-1,TRBJ1-1,CASSPGQGMGEAFF,1,0,1,1
TRBV4-2,TRBJ2-7,CASSPDGAWGEQYF,1,0,1,1
TRBV7-9,TRBJ2-3,CASSPTLDSDTQYF,1,0,1,1
TRBV7-9,TRBJ2-7,CASSPSGTIYEQYF,1,0,1,1
TRBV7-2,TRBJ2-7,CASSPGQGLDEQYF,1,0,1,1
TRBV3-1,TRBJ1-5,CASSPDLGNQPQHF,1,0,1,1
TRBV12-3/4,TRBJ1-2,CASSRFGSSYGYTF,1,0,1,1
TRBV14,TRBJ2-7,CASSRQSISYEQYF,1,0,1,1
TRBV3-1,TRBJ1-4,CASSQSADNEKLFF,1,0,1,1
TRBV7-3,TRBJ2-7,CASSQGTGQSEQYF,1,0,1,1
TRBV4-2,TRBJ1-5,CASSQGQGLEPQHF,1,0,1,1
TRBV4-2,TRBJ1-2,CASSQGTGDYGYTF,1,0,1,1
TRBV14,TRBJ2-5,CASSQDLGQETQYF,1,0,1,1
TRBV9,TRBJ1-1,CASSVGVAFTEAFF,1,0,1,1
TRBV7-9,TRBJ2-3,CASSGRQYTDTQYF,1,0,1,1
TRBV9,TRBJ2-1,CASSETGAYNEQFF,1,0,1,1
TRBV7-9,TRBJ2-1,CASSIGDIHNEQFF,1,0,1,1
TRBV5-5,TRBJ1-1,CASRLGQGKTEAFF,1,0,1,1
TRBV19,TRBJ2-3,CASRTSGSTDTQYF,1,0,1,1
TRBV6-2/3/5/6,TRBJ1-6,CASRFRDGNSPLHF,1,0,1,1
TRBV6-2/3/5/6,TRBJ2-5,CASRLVGRAETQYF,1,0,1,1
TRBV28,TRBJ1-1,CASNIDREGTEAFF,1,0,1,1
TRBV6-2/3/5/6,TRBJ1-5,CASNWDRVNQPQHF,1,0,1,1
TRBV7-9,TRBJ2-4,CASNPGQGAYIQYF,1,0,1,1
TRBV2,TRBJ1-4,CASKPGSTNEKLFF,1,0,1,1
TRBV7-2,TRBJ2-2,CASKGDRYTGELFF,1,0,1,1
TRBV5-1,TRBJ1-2,CASSPLPGSYGYTF,1,0,1,1
TRBV5-1,TRBJ2-1,CASMERLAAGGRFF,1,0,1,1
TRBV6-2/3/5/6,TRBJ1-1,CASSPGITDTEAFF,1,0,1,1
TRBV5-1,TRBJ2-5,CASSRSGVGETQYF,1,0,1,1
TRBV5-1,TRBJ2-7,CASSFSSGGHEQYF,1,0,1,1
TRBV5-1,TRBJ2-5,CASSLATGGGTQYF,1,0,1,1
TRBV5-1,TRBJ1-1,CASSLAQDNTEAFF,1,1,2,2
TRBV5-1,TRBJ2-1,CASSLGTADDEQFF,1,0,1,1
TRBV5-1,TRBJ1-1,CASSLDWANTEAFF,1,0,1,1
TRBV5-1,TRBJ2-5,CASSLEDNQETQYF,1,0,1,1
TRBV5-1,TRBJ2-6,CASSWGTGANVLTF,1,0,1,1
TRBV5-1,TRBJ2-3,CASSWGRNTDTQYF,1,0,1,1
TRBV4-3,TRBJ2-7,CASSLGTGGYEQYF,1,0,1,1
TRBV5-1,TRBJ1-1,CASSPGPSNTEAFF,1,0,1,1
TRBV4-1,TRBJ1-1,CASSQATGFTEAFF,1,0,1,1
TRBV4-1,TRBJ1-1,CASSQERVGTEAFL,1,0,1,1
TRBV5-1,TRBJ2-1,CASSARDSYNEQFF,1,0,1,1
TRBV5-1,TRBJ2-3,CASSGGQVADTQYF,1,1,2,2
TRBV5-1,TRBJ2-1,CASSSPSLYNEQFF,1,0,1,1
TRBV4-1,TRBJ2-4,CASSKGIEGDIQYL,1,0,1,1
TRBV20-1,TRBJ2-1,CSVGARSADNEQFF,1,0,1,1
TRBV20-1,TRBJ2-2,CSAVGLAGTGELVF,1,0,1,1
TRBV20-1,TRBJ2-5,CSARRQGVQETQYF,1,0,1,1
TRBV20-1,TRBJ2-7,CSARGGSPGGEQYF,1,0,1,1
TRBV20-1,TRBJ2-5,CSARGARRQETQYF,1,0,1,1
TRBV20-1,TRBJ2-5,CSARRPGGMETQYF,1,0,1,1
TRBV20-1,TRBJ2-5,CSAREFSGNPTQYF,1,0,1,1
TRBV20-1,TRBJ1-2,CSARRGASNYGYTF,1,0,1,1
TRBV29-1,TRBJ2-1,CSVGAGNNHNEQFF,1,1,2,2
TRBV29-1,TRBJ2-1,CSVEWTYTYNEQFF,1,0,1,1
TRBV29-1,TRBJ2-1,CSVEDWGRANEQFF,1,0,1,1
TRBV29-1,TRBJ1-2,CSVEEDVGDYGYTF,1,0,1,1
TRBV29-1,TRBJ1-1,CSVRTGVGYTEAFF,1,0,1,1
TRBV29-1,TRBJ2-1,CSIFNAAGANEQFF,1,0,1,1
TRBV28,TRBJ1-1,CALQGTLSTEAFF,1,0,1,1
TRBV12-5,TRBJ2-7,CASGLGPIWEQYF,1,0,1,1
TRBV12-3/4,TRBJ2-1,CASDSGDWNEQFF,1,0,1,1
TRBV7-9,TRBJ1-1,CASMGVLNTEAFF,1,0,1,1
TRBV30,TRBJ1-6,CAWSTGASSPLHF,1,0,1,1
TRBV30,TRBJ2-2,CAWGGSLTGELFF,1,0,1,1
TRBV30,TRBJ1-1,CAWTAPKGTEAFF,1,0,1,1
TRBV30,TRBJ1-2,CAWSFDRNYGYTF,1,0,1,1
TRBV30,TRBJ1-1,CAWSVSSRTEAFF,1,0,1,1
TRBV3-1,TRBJ2-2,CAIEDRASGELFF,1,0,1,1
TRBV24-1,TRBJ2-7,CATSSVSGDEQYF,1,0,1,1
TRBV19,TRBJ1-1,CASINRQNTEAFF,1,0,1,1
TRBV19,TRBJ1-5,CASTAMGNQPQHF,1,0,1,1
TRBV19,TRBJ2-3,CASSAGAGDTQYF,1,0,1,1
TRBV19,TRBJ1-1,CASSMTGNTEAFF,1,0,1,1
TRBV18,TRBJ2-7,CASSPSGGGEQYF,1,0,1,1
TRBV6-2/3/5/6,TRBJ1-2,CASRLGLGGGYTF,1,0,1,1
TRBV19,TRBJ1-5,CASHDRVNQPQHF,1,0,1,1
TRBV12-3/4,TRBJ1-2,CASARRGAYGYTF,1,0,1,1
TRBV6-2/3/5/6,TRBJ2-1,CASALAPLNEQFF,1,0,1,1
TRBV12-3/4,TRBJ1-1,CASTLLGDTEAFF,1,0,1,1
TRBV27,TRBJ1-1,CASSFRGPTEAFF,1,0,1,1
TRBV12-3/4,TRBJ2-5,CASSLASEETQYF,1,0,1,1
TRBV12-3/4,TRBJ2-1,CASSLATGAEQFF,1,0,1,1
TRBV6-2/3/5/6,TRBJ1-4,CASSSWGDEKLFF,1,0,1,1
TRBV6-2/3/5/6,TRBJ1-2,CASSSGRPQGYTF,1,0,1,1
TRBV6-2/3/5/6,TRBJ2-5,CASSSLGTRTQYF,1,0,1,1
TRBV6-2/3/5/6,TRBJ1-1,CASSYGQGTEAFF,1,0,1,1
TRBV12-3/4,TRBJ1-2,CASSPRLDYGYTF,1,0,1,1
TRBV12-3/4,TRBJ2-2,CASSPPYTGELFF,1,1,2,2
TRBV6-2/3/5/6,TRBJ2-7,CASSPTWAYEQYF,1,0,1,1
TRBV28,TRBJ1-1,CASSPGSNTEAFF,1,0,1,1
TRBV6-2/3/5/6,TRBJ1-2,CASSPDRRYGYTF,1,0,1,1
TRBV13,TRBJ2-1,CASSPGSYNEQFF,1,1,2,2
TRBV6-2/3/5/6,TRBJ2-7,CASSRGGPYEQYF,1,0,1,1
TRBV2,TRBJ2-4,CASSEGQKNIQYF,1,0,1,1
TRBV6-1,TRBJ2-5,CASSELQKETQYF,1,0,1,1
TRBV11-2,TRBJ2-7,CASSFGPDRGRYF,1,0,1,1
TRBV11-2,TRBJ2-1,CASSFGTKDEQFF,1,0,1,1
TRBV5-4,TRBJ2-3,CASSLGRSDTQYF,1,0,1,1
TRBV7-2,TRBJ2-7,CASSLTASYEQYF,1,0,1,1
TRBV7-9,TRBJ1-2,CASSLSENYGYTF,1,0,1,1
TRBV7-2,TRBJ2-7,CASSLVAFYEQYF,1,0,1,1
TRBV7-9,TRBJ2-1,CASSLAANNEQFF,1,0,1,1
TRBV7-9,TRBJ2-7,CASSLAGAYELYF,1,0,1,1
TRBV7-2,TRBJ2-7,CASSLGRYYEQYF,1,1,2,2
TRBV7-2,TRBJ2-7,CASSLGRSYEQYF,1,0,1,1
TRBV7-2,TRBJ2-7,CASSLGRDYEQYF,1,0,1,1
TRBV7-9,TRBJ2-1,CASSLGGANEQFF,1,0,1,1
TRBV11-2,TRBJ2-5,CASSLDTMETQYF,1,0,1,1
TRBV7-2,TRBJ2-3,CASSLNKADTQYF,1,0,1,1
TRBV11-1,TRBJ2-1,CASSSGSLNEQFF,1,1,2,2
TRBV11-1,TRBJ1-2,CASSLTGNYGYTF,1,0,1,1
TRBV7-2,TRBJ1-2,CASSPLGGYGYTF,1,0,1,1
TRBV3-1,TRBJ1-1,CASSPSQGTEAFF,1,0,1,1
TRBV11-1,TRBJ2-1,CASSPYTYNEQFF,1,0,1,1
TRBV5-6,TRBJ2-7,CASSPAGSYEQYF,1,0,1,1
TRBV7-9,TRBJ2-3,CASSPGGTDTRYF,1,0,1,1
TRBV3-1,TRBJ2-5,CASSRTPPETQYF,1,0,1,1
TRBV3-1,TRBJ2-5,CASSRGGTETQYF,1,0,1,1
TRBV7-2,TRBJ2-3,CASSHGGQGTQYF,1,0,1,1
TRBV3-1,TRBJ2-3,CASSQATADTQYF,1,0,1,1
TRBV28,TRBJ1-5,CASSQSTGQPQHF,1,0,1,1
TRBV14,TRBJ2-2,CASSQYLTGELFF,1,0,1,1
TRBV7-2,TRBJ2-5,CASSQPGQETQYF,1,2,2,3
TRBV14,TRBJ1-5,CASSQKGNQPQHF,1,0,1,1
TRBV11-2,TRBJ1-1,CASSGQRNTEAFF,1,0,1,1
TRBV7-9,TRBJ1-2,CASSGETNYVYTF,1,0,1,1
TRBV7-6,TRBJ1-2,CASSRTGTDGYTF,1,0,1,1
TRBV12-3/4,TRBJ1-2,CASSKGHFGDYTF,1,0,1,1
TRBV3-1,TRBJ2-7,CASSKGWRGEQYF,1,0,1,1
TRBV6-4,TRBJ2-7,CASRGLDSWEQYF,1,0,1,1
TRBV6-2/3/5/6,TRBJ2-1,CASRGQGGNEQFF,1,0,1,1
TRBV2,TRBJ2-7,CASRNRGPYEQYF,1,0,1,1
TRBV6-2/3/5/6,TRBJ1-1,CASRWGQNTEAFF,1,0,1,1
TRBV14,TRBJ2-3,CASRLGGRDTQYF,1,0,1,1
TRBV7-2,TRBJ2-5,CASRGTGRETQYF,1,0,1,1
TRBV6-2/3/5/6,TRBJ1-1,CASRTRDSTEAFF,1,0,1,1
TRBV6-2/3/5/6,TRBJ2-7,CASNPPGGYEQYF,1,0,1,1
TRBV4-2,TRBJ2-1,CASNRAGNNEQFF,1,0,1,1
TRBV28,TRBJ1-2,CANTPGPNYGYTF,1,0,1,1
TRBV5-1,TRBJ2-5,CASSLAERETQYF,1,0,1,1
TRBV5-1,TRBJ2-2,CASSLGFTGELFF,1,0,1,1
TRBV5-1,TRBJ2-5,CASSWLGSQTQYF,1,0,1,1
TRBV5-1,TRBJ2-7,CASSYQGSGEQYF,1,0,1,1
TRBV4-3,TRBJ1-1,CASSQARGNEAFF,1,0,1,1
TRBV4-3,TRBJ2-3,CASSQAVDNTQYF,1,0,1,1
TRBV20-1,TRBJ1-3,CSASLYSGNTIYF,1,0,1,1
TRBV20-1,TRBJ1-5,CSARYTGGQPQHF,1,0,1,1
TRBV20-1,TRBJ2-7,CSARDNWGVEQYF,1,0,1,1
TRBV20-1,TRBJ2-5,CSAKGPGQETQYF,1,0,1,1
TRBV20-1,TRBJ2-4,CSALPPDKNIQYF,1,0,1,1
TRBV29-1,TRBJ1-5,CSVVGQYFSAQHF,1,0,1,1
TRBV29-1,TRBJ1-1,CSVDRAGDTEAFF,1,0,1,1
TRBV29-1,TRBJ2-5,CSVERQGGGTQYF,1,0,1,1
TRBV29-1,TRBJ1-4,CSVMGQFNEKLFF,1,0,1,1
TRBV29-1,TRBJ2-5,CSVPRGGGETQYF,1,0,1,1
TRBV29-1,TRBJ2-6,CSVTGAGANVLTF,1,0,1,1
TRBV29-1,TRBJ2-1,CSGRRSGEVELFF,1,0,1,1
TRBV29-1,TRBJ1-1,SSVKTGGDTEAFF,1,0,1,1
TRBV30,TRBJ2-7,CASNLGTYEQYF,1,0,1,1
TRBV30,TRBJ2-7,CASRTENYEQYF,1,1,2,2
TRBV30,TRBJ2-2,CACTLPPGELFF,1,0,1,1
TRBV30,TRBJ2-2,CAWGDRPGELFF,1,0,1,1
TRBV30,TRBJ2-3,CAWSPFGDTQYF,1,0,1,1
TRBV30,TRBJ2-6,CAYLRGANVLTF,1,0,1,1
TRBV30,TRBJ2-6,CAEDSGANVLTF,1,0,1,1
TRBV19,TRBJ1-1,CASALRNTEAFF,1,0,1,1
TRBV19,TRBJ2-5,CASSLGRETQYF,1,0,1,1
TRBV12-3/4,TRBJ1-2,CASSLAQPGYTF,1,0,1,1
TRBV12-3/4,TRBJ1-1,CASSLRRGIAFF,1,0,1,1
TRBV6-2/3/5/6,TRBJ1-5,CASSYPFQPQHF,1,0,1,1
TRBV7-2,TRBJ1-1,CASSPSFGSAFF,1,0,1,1
TRBV6-2/3/5/6,TRBJ2-1,CASSPEWSEQFF,1,0,1,1
TRBV2,TRBJ2-1,CASSVAGNEQFF,1,0,1,1
TRBV6-1,TRBJ2-1,CASSDGVRGQFF,1,0,1,1
TRBV7-2,TRBJ2-1,CASSFSYNEQFF,1,0,1,1
TRBV7-9,TRBJ2-7,CASSFGLYEQYF,1,0,1,1
TRBV5-5,TRBJ2-3,CASSFDPDTQYF,1,0,1,1
TRBV5-6,TRBJ2-5,CASSLRPGAQYF,1,0,1,1
TRBV7-9,TRBJ1-2,CASSLIMNGYTF,1,0,1,1
TRBV7-2,TRBJ2-7,CASSLASGRGYF,1,0,1,1
TRBV11-3,TRBJ2-5,CASSLDGETQYF,1,0,1,1
TRBV11-2,TRBJ2-5,CASSSGGETQYF,1,0,1,1
TRBV10-3,TRBJ2-3,CASSLPRDTQYF,1,1,2,2
TRBV5-4,TRBJ2-7,CASSPDSYEQYF,1,0,1,1
TRBV11-1,TRBJ2-7,CASSPDRYEQYF,1,0,1,1
TRBV6-2/3/5/6,TRBJ1-6,CASSRQEAPLHF,1,0,1,1
TRBV11-2,TRBJ2-4,CASSRTPEVQYF,1,0,1,1
TRBV3-1,TRBJ2-1,CASSQARREEFF,1,0,1,1
TRBV13,TRBJ2-5,CASSVGQETQYF,1,0,1,1
TRBV7-9,TRBJ2-1,CASSVYYNEQFF,1,0,1,1
TRBV9,TRBJ2-1,CASSVLNNEQFF,1,0,1,1
TRBV9,TRBJ2-3,CASSVQGEAQYF,1,0,1,1
TRBV6-2/3/5/6,TRBJ2-3,CASSASGDTQYF,1,0,1,1
TRBV13,TRBJ2-7,CASSGRVDEQYF,1,0,1,1
TRBV7-2,TRBJ2-7,CASSTTSYEQYF,1,0,1,1
TRBV27,TRBJ1-5,CASRQGSQPQHF,1,0,1,1
TRBV6-2/3/5/6,TRBJ1-4,CASRGQGEKLFF,1,0,1,1
TRBV2,TRBJ2-7,CASRGGPSEQYF,1,0,1,1
TRBV5-1,TRBJ2-4,CASSPQGNIQYF,1,0,1,1
TRBV4-1,TRBJ2-7,CASSQEFGEQYF,1,0,1,1
TRBV9,TRBJ1-5,CASSVDRRPQHF,1,0,1,1
TRBV5-1,TRBJ1-2,CASSETGDGYTF,1,0,1,1
TRBV5-1,TRBJ2-1,CASSTSAYEQFF,1,0,1,1
TRBV20-1,TRBJ2-1,CSALGGGYEQFF,1,0,1,1
TRBV20-1,TRBJ2-2,CSAPTSSGELFF,1,0,1,1
TRBV20-1,TRBJ1-1,CSAPRTGLGAFF,1,0,1,1
TRBV29-1,TRBJ2-2,CSVFRPTGELFF,1,0,1,1
TRBV29-1,TRBJ2-7,CSVVLYLAEQYF,1,0,1,1
TRBV29-1,TRBJ2-5,CSVDSGVQTQYF,1,0,1,1
TRBV29-1,TRBJ2-7,CSVDLGSYEQYF,1,0,1,1
TRBV29-1,TRBJ1-2,CSVDRDGPSYTF,1,0,1,1
TRBV29-1,TRBJ1-1,CSVEKGETEAFF,1,0,1,1
TRBV29-1,TRBJ2-5,CSVTGGLETQYF,1,0,1,1
TRBV29-1,TRBJ1-1,CSVRTGPAEAFF,1,0,1,1
TRBV29-1,TRBJ2-2,CSVGDGTGELFF,1,0,1,1
TRBV29-1,TRBJ2-5,CSVTVSRETQYF,1,0,1,1
TRBV29-1,TRBJ1-3,CSAGSGGNTIYF,1,0,1,1
TRBV18,TRBJ2-5,CASSPQETQYF,1,0,1,1
TRBV2,TRBJ2-1,CASMRAGEQFF,1,0,1,1
TRBV3-1,TRBJ2-5,CASSVQETQYF,1,0,1,1
TRBV7-9,TRBJ2-1,CASSLAYEQFF,1,0,1,1
TRBV7-6,TRBJ2-1,CASSLGNEQFF,1,0,1,1
TRBV14,TRBJ1-1,CASSLQGEDFF,1,0,1,1
TRBV7-9,TRBJ2-7,CASSQLNEQYF,1,0,1,1
TRBV7-9,TRBJ2-7,CASSVEYEQYF,1,0,1,1
TRBV5-1,TRBJ2-7,CASSSDYEQYF,1,0,1,1
TRBV29-1,TRBJ2-7,CSVGRGNEQYF,1,0,1,1
TRBV20-1,TRBJ2-5,CSAIVQETQYF,1,0,1,1
TRBV20-1,TRBJ2-3,CSEGTRDTQYF,1,0,1,1
TRBV29-1,TRBJ1-3,CSVRQGNTIYF,1,0,1,1
TRBV29-1,TRBJ1-2,CSVGDLYGYTF,1,0,1,1
TRBV29-1,TRBJ2-7,CSVTFTGEQYF,1,0,1,1
TRBV29-1,TRBJ2-1,CSATGGHEQFF,1,0,1,1
TRBV13,TRBJ1-1,CASGTQRAFF,1,0,1,1
TRBV4-3,TRBJ2-7,CATLFGEQYF,1,0,1,1
TRBV20-1,TRBJ2-1,CSAGEQFF,1,0,1,1
TRBV20-1,TRBJ2-1,CSARDGASDNEQFF,0,4,1,4
TRBV2,TRBJ1-5,CASSGQSGGNQPQHF,0,6,1,6
TRBV24-1,TRBJ2-7,CATSDLWEQYF,0,1,1,1
TRBV12-3/4,TRBJ2-7,CASSLFSYEQYF,0,1,1,1
TRBV7-9,TRBJ1-1,CASSLRWTGSSGTEAFF,0,1,1,1
TRBV13,TRBJ1-1,CASSPGTAEAFF,0,1,1,1
TRBV6-2/3/5/6,TRBJ1-1,CASLLSLTGTEFPEAFF,0,1,1,1
TRBV7-2,TRBJ2-5,CASSPPGGGRETQYF,0,1,1,1
TRBV29-1,TRBJ2-7,CSVETPGQPHYEQYF,0,1,1,1
TRBV3-1,TRBJ2-2,CASSPELRLAVAGELFF,0,1,1,1
TRBV29-1,TRBJ1-1,CSVEKNKNTEAFF,0,1,1,1
TRBV7-9,TRBJ1-1,CASQDRYTEAFF,0,1,1,1
TRBV5-1,TRBJ2-2,CASSPGTGDTGELFF,0,3,1,3
TRBV11-3,TRBJ2-3,CASSFEGGSFTDTQYF,0,1,1,1
TRBV5-1,TRBJ1-1,CASSLGQNTEAFF,0,2,1,2
TRBV10-1,TRBJ2-2,CASSESDTGELFF,0,1,1,1
TRBV12-3/4,TRBJ2-2,CASSYEVTGELFF,0,1,1,1
TRBV7-2,TRBJ2-3,CASSSVPMGLGFIDTQYF,0,2,1,2
TRBV12-3/4,TRBJ1-1,CASSFQGIIWTEAFF,0,2,1,2
TRBV6-4,TRBJ2-7,CASSDRVGYEQYF,0,2,1,2
TRBV20-1,TRBJ2-5,CSARELFQETQYF,0,2,1,2
TRBV7-2,TRBJ1-1,CASSSTGGNTEAFF,0,4,1,4
TRBV11-1,TRBJ1-1,CASSLQEGTEAFF,0,1,1,1
TRBV12-3/4,TRBJ1-5,CASSWHRGRVAQPQHF,0,2,1,2
TRBV14,TRBJ2-2,CASSLGTLANTGELFF,0,2,1,2
TRBV7-2,TRBJ2-7,CASSLFQGESYEQYF,0,1,1,1
TRBV5-1,TRBJ2-1,CASSSLAGINNEQFF,0,1,1,1
TRBV5-6,TRBJ1-5,CASSLDNRREYQHF,0,3,1,3
TRBV20-1,TRBJ2-5,CSARVQETQYF,0,1,1,1
TRBV4-2,TRBJ1-2,CASSQGTGPYGYTF,0,1,1,1
TRBV20-1,TRBJ1-1,CSAPRDRNTEAFF,0,3,1,3
TRBV7-3,TRBJ1-1,CASSLSRVINTEAFF,0,1,1,1
TRBV29-1,TRBJ2-6,CSVEVYGRDPVLTF,0,2,1,2
TRBV2,TRBJ2-5,CASTKSRQETQYF,0,1,1,1
TRBV5-6,TRBJ2-7,CASSLLGPYEQYF,0,1,1,1
TRBV7-2,TRBJ2-3,CASSPQTTDTQYF,0,1,1,1
TRBV19,TRBJ2-3,CASSRFQGSDTQYF,0,2,1,2
TRBV19,TRBJ2-2,CASSIFSGELFF,0,1,1,1
TRBV5-4,TRBJ1-1,CASSLVGGRNTEAFF,0,1,1,1
TRBV13,TRBJ1-1,CASSLTFELFF,0,1,1,1
TRBV2,TRBJ2-3,CASSRTGAGDTQYF,0,1,1,1
TRBV29-1,TRBJ2-7,CSVVLAGRRHEQYF,0,1,1,1
TRBV3-1,TRBJ2-7,CASSPSWDGTYEQYF,0,1,1,1
TRBV19,TRBJ2-3,CASRGLSGGEDTQYF,0,1,1,1
TRBV14,TRBJ2-1,CASSPGQRSYNEQFF,0,1,1,1
TRBV29-1,TRBJ2-7,CSVGRGTYEQYF,0,2,1,2
TRBV29-1,TRBJ1-5,CSATDRVGQPQHF,0,2,1,2
TRBV12-3/4,TRBJ2-5,CASTPNQETQYF,0,1,1,1
TRBV20-1,TRBJ1-1,CSARGTQNTEAFF,0,1,1,1
TRBV7-9,TRBJ1-5,CSSSLDTQPQHF,0,1,1,1
TRBV7-9,TRBJ2-1,CASRSKERGSSYNEQFF,0,1,1,1
TRBV5-1,TRBJ1-1,CASSLSGQGTTEAFF,0,1,1,1
TRBV14,TRBJ1-1,CASSLEVSRAEAFF,0,1,1,1
TRBV3-1,TRBJ2-7,CASSQGQGTYEQYF,0,2,1,2
TRBV12-3/4,TRBJ1-5,CASSGRENQPQHF,0,2,1,2
TRBV20-1,TRBJ2-3,CSARDRGGKDTQYF,0,1,1,1
TRBV19,TRBJ1-1,CASRPWDRANTEAFF,0,2,1,2
TRBV19,TRBJ2-1,CASSIVGANNEQFF,0,1,1,1
TRBV12-3/4,TRBJ1-5,CASSSHRSLEPQHF,0,1,1,1
TRBV20-1,TRBJ1-5,CSASPGQGDQPQHF,0,1,1,1
TRBV12-3/4,TRBJ2-2,CASSDSNTGELFF,0,1,1,1
TRBV5-6,TRBJ1-2,CASSLNRDYGYTF,0,1,1,1
TRBV3-1,TRBJ1-2,CASSRIGGYGYTF,0,1,1,1
TRBV20-1,TRBJ1-1,CSALPGVNTEAFF,0,1,1,1
TRBV9,TRBJ2-3,CASSVSTDTQYF,0,3,1,3
TRBV29-1,TRBJ2-7,CSVYETGNEQYF,0,1,1,1
TRBV30,TRBJ1-1,CAWFGGATEAFF,0,1,1,1
TRBV20-1,TRBJ2-2,CSARDGARVNTGELLF,0,2,1,2
TRBV19,TRBJ2-3,CASEDRGRGADTQYF,0,1,1,1
TRBV12-3/4,TRBJ1-4,CASSWGMAEKLFF,0,1,1,1
TRBV5-1,TRBJ1-2,CASSGGHNYGYTL,0,1,1,1
TRBV11-3,TRBJ2-4,CASSLDEASGNIQYF,0,2,1,2
TRBV19,TRBJ2-1,CASSMGRGTSYNEQFF,0,1,1,1
TRBV6-2/3/5/6,TRBJ2-3,CASSYFGMTSADTQYF,0,1,1,1
TRBV5-4,TRBJ2-3,CASSSDRTSTDTQYF,0,1,1,1
TRBV11-2,TRBJ2-5,CASSLDRGARKTQYF,0,1,1,1
TRBV29-1,TRBJ1-1,CSLADVGTGRTEAFF,0,1,1,1
TRBV7-9,TRBJ2-5,CASSSGLARETQYF,0,2,1,2
TRBV5-4,TRBJ2-5,CASRADTRQETQYF,0,1,1,1
TRBV12-3/4,TRBJ2-3,CASTHDWEGTQYF,0,1,1,1
TRBV13,TRBJ2-7,CASSLVYSYEQYF,0,2,1,2
TRBV2,TRBJ1-1,CASSGEAPEAFF,0,1,1,1
TRBV20-1,TRBJ2-5,CSAREGGGQETQYF,0,1,1,1
TRBV4-1,TRBJ1-2,CASSQDLGQGKRDYGYTF,0,1,1,1
TRBV19,TRBJ1-1,CASSIDGWGAGTEAFF,0,1,1,1
TRBV7-9,TRBJ2-3,CASSLVSGAGTDTQYF,0,1,1,1
TRBV12-3/4,TRBJ1-5,CASSSTRQYSNQPQHS,0,2,1,2
TRBV5-1,TRBJ2-1,CASSLGREGLYNEQFF,0,1,1,1
TRBV30,TRBJ2-1,CAWSAGTSPHNEQFF,0,1,1,1
TRBV6-4,TRBJ1-5,CASRGQGDSNQPQHF,0,2,1,2
TRBV4-3,TRBJ2-5,CASSHGTGGKETQYF,0,2,1,2
TRBV19,TRBJ2-2,CASSGGGGTGELFF,0,1,1,1
TRBV18,TRBJ1-5,CASSPSDSNQPQHF,0,1,1,1
TRBV9,TRBJ2-3,CASSVGDFQRPQYF,0,2,1,2
TRBV12-3/4,TRBJ2-7,CASSLGTGGEQYF,0,1,1,1
TRBV12-5,TRBJ1-1,CASGPGGSEAFF,0,1,1,1
TRBV6-2/3/5/6,TRBJ2-7,CASSYSWDEQYF,0,2,1,2
TRBV6-1,TRBJ2-1,CASSEFGYEQFF,0,1,1,1
TRBV5-6,TRBJ2-1,CASSLGALPWIF,0,1,1,1
TRBV3-1,TRBJ2-7,CASSQDSTLSYF,0,1,1,1
TRBV29-1,TRBJ2-5,CSVGWGQKTQYF,0,2,1,2
TRBV29-1,TRBJ2-7,CSVEGSYEQYF,0,1,1,1
TRBV29-1,TRBJ2-3,CSVEGADTQYF,0,1,1,1
TRBV19,TRBJ2-6,CASRSGQGAPGANVLTF,0,1,1,1
TRBV20-1,TRBJ2-7,CSARGAGGGLYEQYF,0,1,1,1
TRBV12-3/4,TRBJ1-5,CASSPSHAPQRF,0,1,1,1
TRBV13,TRBJ2-7,CASSRPPPYTLSYEQYF,0,1,1,1
TRBV24-1,TRBJ2-3,CATSEGAGFSPDTQYF,0,1,1,1
TRBV12-3/4,TRBJ1-2,CASSFYNRGVNYGYTF,0,1,1,1
TRBV7-9,TRBJ2-3,CASSFGASGGSDTQYF,0,1,1,1
TRBV13,TRBJ2-6,CASSSWTGNGANVLTF,0,1,1,1
TRBV9,TRBJ2-3,CASSERGGRVADTQYF,0,2,1,2
TRBV30,TRBJ1-4,CACQVPGATNEKLFF,0,1,1,1
TRBV24-1,TRBJ1-5,CATSFHIYSNQPQHF,0,2,1,2
TRBV12-3/4,TRBJ1-5,CASGSGTGGSQPQHF,0,1,1,1
TRBV27,TRBJ1-1,CASSPETRRNTEAFF,0,1,1,1
TRBV5-1,TRBJ2-1,CASSLEAGVGNEQFF,0,2,1,2
TRBV20-1,TRBJ2-3,CSARGGGGGTDTQYF,0,1,1,1
TRBV19,TRBJ1-1,CASSIRQGGTEAFF,0,1,1,1
TRBV7-9,TRBJ1-2,CASSLSREGGRYTF,0,1,1,1
TRBV5-5,TRBJ1-1,CASSWTGTNTEAFF,0,1,1,1
TRBV2,TRBJ1-4,CASRPLIQGEKLFF,0,1,1,1
TRBV5-1,TRBJ2-7,CASSREGQAYEQYF,0,1,1,1
TRBV20-1,TRBJ1-2,CSASIQGSYLSYTF,0,1,1,1
TRBV20-1,TRBJ1-1,CSARDGGGITEAFF,0,2,1,2
TRBV30,TRBJ1-5,CAWSVTLNQPQHF,0,1,1,1
TRBV24-1,TRBJ1-1,CATSATALTEAFF,0,1,1,1
TRBV12-3/4,TRBJ2-1,CASSTRDYNEQFF,0,2,1,2
TRBV7-2,TRBJ2-3,CASSPGNTDTQYF,0,3,1,3
TRBV5-1,TRBJ2-3,CASRTGDTDTQYF,0,1,1,1
TRBV5-1,TRBJ2-3,CASSLWYRDTQYF,0,1,1,1
TRBV29-1,TRBJ1-6,CSVGDSGDSPLHF,0,1,1,1
TRBV28,TRBJ1-2,CASSSTVYGYTF,0,2,1,2
TRBV7-9,TRBJ2-7,CASSSGQGSQYF,0,1,1,1
TRBV11-2,TRBJ1-1,CASRNTEAFF,0,1,1,1
TRBV5-4,TRBJ1-1,CASNLRTGGVTEAFF,0,1,1,1
TRBV5-1,TRBJ2-2,CASSQRTLGGVTGELFF,0,1,1,1
TRBV20-1,TRBJ2-6,CSATGQGSGANVLTF,0,1,1,1
TRBV7-9,TRBJ2-1,CASSPGGRANEQFF,0,1,1,1
TRBV29-1,TRBJ2-5,CSVEGGREETQYF,0,1,1,1
TRBV5-1,TRBJ1-1,CASSLSAQLNTEAFF,0,1,1,1
TRBV5-1,TRBJ2-1,CASSTSGISYNEQFF,0,2,1,2
TRBV18,TRBJ1-1,CASGRLNTEAFF,0,1,1,1
TRBV9,TRBJ2-6,CASSGTGLRAGANVLTF,0,1,1,1
TRBV2,TRBJ1-4,CASSDPRNRGQREKLFF,0,1,1,1
TRBV14,TRBJ2-7,CASSPKASGTNRYEQYF,0,1,1,1
TRBV5-1,TRBJ2-1,CASSLRFGGRNYNEQFF,0,1,1,1
TRBV5-1,TRBJ2-5,CASSPDGTSVLQETQYF,0,1,1,1
TRBV19,TRBJ2-1,CASSASLGGSYNEQFF,0,1,1,1
TRBV12-3/4,TRBJ1-5,CASSLGRIWEGQPQHF,0,1,1,1
TRBV12-3/4,TRBJ1-4,CASSLIGGSTNEKLFF,0,2,1,2
TRBV11-2,TRBJ1-1,CASSLDLGGKNTEAFF,0,1,1,1
TRBV5-4,TRBJ1-2,CASSLVEALNYGYTF,0,1,1,1
TRBV6-1,TRBJ2-7,CASSAAGTGNYEQYF,0,1,1,1
TRBV9,TRBJ2-3,CASSDRQGAEDTQYF,0,3,1,3
TRBV11-1,TRBJ2-3,CASSSWTGSEDTQYF,0,1,1,1
TRBV6-2/3/5/6,TRBJ1-5,CASRYRGYDHQPQHF,0,2,1,2
TRBV20-1,TRBJ2-3,CSARVGVWGTDTQYF,0,1,1,1
TRBV29-1,TRBJ2-7,CSVLTGTGDPYEQYF,0,1,1,1
TRBV29-1,TRBJ2-1,CSVGRREAWDNEQFL,0,1,1,1
TRBV30,TRBJ1-4,CAWRGTETYEKLFF,0,1,1,1
TRBV12-3/4,TRBJ2-2,CATTRTSVGGELFF,0,1,1,1
TRBV12-3/4,TRBJ2-7,CASTSTTVRYEQYF,0,1,1,1
TRBV12-3/4,TRBJ2-7,CASSLVGSSYEQYF,0,1,1,1
TRBV6-2/3/5/6,TRBJ2-3,CASSYTIRGDTQYF,0,2,1,2
TRBV2,TRBJ1-2,CASSVGRGAYGYTF,0,1,1,1
TRBV11-2,TRBJ2-7,CASSLSLVGYEQYF,0,1,1,1
TRBV27,TRBJ2-3,CASSLAGGPDTQYF,0,1,1,1
TRBV7-2,TRBJ1-1,CASSSRAGRTEAFF,0,1,1,1
TRBV6-2/3/5/6,TRBJ2-1,CASRGTGYYNEQFF,0,1,1,1
TRBV4-1,TRBJ2-4,CASSQDISENIQYF,0,1,1,1
TRBV20-1,TRBJ2-1,CSARDLGSYNEQFF,0,1,1,1
TRBV20-1,TRBJ2-2,CSAREGMGTGELFF,0,1,1,1
TRBV30,TRBJ1-1,CAWSIQVNTEAFF,0,1,1,1
TRBV19,TRBJ1-1,CASSINRNTEAFF,0,1,1,1
TRBV6-2/3/5/6,TRBJ2-1,CASSFGPVDEQFF,0,1,1,1
TRBV6-1,TRBJ1-4,CASSRQGFEKLFF,0,1,1,1
TRBV2,TRBJ2-7,CASSDSFPYEQYF,0,1,1,1
TRBV9,TRBJ1-1,CASSGPGFQEAFF,0,1,1,1
TRBV10-1,TRBJ2-3,CASSESLADTQYF,0,1,1,1
TRBV5-1,TRBJ2-7,CASSSGTGYEQYF,0,1,1,1
TRBV20-1,TRBJ1-1,CSAPLVSRPEAFF,0,1,1,1
TRBV29-1,TRBJ1-2,CSAERTTNYGYTF,0,1,1,1
TRBV20-1,TRBJ1-1,CSASLRVTEAFF,0,1,1,1
TRBV29-1,TRBJ1-1,CSVLGGNTEAFF,0,1,1,1
TRBV7-2,TRBJ1-4,CASSLAEKLFF,0,1,1,1
TRBV5-8,TRBJ2-3,CASSPQGFSTDTQYF,0,1,1,1
TRBV6-2/3/5/6,TRBJ2-1,CASSYRPSYNEQFF,0,1,1,1
TRBV5-6,TRBJ2-7,CASSASWHEQYF,0,1,1,1
TRBV3-1,TRBJ2-7,CASSQDVTSGAYEQYF,0,1,1,1
TRBV20-1,TRBJ2-3,CSAGPSRGLGADTQYF,0,1,1,1
TRBV2,TRBJ2-4,CASSPTSLGVQYF,0,2,1,2
TRBV7-6,TRBJ2-7,SASSLALGVHEQYF,0,1,1,1
TRBV7-2,TRBJ2-3,CASSSMSTDTQYF,0,3,1,3
TRBV29-1,TRBJ2-7,CSVGTSGTYEQYF,0,3,1,3
TRBV18,TRBJ1-1,CASSPGRVGVTEAFF,0,1,1,1
TRBV2,TRBJ2-5,CASSVEGEGETQYI,0,1,1,1
TRBV7-9,TRBJ2-1,CASSLPRAYNEQFF,0,1,1,1
TRBV19,TRBJ1-1,CASSRYLGGFEETAGRTEAFF,0,1,1,1
TRBV19,TRBJ2-3,CASSTNPPSGGIPDTQYF,0,1,1,1
TRBV12-3/4,TRBJ1-5,CASSARGTNVYSNQPQHF,0,1,1,1
TRBV20-1,TRBJ2-3,CSARAGLAGDGYTDTQYF,0,1,1,1
TRBV5-8,TRBJ2-1,CASSLAEGSGDPNEQFF,0,1,1,1
TRBV6-2/3/5/6,TRBJ2-7,CASSRGGLAGDSYEQYF,0,1,1,1
TRBV5-1,TRBJ2-1,CASTWGPPTDSYNEQFF,0,1,1,1
TRBV5-1,TRBJ2-7,CASSLYVSRDSNYEQYF,0,1,1,1
TRBV12-5,TRBJ2-1,CASVMGLAGGGNEQFF,0,2,1,2
TRBV19,TRBJ2-1,CASSIYYSSTYNEQFF,0,1,1,1
TRBV19,TRBJ1-1,CASSIVVAGWGTEAFF,0,2,1,2
TRBV27,TRBJ1-5,CASSPQQGSSNQPQHF,0,1,1,1
TRBV12-3/4,TRBJ2-3,CASSPSSGSLTDTQYF,0,1,1,1
TRBV28,TRBJ2-5,CASSPQRAGGLETQYF,0,1,1,1
TRBV7-8,TRBJ1-1,CASSPPSGTGKTEAFF,0,1,1,1
TRBV4-3,TRBJ2-1,CASSQVPAGDTGEQFF,0,1,1,1
TRBV12-3/4,TRBJ1-2,CASSLVPGPNYGYTF,0,1,1,1
TRBV6-2/3/5/6,TRBJ1-5,CASSYFGQGNQPQHF,0,1,1,1
TRBV28,TRBJ2-7,CASSYPPRGHYEQYF,0,1,1,1
TRBV2,TRBJ2-1,CASSERSQGTHEQFF,0,1,1,1
TRBV5-5,TRBJ2-1,CASSLAPGQGKEQFF,0,1,1,1
TRBV7-2,TRBJ2-5,CASSPSGFGWETQYF,0,1,1,1
TRBV2,TRBJ2-1,CASSPGDGRNNEQFF,0,1,1,1
TRBV3-1,TRBJ1-2,CASSQDFQGGYGYTF,0,1,1,1
TRBV10-1,TRBJ2-3,CASSAGGGISDTQYF,0,1,1,1
TRBV5-1,TRBJ2-1,CASSLGHLSYNEQFF,0,1,1,1
TRBV29-1,TRBJ1-2,CSVGTGDNTNYGYTF,0,1,1,1
TRBV18,TRBJ2-1,CASSPPSGDNEQFF,0,1,1,1
TRBV27,TRBJ2-5,CASSLLGQKETQYF,0,1,1,1
TRBV28,TRBJ2-7,CASSLLVGTYEQYF,0,1,1,1
TRBV6-2/3/5/6,TRBJ1-5,CASSRDRVAKPQHF,0,1,1,1
TRBV11-3,TRBJ1-1,CASSFGQMNTEAFF,0,1,1,1
TRBV7-2,TRBJ2-5,CASSLGRRQETQYF,0,1,1,1
TRBV4-2,TRBJ1-2,CASSSGGRIDGYTF,0,1,1,1
TRBV3-1,TRBJ2-3,CASSSGHSTDTQYF,0,1,1,1
TRBV12-3/4,TRBJ2-5,CASSRGTGGETQYF,0,1,1,1
TRBV14,TRBJ2-7,CASSQAAGAYEQYF,0,1,1,1
TRBV5-1,TRBJ2-7,CASSLAADQYEQYF,0,2,1,2
TRBV5-1,TRBJ2-3,CASSSRRSTDTQYF,0,1,1,1
TRBV5-1,TRBJ1-2,CASSSGTGTYGYTF,0,1,1,1
TRBV4-3,TRBJ2-7,CASSRAVGSYEQYF,0,1,1,1
TRBV10-3,TRBJ2-3,CACTQQGAEDTQYF,0,1,1,1
TRBV20-1,TRBJ2-7,CSARGLAGVDEQYF,0,1,1,1
TRBV20-1,TRBJ2-6,CSAKGVSGANVLTF,0,1,1,1
TRBV29-1,TRBJ2-7,CSVTTGGVSYEQYF,0,1,1,1
TRBV6-2/3/5/6,TRBJ2-2,CASSYSYGGELFF,0,1,1,1
TRBV2,TRBJ2-5,CASSEKLKETQYF,0,1,1,1
TRBV5-4,TRBJ2-5,CASSWEGGETQYF,0,1,1,1
TRBV7-2,TRBJ2-5,CASSPAGDETQYF,0,2,1,2
TRBV25-1,TRBJ1-1,CASSGGSGTEAFF,0,1,1,1
TRBV11-1,TRBJ2-3,CASSEQRLDTQYF,0,2,1,2
TRBV20-1,TRBJ1-1,CSALTGEHTEAFF,0,1,1,1
TRBV20-1,TRBJ1-2,CSAIRVKSYGYTF,0,1,1,1
TRBV20-1,TRBJ2-5,CSAPGTPRETQYF,0,1,1,1
TRBV29-1,TRBJ2-7,CSVDGTGAYEQYF,0,1,1,1
TRBV29-1,TRBJ1-1,CSAGQGKNTEAFF,0,1,1,1
TRBV6-2/3/5/6,TRBJ2-3,CASSLTRNTQYF,0,1,1,1
TRBV27,TRBJ1-4,CASSSRPGKLFF,0,1,1,1
TRBV12-3/4,TRBJ2-7,CASSRDRGQQYF,0,1,1,1
TRBV3-1,TRBJ2-1,CASRIGVNEQFF,0,2,1,2
TRBV5-1,TRBJ1-4,CASSFTNEKLFF,0,1,1,1
TRBV29-1,TRBJ2-7,CSVLRDGEEQYF,0,1,1,1
TRBV29-1,TRBJ2-7,CSVVSESYEQYF,0,1,1,1
TRBV29-1,TRBJ1-1,CSVVGVDTEAFF,0,1,1,1
TRBV7-2,TRBJ2-7,CASSLFDEQYF,0,1,1,1
TRBV20-1,TRBJ2-5,CSARLAETQYF,0,1,1,1
TRBV29-1,TRBJ2-1,CSVVWNEQFF,0,1,1,1
TRBV29-1,TRBJ1-1,CSSLSGGSEAFF,0,1,1,1
TRBV6-2/3/5/6,TRBJ2-3,CASSLWPGGADTQYF,0,1,1,1
TRBV7-9,TRBJ1-4,CASSLETGTNEKLFF,0,1,1,1
TRBV4-3,TRBJ2-7,CASSQRTSGVLEQYF,0,2,1,2
TRBV20-1,TRBJ2-3,CSALSTGGLTDTQYF,0,1,1,1
TRBV3-1,TRBJ2-5,CASGQEAGEETQYF,0,1,1,1
TRBV7-9,TRBJ2-1,CASSPMRFNEQFF,0,1,1,1
TRBV20-1,TRBJ1-5,CSARGVGGAVSNSNQPQHF,0,1,1,1
TRBV6-1,TRBJ1-5,CASSEPGQGNGIGQPQHF,0,1,1,1
TRBV11-2,TRBJ2-5,CASSSSSARAGASETQYF,0,1,1,1
TRBV4-2,TRBJ1-5,CASSQDAEDDRFNQPQHF,0,1,1,1
TRBV19,TRBJ1-1,CASSPMRTGGQYTEAFF,0,1,1,1
TRBV7-2,TRBJ2-7,CASSLAVGRGPSNEQYF,0,1,1,1
TRBV9,TRBJ2-1,CASSVELATISYNEQFF,0,1,1,1
TRBV5-1,TRBJ1-2,CASSLGLGDRANYGYTF,0,1,1,1
TRBV4-1,TRBJ2-3,CASSLRAGLAGKDTQYF,0,2,1,2
TRBV20-1,TRBJ2-2,CSARGARDRDSTGELFF,0,1,1,1
TRBV18,TRBJ2-7,CASSPGTSGRAREQYF,0,1,1,1
TRBV7-9,TRBJ2-3,CASSLGLGSLVDTQYF,0,1,1,1
TRBV7-3,TRBJ2-6,CASSSLAGSGANVLTF,0,1,1,1
TRBV7-8,TRBJ2-2,CASSWKRQTNTGELFF,0,1,1,1
TRBV7-8,TRBJ2-1,CASSGRTSGSTDEQFF,0,2,1,2
TRBV5-1,TRBJ2-1,CASSLDGGTSYNEQFF,0,1,1,1
TRBV5-1,TRBJ1-6,CASSLQADSYNSPLHF,0,1,1,1
TRBV4-3,TRBJ2-6,CASSPATGSGANVLTF,0,1,1,1
TRBV4-3,TRBJ2-6,CASSQDYSSGANVLTF,0,1,1,1
TRBV5-1,TRBJ1-2,CASSTVMGAQEYGYTF,0,1,1,1
TRBV29-1,TRBJ2-1,CSVEPEEGSSYNEQFF,0,1,1,1
TRBV29-1,TRBJ2-3,CSVEGRAGAFTDTQYF,0,1,1,1
TRBV19,TRBJ2-7,CASRDRDRNNYEQYF,0,1,1,1
TRBV19,TRBJ1-4,CASSPSGTGGGKLFF,0,1,1,1
TRBV18,TRBJ1-3,CASPVKICAGNTIYF,0,1,1,1
TRBV6-2/3/5/6,TRBJ2-1,CASSSWTGYYNEQFF,0,1,1,1
TRBV7-8,TRBJ2-3,CASSFTSVNTDTQYF,0,1,1,1
TRBV7-9,TRBJ1-1,CASSLAGAGFTEAFF,0,1,1,1
TRBV7-2,TRBJ2-1,CASSLGGSEIGEQFF,0,1,1,1
TRBV7-9,TRBJ2-7,CASSLSIGRDYEQYF,0,1,1,1
TRBV7-9,TRBJ1-2,CASSSGQGMHYGYTF,0,1,1,1
TRBV7-2,TRBJ1-2,CASSSAGTGIYGYTF,0,1,1,1
TRBV11-3,TRBJ2-1,CASSPRTGQYNEQFF,0,1,1,1
TRBV14,TRBJ2-5,CASSPGGGQGETQYF,0,2,1,2
TRBV9,TRBJ2-7,CASSAVPSGPYEQYL,0,1,1,1
TRBV14,TRBJ2-2,CASSIRTGPTGELFF,0,2,1,2
TRBV5-1,TRBJ1-1,CASAPQVGSGAEAFF,0,1,1,1
TRBV5-1,TRBJ2-7,CASSLLIPGSYEQYF,0,1,1,1
TRBV5-1,TRBJ1-1,CASSGNTGENTEAFF,0,1,1,1
TRBV29-1,TRBJ2-5,CSAPPGQGARETQYF,0,1,1,1
TRBV29-1,TRBJ2-5,CSVSHTASREETQYF,0,2,1,2
TRBV29-1,TRBJ2-7,CSVEVSERYTYEQYF,0,1,1,1
TRBV7-9,TRBJ2-3,CASFRQGIADTQYF,0,1,1,1
TRBV19,TRBJ1-3,CASSRVPSGNTIYF,0,1,1,1
TRBV7-9,TRBJ2-1,CASSFATSGNEQFF,0,2,1,2
TRBV5-5,TRBJ1-2,CASSLALGDYGYTF,0,1,1,1
TRBV5-4,TRBJ2-7,CASSLDGAPYEQYF,0,1,1,1
TRBV7-6,TRBJ1-4,CASSLSSFNEKLFF,0,1,1,1
TRBV7-2,TRBJ2-7,CASSLEATSYEQYF,0,1,1,1
TRBV7-8,TRBJ1-1,CASSLTGGNTEAFF,0,1,1,1
TRBV7-3,TRBJ1-1,CASSSQGQGAEAFF,0,2,1,2
TRBV7-2,TRBJ1-5,CASSPVSGNQPQHF,0,1,1,1
TRBV28,TRBJ2-1,CASRLLNRANEQFF,0,1,1,1
TRBV3-1,TRBJ2-7,CASRHRDRAHEQYF,0,1,1,1
TRBV6-2/3/5/6,TRBJ2-2,CASNPGTNTGELFF,0,1,1,1
TRBV5-1,TRBJ2-7,CASSPMQGGDEQYF,0,1,1,1
TRBV20-1,TRBJ1-1,CSARGGAANTEAFF,0,1,1,1
TRBV20-1,TRBJ1-1,CSAREIYRGPEAFF,0,1,1,1
TRBV29-1,TRBJ2-2,CSVRGTGIAGELFF,0,1,1,1
TRBV30,TRBJ1-6,CAWSKGHLITLHF,0,1,1,1
TRBV25-1,TRBJ2-2,CASFDRATGELFF,0,2,1,2
TRBV19,TRBJ2-7,CASSMLDSREQYF,0,1,1,1
TRBV18,TRBJ1-2,CASSPGQDYGYTF,0,1,1,1
TRBV3-1,TRBJ2-3,CASTRTQTDTQYF,0,1,1,1
TRBV12-3/4,TRBJ1-2,CASSPGRGYGYSF,0,1,1,1
TRBV2,TRBJ2-2,CASSGQNTGELFF,0,1,1,1
TRBV6-1,TRBJ2-1,CASSEAPLDEQFF,0,1,1,1
TRBV7-3,TRBJ2-7,CASSLTGANEQYF,0,2,1,2
TRBV7-6,TRBJ2-2,CASSLSYTGELFF,0,1,1,1
TRBV7-3,TRBJ1-2,CASSLNSGDGYTF,0,1,1,1
TRBV3-1,TRBJ1-4,CASSPPSNEKLFF,0,1,1,1
TRBV3-1,TRBJ1-5,CASSPTGDQPQHF,0,2,1,2
TRBV3-1,TRBJ1-1,CASSRTDRAEAFF,0,1,1,1
TRBV6-4,TRBJ1-1,CASSGRQGSEAFF,0,1,1,1
TRBV5-1,TRBJ1-1,CASRIRDSEIAFF,0,1,1,1
TRBV29-1,TRBJ2-7,CSVRDRDSYEQYF,0,1,1,1
TRBV29-1,TRBJ1-1,CSVGSPRDTEAFF,0,1,1,1
TRBV29-1,TRBJ2-7,CSVEEDSTYEQYF,0,1,1,1
TRBV29-1,TRBJ1-5,CSATTGSNQPQHF,0,1,1,1
TRBV27,TRBJ2-7,CASGTYTYEQYF,0,1,1,1
TRBV14,TRBJ1-1,CASSQRTGEAFF,0,1,1,1
TRBV2,TRBJ2-1,CASRLGYNEQFF,0,1,1,1
TRBV5-1,TRBJ2-1,CASSADRNEQFF,0,1,1,1
TRBV20-1,TRBJ1-5,CSVGNSNQPQHF,0,1,1,1
TRBV18,TRBJ2-1,CASSPSDEQFF,0,1,1,1
TRBV6-4,TRBJ1-1,CASLFDTEAFF,0,1,1,1
TRBV3-1,TRBJ2-7,CASSFGNEQYF,0,1,1,1
TRBV12-3/4,TRBJ2-1,CASSLRFEQFF,0,1,1,1
TRBV29-1,TRBJ2-5,CSVEVVRTQYF,0,1,1,1
TRBV12-5,TRBJ1-1,CASGLTGQGTEDTEAFF,0,1,1,1
TRBV14,TRBJ1-6,CASSHNGNPYNSPLHF,0,2,1,2
TRBV6-1,TRBJ2-7,CASSEASGSSYEQYF,0,2,1,2
TRBV5-6,TRBJ2-7,CASSSTGPKRYEQYF,0,1,1,1
TRBV30,TRBJ2-7,CAWTPSSGTYEQYF,0,1,1,1
TRBV29-1,TRBJ1-1,CSVGGRMNTEAFF,0,2,1,2
TRBV6-2/3/5/6,TRBJ2-1,CASSYRTDELFF,0,1,1,1
TRBV29-1,TRBJ2-5,CSVDLEQETQYF,0,1,1,1
TRBV12-3/4,TRBJ1-2,CASSFVGGTNYGYTF,0,1,1,1
TRBV7-2,TRBJ1-4,CASSLRDRVEKLFF,0,1,1,1
TRBV5-1,TRBJ1-1,CASGTEGPGTEAFF,0,1,1,1
TRBV30,TRBJ1-2,CAWGQVPFGYTF,0,1,1,1
TRBV18,TRBJ1-5,WASSPSVNQPQHF,0,1,1,1
TRBV7-8,TRBJ2-2,CASSSRGAGGPVNTGELFF,0,1,1,1
TRBV29-1,TRBJ2-1,CSVDGLDAGGPSSYNEQFF,0,1,1,1
TRBV10-3,TRBJ1-2,CAISESPGPRVTLYGYTF,0,1,1,1
TRBV24-1,TRBJ1-3,CATSDSGSETTSGNTIYF,0,1,1,1
TRBV19,TRBJ2-1,CASSIVPGGISYNEQFF,0,1,1,1
TRBV12-3/4,TRBJ2-1,CASSPPRQGKGYNEQFF,0,1,1,1
TRBV6-1,TRBJ1-5,CASSEHRGRLSNQPQHF,0,1,1,1
TRBV5-6,TRBJ2-7,CASSLGLTSGDSYEQYF,0,1,1,1
TRBV12-3/4,TRBJ2-1,CASSPTSGGNSYNEQFF,0,1,1,1
TRBV4-3,TRBJ2-1,CASSRSPGTSGPNEQFF,0,1,1,1
TRBV29-1,TRBJ2-1,CSVPGTGLAGGWYVQFF,0,1,1,1
TRBV10-3,TRBJ1-5,CAISESSGVGNQPQHF,0,1,1,1
TRBV19,TRBJ1-5,CASSLQQGRGNQPQHF,0,1,1,1
TRBV19,TRBJ2-1,CASSRPGSLPTMRQFF,0,1,1,1
TRBV2,TRBJ2-6,CASAGLSGSGANVLTF,0,1,1,1
TRBV6-2/3/5/6,TRBJ2-7,CASTNIRWGDTYEQYF,0,1,1,1
TRBV27,TRBJ1-4,CASSLNWVDPDEKLFF,0,1,1,1
TRBV2,TRBJ2-1,CASSSYGLAAYNEQFF,0,1,1,1
TRBV6-2/3/5/6,TRBJ1-4,CASSYSVGPRNEKLFF,0,1,1,1
TRBV6-2/3/5/6,TRBJ1-5,CASSPSVGDKNQPQHF,0,1,1,1
TRBV6-4,TRBJ1-6,CASSTERQAGNSPLHF,0,1,1,1
TRBV5-8,TRBJ2-3,CASSLDRDSGTDTQYF,0,1,1,1
TRBV7-8,TRBJ1-4,CASSLEGDTYNEKLFF,0,1,1,1
TRBV7-8,TRBJ2-1,CASSLRSGPFANEQFF,0,1,1,1
TRBV14,TRBJ2-7,CASSQVLGAISYEQYF,0,1,1,1
TRBV7-9,TRBJ1-1,CASRSTGSTLNTEAFF,0,1,1,1
TRBV5-1,TRBJ2-1,CASSLDVTSSYNEQFF,0,1,1,1
TRBV5-1,TRBJ1-5,CASSPGTGGGNQPQHF,0,1,1,1
TRBV20-1,TRBJ1-5,CSAGPGTGISNQPQHF,0,1,1,1
TRBV20-1,TRBJ2-3,CSARGLERGGLDTQYF,0,1,1,1
TRBV29-1,TRBJ2-3,CSVEGVLGGLSDTQYF,0,1,1,1
TRBV12-5,TRBJ2-2,CASGLESGVPGELFF,0,1,1,1
TRBV18,TRBJ2-5,CASSPSSGTRETQYF,0,1,1,1
TRBV7-2,TRBJ1-2,CASQPTGSLNYGYTF,0,1,1,1
TRBV27,TRBJ2-1,CASTSATGGLNEQFF,0,1,1,1
TRBV12-3/4,TRBJ2-4,CASSLSRGAKNIQYF,0,1,1,1
TRBV5-6,TRBJ2-7,CASSQLAEVRDEQYF,0,1,1,1
TRBV6-1,TRBJ2-3,CASSEGSGSTDTQYF,0,1,1,1
TRBV5-6,TRBJ1-5,CASSFGQEINQPQHF,0,1,1,1
TRBV7-6,TRBJ2-3,CASSLGWAGADTQYF,0,1,1,1
TRBV11-2,TRBJ1-2,CASSLGAGTNYGYTF,0,1,1,1
TRBV7-2,TRBJ2-5,CASSLESGGQEAQYF,0,1,1,1
TRBV13,TRBJ2-1,CASSLELAAYNEQFF,0,1,1,1
TRBV11-2,TRBJ1-3,CASSSTLGSGNTIYF,0,1,1,1
TRBV7-2,TRBJ1-2,CASSSGASNNYGYTF,0,1,1,1
TRBV7-2,TRBJ2-7,CASSSNSGMSYEQYF,0,3,1,3
TRBV7-3,TRBJ2-6,CASSSSLSGANVLTF,0,1,1,1
TRBV11-2,TRBJ2-5,CASSLGGKPQETQYF,0,1,1,1
TRBV7-9,TRBJ1-5,CASSLTGDSNQPQHF,0,1,1,1
TRBV3-1,TRBJ2-7,CASSPGHGNSYEQYF,0,1,1,1
TRBV7-6,TRBJ2-3,CASSPTAIRTDTQYF,0,1,1,1
TRBV27,TRBJ1-5,CASSPFGAINQPQHF,0,1,1,1
TRBV7-2,TRBJ2-7,CASSPRGDRVYEQYF,0,1,1,1
TRBV3-1,TRBJ2-5,CASSRRTSGPETQYF,0,2,1,2
TRBV2,TRBJ2-1,CASSQSGTAYNEQFF,0,1,1,1
TRBV11-2,TRBJ2-3,CASSVSGPNTDTQYF,0,1,1,1
TRBV5-8,TRBJ2-5,CASSENRGRRETQYF,0,1,1,1
TRBV7-6,TRBJ2-7,CASSISEGTLYEQYF,0,1,1,1
TRBV7-9,TRBJ2-2,CASSILAGEAGELFF,0,1,1,1
TRBV19,TRBJ2-5,CTSSRQGGIQETQYF,0,1,1,1
TRBV5-1,TRBJ2-2,CASSLDSANTGELFF,0,1,1,1
TRBV5-1,TRBJ1-1,CASSAMVGIGTEAFF,0,1,1,1
TRBV20-1,TRBJ2-7,CSARGGSGRTNEQYF,0,1,1,1
TRBV20-1,TRBJ2-1,CSAREGSRLGNEQFF,0,1,1,1
TRBV29-1,TRBJ1-1,CSVAGQGPTNTEAFF,0,1,1,1
TRBV29-1,TRBJ2-7,CSVEDRAGGPYEQYF,0,1,1,1
TRBV29-1,TRBJ2-1,CSVRGTSGSSNEQFF,0,1,1,1
TRBV30,TRBJ1-1,CAWSGRLSNTEAFF,0,1,1,1
TRBV24-1,TRBJ2-2,CAATGRPNTGELFF,0,1,1,1
TRBV10-3,TRBJ1-2,CAIESGDSNYGYTF,0,1,1,1
TRBV10-3,TRBJ1-5,CAIRGDRDGQPQHF,0,1,1,1
TRBV18,TRBJ1-5,CASATGTRNQPQHF,0,1,1,1
TRBV19,TRBJ1-2,CASTQSTVIGGYTF,0,1,1,1
TRBV7-8,TRBJ2-7,CASSLGPNFYEQYF,0,1,1,1
TRBV7-9,TRBJ1-6,CASSLYPERSPLHF,0,1,1,1
TRBV7-2,TRBJ1-2,CASSLAGQLYGYTF,0,1,1,1
TRBV7-2,TRBJ2-7,CASSLASGRHEQYF,0,1,1,1
TRBV7-2,TRBJ1-3,CASSLEQTGNTIYF,0,1,1,1
TRBV7-9,TRBJ2-5,CASSLRTSEETQYF,0,1,1,1
TRBV6-4,TRBJ1-1,CASSSLWVNTEAFF,0,1,1,1
TRBV7-8,TRBJ1-1,CASSSYRKNTEAFF,0,1,1,1
TRBV7-2,TRBJ2-1,CASSLLQGDSEQFF,0,1,1,1
TRBV28,TRBJ2-5,CASSPPWAGKTQYF,0,1,1,1
TRBV6-2/3/5/6,TRBJ2-3,CASRWTGGTDTQYF,0,1,1,1
TRBV19,TRBJ1-6,CTSRSSRFGSPLHF,0,1,1,1
TRBV5-1,TRBJ2-2,CASTKGSNTGELFF,0,1,1,1
TRBV5-1,TRBJ1-3,CASSLELSGNTIYF,0,1,1,1
TRBV5-1,TRBJ1-2,CASSLEDASPGYTF,0,1,1,1
TRBV4-3,TRBJ2-3,CASSQDGASHTQYF,0,2,1,2
TRBV4-1,TRBJ2-5,CASSQEPGGETQYF,0,1,1,1
TRBV20-1,TRBJ2-7,CSARAAGRSYEQYF,0,1,1,1
TRBV20-1,TRBJ2-1,CSAKAGGPKDEQFF,0,1,1,1
TRBV29-1,TRBJ2-7,CSVAGEGQGYEQYF,0,1,1,1
TRBV29-1,TRBJ1-2,CSVEFQGGILGYTF,0,1,1,1
TRBV29-1,TRBJ2-3,CSVDRGLSTDTQYF,0,1,1,1
TRBV29-1,TRBJ2-3,CSVTTRVSTDTQYF,0,1,1,1
TRBV29-1,TRBJ2-1,CSARQGAGMNEQFF,0,2,1,2
TRBV29-1,TRBJ1-1,CSILHRDKNTEAFF,0,1,1,1
TRBV30,TRBJ1-5,CAWSRDSNQPQHF,0,1,1,1
TRBV19,TRBJ2-1,CASSMGGWNEQFF,0,1,1,1
TRBV12-3/4,TRBJ1-2,CASSLFQGEGYTF,0,1,1,1
TRBV3-1,TRBJ2-7,CASSLGQGGEQYF,0,1,1,1
TRBV7-2,TRBJ1-6,CASSTAGNSPLHF,0,1,1,1
TRBV7-2,TRBJ1-2,CASSFGQLYGYTF,0,1,1,1
TRBV11-3,TRBJ2-1,CASSPGREGEQFF,0,1,1,1
TRBV3-1,TRBJ2-3,CASSQGSTDTQYF,0,1,1,1
TRBV11-3,TRBJ1-1,CASRRRMNTEAFF,0,2,1,2
TRBV6-2/3/5/6,TRBJ1-5,CASRQGNNQPQHF,0,2,1,2
TRBV2,TRBJ2-2,CASRALVAGELFF,0,2,1,2
TRBV6-2/3/5/6,TRBJ2-2,CASKKRNTGELFF,0,1,1,1
TRBV5-1,TRBJ1-2,CASSLAQGFGYTF,0,1,1,1
TRBV5-1,TRBJ2-7,CASSLDRAYEQYF,0,1,1,1
TRBV20-1,TRBJ2-3,CSATLAGGDTQYF,0,1,1,1
TRBV29-1,TRBJ2-5,CSVARASQETQYF,0,1,1,1
TRBV29-1,TRBJ2-1,CSVGGDALTEQFF,0,2,1,2
TRBV29-1,TRBJ1-5,CSVLQASNQPQHF,0,1,1,1
TRBV7-9,TRBJ2-7,RASSPTGSYEQYF,0,1,1,1
TRBV30,TRBJ2-7,CAWSGGPREQYF,0,1,1,1
TRBV25-1,TRBJ2-7,CASSDLGYEQYF,0,2,1,2
TRBV11-2,TRBJ2-5,CASSLDSETQYF,0,1,1,1
TRBV5-1,TRBJ2-5,CASSLGKETQYF,0,1,1,1
TRBV29-1,TRBJ1-2,CSVADSYYGYTF,0,1,1,1
TRBV29-1,TRBJ1-2,CSVEPGGYGYTF,0,1,1,1
TRBV29-1,TRBJ1-1,CSGETGFAEAFF,0,1,1,1
TRBV29-1,TRBJ2-5,CSDRWFGETQYF,0,1,1,1
TRBV9,TRBJ1-2,CASGAIYGYTF,0,1,1,1
TRBV9,TRBJ1-2,CASSLFYGYTF,0,1,1,1
TRBV14,TRBJ1-1,CASSHHTEAFF,0,1,1,1
TRBV29-1,TRBJ2-5,CSPLSGETQYF,0,1,1,1
TRBV29-1,TRBJ1-2,CSVEDLGGYTF,0,1,1,1
TRBV29-1,TRBJ1-1,CSVRDSGEAFF,0,1,1,1
TRBV2,TRBJ2-1,CASLYNEQFF,0,1,1,1
TRBV2,TRBJ2-1,CASGNPEQFF,0,1,1,1
TRBV29-1,TRBJ1-1,CSVGTAEAFF,0,1,1,1
TRBV27,TRBJ2-1,CASSFSGNSYNEQFF,0,1,1,1
TRBV6-2/3/5/6,TRBJ1-5,CASSYSWGAGQPQHF,0,1,1,1
TRBV7-2,TRBJ2-7,CASSLEGQVNYEQYF,0,1,1,1
TRBV2,TRBJ1-2,CASRWDESGTDGYTF,0,1,1,1
TRBV5-1,TRBJ1-1,CATHADRETNTEAFF,0,1,1,1
TRBV7-9,TRBJ2-5,CASSTGGFETQYF,0,1,1,1
TRBV29-1,TRBJ1-5,CSVGANGQPQHF,0,1,1,1
TRBV2,TRBJ1-2,CASSAPLSSDSKNYGYTF,0,1,1,1
TRBV10-3,TRBJ1-1,CAISALRQGTNTEAFF,0,1,1,1
TRBV19,TRBJ2-2,CASSIQGRPGTGELFF,0,2,1,2
TRBV7-2,TRBJ1-5,CASSLNGPGIGQPQHS,0,1,1,1
TRBV5-1,TRBJ2-1,CASSFNWDRSSHEQFF,0,1,1,1
TRBV11-3,TRBJ2-1,CASSSAGETYNEQFF,0,1,1,1
TRBV3-1,TRBJ2-6,CASSSRVVGANVLTF,0,1,1,1
TRBV12-3/4,TRBJ2-7,CASRQGGKANEQYF,0,1,1,1
TRBV20-1,TRBJ1-3,CGAKPAGRGNTIYF,0,1,1,1
TRBV20-1,TRBJ2-3,CSARVRPSTDTQYF,0,1,1,1
TRBV7-9,TRBJ1-2,CASSLRSNGYTF,0,1,1,1
TRBV14,TRBJ2-7,CASSQEGPEQYF,0,1,1,1
TRBV19,TRBJ1-5,CASSYRLGTEESAASNQPQHF,0,1,1,1
TRBV7-2,TRBJ2-6,CASITRGQGLYGAGANVLTF,0,1,1,1
TRBV11-2,TRBJ2-3,CASSHPGTGGDWDTDTQYF,0,1,1,1
TRBV20-1,TRBJ1-1,CSARDGGGRGSELNTEAFF,0,1,1,1
TRBV12-5,TRBJ2-3,CASGLGLAGGISTDTQYF,0,1,1,1
TRBV19,TRBJ1-2,CASSDERVLVGWNYGYTF,0,1,1,1
TRBV6-2/3/5/6,TRBJ2-3,CASSSKSGGPTTRDTQYF,0,1,1,1
TRBV7-9,TRBJ2-5,CASSLGVFGRDYQETQYF,0,1,1,1
TRBV29-1,TRBJ2-1,CSVQQRGAGAGPYNEQFF,0,1,1,1
TRBV29-1,TRBJ2-6,CSVLSERQGATGANVLTF,0,1,1,1
TRBV24-1,TRBJ2-1,CATSDTLLAGSYNEQFF,0,1,1,1
TRBV19,TRBJ1-1,CASSIDESQPVNTEAFF,0,1,1,1
TRBV19,TRBJ1-5,CASSITWDRGPIQPQHF,0,1,1,1
TRBV6-2/3/5/6,TRBJ1-1,CASSYHGQGGMNTEAFF,0,1,1,1
TRBV5-4,TRBJ2-1,CAVRGLAGGSSYNEQFF,0,1,1,1
TRBV20-1,TRBJ2-6,CSAAEMGVGSGANVLTF,0,1,1,1
TRBV30,TRBJ2-2,CAWSPEPGLEAGELFF,0,1,1,1
TRBV7-2,TRBJ2-1,CAILRGGKSSYNEQFF,0,1,1,1
TRBV19,TRBJ2-2,CASRKLEPANTGELFF,0,1,1,1
TRBV18,TRBJ2-5,CASSPPPRGRGETQYF,0,2,1,2
TRBV12-3/4,TRBJ2-3,CASSFSGTGGTDTQYF,0,1,1,1
TRBV12-3/4,TRBJ1-1,CASSFGDTPSRTEAFF,0,1,1,1
TRBV6-1,TRBJ2-1,CASSKTGSGRGDEQFF,0,1,1,1
TRBV7-9,TRBJ2-6,CASSFTRTAGANVLTF,0,1,1,1
TRBV7-2,TRBJ1-2,CASSLALGDRAGGYTF,0,1,1,1
TRBV7-9,TRBJ2-3,CASSPPGGPHIDTQYF,0,1,1,1
TRBV3-1,TRBJ2-1,CASSQLAGVQNNEQFF,0,1,1,1
TRBV11-3,TRBJ2-5,CASSAPDRGVEETQYF,0,1,1,1
TRBV7-2,TRBJ2-5,CASSAQLAGGGETQYF,0,1,1,1
TRBV5-4,TRBJ2-3,CASSIRLATSTDTQYF,0,1,1,1
TRBV28,TRBJ2-7,CASRSPLGRDTYEQYF,0,1,1,1
TRBV12-3/4,TRBJ1-4,CASRSRLHGGNEKLFF,0,1,1,1
TRBV5-1,TRBJ2-6,CASTHNRGSGANVLTF,0,1,1,1
TRBV5-1,TRBJ2-5,CASSLGGLAGRETQYF,0,1,1,1
TRBV5-1,TRBJ2-6,CASSSLQGSGANVLTF,0,1,1,1
TRBV5-1,TRBJ2-7,CASSPRRDRSSYEQYF,0,1,1,1
TRBV5-1,TRBJ1-1,CASSPNKPEMNTEASF,0,1,1,1
TRBV5-1,TRBJ1-1,CASSGYTGAGDTEAFF,0,1,1,1
TRBV20-1,TRBJ1-4,CSARDIVGQGSEKLFF,0,1,1,1
TRBV29-1,TRBJ2-1,CSVEDGTGGLQNEQFF,0,1,1,1
TRBV12-5,TRBJ2-3,CASGSPQAFTDTQYF,0,1,1,1
TRBV30,TRBJ2-4,CAWRADNTYKNIQYF,0,1,1,1
TRBV10-3,TRBJ2-7,CAISESREGRREQYF,0,1,1,1
TRBV19,TRBJ1-2,CASRSGWDFNYGYTF,0,1,1,1
TRBV7-8,TRBJ2-1,CASTSPPGGQVEQFF,0,1,1,1
TRBV7-6,TRBJ2-3,CASTPRTAGVDTQYF,0,1,1,1
TRBV12-3/4,TRBJ1-4,CASSFSGAGNEKLFF,0,1,1,1
TRBV6-2/3/5/6,TRBJ1-1,CASSLQEHLNTEAFF,0,1,1,1
TRBV6-2/3/5/6,TRBJ2-3,CASSWLTTSGDTQYF,0,1,1,1
TRBV12-3/4,TRBJ1-5,CASSVSGGVYQPQHF,0,1,1,1
TRBV12-3/4,TRBJ2-7,CASSAPASGGYEQYF,0,1,1,1
TRBV6-4,TRBJ1-5,CASSAEGLANQPQHF,0,1,1,1
TRBV7-2,TRBJ1-2,CASSLAGFIDYGYTF,0,1,1,1
TRBV7-9,TRBJ1-2,CASSLVSGTGGGYTF,0,1,1,1
TRBV11-2,TRBJ1-1,CASSLGQYMNTEAFF,0,1,1,1
TRBV7-2,TRBJ2-1,CASSLDQTSSNEQFF,0,1,1,1
TRBV5-4,TRBJ2-7,CASSPSSGRIHEQYF,0,1,1,1
TRBV6-2/3/5/6,TRBJ2-3,CASSPSEGATDTQYF,0,1,1,1
TRBV7-9,TRBJ2-7,CASSPPTGGSGEQYF,0,1,1,1
TRBV7-2,TRBJ2-7,CASSHSGRVTYEQYF,0,2,1,2
TRBV3-1,TRBJ1-5,CASSQEGGSNQPQHF,0,1,1,1
TRBV9,TRBJ2-5,CASSVEQGPQETQYF,0,1,1,1
TRBV14,TRBJ2-7,CASSAPGLGVYEQYF,0,1,1,1
TRBV25-1,TRBJ2-3,CASKGTSESTDTQYF,0,1,1,1
TRBV5-1,TRBJ2-1,CASSLGLVDNNEQFF,0,1,1,1
TRBV5-1,TRBJ2-1,CASSLDSLGRDEQFF,0,1,1,1
TRBV5-1,TRBJ2-7,CASSLEGTAGGAQYF,0,1,1,1
TRBV5-1,TRBJ2-5,CASSLTTDNQETQYF,0,1,1,1
TRBV4-1,TRBJ1-5,CASSQDLRSNQPQHF,0,1,1,1
TRBV20-1,TRBJ2-1,CSAWPVGGPNNEQFF,0,1,1,1
TRBV20-1,TRBJ2-6,CSARPQGSGANVLTF,0,1,1,1
TRBV20-1,TRBJ1-1,CSARDFQVMNTEAFF,0,1,1,1
TRBV20-1,TRBJ2-7,CSARDPDYSVYEQYF,0,1,1,1
TRBV20-1,TRBJ2-1,CSARSGRSSYNEQFF,0,1,1,1
TRBV29-1,TRBJ2-4,CSVEDVQGAKNIQYF,0,1,1,1
TRBV29-1,TRBJ2-3,CSTGGPAGSTDTQYF,0,1,1,1
TRBV7-2,TRBJ2-1,RASSYRTGAYNEQFF,0,1,1,1
TRBV12-5,TRBJ1-1,CASGFLGLGNEAFF,0,1,1,1
TRBV10-3,TRBJ2-7,CAIKHRDRDLEQYF,0,1,1,1
TRBV19,TRBJ2-3,CASTRTYATDTQYF,0,1,1,1
TRBV19,TRBJ2-7,CASSSDIFSYEQYF,0,1,1,1
TRBV19,TRBJ1-1,CASNDRGPNTEAFF,0,1,1,1
TRBV18,TRBJ1-4,CASSPLAFNEKPFF,0,1,1,1
TRBV27,TRBJ2-1,CASSSSGIYNEQFF,0,1,1,1
TRBV12-3/4,TRBJ1-2,CASSSDTGVDRYTF,0,1,1,1
TRBV6-2/3/5/6,TRBJ2-7,CASSPGQGNYEQCF,0,1,1,1
TRBV2,TRBJ2-7,CASSDKTHSYEQYF,0,1,1,1
TRBV25-1,TRBJ2-5,CASSEFVGTETQYF,0,1,1,1
TRBV6-1,TRBJ1-5,CASSETSLSMTQHF,0,1,1,1
TRBV7-6,TRBJ1-5,CASSFGAVNQPQHF,0,1,1,1
TRBV7-6,TRBJ1-1,CASSFSGRDTEAFF,0,1,1,1
TRBV7-2,TRBJ2-2,CASSLFGNTGELFF,0,1,1,1
TRBV7-6,TRBJ2-7,CASSLGGRTYEQYF,0,1,1,1
TRBV11-2,TRBJ2-5,CASSLGTTQETQYF,0,1,1,1
TRBV6-2/3/5/6,TRBJ1-1,CASSLGQPNTEAFF,0,1,1,1
TRBV7-9,TRBJ2-5,CASSSLAGSETQYF,0,1,1,1
TRBV5-5,TRBJ2-7,CASSLGSVSYEQYF,0,1,1,1
TRBV7-2,TRBJ1-5,CASSLNPGNQPQHF,0,1,1,1
TRBV5-4,TRBJ1-2,CASSLGGTGGGYTF,0,1,1,1
TRBV2,TRBJ1-5,CASSLTGGYQPQHF,0,2,1,2
TRBV7-2,TRBJ1-1,CASSLDRFSTEAFF,0,2,1,2
TRBV14,TRBJ1-4,CASSQPTGNEKLFF,0,1,1,1
TRBV7-2,TRBJ2-7,CASSQQGDLYEQYF,0,1,1,1
TRBV14,TRBJ2-7,CASSQVGDYYEQYF,0,1,1,1
TRBV7-9,TRBJ2-5,CASSDGLGGETQYF,0,1,1,1
TRBV7-2,TRBJ1-5,CASSMTGVGQPQHF,0,1,1,1
TRBV5-4,TRBJ2-5,CASSTPTGGETQYF,0,1,1,1
TRBV5-4,TRBJ1-5,CASSRQGSGQPQHF,0,1,1,1
TRBV6-2/3/5/6,TRBJ2-7,CASKQTSSSYEQYF,0,1,1,1
TRBV2,TRBJ2-6,CARGQLSGANVLTF,0,1,1,1
TRBV5-1,TRBJ1-5,CASTWGPGGQPQHF,0,1,1,1
TRBV5-1,TRBJ2-6,CASTPASGANVLTF,0,1,1,1
TRBV4-3,TRBJ2-7,CASSQARFSYEQYF,0,1,1,1
TRBV20-1,TRBJ1-1,CSAKMVGRNTEAFF,0,1,1,1
TRBV29-1,TRBJ2-6,CSATFPTGANVLTF,0,1,1,1
TRBV29-1,TRBJ1-1,CSLEQGAGNTEAFF,0,1,1,1
TRBV29-1,TRBJ2-3,CSVARGLRTDTQYF,0,1,1,1
TRBV29-1,TRBJ2-5,CSVEQTGAQETQYF,0,1,1,1
TRBV29-1,TRBJ1-5,CSVIPDGRNQPQHF,0,1,1,1
TRBV30,TRBJ2-2,CAWTLGWTGELFF,0,3,1,3
TRBV30,TRBJ1-2,CAWSKEHYYGYTF,0,1,1,1
TRBV10-3,TRBJ1-5,CAISEYSNQPQHF,0,1,1,1
TRBV25-1,TRBJ2-7,CATSVDTFYEQYF,0,1,1,1
TRBV18,TRBJ2-1,CASSLGENNEQFF,0,1,1,1
TRBV2,TRBJ1-1,CASTQGENTEAFF,0,1,1,1
TRBV12-3/4,TRBJ1-2,CASSLSVDYGYTF,0,1,1,1
TRBV7-2,TRBJ1-1,CASSPHRDGEAFF,0,1,1,1
TRBV6-2/3/5/6,TRBJ2-4,CASSTGLQNIQYF,0,1,1,1
TRBV7-8,TRBJ2-7,CASSFQGYYEQYF,0,1,1,1
TRBV7-2,TRBJ2-3,CASSFGITDTQYF,0,1,1,1
TRBV11-3,TRBJ2-5,CASSFRGWETQYF,0,1,1,1
TRBV7-2,TRBJ2-3,CASSLARGETQYF,0,1,1,1
TRBV7-2,TRBJ2-7,CASSSLIQSEQYF,0,1,1,1
TRBV5-6,TRBJ1-1,CASSPHFGTEAFS,0,1,1,1
TRBV13,TRBJ2-3,CASSPLPTDTQYF,0,1,1,1
TRBV7-2,TRBJ1-5,CASSRTGSQPQHF,0,1,1,1
TRBV5-5,TRBJ2-7,CASSQTGIDEQYF,0,1,1,1
TRBV3-1,TRBJ1-1,CASSQVGGAEAFF,0,1,1,1
TRBV7-9,TRBJ2-2,CASSQMPTGELFF,0,1,1,1
TRBV12-3/4,TRBJ2-2,CASRVLGPGELFF,0,1,1,1
TRBV5-1,TRBJ2-1,CASSLAQTNEQFF,0,1,1,1
TRBV4-1,TRBJ2-1,CASSLQGGYEQFF,0,1,1,1
TRBV4-1,TRBJ2-1,CASSQDAGHEQFF,0,1,1,1
TRBV20-1,TRBJ1-3,CGGQGFSGNTIYF,0,1,1,1
TRBV20-1,TRBJ2-3,CSLDRRVGDTQYF,0,1,1,1
TRBV29-1,TRBJ2-1,CSVEEVSPGLALF,0,1,1,1
TRBV29-1,TRBJ1-5,CSASDFSNQPQHF,0,1,1,1
TRBV29-1,TRBJ2-1,CSGWTGGFNEQFF,0,1,1,1
TRBV29-1,TRBJ2-2,RSGRVVQAGELFF,0,1,1,1
TRBV6-2/3/5/6,TRBJ1-2,SASSLDRDYGYTF,0,1,1,1
TRBV5-4,TRBJ1-2,CACSGDTYGYTF,0,1,1,1
TRBV30,TRBJ1-5,CAWSATNQPQHF,0,2,1,2
TRBV5-6,TRBJ2-7,CASGARSYEQYF,0,1,1,1
TRBV28,TRBJ1-5,CASSLSVQPQHF,0,1,1,1
TRBV6-2/3/5/6,TRBJ2-7,CASSYSSYEQYF,0,1,1,1
TRBV6-2/3/5/6,TRBJ1-1,CASSYRRQEAFF,0,1,1,1
TRBV11-2,TRBJ2-1,CASSSWPDEQFF,0,1,1,1
TRBV11-3,TRBJ2-2,CASSPEARELFF,0,1,1,1
TRBV3-1,TRBJ2-7,CASSHHSYEQYF,0,1,1,1
TRBV5-1,TRBJ2-2,CASSFNTGELFF,0,1,1,1
TRBV20-1,TRBJ2-3,CSARDPLDAQYF,0,1,1,1
TRBV29-1,TRBJ2-1,CSVVQGWNEQFF,0,1,1,1
TRBV29-1,TRBJ2-5,CSVVTGTTTQYF,0,1,1,1
TRBV29-1,TRBJ1-1,CSVEENRAEAFF,0,1,1,1
TRBV29-1,TRBJ2-1,CSVARGHNEQFF,0,1,1,1
TRBV7-9,TRBJ1-5,RASSPYNQPQHF,0,1,1,1
TRBV12-3/4,TRBJ1-1,CASSIVRKAFF,0,1,1,1
TRBV7-9,TRBJ2-5,CASSLGETQYF,0,1,1,1
TRBV7-8,TRBJ2-1,CASSPNSEQFF,0,1,1,1
TRBV7-9,TRBJ2-1,CASSTLDEQFF,0,1,1,1
TRBV29-1,TRBJ2-5,CSVEVGETQYF,0,1,1,1
TRBV3-1,TRBJ1-1,CASSGPEAFF,0,1,1,1
TRBV29-1,TRBJ1-2,CSVDTYGYTF,0,1,1,1
TRBV7-6,TRBJ1-2,CASSLLGQGGTNYGYTF,0,2,1,2
TRBV5-1,TRBJ1-3,CASSSWGQADSGNTIYF,0,1,1,1
TRBV7-9,TRBJ2-7,CASSLTVGGRGNEQYF,0,1,1,1
TRBV2,TRBJ2-1,CASTPGLGACNEQFF,0,1,1,1
TRBV4-1,TRBJ2-7,CASSSWGGSDHEQYF,0,1,1,1
TRBV20-1,TRBJ2-2,CSAREGTSDTGELFF,0,1,1,1
TRBV7-2,TRBJ2-7,CASSLTGGGYGQYF,0,1,1,1
TRBV7-9,TRBJ2-5,CASRPQGFETQYF,0,1,1,1
TRBV20-1,TRBJ2-7,CSANREDLYEQYF,0,2,1,2
TRBV29-1,TRBJ2-4,CSVGEGNIQCF,0,1,1,1
TRBV7-2,TRBJ1-1,CASSPLPTGGDSLGAEAFF,0,1,1,1
TRBV5-1,TRBJ2-6,CASSRGDSDSSGANVLTF,0,1,1,1
TRBV4-1,TRBJ2-7,CASSQGVSFSGLAYEQYF,0,1,1,1
TRBV4-1,TRBJ2-7,CASSPRGPGGVDERYF,0,1,1,1
TRBV20-1,TRBJ2-7,CSARNIDRDEQYF,0,1,1,1
TRBV6-2/3/5/6,TRBJ1-3,CASSWRTPGQGRTSGNTIYF,0,1,1,1
TRBV6-2/3/5/6,TRBJ1-5,CASSYSRDRGYSNQPQHF,0,1,1,1
TRBV7-2,TRBJ2-1,CASSLAVRAAGGMDEQFF,0,1,1,1
TRBV9,TRBJ1-2,CASSPHMTTQPFNYGYTF,0,1,1,1
TRBV3-1,TRBJ2-1,CASSPSEAGTSSYNEQFF,0,1,1,1
TRBV14,TRBJ1-1,CASSQDIFGVGMNTEAFF,0,1,1,1
TRBV29-1,TRBJ2-1,CSVEAQEFDRIPYNEQFF,0,1,1,1
TRBV10-3,TRBJ1-2,CAISNGPFSSTGHGYTS,0,1,1,1
TRBV19,TRBJ1-2,CASSTRGQYLTNYGYTF,0,1,1,1
TRBV6-2/3/5/6,TRBJ1-6,CASISTRRSSYNSPLHF,0,1,1,1
TRBV28,TRBJ1-1,CASSLLQGAAANTEAFF,0,1,1,1
TRBV11-2,TRBJ2-1,CASSLGAASGSFYEQFF,0,1,1,1
TRBV7-2,TRBJ1-5,CASSLGASRDRGQPQHF,0,1,1,1
TRBV13,TRBJ2-5,CASSLEGFGGRQETQYF,0,2,1,2
TRBV7-6,TRBJ2-1,CASSLLYSGSAYNEQFF,0,1,1,1
TRBV7-2,TRBJ2-7,CASSHPGLAGGSYEQYF,0,1,1,1
TRBV14,TRBJ1-5,CASSQPDGEYWNQPQHF,0,1,1,1
TRBV7-9,TRBJ2-1,CASSGIAVGLAGVEQFF,0,1,1,1
TRBV5-4,TRBJ2-5,CASSRGASGSGEETQYF,0,1,1,1
TRBV5-1,TRBJ2-3,CASSAKGRGMGTDTQYF,0,1,1,1
TRBV29-1,TRBJ2-1,CSVEGIKGFDPYNEQFF,0,1,1,1
TRBV30,TRBJ2-7,CAWSVIRGRGYNEQYF,0,1,1,1
TRBV19,TRBJ1-1,CASSGQGAGENTEAFF,0,1,1,1
TRBV19,TRBJ1-2,CASRKPGQADSLGYTF,0,1,1,1
TRBV18,TRBJ2-3,CASSPGLAGATDTQYF,0,1,1,1
TRBV18,TRBJ2-1,CASSPPLAGVGNEQFF,0,1,1,1
TRBV3-1,TRBJ1-4,CASGSARVLSREKLFF,0,1,1,1
TRBV12-3/4,TRBJ2-5,CASSFFGGPYQETQYF,0,1,1,1
TRBV6-2/3/5/6,TRBJ2-7,CASSLITGPGRYEQYF,0,1,1,1
TRBV9,TRBJ2-1,CASSSSGGPPDNEQFF,0,1,1,1
TRBV12-3/4,TRBJ1-6,CASSRILGQGWSPLHF,0,1,1,1
TRBV6-1,TRBJ2-7,CASSAEGTSGSHEQYF,0,1,1,1
TRBV7-9,TRBJ1-1,CASSFTTDPKYTEAFF,0,1,1,1
TRBV5-6,TRBJ2-1,CASSLLDRGHLNEQFF,0,1,1,1
TRBV7-2,TRBJ2-4,CASSLSPLGVKNIQYF,0,1,1,1
TRBV7-2,TRBJ2-2,CASSLMGGQHTGELFF,0,1,1,1
TRBV5-6,TRBJ1-4,CASSSNSRRSSEKLFF,0,1,1,1
TRBV5-6,TRBJ2-1,CASSLTSGRANNEQFF,0,1,1,1
TRBV7-9,TRBJ1-1,CASSLGDRVWNTEAFF,0,1,1,1
TRBV7-9,TRBJ2-1,CASSPGRDSPYNEQFF,0,1,1,1
TRBV3-1,TRBJ2-2,CASSQDIGARTGELFF,0,1,1,1
TRBV7-2,TRBJ2-7,CASSVGQGAVSYEQYF,0,1,1,1
TRBV4-2,TRBJ2-3,CASSVPGTSGTDTQYF,0,1,1,1
TRBV5-5,TRBJ2-7,CASSGSGSGSIYEQYF,0,1,1,1
TRBV7-2,TRBJ1-3,CASSTRQGSVGNTIYF,0,1,1,1
TRBV10-1,TRBJ2-3,CASSDSSGANTDTQYF,0,1,1,1
TRBV5-1,TRBJ2-1,CASSTTGTGIYNEQFF,0,1,1,1
TRBV20-1,TRBJ1-5,CSAPEPGGDGNQPQHF,0,1,1,1
TRBV20-1,TRBJ1-6,CSASEGTGQGNSPLHL,0,1,1,1
TRBV29-1,TRBJ2-1,CSVVPSGSRRLNEQFF,0,1,1,1
TRBV6-2/3/5/6,TRBJ2-1,CACSPRLAEYNEQFF,0,1,1,1
TRBV30,TRBJ2-7,CAWMIQGQGRYEQYF,0,1,1,1
TRBV30,TRBJ2-2,CAWSVRWANTGELFF,0,1,1,1
TRBV10-3,TRBJ2-3,CAISNGREGQDTQYF,0,1,1,1
TRBV10-3,TRBJ1-6,CAISVDPGGYSPLHF,0,1,1,1
TRBV24-1,TRBJ2-3,CATSDTGTTTDTQYF,0,1,1,1
TRBV5-6,TRBJ2-7,CASFPGLAVVYEQYF,0,1,1,1
TRBV19,TRBJ2-3,CASSIPTGVTDTQYF,0,1,1,1
TRBV19,TRBJ2-1,CASSTLAGGVNEQFF,0,1,1,1
TRBV19,TRBJ1-6,CASSTQGADNSPLHF,0,1,1,1
TRBV19,TRBJ1-2,CASNHPPTGNYGYTF,0,1,1,1
TRBV19,TRBJ2-1,CASKRVDSGYNEQFF,0,1,1,1
TRBV28,TRBJ2-1,CASRPTGPRGNEQFF,0,1,1,1
TRBV11-2,TRBJ2-7,CASTLTGGRLSEQYF,0,1,1,1
TRBV28,TRBJ1-1,CASSLRAELNTEAFF,0,1,1,1
TRBV6-2/3/5/6,TRBJ2-2,CASSSGLGGAGELFF,0,1,1,1
TRBV6-2/3/5/6,TRBJ2-1,CASSYWGQGGNEQFF,0,1,1,1
TRBV6-2/3/5/6,TRBJ2-7,CASSYPATGSYEQYF,0,1,1,1
TRBV27,TRBJ2-3,CASSYAGLAGDTQYF,0,1,1,1
TRBV12-3/4,TRBJ2-1,CASSPLAGGRNEQFF,0,1,1,1
TRBV2,TRBJ1-2,CASSEFRTEDYGYTF,0,1,1,1
TRBV2,TRBJ2-5,CASSELGTAQETQYF,0,1,1,1
TRBV12-3/4,TRBJ1-5,CASSTGTGDNQPQHF,0,1,1,1
TRBV7-2,TRBJ2-1,CASSFRTLTYNEQFF,0,1,1,1
TRBV11-2,TRBJ2-1,CASSFGQYTYNEQFF,0,1,1,1
TRBV5-8,TRBJ2-1,CASSLGDGVYNEQFL,0,1,1,1
TRBV7-2,TRBJ1-4,CASSLGSGGHEKLFF,0,1,1,1
TRBV7-9,TRBJ2-7,CASSLGAGVRYEQYF,0,1,1,1
TRBV7-6,TRBJ2-5,CASSLEAGHQETQYF,0,1,1,1
TRBV7-9,TRBJ2-5,CASSLKGAREETQYF,0,1,1,1
TRBV5-6,TRBJ1-1,CASSSGTGGYTEAFF,0,1,1,1
TRBV5-5,TRBJ2-3,CASSSRGERGDTQYF,0,1,1,1
TRBV7-9,TRBJ2-3,CASSSRIAGADTQYF,0,1,1,1
TRBV5-5,TRBJ1-2,CASSWPGQSGYGYTF,0,1,1,1
TRBV5-4,TRBJ2-1,CASSLDRGSYNEQFF,0,1,1,1
TRBV7-9,TRBJ2-7,CASSPLDLTSYEQYF,0,1,1,1
TRBV11-2,TRBJ1-1,CASSPGRGPGTEAFF,0,1,1,1
TRBV7-9,TRBJ2-1,CASSPRVAGGKEQFF,0,1,1,1
TRBV3-1,TRBJ1-1,CASSQPGESGTEAFF,0,1,1,1
TRBV3-1,TRBJ2-1,CASSQRTRGYNEQFF,0,1,1,1
TRBV14,TRBJ2-5,CASSQQVGGQETQYF,0,1,1,1
TRBV3-1,TRBJ2-7,CASSQVDWTGYEQYF,0,1,1,1
TRBV3-1,TRBJ2-3,CASSQGWEGEDTQYF,0,1,1,1
TRBV3-1,TRBJ2-5,CASSQEASYQETQYF,0,1,1,1
TRBV9,TRBJ2-3,CASSVGLKSTDTQYF,0,1,1,1
TRBV6-2/3/5/6,TRBJ1-6,CASSVDGEMDSPLHF,0,1,1,1
TRBV14,TRBJ2-3,CASSAQLASTDTQYF,0,1,1,1
TRBV6-1,TRBJ1-2,CASSEPRDGVYGYTF,0,1,1,1
TRBV5-6,TRBJ1-1,CASSSPGEGNTEAFF,0,2,1,2
TRBV5-1,TRBJ2-2,CASGRLAGDTGELFF,0,2,1,2
TRBV5-1,TRBJ2-1,CASSLVDSSYNEQFF,0,1,1,1
TRBV5-1,TRBJ1-1,CASSLGPWQATEAFF,0,1,1,1
TRBV4-3,TRBJ2-2,CASSLYATGPLELFF,0,1,1,1
TRBV5-1,TRBJ1-2,CASSPEGQGRDGYTF,0,1,1,1
TRBV5-1,TRBJ2-2,CASSRSTTNTGELFF,0,1,1,1
TRBV4-3,TRBJ1-1,CASSHRQGFGFEAFF,0,1,1,1
TRBV20-1,TRBJ2-1,CSAPSTSGRAGEQFF,0,1,1,1
TRBV20-1,TRBJ2-1,CSARPTSGSLNEQFF,0,1,1,1
TRBV20-1,TRBJ2-5,CSARDFQGKQETQYF,0,1,1,1
TRBV20-1,TRBJ2-3,CSARDRILSTDTQYF,0,1,1,1
TRBV29-1,TRBJ2-1,CSPSSGPRDYNEQFF,0,1,1,1
TRBV14,TRBJ2-7,SASSQDGAGVPEQYF,0,1,1,1
TRBV30,TRBJ2-3,CAWTMSGRGGTQYF,0,1,1,1
TRBV30,TRBJ1-5,CAWSGVTINQPQHF,0,1,1,1
TRBV30,TRBJ1-1,CAWSEGHLNTEAFF,0,1,1,1
TRBV30,TRBJ2-1,CAWSTPGRGNEQFF,0,1,1,1
TRBV24-1,TRBJ2-1,CATSDPTGSHEQFF,0,1,1,1
TRBV19,TRBJ2-7,CASTLRWEGYEQYF,0,1,1,1
TRBV11-3,TRBJ2-5,CASRDRALRRAQYF,0,1,1,1
TRBV19,TRBJ2-3,CASKTLAETDTQYF,0,1,1,1
TRBV2,TRBJ2-5,CASRGLAGQETQYF,0,1,1,1
TRBV6-4,TRBJ2-7,CASRGLLGFHEQYF,0,1,1,1
TRBV9,TRBJ2-3,CASGDRADTDTQYF,0,1,1,1
TRBV27,TRBJ2-7,CASSFTTVSYEQYF,0,1,1,1
TRBV2,TRBJ1-1,CASSLETVNTEAFF,0,1,1,1
TRBV12-3/4,TRBJ1-1,CASSLTGANSEAFF,0,1,1,1
TRBV6-2/3/5/6,TRBJ2-7,CASSYPAETYEQYF,0,1,1,1
TRBV6-2/3/5/6,TRBJ2-7,CASSYSERAYEQYF,0,1,1,1
TRBV28,TRBJ1-1,CASSLPTQATEAFF,0,1,1,1
TRBV6-2/3/5/6,TRBJ2-6,CASSLAGGANVLTF,0,1,1,1
TRBV6-2/3/5/6,TRBJ2-1,CASSLVAGVGEQFF,0,1,1,1
TRBV12-3/4,TRBJ1-2,CASSPPWTAYGYTF,0,1,1,1
TRBV12-3/4,TRBJ1-1,CASSPPAGLTEAFF,0,1,1,1
TRBV7-2,TRBJ2-3,CASSPGLPTDTQYF,0,1,1,1
TRBV7-9,TRBJ2-5,CASSRDRGRETQYF,0,1,1,1
TRBV28,TRBJ1-5,CASSQAGMGQPQHF,0,1,1,1
TRBV2,TRBJ2-3,CASSGLTVPDTQYF,0,1,1,1
TRBV6-4,TRBJ2-1,CASSEETEDNEQFF,0,1,1,1
TRBV2,TRBJ2-7,CASSEASGSQEQYF,0,1,1,1
TRBV7-9,TRBJ1-1,CASSLSQGATEAFF,0,1,1,1
TRBV7-9,TRBJ2-1,CASSLAAGADEQFF,0,1,1,1
TRBV7-2,TRBJ1-2,CASSLELDNYGYTF,0,1,1,1
TRBV11-1,TRBJ2-1,CASSLEREGNEQFF,0,1,1,1
TRBV2,TRBJ2-7,CASSLKAVSYEQYF,0,1,1,1
TRBV7-9,TRBJ2-1,CASSSGREFAEQFF,0,1,1,1
TRBV6-2/3/5/6,TRBJ2-1,CASSYSGTYNEQFF,0,1,1,1
TRBV7-9,TRBJ1-1,CASSLDPPNTEAFF,0,1,1,1
TRBV3-1,TRBJ1-4,CASSPRDTNEKLFF,0,1,1,1
TRBV7-9,TRBJ2-7,CASSRGSQSSEQYF,0,1,1,1
TRBV7-2,TRBJ2-7,CASSRRMKEYEQYF,0,1,1,1
TRBV7-8,TRBJ1-4,CASSVSTTNEKLFF,0,1,1,1
TRBV7-2,TRBJ1-2,CASSAGGDPSRYTF,0,1,1,1
TRBV9,TRBJ2-1,CASSASSSYSEQFF,0,1,1,1
TRBV6-2/3/5/6,TRBJ2-7,CASSTTGASYEQYF,0,1,1,1
TRBV2,TRBJ1-1,CASRAPAIETEAFF,0,1,1,1
TRBV2,TRBJ1-1,CASRGDPGGTEAFF,0,1,1,1
TRBV2,TRBJ1-1,CASRTDRMNTEAFF,0,1,1,1
TRBV6-2/3/5/6,TRBJ2-2,CTSSYSRVPGELFF,0,1,1,1
TRBV5-1,TRBJ2-1,CASSLEGRYNEQFF,0,1,1,1
TRBV5-1,TRBJ2-4,CASSSASRGNIQYF,0,1,1,1
TRBV4-3,TRBJ2-3,CASSQGSSADTQYF,0,1,1,1
TRBV4-1,TRBJ2-5,CASSQGQGAETQYF,0,1,1,1
TRBV4-1,TRBJ1-2,CASSATGDGYGYTF,0,1,1,1
TRBV5-1,TRBJ2-1,CASSTGTGRNEQFF,0,1,1,1
TRBV4-1,TRBJ2-7,CASRPGQQSYEQYF,0,1,1,1
TRBV5-1,TRBJ2-1,CASRGTGPRNEQFF,0,1,1,1
TRBV20-1,TRBJ2-2,CSASKTANTGELFF,0,1,1,1
TRBV20-1,TRBJ2-6,CSARTGVGANVLTF,0,1,1,1
TRBV20-1,TRBJ2-3,CSAHAGLASNTQYF,0,1,1,1
TRBV29-1,TRBJ2-7,CSVVRDSSSYEQYF,0,1,1,1
TRBV29-1,TRBJ2-2,CSVEGSQNTGELFF,0,1,1,1
TRBV29-1,TRBJ2-2,CSVTYPSNTGELFF,0,1,1,1
TRBV29-1,TRBJ2-3,CSVRGQGSSDTQYF,0,1,1,1
TRBV29-1,TRBJ1-1,CSGRESPGRREAFF,0,1,1,1
TRBV29-1,TRBJ1-2,CRVEDMREGDGYTF,0,1,1,1
TRBV19,TRBJ1-1,RASILSQGNTEAFF,0,1,1,1
TRBV5-1,TRBJ2-7,RASSLNRGWNEQYF,0,1,1,1
TRBV5-1,TRBJ1-4,RASSQTMGSEKLFF,0,1,1,1
TRBV30,TRBJ1-4,CAWASSLFEKLFF,0,1,1,1
TRBV30,TRBJ2-3,CAWTGGGTDTQYF,0,1,1,1
TRBV18,TRBJ1-5,CAGSPGANQPQHF,0,1,1,1
TRBV7-9,TRBJ1-1,CASCGQGNAEAFF,0,1,1,1
TRBV28,TRBJ2-5,CASGMTGEETQYF,0,1,1,1
TRBV19,TRBJ2-5,CASSRQAGETQYF,0,1,1,1
TRBV19,TRBJ2-7,CASSINQLGEQYF,0,1,1,1
TRBV18,TRBJ2-7,CASSQGAAYEQYF,0,1,1,1
TRBV18,TRBJ2-2,CASSPIGTGELFF,0,1,1,1
TRBV2,TRBJ2-7,CASGGTARWEQYF,0,1,1,1
TRBV6-2/3/5/6,TRBJ1-4,CASGGNLRGKLFF,0,1,1,1
TRBV28,TRBJ1-1,CASITSRNTEAFF,0,1,1,1
TRBV6-2/3/5/6,TRBJ2-1,CASTYWIEGEQFF,0,1,1,1
TRBV12-3/4,TRBJ1-1,CASSFGRNTEAFF,0,1,1,1
TRBV6-2/3/5/6,TRBJ2-5,CASSWREPRTQYF,0,1,1,1
TRBV6-2/3/5/6,TRBJ1-1,CASSYSGDVEAFF,0,1,1,1
TRBV6-2/3/5/6,TRBJ1-1,CASSYDERTEALF,0,1,1,1
TRBV7-9,TRBJ1-5,CASSPNTDQPQHF,0,1,1,1
TRBV2,TRBJ2-1,CASSETGGNEQFF,0,1,1,1
TRBV5-4,TRBJ2-4,CASSLAGKNIQYF,0,1,1,1
TRBV11-2,TRBJ2-1,CASSLASNSEQFF,0,1,1,1
TRBV7-2,TRBJ2-3,CASSLGLTDTQYF,0,1,1,1
TRBV11-2,TRBJ2-7,CASSLESRGEQYF,0,1,1,1
TRBV7-9,TRBJ1-1,CASSPTRDTEAFF,0,1,1,1
TRBV7-9,TRBJ1-2,CASSDDRGPGYTF,0,1,1,1
TRBV7-2,TRBJ1-2,CASSRDRNYGYTF,0,1,1,1
TRBV6-2/3/5/6,TRBJ1-2,CASRTGTGEGYTF,0,1,1,1
TRBV5-1,TRBJ1-5,CAGARVSNQPQHF,0,1,1,1
TRBV5-1,TRBJ2-1,CASTKQGGNEQFF,0,1,1,1
TRBV5-1,TRBJ2-7,CASSLVQGYEQYF,0,1,1,1
TRBV5-1,TRBJ2-7,CASSLGPRGEEDF,0,1,1,1
TRBV5-1,TRBJ2-7,CASSLDQWGEEYF,0,1,1,1
TRBV5-1,TRBJ2-7,CASKFMEGGEQYF,0,1,1,1
TRBV20-1,TRBJ2-1,CSVLAGPYNEQFF,0,1,1,1
TRBV20-1,TRBJ2-2,CSASKAMFGELFF,0,1,1,1
TRBV20-1,TRBJ2-1,CSARVTSGNEQSF,0,1,1,1
TRBV20-1,TRBJ2-3,CSAPGQGVDTQYF,0,1,1,1
TRBV29-1,TRBJ1-1,CSVFPGSNTEAFF,0,1,1,1
TRBV29-1,TRBJ1-5,CSVAIQSNQPQHF,0,1,1,1
TRBV29-1,TRBJ2-1,CSVGGTSLKEQFF,0,1,1,1
TRBV29-1,TRBJ1-4,CSAQGKANEKLFF,0,1,1,1
TRBV29-1,TRBJ2-7,CSAEGTGVNEQYF,0,1,1,1
TRBV7-6,TRBJ2-7,RASSSRISYEQYF,0,1,1,1
TRBV30,TRBJ2-1,CAWDGSGFEQFF,0,1,1,1
TRBV10-3,TRBJ2-7,CAIRKGAYEQYF,0,1,1,1
TRBV15,TRBJ2-7,CATSRDFGEQYF,0,1,1,1
TRBV19,TRBJ2-2,CASSLQSGELFF,0,1,1,1
TRBV27,TRBJ2-7,CASFGTNYEQYF,0,1,1,1
TRBV18,TRBJ2-3,CASSPPTDTQYF,0,1,1,1
TRBV12-3/4,TRBJ2-7,CASSLAIYEQYF,0,1,1,1
TRBV5-6,TRBJ1-4,CASSPDQGQLFF,0,1,1,1
TRBV7-2,TRBJ1-3,CASSVFGNTIYF,0,1,1,1
TRBV5-6,TRBJ2-7,CASSSPGLEQYF,0,1,1,1
TRBV2,TRBJ2-3,CASSLEGDTQYF,0,1,1,1
TRBV11-2,TRBJ2-5,CASSPQQETQYF,0,1,1,1
TRBV3-1,TRBJ1-1,CASSQTNTEAFF,0,1,1,1
TRBV7-6,TRBJ2-5,CASSMAGETQYF,0,2,1,2
TRBV28,TRBJ1-2,CASRYRGYGYTF,0,1,1,1
TRBV11-3,TRBJ2-1,CASRGGAGEQFF,0,1,1,1
TRBV10-2,TRBJ2-7,CASSTRFYEQYF,0,1,1,1
TRBV4-1,TRBJ2-3,CASSLPADTQYF,0,1,1,1
TRBV4-3,TRBJ2-2,CASSHLGGELFF,0,1,1,1
TRBV29-1,TRBJ2-1,CSLQGPYNEQFF,0,1,1,1
TRBV20-1,TRBJ2-1,CSAVRLADEQFF,0,1,1,1
TRBV20-1,TRBJ2-5,CSAKWFAETQYF,0,1,1,1
TRBV29-1,TRBJ1-5,CSVGQSNQPQHF,0,1,1,1
TRBV29-1,TRBJ1-2,CSVEDGVWGYTF,0,1,1,1
TRBV29-1,TRBJ2-1,CSVVPADNEQFF,0,1,1,1
TRBV29-1,TRBJ2-1,CSVRTPEWGQFF,0,2,1,2
TRBV29-1,TRBJ2-5,CSARETGETQYF,0,1,1,1
TRBV29-1,TRBJ1-2,CSGGQGNYGYTF,0,1,1,1
TRBV6-2/3/5/6,TRBJ2-2,CASGMGGELFF,0,1,1,1
TRBV6-2/3/5/6,TRBJ1-2,CASSYGYGYTF,0,1,1,1
TRBV6-4,TRBJ2-3,CASSDPDTQYF,0,1,1,1
TRBV5-6,TRBJ2-3,CASSLWDTQYF,0,1,1,1
TRBV14,TRBJ2-7,CASSSNYEQYF,0,1,1,1
TRBV7-8,TRBJ2-7,CASSVYYEQYF,0,1,1,1
TRBV14,TRBJ2-3,CASSTEDTQYF,0,1,1,1
TRBV6-1,TRBJ2-3,CASRNRDTQYF,0,1,1,1
TRBV20-1,TRBJ2-1,CSAGLEDEQFF,0,1,1,1
TRBV29-1,TRBJ1-2,CSAGWDYGYTF,0,1,1,1
TRBV29-1,TRBJ1-1,CSAGTSEAFF,0,1,1,1
TRBV29-1,TRBJ1-1,CSGGDTEAFF,0,1,1,1
TRBV6-4,TRBJ1-5,CASSQPQHF,0,1,1,1
TRBV4-2,TRBJ2-7,CASSQDIVTQGPRLEQYF,0,1,1,1
TRBV20-1,TRBJ2-1,CSATRLAGGIFAGNEQFF,0,1,1,1
TRBV5-4,TRBJ1-6,YASSLGTGERLRNSPLHF,0,2,1,2
TRBV5-1,TRBJ1-1,CASSSTTGGAGTEAFF,0,1,1,1
TRBV2,TRBJ1-4,CASGGQAVFGEKLFF,0,1,1,1
TRBV4-1,TRBJ1-2,CASSQESQTIGYTF,0,1,1,1
TRBV20-1,TRBJ1-5,CSANDRGGNQPQHF,0,2,1,2
TRBV29-1,TRBJ2-2,CSVQEGVNTGELFF,0,1,1,1
TRBV30,TRBJ2-1,RAWKTGGSRNEQFF,0,1,1,1
TRBV7-2,TRBJ2-5,CASSFLQETQYF,0,2,1,2
TRBV6-2/3/5/6,TRBJ1-5,CASSLEGTQHF,0,1,1,1
TRBV24-1,TRBJ2-1,CATSDPGLAGRSSYNEQFF,0,1,1,1
TRBV19,TRBJ2-1,CASSIEGTGGIMSYNEQFF,0,1,1,1
TRBV6-2/3/5/6,TRBJ1-2,CASSFLEGMKTAANYGYTF,0,1,1,1
TRBV3-1,TRBJ2-3,CASSQDSYVTSDATDTQYF,0,1,1,1
TRBV29-1,TRBJ2-6,CSVEDRVSSHPLGANVLTF,0,1,1,1
TRBV12-5,TRBJ2-7,CASGSLPWGIFPSYEQYF,0,1,1,1
TRBV30,TRBJ2-7,CAWSVKGTAGHDFYEQYF,0,1,1,1
TRBV5-1,TRBJ2-6,CASSPVPRGKAGANVLTF,0,1,1,1
TRBV12-5,TRBJ2-7,CASGFGEREGLTYEQYF,0,1,1,1
TRBV7-3,TRBJ1-5,CASSFTTGNEGGQPQHF,0,1,1,1
TRBV6-2/3/5/6,TRBJ1-6,CASSYSNYIQTESPLHF,0,1,1,1
TRBV6-2/3/5/6,TRBJ2-1,CASSYLITGPLYNEQFF,0,1,1,1
TRBV6-1,TRBJ2-4,CASSQLRGGDIKNIQYF,0,1,1,1
TRBV5-6,TRBJ2-7,CASSLEQTGGFRYEQYF,0,1,1,1
TRBV7-6,TRBJ2-5,CASSSFTGTSGQETQYF,0,1,1,1
TRBV7-2,TRBJ2-7,CASSSTAEGDFSYEQYF,0,1,1,1
TRBV12-3/4,TRBJ2-6,CASSWDNQLSGANVLTF,0,2,1,2
TRBV14,TRBJ2-2,CASSYRQGAANTGELFF,0,1,1,1
TRBV3-1,TRBJ2-3,CASSPVPGTGLGDTQYL,0,1,1,1
TRBV5-6,TRBJ1-1,CASSPGQKKPMNTEAFL,0,1,1,1
TRBV12-3/4,TRBJ2-3,CASSPGTSGIRTDTQYF,0,1,1,1
TRBV5-6,TRBJ2-4,CASSRSGLADLGNIQYF,0,1,1,1
TRBV3-1,TRBJ1-2,CASSQALQEYLTGGYTF,0,1,1,1
TRBV7-2,TRBJ2-2,CASSKGLAGTNTGELFF,0,1,1,1
TRBV24-1,TRBJ2-3,CTTSDTTGTGDTDTQYF,0,1,1,1
TRBV5-1,TRBJ2-7,CASSFQGAGGPNYEQYF,0,1,1,1
TRBV4-3,TRBJ2-3,CASSPSLTSGRQDTQYF,0,1,1,1
TRBV4-3,TRBJ2-3,CASSQDLGSRRTDTQYF,0,1,1,1
TRBV20-1,TRBJ1-4,CSASLTETWATNEKLSF,0,1,1,1
TRBV29-1,TRBJ2-1,CSVARARKLAGVNEQFF,0,1,1,1
TRBV11-2,TRBJ2-4,CAGTPGGLLAKNFQYF,0,1,1,1
TRBV15,TRBJ2-1,CATSRRTGISYNEQFF,0,1,1,1
TRBV19,TRBJ2-4,CASSSRAEGAKNIQYF,0,1,1,1
TRBV19,TRBJ1-5,CASSPGRAYSNQPQHF,0,1,1,1
TRBV19,TRBJ2-1,CASSPTLAGSYNEQFF,0,1,1,1
TRBV19,TRBJ2-7,CASSRLPGTSTDEQYF,0,1,1,1
TRBV18,TRBJ2-3,CASSPRASDSTDTQYF,0,1,1,1
TRBV2,TRBJ2-3,CASLKLHSGRTDTQYF,0,1,1,1
TRBV6-2/3/5/6,TRBJ1-3,CASSYPQGSSGNTIYF,0,1,1,1
TRBV6-2/3/5/6,TRBJ1-1,CASSYSPAWGVTEAFF,0,1,1,1
TRBV6-2/3/5/6,TRBJ2-1,CASSYSESGPRNEQFF,0,1,1,1
TRBV6-2/3/5/6,TRBJ1-5,CASSYSSQGNNQPQHF,0,1,1,1
TRBV12-3/4,TRBJ2-6,CASSLYSAMGANVLTF,0,1,1,1
TRBV6-2/3/5/6,TRBJ2-3,CASSPRTGGIGDTQYF,0,1,1,1
TRBV2,TRBJ2-7,CASSEASLTYSYEQYF,0,1,1,1
TRBV2,TRBJ2-2,CASSEGIGPYTGELFF,0,1,1,1
TRBV2,TRBJ2-7,CASSEESRDPPCEQYF,0,1,1,1
TRBV7-2,TRBJ2-1,CASSLGGLAYYNEQFF,0,1,1,1
TRBV7-9,TRBJ1-4,CASSLSPGMGEEKLFF,0,1,1,1
TRBV7-3,TRBJ2-1,CASSLQGLAGANEQFF,0,1,1,1
TRBV7-2,TRBJ2-4,CASSLVGTGVKNIQYF,0,1,1,1
TRBV7-9,TRBJ2-6,CASSLAWGAGANVLTF,0,1,1,1
TRBV13,TRBJ2-2,CASSLTSGTKTGELFF,0,1,1,1
TRBV5-5,TRBJ2-3,CASSWAGSPETDTQYF,0,1,1,1
TRBV7-9,TRBJ2-7,CASSLRRETGAYEQYF,0,1,1,1
TRBV7-3,TRBJ2-1,CASSLTGTGGYNEQFF,0,1,1,1
TRBV3-1,TRBJ2-5,CASSPFGFDFKETQYF,0,1,1,1
TRBV7-9,TRBJ1-6,CASSPASGTGNSPLHF,0,1,1,1
TRBV7-9,TRBJ1-1,CASSRPGTGVGTEAFF,0,1,1,1
TRBV7-8,TRBJ1-1,CASSQEGGATNTEAFF,0,1,1,1
TRBV14,TRBJ2-7,CASSQEQGRTLGGQYF,0,1,1,1
TRBV9,TRBJ1-1,CASSVDQTVGNTEAFF,0,1,1,1
TRBV9,TRBJ2-7,CASSVAPSGQGYEQYF,0,1,1,1
TRBV6-1,TRBJ2-7,CASSVAGGNNFREQYF,0,1,1,1
TRBV9,TRBJ2-3,CASSVIPGGPTDTQYF,0,1,1,1
TRBV5-4,TRBJ2-7,CASSAIFGTKNHEQYF,0,1,1,1
TRBV9,TRBJ1-6,CASSAASDRGSSPLHF,0,1,1,1
TRBV6-1,TRBJ2-6,CASSEGRNSGANVLTF,0,1,1,1
TRBV6-2/3/5/6,TRBJ2-3,CASRPSGRALSDTQYF,0,1,1,1
TRBV4-3,TRBJ1-3,CAGSQDVYSSGNTIYF,0,1,1,1
TRBV5-1,TRBJ2-1,CASSLGGGVGYNEQFF,0,1,1,1
TRBV5-1,TRBJ2-7,CASSLGGSGISYEQYF,0,1,1,1
TRBV5-1,TRBJ1-1,CASSLDRVPSGLGAFF,0,1,1,1
TRBV4-3,TRBJ2-1,CASSQERSGVYNEQFF,0,1,1,1
TRBV5-1,TRBJ2-1,CASSTGQGSSYNEQFF,0,1,1,1
TRBV20-1,TRBJ1-5,CSASRGAGAVDQPQHF,0,1,1,1
TRBV29-1,TRBJ1-1,CSGLGTGKIAGLEAFF,0,1,1,1
TRBV12-5,TRBJ2-5,CASGTGLAGEETQYF,0,1,1,1
TRBV7-8,TRBJ2-5,CACSLSHQLLETQYF,0,1,1,1
TRBV30,TRBJ2-1,CAWDPGLAGGDEQFF,0,1,1,1
TRBV30,TRBJ2-7,CAWSPVDSQATEQYF,0,1,1,1
TRBV12-3/4,TRBJ1-1,CATRPPTEMNTEAFF,0,1,1,1
TRBV2,TRBJ2-2,CATLLGAAGTGELFF,0,1,1,1
TRBV24-1,TRBJ2-1,CATSDLVAGGTEQFF,0,1,1,1
TRBV15,TRBJ1-5,CATSIRDAHNQPQHF,0,1,1,1
TRBV19,TRBJ1-5,CASSFRRDRGQPQHF,0,1,1,1
TRBV19,TRBJ1-1,CASSLGQGGSTEAFF,0,1,1,1
TRBV19,TRBJ2-7,CASSARAGVSYEQYF,0,1,1,1
TRBV19,TRBJ2-1,CASSTGLAGYNEQFF,0,1,1,1
TRBV19,TRBJ1-1,CASSAYGTVNTEAFS,0,1,1,1
TRBV19,TRBJ1-6,CASSDHGTGSSPLHF,0,1,1,1
TRBV19,TRBJ1-5,CASNRGDRGYQPQHF,0,1,1,1
TRBV6-2/3/5/6,TRBJ2-7,CASSRALRGSYEQYF,0,1,1,1
TRBV6-4,TRBJ1-1,CASGDRGPMNTEAFF,0,1,1,1
TRBV27,TRBJ2-1,CASTMGGGSYNEQFI,0,1,1,1
TRBV6-2/3/5/6,TRBJ2-5,CASSLGGEPQETQYF,0,1,1,1
TRBV12-3/4,TRBJ1-5,CASSLRTGGVGPQHF,0,1,1,1
TRBV7-9,TRBJ2-6,CASSSRGSGANVLTF,0,1,1,1
TRBV6-4,TRBJ2-2,CASSRQGRATGELFF,0,1,1,1
TRBV25-1,TRBJ2-3,CASSVSGASTDTQYF,0,1,1,1
TRBV6-1,TRBJ1-3,CASSAQGNPGNTIYF,0,1,1,1
TRBV6-1,TRBJ2-4,CASSDRRVSKNIQYF,0,1,1,1
TRBV12-3/4,TRBJ1-1,CASSELRGANTEAFF,0,1,1,1
TRBV12-3/4,TRBJ2-7,CASSMGPWVGYEQYF,0,1,1,1
TRBV7-2,TRBJ1-1,CASSFRASGNTEAFF,0,1,1,1
TRBV3-1,TRBJ2-1,CASSFMGGNKNEQFF,0,1,1,1
TRBV7-2,TRBJ2-1,CASSLQESSYNEQFF,0,1,1,1
TRBV5-5,TRBJ1-5,CASSLAPGARQPQHF,0,1,1,1
TRBV5-5,TRBJ1-2,CASSLAGRDYYGYTF,0,1,1,1
TRBV7-8,TRBJ1-2,CASSLLGGSTYGYTF,0,1,1,1
TRBV7-6,TRBJ2-5,CASSLVPGGQETQYF,0,1,1,1
TRBV7-2,TRBJ2-7,CASSLVRVLSYEQYF,0,1,1,1
TRBV7-9,TRBJ2-7,CASSLGDRNFYEQYF,0,1,1,1
TRBV7-9,TRBJ1-2,CASSLGRDGNYGYTF,0,1,1,1
TRBV7-3,TRBJ2-2,CASSLNGGNTGELFF,0,1,1,1
TRBV6-4,TRBJ2-3,CASSSTGQGADTQYF,0,1,1,1
TRBV9,TRBJ2-1,CASSSRGGRYNEQFF,0,1,1,1
TRBV14,TRBJ2-1,CASSLVAGGYNEQFF,0,1,1,1
TRBV5-4,TRBJ1-2,CASSLGGGDDYGYTF,0,1,1,1
TRBV5-4,TRBJ2-2,CASSLGLAESGELFF,0,1,1,1
TRBV6-4,TRBJ1-2,CASSLGQGANYGYTF,0,1,1,1
TRBV7-2,TRBJ1-6,CASSPFSSYNSPLHF,0,1,1,1
TRBV7-9,TRBJ2-3,CASSPGLGSTDTQYF,0,1,1,1
TRBV7-2,TRBJ2-3,CASSPGQGVGDTQYF,0,1,1,1
TRBV7-2,TRBJ1-1,CASSPTARAMAEAFF,0,1,1,1
TRBV5-4,TRBJ2-1,CASSPKGLAGNEQFF,0,1,1,1
TRBV13,TRBJ2-1,CASSPRLAEYNEQFF,0,1,1,1
TRBV3-1,TRBJ2-1,CASSPELAGENEQFF,0,1,1,1
TRBV3-1,TRBJ2-7,CASSRSGDRDYEQYF,0,1,1,1
TRBV7-2,TRBJ2-7,CASSRPGQRSYEQYF,0,1,1,1
TRBV6-1,TRBJ2-5,CASSRLGGPPETQYF,0,1,1,1
TRBV3-1,TRBJ1-2,CASSQGQGYAYGYTF,0,1,1,1
TRBV14,TRBJ1-2,CASSQDSIQSYGYTF,0,1,1,1
TRBV4-2,TRBJ1-2,CASSQETGPYYGYTF,0,1,1,1
TRBV9,TRBJ1-4,CASSVGGGQVEKLFF,0,1,1,1
TRBV9,TRBJ2-3,CASSESGGTTDTQYF,0,1,1,1
TRBV9,TRBJ2-7,CASSERGGFPYEQYF,0,1,1,1
TRBV12-3/4,TRBJ2-1,CASRVAGGPTREQFF,0,1,1,1
TRBV5-1,TRBJ2-4,CASGLAQGRVNIQYF,0,1,1,1
TRBV5-1,TRBJ2-5,CASIPTVPKGETQYF,0,1,1,1
TRBV10-1,TRBJ2-5,CASSARGGRQETQYF,0,1,1,1
TRBV5-1,TRBJ1-1,CASSLVTGVNTEAFF,0,1,1,1
TRBV5-1,TRBJ2-3,CASSLGGRGTDTQYF,0,1,1,1
TRBV5-1,TRBJ1-4,CASSLTGQATEKLCF,0,1,1,1
TRBV11-2,TRBJ2-7,CASSLEPGANSEQYF,0,1,1,1
TRBV5-1,TRBJ1-2,CASSSTPGIPRGYTF,0,1,1,1
TRBV5-1,TRBJ1-1,CASSLNLGMNTEAFF,0,1,1,1
TRBV4-1,TRBJ1-1,CASSQDRQGDTEAFF,0,1,1,1
TRBV4-1,TRBJ2-1,CASSQDRTSTNEQFF,0,1,1,1
TRBV4-3,TRBJ2-1,CASSAGTSGNNEQFF,0,1,1,1
TRBV5-1,TRBJ2-1,CASSATSGSKNEQFF,0,1,1,1
TRBV20-1,TRBJ2-6,CSASIRDTGANVLTF,0,1,1,1
TRBV20-1,TRBJ2-1,CSARSLGRIYNEQFF,0,1,1,1
TRBV20-1,TRBJ2-5,CSARDGTSAAATQYF,0,1,1,1
TRBV20-1,TRBJ2-7,CSARDGSGASGEQYF,0,1,1,1
TRBV29-1,TRBJ1-1,CSVPTGGSWNTEAFF,0,1,1,1
TRBV29-1,TRBJ2-1,CSVEGRGRAAGEQFF,0,1,1,1
TRBV29-1,TRBJ2-3,CSAPGVGGFTDTQYF,0,1,1,1
TRBV29-1,TRBJ2-2,CSGALERGGLGELFF,0,1,1,1
TRBV5-1,TRBJ1-4,RASRVNSGANEKLFF,0,1,1,1
TRBV7-2,TRBJ1-2,SASSLRPGNQYGYTF,0,1,1,1
TRBV5-4,TRBJ1-1,CPSSLQGWNTEAFF,0,1,1,1
TRBV12-5,TRBJ1-2,CASGLVARLYGYTF,0,1,1,1
TRBV7-8,TRBJ2-2,CAGSLGDMTGELFF,0,1,1,1
TRBV15,TRBJ2-7,CATSRGDGRYEQYF,0,1,1,1
TRBV27,TRBJ2-5,CATKARDLQETQYF,0,1,1,1
TRBV2,TRBJ1-4,CATGQGMANEKLFF,0,1,1,1
TRBV19,TRBJ1-1,CASTSDRFGRQAFF,0,1,1,1
TRBV19,TRBJ1-1,CASSIRTMKTEAFF,0,1,1,1
TRBV19,TRBJ2-3,CASSIAVRTDTQYY,0,1,1,1
TRBV19,TRBJ1-4,CASRLDRGNEKLFF,0,1,1,1
TRBV12-3/4,TRBJ2-1,CASCRAGPYNEQFF,0,1,1,1
TRBV12-3/4,TRBJ2-1,CASALAGGYNEQFF,0,1,1,1
TRBV7-2,TRBJ2-3,CASGPRQGTDTQYF,0,1,1,1
TRBV25-1,TRBJ1-2,CASEGAWAEYGYTF,0,1,1,1
TRBV2,TRBJ1-2,CASTPGTDNYGYTF,0,1,1,1
TRBV5-6,TRBJ2-4,CASTQGAAKNIQYF,0,1,1,1
TRBV6-2/3/5/6,TRBJ1-4,CASSFSGGDEKLFF,0,1,1,1
TRBV27,TRBJ2-3,CASSFRARLDTQYF,0,1,1,1
TRBV27,TRBJ2-5,CASSLSGQGGTQYF,0,1,1,1
TRBV6-2/3/5/6,TRBJ2-5,CASSYSLHSPTQYF,0,1,1,1
TRBV6-2/3/5/6,TRBJ2-1,CASSYGSSYNEQFF,0,1,1,1
TRBV6-1,TRBJ1-5,CASSATSSNQPQHF,0,1,1,1
TRBV2,TRBJ2-1,CASSELAGGGEQFF,0,1,1,1
TRBV6-1,TRBJ1-3,CASSEQSSGNTIYF,0,1,1,1
TRBV7-9,TRBJ2-7,CASSFSRESYEQYF,0,1,1,1
TRBV7-9,TRBJ2-7,CASSFGRVVSEQYF,0,1,1,1
TRBV5-6,TRBJ1-1,CASSLGQRNTEAFF,0,1,1,1
TRBV5-6,TRBJ2-1,CASSLGRPGNEQFF,0,1,1,1
TRBV7-3,TRBJ2-1,CASSLDRGGGEQFF,0,1,1,1
TRBV7-2,TRBJ2-7,CASSLIPSSYEQYF,0,1,1,1
TRBV7-9,TRBJ2-5,CASSLTGGQETQYF,0,1,1,1
TRBV7-3,TRBJ2-1,CASSLSTKNNEQFF,0,1,1,1
TRBV13,TRBJ2-1,CASSLRTFYNEQFF,0,1,1,1
TRBV7-9,TRBJ2-5,CASSLASEKETQYF,0,1,1,1
TRBV7-2,TRBJ2-3,CASSLGREGDTQYF,0,1,1,1
TRBV11-3,TRBJ2-5,CASSLDDGGETQYF,0,1,1,1
TRBV7-2,TRBJ2-7,CASSLELGTYEQYF,0,1,1,1
TRBV13,TRBJ2-5,CASSSPRARETQYF,0,1,1,1
TRBV7-3,TRBJ2-5,CASSSLGGGETQYF,0,1,1,1
TRBV7-6,TRBJ2-1,CASSSRMRSNEQFF,0,1,1,1
TRBV11-3,TRBJ1-1,CASSSRQGNAVAFF,0,1,1,1
TRBV5-4,TRBJ2-1,CASSYTGGFDEQFF,0,1,1,1
TRBV3-1,TRBJ2-7,CASSLDIASYEQYF,0,1,1,1
TRBV11-1,TRBJ1-1,CASSLTRENTEAFF,0,1,1,1
TRBV7-2,TRBJ2-7,CASSPTGGENEQYF,0,1,1,1
TRBV7-3,TRBJ1-2,CASSRVGRLYGYTF,0,1,1,1
TRBV14,TRBJ1-6,CASSQERAYGPLHF,0,1,1,1
TRBV3-1,TRBJ1-6,CASSTQGTNSPLHF,0,1,1,1
TRBV2,TRBJ1-5,CASSRSIGNQPQHF,0,1,1,1
TRBV5-4,TRBJ2-3,CASRVTGDTDTQYF,0,1,1,1
TRBV28,TRBJ1-1,CASRPTGGNTEAFF,0,1,1,1
TRBV28,TRBJ2-6,CASKPGAGANVLTF,0,1,1,1
TRBV6-2/3/5/6,TRBJ1-1,CARSPRTLNTEAFF,0,1,1,1
TRBV19,TRBJ2-7,CANTSDRVLDEQYF,0,1,1,1
TRBV20-1,TRBJ2-7,CCASSGGDRYEQYF,0,1,1,1
TRBV5-1,TRBJ2-3,CASSFTSGSDTQYF,0,1,1,1
TRBV5-1,TRBJ2-5,CASSLVAAGETQYF,0,1,1,1
TRBV5-1,TRBJ2-7,CASSSTGGSYEQYF,0,1,1,1
TRBV4-1,TRBJ1-2,CASSLDRLTGGYTF,0,1,1,1
TRBV5-1,TRBJ1-2,CASSPGFTRAGYTF,0,1,1,1
TRBV4-1,TRBJ2-1,CASSPKRAGTGQFF,0,1,1,1
TRBV5-1,TRBJ1-4,CASSQGAADEKLFF,0,1,1,1
TRBV5-1,TRBJ2-1,CASRLGGEHNEQFF,0,1,1,1
TRBV20-1,TRBJ1-5,CSASRGQGYQPQHF,0,1,1,1
TRBV20-1,TRBJ2-1,CSARGRGLLNEQFF,0,1,1,1
TRBV20-1,TRBJ2-3,CSARGLGRADTQYF,0,1,1,1
TRBV20-1,TRBJ1-2,CSASPPGQVYGYTF,0,1,1,1
TRBV20-1,TRBJ2-1,CSARGLAAPDEQFF,0,1,1,1
TRBV20-1,TRBJ1-4,CSARKTGKDEKLFF,0,1,1,1
TRBV20-1,TRBJ2-5,CSARQLQEQETQYF,0,1,1,1
TRBV20-1,TRBJ1-1,CSARVGDMDTEAFF,0,1,1,1
TRBV20-1,TRBJ2-7,CSARDRLFTYEQYF,0,1,1,1
TRBV20-1,TRBJ2-5,CSAREIAGGYRQYF,0,1,1,1
TRBV20-1,TRBJ1-4,CSAREQSYNEKLFF,0,1,1,1
TRBV29-1,TRBJ2-3,CSVPRDYPTDTQYF,0,1,1,1
TRBV29-1,TRBJ2-3,CSVEARTSTDTQYF,0,1,1,1
TRBV29-1,TRBJ2-1,CSVENQVGGDEQFF,0,1,1,1
TRBV29-1,TRBJ2-1,CSVSALAGVHEQFF,0,1,1,1
TRBV29-1,TRBJ2-6,CSVTRTGGANVLTF,0,1,1,1
TRBV4-3,TRBJ2-3,YASSQDGLADTQYF,0,1,1,1
TRBV12-5,TRBJ1-5,CASGLVLGQGLLF,0,1,1,1
TRBV12-5,TRBJ2-1,CASGLGLYNEQFF,0,1,1,1
TRBV30,TRBJ1-2,CAWSEDRGYGYTF,0,1,1,1
TRBV30,TRBJ1-1,CAWRRAPNTEAFF,0,1,1,1
TRBV30,TRBJ1-2,CAWRDRGDGGYTF,0,1,1,1
TRBV10-3,TRBJ2-1,CAITSFTDNEQFF,0,1,1,1
TRBV7-9,TRBJ2-2,CATLGTITGELFF,0,1,1,1
TRBV2,TRBJ2-7,CATLTRGSYEQNF,0,1,1,1
TRBV7-9,TRBJ1-2,CATVLGQNYGYTF,0,1,1,1
TRBV24-1,TRBJ1-1,CATSDSGTLEAFF,0,1,1,1
TRBV19,TRBJ1-2,CASTLPGGYGYTF,0,1,1,1
TRBV19,TRBJ2-1,CASSPGQGYEQFF,0,1,1,1
TRBV19,TRBJ1-6,CASSIRIGLPLHF,0,1,1,1
TRBV18,TRBJ2-4,CASSPSGTGAQYF,0,1,1,1
TRBV18,TRBJ1-1,CASSPGGNTEAFF,0,1,1,1
TRBV18,TRBJ1-6,CASSGGRNSPLHF,0,1,1,1
TRBV12-3/4,TRBJ2-5,CASGSKVGVAQYF,0,1,1,1
TRBV7-9,TRBJ2-5,CASTPGQGETQYF,0,1,1,1
TRBV7-9,TRBJ2-7,CASTSTGTYEQYF,0,1,1,1
TRBV28,TRBJ2-2,CASSFTNTGELFF,0,1,1,1
TRBV12-3/4,TRBJ2-7,CASSFRAAYEQYF,0,1,1,1
TRBV6-2/3/5/6,TRBJ1-5,CASSLGGNQPQHF,0,1,1,1
TRBV7-9,TRBJ2-7,CASSLGVWIEQYF,0,1,1,1
TRBV12-3/4,TRBJ1-2,CASSLTENYGYTF,0,1,1,1
TRBV12-3/4,TRBJ1-2,CASSLKLIYGYTF,0,1,1,1
TRBV6-2/3/5/6,TRBJ1-1,CASSYSRRGEAFF,0,1,1,1
TRBV12-3/4,TRBJ1-2,CASSYGQGKIYTF,0,1,1,1
TRBV6-2/3/5/6,TRBJ2-5,CASSLIRQETQCF,0,1,1,1
TRBV2,TRBJ1-5,CASSRDGNQPQHF,0,1,1,1
TRBV2,TRBJ1-2,CASSVTLGYGYTF,0,1,1,1
TRBV25-1,TRBJ1-5,CASSAGSNQPQHF,0,1,1,1
TRBV6-1,TRBJ2-7,CASSGAFGDRENF,0,1,1,1
TRBV7-8,TRBJ1-5,CASSIGGAWPQHF,0,1,1,1
TRBV7-9,TRBJ1-5,CASSFLQGQPQHF,0,1,1,1
TRBV11-3,TRBJ2-1,CASSFVSFNEQFF,0,1,1,1
TRBV11-3,TRBJ1-1,CASSLGQDTEAFF,0,1,1,1
TRBV7-3,TRBJ2-3,CASSLQASGTQYF,0,1,1,1
TRBV7-2,TRBJ1-5,CASSLAKNQPQHF,0,1,1,1
TRBV11-2,TRBJ2-5,CASSLGRAETQYF,0,1,1,1
TRBV7-6,TRBJ2-3,CASSLDAADTQYF,0,1,1,1
TRBV12-3/4,TRBJ1-1,CASSSAGTGKAFF,0,1,1,1
TRBV3-1,TRBJ1-1,CASSLGANTEAFF,0,1,1,1
TRBV7-9,TRBJ2-1,CASSPGTYNEQFF,0,1,1,1
TRBV9,TRBJ2-7,CASSPPRQGEQYF,0,1,1,1
TRBV7-9,TRBJ2-7,CASSPQGEYEQYF,0,1,1,1
TRBV3-1,TRBJ1-4,CASSQDSGSRLFF,0,1,1,1
TRBV14,TRBJ1-1,CASSQDYGNEAFF,0,1,1,1
TRBV4-2,TRBJ2-3,CASSQDSADTQYF,0,1,1,1
TRBV3-1,TRBJ1-1,CASSQERITEAFF,0,1,1,1
TRBV3-1,TRBJ2-3,CASSQIFMDTQYF,0,1,1,1
TRBV3-1,TRBJ1-1,CASSQTRTTEAFF,0,1,1,1
TRBV7-9,TRBJ2-7,CASSTPLRGRQYF,0,1,1,1
TRBV7-6,TRBJ2-3,CASSRLSTDTQYF,0,1,1,1
TRBV9,TRBJ1-4,CASSKGTAEKLFF,0,1,1,1
TRBV6-2/3/5/6,TRBJ2-7,CASRGGKDYEQYF,0,1,1,1
TRBV19,TRBJ1-5,CAKDSPRGQPQHF,0,1,1,1
TRBV5-1,TRBJ1-2,CASSFREGYGYTF,0,1,1,1
TRBV5-1,TRBJ2-7,CASSDGQGYEQYF,0,1,1,1
TRBV20-1,TRBJ2-2,CSAQDRDTGELFF,0,1,1,1
TRBV20-1,TRBJ2-3,CSARWGAPDTQYF,0,1,1,1
TRBV20-1,TRBJ2-7,CSARGAGTYEQYF,0,1,1,1
TRBV20-1,TRBJ2-7,CSARIPGLDEQYF,0,1,1,1
TRBV20-1,TRBJ2-1,CSAPSLAYNEQFF,0,1,1,1
TRBV29-1,TRBJ2-1,CSPINGDRSEQFF,0,1,1,1
TRBV29-1,TRBJ1-2,CSVVVGGTGSYTF,0,1,1,1
TRBV29-1,TRBJ1-4,CSVAGTGVEKLFF,0,2,1,2
TRBV29-1,TRBJ1-2,CSVEDLRSYGYTF,0,1,1,1
TRBV29-1,TRBJ2-2,CSVRTSWGGELFF,0,1,1,1
TRBV29-1,TRBJ2-1,CNCVQGALGEQFF,0,1,1,1
TRBV7-9,TRBJ2-1,YASSLGTYNEQFF,0,1,1,1
TRBV30,TRBJ2-1,CAWSVTSGLLFF,0,1,1,1
TRBV11-2,TRBJ2-1,CAVSLSYNEQFF,0,1,1,1
TRBV2,TRBJ2-1,CASSSSGNEQFF,0,1,1,1
TRBV7-2,TRBJ2-6,CASFGRDDVLTF,0,1,1,1
TRBV2,TRBJ2-7,CASLDGYYEQYF,0,1,1,1
TRBV12-3/4,TRBJ1-1,CASSFGGTEAFF,0,1,1,1
TRBV3-1,TRBJ2-1,CASSLTGNEQFF,0,1,1,1
TRBV7-2,TRBJ2-5,CASSLPGSAQYF,0,1,1,1
TRBV9,TRBJ2-1,CASSSSYNEQFF,0,1,1,1
TRBV3-1,TRBJ2-7,CASSYTGYEQYF,0,1,1,1
TRBV7-8,TRBJ2-1,CASSPNYGEQFF,0,1,1,1
TRBV3-1,TRBJ2-7,CASSQFAAEQYF,0,1,1,1
TRBV14,TRBJ1-2,CASSQEAFGYTF,0,1,1,1
TRBV9,TRBJ2-3,CASSVAVDTQYF,0,1,1,1
TRBV9,TRBJ2-3,CASSGGENTQYF,0,1,1,1
TRBV6-2/3/5/6,TRBJ2-2,CASRLVPRELFF,0,1,1,1
TRBV12-3/4,TRBJ2-1,CASNLGYNEQFF,0,1,1,1
TRBV20-1,TRBJ2-1,CVEETSGSKQFF,0,1,1,1
TRBV10-1,TRBJ1-5,CATRDVNQPQHF,0,1,1,1
TRBV5-1,TRBJ2-1,CASSFLSDEQFF,0,1,1,1
TRBV5-1,TRBJ2-7,CASSLTRNEQYF,0,1,1,1
TRBV5-1,TRBJ1-2,CASSPDRDGYTF,0,1,1,1
TRBV20-1,TRBJ1-5,CSARVSNQPQHF,0,1,1,1
TRBV29-1,TRBJ1-1,CSVGSPNTEAFF,0,1,1,1
TRBV29-1,TRBJ1-1,CSVDNLNTEAFF,0,1,1,1
TRBV29-1,TRBJ2-7,CSVEEDSYEQYF,0,1,1,1
TRBV29-1,TRBJ2-7,CSVRTETYEQYF,0,1,1,1
TRBV29-1,TRBJ1-4,CSVLQDTEKLFF,0,1,1,1
TRBV29-1,TRBJ1-3,CSALSSGNTIYF,0,1,1,1
TRBV30,TRBJ2-7,CASGTVYEQYF,0,1,1,1
TRBV30,TRBJ1-1,CAWSRRGEAFF,0,1,1,1
TRBV24-1,TRBJ2-1,CATSAYNEQFF,0,1,1,1
TRBV6-2/3/5/6,TRBJ2-1,CASTSFNEQFF,0,1,1,1
TRBV7-9,TRBJ2-3,CASTFLDTQYF,0,1,1,1
TRBV12-3/4,TRBJ2-1,CASSFSHEQFF,0,1,1,1
TRBV12-3/4,TRBJ1-5,CASSLEGAQHF,0,1,1,1
TRBV28,TRBJ1-5,CASSSYQPQHF,0,1,1,1
TRBV7-9,TRBJ1-1,CASSSFTEAFF,0,1,1,1
TRBV3-1,TRBJ2-7,CASSRRYEQYF,0,1,1,1
TRBV20-1,TRBJ2-1,CSASKAMVQFF,0,1,1,1
TRBV29-1,TRBJ2-1,CSPAGGNEQFF,0,1,1,1
TRBV29-1,TRBJ2-7,CSVRVSYEQYF,0,1,1,1
TRBV29-1,TRBJ2-1,CSVVAVNEQFF,0,1,1,1
TRBV20-1,TRBJ2-1,CSAREREQFF,0,1,1,1
TRBV29-1,TRBJ1-2,CSAGDNGYTF,0,1,1,1
TRBV10-3,TRBJ2-1,CAISEEFF,0,1,1,1
TRBV2,TRBJ1-2,CASSEWGTATANYGYTF,0,1,1,1
TRBV5-1,TRBJ2-6,CASSPGLLVSGANVLTF,0,1,1,1
TRBV12-3/4,TRBJ2-1,CASSETSVGYNEQFF,0,1,1,1
TRBV7-2,TRBJ2-1,CASSTSGRSYNEQFF,0,2,1,2
TRBV5-1,TRBJ1-1,CASSSTTGNTEAFF,0,1,1,1
TRBV19,TRBJ1-1,CASRRVPGTEAFF,0,1,1,1
TRBV5-6,TRBJ2-5,CASSLRNWETQYF,0,1,1,1
TRBV6-2/3/5/6,TRBJ2-3,CASSLQRDTQYF,0,1,1,1
TRBV7-2,TRBJ2-6,CASSSPRLAGKAGANVLTL,0,1,1,1
TRBV3-1,TRBJ2-1,CASSQNWDFSPSSYNEQFF,0,1,1,1
TRBV4-2,TRBJ2-7,CAGSQDLSRWDGVYEQYF,0,1,1,1
TRBV19,TRBJ1-6,CASSPSTVRGSYNSPLHF,0,1,1,1
TRBV19,TRBJ1-5,CASSHKMGDWSGNQPQHF,0,1,1,1
TRBV6-2/3/5/6,TRBJ1-5,CASSYSSRAGFGNQPQHF,0,1,1,1
TRBV7-2,TRBJ2-7,CASSLGGAGGAVRYEQYF,0,1,1,1
TRBV7-2,TRBJ2-4,CASSLDSPLGQGENIQYF,0,1,1,1
TRBV7-2,TRBJ2-1,CASSLRGRLAGEGNKQFF,0,1,1,1
TRBV5-4,TRBJ2-3,CASSLPTSGIAYTDTQYF,0,1,1,1
TRBV4-2,TRBJ2-7,CASSQEILAGGWSYEQYF,0,1,1,1
TRBV5-1,TRBJ2-1,CASSLETTGTPAYNEQFF,0,1,1,1
TRBV29-1,TRBJ2-2,CSVEDPWGSGVNTGELFF,0,1,1,1
TRBV30,TRBJ1-4,CAWTHGEQGEPNEKLFF,0,1,1,1
TRBV24-1,TRBJ2-1,CATSDLPAGLPHNEQFF,0,1,1,1
TRBV15,TRBJ2-7,CATSENLGQRGTYEQYF,0,1,1,1
TRBV19,TRBJ2-1,CASSDIIRTSGRNSQFI,0,1,1,1
TRBV6-2/3/5/6,TRBJ2-2,CASSYSTRDLNTGELFF,0,1,1,1
TRBV25-1,TRBJ2-5,CASSPGLAGGPRETQYF,0,1,1,1
TRBV27,TRBJ1-6,CASSPMSYRDRGSPLHF,0,1,1,1
TRBV6-4,TRBJ1-4,CASSDPHRSATNEKLFF,0,1,1,1
TRBV6-1,TRBJ1-1,CASSEAMAGPMNTEAFF,0,1,1,1
TRBV7-9,TRBJ1-1,CASSFGRAGDKNTEAFF,0,1,1,1
TRBV5-6,TRBJ1-5,CASSLAAGFEKDQPQHF,0,1,1,1
TRBV11-2,TRBJ2-3,CASSLAGGTSSTDTQYF,0,1,1,1
TRBV7-9,TRBJ1-1,CASSLVGQGIMNTEAFF,0,1,1,1
TRBV7-9,TRBJ2-7,CASSLVGWTGNSYEQYF,0,1,1,1
TRBV11-3,TRBJ1-1,CASSSYHNGPLNTEAFF,0,1,1,1
TRBV11-3,TRBJ1-6,CASSSRIPLGGNSPLHF,0,1,1,1
TRBV7-2,TRBJ2-7,CASSSGAYSQSSYEQYF,0,1,1,1
TRBV7-9,TRBJ2-3,CASSPGSGGSGTDTQYF,0,1,1,1
TRBV6-2/3/5/6,TRBJ2-1,CASSQWKGAFSYNEQFS,0,1,1,1
TRBV5-6,TRBJ2-1,CASSQGPGGHTHDEQFF,0,1,1,1
TRBV3-1,TRBJ2-7,CASSQDRLAGGTYEQYF,0,1,1,1
TRBV9,TRBJ2-1,CASSVGRTRTRGNEQFF,0,1,1,1
TRBV12-3/4,TRBJ2-3,CASNPDSPGLSTDTQYF,0,1,1,1
TRBV5-1,TRBJ2-2,CASSLAPLAGAPGELFF,0,1,1,1
TRBV5-1,TRBJ1-4,CASSLGTFGLTNEKLFF,0,1,1,1
TRBV5-1,TRBJ2-3,CASSRAPGTGGTDTQYF,0,1,1,1
TRBV4-1,TRBJ2-1,CASSQGPGQGGGYEQFF,0,1,1,1
TRBV4-3,TRBJ2-5,CASSQDGGASGGETQYF,0,1,1,1
TRBV29-1,TRBJ2-2,CSVDAERTGELTGELFF,0,1,1,1
TRBV12-5,TRBJ2-7,CASGLVLGTGVYEQYF,0,1,1,1
TRBV12-5,TRBJ2-7,CASGLVQGYQGNEQYF,0,1,1,1
TRBV30,TRBJ2-3,CAWSLLGQANTDTQYF,0,1,1,1
TRBV30,TRBJ1-5,CAWSVQSRGRVRPQHF,0,1,1,1
TRBV24-1,TRBJ2-6,CATSGPLGPGANVLTF,0,1,1,1
TRBV19,TRBJ1-1,CASSIGPGRRNTEAFF,0,1,1,1
TRBV19,TRBJ2-7,CASSDLRDRASHEQYF,0,1,1,1
TRBV19,TRBJ2-3,CASRPLTSGSTDTQYF,0,1,1,1
TRBV19,TRBJ1-1,CASNLRAAGGKTEAFF,0,1,1,1
TRBV19,TRBJ2-1,CASNPPGGRDNNEQFF,0,1,1,1
TRBV18,TRBJ2-1,CASSAGLTSSYNEQFF,0,1,1,1
TRBV18,TRBJ1-3,CASSPPGTRVRNTIYF,0,1,1,1
TRBV18,TRBJ1-5,CASSPPNQGGNQPQHF,0,1,1,1
TRBV18,TRBJ2-3,CASSRNRGTSTDTQYF,0,1,1,1
TRBV6-2/3/5/6,TRBJ2-7,CASPGTSGLGVYEQYF,0,1,1,1
TRBV2,TRBJ2-7,CASTWRWGEAAREQYF,0,1,1,1
TRBV6-2/3/5/6,TRBJ1-5,CASSLTGGGRNQPQHF,0,1,1,1
TRBV6-2/3/5/6,TRBJ1-5,CASSYRVEGGNQPQHF,0,1,1,1
TRBV6-1,TRBJ2-7,CASSAGQGVQLYEQYF,0,1,1,1
TRBV6-4,TRBJ2-1,CASSDGLAGLFNEQFF,0,1,1,1
TRBV7-8,TRBJ2-7,CASSFVHTETFYEQYF,0,1,1,1
TRBV5-4,TRBJ2-7,CASSLSSKSTGPEQYF,0,1,1,1
TRBV7-2,TRBJ2-1,CASSLALAGGYNEQFF,0,1,1,1
TRBV7-2,TRBJ2-3,CASSLGGRGATDTQYF,0,1,1,1
TRBV7-8,TRBJ1-4,CASSLFADRWVEKLFF,0,1,1,1
TRBV7-9,TRBJ2-1,CASSLSSSGTLEEQFF,0,1,1,1
TRBV7-9,TRBJ2-1,CASSLPGLAGGNEQFF,0,1,1,1
TRBV7-6,TRBJ2-1,CASSLGLAGGPDEQFF,0,1,1,1
TRBV7-2,TRBJ1-1,CASSLGQALWDTEAFF,0,1,1,1
TRBV11-2,TRBJ2-2,CASSLGGGSWTGELFF,0,1,1,1
TRBV7-2,TRBJ2-7,CASSLGGTGSHAEQYF,0,1,1,1
TRBV11-1,TRBJ2-5,CASSSSTSGYQETQYF,0,1,1,1
TRBV5-5,TRBJ2-5,CASSWEGDIHQETQYF,0,1,1,1
TRBV7-9,TRBJ1-4,CASSPRQTATNEKLFF,0,1,1,1
TRBV5-8,TRBJ2-7,CASSPGASGYSYEQYF,0,1,1,1
TRBV4-2,TRBJ2-1,CASSHVGVTTYDEQFF,0,1,1,1
TRBV4-2,TRBJ2-7,CASSQASSGNSYEQYF,0,1,1,1
TRBV3-1,TRBJ1-1,CASSQDWRGSKTEAFF,0,1,1,1
TRBV3-1,TRBJ1-1,CASSQDERGWGTEAFF,0,1,1,1
TRBV4-2,TRBJ2-2,CASSQDNRENTGELFF,0,1,1,1
TRBV14,TRBJ2-7,CASSQEGQGGSYEQYF,0,1,1,1
TRBV3-1,TRBJ2-2,CASSVLAGGDTGELFF,0,1,1,1
TRBV9,TRBJ1-4,CASSAGTGVADEKLYF,0,1,1,1
TRBV9,TRBJ1-3,CASSADETYSGNTIYF,0,1,1,1
TRBV2,TRBJ2-3,CAREEEAGGHPWGQYF,0,1,1,1
TRBV5-1,TRBJ2-6,CVSGQGASTGANVLTF,0,1,1,1
TRBV4-3,TRBJ2-3,CASGTGKLAGADTQHF,0,1,1,1
TRBV5-1,TRBJ1-4,CASSLAGGQRNEKLFF,0,1,1,1
TRBV5-1,TRBJ1-1,CASSLDARYRNTEAFF,0,1,1,1
TRBV4-1,TRBJ2-7,CASSLGLAGGIYEQYF,0,1,1,1
TRBV4-3,TRBJ2-7,CASSQTGTSHLYEQYF,0,1,1,1
TRBV4-1,TRBJ2-1,CASSQGTSGNYNEQFF,0,1,1,1
TRBV5-1,TRBJ2-5,CASSGTSGRSGETQYF,0,1,1,1
TRBV10-1,TRBJ2-3,CASNLGASSSGDTQYF,0,1,1,1
TRBV20-1,TRBJ1-6,CSARVEQGAGNSPLHF,0,1,1,1
TRBV12-5,TRBJ2-3,CASGSSGRVSDTQYF,0,1,1,1
TRBV30,TRBJ2-1,CAWSGAGGSYNEQFF,0,1,1,1
TRBV10-3,TRBJ2-7,CAISESNVKSYEQYF,0,1,1,1
TRBV10-3,TRBJ2-7,CAISEGTGASYEQYF,0,1,1,1
TRBV10-3,TRBJ1-1,CAIRAVGGEDTEAFF,0,1,1,1
TRBV10-3,TRBJ1-4,CATRDRVATNEKLFF,0,1,1,1
TRBV19,TRBJ1-5,CATQVRGRGNQPQHF,0,1,1,1
TRBV15,TRBJ1-1,CATSTVPEGQIEAFF,0,1,1,1
TRBV10-3,TRBJ2-2,CATLREGTNTGELSF,0,1,1,1
TRBV24-1,TRBJ2-2,CATSNGGSNSGELFF,0,1,1,1
TRBV2,TRBJ2-6,CASWALGSGANVLTF,0,1,1,1
TRBV19,TRBJ2-2,CASTLELANTGELFF,0,1,1,1
TRBV19,TRBJ2-7,CASSAGGSSSYEQYF,0,1,1,1
TRBV19,TRBJ2-7,CASSTGDREGYEQYF,0,1,1,1
TRBV19,TRBJ1-1,CASSTYGTGGTEAFF,0,1,1,1
TRBV19,TRBJ1-1,CASSTGQGAFTEAFF,0,1,1,1
TRBV19,TRBJ2-3,CASSQGQGAHPTQYF,0,1,1,1
TRBV18,TRBJ1-1,CASSLTRVASVEAFF,0,1,1,1
TRBV2,TRBJ2-7,CASYDTVAKGYEQYF,0,1,1,1
TRBV3-1,TRBJ2-1,CASQFGGGLANEQFF,0,1,1,1
TRBV7-9,TRBJ1-6,CASMPSEGRNSPLHF,0,1,1,1
TRBV6-2/3/5/6,TRBJ2-1,CASSFSGIQINEQFF,0,1,1,1
TRBV12-3/4,TRBJ2-5,CASSFASGSQETQYF,0,1,1,1
TRBV12-3/4,TRBJ1-5,CASSLGQGVDQPQHF,0,1,1,1
TRBV6-2/3/5/6,TRBJ2-1,CASSLERGAYNEQFF,0,1,1,1
TRBV28,TRBJ2-7,CASSLRDRQNYEQYF,0,1,1,1
TRBV28,TRBJ1-6,CASSLGGSFASPLHF,0,1,1,1
TRBV28,TRBJ2-1,CASSLTSGPPYEQFF,0,1,1,1
TRBV6-2/3/5/6,TRBJ2-3,CASSYSGARTDTQYF,0,1,1,1
TRBV6-2/3/5/6,TRBJ2-7,CASSYRPGFLYEQYF,0,1,1,1
TRBV6-2/3/5/6,TRBJ1-5,CASSPHRGNNQPQHF,0,1,1,1
TRBV6-2/3/5/6,TRBJ1-6,CASSHIGDYNSPLHF,0,1,1,1
TRBV2,TRBJ1-5,CASSELRGENQPQHF,0,1,1,1
TRBV6-2/3/5/6,TRBJ1-1,CASSSQGAPNDEAFF,0,1,1,1
TRBV5-6,TRBJ2-7,CASSFLTRDSHEQYF,0,1,1,1
TRBV5-4,TRBJ2-5,CASSFTSGGQETQYF,0,1,1,1
TRBV7-9,TRBJ1-4,CASSLYGQPNEKLFF,0,1,1,1
TRBV5-4,TRBJ1-1,CASSLVPSKAPEAFF,0,1,1,1
TRBV5-5,TRBJ1-1,CASSLGFRVGTEAFF,0,1,1,1
TRBV5-8,TRBJ2-3,CASSLGAGRTDTQYF,0,1,1,1
TRBV7-2,TRBJ1-1,CASSLDPGMNTEAFF,0,1,1,1
TRBV7-9,TRBJ2-6,CASSLLSGPANVLTF,0,1,1,1
TRBV7-9,TRBJ1-1,CASSLPRGQGRLAFF,0,1,1,1
TRBV7-9,TRBJ2-7,CASSLVTGRSYEQYF,0,1,1,1
TRBV7-2,TRBJ2-6,CASSLASSGANVLTF,0,1,1,1
TRBV7-9,TRBJ1-1,CASSLALVGNTEAFF,0,1,1,1
TRBV7-9,TRBJ2-1,CASSLAGSSYNEQFF,0,1,1,1
TRBV7-2,TRBJ2-3,CASSLGAGYTDTQYF,0,1,1,1
TRBV11-2,TRBJ1-1,CASSLDFGSNTEAFF,0,1,1,1
TRBV11-3,TRBJ1-2,CASSLDGGPQDGYTF,0,1,1,1
TRBV11-2,TRBJ2-7,CASSLDEGSVGEQYF,0,1,1,1
TRBV7-2,TRBJ2-1,CASSLESQVHNEQFF,0,1,1,1
TRBV7-9,TRBJ1-1,CASSLRGGPNTEAFF,0,1,1,1
TRBV5-4,TRBJ2-7,CASSLKGMVSYEQYF,0,1,1,1
TRBV5-4,TRBJ2-5,CASSSAGKDWETQYF,0,1,1,1
TRBV5-4,TRBJ1-2,CASSSPTGPTQGYTF,0,1,1,1
TRBV5-6,TRBJ2-1,CASSSLRNPYNEQFF,0,1,1,1
TRBV7-9,TRBJ2-7,CASSLRTGEGDEQYF,0,1,1,1
TRBV7-9,TRBJ2-3,CASSPRDIFTDTQYF,0,1,1,1
TRBV7-3,TRBJ2-1,CASSPSGRLLDEQFF,0,1,1,1
TRBV4-2,TRBJ2-5,CASSPFLADPETQYF,0,1,1,1
TRBV3-1,TRBJ2-5,CASSPLLGVGETQYF,0,1,1,1
TRBV7-6,TRBJ2-3,CASSPGLDSTDTQYF,0,1,1,1
TRBV9,TRBJ1-1,CASSPRQGRNTEAFF,0,1,1,1
TRBV11-2,TRBJ2-3,CASSPSGRVMDTQYF,0,1,1,1
TRBV4-2,TRBJ2-2,CASSRASGSTGELFF,0,1,1,1
TRBV7-2,TRBJ2-3,CASSRTSGSLDTQYF,0,1,1,1
TRBV7-2,TRBJ2-3,CASSRLAGSTDTQYF,0,1,1,1
TRBV14,TRBJ2-3,CASSHTGASTDTQYF,0,1,1,1
TRBV14,TRBJ1-1,CASSQDRGGWAEAFF,0,1,1,1
TRBV3-1,TRBJ2-3,CASSQDGVSTDTQYF,0,1,1,1
TRBV4-2,TRBJ1-5,CASSQEPTGNQPQHF,0,1,1,1
TRBV3-1,TRBJ2-1,CASSQEASGRGEQFF,0,1,1,1
TRBV9,TRBJ2-7,CASSVPGSGAYEQYF,0,1,1,1
TRBV9,TRBJ2-3,CASSVGEESTDTQYF,0,1,1,1
TRBV6-2/3/5/6,TRBJ2-1,CASSVVGGSYNEQFF,0,1,1,1
TRBV9,TRBJ2-7,CASSVGQDRTYEQYF,0,1,1,1
TRBV9,TRBJ2-3,CASSVGATMADTQYF,0,1,1,1
TRBV9,TRBJ2-1,CASSVGGTIYNEQFF,0,1,1,1
TRBV7-7,TRBJ2-2,CASSATGIGTGELFF,0,1,1,1
TRBV7-2,TRBJ2-7,CASSGTSGDLYEQYF,0,1,1,1
TRBV3-1,TRBJ1-1,CASSDYGAIRGEAFF,0,1,1,1
TRBV5-6,TRBJ1-5,CASSTTGLAVQPQHF,0,1,1,1
TRBV7-2,TRBJ2-5,CASRSTGQTYETQYF,0,1,1,1
TRBV6-2/3/5/6,TRBJ2-5,CASRGPRTAQETQYF,0,1,1,1
TRBV12-3/4,TRBJ1-1,CASREQGRGDTEAFF,0,1,1,1
TRBV2,TRBJ1-5,CASKMEGLLNQPQHF,0,1,1,1
TRBV5-1,TRBJ2-7,CASSFQGGLAGEQYF,0,1,1,1
TRBV5-1,TRBJ2-2,CASSLSPSGTGELFF,0,1,1,1
TRBV5-1,TRBJ1-2,CASSLDGDINYGYTF,0,1,1,1
TRBV5-1,TRBJ1-5,CASSLSPTDPQPQHF,0,1,1,1
TRBV5-1,TRBJ2-1,CASSSASGRINEQFF,0,1,1,1
TRBV4-3,TRBJ1-2,CASSPVGGKNYGYTF,0,1,1,1
TRBV4-1,TRBJ1-2,CASSHPGQGNRGYTF,0,1,1,1
TRBV4-3,TRBJ2-3,CASSQGKGLTDTQYS,0,1,1,1
TRBV4-3,TRBJ1-6,CASSQDRKAYSPLHF,0,1,1,1
TRBV4-1,TRBJ2-7,CASSQDPGQHYEQYI,0,1,1,1
TRBV20-1,TRBJ1-1,CSAPGRTGGTTEAFF,0,1,1,1
TRBV20-1,TRBJ2-3,CSAGPPSGGADTQYF,0,1,1,1
TRBV20-1,TRBJ1-5,CSAGQGADSNQPQHF,0,1,1,1
TRBV20-1,TRBJ1-1,CSADRDRQTNTEAFF,0,1,1,1
TRBV20-1,TRBJ1-1,CSATNRTETNTGAFF,0,1,1,1
TRBV20-1,TRBJ1-1,CSARSHGGANTEAFF,0,1,1,1
TRBV20-1,TRBJ2-4,CSARLGGTSENIQYF,0,1,1,1
TRBV20-1,TRBJ2-2,CSARQGWDDTGELFF,0,1,1,1
TRBV20-1,TRBJ1-6,CSARVRQGTNSPLHF,0,1,1,1
TRBV20-1,TRBJ2-1,CSAREASADYNEQFF,0,1,1,1
TRBV20-1,TRBJ2-1,CSAGPSSGGAYEQFF,0,1,1,1
TRBV20-1,TRBJ2-7,CSAMNSGESSYEQYF,0,1,1,1
TRBV29-1,TRBJ2-3,CSVLTLGRSTDTQYF,0,1,1,1
TRBV29-1,TRBJ1-1,CSVADSPMGNTEAFF,0,1,1,1
TRBV29-1,TRBJ1-2,CSVEDPGTGGYGYTF,0,1,1,1
TRBV29-1,TRBJ2-5,CSVEERGRGGETQYF,0,1,1,1
TRBV29-1,TRBJ1-1,CSVANFLGTGTEAFF,0,1,1,1
TRBV19,TRBJ1-6,SASSIQQGGNSPLHF,0,1,1,1
TRBV12-5,TRBJ1-4,CASGYWATARKLFF,0,1,1,1
TRBV30,TRBJ1-1,CAWSLGLGATEAFF,0,1,1,1
TRBV30,TRBJ2-6,CAWSVNSGANVLTF,0,1,1,1
TRBV30,TRBJ1-6,CAWSAGQDNSPLHF,0,1,1,1
TRBV30,TRBJ2-1,CAPAASGDYNEQFF,0,1,1,1
TRBV10-3,TRBJ2-3,CAIRPDRVGDTQYF,0,1,1,1
TRBV18,TRBJ2-5,CASSPDALQETQYF,0,1,1,1
TRBV19,TRBJ2-5,CASPGTVPQETQYF,0,1,1,1
TRBV19,TRBJ2-2,CASTGQGRPGEPFF,0,1,1,1
TRBV19,TRBJ2-2,CASSWDGGTGELFF,0,1,1,1
TRBV19,TRBJ2-7,CASSPQRVSYEQYF,0,1,1,1
TRBV19,TRBJ1-3,CASSPAYTGNTIYF,0,1,1,1
TRBV19,TRBJ1-1,CASSGLGLRTEAFF,0,1,1,1
TRBV19,TRBJ1-1,CASSGDRAVTEAFF,0,1,1,1
TRBV19,TRBJ2-7,CASSIATESYEQYF,0,1,1,1
TRBV19,TRBJ2-1,CASSKRQGANEQFF,0,1,1,1
TRBV18,TRBJ1-4,CASSPRGADEKLFF,0,1,1,1
TRBV18,TRBJ1-2,CASSPVEKDYGYTF,0,1,1,1
TRBV2,TRBJ2-7,CASSAGTSVYEQYF,0,1,1,1
TRBV2,TRBJ1-1,CASCVTGSNTEAFF,0,1,1,1
TRBV7-9,TRBJ1-2,CASGRDRVIYGYTF,0,1,1,1
TRBV6-2/3/5/6,TRBJ2-7,CASTPGPSSYEQYF,0,1,1,1
TRBV2,TRBJ1-1,CASTKDRVGTEAFF,0,1,1,1
TRBV12-3/4,TRBJ2-7,CASTTPGNRYEQYF,0,1,1,1
TRBV12-3/4,TRBJ1-4,CASSFSGGGEKLFF,0,1,1,1
TRBV12-3/4,TRBJ2-7,CASSLAPRAGEQYF,0,1,1,1
TRBV27,TRBJ2-2,CASSSQLNTGELFF,0,1,1,1
TRBV28,TRBJ1-2,CASSSGGTNYGYTF,0,1,1,1
TRBV28,TRBJ2-3,CASSSGQGTDTQYF,0,1,1,1
TRBV12-3/4,TRBJ1-1,CASSSRGFDTEAFF,0,1,1,1
TRBV6-2/3/5/6,TRBJ1-1,CASSWGEANSEAFF,0,1,1,1
TRBV27,TRBJ2-3,CASSYDIRTDTQYF,0,1,1,1
TRBV6-2/3/5/6,TRBJ1-3,CASSPPGAGNTIYF,0,1,1,1
TRBV6-2/3/5/6,TRBJ1-5,CASSPPGGNQPQHF,0,1,1,1
TRBV6-4,TRBJ1-6,CASSRQARGSPLHF,0,1,1,1
TRBV12-3/4,TRBJ2-7,CASSHRARRYEQYF,0,1,1,1
TRBV6-2/3/5/6,TRBJ1-5,CASSQGRSNQPQHF,0,1,1,1
TRBV7-3,TRBJ1-6,CASSVKDYNSPLHF,0,1,1,1
TRBV6-4,TRBJ1-1,CASSARRENTEAFF,0,1,1,1
TRBV6-1,TRBJ2-1,CASSDYHGTGRRFF,0,1,1,1
TRBV25-1,TRBJ2-7,CASSELRDTYEQYF,0,1,1,1
TRBV6-1,TRBJ2-1,CASSETGGGNEQFF,0,1,1,1
TRBV2,TRBJ2-5,CASSEFFGAETQYF,0,1,1,1
TRBV2,TRBJ2-3,CASSEGKASGTQYF,0,1,1,1
TRBV5-6,TRBJ2-7,CASSFQGPSYEQYF,0,1,1,1
TRBV5-6,TRBJ1-1,CASSFAVSDTEAFF,0,1,1,1
TRBV5-6,TRBJ2-7,CASSFGAGAYEQYF,0,1,1,1
TRBV5-6,TRBJ2-1,CASSFGTGHNEQFF,0,1,1,1
TRBV5-6,TRBJ2-1,CASSFSGSRNEQFF,0,1,1,1
TRBV5-6,TRBJ1-5,CASSFLGNGQPQHF,0,1,1,1
TRBV7-2,TRBJ1-2,CASSLTGISYGYTF,0,1,1,1
TRBV7-9,TRBJ1-2,CASSLVQLNYGYTF,0,1,1,1
TRBV7-6,TRBJ1-1,CASSLVTENTEAFF,0,1,1,1
TRBV7-2,TRBJ2-7,CASSLGGGAREQYF,0,1,1,1
TRBV7-2,TRBJ1-5,CASSLGRENQPQHF,0,1,1,1
TRBV7-2,TRBJ2-7,CASSSPRAFYEQYF,0,1,1,1
TRBV11-1,TRBJ2-3,CASSSQNYISSVYF,0,1,1,1
TRBV7-8,TRBJ1-1,CASSSRAEVAEAFF,0,1,1,1
TRBV7-3,TRBJ2-6,CASSSGGGANVLTF,0,1,1,1
TRBV5-6,TRBJ2-7,CASSWGTSLYEQYF,0,1,1,1
TRBV7-9,TRBJ2-7,CASSWDGTSYEQYF,0,1,1,1
TRBV7-8,TRBJ2-1,CASSLLGSYNEQFF,0,1,1,1
TRBV5-8,TRBJ1-5,CASSLDTDNQPQHF,0,1,1,1
TRBV12-3/4,TRBJ2-7,CASSLTGGTGEQYF,0,1,1,1
TRBV11-2,TRBJ1-1,CASSLGARGLEAFF,0,1,1,1
TRBV5-4,TRBJ2-4,CASSPATRWDIQYF,0,1,1,1
TRBV12-3/4,TRBJ2-1,CASSPGGNYNEQFF,0,1,1,1
TRBV5-4,TRBJ1-2,CASSPDISTYGYTF,0,1,1,1
TRBV7-2,TRBJ2-4,CASSPGGSKNVQYF,0,1,1,1
TRBV7-3,TRBJ1-2,CASSPGQGGYGYTF,0,1,1,1
TRBV4-2,TRBJ2-7,CASSRQGGNYEQYF,0,1,1,1
TRBV6-2/3/5/6,TRBJ2-2,CASSRDSNTGELFF,0,1,1,1
TRBV7-9,TRBJ1-2,CASSRTGVGYGYTF,0,1,1,1
TRBV7-9,TRBJ2-7,CASSRTGISYEQYF,0,1,1,1
TRBV3-1,TRBJ2-5,CASSRQREGETQYF,0,1,1,1
TRBV7-9,TRBJ1-4,CASSQRDGGGKLFF,0,1,1,1
TRBV14,TRBJ1-3,CASSQGPSGNTIYF,0,1,1,1
TRBV3-1,TRBJ2-7,CASSQGTGNHEQYF,0,1,1,1
TRBV2,TRBJ1-5,CASSGQGSNQPQHF,0,1,1,1
TRBV7-9,TRBJ2-7,CASSRDPTGNEQYF,0,1,1,1
TRBV7-2,TRBJ2-5,CASRYQRDQETQYF,0,1,1,1
TRBV12-3/4,TRBJ2-1,CASRREGGYNEQFF,0,1,1,1
TRBV5-1,TRBJ2-7,CASTRDSFSYEQYF,0,1,1,1
TRBV6-2/3/5/6,TRBJ1-2,CASSYGQGDYGYTF,0,1,1,1
TRBV5-1,TRBJ2-4,CASSFRHRGNIQYF,0,1,1,1
TRBV5-1,TRBJ2-3,CASSLADLTDTQYF,0,1,1,1
TRBV5-1,TRBJ2-3,CASSLETNANTQYF,0,1,1,1
TRBV5-1,TRBJ1-2,CASSLNQEGAGYTF,0,1,1,1
TRBV5-1,TRBJ1-2,CASSSTGGDYGYTF,0,1,1,1
TRBV5-1,TRBJ1-1,CASSSTGGRTEAFF,0,1,1,1
TRBV7-9,TRBJ1-2,CASSSEQGPDGYTF,0,1,1,1
TRBV4-3,TRBJ1-1,CASSQDRENTEAFF,0,1,1,1
TRBV4-3,TRBJ2-3,CASSTQDNTDTQYF,0,1,1,1
TRBV20-1,TRBJ2-7,CSALDEVVAGPQYF,0,1,1,1
TRBV20-1,TRBJ1-1,CSAPRMDSNTEAFF,0,1,1,1
TRBV20-1,TRBJ2-7,CSAATGRSSYEQYF,0,1,1,1
TRBV20-1,TRBJ2-5,CSARGHTSLETQYF,0,1,1,1
TRBV20-1,TRBJ2-1,CSARSSGGAGEQFF,0,1,1,1
TRBV20-1,TRBJ2-5,CSARVGTGQETQYF,0,1,1,1
TRBV20-1,TRBJ1-5,CSARTLTSNQPQHF,0,1,1,1
TRBV20-1,TRBJ1-5,CSAQDRATNQPQHF,0,1,1,1
TRBV20-1,TRBJ2-3,CSAGRDSSTDTQYF,0,1,1,1
TRBV20-1,TRBJ2-7,CSAPNQGYGYEQYF,0,1,1,1
TRBV20-1,TRBJ1-3,CSAIQGNSGNTIYF,0,1,1,1
TRBV29-1,TRBJ2-1,CSVLKGAVYNEQFF,0,1,1,1
TRBV29-1,TRBJ2-5,CSVPYRGEQETQYF,0,1,1,1
TRBV29-1,TRBJ2-1,CSVVWLAVNNEQFF,0,1,1,1
TRBV29-1,TRBJ2-7,CSVERDSEAYEQYF,0,1,1,1
TRBV29-1,TRBJ1-2,CSVEGRGKNYGYTF,0,1,1,1
TRBV29-1,TRBJ2-3,CSVRTSGGTDTQYF,0,1,1,1
TRBV29-1,TRBJ2-1,CSVGAGFSYNEQFF,0,1,1,1
TRBV29-1,TRBJ1-1,CSGDTGPLNTEAFF,0,1,1,1
TRBV5-1,TRBJ2-1,SASSLGTSNEQFF,0,1,1,1
TRBV30,TRBJ1-2,CAVGGFANYGYTF,0,1,1,1
TRBV30,TRBJ1-5,CAWGGSGSQPQHF,0,1,1,1
TRBV30,TRBJ2-7,CAWTRGSVYEQYF,0,1,1,1
TRBV30,TRBJ2-7,CAWSPGLAYEQYF,0,1,1,1
TRBV30,TRBJ1-2,CAWSVSGYYGYTF,0,1,1,1
TRBV7-2,TRBJ2-7,CARSLDPDYEQYF,0,1,1,1
TRBV2,TRBJ2-7,CAGGQARGYEQYY,0,1,1,1
TRBV10-3,TRBJ2-1,CAITPGTGNEQFF,0,1,1,1
TRBV10-3,TRBJ1-5,CAISGTGTRAQHF,0,1,1,1
TRBV10-3,TRBJ2-1,CAISEARENEQFF,0,1,1,1
TRBV24-1,TRBJ1-5,CATSDQTRWPQHF,0,1,1,1
TRBV9,TRBJ2-5,CASSSGVPETQYF,0,1,1,1
TRBV19,TRBJ2-1,CASSISRYNEQFF,0,1,1,1
TRBV19,TRBJ2-1,CASSISGSSGQFF,0,1,1,1
TRBV19,TRBJ2-7,CASRTRGSYEQYF,0,1,1,1
TRBV18,TRBJ1-1,CASSPQMNTEAFF,0,1,1,1
TRBV7-2,TRBJ2-7,CASGIPASYEQYF,0,1,1,1
TRBV7-2,TRBJ2-7,CASGEWGEGEQYF,0,1,1,1
TRBV6-2/3/5/6,TRBJ2-7,CASSLDRADEQYF,0,1,1,1
TRBV12-3/4,TRBJ2-5,CASSLPGVETQYF,0,1,1,1
TRBV12-3/4,TRBJ1-1,CASSLTGLTEAFF,0,1,1,1
TRBV12-3/4,TRBJ2-7,CASSLSEADEQYF,0,1,1,1
TRBV6-2/3/5/6,TRBJ2-1,CASSWTVYNKQFF,0,1,1,1
TRBV6-2/3/5/6,TRBJ1-1,CASSYNEWTEAFF,0,1,1,1
TRBV6-1,TRBJ2-5,CASSVVAQETQYF,0,1,1,1
TRBV6-4,TRBJ2-7,CASSAFGAYEQYF,0,1,1,1
TRBV6-1,TRBJ1-5,CASSGRENQPQYF,0,1,1,1
TRBV6-1,TRBJ2-1,CASSESLQRLKFF,0,1,1,1
TRBV2,TRBJ2-7,CASSEYRGNEQYF,0,1,1,1
TRBV2,TRBJ2-1,CASSERVRDEQFF,0,1,1,1
TRBV2,TRBJ1-2,CASSERGLYGYTF,0,1,1,1
TRBV7-3,TRBJ2-7,CASSIGPVYEQYF,0,1,1,1
TRBV6-2/3/5/6,TRBJ1-1,CASSTSGGMGAFF,0,1,1,1
TRBV6-2/3/5/6,TRBJ2-1,CASSNSPQGSEFF,0,1,1,1
TRBV25-1,TRBJ2-3,CASSKGAHSTQYF,0,1,1,1
TRBV5-6,TRBJ1-6,CASSFGLNSPLHF,0,1,1,1
TRBV5-6,TRBJ2-2,CASSLGGTGELFF,0,1,1,1
TRBV5-4,TRBJ2-7,CASSLDRVYEQYF,0,1,1,1
TRBV7-2,TRBJ2-5,CASSLERQETQYF,0,1,1,1
TRBV13,TRBJ1-2,CASSLKGTYGYTF,0,1,1,1
TRBV5-4,TRBJ1-1,CASSLHRGTEAFF,0,1,1,1
TRBV11-2,TRBJ2-1,CASSLASNNEQFF,0,1,1,1
TRBV7-9,TRBJ2-1,CASSLGRANEQFF,0,1,1,1
TRBV11-2,TRBJ2-7,CASSLGNSYEQYF,0,1,1,1
TRBV7-6,TRBJ2-7,CASSLESSYEQYF,0,1,1,1
TRBV7-9,TRBJ2-3,CASSLIVADTQYF,0,1,1,1
TRBV11-2,TRBJ2-5,CASSSGFRETRYF,0,1,1,1
TRBV7-2,TRBJ1-3,CASSSRQGNTIYF,0,1,1,1
TRBV9,TRBJ1-1,CASSSGPNAEAFF,0,1,1,1
TRBV7-9,TRBJ1-2,CASSSRPGYGYTF,0,1,1,1
TRBV11-2,TRBJ2-7,CASSWTGGEEQYF,0,1,1,1
TRBV7-3,TRBJ1-5,CASSLGVNQPQHF,0,1,1,1
TRBV5-6,TRBJ2-3,CASSLGTADTQYF,0,1,1,1
TRBV7-9,TRBJ2-7,CASSPSTGNEQYF,0,1,1,1
TRBV7-2,TRBJ2-7,CASSPVGAYEQYF,0,1,1,1
TRBV6-2/3/5/6,TRBJ2-7,CASSPGAQNEQYF,0,1,1,1
TRBV5-6,TRBJ2-7,CASSHRENYEQYF,0,1,1,1
TRBV3-1,TRBJ2-1,CASSQDWVHEQLF,0,1,1,1
TRBV3-1,TRBJ1-1,CASSQDPRGGAFF,0,1,1,1
TRBV3-1,TRBJ2-7,CASSQERSYEQHF,0,1,1,1
TRBV7-8,TRBJ2-5,CASSVRLQETQYF,0,1,1,1
TRBV7-9,TRBJ2-4,CASSATGSDIQYF,0,1,1,1
TRBV7-9,TRBJ2-7,CASSGTPTYEQYF,0,1,1,1
TRBV5-5,TRBJ2-1,CASSSTGINEQFF,0,1,1,1
TRBV2,TRBJ1-2,CASRAYREDGYTF,0,1,1,1
TRBV2,TRBJ1-1,CASRGWRDTEAFF,0,1,1,1
TRBV2,TRBJ1-5,CASRSGGEQPQHF,0,1,1,1
TRBV3-1,TRBJ2-5,CASRTFAGETQYF,0,1,1,1
TRBV5-6,TRBJ1-1,CASRSGGTPKTFF,0,1,1,1
TRBV2,TRBJ2-5,CASRKDVEETQYF,0,1,1,1
TRBV29-1,TRBJ1-2,CFARDSLDYGYTF,0,1,1,1
TRBV5-1,TRBJ2-7,CASSLAWDSEQYF,0,1,1,1
TRBV5-1,TRBJ2-2,CASSLEGNGELFF,0,1,1,1
TRBV5-1,TRBJ2-7,CASSLTGTYEQYF,0,1,1,1
TRBV5-1,TRBJ2-1,CASSLVGHDEQFF,0,1,1,1
TRBV5-1,TRBJ2-7,CASSSGTEYEQYF,0,1,1,1
TRBV10-2,TRBJ2-2,CASRDFNTGELFF,0,1,1,1
TRBV20-1,TRBJ2-7,CSAVRDKGYEQYF,0,1,1,1
TRBV20-1,TRBJ1-5,CSASGEFNQPQHF,0,1,1,1
TRBV20-1,TRBJ2-3,CSASGVGIATQYF,0,1,1,1
TRBV20-1,TRBJ2-2,CSARPWDNGELFF,0,1,1,1
TRBV20-1,TRBJ1-1,CSARVQKNTEAFF,0,1,1,1
TRBV20-1,TRBJ1-5,CSARIEGNQPQHF,0,1,1,1
TRBV29-1,TRBJ1-2,CSVEDTRGYGYTF,0,1,1,1
TRBV29-1,TRBJ2-2,CSVRQANTGELFF,0,1,1,1
TRBV29-1,TRBJ2-7,CSVSPGQGSEQYF,0,1,1,1
TRBV29-1,TRBJ2-7,CSVRTGDDYEQYF,0,1,1,1
TRBV29-1,TRBJ1-6,CSAGQGDNSPLHF,0,1,1,1
TRBV29-1,TRBJ1-4,CSGGQGRNEKLFF,0,1,1,1
TRBV30,TRBJ2-4,CAWKGPKNIQYF,0,1,1,1
TRBV10-3,TRBJ2-7,CAISESPGRRYF,0,1,1,1
TRBV19,TRBJ2-5,CASSGSRETQYF,0,1,1,1
TRBV11-2,TRBJ2-7,CASAAGGDEQYF,0,1,1,1
TRBV7-9,TRBJ2-1,CASTGTNVGQFF,0,1,1,1
TRBV2,TRBJ2-1,CASTGDYNEQFF,0,1,1,1
TRBV12-3/4,TRBJ2-7,CASSSVSYEQYF,0,1,1,1
TRBV6-2/3/5/6,TRBJ1-1,CASSYRGTEAFF,0,1,1,1
TRBV2,TRBJ2-7,CASSAETYEQYF,0,1,1,1
TRBV6-1,TRBJ2-7,CASSEFQGRIDF,0,1,1,1
TRBV3-1,TRBJ2-1,CASSKGAGGPIF,0,1,1,1
TRBV5-6,TRBJ2-4,CASSFGGNIQYF,0,1,1,1
TRBV5-6,TRBJ2-7,CASSLGFYEQYF,0,1,1,1
TRBV6-2/3/5/6,TRBJ2-3,CASSLAPDTQYF,0,1,1,1
TRBV13,TRBJ2-5,CASSLAEETQYF,0,1,1,1
TRBV7-2,TRBJ2-7,CASSLENYEQYF,0,1,1,1
TRBV7-9,TRBJ1-2,CASSSSNYGYTF,0,1,1,1
TRBV11-3,TRBJ2-3,CASSSFTDTQYF,0,1,1,1
TRBV7-6,TRBJ2-7,CASSLSGYEQYF,0,1,1,1
TRBV7-8,TRBJ1-5,CASSPLNQPQHF,0,1,1,1
TRBV4-2,TRBJ1-3,CASSPGGNTIYF,0,1,1,1
TRBV6-4,TRBJ1-2,CASSRGSYGYTF,0,1,1,1
TRBV7-2,TRBJ2-5,CASSHEAETQYF,0,1,1,1
TRBV3-1,TRBJ1-2,CASSQDKGGYTF,0,1,1,1
TRBV14,TRBJ2-7,CASSQIHDEQYF,0,1,1,1
TRBV7-9,TRBJ2-7,CASSVSTYEQYF,0,1,1,1
TRBV7-9,TRBJ1-1,CASSAPGAEAFF,0,1,1,1
TRBV12-3/4,TRBJ2-2,CASRLITGELFF,0,1,1,1
TRBV2,TRBJ1-1,CASNPWNTEAFF,0,1,1,1
TRBV5-1,TRBJ2-7,CASSLDLDEQYF,0,1,1,1
TRBV5-1,TRBJ1-1,CASSEQNTEAFF,0,1,1,1
TRBV20-1,TRBJ1-3,CSAEIRGNTIYF,0,1,1,1
TRBV20-1,TRBJ2-1,CSALSGANEQFF,0,1,1,1
TRBV29-1,TRBJ2-5,CSVVIAGETQYF,0,1,1,1
TRBV29-1,TRBJ2-7,CSVARVAAEQYF,0,1,1,1
TRBV29-1,TRBJ1-1,CSVGPGGTEAFF,0,1,1,1
TRBV29-1,TRBJ2-1,CSVVAGGDEQFF,0,1,1,1
TRBV29-1,TRBJ2-1,CSVWTGSNEQFF,0,1,1,1
TRBV29-1,TRBJ2-1,SSARGIFNEQFF,0,1,1,1
TRBV30,TRBJ1-4,CAWSGGEKLFF,0,1,1,1
TRBV19,TRBJ2-2,CATGGTGELFF,0,1,1,1
TRBV19,TRBJ2-1,CASSTGYTAFF,0,1,1,1
TRBV6-2/3/5/6,TRBJ1-3,CASDSGNTIYF,0,1,1,1
TRBV28,TRBJ1-5,CASSLGGTQHF,0,1,1,1
TRBV25-1,TRBJ1-1,CASSPGSTAFF,0,1,1,1
TRBV5-6,TRBJ2-3,CASSLSGTQYF,0,1,1,1
TRBV7-2,TRBJ2-3,CASSLVDTQCF,0,1,1,1
TRBV6-2/3/5/6,TRBJ1-1,CASSYTRRAFF,0,1,1,1
TRBV7-2,TRBJ2-1,CASSPRNEQFF,0,1,1,1
TRBV11-1,TRBJ2-1,CASSHHNEQFS,0,1,1,1
TRBV4-2,TRBJ2-7,CASSQEDEQYF,0,1,1,1
TRBV6-2/3/5/6,TRBJ2-3,CASNQGGTQYF,0,1,1,1
TRBV4-1,TRBJ2-1,CASSHHNEQFF,0,1,1,1
TRBV5-1,TRBJ1-1,CASRSQTEAFF,0,1,1,1
TRBV20-1,TRBJ2-3,CSATGLGSQYF,0,1,1,1
TRBV29-1,TRBJ2-1,CSVVPYNEQFF,0,1,1,1
TRBV29-1,TRBJ2-3,CSVGGGRTQYF,0,1,1,1
TRBV29-1,TRBJ1-1,CSVEEGGLAFF,0,1,1,1
TRBV7-2,TRBJ2-3,CASSPLSLTSGNEVVSADTQYF,0,1,1,1
TRBV14,TRBJ2-1,CASSQDPARLAGASPRNEQFF,0,1,1,1
TRBV12-3/4,TRBJ1-3,CASSWRTPGQGRTSGNTLYF,0,1,1,1
TRBV5-1,TRBJ2-3,CASSWTTSGGAMVVGDTQYF,0,1,1,1
TRBV14,TRBJ1-3,CACSSDRSSSSSSGNTIYF,0,1,1,1
TRBV10-3,TRBJ2-1,CAISESPLTSGNRYNEQFF,0,1,1,1
TRBV13,TRBJ2-7,CASSLSSWAGGSSAYEQYF,0,1,1,1
TRBV7-9,TRBJ2-1,CASSLAIGLAGGPNNEQFF,0,1,1,1
TRBV28,TRBJ2-5,CASSLPGLAERHTQETQYF,0,1,1,1
TRBV4-2,TRBJ2-6,CASSQEGTGFLSGANVLTF,0,1,1,1
TRBV9,TRBJ1-4,CASSANPTGTESINEKLFF,0,1,1,1
TRBV7-9,TRBJ1-2,CASSTSAGIYRETNYGYTF,0,1,1,1
TRBV4-3,TRBJ2-1,CASSQVSGMDSSANNEQFF,0,1,1,1
TRBV15,TRBJ1-5,CATSRGLGGFDGNQPQHF,0,1,1,1
TRBV7-8,TRBJ2-1,CASTLGIVRSELGNEQFF,0,1,1,1
TRBV6-2/3/5/6,TRBJ2-5,CASSFATSGDISQETQYF,0,1,1,1
TRBV6-2/3/5/6,TRBJ1-1,CASSYVPGMQTKNTEAFF,0,1,1,1
TRBV14,TRBJ2-3,CASSPTRGLAGGLDTQYF,0,1,1,1
TRBV6-2/3/5/6,TRBJ2-1,CASSARDGGTSDYNEQFF,0,1,1,1
TRBV7-6,TRBJ2-5,CASSIPLPGLAGQETQYF,0,1,1,1
TRBV7-2,TRBJ1-5,CASSTPRDDGSSNQPQHF,0,1,1,1
TRBV5-1,TRBJ2-1,CASSLRGGASGGNNEQFF,0,1,1,1
TRBV5-1,TRBJ1-6,CASSLGHRDVGYNSPLHF,0,1,1,1
TRBV5-1,TRBJ2-7,CASSLGTSGRIRQDEQYF,0,1,1,1
TRBV4-1,TRBJ2-1,CASSLFGTALSSYNEQFF,0,1,1,1
TRBV4-3,TRBJ2-7,CASSLSKGSSGRAYEQYF,0,1,1,1
TRBV5-1,TRBJ2-6,CASSPKGGQGSGANVLTF,0,1,1,1
TRBV4-3,TRBJ2-3,CASSQHRTSGRIPDTQYF,0,1,1,1
TRBV4-3,TRBJ2-2,CASSQDWGGFTNTGELFF,0,1,1,1
TRBV5-1,TRBJ2-3,CASSAVGYSGTSTDTQYF,0,1,1,1
TRBV20-1,TRBJ2-4,CSATRTSGGLQAKNIQYF,0,1,1,1
TRBV12-3/4,TRBJ1-6,CAGSFTAGGQGGSPLHF,0,1,1,1
TRBV9,TRBJ2-1,CAGSRRLAGGPYNEQFF,0,1,1,1
TRBV10-3,TRBJ2-2,CAISESLAGGGTGELFF,0,1,1,1
TRBV24-1,TRBJ2-1,CATSDPLAGGPEDEQFF,0,1,1,1
TRBV19,TRBJ2-7,CASSAQRGTELTYEQYF,0,1,1,1
TRBV19,TRBJ2-1,CASSIDGDRGTRNEQFF,0,1,1,1
TRBV18,TRBJ1-5,CASSPDRTGSNNQPQHF,0,1,1,1
TRBV6-2/3/5/6,TRBJ1-5,CASTTRGGGVSNQLQHF,0,1,1,1
TRBV28,TRBJ2-2,CASSYLADRGLTGELFF,0,1,1,1
TRBV25-1,TRBJ2-5,CASSEYAGLRVQETQYF,0,1,1,1
TRBV5-6,TRBJ1-2,CASSLLQGRNPNYGYTF,0,1,1,1
TRBV7-9,TRBJ2-1,CASSLLSGLGEYNEQFF,0,1,1,1
TRBV5-6,TRBJ2-4,CASSLVLAGDGKNIQYF,0,1,1,1
TRBV5-4,TRBJ2-1,CASSLGSGTSSYNEQFF,0,1,1,1
TRBV7-2,TRBJ2-1,CASSLVGVGTARNEQFF,0,1,1,1
TRBV7-9,TRBJ2-4,CASSLGLAELAKNIQYF,0,1,1,1
TRBV7-2,TRBJ2-4,CASSLGSVGGRGIIQYF,0,1,1,1
TRBV7-3,TRBJ1-2,CASSYSRNRGSNYGYTF,0,1,1,1
TRBV7-2,TRBJ2-1,CASSRPRKRATYNEQFF,0,1,1,1
TRBV3-1,TRBJ2-2,CASSQDLGSGRTGELFF,0,1,1,1
TRBV5-5,TRBJ2-1,CASSVDGWLARYNEQFF,0,1,1,1
TRBV9,TRBJ2-1,CASSARLGLAGGNEQFF,0,1,1,1
TRBV7-9,TRBJ2-7,CASSARDSRSPPYERYF,0,1,1,1
TRBV7-3,TRBJ2-3,CASSNPTGEGSTDTQYF,0,1,1,1
TRBV11-2,TRBJ2-3,CASRPPQSGPSTDTQYF,0,1,1,1
TRBV5-1,TRBJ2-7,CAGSLAASGRIKYEQYF,0,1,1,1
TRBV20-1,TRBJ2-1,CSAPGTSGGASYNEQFF,0,1,1,1
TRBV12-5,TRBJ2-7,CASGLVTGTHSYEQYF,0,1,1,1
TRBV12-3/4,TRBJ2-1,CASRTRKGAGYNEQFF,0,1,1,1
TRBV11-2,TRBJ1-1,CASSLDQGLMNTEAFF,0,1,1,1
TRBV7-2,TRBJ2-1,CACSPVGGLASNEQFF,0,1,1,1
TRBV30,TRBJ2-7,CAWGASGLAFSYEQYF,0,1,1,1
TRBV10-3,TRBJ2-5,CAISAVGDASEETQYF,0,1,1,1
TRBV19,TRBJ2-1,CASKPQGRTSYNEQFF,0,1,1,1
TRBV18,TRBJ2-1,CASSGSGGRGLNEQFF,0,1,1,1
TRBV5-4,TRBJ2-3,CASCPGTSGFADTQYF,0,1,1,1
TRBV6-2/3/5/6,TRBJ1-6,CASSLPDRGPLSVLHF,0,1,1,1
TRBV12-3/4,TRBJ1-2,CASSLTRGELYYGYTF,0,1,1,1
TRBV6-2/3/5/6,TRBJ2-1,CASSYSASGGYNEQFF,0,1,1,1
TRBV6-2/3/5/6,TRBJ2-2,CASSYSTQGAGGELFF,0,1,1,1
TRBV6-2/3/5/6,TRBJ2-2,CASSLGTASHTGELFF,0,1,1,1
TRBV4-2,TRBJ2-1,CASSPGGASSYNEQYF,0,1,1,1
TRBV6-1,TRBJ1-2,CASSVGSGPQMIGYTF,0,1,1,1
TRBV6-4,TRBJ2-7,CASSAEGHRFSYGQYF,0,1,1,1
TRBV2,TRBJ2-7,CASSDPTGPLVLEQYF,0,1,1,1
TRBV25-1,TRBJ2-3,CASSEYASGHLDTQYF,0,1,1,1
TRBV2,TRBJ2-7,CASSEGSTGGPNEQYF,0,1,1,1
TRBV5-4,TRBJ2-2,CASSFLKGLGTGELFF,0,1,1,1
TRBV7-9,TRBJ1-1,CASSFRTLQANTEAFF,0,1,1,1
TRBV7-9,TRBJ2-4,CASSFWTGSAKNIQYF,0,1,1,1
TRBV5-5,TRBJ2-3,CASSLFGVSNLDTQYF,0,1,1,1
TRBV11-1,TRBJ2-2,CASSLRGRRNTGELFF,0,1,1,1
TRBV5-4,TRBJ2-5,CASSLVDRGPQETQYF,0,1,1,1
TRBV5-6,TRBJ2-1,CASSLARLAGAYEQFF,0,1,1,1
TRBV13,TRBJ1-5,CASSLGRRSSNQPQHF,0,1,1,1
TRBV11-3,TRBJ1-1,CASSLDLAGWGTEAFF,0,1,1,1
TRBV9,TRBJ2-1,CASSSHPGPERNEQFF,0,1,1,1
TRBV14,TRBJ1-4,CASSPGPKPLNEILFF,0,1,1,1
TRBV7-9,TRBJ1-1,CASSPAGLTMNTEAFF,0,1,1,1
TRBV3-1,TRBJ2-3,CASSPEAGAITDTQYF,0,1,1,1
TRBV7-8,TRBJ2-3,CASSPDRDYSTDTQYF,0,1,1,1
TRBV14,TRBJ2-2,CASSHREAGVTGELFF,0,1,1,1
TRBV4-2,TRBJ2-1,CASSHALAGEFDEQFF,0,1,1,1
TRBV7-6,TRBJ2-1,CASSQRGARINNEQFF,0,1,1,1
TRBV4-2,TRBJ2-3,CASSQGLAGAEDTQYF,0,1,1,1
TRBV3-1,TRBJ2-6,CASSQWAGSGANVLTF,0,1,1,1
TRBV13,TRBJ2-7,CASSQRGGLAGVEQYF,0,1,1,1
TRBV14,TRBJ2-1,CASSQARPIFYNEQFF,0,1,1,1
TRBV3-1,TRBJ2-7,CASSQDLSGRAYEQYF,0,1,1,1
TRBV4-2,TRBJ1-6,CASSQDAGQGRVSLHF,0,1,1,1
TRBV3-1,TRBJ2-5,CASSQIRGQGAETQYF,0,1,1,1
TRBV9,TRBJ1-4,CASSATTGGRGEKLFF,0,1,1,1
TRBV7-3,TRBJ1-1,CASSAIGGQSNTEAFF,0,1,1,1
TRBV5-4,TRBJ2-5,CASSSRDNAIEETQYF,0,1,1,1
TRBV7-9,TRBJ2-7,CASSKTGTSGSDEQYF,0,1,1,1
TRBV6-2/3/5/6,TRBJ1-5,CASRSRGQGVFQPQHF,0,1,1,1
TRBV6-1,TRBJ2-7,CASRKAGVLESYERYF,0,1,1,1
TRBV7-2,TRBJ2-1,CASSLLSAFAYNEQFF,0,1,1,1
TRBV5-1,TRBJ2-6,CASGQGASTGASVLTF,0,1,1,1
TRBV5-1,TRBJ2-5,CASGNTLGTSGETQYF,0,1,1,1
TRBV10-2,TRBJ1-5,CASTPGHSNSNQPQHF,0,1,1,1
TRBV5-1,TRBJ2-1,CASSLVPSGGNNEQFF,0,1,1,1
TRBV5-1,TRBJ1-1,CASSLGFSRTGTEAFL,0,1,1,1
TRBV5-1,TRBJ1-1,CASSLEFGAGKVGSFF,0,1,1,1
TRBV5-1,TRBJ2-1,CASSLLVADSYNEQFF,0,1,1,1
TRBV5-1,TRBJ2-3,CASSQTSGVSTDTQYF,0,1,1,1
TRBV5-1,TRBJ2-2,CASSAGQGDWTGELFF,0,1,1,1
TRBV20-1,TRBJ2-5,CSALPPWGQGEETQYF,0,1,1,1
TRBV20-1,TRBJ2-5,CSALRGLAGSQETQYF,0,1,1,1
TRBV19,TRBJ1-1,SASPCVEGGSTEAFF,0,1,1,1
TRBV12-5,TRBJ1-5,CASGTGRVSNQPQHF,0,1,1,1
TRBV30,TRBJ1-1,CAWSWRAGGGTEAFF,0,1,1,1
TRBV30,TRBJ2-1,CAWSLGLARNNEQFF,0,1,1,1
TRBV30,TRBJ2-2,CAWRVGYQNTGELFF,0,1,1,1
TRBV12-5,TRBJ2-1,CALMEGQGTYNEQFF,0,1,1,1
TRBV10-3,TRBJ1-6,CAISSGQGGNSPLHF,0,1,1,1
TRBV10-3,TRBJ2-2,CATLRGSQNTGELFF,0,1,1,1
TRBV15,TRBJ2-3,CATSRGDSETDTQYF,0,1,1,1
TRBV19,TRBJ2-3,CASSIARTGSDTQYF,0,1,1,1
TRBV18,TRBJ1-1,CASSPGSQENTEAFF,0,1,1,1
TRBV18,TRBJ1-1,CASSRQTGGNTEAFF,0,1,1,1
TRBV12-3/4,TRBJ2-1,CASRFLGGGRNEQFF,0,1,1,1
TRBV18,TRBJ2-7,CASARSGGRNYEQYF,0,1,1,1
TRBV12-3/4,TRBJ2-1,CASTLRVAGINEQFF,0,1,1,1
TRBV7-2,TRBJ2-1,CASTRGAGLNNEQFF,0,1,1,1
TRBV12-3/4,TRBJ1-2,CASSFSRRSGDGYTF,0,1,1,1
TRBV6-2/3/5/6,TRBJ2-2,CASSLGLAGAGELFF,0,1,1,1
TRBV6-2/3/5/6,TRBJ1-5,CASSLWGTFNQPQHF,0,1,1,1
TRBV6-2/3/5/6,TRBJ2-1,CASSLYRGTYNEQFF,0,1,1,1
TRBV27,TRBJ1-1,CASSLVRQDPEAGFF,0,1,1,1
TRBV28,TRBJ2-3,CASSLRQLGTDTQYF,0,1,1,1
TRBV7-9,TRBJ2-7,CASSSTGTGVYEQYF,0,1,1,1
TRBV6-2/3/5/6,TRBJ2-3,CASSSPSGSTDTQYF,0,1,1,1
TRBV2,TRBJ1-5,CASSWDGYSNQPQHF,0,1,1,1
TRBV27,TRBJ1-1,CASSPLSPGQPPSFF,0,1,1,1
TRBV12-3/4,TRBJ2-3,CASSPSAGVRDTQYF,0,1,1,1
TRBV7-6,TRBJ2-1,CASSHTSGRANEQFF,0,1,1,1
TRBV28,TRBJ2-1,CASSQLTGSPGEQLF,0,1,1,1
TRBV7-9,TRBJ1-1,CASSQRRGGYTEAFF,0,1,1,1
TRBV6-1,TRBJ2-2,CASSVASGQTGELFF,0,1,1,1
TRBV2,TRBJ2-1,CASSVGTSANNEQFF,0,1,1,1
TRBV6-1,TRBJ2-3,CASSGRTGGEDTQYF,0,1,1,1
TRBV6-4,TRBJ2-3,CASSDSSGGADTQYF,0,1,1,1
TRBV6-1,TRBJ2-7,CASSESSGSSYERYF,0,1,1,1
TRBV6-1,TRBJ2-2,CASSESSGRASELFF,0,1,1,1
TRBV2,TRBJ2-5,CASSENGQNQETQYF,0,1,1,1
TRBV12-3/4,TRBJ2-7,CASSILRDRVYEQYF,0,1,1,1
TRBV28,TRBJ2-7,CASSTTADRGDEQYF,0,1,1,1
TRBV11-2,TRBJ2-1,CASSTGTSPNNEQFF,0,1,1,1
TRBV7-3,TRBJ2-5,CASSFGQGAKETQYF,0,1,1,1
TRBV7-9,TRBJ2-7,CASSLEGQGPYEQYF,0,1,1,1
TRBV7-2,TRBJ2-4,CASSLTPSQGGIQYF,0,1,1,1
TRBV7-2,TRBJ1-1,CASSLRGQEYTEAFF,0,1,1,1
TRBV7-6,TRBJ2-1,CASSLLASSYNEQFF,0,1,1,1
TRBV7-3,TRBJ2-5,CASSLVVGRGETQYF,0,1,1,1
TRBV7-2,TRBJ2-1,CASSLAGDSYNEQFF,0,1,1,1
TRBV6-2/3/5/6,TRBJ2-1,CASSLGHSSYNEQFF,0,1,1,1
TRBV7-2,TRBJ1-1,CASSLGQGMNTEAFF,0,1,1,1
TRBV7-6,TRBJ1-3,CASSLGGDSGNTIYF,0,1,1,1
TRBV7-6,TRBJ2-1,CASSLTSGRDNEQFF,0,1,1,1
TRBV7-2,TRBJ1-5,CASSLTRNSNQPQHF,0,1,1,1
TRBV7-2,TRBJ2-2,CASSLTQINTGELFF,0,1,1,1
TRBV7-9,TRBJ2-3,CASSLSLAGTDTQYF,0,1,1,1
TRBV7-8,TRBJ2-7,CASSLSGRTSYEQYF,0,1,1,1
TRBV7-9,TRBJ2-2,CASSLRAGNTGELFF,0,1,1,1
TRBV7-3,TRBJ2-5,CASSLKGARKETQYF,0,1,1,1
TRBV7-9,TRBJ2-1,CASSSRRDREGEQFF,0,1,1,1
TRBV7-9,TRBJ2-7,CASSLPTSGRGEQYF,0,1,1,1
TRBV12-3/4,TRBJ2-1,CASSLRDRVYNEQFF,0,1,1,1
TRBV3-1,TRBJ2-2,CASSLRQGNTGELFF,0,1,1,1
TRBV7-2,TRBJ2-1,CASSLSGGVYNEQFF,0,1,1,1
TRBV4-2,TRBJ1-2,CASSLDVGGSYGYTF,0,1,1,1
TRBV7-9,TRBJ1-2,CASSLTTETNYGYTF,0,1,1,1
TRBV7-2,TRBJ1-2,CASSPSPGANYGYTF,0,1,1,1
TRBV7-2,TRBJ1-2,CASSPAPGTSGGYTF,0,1,1,1
TRBV7-2,TRBJ2-1,CASSPWGGGNNEQFF,0,1,1,1
TRBV11-1,TRBJ2-5,CASSPDGYREETQYF,0,1,1,1
TRBV11-3,TRBJ2-7,CASSRGQGTDYEQYS,0,1,1,1
TRBV7-3,TRBJ2-1,CASSRTSGGYNEQFF,0,1,1,1
TRBV7-2,TRBJ2-7,CASSRPGQGAGEQYF,0,1,1,1
TRBV5-6,TRBJ2-1,CASSRAGGPWNEQFF,0,1,1,1
TRBV14,TRBJ1-4,CASSQAGHLNEKLFF,0,1,1,1
TRBV9,TRBJ2-5,CASSVGSVVQETQYF,0,1,1,1
TRBV9,TRBJ2-1,CASSADGGSYNEQFF,0,1,1,1
TRBV7-6,TRBJ1-4,CASSGGGMANEKLFF,0,1,1,1
TRBV7-6,TRBJ1-5,CASSMETGGVQPQHF,0,1,1,1
TRBV9,TRBJ1-2,CASSIARGQGEGYTF,0,1,1,1
TRBV5-4,TRBJ2-7,CASSSNLQGAFEQYF,0,1,1,1
TRBV7-3,TRBJ2-3,CASSRSGTKTDTQYF,0,1,1,1
TRBV11-2,TRBJ2-1,CASRRDAAPYDEQFF,0,1,1,1
TRBV12-3/4,TRBJ1-5,CASRTDIGGNQPQHF,0,1,1,1
TRBV5-1,TRBJ2-1,CASFSRLGGFNEQFF,0,1,1,1
TRBV5-1,TRBJ1-1,CASTLDPGGRSEAFF,0,1,1,1
TRBV5-1,TRBJ2-7,CASSFLGQGYDEQYF,0,1,1,1
TRBV5-1,TRBJ1-1,CASSFEGSWNTEAFF,0,1,1,1
TRBV5-1,TRBJ1-1,CASSLGGQGVPEAFF,0,1,1,1
TRBV5-1,TRBJ2-1,CASSLEGGSYNEQFF,0,1,1,1
TRBV5-1,TRBJ1-5,CASSLTPDGFQPQHF,0,1,1,1
TRBV5-1,TRBJ2-3,CASSLTRGGTDTQYF,0,1,1,1
TRBV5-1,TRBJ2-7,CASSSSGTGSYEQYF,0,1,1,1
TRBV5-1,TRBJ2-5,CASSSDTGARETQYF,0,1,1,1
TRBV5-1,TRBJ2-7,CASSLRGQGRDEQYF,0,1,1,1
TRBV4-1,TRBJ2-7,CASSRPGQDIYEQYF,0,1,1,1
TRBV4-3,TRBJ2-4,CASSQGVGGRNIQYF,0,1,1,1
TRBV4-1,TRBJ2-7,CASSQVIGSNYEQYF,0,1,1,1
TRBV4-1,TRBJ2-5,CASSQDRSGRETQYF,0,1,1,1
TRBV4-3,TRBJ1-5,CASSQDQGEGQPQHF,0,1,1,1
TRBV4-3,TRBJ2-7,CASSQEGASSYEQYF,0,1,1,1
TRBV5-1,TRBJ2-7,CASSIYRDRAHEQYF,0,1,1,1
TRBV5-1,TRBJ2-1,CASRMGGRLTNEQFF,0,1,1,1
TRBV20-1,TRBJ2-3,CSAFTSGGAKDTQYF,0,1,1,1
TRBV20-1,TRBJ2-5,CSALPPEGVGETQYF,0,1,1,1
TRBV20-1,TRBJ2-1,CSAGSGGGERTEQFF,0,1,1,1
TRBV20-1,TRBJ2-3,CSASISGSGADTQYF,0,1,1,1
TRBV20-1,TRBJ2-3,CSARPGTSGGNTQYF,0,1,1,1
TRBV20-1,TRBJ1-6,CSARRGTEYNSPLHF,0,1,1,1
TRBV20-1,TRBJ2-5,CSARGLADYQETQYF,0,1,1,1
TRBV20-1,TRBJ1-6,CSAVSGTGSNSPLHF,0,1,1,1
TRBV20-1,TRBJ2-3,CSAGDSATSTDTQYF,0,1,1,1
TRBV20-1,TRBJ2-6,CSGLAGSSGANVLTF,0,1,1,1
TRBV29-1,TRBJ1-5,CSVSTGGYGDQPQHF,0,1,1,1
TRBV29-1,TRBJ2-5,CSVVGLAGGSWAQYF,0,1,1,1
TRBV29-1,TRBJ2-7,CSVEDRDRGTYEQYF,0,1,1,1
TRBV29-1,TRBJ1-2,CSVEEGQDPIGGYTF,0,1,1,1
TRBV29-1,TRBJ2-1,CSVENRDTGTYEQFF,0,1,1,1
TRBV29-1,TRBJ2-7,CSAHLRQGGPYEQYF,0,1,1,1
TRBV29-1,TRBJ2-7,CSAKVLGTSSYEQYF,0,1,1,1
TRBV29-1,TRBJ1-5,CSGTTGGYGNQPQHF,0,1,1,1
TRBV29-1,TRBJ1-1,RSVRGQGVLNTEAFF,0,1,1,1
TRBV28,TRBJ1-1,CATQTGQENTEAFF,0,1,1,1
TRBV12-5,TRBJ1-2,CASGIPTGLGGYTF,0,1,1,1
TRBV30,TRBJ2-5,CALTTSGRVETQYF,0,1,1,1
TRBV30,TRBJ2-7,CAWSPTGVGYEQYF,0,1,1,1
TRBV30,TRBJ2-1,CAWNPSGRANEQFF,0,1,1,1
TRBV19,TRBJ2-5,CASSSLAGVETQYF,0,1,1,1
TRBV19,TRBJ2-7,CASSPTTTGNQQYF,0,1,1,1
TRBV19,TRBJ1-6,CASSILGANSPLHF,0,1,1,1
TRBV6-2/3/5/6,TRBJ1-5,CASSGTGENQPQHF,0,1,1,1
TRBV19,TRBJ2-7,CASRRGRESYEQYI,0,1,1,1
TRBV18,TRBJ1-1,CASSLQQLNTEAFF,0,1,1,1
TRBV18,TRBJ1-1,CASSPLQVNTEAFF,0,1,1,1
TRBV18,TRBJ1-4,CASSPAATNEKLFF,0,1,1,1
TRBV18,TRBJ1-5,CASSPGISNQPQHF,0,1,1,1
TRBV18,TRBJ1-2,CASSPGTDVYGYTF,0,1,1,1
TRBV18,TRBJ1-5,CASSPNRVDQPQHF,0,1,1,1
TRBV28,TRBJ2-3,CASGRSTYTDTQYF,0,1,1,1
TRBV11-2,TRBJ2-2,CASDRGLLAGELFF,0,1,1,1
TRBV7-2,TRBJ2-7,CASIPGAEADEQYF,0,1,1,1
TRBV19,TRBJ1-3,CASTSGSSGNTIYF,0,1,1,1
TRBV24-1,TRBJ2-6,CASTPETGEDVLTF,0,1,1,1
TRBV6-2/3/5/6,TRBJ2-3,CASTPRRSTDTQYF,0,1,1,1
TRBV12-3/4,TRBJ1-6,CASTRQEYNSPLHF,0,1,1,1
TRBV11-2,TRBJ2-1,CASTQPSGRYEQFF,0,1,1,1
TRBV12-3/4,TRBJ1-5,CASTGQGRNQPQHF,0,1,1,1
TRBV28,TRBJ1-1,CASTGTGVYTEAFF,0,1,1,1
TRBV12-3/4,TRBJ1-5,CASSFLGQAQPQHF,0,1,1,1
TRBV27,TRBJ1-1,CASSLGQGSTEAFF,0,1,1,1
TRBV6-2/3/5/6,TRBJ2-7,CASSSGTGLYEQYF,0,1,1,1
TRBV27,TRBJ1-2,CASSSGGANYGYTF,0,1,1,1
TRBV6-2/3/5/6,TRBJ2-5,CASSYRTGEETQYF,0,1,1,1
TRBV9,TRBJ2-2,CASSRSGNTGELFF,0,1,1,1
TRBV6-1,TRBJ2-1,CASSVGNNYNEQFF,0,1,1,1
TRBV25-1,TRBJ1-4,CASSARGLNEKLFF,0,1,1,1
TRBV2,TRBJ1-5,CASSATSSNQPRHF,0,1,1,1
TRBV25-1,TRBJ2-1,CASSEVNRYNEQFF,0,1,1,1
TRBV2,TRBJ2-1,CASSEAGTGNEQFF,0,1,1,1
TRBV6-1,TRBJ2-5,CASSEEKGGETQYF,0,1,1,1
TRBV25-1,TRBJ2-7,CASSTTGTAGEQYF,0,1,1,1
TRBV7-2,TRBJ2-1,CASSFTRGQGEQFF,0,1,1,1
TRBV7-9,TRBJ1-1,CASSFALGNSEAFF,0,1,1,1
TRBV7-2,TRBJ2-7,CASSFGYNSYEQYF,0,1,1,1
TRBV13,TRBJ2-7,CASSFGVSRDEQYF,0,1,1,1
TRBV7-2,TRBJ2-7,CASSFSGSSYEQYF,0,1,1,1
TRBV7-6,TRBJ2-3,CASSLSTYTDTQYF,0,1,1,1
TRBV7-2,TRBJ2-5,CASSLPVVQETQYF,0,1,1,1
TRBV7-2,TRBJ2-7,CASSLPGLAVWQYF,0,1,1,1
TRBV11-2,TRBJ1-5,CASSLQGSNQPQHF,0,1,1,1
TRBV7-2,TRBJ2-7,CASSLAVTTYEQYF,0,1,1,1
TRBV7-6,TRBJ1-2,CASSLAKGSYGYTF,0,1,1,1
TRBV7-2,TRBJ2-1,CASSLGGGEGEQFF,0,1,1,1
TRBV7-3,TRBJ2-3,CASSLGGFSDTQYF,0,1,1,1
TRBV7-2,TRBJ1-2,CASSLGKGRYGYTF,0,1,1,1
TRBV7-9,TRBJ2-2,CASSLDRVTGELFF,0,1,1,1
TRBV7-2,TRBJ1-1,CASSSVIEGTEAFF,0,1,1,1
TRBV7-9,TRBJ1-1,CASSSGRWGTEAFF,0,1,1,1
TRBV3-1,TRBJ1-1,CASSWTGGNTEAFF,0,1,1,1
TRBV6-2/3/5/6,TRBJ2-7,CASSLPGQAGEQYF,0,1,1,1
TRBV11-2,TRBJ1-2,CASSLGGLNYGYTF,0,1,1,1
TRBV7-2,TRBJ1-2,CASSLGQEYYGYTF,0,1,1,1
TRBV7-9,TRBJ1-1,CASSPTGGLGEAFF,0,1,1,1
TRBV7-6,TRBJ2-3,CASSPYGGADTQYF,0,1,1,1
TRBV11-2,TRBJ1-2,CASSPRGGYYGYTF,0,1,1,1
TRBV6-2/3/5/6,TRBJ2-1,CASSPRDSTNEQFF,0,1,1,1
TRBV12-3/4,TRBJ1-1,CASSPRTLNTEAFF,0,1,1,1
TRBV6-2/3/5/6,TRBJ2-6,CASSPVYGANVLTF,0,1,1,1
TRBV28,TRBJ1-4,CASSPADFNEKLFF,0,1,1,1
TRBV7-2,TRBJ2-5,CASSPGPMMETQYF,0,1,1,1
TRBV7-9,TRBJ1-1,CASSPGQGYTEAFF,0,1,1,1
TRBV11-2,TRBJ2-2,CASSQTGMGGELFF,0,1,1,1
TRBV6-2/3/5/6,TRBJ2-5,CASSQGGYQETQYF,0,1,1,1
TRBV4-2,TRBJ2-4,CASSQESRGNIQYF,0,1,1,1
TRBV3-1,TRBJ2-1,CASSQEGDNNEQFF,0,1,1,1
TRBV3-1,TRBJ1-1,CASSQSPENTEAFF,0,1,1,1
TRBV9,TRBJ1-2,CASSVLASNYGYTF,0,1,1,1
TRBV5-6,TRBJ1-6,CASSAIWSDSPLHF,0,1,1,1
TRBV7-9,TRBJ2-7,CASSAKGGSYEQYF,0,1,1,1
TRBV7-6,TRBJ1-5,CASSTGQGAQPQHF,0,1,1,1
TRBV7-6,TRBJ2-5,CASSNYNEGETQYF,0,1,1,1
TRBV6-2/3/5/6,TRBJ1-3,CASRSTVSGNTIYF,0,1,1,1
TRBV27,TRBJ1-4,CASRYRGLGEKLFF,0,1,1,1
TRBV2,TRBJ2-5,CASRAGTGAETQYF,0,1,1,1
TRBV5-6,TRBJ2-2,CASRAVSNTGELFF,0,1,1,1
TRBV2,TRBJ2-2,CASRGGGITGELFF,0,1,1,1
TRBV6-1,TRBJ2-1,CASREDRTYNEQFF,0,1,1,1
TRBV6-1,TRBJ1-2,CASRKGGIANGYTF,0,1,1,1
TRBV12-3/4,TRBJ1-1,CASRLGDRNTEAFF,0,1,1,1
TRBV7-9,TRBJ1-1,CASRGGGKNTEAFF,0,1,1,1
TRBV12-3/4,TRBJ2-1,CASKTSGRLNEQFF,0,1,1,1
TRBV18,TRBJ1-1,CASSPAKTGPQAFF,0,1,1,1
TRBV5-1,TRBJ2-1,CASSFLQGADEQFF,0,1,1,1
TRBV5-1,TRBJ2-7,CASSFDRVAYEQYF,0,1,1,1
TRBV5-1,TRBJ2-3,CASSLLGGRDTQYF,0,1,1,1
TRBV5-1,TRBJ2-7,CASSSGGTIYEQYF,0,1,1,1
TRBV5-1,TRBJ2-3,CASSSGQFTDTQYF,0,1,1,1
TRBV5-1,TRBJ2-2,CASSWRQDTGELFF,0,1,1,1
TRBV5-1,TRBJ1-1,CASSPVGSVYEAFF,0,1,1,1
TRBV4-1,TRBJ1-2,CASSQDIREIGYTF,0,1,1,1
TRBV5-1,TRBJ2-7,CASSGPYLNHEQYF,0,1,1,1
TRBV5-1,TRBJ2-2,CASSEGLLAGELFF,0,1,1,1
TRBV5-1,TRBJ1-2,CASRVGARHYGYTF,0,1,1,1
TRBV5-1,TRBJ2-1,CASRAGGDTGPQFY,0,1,1,1
TRBV5-1,TRBJ2-6,CASRPDRGLRGTTF,0,1,1,1
TRBV20-1,TRBJ2-3,CSATLAGVGDTQYF,0,1,1,1
TRBV20-1,TRBJ2-1,CSASVAPGGHEQFF,0,1,1,1
TRBV20-1,TRBJ1-5,CSASGLTNNQPQHF,0,1,1,1
TRBV20-1,TRBJ2-7,CSASDQGTSYEQYF,0,1,1,1
TRBV20-1,TRBJ2-7,CSARVRGRVDEQYF,0,1,1,1
TRBV20-1,TRBJ1-1,CSARKDRVNTEAFF,0,1,1,1
TRBV20-1,TRBJ2-1,CSAGGTSGGNEQFF,0,1,1,1
TRBV20-1,TRBJ1-4,CSADTGQGDEKLFF,0,1,1,1
TRBV29-1,TRBJ1-4,CSVEVGTGEEKLSF,0,1,1,1
TRBV29-1,TRBJ2-7,CSGSQGEVAYEQYF,0,1,1,1
TRBV7-7,TRBJ1-6,CASSSDRGSPLHF,0,1,1,1
TRBV30,TRBJ1-6,CACRGSYNSPLHF,0,1,1,1
TRBV30,TRBJ1-1,CAWSRGRLTEAFF,0,1,1,1
TRBV30,TRBJ2-7,CAWNEGDRGEQYF,0,1,1,1
TRBV10-3,TRBJ2-7,CAISEGRAYEQYF,0,1,1,1
TRBV10-3,TRBJ2-7,CAISEGTVYEQYF,0,1,1,1
TRBV10-3,TRBJ1-1,CAISTGEGTEAFF,0,1,1,1
TRBV10-3,TRBJ2-3,CAIKGVEADTQYF,0,1,1,1
TRBV19,TRBJ1-2,CATQTGGRYGYTF,0,1,1,1
TRBV9,TRBJ2-2,CASSGGSAGELFF,0,1,1,1
TRBV19,TRBJ2-7,CASSVTGTYEQYF,0,1,1,1
TRBV19,TRBJ1-5,CASSGGPNQPQHF,0,1,1,1
TRBV19,TRBJ1-1,CASSIALGMEAFF,0,1,1,1
TRBV19,TRBJ1-5,CASSGTDNQPQHF,0,1,1,1
TRBV19,TRBJ1-2,CASRPGSSSGYTF,0,1,1,1
TRBV18,TRBJ2-3,CASSSRRTDTQYF,0,1,1,1
TRBV18,TRBJ2-1,CASSPQREDEQFF,0,1,1,1
TRBV18,TRBJ2-1,CASSPNSGDEQFF,0,1,1,1
TRBV18,TRBJ1-2,CASSGPGDYGYTF,0,1,1,1
TRBV6-2/3/5/6,TRBJ2-5,CASRTGGRETQYF,0,1,1,1
TRBV6-2/3/5/6,TRBJ2-7,CASQSLGTYEQYF,0,1,1,1
TRBV7-9,TRBJ2-7,CASGLGPEGKQYF,0,1,1,1
TRBV7-9,TRBJ1-1,CASGSPFNTEAFS,0,1,1,1
TRBV7-7,TRBJ2-1,CASGGHSYNEQFL,0,1,1,1
TRBV25-1,TRBJ1-1,CASMGVMNTEAFF,0,1,1,1
TRBV19,TRBJ1-5,CASMDRTDQPQHF,0,1,1,1
TRBV7-2,TRBJ2-5,CASTLGGWETQYF,0,1,1,1
TRBV28,TRBJ1-6,CASSFGVNSPLHF,0,1,1,1
TRBV12-3/4,TRBJ1-1,CASSLFRYAEAFF,0,1,1,1
TRBV12-3/4,TRBJ1-1,CASSLNRGTEAFF,0,1,1,1
TRBV2,TRBJ2-5,CASSSEGAETQYF,0,1,1,1
TRBV12-3/4,TRBJ1-5,CASSWTGNQPQHF,0,1,1,1
TRBV6-2/3/5/6,TRBJ1-1,CASSYSENTEAFF,0,1,1,1
TRBV6-2/3/5/6,TRBJ1-2,CASSPGRGYGYTF,0,1,1,1
TRBV12-3/4,TRBJ2-5,CASSPGPQETQYF,0,1,1,1
TRBV12-3/4,TRBJ2-7,CASSPMDSYEQYF,0,1,1,1
TRBV6-1,TRBJ1-5,CASSVGSNQPQHF,0,1,1,1
TRBV6-4,TRBJ2-5,CASSDQGGETQYF,0,1,1,1
TRBV6-4,TRBJ2-4,CASSDGQGAARGF,0,1,1,1
TRBV6-2/3/5/6,TRBJ1-1,CASSRTKNTEAFF,0,1,1,1
TRBV7-9,TRBJ2-1,CASSLVFGGEQFF,0,1,1,1
TRBV7-2,TRBJ2-1,CASSLGPYDGQFF,0,1,1,1
TRBV7-9,TRBJ2-5,CASSLGVMETQYF,0,1,1,1
TRBV7-9,TRBJ2-5,CASSLGGQETQYF,0,1,1,1
TRBV7-9,TRBJ1-1,CASSLERETEAFF,0,1,1,1
TRBV13,TRBJ2-5,CASSLTDQETQYF,0,1,1,1
TRBV7-2,TRBJ1-1,CASSSRVGTEAFF,0,1,1,1
TRBV7-6,TRBJ2-3,CASSLDREDTQYF,0,1,1,1
TRBV7-2,TRBJ2-1,CASSLTSRREQFF,0,1,1,1
TRBV7-3,TRBJ2-6,CASSPPGANVLTF,0,1,1,1
TRBV11-2,TRBJ2-7,CASSPGGALEQYF,0,1,1,1
TRBV7-2,TRBJ2-7,CASSHPGFYEQYF,0,1,1,1
TRBV4-2,TRBJ1-1,CASSQGQNTEAFF,0,1,1,1
TRBV3-1,TRBJ1-2,CASSQDSGSGYTF,0,1,1,1
TRBV3-1,TRBJ2-7,CASSQEGAYEQYF,0,1,1,1
TRBV9,TRBJ2-3,CASSVSFTDTQYF,0,1,1,1
TRBV5-5,TRBJ2-5,CASSVGRTETQYF,0,1,1,1
TRBV9,TRBJ2-5,CASSVGGLETQYF,0,1,1,1
TRBV11-3,TRBJ1-1,CASSAQLGGKAFF,0,1,1,1
TRBV2,TRBJ2-5,CASSAERHRGHGF,0,1,1,1
TRBV12-3/4,TRBJ1-1,CASRPGQGARAFF,0,1,1,1
TRBV12-3/4,TRBJ2-5,CASRRDGQETQYF,0,1,1,1
TRBV10-2,TRBJ2-7,CASARGQGLEQYF,0,1,1,1
TRBV5-1,TRBJ2-1,CASSPGVENEQFF,0,1,1,1
TRBV5-1,TRBJ2-3,CASSFDTADTQYF,0,1,1,1
TRBV5-1,TRBJ2-3,CASSLPSEDTQYF,0,1,1,1
TRBV5-1,TRBJ2-1,CASSLVPGNEQFF,0,1,1,1
TRBV5-1,TRBJ2-1,CASSSQGGNEQFF,0,1,1,1
TRBV4-1,TRBJ2-7,CASSRDGPYEQYS,0,1,1,1
TRBV4-1,TRBJ2-1,CASSQVGVLEQFF,0,1,1,1
TRBV5-1,TRBJ2-7,CASSQGQVNEQYF,0,1,1,1
TRBV4-3,TRBJ2-7,CASSQDVTQPQYF,0,1,1,1
TRBV4-3,TRBJ1-2,CASSQEIRDGYTF,0,1,1,1
TRBV10-2,TRBJ1-1,CASRVGFLSEAFF,0,1,1,1
TRBV20-1,TRBJ1-1,CSAAPTANTEAFF,0,1,1,1
TRBV20-1,TRBJ2-1,CSAGREFHNEQFF,0,1,1,1
TRBV20-1,TRBJ2-1,CSATLAGVNEQFF,0,1,1,1
TRBV20-1,TRBJ1-1,CSARWGRWDEAFF,0,1,1,1
TRBV20-1,TRBJ1-5,CSARDFQDQPQHF,0,1,1,1
TRBV20-1,TRBJ2-5,CSARDSAKETQYF,0,1,1,1
TRBV20-1,TRBJ2-7,CSATDRAIDEQYF,0,1,1,1
TRBV20-1,TRBJ1-5,CSASDSSNQPQHF,0,1,1,1
TRBV29-1,TRBJ1-1,CSSVRRRDTEAFF,0,1,1,1
TRBV29-1,TRBJ2-5,CSVLRRPEETQYF,0,1,1,1
TRBV29-1,TRBJ2-7,CSVEGTGVNKQYF,0,1,1,1
TRBV29-1,TRBJ2-1,CSVEDSHFNEQFF,0,1,1,1
TRBV29-1,TRBJ1-2,CSVRSETDYGYTF,0,1,1,1
TRBV29-1,TRBJ2-5,CSVGQGAQETQYF,0,1,1,1
TRBV29-1,TRBJ2-1,CSVRTKGNDEQFF,0,1,1,1
TRBV20-1,TRBJ2-3,CSTPDGATDTQYF,0,1,1,1
TRBV10-3,TRBJ1-1,CASRDRATEAFF,0,1,1,1
TRBV30,TRBJ2-1,CAWSGSGNEQFF,0,1,1,1
TRBV30,TRBJ2-1,CAWKGFNNEQFF,0,1,1,1
TRBV10-3,TRBJ2-7,CAISDRGHEQYF,0,1,1,1
TRBV19,TRBJ1-2,CASYKGDGGYTF,0,1,1,1
TRBV19,TRBJ1-2,CASIGGNYGYTF,0,1,1,1
TRBV7-2,TRBJ2-3,CASSAAGNTQYF,0,1,1,1
TRBV18,TRBJ2-5,CASSQYQETQYF,0,1,1,1
TRBV9,TRBJ1-2,CASGPVNYGYTF,0,1,1,1
TRBV14,TRBJ2-1,CASGQADDEQFF,0,1,1,1
TRBV11-2,TRBJ1-2,CASTPTYYGYTF,0,1,1,1
TRBV6-2/3/5/6,TRBJ1-5,CASSFQVVPQHF,0,1,1,1
TRBV6-2/3/5/6,TRBJ2-3,CASSSGSGTQYF,0,1,1,1
TRBV12-3/4,TRBJ2-5,CASSSNRGTQYF,0,1,1,1
TRBV7-9,TRBJ1-2,CASSWDGNGYTF,0,1,1,1
TRBV6-2/3/5/6,TRBJ2-3,CASSYVSDTQYF,0,1,1,1
TRBV6-2/3/5/6,TRBJ1-6,CASSYGESPLHF,0,1,1,1
TRBV5-6,TRBJ2-4,CASSFTTNIQYF,0,1,1,1
TRBV7-9,TRBJ2-7,CASSFHPYEQYF,0,1,1,1
TRBV11-1,TRBJ2-1,CASSLSGTEQFF,0,1,1,1
TRBV7-9,TRBJ2-7,CASSLAGPGQYF,0,1,1,1
TRBV7-9,TRBJ1-5,CASSLGGQPQHF,0,1,1,1
TRBV7-9,TRBJ2-7,CASSLGRYEQYF,0,1,1,1
TRBV11-2,TRBJ2-5,CASSLGGRTQYF,0,1,1,1
TRBV25-1,TRBJ2-6,CASSSGANVLTF,0,1,1,1
TRBV7-9,TRBJ2-7,CASSSPWSEQYF,0,1,1,1
TRBV7-9,TRBJ1-5,CASSSNNQPQHF,0,1,1,1
TRBV5-6,TRBJ2-2,CASSSYTGELFF,0,1,1,1
TRBV7-9,TRBJ2-3,CASSSRADTQYF,0,1,1,1
TRBV11-1,TRBJ1-2,CASSLVRDGYTF,0,1,1,1
TRBV3-1,TRBJ1-2,CASSPGESGYTF,0,1,1,1
TRBV3-1,TRBJ2-3,CASSQASDTQYF,0,1,1,1
TRBV7-2,TRBJ2-2,CASSGNPGELFF,0,1,1,1
TRBV28,TRBJ1-1,CASSGGNTEAFF,0,1,1,1
TRBV11-3,TRBJ1-1,CASSDRPIKAFF,0,1,1,1
TRBV2,TRBJ1-2,CASSESVDGYTF,0,1,1,1
TRBV7-2,TRBJ2-1,CASRLAGSEQFF,0,1,1,1
TRBV6-2/3/5/6,TRBJ1-2,CASRHLVYGYTF,0,1,1,1
TRBV6-2/3/5/6,TRBJ2-7,CASRRNTYEQYF,0,1,1,1
TRBV5-1,TRBJ1-2,CATTTGSRGYTF,0,1,1,1
TRBV5-1,TRBJ2-5,CASSLLEETQYF,0,1,1,1
TRBV20-1,TRBJ2-1,CSASPQVDEQFF,0,1,1,1
TRBV20-1,TRBJ2-1,CSASVLARGQFF,0,1,1,1
TRBV20-1,TRBJ2-3,CSARGRSDTQYF,0,1,1,1
TRBV20-1,TRBJ2-1,CSAKRGYNEQFF,0,1,1,1
TRBV20-1,TRBJ2-5,CSASPGQETQYF,0,1,1,1
TRBV20-1,TRBJ2-7,CSAGGLAYEQYF,0,1,1,1
TRBV29-1,TRBJ2-1,CSVVAGLNEQFF,0,1,1,1
TRBV29-1,TRBJ2-5,CSVELGGETQYF,0,1,1,1
TRBV29-1,TRBJ2-5,CSVETGEETQYF,0,1,1,1
TRBV29-1,TRBJ2-1,CSARGIYNEQFF,0,1,1,1
TRBV29-1,TRBJ1-1,CSGSPGGIGAFF,0,1,1,1
TRBV29-1,TRBJ2-7,CSIRRGQYEQYF,0,1,1,1
TRBV12-5,TRBJ2-1,CASGLTGQQFF,0,1,1,1
TRBV30,TRBJ2-7,CACRGTYEQYF,0,1,1,1
TRBV30,TRBJ2-7,CAWIAGNEQYF,0,1,1,1
TRBV30,TRBJ2-3,CAWSARGTQYF,0,1,1,1
TRBV6-2/3/5/6,TRBJ2-1,CAVRGEGEQFF,0,1,1,1
TRBV7-2,TRBJ2-7,CAISLYYEQHF,0,1,1,1
TRBV18,TRBJ2-7,CASSQGDEQYF,0,1,1,1
TRBV6-4,TRBJ2-7,CASRDNYEQYF,0,1,1,1
TRBV2,TRBJ2-1,CASGWAWEQFF,0,1,1,1
TRBV6-2/3/5/6,TRBJ2-5,CASGGRETQYF,0,1,1,1
TRBV6-2/3/5/6,TRBJ1-2,CASSSTKGYTF,0,1,1,1
TRBV12-3/4,TRBJ2-7,CASSSPYEQYF,0,1,1,1
TRBV6-2/3/5/6,TRBJ2-7,CASSWGYEQYF,0,1,1,1
TRBV27,TRBJ2-3,CASSYTDTQYF,0,1,1,1
TRBV11-2,TRBJ2-3,CASSFVDTQYF,0,1,1,1
TRBV7-2,TRBJ2-7,CASSLPYEQYF,0,1,1,1
TRBV7-2,TRBJ2-7,CASSLVVEQYF,0,1,1,1
TRBV7-2,TRBJ2-1,CASSSLDEQFS,0,1,1,1
TRBV7-2,TRBJ2-1,CASSSLDEQFF,0,1,1,1
TRBV2,TRBJ2-7,CASRDSYEQYF,0,1,1,1
TRBV20-1,TRBJ1-4,CSASGDEKLFF,0,1,1,1
TRBV20-1,TRBJ1-1,CSASQNTEAFF,0,1,1,1
TRBV20-1,TRBJ2-1,CSATGDNEQFF,0,1,1,1
TRBV29-1,TRBJ2-7,CSVFTSYEQYF,0,1,1,1
TRBV29-1,TRBJ2-7,CSVAIVDEQYF,0,1,1,1
TRBV29-1,TRBJ2-1,CSVDSYNEQFF,0,1,1,1
TRBV29-1,TRBJ2-1,CSVIRDNEQFF,0,1,1,1
TRBV30,TRBJ1-1,CACPRTEAFF,0,1,1,1
