v_hit,j_hit,cdr3,S5-10ng_S10,S5-10ng_S22,freq,count_sum
TRBV5-6,TRBJ2-3,CASSSLRGGRDTQYF,164,0,1,164
TRBV14,TRBJ1-2,CASSPGRNYGYTF,105,94,2,199
TRBV2,TRBJ1-2,CASSEERDYGYTF,75,0,1,75
TRBV15,TRBJ2-5,CATSRDISGETQYF,72,0,1,72
TRBV19,TRBJ2-7,CASRAEATYEQYF,58,0,1,58
TRBV11-1,TRBJ1-1,CASSLTGDTEAFF,50,19,2,69
TRBV4-1,TRBJ1-1,CASSQGAGETEAFF,49,39,2,88
TRBV10-3,TRBJ2-2,CATEREGIGELFF,48,17,2,65
TRBV3-1,TRBJ1-5,CASSPGQGLYSNQPQHF,42,23,2,65
TRBV28,TRBJ2-3,CASSPLETSTDTQYF,39,40,2,79
TRBV2,TRBJ2-7,CASSGQGSSYEQYF,35,7,2,42
TRBV7-2,TRBJ2-7,CASSSSSYEQYF,40,35,2,75
TRBV30,TRBJ1-1,CAWSVGSYVINTEAFF,32,15,2,47
TRBV16,TRBJ1-1,CASSPFGGGNTEAFF,32,0,1,32
TRBV6-2/3/5/6,TRBJ2-5,CASSQDRNQETQYF,32,0,1,32
TRBV29-1,TRBJ2-5,CSVEAGETQYF,32,6,2,38
TRBV7-3,TRBJ2-5,CASSLGGGTQYF,31,0,1,31
TRBV11-1,TRBJ1-1,CASSPRQGVTEAFF,30,11,2,41
TRBV3-1,TRBJ2-2,CASSPSNTGELFF,30,0,1,30
TRBV20-1,TRBJ2-1,CSARVSMGQFF,28,0,1,28
TRBV5-4,TRBJ2-5,CSAGTGLAGYQETQYF,27,0,1,27
TRBV12-3/4,TRBJ1-2,CASSIPDRGPLSGYTF,25,0,1,25
TRBV9,TRBJ1-5,CASSQGDSLRPQHF,24,33,2,57
TRBV4-1,TRBJ1-1,CASSPPGESPALF,24,0,1,24
TRBV5-6,TRBJ2-1,CASSNTGVYNEQFF,23,0,1,23
TRBV19,TRBJ2-5,CASSRQGGIQETQYF,23,0,1,23
TRBV2,TRBJ1-3,CASRSRDAGNTIYF,22,13,2,35
TRBV11-2,TRBJ1-5,CASSSTGRNQPQHF,22,0,1,22
TRBV3-1,TRBJ2-7,CASSQTFSYEQYF,22,0,1,22
TRBV7-6,TRBJ2-1,CASSPPGGGAYNEQFF,21,0,1,21
TRBV7-2,TRBJ1-3,CASSFGVSGNTIYF,21,0,1,21
TRBV30,TRBJ2-1,CARSRGPYNEQFF,21,0,1,21
TRBV6-2/3/5/6,TRBJ2-5,CASSLNRQETQYF,21,0,1,21
TRBV14,TRBJ1-4,CASSRKRTAVNEKLFF,26,0,1,26
TRBV29-1,TRBJ2-1,CSVNRGPNEQFF,20,0,1,20
TRBV12-3/4,TRBJ1-5,CASSLSRWYSNQPQHF,20,0,1,20
TRBV3-1,TRBJ1-2,CASSQDVAGFGTPYGYTF,19,4,2,23
TRBV3-1,TRBJ1-3,CASSREQGSSGNTIYF,19,0,1,19
TRBV2,TRBJ1-2,CASSEDSIYGYTF,19,0,1,19
TRBV13,TRBJ2-2,CASNIAGRDTGELFF,19,29,2,48
TRBV5-4,TRBJ2-4,CASSFVEGNIQYF,19,0,1,19
TRBV9,TRBJ1-3,CASSATPHSGNTIYF,19,0,1,19
TRBV18,TRBJ1-5,CASSLSGGNQPQHF,19,0,1,19
TRBV20-1,TRBJ1-5,CSARRQETDSNQPQHF,19,0,1,19
TRBV20-1,TRBJ2-7,CSASAIDRDPYEQYF,19,0,1,19
TRBV7-9,TRBJ2-7,CASSLGLTYEQYF,18,0,1,18
TRBV3-1,TRBJ2-4,CASSQSNTRVIAKNIQYF,18,0,1,18
TRBV6-4,TRBJ2-2,CASRTLPGVVGTGELFF,18,0,1,18
TRBV19,TRBJ2-7,CASSLSDWGEPYEQYF,18,0,1,18
TRBV3-1,TRBJ2-7,CASSLKRTGEYEQYF,18,10,2,28
TRBV3-1,TRBJ2-3,CASSLAGGGLDTQYF,18,3,2,21
TRBV5-4,TRBJ1-2,CASTPGSTNYGYTF,18,0,1,18
TRBV2,TRBJ1-2,CASSEASNYGYTF,18,4,2,22
TRBV20-1,TRBJ2-5,CSATGGGETQYF,18,0,1,18
TRBV5-1,TRBJ2-1,CASSRTPNNPYNEQFF,18,0,1,18
TRBV6-2/3/5/6,TRBJ2-2,CASSLLPPSGSAGELFF,17,0,1,17
TRBV5-5,TRBJ1-6,CASSLGVRRPQDSPLHF,17,0,1,17
TRBV14,TRBJ2-3,CASSQVVSSTDTQYF,17,0,1,17
TRBV4-2,TRBJ2-7,CASSQEEGAYYEQYF,17,24,2,41
TRBV20-1,TRBJ2-1,CSARLDSGRINEQFF,17,0,1,17
TRBV5-1,TRBJ2-3,CASRGLGTDTQYF,17,0,1,17
TRBV3-1,TRBJ2-7,CASSQVYEQYF,17,0,1,17
TRBV3-1,TRBJ2-1,CASSQWKGAFSYNEQFF,24,12,2,36
TRBV5-6,TRBJ1-5,CASSLSGQGSNQPQHF,16,0,1,16
TRBV12-3/4,TRBJ2-7,CASSFGGGFYEQYF,16,0,1,16
TRBV11-3,TRBJ2-5,CASSRALETQYF,16,0,1,16
TRBV6-1,TRBJ2-7,CASSEFGYEQYF,16,3,2,19
TRBV3-1,TRBJ2-1,CASSPHRGSGVSNEQFF,15,0,1,15
TRBV12-3/4,TRBJ2-7,CASSFEGLADTYEQYF,15,0,1,15
TRBV14,TRBJ2-7,CASSPEDRAGAYEQYF,15,0,1,15
TRBV7-9,TRBJ2-7,CASSPSKDSNYEQYF,15,0,1,15
TRBV13,TRBJ1-1,CASSLLQGGTEAFF,15,0,1,15
TRBV28,TRBJ2-7,CASRSSGSSYEQYF,15,9,2,24
TRBV20-1,TRBJ2-3,CSAELAGGADTQYF,15,0,1,15
TRBV29-1,TRBJ2-7,CSVARSGSQDEQYF,15,0,1,15
TRBV30,TRBJ1-1,CAWSRSGPTEAFF,15,0,1,15
TRBV19,TRBJ1-5,CASSLGEDQPQHF,15,2,2,17
TRBV7-2,TRBJ1-1,CASSLGRDLEAFF,15,0,1,15
TRBV5-1,TRBJ2-7,CASSPGAAYEQYF,15,0,1,15
TRBV12-3/4,TRBJ2-3,CASGEGSDTQYF,15,0,1,15
TRBV2,TRBJ1-1,CASSYPGNGANTEAFF,15,0,1,15
TRBV5-6,TRBJ2-5,CASSLEFIETQYF,15,0,1,15
TRBV5-5,TRBJ1-4,CASSFVNEKLFF,15,0,1,15
TRBV18,TRBJ1-1,CASSLTDRGGTEAFF,14,0,1,14
TRBV19,TRBJ2-1,CASSILGFGEQFF,14,0,1,14
TRBV5-6,TRBJ2-3,CASSLERALLQTSTDTQYF,14,0,1,14
TRBV6-2/3/5/6,TRBJ2-1,CASSYRSWGSSYNEQFF,14,0,1,14
TRBV6-1,TRBJ2-3,CASSEAAGQGADTQYF,14,0,1,14
TRBV5-1,TRBJ2-2,CASSLYAGYNTGELFF,14,0,1,14
TRBV20-1,TRBJ2-2,CSARKQGLANTGELFF,14,0,1,14
TRBV7-9,TRBJ2-1,CASPHNGQGFVEQFF,14,0,1,14
TRBV28,TRBJ1-1,CASSLVRTTNTEAFF,14,5,2,19
TRBV6-2/3/5/6,TRBJ1-2,CASSPKRNLVNGYTF,14,0,1,14
TRBV2,TRBJ2-6,CASSAQGPGANVLTF,14,0,1,14
TRBV7-2,TRBJ2-3,CASSLDRISTDTQYF,14,27,2,41
TRBV6-2/3/5/6,TRBJ2-3,CASSPRGASTDTQYF,14,0,1,14
TRBV7-2,TRBJ2-3,CASSRTSDSTDTQYF,14,0,1,14
TRBV7-3,TRBJ2-7,CASSETSGGSYEQYF,14,0,1,14
TRBV19,TRBJ2-1,CASSMEVAYNEQFF,14,0,1,14
TRBV6-2/3/5/6,TRBJ2-3,CASSYSGLTDTQYF,14,0,1,14
TRBV11-3,TRBJ1-1,CASSLSQGMTEAFF,14,0,1,14
TRBV5-4,TRBJ2-2,CASSRDPLAGELFF,14,0,1,14
TRBV12-3/4,TRBJ2-3,CASSRDSQDTQYF,14,0,1,14
TRBV10-2,TRBJ2-5,CASSEPSQETQYF,14,0,1,14
TRBV5-6,TRBJ1-1,CASSFDRNTEAFF,13,0,1,13
TRBV7-9,TRBJ1-1,CASSLAEGEAFF,13,0,1,13
TRBV11-3,TRBJ2-1,CASSLGSEQFF,13,0,1,13
TRBV28,TRBJ2-7,CASSAAPLYEQYF,13,0,1,13
TRBV3-1,TRBJ1-4,CASSQLDEKLFF,13,0,1,13
TRBV3-1,TRBJ2-6,CASSQGAGQGSGANVLTF,13,0,1,13
TRBV7-2,TRBJ2-7,CASSPWGGPSSYEQYF,13,0,1,13
TRBV19,TRBJ2-2,CASTKELANTGELFF,13,0,1,13
TRBV2,TRBJ2-1,CASTPTEGSYNEQFF,13,0,1,13
TRBV12-3/4,TRBJ2-3,CASSFLAGSADTQYF,13,14,2,27
TRBV7-8,TRBJ2-1,CASSSQPNSYNEQFF,13,0,1,13
TRBV24-1,TRBJ1-1,CATSDLVRDTEAFF,13,0,1,13
TRBV19,TRBJ2-1,CASSVGLANNEQFF,13,0,1,13
TRBV5-5,TRBJ2-7,CASSSGTSLYEQYF,13,0,1,13
TRBV12-3/4,TRBJ2-1,CASSRGGFYNEQFF,13,0,1,13
TRBV7-2,TRBJ2-7,CASSRNLGTYEQYF,13,0,1,13
TRBV3-1,TRBJ1-1,CASSQVGTKGEAFF,13,0,1,13
TRBV3-1,TRBJ1-2,CASSQDPPNYGYTF,13,0,1,13
TRBV12-3/4,TRBJ2-1,CASRLTDRDNEQFF,13,15,2,28
TRBV5-1,TRBJ1-4,CASSLDPGNEKPFF,13,0,1,13
TRBV27,TRBJ2-3,CASSLSHTDTQYF,13,0,1,13
TRBV5-1,TRBJ2-7,CASSSTGAYEQYF,13,0,1,13
TRBV20-1,TRBJ1-2,CSATDGTNYGYTF,13,0,1,13
TRBV29-1,TRBJ1-1,CSGARGKNTEAFF,13,0,1,13
TRBV12-3/4,TRBJ2-2,CASSPGPNTGELFF,12,0,1,12
TRBV20-1,TRBJ1-5,CSASKPDEQIIPNQPQHF,12,0,1,12
TRBV27,TRBJ2-1,CASSLSGLADYNEQFF,12,4,2,16
TRBV5-4,TRBJ2-2,CASSFRLAGAGGELFF,12,11,2,23
TRBV5-8,TRBJ2-3,CASSPYRLVRTDTQYF,12,0,1,12
TRBV30,TRBJ2-1,CAWSVPYQAYNEQFF,12,0,1,12
TRBV6-1,TRBJ2-5,CASSERGRRSETQYF,12,0,1,12
TRBV7-9,TRBJ1-1,CASSLEGGLNTEAFF,12,10,2,22
TRBV7-3,TRBJ2-3,CASSKRTGGTDTQYF,12,0,1,12
TRBV4-3,TRBJ1-6,CASSQNMKGGSPLHF,12,6,2,18
TRBV4-3,TRBJ2-1,CASSQERTGFREQFF,12,0,1,12
TRBV20-1,TRBJ2-5,CSARPGQGDQETQYF,12,0,1,12
TRBV20-1,TRBJ2-5,CSASAPLGRQETQYF,12,0,1,12
TRBV19,TRBJ1-1,CASSPGGMNTEAFF,12,0,1,12
TRBV19,TRBJ2-3,CASRPDRGTDTQYF,12,0,1,12
TRBV12-3/4,TRBJ2-3,CASSLWGKSDTQYF,12,0,1,12
TRBV28,TRBJ1-2,CASSLRGGAGGYTF,12,0,1,12
TRBV12-3/4,TRBJ1-1,CASSLGGGDTEAFF,12,0,1,12
TRBV7-3,TRBJ1-1,CASSRDSMNTEAFF,12,0,1,12
TRBV6-4,TRBJ1-5,CASSDEIGGQPQHF,12,0,1,12
TRBV5-1,TRBJ1-1,CASSFDRVSSEAFF,12,0,1,12
TRBV5-1,TRBJ1-1,CASSLLQGNTEAFF,12,0,1,12
TRBV5-1,TRBJ2-7,CASSLLGQGYERYF,12,0,1,12
TRBV20-1,TRBJ1-1,CSARAGQGGTEAFF,12,0,1,12
TRBV20-1,TRBJ2-7,CSAREELEYGEQYF,12,0,1,12
TRBV29-1,TRBJ1-1,CSVLTGGVRTEAFF,12,0,1,12
TRBV12-3/4,TRBJ1-1,CASSLAVGWGAFF,12,0,1,12
TRBV5-5,TRBJ1-1,CASSLLGNTEAFF,12,0,1,12
TRBV7-6,TRBJ1-1,CASSLGVNTEAFF,12,0,1,12
TRBV7-3,TRBJ2-5,CASSLESQETQYF,12,5,2,17
TRBV7-2,TRBJ2-7,CASSSGRAVEQYF,12,0,1,12
TRBV14,TRBJ2-7,CASSHGFSAEQYF,12,0,1,12
TRBV29-1,TRBJ1-1,CSVDTGSRTEAFF,12,0,1,12
TRBV29-1,TRBJ2-1,CSALTGIWDEQFF,12,0,1,12
TRBV13,TRBJ1-1,CASSSRQGEAFF,12,0,1,12
TRBV14,TRBJ2-7,CASSQPGREQYF,12,0,1,12
TRBV20-1,TRBJ1-1,CSARDGDPEAFF,12,0,1,12
TRBV29-1,TRBJ1-2,CSVPDRVNGYTF,12,0,1,12
TRBV29-1,TRBJ1-2,CSVRDRNYGYTF,12,0,1,12
TRBV29-1,TRBJ1-4,CSFYNEKLFF,12,3,2,15
TRBV30,TRBJ1-1,CAWTTGQGLNTEAFF,12,0,1,12
TRBV12-5,TRBJ2-3,CASGTVSTDTQYF,12,0,1,12
TRBV2,TRBJ2-5,CASGRYQETQYF,12,0,1,12
TRBV7-6,TRBJ2-7,CASSFHGREQYF,12,0,1,12
TRBV3-1,TRBJ1-1,CASSQVSHTEAFF,11,7,2,18
TRBV20-1,TRBJ2-1,CSASAGTGDLYSSYNEQFF,11,0,1,11
TRBV11-3,TRBJ2-5,CASSPRTGLKGWKETQYF,11,0,1,11
TRBV3-1,TRBJ2-6,CASSQIRAQGVGANVLTF,11,0,1,11
TRBV5-1,TRBJ2-1,CASSLGTGVKNSYNEQFF,11,0,1,11
TRBV7-2,TRBJ2-3,CASAGVAGVFETDTQYF,11,0,1,11
TRBV13,TRBJ2-1,CASSLLYTGNSYNEQFF,11,0,1,11
TRBV9,TRBJ2-1,CASSRRLAGGPYNEQFF,11,0,1,11
TRBV3-1,TRBJ2-7,CGSSQDILAGDTYEQYF,11,0,1,11
TRBV3-1,TRBJ2-3,CASSPFEGGSTDTQYF,11,0,1,11
TRBV7-9,TRBJ1-1,CASSPRTGDMNTEAFF,11,0,1,11
TRBV3-1,TRBJ2-1,CASSQQGLALSDEQFF,11,0,1,11
TRBV7-2,TRBJ2-1,CASGVGLLGDNEQFF,11,0,1,11
TRBV11-3,TRBJ1-2,CASSFLTGDDGGYTF,11,0,1,11
TRBV9,TRBJ2-1,CASSPFSGRMNEQFF,11,0,1,11
TRBV12-3/4,TRBJ2-3,CASSRAGTGSDTQYF,11,0,1,11
TRBV11-2,TRBJ2-3,CASRRTSGSTDTQYF,11,0,1,11
TRBV5-1,TRBJ1-1,CASSLAAGLNTEAFF,11,0,1,11
TRBV5-1,TRBJ2-3,CASSSRDRGADTQYF,11,0,1,11
TRBV5-1,TRBJ1-1,CASSPVGLLNTEAFF,11,0,1,11
TRBV5-1,TRBJ2-7,CASSKASGRTHEQYF,11,0,1,11
TRBV19,TRBJ1-1,CASSIRGQDTEAFF,11,0,1,11
TRBV2,TRBJ2-7,CASIPGTGSYEQYF,11,0,1,11
TRBV12-3/4,TRBJ1-2,CASSLSDKTTGYTF,11,0,1,11
TRBV7-3,TRBJ2-1,CASSPGTNNNEQFF,11,0,1,11
TRBV5-6,TRBJ2-7,CASSSGGQPYEQYF,11,0,1,11
TRBV5-1,TRBJ1-1,CASSLVWSSTEAFF,11,0,1,11
TRBV20-1,TRBJ2-3,CSARASTNTDTQYF,11,0,1,11
TRBV20-1,TRBJ2-2,CSARALAETGELFF,11,0,1,11
TRBV6-2/3/5/6,TRBJ2-7,CASSLGGTYEQYF,11,0,1,11
TRBV2,TRBJ1-1,CASSPQANTEAFF,11,0,1,11
TRBV2,TRBJ1-5,CASSEWAPQPQHF,11,0,1,11
TRBV7-9,TRBJ1-5,CASSLAGRRPQHF,11,0,1,11
TRBV5-6,TRBJ1-2,CASSAGTAYGYTF,11,0,1,11
TRBV5-1,TRBJ1-1,CASRQGLNTEAFF,11,0,1,11
TRBV7-9,TRBJ2-1,CASSFGFGEQFF,11,8,2,19
TRBV20-1,TRBJ2-7,CSARVGSYEQYF,11,0,1,11
TRBV20-1,TRBJ2-7,CSARVTGYEQYF,11,0,1,11
TRBV20-1,TRBJ2-3,CSARGSTDTQYF,11,0,1,11
TRBV29-1,TRBJ1-1,CSVGTGLTEAFF,11,0,1,11
TRBV19,TRBJ2-3,CASSIGGRRTDAQYF,11,0,1,11
TRBV13,TRBJ1-6,CASSLETGINSPLHF,11,0,1,11
TRBV12-3/4,TRBJ2-7,CASSSSSTGDEQYF,11,0,1,11
TRBV5-1,TRBJ1-6,CASSLTGVDSPLHF,11,0,1,11
TRBV7-6,TRBJ2-1,CASSIMSGERSNEQFF,11,0,1,11
TRBV12-3/4,TRBJ2-3,CASSLVQTGLDTQHF,11,0,1,11
TRBV25-1,TRBJ2-7,CASSDIAGGLYEQYF,11,0,1,11
TRBV15,TRBJ2-3,CATSRDTSGRSSESDTQYF,10,0,1,10
TRBV7-6,TRBJ1-5,CASSPRSGQGTINNQPQHF,10,4,2,14
TRBV7-2,TRBJ2-6,CASSVPEGQGRTGANVLTF,10,0,1,10
TRBV5-6,TRBJ2-3,CASSRPTSGDSTDTQYF,10,0,1,10
TRBV20-1,TRBJ2-3,CSARDSRAGGHTDTQYF,10,0,1,10
TRBV19,TRBJ2-1,CASSIGSREGYNEQFF,10,0,1,10
TRBV12-3/4,TRBJ2-1,CASSLARGYLDNEQFF,10,0,1,10
TRBV7-9,TRBJ2-2,CASSLVWTGVTGELFF,10,0,1,10
TRBV11-2,TRBJ1-2,CASSLEARGTLYGYTF,10,0,1,10
TRBV12-3/4,TRBJ1-5,CASSSTRQYSNQPQHF,10,0,1,10
TRBV10-1,TRBJ2-3,CASSARLAGDTDTQYF,10,0,1,10
TRBV5-1,TRBJ1-4,CASSLDPTAHNEKLFF,10,0,1,10
TRBV5-1,TRBJ2-1,CASSPGGTGSYNEQFF,10,0,1,10
TRBV7-9,TRBJ2-7,CASGMGGQPSYEQYF,10,0,1,10
TRBV28,TRBJ1-5,CASTSGGLGNQPQHF,10,0,1,10
TRBV27,TRBJ2-7,CASSTRTRESYEQYF,10,0,1,10
TRBV7-2,TRBJ2-3,CASSLAQGRGDTQYF,10,0,1,10
TRBV5-4,TRBJ2-4,CASSSPGRGLNIQYF,10,0,1,10
TRBV5-1,TRBJ1-2,CASSLARGLNYGYTF,10,0,1,10
TRBV20-1,TRBJ2-7,CSARIPAGLSYEQYF,10,0,1,10
TRBV29-1,TRBJ2-7,CSVDRLGTGELEQYF,10,0,1,10
TRBV19,TRBJ2-5,CASSIRHDQETQYF,10,0,1,10
TRBV27,TRBJ2-7,CASTPGGRFYEQYF,10,0,1,10
TRBV28,TRBJ2-7,CASTRGSFNYEQYF,10,0,1,10
TRBV12-3/4,TRBJ1-6,CASSLSPTNSPLHF,10,0,1,10
TRBV12-3/4,TRBJ1-1,CASSLMGSRGGAFF,10,2,2,12
TRBV11-2,TRBJ2-1,CASSLGTLDYEQFF,10,0,1,10
TRBV7-2,TRBJ1-1,CASSLDSSNTEAFF,10,0,1,10
TRBV12-3/4,TRBJ2-7,CASSLGQGNYEQYF,10,0,1,10
TRBV11-2,TRBJ2-5,CASSLDRGAETQYF,10,0,1,10
TRBV12-3/4,TRBJ1-5,CASSLRQGIQPQHF,10,0,1,10
TRBV3-1,TRBJ1-1,CASSQVLGDTEAFF,10,0,1,10
TRBV9,TRBJ2-7,CASSVGGPSYEQYF,10,0,1,10
TRBV12-3/4,TRBJ2-7,CASRPGGQGDEQYF,10,0,1,10
TRBV6-2/3/5/6,TRBJ1-1,CASNPNRFHTEAFF,10,0,1,10
TRBV5-1,TRBJ1-1,CASRRTGENTEAFF,10,0,1,10
TRBV20-1,TRBJ1-1,CSAPPGTGSTEAFF,10,5,2,15
TRBV20-1,TRBJ1-1,CSANPRGGAGGAFF,10,0,1,10
TRBV2,TRBJ2-1,CATRTDPNNEQFF,10,0,1,10
TRBV12-3/4,TRBJ2-3,CASTATLGDTQYF,10,0,1,10
TRBV5-4,TRBJ1-1,CASSLAGGTEAFF,10,0,1,10
TRBV7-8,TRBJ2-7,CASSLGTTYEQYF,10,0,1,10
TRBV9,TRBJ1-1,CASSVEGNTEAFF,10,0,1,10
TRBV6-4,TRBJ1-5,CASRDTRNQPQHF,10,24,2,34
TRBV4-3,TRBJ2-7,CASSAGTSYEQYF,10,12,2,22
TRBV5-1,TRBJ2-5,CASRRGAEETQYF,10,0,1,10
TRBV20-1,TRBJ2-4,CSALTRDQNIQYF,10,0,1,10
TRBV20-1,TRBJ1-1,CSAQGLLNTEAFF,10,0,1,10
TRBV20-1,TRBJ2-5,CSASGGTQETQYF,10,0,1,10
TRBV29-1,TRBJ1-5,CSVGGYSNQPQHF,10,0,1,10
TRBV29-1,TRBJ2-1,CSVDRGPYNEQFF,10,0,1,10
TRBV19,TRBJ1-5,CASSIELKPQHF,10,0,1,10
TRBV12-3/4,TRBJ2-1,CASSTRFDEQFF,10,0,1,10
TRBV29-1,TRBJ1-1,CSVNRGPTEAFF,10,10,2,20
TRBV20-1,TRBJ1-1,CSATGDTEAFF,10,0,1,10
TRBV2,TRBJ2-2,CASTTNTGELFF,10,5,2,15
TRBV29-1,TRBJ1-2,CSVEDQLGVLGYTF,10,0,1,10
TRBV12-3/4,TRBJ1-1,CASSLRGKNTEAFF,10,0,1,10
TRBV14,TRBJ1-4,CASRGQGTNEKLFF,10,0,1,10
TRBV28,TRBJ1-5,CASSVRDSPYSNQPQHF,10,0,1,10
TRBV5-1,TRBJ1-4,CASSHRSASDEKLFF,10,0,1,10
TRBV12-3/4,TRBJ1-4,CASSLQGVGEKLFF,10,0,1,10
TRBV3-1,TRBJ2-5,CASSQWGGQETQYF,10,0,1,10
TRBV11-2,TRBJ2-2,CASSGSGYTGELFF,10,0,1,10
TRBV4-2,TRBJ2-3,CASSQKGIGFSGIGTDTQYF,10,0,1,10
TRBV9,TRBJ2-1,CASSVGLAGGDEQFF,10,0,1,10
TRBV27,TRBJ2-1,CASSPSGLADYNEQFF,9,0,1,9
TRBV2,TRBJ2-1,CASDLTGNEQSF,9,0,1,9
TRBV19,TRBJ2-6,CASSTRGTGHLSGANVLTF,9,0,1,9
TRBV18,TRBJ2-1,CASSPPVYQGNYWDEQFF,9,0,1,9
TRBV4-3,TRBJ2-6,CASSQDSVTGSGANVLTF,9,0,1,9
TRBV29-1,TRBJ1-3,CSAGPGQGAPYPAKTIYF,9,0,1,9
TRBV29-1,TRBJ2-6,YSVAERYRGLAGANVLTF,9,0,1,9
TRBV7-2,TRBJ2-7,CASSPSRSLAGEGEQYF,9,0,1,9
TRBV10-2,TRBJ1-5,CASSESRDRGLRQPQHF,9,0,1,9
TRBV15,TRBJ1-6,CATSRDRSSYNSPLHF,9,0,1,9
TRBV18,TRBJ2-7,CASSPLRAGGSYEQYF,9,0,1,9
TRBV18,TRBJ1-2,CASSPESRGANYGYTF,9,0,1,9
TRBV12-3/4,TRBJ1-5,CASSLARGYGNQPQHF,9,0,1,9
TRBV27,TRBJ2-7,CASSPDTTTASYEQYF,9,0,1,9
TRBV6-4,TRBJ1-5,CASSDPRWGSNQPQHF,9,0,1,9
TRBV7-2,TRBJ2-1,CASSLDGFSSYNEQFF,9,6,2,15
TRBV5-5,TRBJ1-6,CASSSRDLNYNSPLHF,9,0,1,9
TRBV7-8,TRBJ1-3,CASSLISSTFGNTIYF,9,0,1,9
TRBV7-9,TRBJ2-2,CASSPTSGRHTGELFF,9,0,1,9
TRBV11-3,TRBJ2-3,CASSRGTSGRTDTQYF,9,0,1,9
TRBV6-4,TRBJ2-7,CASSQDPGQSSYEQYF,9,0,1,9
TRBV7-9,TRBJ2-3,CASRLSSTGLADTQYF,9,0,1,9
TRBV5-1,TRBJ2-1,CASSPFSGRALNEQFF,9,5,2,14
TRBV12-5,TRBJ1-1,CASALRPQLGTEAFF,9,7,2,16
TRBV19,TRBJ2-4,CASSTLEFAKNIQYF,9,0,1,9
TRBV28,TRBJ2-1,CASSLPGILINEQFF,9,0,1,9
TRBV2,TRBJ2-2,CASSVKQGGTGELFF,9,0,1,9
TRBV11-2,TRBJ1-1,CASSLTGTGGTEAFF,9,0,1,9
TRBV7-9,TRBJ1-4,CASSLDRGWNEKLFF,9,0,1,9
TRBV5-5,TRBJ2-1,CASSPPDTGSREQFF,9,0,1,9
TRBV11-1,TRBJ2-1,CASSQAVPPLGEQFF,9,0,1,9
TRBV7-9,TRBJ2-1,CASSGLAGAYNEQFF,9,0,1,9
TRBV4-1,TRBJ2-3,CASSLWTSEGDTQYF,9,0,1,9
TRBV5-1,TRBJ2-1,CASSPPTSGGDEQFF,9,0,1,9
TRBV20-1,TRBJ2-1,CSARGPGQGADEQFF,9,0,1,9
TRBV20-1,TRBJ1-4,CSAREVTGSNEKLFF,9,0,1,9
TRBV20-1,TRBJ2-7,CSAKGGTGGPYEQYF,9,0,1,9
TRBV29-1,TRBJ1-1,CSVGDRGEFDTEAFF,9,0,1,9
TRBV29-1,TRBJ2-1,CSVIITGGVHNEQFF,9,0,1,9
TRBV29-1,TRBJ1-1,CSVRTGAARNTEAFF,9,0,1,9
TRBV29-1,TRBJ2-1,CSVHPSDSSYNEQFF,9,0,1,9
TRBV12-5,TRBJ1-3,CASGLVAGGNTIYF,9,0,1,9
TRBV12-5,TRBJ1-5,CASGRQGVNQPQHF,9,0,1,9
TRBV19,TRBJ1-5,CASSIVASNQPQHF,9,0,1,9
TRBV5-5,TRBJ1-5,CASSLADSNQPQHF,9,0,1,9
TRBV12-3/4,TRBJ1-3,CASSSSTGRDTIYF,9,0,1,9
TRBV6-2/3/5/6,TRBJ1-5,CASSRDLSNQPQHF,9,0,1,9
TRBV6-4,TRBJ2-1,CASSELRGDNEQFF,9,0,1,9
TRBV7-9,TRBJ2-3,CASSFARSTDTQYF,9,0,1,9
TRBV7-9,TRBJ1-3,CASSPEGSGNTIYF,9,0,1,9
TRBV9,TRBJ2-5,CASSVGSREETQYF,9,0,1,9
TRBV3-1,TRBJ2-4,CASSARTSGGIQYF,9,0,1,9
TRBV5-1,TRBJ2-1,CASSLAVLAGEQFF,9,0,1,9
TRBV4-3,TRBJ2-3,CASSQDSSTDTQYF,9,0,1,9
TRBV5-1,TRBJ2-1,CASSARGVNNEQFF,9,0,1,9
TRBV20-1,TRBJ1-1,CSAESRGRWAEAFF,9,0,1,9
TRBV20-1,TRBJ1-1,CSARGGDIDTEAFF,9,0,1,9
TRBV29-1,TRBJ2-6,CSVLTGSGANVLTF,9,0,1,9
TRBV29-1,TRBJ2-3,CSVETGDRTDTQYF,9,0,1,9
TRBV29-1,TRBJ2-1,CSAPTSGSYNEQFF,9,0,1,9
TRBV12-5,TRBJ1-5,CASGLAIDRTWHF,9,0,1,9
TRBV19,TRBJ1-5,CASSSAGNQPQHF,9,0,1,9
TRBV12-3/4,TRBJ1-2,CASSPQGSYGYTF,9,0,1,9
TRBV7-3,TRBJ2-1,CASSFGTANEQFF,9,0,1,9
TRBV3-1,TRBJ2-1,CASSRAPGDEQFF,9,0,1,9
TRBV3-1,TRBJ2-1,CASSQVRAGEQFF,9,0,1,9
TRBV14,TRBJ2-7,CASSQGRFYEQYF,9,0,1,9
TRBV3-1,TRBJ2-7,CASSERHPWEQYF,9,0,1,9
TRBV27,TRBJ2-7,CASRLGGSGEQYF,9,0,1,9
TRBV12-3/4,TRBJ2-1,CASNVGGGTEQFF,9,0,1,9
TRBV20-1,TRBJ1-6,CSARGGEDSPLHF,9,8,2,17
TRBV29-1,TRBJ2-3,CSARDRARDTQYF,9,0,1,9
TRBV29-1,TRBJ1-1,CSGDRVANTEAFF,9,0,1,9
TRBV7-2,TRBJ2-1,CATGDSYNEQFF,9,0,1,9
TRBV12-3/4,TRBJ1-1,CASSFNYLGAFF,9,0,1,9
TRBV12-3/4,TRBJ2-7,CASSPRGYEQYF,9,0,1,9
TRBV14,TRBJ2-1,CASRSGGNEQFF,9,0,1,9
TRBV29-1,TRBJ2-7,CSARDISYEQYF,9,0,1,9
TRBV20-1,TRBJ1-1,CSAREGQPAFF,9,0,1,9
TRBV29-1,TRBJ1-2,CSVGGLEGYTF,9,0,1,9
TRBV27,TRBJ2-7,CASSSNGLIGVSGRNYYSYEQYF,9,0,1,9
TRBV7-8,TRBJ2-7,CASSLDTLDPLLSYEQYF,9,0,1,9
TRBV10-3,TRBJ2-1,CAISAGGVITYNEQFF,9,0,1,9
TRBV2,TRBJ2-7,CASSDVSGGPPYEQYF,9,0,1,9
TRBV5-8,TRBJ1-1,CASSLGGTVDTEAFF,9,0,1,9
TRBV7-3,TRBJ1-1,CASSVIRDTEAFF,9,0,1,9
TRBV5-1,TRBJ1-3,CASSPRQESSGNTIYF,9,0,1,9
TRBV5-1,TRBJ2-7,CASSLVPGGFSYEQYF,9,0,1,9
TRBV15,TRBJ2-1,CATSRDRGLAGVLSYNEQFF,9,0,1,9
TRBV4-1,TRBJ1-5,CVSSQDPGDGENQPQHF,9,0,1,9
TRBV28,TRBJ1-3,CASRPGTVRGNTIYF,9,0,1,9
TRBV12-3/4,TRBJ2-1,CASKTGDEQFF,9,0,1,9
TRBV29-1,TRBJ2-1,CSVTTWTRYNEQFF,9,0,1,9
TRBV12-3/4,TRBJ1-5,CASSFRALTGGVPTSYSNQPQHF,8,0,1,8
TRBV4-2,TRBJ2-6,CASSQDPLAGVGGANVLTF,8,0,1,8
TRBV20-1,TRBJ2-7,CSARGAWDYVTSGIGEQYF,8,0,1,8
TRBV18,TRBJ1-1,CASSPFNGVARSDTEAFF,8,0,1,8
TRBV5-1,TRBJ2-1,CASSSNPRQGTFHNEQFF,8,0,1,8
TRBV7-9,TRBJ2-1,CASSSRTSGIVYNEQFF,8,0,1,8
TRBV5-1,TRBJ2-1,CASSLFTGRNSHNEQFF,8,0,1,8
TRBV20-1,TRBJ2-3,CSAREGVGLAATDTQYF,8,0,1,8
TRBV19,TRBJ2-3,CASGTMGQESTDTQYF,8,0,1,8
TRBV18,TRBJ2-2,CASSPFRGVNTGELFF,8,0,1,8
TRBV2,TRBJ2-1,CASSDSGTGVINEQFF,8,0,1,8
TRBV11-2,TRBJ1-1,CASSLWSGGSRTEAFF,8,0,1,8
TRBV7-2,TRBJ1-1,CASSLEGQGSPEKTFF,8,0,1,8
TRBV3-1,TRBJ2-6,CASSLVSGSGANVLTF,8,3,2,11
TRBV4-2,TRBJ1-2,CASSQGLADRGVGYTF,8,0,1,8
TRBV5-4,TRBJ2-1,CASSKEQTSGGNEQFF,8,0,1,8
TRBV7-8,TRBJ2-1,CASRPGTSGHYNEQFF,8,0,1,8
TRBV7-2,TRBJ2-1,CASRLVRGRGYNEQFF,8,0,1,8
TRBV20-1,TRBJ2-3,CSAPRTSGGFTDTQYF,8,0,1,8
TRBV20-1,TRBJ1-2,CSARDRRQGQRKGYTF,8,0,1,8
TRBV30,TRBJ2-2,CAWSYSWTTTGELFF,8,0,1,8
TRBV30,TRBJ1-1,CAWSDRTGSNTEAFF,8,0,1,8
TRBV24-1,TRBJ2-5,CATSDPTGDQETQYF,8,0,1,8
TRBV19,TRBJ1-4,CASSIFPGGGEKLFF,8,0,1,8
TRBV19,TRBJ1-1,CASSTLQGAGTEAFF,8,0,1,8
TRBV19,TRBJ1-2,CASRPQGQGSYGYTF,8,0,1,8
TRBV18,TRBJ2-5,CASSPPGQPWETQYF,8,0,1,8
TRBV2,TRBJ2-1,CASTPGLGAYNEQFF,8,0,1,8
TRBV12-3/4,TRBJ2-7,CASSFPQGGSYEQYF,8,6,2,14
TRBV12-3/4,TRBJ1-1,CASSLGEGRNAEAFF,8,0,1,8
TRBV6-2/3/5/6,TRBJ2-4,CASSYRGGVRNIQYF,8,0,1,8
TRBV3-1,TRBJ2-1,CASSPTSTGEYEQFF,8,0,1,8
TRBV12-3/4,TRBJ2-1,CASSPDRPGYNEQFF,8,5,2,13
TRBV11-2,TRBJ1-3,CASSRTGDAGNTIYF,8,0,1,8
TRBV6-1,TRBJ2-1,CASSGTSGTYNEQFF,8,0,1,8
TRBV7-9,TRBJ1-4,CASSFPSTTNEKLFF,14,8,2,22
TRBV7-8,TRBJ1-6,CASSLGTGKASPLHF,8,7,2,15
TRBV5-4,TRBJ2-3,CASSSRAPSTDTQYF,8,0,1,8
TRBV3-1,TRBJ1-4,CASSSLSATNEKLFF,8,0,1,8
TRBV5-1,TRBJ2-5,CASSLRGGLGETQYF,8,0,1,8
TRBV5-1,TRBJ1-4,CASSLGGRANEKLFF,8,0,1,8
TRBV5-1,TRBJ2-7,CASSSTGLAAYEQYF,8,0,1,8
TRBV5-1,TRBJ2-2,CASSPPAGGIGELFF,8,0,1,8
TRBV4-1,TRBJ2-5,CASSQGAGFQETQYF,8,0,1,8
TRBV20-1,TRBJ1-1,CSARDFQEVNTEAFF,8,0,1,8
TRBV20-1,TRBJ2-7,CSARDMGQNPYEQYF,8,0,1,8
TRBV20-1,TRBJ1-1,CSARESTGSHTEAFF,8,0,1,8
TRBV20-1,TRBJ2-3,CSAREAGGSTDTQYF,8,0,1,8
TRBV29-1,TRBJ2-3,CSVESLAGGTDTQYF,8,0,1,8
TRBV30,TRBJ1-2,CAWSPRGLARGYTF,8,0,1,8
TRBV19,TRBJ2-4,CASSSRTGLGIQYF,8,0,1,8
TRBV19,TRBJ1-1,CASSMIAGSAEAFF,8,0,1,8
TRBV7-3,TRBJ1-1,CASAHGGQNTEAFF,8,0,1,8
TRBV28,TRBJ2-2,CASTLADHTGELFF,8,0,1,8
TRBV12-3/4,TRBJ2-1,CASSFSAGVNEQFF,8,0,1,8
TRBV12-3/4,TRBJ2-5,CASSSDIREETQYF,8,0,1,8
TRBV25-1,TRBJ1-1,CASSAPTGNTEAFF,8,0,1,8
TRBV2,TRBJ2-2,CASSENSDTGELFF,8,0,1,8
TRBV7-2,TRBJ2-2,CASSLDHGAGELFF,8,6,2,14
TRBV5-6,TRBJ2-1,CASSLTSGSNEQFF,8,0,1,8
TRBV7-2,TRBJ2-5,CASSLVAGEETQYF,8,0,1,8
TRBV7-2,TRBJ2-7,CASSPGGSKTEQYF,8,3,2,11
TRBV3-1,TRBJ2-4,CASSPTGLQNIQYF,8,0,1,8
TRBV12-3/4,TRBJ1-4,CASSEPTTNEKLFF,8,0,1,8
TRBV2,TRBJ2-7,CASSRTSGSYEQYF,8,0,1,8
TRBV12-3/4,TRBJ1-5,CASRGGQYNQPQHF,8,0,1,8
TRBV5-6,TRBJ2-7,CASRRSGGLYEQYF,8,0,1,8
TRBV5-1,TRBJ2-7,CASSRPDRYYEQYF,8,0,1,8
TRBV10-2,TRBJ1-2,CASSESPGIRGYTF,8,4,2,12
TRBV5-1,TRBJ1-1,CASSFSGRNTEAFF,8,0,1,8
TRBV5-1,TRBJ2-7,CASSSGGPSNEQYF,8,0,1,8
TRBV5-1,TRBJ2-1,CASSPYSGDNEQFF,8,0,1,8
TRBV4-3,TRBJ2-3,CASSQGPGTDTQYF,8,0,1,8
TRBV4-3,TRBJ1-5,CASSQEAHHQPQHF,8,0,1,8
TRBV20-1,TRBJ1-5,CSAITAIGRKPQHF,8,0,1,8
TRBV20-1,TRBJ2-1,CSASGSGSLNEQFF,8,0,1,8
TRBV20-1,TRBJ2-3,CSAREGQGTDTQYF,8,0,1,8
TRBV29-1,TRBJ2-7,CSVRRDIETYEQYF,8,0,1,8
TRBV29-1,TRBJ2-7,CSVELATHAYEQYF,8,0,1,8
TRBV29-1,TRBJ2-1,CSVNGRLAELPPFF,8,0,1,8
TRBV29-1,TRBJ2-3,CSAITRAGTDTQYF,8,0,1,8
TRBV30,TRBJ2-1,CAWSGHIGDLQFF,8,0,1,8
TRBV10-3,TRBJ1-1,CAISETGNTEAFF,8,0,1,8
TRBV18,TRBJ2-3,CASSLTAEDTQYF,8,0,1,8
TRBV12-3/4,TRBJ1-1,CASSLPPRTEAFF,8,0,1,8
TRBV12-3/4,TRBJ2-7,CASSLPGACEQYF,8,0,1,8
TRBV6-2/3/5/6,TRBJ2-1,CASSLQGVDEQFF,8,0,1,8
TRBV12-3/4,TRBJ1-2,CASSSDSYYGYTF,8,0,1,8
TRBV6-1,TRBJ1-4,CASSEVANEKLFF,8,0,1,8
TRBV7-9,TRBJ1-4,CASSLNLGEKLFF,8,0,1,8
TRBV5-6,TRBJ2-7,CASSWDSSYEQYF,8,0,1,8
TRBV7-9,TRBJ1-2,CASSPGQGNGYTF,8,0,1,8
TRBV3-1,TRBJ1-1,CASSRGPMTEAFF,8,0,1,8
TRBV19,TRBJ1-3,CGSKGGAGNTIYF,8,0,1,8
TRBV5-1,TRBJ2-2,CASRTGGTGELFF,8,0,1,8
TRBV20-1,TRBJ2-1,CSAYGGSYNEQFF,8,0,1,8
TRBV29-1,TRBJ1-2,CSVETGNNYGYTF,8,0,1,8
TRBV12-5,TRBJ2-7,CASNQGDNEQYF,8,0,1,8
TRBV3-1,TRBJ1-4,CACGGPNEKLFF,8,0,1,8
TRBV30,TRBJ1-1,CAWSVGGTEAFF,8,0,1,8
TRBV19,TRBJ2-1,CASSIGGHEQFF,8,0,1,8
TRBV7-9,TRBJ1-1,CASSLQNTEAFF,8,0,1,8
TRBV5-6,TRBJ2-3,CASSSTTDTQYF,8,0,1,8
TRBV3-1,TRBJ2-3,CASSLSTDTQYF,8,0,1,8
TRBV7-9,TRBJ2-1,CASSAGASEQFF,8,0,1,8
TRBV5-1,TRBJ2-1,CASSVDYNEQFF,8,0,1,8
TRBV20-1,TRBJ2-7,CSAVYGAYEQYF,8,0,1,8
TRBV29-1,TRBJ2-7,CSVSWGIHEQYF,8,0,1,8
TRBV29-1,TRBJ2-1,CSAAGTYNEQFF,8,0,1,8
TRBV12-3/4,TRBJ1-4,CASSNNEKLFF,8,0,1,8
TRBV5-1,TRBJ1-2,CASSLEGYTF,8,0,1,8
TRBV10-3,TRBJ2-3,CAISEGGGTDTQYF,8,0,1,8
TRBV19,TRBJ1-1,CASSKDRVNTEAFF,8,0,1,8
TRBV14,TRBJ1-3,CASSQVPQGVYGNTIYF,8,0,1,8
TRBV10-3,TRBJ2-4,CAISESRWQGKNIQYF,8,0,1,8
TRBV2,TRBJ2-3,CASRGLAGDRTDTQYF,8,0,1,8
TRBV18,TRBJ2-7,CASSPSRASMVEQYF,8,0,1,8
TRBV19,TRBJ2-4,CASRTRDSKNIQYF,8,9,2,17
TRBV29-1,TRBJ2-5,CSVEEGGETQYF,8,0,1,8
TRBV29-1,TRBJ1-1,CSVEDSGQGGTEAFF,8,0,1,8
TRBV4-1,TRBJ1-2,CASSRDREVGYTF,8,0,1,8
TRBV7-9,TRBJ1-6,CASSLVGISSYNSPLHF,8,0,1,8
TRBV19,TRBJ1-5,CASSTNRESNQPQHF,8,0,1,8
TRBV4-3,TRBJ1-1,CASSQTLGVYTEAFF,8,0,1,8
TRBV5-6,TRBJ1-2,CAGSLGWKANGYTF,8,0,1,8
TRBV4-3,TRBJ2-1,CASSQEGWGGEQFF,7,0,1,7
TRBV7-2,TRBJ2-7,CASSLYYEQYF,11,0,1,11
TRBV20-1,TRBJ2-3,CSARDLTSADTQYF,7,0,1,7
TRBV18,TRBJ2-3,CASSPDTDTQYF,9,5,2,14
TRBV12-3/4,TRBJ2-1,CASSRAGTSALGAYNEQFF,7,0,1,7
TRBV6-2/3/5/6,TRBJ2-1,CASSPEARTSGGNYNEQFF,7,0,1,7
TRBV5-1,TRBJ2-6,CASSLYPDRPSRGANVLTF,7,0,1,7
TRBV2,TRBJ2-6,CASSENLIIQAGANVLTF,7,0,1,7
TRBV7-2,TRBJ1-1,CASSSKGGTGWFKTEAFF,7,0,1,7
TRBV19,TRBJ2-1,CASSSGPGQGYNSEQFF,7,7,2,14
TRBV12-3/4,TRBJ1-2,CASSFGAGGGLGYGYTF,7,0,1,7
TRBV7-9,TRBJ2-2,CASSLDGGRFDTGELFF,7,0,1,7
TRBV14,TRBJ2-1,CASSQGRLDRGKDEQFF,7,0,1,7
TRBV3-1,TRBJ2-6,CASSQDHRGAGANVLTF,7,0,1,7
TRBV30,TRBJ1-5,CAWSDGGLWSNQPQHF,7,0,1,7
TRBV19,TRBJ1-2,CASSIDPSGFSYGYTF,7,4,2,11
TRBV7-2,TRBJ2-1,CASLPQGALRGYEQFF,7,0,1,7
TRBV6-2/3/5/6,TRBJ2-1,CASSFVAGPRYNEQFF,7,0,1,7
TRBV12-3/4,TRBJ2-2,CASSATGTVFTGELFF,7,0,1,7
TRBV6-2/3/5/6,TRBJ2-1,CASSLMASGRSDEQFF,7,0,1,7
TRBV7-9,TRBJ2-1,CASSPDRGRAYNEQFF,7,0,1,7
TRBV9,TRBJ2-7,CASSVTETSGRYEQYF,7,0,1,7
TRBV7-2,TRBJ2-3,CASSARTARGADTQYF,7,0,1,7
TRBV7-2,TRBJ1-2,CASSTQQGTSNYGYTF,7,0,1,7
TRBV2,TRBJ2-3,CASRGRGFFGTDTQYF,7,0,1,7
TRBV4-3,TRBJ2-7,CASSQDQTGEPYEQYF,7,0,1,7
TRBV10-1,TRBJ2-1,CASRLTSGLSYNEQFF,7,2,2,9
TRBV20-1,TRBJ2-1,CSAHGTGGSSYNEQFF,7,0,1,7
TRBV29-1,TRBJ2-1,CSVTSSVTGRDNEQFF,7,0,1,7
TRBV12-5,TRBJ2-1,CASAPPGVSYNEQFF,7,0,1,7
TRBV5-5,TRBJ2-5,CAGSAALGPVETQYF,7,0,1,7
TRBV10-3,TRBJ1-1,CAITKQGAGDTEAFF,7,0,1,7
TRBV10-3,TRBJ2-7,CAISEPGLLSHEQYF,7,0,1,7
TRBV24-1,TRBJ1-5,CATSDSRQADQPQHF,7,0,1,7
TRBV7-2,TRBJ2-1,CASFSGTGLWDEQFF,7,2,2,9
TRBV27,TRBJ1-1,CASSLIGRGNTEAFF,7,0,1,7
TRBV6-2/3/5/6,TRBJ1-2,CASSYVDTGEYGYTF,7,0,1,7
TRBV9,TRBJ1-1,CASSPPGTGRPEAFF,7,0,1,7
TRBV6-4,TRBJ2-3,CASSDGPSSPDTQYF,7,0,1,7
TRBV6-1,TRBJ2-3,CASSEVAGGTDTQYF,7,0,1,7
TRBV6-1,TRBJ1-1,CASSEDRTLNTAAFF,7,0,1,7
TRBV11-3,TRBJ2-1,CASSLVLAGSNEQFF,7,0,1,7
TRBV7-2,TRBJ2-1,CASSLGGGDHNEQFF,7,0,1,7
TRBV7-2,TRBJ2-5,CASSLDLGFQETQYF,7,0,1,7
TRBV11-2,TRBJ2-1,CASSLEPSDRAEQFF,7,0,1,7
TRBV7-2,TRBJ2-3,CASSLERESTDTQYF,7,0,1,7
TRBV11-2,TRBJ2-3,CASSLNAGLADTQYF,7,0,1,7
TRBV5-6,TRBJ1-6,CASSRGQMGSSPLHF,7,0,1,7
TRBV13,TRBJ2-3,CASSHTSGGTDTQYF,7,0,1,7
TRBV3-1,TRBJ2-7,CASSQGQGGFYEQYF,7,0,1,7
TRBV14,TRBJ1-1,CASSQEGGQNTEAFF,7,0,1,7
TRBV5-8,TRBJ2-2,CASSQNRRGTGELFF,7,0,1,7
TRBV9,TRBJ1-1,CASSVSGAGRPEAFL,7,0,1,7
TRBV9,TRBJ2-2,CASSATGGNTGELFF,7,3,2,10
TRBV9,TRBJ2-5,CASSTGTVVGETQYF,7,0,1,7
TRBV3-1,TRBJ2-6,CASRLTGSGANVLTF,7,13,2,20
TRBV6-2/3/5/6,TRBJ1-3,CASRPGRVSGNTIYF,7,0,1,7
TRBV5-1,TRBJ2-5,CASSFSGLQGETQYF,7,0,1,7
TRBV5-1,TRBJ2-1,CASSLAEGGYNEQFF,7,0,1,7
TRBV5-1,TRBJ2-7,CASSLGTSGTYEQYF,7,0,1,7
TRBV5-1,TRBJ2-7,CASSPGQLDPYEQYF,7,8,2,15
TRBV5-1,TRBJ1-4,CASSRLGARNEKLFF,7,0,1,7
TRBV20-1,TRBJ2-1,CSARVGTGILNEQFF,7,0,1,7
TRBV20-1,TRBJ2-3,CSARDLAGGTDTQYF,7,21,2,28
TRBV20-1,TRBJ1-4,CSAQTGLISNEKLFF,7,0,1,7
TRBV29-1,TRBJ1-2,CSVAGQHFPNYGYTF,7,0,1,7
TRBV29-1,TRBJ1-2,CSVEDWGTEDYGYTF,7,0,1,7
TRBV30,TRBJ2-5,CAWSVGLARETQYF,7,0,1,7
TRBV19,TRBJ2-1,CATHSGTTYNEQFF,7,0,1,7
TRBV24-1,TRBJ2-1,CATSARESYNEQFF,7,0,1,7
TRBV15,TRBJ1-4,CATSRAVTNEKLFF,7,0,1,7
TRBV19,TRBJ2-4,CASSTSANKNIQYF,7,0,1,7
TRBV19,TRBJ2-3,CASTEAGDTDTQYF,7,0,1,7
TRBV19,TRBJ2-1,CASRDGTINNEQFF,7,0,1,7
TRBV18,TRBJ2-7,CASSRSGESGEQYF,7,0,1,7
TRBV6-2/3/5/6,TRBJ2-3,CASTSSLVVDTQYF,7,0,1,7
TRBV12-3/4,TRBJ1-5,CASSLWGGNQPQHF,7,0,1,7
TRBV12-3/4,TRBJ1-2,CASSYQPSNYGYTF,7,0,1,7
TRBV6-2/3/5/6,TRBJ1-5,CASSYTGRDQPQHF,7,0,1,7
TRBV12-3/4,TRBJ2-1,CASSDQERDNEQFF,7,0,1,7
TRBV2,TRBJ2-7,CASSELAESYEQYF,7,0,1,7
TRBV7-2,TRBJ1-4,CASSFRDSNEKLFF,7,0,1,7
TRBV11-2,TRBJ2-7,CASSLHRFSYEQYF,7,0,1,7
TRBV5-4,TRBJ1-1,CASSLVGANTEAFF,7,0,1,7
TRBV7-9,TRBJ2-1,CASSLVPGIDEQFF,7,0,1,7
TRBV11-2,TRBJ2-1,CASSLVRRANEQFF,7,0,1,7
TRBV7-9,TRBJ1-2,CASSLAWGAYGYTF,7,0,1,7
TRBV13,TRBJ2-7,CASSLGRTTYEQYF,7,0,1,7
TRBV7-9,TRBJ2-5,CASSSTGGGETQYF,7,0,1,7
TRBV7-9,TRBJ2-1,CASSSPGLLWKEFF,7,0,1,7
TRBV9,TRBJ1-1,CASSLGQGASVAFF,7,0,1,7
TRBV6-2/3/5/6,TRBJ2-3,CASSRTGETDTQYF,7,0,1,7
TRBV12-3/4,TRBJ2-1,CASSHTATYNEQFF,7,0,1,7
TRBV9,TRBJ1-1,CASSVDLQNTEAFF,7,0,1,7
TRBV7-9,TRBJ1-1,CASSGQALNTEAFF,7,0,1,7
TRBV12-3/4,TRBJ1-2,CASRSRRRNYGYTF,7,0,1,7
TRBV11-2,TRBJ2-3,CASRYTGTTDTQYF,7,0,1,7
TRBV5-8,TRBJ2-1,CASRHRTGKNEQFF,7,0,1,7
TRBV10-2,TRBJ1-3,CASSESESGNTIYF,7,0,1,7
TRBV5-1,TRBJ2-5,CASSLWTGKETQYF,7,0,1,7
TRBV5-1,TRBJ1-4,CASSLYQGGEKLFF,7,0,1,7
TRBV5-1,TRBJ1-5,CASSLRRENQPQHF,7,0,1,7
TRBV5-1,TRBJ2-5,CASRPTGTEETQYF,7,0,1,7
TRBV20-1,TRBJ2-7,CSARGGGSSYEQYF,7,0,1,7
TRBV20-1,TRBJ1-1,CSARGGQGDTEAFF,7,0,1,7
TRBV20-1,TRBJ2-7,CSAREAWTAYEQYF,7,0,1,7
TRBV29-1,TRBJ1-1,CSVFYRAEGTEAFF,7,0,1,7
TRBV29-1,TRBJ2-3,CSVLLAGGRDTQYF,7,0,1,7
TRBV29-1,TRBJ2-4,CSVVGGPFKNIQYF,7,0,1,7
TRBV29-1,TRBJ2-1,CSVLFGQGYNEQFF,7,11,2,18
TRBV30,TRBJ1-5,CACGQGAGQPQHF,7,0,1,7
TRBV19,TRBJ1-1,CASSSQGNTEAFF,7,0,1,7
TRBV19,TRBJ1-5,CASSIAPAQPQHF,7,0,1,7
TRBV9,TRBJ2-7,CASGHGTDYEQYF,7,0,1,7
TRBV7-9,TRBJ2-7,CASIPINSYEQYF,7,0,1,7
TRBV12-3/4,TRBJ1-1,CASSLGWDTEAFF,7,0,1,7
TRBV6-2/3/5/6,TRBJ2-1,CASSYPANLEQFF,7,0,1,7
TRBV6-2/3/5/6,TRBJ1-1,CASSYNRKTEAFF,7,0,1,7
TRBV6-1,TRBJ2-2,CASSDRDTGELFF,7,12,2,19
TRBV5-6,TRBJ2-2,CASSFGRAGELFF,7,0,1,7
TRBV5-4,TRBJ1-1,CASSFHPDGEAFF,7,0,1,7
TRBV5-6,TRBJ2-7,CASSLGPTYEQYF,7,0,1,7
TRBV7-9,TRBJ1-2,CASSLVSMNAYTF,7,0,1,7
TRBV11-2,TRBJ2-3,CASSLEPLSTQYF,7,0,1,7
TRBV11-2,TRBJ1-1,CASSYTRDSQSMF,7,0,1,7
TRBV11-3,TRBJ2-2,CASSPPPTGELFF,7,0,1,7
TRBV3-1,TRBJ2-7,CASSHGRYYEQYF,7,0,1,7
TRBV16,TRBJ2-1,CASSQFSGDEQFF,7,0,1,7
TRBV16,TRBJ1-2,CASSQSTTYGYTF,7,0,1,7
TRBV3-1,TRBJ2-7,CASSQDVYYEQYF,7,0,1,7
TRBV7-2,TRBJ2-1,CASSTPRNNEQFF,7,0,1,7
TRBV7-8,TRBJ1-2,CASRSDRDPGYTF,7,0,1,7
TRBV2,TRBJ1-5,CASKDSRNQPQHF,7,0,1,7
TRBV5-1,TRBJ2-7,CASSLDSSYEQYF,7,0,1,7
TRBV20-1,TRBJ1-5,CSATVSGGQPQHF,7,0,1,7
TRBV20-1,TRBJ1-1,CSAREGTRSEAFF,7,0,1,7
TRBV20-1,TRBJ1-2,CSADRRTNYGYTF,7,0,1,7
TRBV29-1,TRBJ2-1,CSVVRTGANEQFF,7,0,1,7
TRBV29-1,TRBJ2-7,CSVGLVAGYEQYF,7,0,1,7
TRBV29-1,TRBJ2-7,CSVLGGSSYEQYF,7,0,1,7
TRBV29-1,TRBJ2-5,CSADLAAQETQYF,7,0,1,7
TRBV30,TRBJ2-1,CAWTSRYNEQFF,7,0,1,7
TRBV30,TRBJ1-1,CACSGAYTEAFF,7,0,1,7
TRBV30,TRBJ1-1,CAWSYGRSEAFF,7,0,1,7
TRBV24-1,TRBJ1-5,CATGTVNQPQHF,7,0,1,7
TRBV19,TRBJ2-1,CASSAGYNEQFF,7,0,1,7
TRBV25-1,TRBJ1-1,CASGRTPTEAFF,7,0,1,7
TRBV28,TRBJ1-5,CASGQVGQPQHF,7,0,1,7
TRBV27,TRBJ2-2,CASSFTTGELFF,7,0,1,7
TRBV28,TRBJ2-3,CASSLGQGTQYF,7,0,1,7
TRBV12-3/4,TRBJ1-5,CASSSGSQPQHF,7,0,1,7
TRBV5-6,TRBJ2-7,CASSFSGNEQYF,7,0,1,7
TRBV7-9,TRBJ2-1,CASSSISGWQFF,7,0,1,7
TRBV7-2,TRBJ2-7,CASSLDSYEQYF,7,4,2,11
TRBV13,TRBJ2-7,CASSLGQGEQYF,7,0,1,7
TRBV9,TRBJ2-7,CASSVGVGEQYF,7,0,1,7
TRBV6-4,TRBJ2-1,CASSGGYNEQSF,7,0,1,7
TRBV12-3/4,TRBJ1-2,CASRTGAYGYTF,7,0,1,7
TRBV5-1,TRBJ2-2,CASREGAGELFF,7,0,1,7
TRBV20-1,TRBJ1-1,CSATDRPTEAFF,7,0,1,7
TRBV20-1,TRBJ1-2,CSASGANYGYTF,7,0,1,7
TRBV29-1,TRBJ1-1,CSVEFRPAEAFF,7,0,1,7
TRBV12-3/4,TRBJ2-3,CASTPGAVRYF,7,0,1,7
TRBV12-3/4,TRBJ2-5,CASSSQETQYF,10,0,1,10
TRBV5-6,TRBJ1-2,CASSFLYSYTF,7,0,1,7
TRBV7-2,TRBJ2-7,CASSTYYEQYF,7,0,1,7
TRBV27,TRBJ1-2,CASRTWWGYTF,7,0,1,7
TRBV29-1,TRBJ1-1,CSTERDYEAFF,7,0,1,7
TRBV29-1,TRBJ2-7,CSVGQTYEQYF,7,0,1,7
TRBV29-1,TRBJ2-2,CSASVGGELFF,7,0,1,7
TRBV29-1,TRBJ1-2,CSVAGDGYTF,7,0,1,7
TRBV12-3/4,TRBJ2-5,CASSLTDSRGETQYF,7,0,1,7
TRBV6-2/3/5/6,TRBJ1-1,CASSYPGRGTEAFF,7,0,1,7
TRBV5-4,TRBJ2-2,CASSLDSTNTGELFF,7,0,1,7
TRBV6-2/3/5/6,TRBJ1-4,CASSIGQGGEKLFF,7,0,1,7
TRBV2,TRBJ1-5,CASGGQSGGNQPQHF,7,0,1,7
TRBV2,TRBJ2-6,CASSKSTGANVQTF,7,0,1,7
TRBV7-3,TRBJ2-1,CASSLAGEDNEQFF,7,0,1,7
TRBV3-1,TRBJ1-2,CASSQRWGAYGYTF,7,0,1,7
TRBV3-1,TRBJ2-3,CASSGSNSGRFAYF,7,0,1,7
TRBV4-1,TRBJ2-3,CASSQKGTDTQHF,7,0,1,7
TRBV15,TRBJ2-7,CATSRDAKRGAPYEQYF,7,0,1,7
TRBV6-2/3/5/6,TRBJ2-3,CASSSGLAGFTDTQYF,7,0,1,7
TRBV11-2,TRBJ2-5,CASSFPDSQETQYF,6,0,1,6
TRBV30,TRBJ2-7,CAWQPTRPPYEQYF,6,0,1,6
TRBV5-6,TRBJ2-7,CASSAVGLQEQYF,6,0,1,6
TRBV7-9,TRBJ2-4,CASSNIAKNIQYF,6,0,1,6
TRBV11-3,TRBJ2-6,CASSSVSSGANVLTF,6,0,1,6
TRBV9,TRBJ2-7,CASSVGTSGRRAHEQYF,6,5,2,11
TRBV5-5,TRBJ1-5,CASSLAGDHSNQPQHF,6,0,1,6
TRBV7-2,TRBJ1-2,CASSLVPGSHYGYTF,6,0,1,6
TRBV5-1,TRBJ1-2,CASSDRDQPHYGYTF,6,0,1,6
TRBV12-5,TRBJ1-2,CASGLVPQIPPANYGYTF,6,0,1,6
TRBV5-1,TRBJ2-1,CASSPGRVGLAGGGSSDEQFF,6,0,1,6
TRBV7-2,TRBJ2-6,CASSLALLTGLLSGANVLTF,6,0,1,6
TRBV20-1,TRBJ2-7,CSAGSSLADRGWLAGEEQYF,6,0,1,6
TRBV20-1,TRBJ2-1,CSARVTGAGGTRSSYNEQLF,6,0,1,6
TRBV2,TRBJ2-3,CASSQPRDRGRITDTQYF,6,0,1,6
TRBV5-6,TRBJ2-7,CASSSPFEGRLSSYEQYF,6,0,1,6
TRBV5-1,TRBJ2-1,CASSDGTSGYLSYNEQFF,6,0,1,6
TRBV24-1,TRBJ2-7,CATSDLQDRGLSYEQYF,6,0,1,6
TRBV19,TRBJ1-5,CASSIETTTHSNQPQHF,6,0,1,6
TRBV3-1,TRBJ2-1,CASSRRGGAAIYNEQFF,6,0,1,6
TRBV4-2,TRBJ2-1,CASSQSITSGAYNEQFF,6,2,2,8
TRBV3-1,TRBJ1-5,CASSGGTGPFSNQPQHF,6,0,1,6
TRBV12-3/4,TRBJ2-6,CAIPLDRVSGANVLTF,6,0,1,6
TRBV19,TRBJ1-5,CASSIRRGPSNQPQHF,6,0,1,6
TRBV19,TRBJ1-6,CASSILMGTENSPLHF,6,0,1,6
TRBV18,TRBJ1-5,CASSPGQGGFDQPQHF,6,0,1,6
TRBV18,TRBJ2-3,CASSPPGHPNTDTQYF,6,0,1,6
TRBV18,TRBJ1-1,CASSIGQGLENTEAFF,6,0,1,6
TRBV6-2/3/5/6,TRBJ1-5,CASSLARGYSNQPQHF,6,0,1,6
TRBV2,TRBJ1-6,CASSENGEGNNSPLHF,6,0,1,6
TRBV7-9,TRBJ2-7,CASSFNRRQGPYEQYF,6,0,1,6
TRBV7-9,TRBJ2-5,CASSLVWDSYQETQYF,6,0,1,6
TRBV7-9,TRBJ2-1,CASSLGPSGRIDEQFF,6,6,2,12
TRBV13,TRBJ1-6,CASSLGAGTSGSPLHF,6,0,1,6
TRBV11-2,TRBJ2-1,CASSLNGQGPYNEQFF,6,0,1,6
TRBV7-9,TRBJ2-3,CASSPRTSGATDTQYF,6,0,1,6
TRBV3-1,TRBJ2-1,CASSPGPPSSYNEQFF,6,0,1,6
TRBV3-1,TRBJ2-1,CASSHGVEGAGNEQFF,6,0,1,6
TRBV11-2,TRBJ1-2,CASSQFRDRASDGYTF,6,0,1,6
TRBV7-3,TRBJ1-1,CASSQEPGFMNTEAFF,6,0,1,6
TRBV4-1,TRBJ1-4,CASSQVATGQGEKLFF,6,0,1,6
TRBV4-1,TRBJ1-5,CASSQDRTGAFQPQHF,6,0,1,6
TRBV5-1,TRBJ2-3,CASSITGTSGTDTQYF,6,0,1,6
TRBV20-1,TRBJ2-7,CSARSPGQGRTWEQYF,6,0,1,6
TRBV20-1,TRBJ1-5,CSARDLMDRTAQPQHF,6,0,1,6
TRBV20-1,TRBJ2-7,CSARDGTSGTIYEQYF,6,0,1,6
TRBV20-1,TRBJ2-1,CSAREFGDRGNNEQFF,6,0,1,6
TRBV12-5,TRBJ1-6,CASGRDSGLNSPLHF,6,0,1,6
TRBV30,TRBJ1-1,CAWSHSADLNTEAFF,6,0,1,6
TRBV24-1,TRBJ2-7,CATSDVRTGDYEQYF,6,0,1,6
TRBV19,TRBJ1-5,CASSIRQGMHQPQHF,6,0,1,6
TRBV19,TRBJ2-7,CASSTSSAGAYEQYF,6,0,1,6
TRBV18,TRBJ2-1,CASSPVETGGNEQFF,6,0,1,6
TRBV6-2/3/5/6,TRBJ1-2,CASSFVHGVNYGYTF,6,0,1,6
TRBV6-2/3/5/6,TRBJ2-7,CASSSEVGNFYEQYF,6,0,1,6
TRBV2,TRBJ2-1,CASSSGGPSYNEQFF,6,0,1,6
TRBV2,TRBJ1-1,CASSLRTGRNTEAFF,6,0,1,6
TRBV6-2/3/5/6,TRBJ1-5,CASSLQGAGNQPQHF,6,0,1,6
TRBV12-3/4,TRBJ2-5,CASSPNAGGQETQYF,6,0,1,6
TRBV6-2/3/5/6,TRBJ2-3,CASSPRGGPTDTQYF,6,0,1,6
TRBV12-3/4,TRBJ2-1,CASSETSGGYNEQFF,11,0,1,11
TRBV11-3,TRBJ2-3,CASSFLSTVTDTQYF,6,0,1,6
TRBV11-2,TRBJ2-7,CASSLPSGSFYEQYF,6,0,1,6
TRBV7-2,TRBJ1-1,CASSLVGRADTEAFF,6,0,1,6
TRBV7-2,TRBJ2-1,CASSLVGDTYNEQFF,6,0,1,6
TRBV7-9,TRBJ1-1,CASSLDGRGMDEAFF,6,0,1,6
TRBV11-2,TRBJ1-1,CASSLEPGQNTEAFF,6,0,1,6
TRBV7-2,TRBJ2-7,CASSLNLAGAYEQYF,6,0,1,6
TRBV7-2,TRBJ2-7,CASSLNGAGVDEQYF,6,0,1,6
TRBV7-2,TRBJ1-5,CASSSLGNSNQPQHF,6,0,1,6
TRBV9,TRBJ2-7,CASSSGTGGAYEQYF,6,0,1,6
TRBV11-2,TRBJ1-2,CASSWGHKANYGYTF,6,0,1,6
TRBV5-5,TRBJ2-1,CASSPEAGGPLEQFF,6,0,1,6
TRBV9,TRBJ2-7,CASSPAGTYPSEQYF,6,0,1,6
TRBV7-9,TRBJ2-5,CASSGTGGAAETQYF,6,0,1,6
TRBV11-2,TRBJ2-3,CASSNVGTGSNTQYF,6,0,1,6
TRBV28,TRBJ1-6,CASRRHQGLNSPLHF,6,0,1,6
TRBV7-2,TRBJ1-6,CASNEGSSNNSPLHF,6,0,1,6
TRBV5-1,TRBJ2-7,CVSSPGGARVKEQYF,6,0,1,6
TRBV5-1,TRBJ2-3,CASHQTSATTDTQYF,6,0,1,6
TRBV10-1,TRBJ2-7,CASSDLHRIPYEQYF,6,0,1,6
TRBV10-2,TRBJ1-4,CASSDGLTGYEKLFF,6,0,1,6
TRBV5-1,TRBJ2-1,CASSSGAGGYNEQFF,6,0,1,6
TRBV5-1,TRBJ2-1,CASSWTGLESNEQFF,6,0,1,6
TRBV4-3,TRBJ2-5,CASSPRWAPEETQYF,6,0,1,6
TRBV4-3,TRBJ2-4,CASSQEGTAKNIQYF,6,0,1,6
TRBV5-1,TRBJ2-6,CASRLRVAGANVLTF,6,0,1,6
TRBV5-1,TRBJ2-1,CASRIRNTQNNEQFF,6,0,1,6
TRBV20-1,TRBJ2-7,CSAHLGTSAAYEQYF,6,0,1,6
TRBV20-1,TRBJ2-7,CSAGGLAASSYEQYF,6,0,1,6
TRBV20-1,TRBJ2-3,CSASSRQPLTDTQYF,6,0,1,6
TRBV20-1,TRBJ2-7,CSARLGTGSGYEQYF,6,0,1,6
TRBV20-1,TRBJ1-6,CSARRGGSYNSPLHF,6,0,1,6
TRBV20-1,TRBJ2-1,CSARWVAGGLNEQFF,6,0,1,6
TRBV29-1,TRBJ2-7,CSVSPGQRIPYEQYF,6,0,1,6
TRBV12-5,TRBJ2-1,CASGPGQGSNEQFF,6,0,1,6
TRBV12-5,TRBJ2-1,CASGSLAGLNEQFF,6,0,1,6
TRBV10-3,TRBJ2-5,CAISEIGEGETQYF,6,0,1,6
TRBV19,TRBJ1-2,CASTSTGADYGYTF,6,0,1,6
TRBV19,TRBJ2-1,CASSIGYRVNEQFF,6,0,1,6
TRBV19,TRBJ1-2,CASSIGGQGGGYTF,6,0,1,6
TRBV19,TRBJ2-3,CASSIELAGDTQYF,6,0,1,6
TRBV12-3/4,TRBJ1-2,CASCPTGIDYGYTF,6,0,1,6
TRBV12-3/4,TRBJ1-1,CASSLLEGFTEAFF,6,0,1,6
TRBV6-2/3/5/6,TRBJ1-5,CASSWTGGNQPQHF,6,0,1,6
TRBV6-2/3/5/6,TRBJ1-4,CASSYDPQVEKLFF,6,0,1,6
TRBV6-2/3/5/6,TRBJ1-1,CASSYSGGSTEAFF,6,0,1,6
TRBV6-2/3/5/6,TRBJ2-1,CASSYGDFYNEQFF,6,0,1,6
TRBV6-2/3/5/6,TRBJ2-1,CASSYGSSYNEQFF,6,4,2,10
TRBV12-3/4,TRBJ1-5,CASSGRLGDQPQHF,6,0,1,6
TRBV6-1,TRBJ1-1,CASSEDPEGAEAFF,6,0,1,6
TRBV7-9,TRBJ2-5,CASSFSRLEETQYF,6,0,1,6
TRBV5-6,TRBJ2-7,CASSLGRSAYEQYF,6,0,1,6
TRBV12-3/4,TRBJ2-7,CASSSQDRGYEQYF,6,0,1,6
TRBV7-3,TRBJ2-5,CASSSSGRQETQYF,6,0,1,6
TRBV6-1,TRBJ1-2,CASSWKTGGFGYTF,6,0,1,6
TRBV3-1,TRBJ1-1,CASSPDRVNTEAFF,6,0,1,6
TRBV7-9,TRBJ2-5,CASSPRQGGETQYF,6,0,1,6
TRBV3-1,TRBJ1-1,CASSQLQGNTEAFF,6,0,1,6
TRBV14,TRBJ2-7,CASSQVPFGGEQYF,6,0,1,6
TRBV7-2,TRBJ2-7,CASSVTSGVYEQYF,6,0,1,6
TRBV9,TRBJ2-5,CASSVGTIQETQYF,6,0,1,6
TRBV6-2/3/5/6,TRBJ1-1,CASSKGQGNTEAFL,6,0,1,6
TRBV12-3/4,TRBJ1-4,CASRFDRGSEKLFF,6,0,1,6
TRBV12-3/4,TRBJ2-2,CASRLTSGTGELFF,6,0,1,6
TRBV2,TRBJ1-1,CASRGQGGNTEAFF,6,0,1,6
TRBV2,TRBJ2-1,CASRTHGNSNEQFF,6,0,1,6
TRBV14,TRBJ2-1,CASRMRGANNEQFF,6,0,1,6
TRBV5-1,TRBJ2-5,CASSFGTSEKTQYF,6,0,1,6
TRBV5-1,TRBJ2-7,CASSHRDGPYEQYF,6,0,1,6
TRBV20-1,TRBJ2-7,CSVASDTSSYEQYF,6,0,1,6
TRBV20-1,TRBJ2-1,CSARSRSSYNEQFF,6,4,2,10
TRBV20-1,TRBJ2-4,CSARDRGSKNIQYF,6,0,1,6
TRBV5-1,TRBJ2-7,SASSLASGQGEQYF,6,0,1,6
TRBV30,TRBJ2-1,CALTSGAYNEQFF,6,0,1,6
TRBV30,TRBJ2-5,CAWSVLSSETQYF,6,0,1,6
TRBV30,TRBJ1-5,CAWSGDPHQPQHF,6,0,1,6
TRBV15,TRBJ1-5,CATSRDHDQPQHF,6,0,1,6
TRBV19,TRBJ1-1,CASSIRHDTEAFF,6,0,1,6
TRBV19,TRBJ2-3,CASKERNTDTQYF,6,0,1,6
TRBV7-2,TRBJ1-2,CASLPQGLYGYTF,6,0,1,6
TRBV6-2/3/5/6,TRBJ2-1,CASSYTSNNEQFF,6,0,1,6
TRBV6-2/3/5/6,TRBJ1-1,CASSYLRQGIAFF,6,0,1,6
TRBV12-3/4,TRBJ1-1,CASSPNTGAEAFF,6,0,1,6
TRBV2,TRBJ1-1,CASSGDSWTEAFF,6,15,2,21
TRBV7-9,TRBJ2-5,CASSDDRKETQYF,6,0,1,6
TRBV11-2,TRBJ2-5,CASSFQSQETQYF,6,0,1,6
TRBV7-3,TRBJ1-1,CASSLVRVTEAFF,6,0,1,6
TRBV7-2,TRBJ2-2,CASSLGLAGELFF,6,0,1,6
TRBV7-3,TRBJ2-1,CASSLEGDNEQFF,6,0,1,6
TRBV5-6,TRBJ2-5,CASSSNFQETQYF,6,0,1,6
TRBV3-1,TRBJ1-6,CASSSTDNSPLHF,6,0,1,6
TRBV14,TRBJ2-3,CASSLGPGDTQYF,6,0,1,6
TRBV9,TRBJ2-7,CASSPRVIDEQYF,6,0,1,6
TRBV7-9,TRBJ2-3,CASSPQGGGHGYF,6,0,1,6
TRBV7-9,TRBJ1-1,CASSREELTEAFF,6,0,1,6
TRBV3-1,TRBJ1-5,CASSQDRGQPQHF,6,3,2,9
TRBV3-1,TRBJ2-1,CASSQGWQNEQFF,6,0,1,6
TRBV14,TRBJ2-7,CASSQDPGAEQYF,6,0,1,6
TRBV14,TRBJ1-1,CASSQDGNTEAFF,6,0,1,6
TRBV12-3/4,TRBJ1-5,CASSMVGRQPQHF,6,0,1,6
TRBV30,TRBJ2-1,CALNRVWGNEQFF,6,0,1,6
TRBV5-1,TRBJ2-3,CATASGGTDTQYF,6,0,1,6
TRBV5-1,TRBJ1-4,CASSFAGNEKLFF,6,0,1,6
TRBV5-1,TRBJ1-1,CASSLRMNTEAFF,6,0,1,6
TRBV5-1,TRBJ2-1,CASSGDSYNEQFF,6,0,1,6
TRBV20-1,TRBJ2-5,CSAGDYGRETQYF,6,0,1,6
TRBV29-1,TRBJ2-2,CSTRGGDTGELFF,6,0,1,6
TRBV29-1,TRBJ2-3,CSVYIRQTDTQYF,6,0,1,6
TRBV29-1,TRBJ2-3,CSVRTGDTDTQYF,6,0,1,6
TRBV29-1,TRBJ2-1,CSVGQGTYNEQFF,6,0,1,6
TRBV29-1,TRBJ1-1,CSVTQGVSTEAFF,6,0,1,6
TRBV29-1,TRBJ2-7,CSVKPGGEGEQYF,6,0,1,6
TRBV29-1,TRBJ2-3,CSVRGPSTDTQYF,6,0,1,6
TRBV29-1,TRBJ2-3,CSGGGTGTDTQYF,6,0,1,6
TRBV3-1,TRBJ2-7,RASSLDRSYEQYF,6,0,1,6
TRBV18,TRBJ1-1,CSSSPGNLDAFF,6,0,1,6
TRBV30,TRBJ1-5,CAWTQDHQPQHF,6,0,1,6
TRBV30,TRBJ1-1,CAWSVSLREAFF,6,0,1,6
TRBV28,TRBJ1-5,CAISTGDQPQHF,6,0,1,6
TRBV15,TRBJ1-2,CATSREEGGYTF,6,0,1,6
TRBV19,TRBJ1-5,CASTGDNQPQHF,6,0,1,6
TRBV19,TRBJ2-5,CASSTGQETQYF,6,0,1,6
TRBV6-1,TRBJ2-1,CASGENTHEQFF,6,0,1,6
TRBV14,TRBJ2-1,CASSFQGVEQFF,6,0,1,6
TRBV7-2,TRBJ1-1,CASSLGPDKAFF,6,0,1,6
TRBV3-1,TRBJ2-4,CASSQRQNIQYF,6,0,1,6
TRBV20-1,TRBJ2-3,CSARLGPDTQYF,6,0,1,6
TRBV29-1,TRBJ1-2,CSVGTPNYGYTF,6,0,1,6
TRBV29-1,TRBJ2-1,CSVGGSKGEQFF,6,0,1,6
TRBV29-1,TRBJ1-5,CSARESNQPQHF,6,0,1,6
TRBV30,TRBJ1-1,CAGRDRSEAFF,6,0,1,6
TRBV7-2,TRBJ2-5,CASSLRETQYF,6,0,1,6
TRBV20-1,TRBJ2-1,CSALTYNEQFF,6,0,1,6
TRBV29-1,TRBJ2-5,CSTRAEETQYF,6,0,1,6
TRBV13,TRBJ1-2,CASSWGRSSAPGYTF,6,0,1,6
TRBV11-3,TRBJ1-1,CASSPRRKLNTEAFF,6,0,1,6
TRBV9,TRBJ1-6,CASSRTGRGSPLHF,6,0,1,6
TRBV5-5,TRBJ1-1,CASSLEPANTEAFF,6,0,1,6
TRBV7-2,TRBJ2-3,CASSLWTTDTEYF,6,0,1,6
TRBV4-1,TRBJ2-1,CASSRDRGAGNEQFF,6,0,1,6
TRBV24-1,TRBJ2-7,CATSDDGTSGEFEQYF,6,0,1,6
TRBV7-3,TRBJ2-3,CASSLTGGADTDTQYF,6,8,2,14
TRBV11-2,TRBJ1-5,CASSLGQVNSNQPQHF,6,0,1,6
TRBV29-1,TRBJ2-3,CSVRGASTDTQYF,5,0,1,5
TRBV7-2,TRBJ2-5,CASSLASAGAGETQYF,5,7,2,12
TRBV7-2,TRBJ2-1,CASSLTSGGTYNEQFF,5,0,1,5
TRBV5-4,TRBJ2-3,CASSLPIGGAAVASSTDTQYF,5,0,1,5
TRBV12-5,TRBJ2-4,CASGPRGTGGKNIQYF,5,0,1,5
TRBV5-5,TRBJ1-2,CASSRDSFLDYGYTF,5,0,1,5
TRBV18,TRBJ2-5,CASSPAGQETQYF,5,0,1,5
TRBV7-2,TRBJ1-1,CASSFQGGTEAFF,5,16,2,21
TRBV7-2,TRBJ2-2,CASSFGTTGELFF,5,0,1,5
TRBV4-3,TRBJ2-7,CASSQESRAEQYF,5,0,1,5
TRBV6-2/3/5/6,TRBJ2-2,CVSSYSGGGHTGELFF,5,0,1,5
TRBV6-2/3/5/6,TRBJ2-5,CASSYLTVMGQLSLKREEMETQYF,5,0,1,5
TRBV10-3,TRBJ2-6,CAISEGLMGRSSGANVLTF,5,0,1,5
TRBV6-2/3/5/6,TRBJ2-1,CASSYSPRSLAGGPNEQFF,5,0,1,5
TRBV12-3/4,TRBJ1-2,CASSRRPFGRETTNYGYTF,5,0,1,5
TRBV7-9,TRBJ2-3,CASSSLALRLAGSTDTQYF,5,0,1,5
TRBV7-9,TRBJ2-2,CASSTPGLAGGQNTGELFF,5,0,1,5
TRBV10-3,TRBJ2-1,CAISEQGLAGGLYNEQFF,5,0,1,5
TRBV7-2,TRBJ2-1,CASSLPRGRSSSYNEQFF,5,0,1,5
TRBV12-3/4,TRBJ2-6,CASSRRGQGYSGANVLTF,5,0,1,5
TRBV7-9,TRBJ2-1,CASSESETSGRLYNEQFF,5,0,1,5
TRBV5-1,TRBJ2-7,CASSSPDGLSQTLYEQYF,5,0,1,5
TRBV4-1,TRBJ2-4,CASSQAHPGILSKNIQYF,5,0,1,5
TRBV20-1,TRBJ2-1,CSARDRLQGLAGADEQFF,5,0,1,5
TRBV29-1,TRBJ2-2,CSVRLAGVRVTNTGELFF,5,0,1,5
TRBV19,TRBJ1-5,CASSIPRGKGSNQPQHF,5,0,1,5
TRBV10-3,TRBJ1-1,CAISESWPGWKNTEAFF,5,0,1,5
TRBV19,TRBJ2-7,CASSHFSMGRTSYEQYF,5,0,1,5
TRBV19,TRBJ2-5,CASSIRGGQSIQETQYF,5,0,1,5
TRBV2,TRBJ2-4,CASRQNTLIEAKNIQYF,5,0,1,5
TRBV12-3/4,TRBJ2-4,CASSLEGALPAKNIQYF,5,0,1,5
TRBV6-1,TRBJ2-2,CASSGPGTGANTGELFF,5,0,1,5
TRBV11-3,TRBJ2-2,CASSLVFQSGHTGELFF,5,0,1,5
TRBV7-9,TRBJ1-3,CASSPVPLGYSGNTIYF,5,0,1,5
TRBV7-9,TRBJ2-3,CASSQVAGGPGTDTQYF,5,5,2,10
TRBV7-3,TRBJ2-1,CASSQNAQGTSRTEQFF,5,0,1,5
TRBV4-2,TRBJ2-7,CASSQALGLTNSYEQYF,5,0,1,5
TRBV5-1,TRBJ2-2,CASSLRVGRANTGELFF,5,0,1,5
TRBV20-1,TRBJ2-5,CSAPRQGAVITGETQYF,5,0,1,5
TRBV29-1,TRBJ2-6,CSVASQGSPSGANVLTF,5,0,1,5
TRBV24-1,TRBJ2-2,CATSDFSTGFTGELFF,5,0,1,5
TRBV24-1,TRBJ2-3,CATSDLRLADTDTQYF,5,0,1,5
TRBV24-1,TRBJ2-6,CATSDSSGSGANVLTF,5,0,1,5
TRBV15,TRBJ1-1,CATSRPGQGKNTEAFF,5,3,2,8
TRBV19,TRBJ1-5,CASSIAANSREGPQHF,5,0,1,5
TRBV18,TRBJ2-5,CASSPSDRGIMKTQYF,5,0,1,5
TRBV18,TRBJ1-1,CASSPSRGTANTEAFF,5,0,1,5
TRBV18,TRBJ1-1,CASSPPGRTMNTEAFF,5,0,1,5
TRBV18,TRBJ2-1,CASSPPSSTINNEQFF,5,0,1,5
TRBV19,TRBJ2-1,CASAYPGHSSYNEQFF,5,0,1,5
TRBV2,TRBJ1-5,CASTPRHINSNQPQHF,5,0,1,5
TRBV28,TRBJ2-3,CASTPMNTYRTDTQYF,5,0,1,5
TRBV6-2/3/5/6,TRBJ1-5,CASSLVSGVGNQPQHF,5,0,1,5
TRBV28,TRBJ2-1,CASSLIAGWSYNEQFF,5,0,1,5
TRBV12-3/4,TRBJ1-5,CASSLSRQFLVQPQHF,5,0,1,5
TRBV12-3/4,TRBJ2-7,CASSYGRGSDAYEQYF,5,0,1,5
TRBV12-3/4,TRBJ2-4,CASSQTGSLARNIQYL,5,0,1,5
TRBV6-1,TRBJ1-2,CASSVTETGNNYGYTF,5,0,1,5
TRBV6-1,TRBJ1-6,CASSAGTGARSSPLHF,5,0,1,5
TRBV2,TRBJ1-5,CASSGGPGSSNQPQHF,5,0,1,5
TRBV6-4,TRBJ2-5,CASSDSSSAGVETQYF,5,0,1,5
TRBV6-1,TRBJ2-5,CASSEVGQGHRETQYF,5,0,1,5
TRBV6-1,TRBJ2-7,CASSETGTGRTYEQYF,5,0,1,5
TRBV5-6,TRBJ2-5,CASSLLNRQDQETQYF,5,0,1,5
TRBV5-5,TRBJ1-1,CASSLVRQTQNTEAFF,5,0,1,5
TRBV7-3,TRBJ2-1,CASSLYTFSSYNEQFF,5,0,1,5
TRBV28,TRBJ1-5,CASSLVGPRSNQPQHF,5,0,1,5
TRBV11-3,TRBJ2-1,CASSLGGRAGWNEQFF,5,0,1,5
TRBV11-3,TRBJ2-3,CASSLGNSGLTDTQYF,5,0,1,5
TRBV7-8,TRBJ2-7,CASSLGGLAGSYEQYF,5,0,1,5
TRBV7-3,TRBJ2-1,CASSLSSGGTYNEQFF,5,0,1,5
TRBV12-3/4,TRBJ1-2,CASSPLGEGGWGGYTF,5,0,1,5
TRBV5-4,TRBJ1-4,CASSRDRGLGDEKLFF,5,0,1,5
TRBV7-2,TRBJ2-2,CASSRVRTPNTGELFF,5,0,1,5
TRBV5-8,TRBJ2-1,CASSRPTGGPYNEQFF,5,0,1,5
TRBV7-2,TRBJ1-2,CASSRGGRGSNYGYTF,5,0,1,5
TRBV3-1,TRBJ2-6,CASSQDRVSGANVLTF,5,0,1,5
TRBV14,TRBJ2-3,CASSQDGTGNTDTQYF,5,0,1,5
TRBV2,TRBJ2-5,CASRPPGTGRRETQYF,5,0,1,5
TRBV7-9,TRBJ2-7,CTSSLDISAGYYEQYF,5,0,1,5
TRBV5-1,TRBJ2-3,CASSLGFRVSTDTQYF,5,0,1,5
TRBV5-1,TRBJ2-5,CASSLGVAAVQETQYF,5,0,1,5
TRBV5-1,TRBJ2-3,CASSLEVTGGTDTQYF,5,0,1,5
TRBV5-1,TRBJ1-1,CASSSINRDMNTEAFF,5,0,1,5
TRBV4-1,TRBJ2-1,CASSLPGTGPYNEQFF,5,0,1,5
TRBV20-1,TRBJ2-5,CSAAGTSGSPQETQYF,5,0,1,5
TRBV20-1,TRBJ2-1,CSARDARATLGDEQFF,5,0,1,5
TRBV29-1,TRBJ2-1,CSVVAPSEGYYNEQFF,5,0,1,5
TRBV29-1,TRBJ1-2,CSVLGPEPVGPYGYTF,5,0,1,5
TRBV10-3,TRBJ2-3,CAITQGRGETDTQYF,5,0,1,5
TRBV15,TRBJ2-5,CATSRENPSQETQYF,5,0,1,5
TRBV15,TRBJ1-5,CATGELNLSNQPQHF,5,0,1,5
TRBV19,TRBJ2-3,CASTPRDRRPNTQYF,5,0,1,5
TRBV19,TRBJ2-3,CASSISSLSTDTQYF,5,0,1,5
TRBV19,TRBJ2-7,CASSKRMWATYEQYF,5,0,1,5
TRBV19,TRBJ2-1,CASSPLAGDDNEQFF,5,0,1,5
TRBV19,TRBJ2-3,CASRVVAFYTDTQYF,5,0,1,5
TRBV7-2,TRBJ2-7,CASGLEGQGPYEQYF,5,0,1,5
TRBV18,TRBJ2-1,CASTPGTGGSNEQFF,5,0,1,5
TRBV6-2/3/5/6,TRBJ2-7,CASSSAPGQGYEQYF,5,0,1,5
TRBV6-2/3/5/6,TRBJ2-7,CASSYSGYRDYEQYF,5,0,1,5
TRBV6-2/3/5/6,TRBJ2-5,CASSYSGTSQETQYF,5,0,1,5
TRBV6-2/3/5/6,TRBJ1-5,CASSLRGLGNQPQHF,5,0,1,5
TRBV12-3/4,TRBJ1-5,CASSPDRGRDQPQHF,5,0,1,5
TRBV6-1,TRBJ2-3,CASSASSLLSNTQYF,5,0,1,5
TRBV2,TRBJ2-5,CASSGTSGVGKTQYF,5,0,1,5
TRBV6-1,TRBJ2-7,CASSESSGSSYEQYF,5,0,1,5
TRBV6-1,TRBJ2-3,CASSEASGGLDTQYF,5,0,1,5
TRBV2,TRBJ2-5,CASSEDWGGQETQYF,5,0,1,5
TRBV28,TRBJ1-1,CASSTPGLEDTEAFF,5,0,1,5
TRBV7-2,TRBJ2-3,CASSFGRVYTDTQYF,5,0,1,5
TRBV11-1,TRBJ2-2,CASSFSGTLTGELFF,5,0,1,5
TRBV11-2,TRBJ2-5,CASSFRTSSPKTLYF,5,0,1,5
TRBV7-9,TRBJ2-3,CASSLLAGGTDTQYF,5,0,1,5
TRBV5-6,TRBJ2-1,CASSLVTGGPDEQFF,5,0,1,5
TRBV7-9,TRBJ1-1,CASSLGDRMNTEAFF,5,0,1,5
TRBV5-4,TRBJ2-1,CASSLDGSVYNEQLF,5,0,1,5
TRBV5-6,TRBJ2-3,CASSLEEREADTQYF,5,0,1,5
TRBV11-3,TRBJ1-2,CASSLTPQGNYGYTF,5,0,1,5
TRBV5-4,TRBJ2-3,CASSLTEEYTDTQYF,5,0,1,5
TRBV5-6,TRBJ2-5,CASSLKGDIQETQYF,5,0,1,5
TRBV7-3,TRBJ1-6,CASSLFSGSNSPLHF,5,0,1,5
TRBV7-2,TRBJ1-4,CASSLGQGRVEKLFF,5,0,1,5
TRBV7-2,TRBJ2-2,CASSLDPQNTGELFF,5,0,1,5
TRBV7-2,TRBJ2-3,CASSLERGGTDTQYF,5,0,1,5
TRBV7-2,TRBJ2-3,CASSLMVGVQDTQYF,5,0,1,5
TRBV11-2,TRBJ1-6,CASSLTLWGNSPLHF,5,0,1,5
TRBV7-2,TRBJ2-3,CASSLTGVGPDTQYF,5,0,1,5
TRBV7-2,TRBJ2-1,CASSLRSASYNEQFF,5,0,1,5
TRBV7-2,TRBJ2-3,CASSSRAGGTDTQYF,5,0,1,5
TRBV7-2,TRBJ1-1,CASSSGQALNTEAFF,5,0,1,5
TRBV7-8,TRBJ2-5,CASSSDRIGGETQYF,5,0,1,5
TRBV5-6,TRBJ2-2,CASSWGHAKTGELFF,5,0,1,5
TRBV27,TRBJ1-4,CASSPLTTTNEKLFF,5,0,1,5
TRBV3-1,TRBJ1-1,CASSPLGEGDTEAFF,5,0,1,5
TRBV5-4,TRBJ2-3,CASSPPRGPTDTQYF,5,4,2,9
TRBV11-1,TRBJ2-1,CASSPTSGNYNEQFF,5,0,1,5
TRBV7-9,TRBJ2-1,CASSPVPGQYNEQFF,5,12,2,17
TRBV6-2/3/5/6,TRBJ1-3,CASSPGGNSGNTIYF,5,0,1,5
TRBV7-2,TRBJ2-6,CASSHSVSGANVLTF,5,0,1,5
TRBV14,TRBJ2-1,CASSQPSGSRNEQFF,5,0,1,5
TRBV3-1,TRBJ1-4,CASSQVGWTNEKLFF,5,0,1,5
TRBV3-1,TRBJ2-7,CASSQGTAGPYEQYF,5,0,1,5
TRBV3-1,TRBJ2-5,CASSQGGGGRETHYF,5,0,1,5
TRBV7-8,TRBJ2-7,CASSVLSTEAYEQYF,5,0,1,5
TRBV9,TRBJ2-3,CASSVDSDNTDTQYF,5,0,1,5
TRBV28,TRBJ2-3,CASRLGTSGTDTQYF,5,0,1,5
TRBV5-1,TRBJ1-2,CASSLVGGFNYGYTF,5,0,1,5
TRBV5-1,TRBJ2-7,CASSLVAGAAYEQYF,5,0,1,5
TRBV5-1,TRBJ2-3,CASSLGLAGTDTQYF,5,0,1,5
TRBV5-1,TRBJ2-1,CASSSGLAGNNEQFF,5,0,1,5
TRBV5-1,TRBJ1-1,CASSSEGQLNTEAFF,5,0,1,5
TRBV5-1,TRBJ2-1,CASSQMGGGNNEQFF,5,0,1,5
TRBV4-3,TRBJ1-4,CASSQDFPDGEKLFF,5,0,1,5
TRBV4-3,TRBJ1-2,CASSQRPGDLNGYTF,5,0,1,5
TRBV5-1,TRBJ2-1,CASSRPGISYNEQFF,5,0,1,5
TRBV20-1,TRBJ2-1,CSARTEQEGYNEQFF,5,0,1,5
TRBV20-1,TRBJ2-5,CSTSFPAGGGETQYF,5,0,1,5
TRBV29-1,TRBJ2-1,CSVEPGRLGRNEQFF,5,0,1,5
TRBV29-1,TRBJ1-1,CSVAVNPSAGTEAFF,5,0,1,5
TRBV29-1,TRBJ2-1,RSVAGGTGVHNEQFF,5,0,1,5
TRBV7-9,TRBJ2-7,CVSSSPGGSYEQYF,5,0,1,5
TRBV28,TRBJ2-7,CATYRGAGAYEQYF,5,0,1,5
TRBV30,TRBJ1-5,CACQSADSNQPQHF,5,5,2,10
TRBV12-3/4,TRBJ1-3,CACTRRDRRNTIYF,5,0,1,5
TRBV30,TRBJ1-2,CAWSVRGGVPPYTF,5,0,1,5
TRBV30,TRBJ2-6,CAWRGETGANVLTF,5,0,1,5
TRBV10-3,TRBJ1-5,CAISEGTGNQPQHF,5,0,1,5
TRBV10-3,TRBJ1-1,CAIRGTAEGTEAFF,5,0,1,5
TRBV15,TRBJ2-4,CATSPGSWGNIQYF,5,0,1,5
TRBV19,TRBJ1-1,CASSALQGNTEAFF,5,0,1,5
TRBV12-3/4,TRBJ1-2,CASSPRTVRSGYTF,5,0,1,5
TRBV18,TRBJ2-1,CASSLIDREGEQFF,5,0,1,5
TRBV12-3/4,TRBJ1-1,CASSFYPENTEAFF,5,0,1,5
TRBV12-3/4,TRBJ2-5,CASSLAGGQETQYF,5,0,1,5
TRBV12-3/4,TRBJ2-3,CASSLGGTADTQYF,5,0,1,5
TRBV27,TRBJ2-5,CASSSRGRQETQYF,5,0,1,5
TRBV2,TRBJ2-5,CASSVEGEGETQYF,5,0,1,5
TRBV2,TRBJ1-5,CASSELRAGQPQHF,5,0,1,5
TRBV25-1,TRBJ1-1,CASSEAGGRTEAFF,5,0,1,5
TRBV12-3/4,TRBJ2-3,CASSTTGGGGTQYF,5,0,1,5
TRBV5-4,TRBJ2-3,CASSFGLATDTQYF,5,0,1,5
TRBV5-4,TRBJ2-7,CASSLFQGGYEQYF,5,0,1,5
TRBV5-4,TRBJ1-2,CASSLGLSNYGYTF,5,0,1,5
TRBV7-6,TRBJ1-1,CASSLASVNTEAFF,5,0,1,5
TRBV7-2,TRBJ2-7,CASSLAGSSYEQYF,5,0,1,5
TRBV13,TRBJ1-1,CASSLEQPNTEAFF,5,0,1,5
TRBV7-3,TRBJ2-2,CASSLQGYTGELFF,5,0,1,5
TRBV11-2,TRBJ1-1,CASSPGPLNTEAVF,5,0,1,5
TRBV7-9,TRBJ1-5,CASSPGGYNQPQHF,5,0,1,5
TRBV7-9,TRBJ2-3,CASSPTGATDTQYF,5,0,1,5
TRBV7-9,TRBJ1-1,CASSPASPGAEAFF,5,0,1,5
TRBV7-2,TRBJ1-4,CASSHPTVAEKLFF,5,0,1,5
TRBV7-9,TRBJ1-1,CASSQGRKNTEAFF,5,0,1,5
TRBV3-1,TRBJ2-5,CASSQEPAGETQYF,5,0,1,5
TRBV11-2,TRBJ1-2,CASSVTGTAYGYTF,5,0,1,5
TRBV5-6,TRBJ2-7,CASSAQGNPYEQYF,5,2,2,7
TRBV7-9,TRBJ1-5,CASSIGQGGRPQHF,5,0,1,5
TRBV4-2,TRBJ1-1,CASSTRGLNTEAFF,5,0,1,5
TRBV6-2/3/5/6,TRBJ1-2,CASSRTGHAYGYTF,5,0,1,5
TRBV12-3/4,TRBJ1-5,CASSKGQGNQPQHF,5,0,1,5
TRBV7-9,TRBJ2-7,CASRAPENTHEQYF,5,0,1,5
TRBV6-2/3/5/6,TRBJ1-5,CASRGGQYDQPQHF,5,0,1,5
TRBV7-3,TRBJ1-5,CARPRGIGNQPQHF,5,0,1,5
TRBV5-1,TRBJ2-2,CASTALLGTGELFF,5,0,1,5
TRBV10-1,TRBJ2-1,CASSARPTYNEQFF,5,0,1,5
TRBV5-1,TRBJ1-2,CASSLGQGIYGYTF,5,0,1,5
TRBV5-1,TRBJ2-7,CASSLGDAPYEQYF,5,0,1,5
TRBV5-1,TRBJ2-1,CASSLGLIINEQFF,5,0,1,5
TRBV5-1,TRBJ2-7,CASSSSGLSYEQYF,5,0,1,5
TRBV5-1,TRBJ2-3,CASSPPQDLDTQYF,5,0,1,5
TRBV4-1,TRBJ2-7,CASSQDPQSYEQYF,5,0,1,5
TRBV4-3,TRBJ2-2,CASSQDSNTGELFF,5,0,1,5
TRBV20-1,TRBJ2-3,CSASQGVWTDTQYF,5,0,1,5
TRBV20-1,TRBJ1-1,CSASPPKGNTEAFF,5,0,1,5
TRBV20-1,TRBJ2-1,CSARGTSDYNEQFF,5,0,1,5
TRBV20-1,TRBJ2-3,CSARDLASTDTQYF,5,0,1,5
TRBV20-1,TRBJ2-6,CSARENSGANVLTF,5,0,1,5
TRBV20-1,TRBJ1-5,CSARKTGPNQPQHF,5,0,1,5
TRBV20-1,TRBJ1-2,CSAEINRLAMLYTF,5,0,1,5
TRBV20-1,TRBJ2-7,CSAASGAAGDLEYF,5,0,1,5
TRBV29-1,TRBJ2-5,CSVVLGGSPETQYF,5,0,1,5
TRBV29-1,TRBJ2-7,CSVARGTSSYEQYF,5,0,1,5
TRBV29-1,TRBJ1-3,CSVEYPGSGNTIYF,5,0,1,5
TRBV29-1,TRBJ1-4,CSVTKRATNEKLFF,5,0,1,5
TRBV29-1,TRBJ2-7,CSVNRSNFSNEQYF,5,0,1,5
TRBV29-1,TRBJ2-1,CSALPRQGEDEQFF,5,0,1,5
TRBV12-5,TRBJ2-7,CASGLVLGNEQYF,5,0,1,5
TRBV19,TRBJ2-4,CASSWGPKNIQYF,5,0,1,5
TRBV12-3/4,TRBJ2-1,CATGTTSHNEQFF,5,0,1,5
TRBV10-3,TRBJ1-2,CATKLGPGAGYTF,5,0,1,5
TRBV19,TRBJ1-5,CASSRGWGEPQHF,5,0,1,5
TRBV19,TRBJ2-7,CASSIQGGYEQYF,5,0,1,5
TRBV19,TRBJ1-5,CASSTGGHQPQHF,5,0,1,5
TRBV7-9,TRBJ2-5,CASTPGAGVPQYF,5,0,1,5
TRBV7-9,TRBJ2-5,CASTHKDGKTQYF,5,0,1,5
TRBV6-2/3/5/6,TRBJ1-1,CASSLTGVTEAFF,5,0,1,5
TRBV6-2/3/5/6,TRBJ2-7,CASSLSRGHEQYF,5,0,1,5
TRBV28,TRBJ2-3,CASSLSGSPTQYF,5,0,1,5
TRBV28,TRBJ1-1,CASSLQGYTEAFF,5,0,1,5
TRBV27,TRBJ1-2,CASSLGGGYGYTF,5,0,1,5
TRBV5-6,TRBJ1-2,CASSSGQGYGYTS,5,0,1,5
TRBV6-2/3/5/6,TRBJ1-1,CASSYTGSTEAFF,5,0,1,5
TRBV7-6,TRBJ1-6,CASSPGSSSPLHF,5,0,1,5
TRBV2,TRBJ1-1,CASSEEVGTEAFF,5,0,1,5
TRBV5-6,TRBJ1-1,CASSFYRGTEAFF,5,0,1,5
TRBV7-2,TRBJ2-2,CASSLGEAGELFF,5,0,1,5
TRBV7-2,TRBJ2-7,CASSLGQGREQYF,5,0,1,5
TRBV7-9,TRBJ1-2,CASSSRGLYGYTF,5,0,1,5
TRBV7-2,TRBJ2-7,CASSSRGGYEQYF,5,0,1,5
TRBV14,TRBJ1-5,CASSPLGGQPQHF,5,0,1,5
TRBV7-2,TRBJ2-1,CASSPRPGYEQFF,5,0,1,5
TRBV14,TRBJ2-7,CASSRGHFYEQYF,5,0,1,5
TRBV6-2/3/5/6,TRBJ2-1,CASSRDRFNEQFF,5,0,1,5
TRBV3-1,TRBJ2-1,CASSQDVNNEQFF,5,0,1,5
TRBV3-1,TRBJ2-1,CASSQDKVNEQFF,5,0,1,5
TRBV9,TRBJ2-1,CASSVGTDNEQFF,5,0,1,5
TRBV13,TRBJ2-2,CASSVRNTGELFF,5,0,1,5
TRBV6-2/3/5/6,TRBJ1-2,CASSAGTLYGYTF,5,0,1,5
TRBV7-3,TRBJ2-3,CASSDPGGGTQYF,5,0,1,5
TRBV7-9,TRBJ2-2,CASSDRGPGELFF,5,0,1,5
TRBV12-3/4,TRBJ2-7,CASSTPGQYEQYF,5,0,1,5
TRBV7-3,TRBJ2-7,CASSKDRSYEQYF,5,0,1,5
TRBV5-4,TRBJ2-1,CASRSGTHNEQFF,5,0,1,5
TRBV10-1,TRBJ2-7,CASSPGRAYEQYF,5,0,1,5
TRBV5-1,TRBJ2-7,CASRVEGRYEQYF,5,0,1,5
TRBV10-1,TRBJ1-1,CASSLTGEAEAFF,5,0,1,5
TRBV4-3,TRBJ2-1,CASSSLSSFEQFF,5,0,1,5
TRBV4-1,TRBJ2-1,CASSRDYRTEQFF,5,0,1,5
TRBV4-1,TRBJ2-7,CASSQDPRGEQYF,5,0,1,5
TRBV4-3,TRBJ2-3,CASSQDRESGQYF,5,0,1,5
TRBV5-1,TRBJ1-2,CASSRAQGYGYTF,5,0,1,5
TRBV20-1,TRBJ1-1,CSASPDRNTEAFF,5,0,1,5
TRBV20-1,TRBJ1-1,CSARDFTGTEAFF,5,0,1,5
TRBV20-1,TRBJ2-7,CSARDQGPREQYF,5,0,1,5
TRBV20-1,TRBJ1-1,CSARRGSDTEAFF,5,0,1,5
TRBV20-1,TRBJ1-1,CSATTTHRLEAFF,5,0,1,5
TRBV29-1,TRBJ2-1,CSVRLNWDNEQFF,5,0,1,5
TRBV29-1,TRBJ1-2,CSVVGDSWDGYTF,5,0,1,5
TRBV29-1,TRBJ1-2,CSVGGQGNYGYTF,5,0,1,5
TRBV29-1,TRBJ1-2,CSVLRELGYGYTF,5,0,1,5
TRBV29-1,TRBJ2-6,CSVPGPGANVLTF,5,0,1,5
TRBV29-1,TRBJ2-4,CSASGVAENIQYF,5,0,1,5
TRBV5-6,TRBJ2-1,RASSGGANNEQFF,5,0,1,5
TRBV7-2,TRBJ1-2,CASRGYSYGYTF,5,0,1,5
TRBV10-3,TRBJ2-7,CATEGGRIEQYF,5,0,1,5
TRBV11-1,TRBJ1-1,CATPGGPAEAFF,5,0,1,5
TRBV7-2,TRBJ2-1,CASISSYNEQLF,5,0,1,5
TRBV6-2/3/5/6,TRBJ2-7,CASFGPSYEQYF,5,0,1,5
TRBV7-6,TRBJ1-5,CASSFGQGPQHF,5,0,1,5
TRBV5-6,TRBJ2-7,CASSLRAGEQYF,5,0,1,5
TRBV11-2,TRBJ1-6,CASSPSAPDLHF,5,0,1,5
TRBV7-9,TRBJ1-2,CASSPPGVPHTF,5,0,1,5
TRBV3-1,TRBJ2-7,CASSQVRGDRCF,5,0,1,5
TRBV3-1,TRBJ1-5,CASSQEGKPQHF,5,0,1,5
TRBV6-2/3/5/6,TRBJ1-1,CASRLGYTEAFF,5,0,1,5
TRBV5-1,TRBJ1-2,CASSLENYGYTF,5,0,1,5
TRBV4-1,TRBJ1-1,CASSQARRPAFF,5,0,1,5
TRBV20-1,TRBJ2-7,CSARGQGNEQYF,5,0,1,5
TRBV20-1,TRBJ2-3,CSARVQTDTQYF,5,8,2,13
TRBV29-1,TRBJ2-7,CSVERESDEQYF,5,0,1,5
TRBV29-1,TRBJ1-2,CSVQAGAGGYTF,5,0,1,5
TRBV29-1,TRBJ1-1,CSAGVGLEEAFF,5,0,1,5
TRBV19,TRBJ2-1,CASNYYNEQFF,5,0,1,5
TRBV12-3/4,TRBJ1-1,CASSLGPEAFF,5,0,1,5
TRBV6-2/3/5/6,TRBJ1-1,CASSSRGGAFF,5,0,1,5
TRBV12-3/4,TRBJ1-1,CASSLGTEAFF,5,0,1,5
TRBV7-2,TRBJ2-1,CASSFRNEQFF,5,0,1,5
TRBV7-9,TRBJ2-5,CASSLKETQYF,5,0,1,5
TRBV29-1,TRBJ2-2,CSVENTGELFF,5,0,1,5
TRBV29-1,TRBJ2-1,CSGRDGRGQFF,5,0,1,5
TRBV30,TRBJ2-7,CAWSGKEQYF,5,0,1,5
TRBV20-1,TRBJ2-3,CSATSDTQYF,5,0,1,5
TRBV29-1,TRBJ1-1,CSVEFRVAFF,5,0,1,5
TRBV3-1,TRBJ2-7,CASSLQGLAAREQYF,5,0,1,5
TRBV9,TRBJ1-2,CASSAGLTYGYTF,5,7,2,12
TRBV9,TRBJ2-5,CASSVAPSAKETQYF,5,0,1,5
TRBV12-3/4,TRBJ1-3,CASSLARGARQGAPGNTIYF,4,0,1,4
TRBV7-2,TRBJ2-1,CASSLRPGAGGTTGYNEQFF,4,0,1,4
TRBV11-2,TRBJ2-6,CASRPLPGTGGSEGANVLTF,4,0,1,4
TRBV10-2,TRBJ2-3,CASSLSGQGIRAVNTDTQYF,4,0,1,4
TRBV20-1,TRBJ1-5,CSARPPGRAPPYSNQPQHF,4,0,1,4
TRBV20-1,TRBJ2-1,YSAVIPLAHVRSSYNEQFF,4,0,1,4
TRBV15,TRBJ2-5,CATSRPRRTSGGIETQYF,4,0,1,4
TRBV19,TRBJ1-5,CASSMGAGGMVSNQPQHF,4,0,1,4
TRBV7-6,TRBJ2-1,CASSSLKQAGASYNEQFF,4,0,1,4
TRBV7-9,TRBJ2-3,CASSSSRREATSTDTQYF,4,0,1,4
TRBV5-1,TRBJ2-3,CASTPRTGNNGLTDTQYF,4,0,1,4
TRBV4-1,TRBJ1-2,CASSQDSKLTGTHYGYTF,4,0,1,4
TRBV20-1,TRBJ1-6,CSARDRSGRQGQRSPLHF,4,0,1,4
TRBV6-2/3/5/6,TRBJ2-1,YASSYVRGVRNSYNEQFF,4,0,1,4
TRBV24-1,TRBJ2-5,CATSDFVPGQIQETQYF,4,13,2,17
TRBV19,TRBJ2-1,CASSIPGHHSSYNEQFF,4,0,1,4
TRBV19,TRBJ1-3,CASSSRRQSLWRNTIYF,4,0,1,4
TRBV18,TRBJ2-6,CASSMTGSLSGANVLTF,4,0,1,4
TRBV18,TRBJ2-4,CASSPGTGRLAKNIQYF,4,0,1,4
TRBV18,TRBJ2-3,CASSPTPGTGESDTQYF,4,0,1,4
TRBV27,TRBJ2-7,CASSLSPAGTGGYEQYF,4,0,1,4
TRBV6-2/3/5/6,TRBJ2-5,CASSLRNRGTPSGTQYF,4,0,1,4
TRBV12-3/4,TRBJ2-1,CASSLRTDRNSYNEQFF,4,0,1,4
TRBV6-2/3/5/6,TRBJ1-5,CASSYSIFRDRVQPQHF,4,0,1,4
TRBV6-2/3/5/6,TRBJ2-6,CASSYSPPPSGANVLTF,4,0,1,4
TRBV6-1,TRBJ1-5,CASSEGGIWGVTQPQHF,4,0,1,4
TRBV6-4,TRBJ1-5,CASSEGGIWGVTQPQHL,4,0,1,4
TRBV27,TRBJ2-2,CASSTRTSGGVAGELFF,4,0,1,4
TRBV7-6,TRBJ2-2,CASSLPSTGLLTGELFF,4,0,1,4
TRBV7-2,TRBJ2-7,CASSLVGGRMLSYEQYF,4,0,1,4
TRBV11-2,TRBJ1-6,CASSLEVPGGWNSPLHF,4,0,1,4
TRBV7-2,TRBJ2-3,CASSLIGLAGITDTQYF,4,0,1,4
TRBV7-2,TRBJ2-1,CASSLGTGDPSYNEQFF,4,0,1,4
TRBV7-2,TRBJ2-3,CASSPFLDSLSTDTQYF,4,0,1,4
TRBV4-2,TRBJ2-7,CASSPLGQGERSYEQYF,4,0,1,4
TRBV7-2,TRBJ2-1,CASSPRGQMGKSNEQFF,4,0,1,4
TRBV7-2,TRBJ2-3,CASSPTRQGIGADTQYF,4,0,1,4
TRBV7-2,TRBJ2-1,CASSRGWTGGPVNEQFF,4,0,1,4
TRBV14,TRBJ1-2,CASSQVGLRGPNYGYTF,4,0,1,4
TRBV11-2,TRBJ2-1,CASSVRTASGGYNEQFF,4,0,1,4
TRBV5-4,TRBJ2-2,CASSDRAGGPYTGELFF,4,0,1,4
TRBV5-1,TRBJ2-3,CASSLVVSGGATDTQYF,4,0,1,4
TRBV20-1,TRBJ2-5,CSALSLGGTGAGETQYF,4,0,1,4
TRBV29-1,TRBJ1-1,CSVGPGQDWGINTEAFF,4,0,1,4
TRBV29-1,TRBJ2-6,CSVEDHPPGPGANVLTF,4,0,1,4
TRBV30,TRBJ1-1,CAWSVGSYVINTEAFL,4,0,1,4
TRBV19,TRBJ1-2,CASSSEPGTGIYGYTF,4,0,1,4
TRBV19,TRBJ2-4,CASSAADLVLTNIQYF,4,11,2,15
TRBV19,TRBJ1-5,CASSMGTEARDVPQHF,4,0,1,4
TRBV19,TRBJ2-1,CASSIALAGIRGEQFF,4,0,1,4
TRBV19,TRBJ2-3,CASSIGSGQGTDTQYF,4,0,1,4
TRBV19,TRBJ2-3,CASSIGRQGSTDTQYF,4,0,1,4
TRBV28,TRBJ1-5,CASTTPAWGLRQPQHF,4,0,1,4
TRBV11-2,TRBJ2-1,CASSFRGSGNYNEQFF,4,0,1,4
TRBV6-2/3/5/6,TRBJ2-1,CASSLSWTGRNNEQFF,4,0,1,4
TRBV12-3/4,TRBJ1-5,CASSLARQYSNQPQHF,4,0,1,4
TRBV5-6,TRBJ2-1,CASSSTRDFHLEEQFF,4,0,1,4
TRBV6-2/3/5/6,TRBJ1-3,CASSWGGAGIGNTIYF,4,0,1,4
TRBV6-2/3/5/6,TRBJ2-3,CASSYSDEPSTDTQYF,4,0,1,4
TRBV6-2/3/5/6,TRBJ1-5,CASSLFGTGSNQPQHF,4,0,1,4
TRBV6-1,TRBJ1-1,CASSGRKTGMNTEAFF,4,0,1,4
TRBV7-9,TRBJ2-3,CASSFPRGASTDTQYF,4,0,1,4
TRBV13,TRBJ1-6,CASSFRQGRGNSPLHF,4,0,1,4
TRBV7-8,TRBJ2-1,CASSLGRDYRNNEQFF,4,0,1,4
TRBV11-2,TRBJ2-5,CASSLVTSGDQETQYF,4,0,1,4
TRBV7-2,TRBJ2-7,CASSLGTSGLAYEQYF,4,0,1,4
TRBV13,TRBJ2-3,CASSLKTSGYTDTQYF,4,0,1,4
TRBV5-6,TRBJ2-3,CASSSLSRIPTDTQYF,4,0,1,4
TRBV7-9,TRBJ1-3,CASSSNRGFSGNTIHF,4,0,1,4
TRBV7-6,TRBJ2-7,CASSPETGTDSYEQYF,4,0,1,4
TRBV7-9,TRBJ1-1,CASSPRAAEYNTEAFF,4,0,1,4
TRBV5-5,TRBJ2-5,CASSPKVLAGEETQYF,4,0,1,4
TRBV14,TRBJ2-1,CASSQDTGGSYNEQFF,4,0,1,4
TRBV14,TRBJ2-7,CASSQDNAAGTYEQYF,4,2,2,6
TRBV3-1,TRBJ1-6,CASSQEGRARNSPLHF,4,0,1,4
TRBV7-9,TRBJ2-1,CASSVLQGMSYNELFF,4,0,1,4
TRBV5-6,TRBJ2-3,CASSDLQGGGTDTQYF,4,0,1,4
TRBV14,TRBJ1-1,CASSEGQGTENTEAFF,4,0,1,4
TRBV7-3,TRBJ2-1,CASSTQRPGTGDEQFF,4,0,1,4
TRBV7-9,TRBJ1-1,CASRGPGQGLSTGAFF,4,0,1,4
TRBV5-1,TRBJ2-1,CASSLGTSYRGGEQFF,4,0,1,4
TRBV5-1,TRBJ2-7,CASSLDRTSGGYEQYF,4,0,1,4
TRBV5-1,TRBJ2-5,CASSSEGLAGPETQYF,4,0,1,4
TRBV5-1,TRBJ2-1,CASSPVLGPPYNEQFF,4,0,1,4
TRBV4-1,TRBJ1-1,CASSPTGGTMNTEAFF,4,0,1,4
TRBV4-3,TRBJ2-5,CASSQGRPGGVETQYF,4,0,1,4
TRBV20-1,TRBJ2-5,CSAMGLAGGHQETQYF,4,0,1,4
TRBV20-1,TRBJ2-6,CSATASRGSGANVLTF,4,0,1,4
TRBV20-1,TRBJ1-3,CSARVPGQGDGNTIYF,4,0,1,4
TRBV20-1,TRBJ2-3,CSARDTSGRGTDTQYF,4,0,1,4
TRBV20-1,TRBJ2-5,CSARDPNSGGGETQYF,4,0,1,4
TRBV20-1,TRBJ2-3,CSARDVLAGNQDTQYF,4,0,1,4
TRBV29-1,TRBJ2-3,CSVDGTVAGGGYTQYF,4,0,1,4
TRBV29-1,TRBJ2-2,CSVEGSGRRRTGELFF,4,0,1,4
TRBV29-1,TRBJ2-2,RSVTNPRAKGAGELFF,4,0,1,4
TRBV12-5,TRBJ2-7,CASALRVSAHHEQYF,4,0,1,4
TRBV5-4,TRBJ2-5,CASSLTSGGEETQYF,4,0,1,4
TRBV10-3,TRBJ2-3,CAIGTDRDRTDTRYF,4,0,1,4
TRBV10-3,TRBJ1-1,CAISENGRSLAEAFF,4,0,1,4
TRBV15,TRBJ1-1,CATSRDRSVNTEAFF,4,0,1,4
TRBV15,TRBJ2-7,CATSRESSGSHEQYF,4,0,1,4
TRBV19,TRBJ1-5,CASSIGTGVDQPQHF,4,0,1,4
TRBV19,TRBJ2-1,CASSIASGIYNEQFF,4,0,1,4
TRBV19,TRBJ2-7,CASSTTGGWSYERYF,4,0,1,4
TRBV19,TRBJ1-5,CASNSRTEGGQPQHF,4,0,1,4
TRBV7-9,TRBJ2-7,CASSRPGTGNYEQYF,4,0,1,4
TRBV18,TRBJ1-1,CASSPYRESNTEAFF,4,0,1,4
TRBV18,TRBJ1-1,CASSPNQGENTEAFF,4,0,1,4
TRBV12-3/4,TRBJ2-1,CASQPRQSSYNEQFF,4,0,1,4
TRBV7-2,TRBJ1-6,CASTLMDIQNSPLHF,4,0,1,4
TRBV27,TRBJ1-2,CASSLSPRGDYGYTF,4,0,1,4
TRBV28,TRBJ1-5,CASSLWDREDQPQHF,4,0,1,4
TRBV27,TRBJ1-1,CASSSPGTGITEAFF,4,0,1,4
TRBV6-2/3/5/6,TRBJ1-1,CASSSNARTPPEAYF,4,0,1,4
TRBV6-2/3/5/6,TRBJ2-1,CASSPLAGGYNEQFF,4,0,1,4
TRBV12-3/4,TRBJ2-1,CASSPDRRALNEQFF,4,0,1,4
TRBV6-2/3/5/6,TRBJ1-3,CASSHRGGSGDTIYF,4,0,1,4
TRBV5-4,TRBJ2-1,CASSLPAGGWDEQFF,4,0,1,4
TRBV5-4,TRBJ1-6,CASSLQGIGYSPLHF,4,0,1,4
TRBV5-4,TRBJ2-3,CASSLVQGSTDTQYF,4,0,1,4
TRBV5-4,TRBJ2-5,CASSLGPGSKETQYF,4,0,1,4
TRBV5-4,TRBJ2-3,CASSLGGKIPDTQYF,4,0,1,4
TRBV5-6,TRBJ1-1,CASSLEVSGLTEAFF,4,0,1,4
TRBV7-3,TRBJ1-1,CASSLWGASNTEAFF,4,0,1,4
TRBV5-6,TRBJ2-7,CASSLPSGDSYEQYF,4,0,1,4
TRBV7-9,TRBJ2-3,CASSLVPSHQDTQYF,4,3,2,7
TRBV7-9,TRBJ1-4,CASSLAHRNNEKLFF,4,0,1,4
TRBV7-2,TRBJ1-2,CASSLGAGETYGYTF,4,0,1,4
TRBV5-4,TRBJ2-7,CASSLGTGGRYEQYF,4,0,1,4
TRBV7-9,TRBJ2-7,CASSLISASRDEQYF,4,0,1,4
TRBV7-9,TRBJ2-3,CASSLIRVRTDTQYF,4,0,1,4
TRBV7-2,TRBJ2-7,CASSLTSGRIYEQYF,4,0,1,4
TRBV11-1,TRBJ2-4,CASSLRGHSENIQYF,4,0,1,4
TRBV5-6,TRBJ2-6,CASSLKVSGANVLTF,4,0,1,4
TRBV7-9,TRBJ2-1,CASSSRVANYNEQFF,4,0,1,4
TRBV9,TRBJ2-6,CASSSAGSGANVLTF,4,0,1,4
TRBV7-9,TRBJ2-1,CASSSNPIGKNEQFF,4,0,1,4
TRBV7-9,TRBJ2-2,CASSSPFRDTGELFF,4,0,1,4
TRBV7-9,TRBJ1-5,CASSSYTGFGSPQHF,4,0,1,4
TRBV6-4,TRBJ2-7,CASSWTSGSSYEQYF,4,0,1,4
TRBV6-2/3/5/6,TRBJ2-7,CASSLGTGVPYEQYF,4,0,1,4
TRBV13,TRBJ2-1,CASSLSSGRYNEQFF,4,0,1,4
TRBV3-1,TRBJ2-1,CASSPPDRAYNEQFF,4,0,1,4
TRBV5-4,TRBJ1-4,CASSPRSGFNEKLFF,4,0,1,4
TRBV11-1,TRBJ2-1,CASSPTSISYNEQFF,4,4,2,8
TRBV7-9,TRBJ1-1,CASSPSAGGTTEAFF,4,0,1,4
TRBV9,TRBJ1-2,CASSPTATGPPGYTF,4,0,1,4
TRBV7-9,TRBJ1-3,CASSRRTITGNTIYF,4,0,1,4
TRBV16,TRBJ1-2,CASSQSHSGFYGYTF,4,0,1,4
TRBV3-1,TRBJ1-5,CASSQGKLTNQPQHF,4,0,1,4
TRBV4-2,TRBJ2-3,CASSQDPRQGNTQYF,4,0,1,4
TRBV14,TRBJ1-4,CASSQDKGANEKLFF,4,0,1,4
TRBV3-1,TRBJ2-6,CASSQDFSGANVLTF,4,0,1,4
TRBV3-1,TRBJ1-2,CASSQEWQGGDGYTF,4,0,1,4
TRBV9,TRBJ2-7,CASSVELAATYEQYF,4,0,1,4
TRBV9,TRBJ2-6,CASSAGGRTANVLTF,4,0,1,4
TRBV5-4,TRBJ2-7,CASRSDASISYEQYF,4,0,1,4
TRBV3-1,TRBJ2-7,CASRQGSEGGGEQYF,4,0,1,4
TRBV3-1,TRBJ2-7,CASRNRGTGPYEQYF,4,0,1,4
TRBV5-1,TRBJ2-1,CATLPGASSYNEQFF,4,0,1,4
TRBV10-1,TRBJ2-3,CASSSVTGATDTQYF,4,0,1,4
TRBV5-1,TRBJ2-2,CASTTGARDTGELFF,4,0,1,4
TRBV5-1,TRBJ2-3,CASSLRRSYTDTQYF,4,0,1,4
TRBV10-2,TRBJ2-3,CASSERTGLADTQYF,4,0,1,4
TRBV5-1,TRBJ1-2,CASSFRDRASDGYTF,4,0,1,4
TRBV5-1,TRBJ2-7,CASSLGGVLGYEQYF,4,0,1,4
TRBV5-1,TRBJ1-5,CASSLGQGANQPQHF,4,0,1,4
TRBV5-1,TRBJ1-1,CASSLQGPTNTEAFF,4,0,1,4
TRBV5-1,TRBJ2-7,CASSPRDRGKYEQYF,4,0,1,4
TRBV4-1,TRBJ2-5,CASSPMTGGRETQYF,4,0,1,4
TRBV5-1,TRBJ1-4,CASSPIPGGSEELFF,4,0,1,4
TRBV4-3,TRBJ2-5,CASSQSAGPRETQYF,4,0,1,4
TRBV4-1,TRBJ1-5,CASSQDWQGDQPQHF,4,0,1,4
TRBV4-3,TRBJ2-5,CASSQDRGESETQYF,4,0,1,4
TRBV4-3,TRBJ1-5,CASSQDRRRIQPQHF,4,0,1,4
TRBV13,TRBJ1-6,CTSSAGRAKNSPLHF,4,0,1,4
TRBV20-1,TRBJ2-7,CSARDPAGGPREQYF,4,0,1,4
TRBV20-1,TRBJ2-1,CSARDRSDGDNEQFF,4,0,1,4
TRBV29-1,TRBJ1-1,CSVAAPGGGVTEAFF,4,0,1,4
TRBV29-1,TRBJ2-1,CSVEDASGRVNEQFF,4,0,1,4
TRBV29-1,TRBJ1-4,CSVEDASSTNEKLFF,4,0,1,4
TRBV19,TRBJ2-7,RASSTAQGASGEQYF,4,0,1,4
TRBV30,TRBJ2-5,CAWRPPRGEETQYF,4,0,1,4
TRBV24-1,TRBJ2-2,CATASGTGLGELFF,4,0,1,4
TRBV24-1,TRBJ1-4,CATSESNSGEKLFF,4,0,1,4
TRBV19,TRBJ2-2,CASSPGVGTGELFF,4,0,1,4
TRBV19,TRBJ2-5,CASSIEASQETQYF,4,0,1,4
TRBV19,TRBJ2-5,CASSKLGQQETQYF,4,0,1,4
TRBV19,TRBJ2-7,CASKSQPATYEQYF,4,3,2,7
TRBV12-3/4,TRBJ2-7,CASSPGQGSYEQYF,4,0,1,4
TRBV11-1,TRBJ1-1,CASSRDRGNTEAFF,4,0,1,4
TRBV18,TRBJ2-1,CASSPGTGGNEQFF,4,0,1,4
TRBV18,TRBJ2-5,CASSRTTGSETQYF,4,8,2,12
TRBV2,TRBJ1-1,CASAIRLGNTEAFF,4,0,1,4
TRBV12-3/4,TRBJ1-1,CASTPANMNTEAYF,4,0,1,4
TRBV25-1,TRBJ2-3,CASTGRRFTDTQYF,4,0,1,4
TRBV6-2/3/5/6,TRBJ1-6,CASTPLQGNSPLHF,4,0,1,4
TRBV12-3/4,TRBJ2-1,CASSFERGYNEQFF,4,0,1,4
TRBV6-2/3/5/6,TRBJ2-7,CASSLSGQFYEQYF,4,0,1,4
TRBV6-2/3/5/6,TRBJ2-2,CASSLVAGVGELFF,4,0,1,4
TRBV12-3/4,TRBJ2-1,CASSLAPLYNEQFF,4,11,2,15
TRBV7-2,TRBJ2-3,CASSLAEGPDTQYF,4,0,1,4
TRBV6-2/3/5/6,TRBJ2-1,CASSSPDGYNEQFF,4,0,1,4
TRBV6-2/3/5/6,TRBJ2-7,CASSYSNGVYEQYF,4,0,1,4
TRBV6-2/3/5/6,TRBJ2-3,CASSYGGATDTQYF,4,0,1,4
TRBV6-2/3/5/6,TRBJ1-2,CASSYDRIPQQYTF,4,0,1,4
TRBV28,TRBJ1-1,CASSPGQGAWYAFS,4,0,1,4
TRBV28,TRBJ2-3,CASSRTSVADTQYF,4,0,1,4
TRBV2,TRBJ2-5,CASSGAGAQETQYF,4,0,1,4
TRBV7-9,TRBJ1-5,CASSGGQGSQPQHF,4,0,1,4
TRBV6-1,TRBJ2-2,CASSEGGGPGELFF,4,0,1,4
TRBV6-2/3/5/6,TRBJ2-1,CASSSGSSYNGQFF,4,0,1,4
TRBV27,TRBJ2-7,CASSKDRGSYEQYF,4,0,1,4
TRBV5-5,TRBJ1-5,CASSFRREGQPQHF,4,0,1,4
TRBV2,TRBJ2-5,CASSFRDRVVTQYF,4,0,1,4
TRBV7-8,TRBJ1-1,CASSFRGANTEAFF,4,0,1,4
TRBV7-6,TRBJ1-1,CASSFRDQNTEAFF,4,0,1,4
TRBV5-6,TRBJ2-1,CASSLVGRVNEQFF,4,0,1,4
TRBV5-5,TRBJ2-7,CASSLGAGGYEQYF,4,0,1,4
TRBV7-2,TRBJ2-7,CASSLSSNRDEQYF,4,0,1,4
TRBV7-9,TRBJ2-7,CASSLSGISYEQYF,4,4,2,8
TRBV7-2,TRBJ2-3,CASSLAGTTDTQYF,4,0,1,4
TRBV5-6,TRBJ2-3,CASSLASSTDTQYF,4,0,1,4
TRBV7-2,TRBJ1-1,CASSLGTGSTEAFF,4,0,1,4
TRBV7-6,TRBJ2-1,CASSLDVRYNEQFF,4,0,1,4
TRBV11-2,TRBJ1-1,CASSLETGNTEAFF,4,0,1,4
TRBV7-2,TRBJ1-1,CASSLRQGFTEAFF,4,0,1,4
TRBV7-9,TRBJ2-7,CASSSRGGSYEQYF,4,0,1,4
TRBV7-8,TRBJ2-5,CASSYTGNQETQYF,4,0,1,4
TRBV7-6,TRBJ2-1,CASSLFNRGNEQFF,4,0,1,4
TRBV5-6,TRBJ2-6,CASSLLSGANVLTF,4,0,1,4
TRBV6-2/3/5/6,TRBJ2-5,CASSLSWGQETQYF,4,0,1,4
TRBV7-3,TRBJ2-5,CASSLGTAQETQYF,4,0,1,4
TRBV9,TRBJ2-1,CASSPQGAPYLRFF,4,0,1,4
TRBV5-5,TRBJ2-7,CASSPTGGRYEQYF,4,0,1,4
TRBV3-1,TRBJ1-2,CASSPGTGNYGYTF,4,0,1,4
TRBV2,TRBJ2-3,CASSRDRGSDTQYF,4,0,1,4
TRBV3-1,TRBJ2-7,CASSHPRQSYEQYF,4,0,1,4
TRBV7-2,TRBJ2-2,CASSQIGDTGELFF,4,0,1,4
TRBV14,TRBJ2-3,CASSQDLSVYTQYF,4,0,1,4
TRBV4-2,TRBJ2-1,CASSQEFTHNEQFF,4,0,1,4
TRBV9,TRBJ1-6,CASSVTDGYSPLHF,4,0,1,4
TRBV9,TRBJ2-3,CASSVDPSTDTQYF,4,0,1,4
TRBV7-9,TRBJ2-5,CASSATGVWETQYF,4,0,1,4
TRBV7-3,TRBJ1-1,CASSDYPGRTEAFF,4,0,1,4
TRBV9,TRBJ2-7,CASSEDRYSYEQYF,4,0,1,4
TRBV7-3,TRBJ2-3,CASSEGGSTDTQYF,4,0,1,4
TRBV6-2/3/5/6,TRBJ1-1,CASSTTGGRTEAFF,4,0,1,4
TRBV7-9,TRBJ1-6,CASSSGAGNSPLHF,4,0,1,4
TRBV2,TRBJ2-2,CASRLAVNTGELFF,4,0,1,4
TRBV6-2/3/5/6,TRBJ2-7,CASRQDSISYEQYF,4,0,1,4
TRBV5-1,TRBJ2-1,CASSLRGPYNEQFF,4,4,2,8
TRBV5-1,TRBJ2-7,CASSFGEEGYEQYF,4,0,1,4
TRBV5-1,TRBJ1-4,CASSLSGLNEKLFF,4,0,1,4
TRBV5-1,TRBJ1-1,CASSLSAGNTEAFF,4,0,1,4
TRBV5-1,TRBJ2-3,CASSLATGTDTQYF,4,0,1,4
TRBV5-1,TRBJ2-1,CASSLAQRGNEQFF,4,0,1,4
TRBV5-1,TRBJ2-1,CASSLAGQHNEQFF,4,0,1,4
TRBV5-1,TRBJ2-5,CASSLGVAEETQYF,4,0,1,4
TRBV5-1,TRBJ1-4,CASSSDRGREKLFF,4,0,1,4
TRBV5-1,TRBJ1-1,CASSLGQVNTEAFF,4,0,1,4
TRBV4-1,TRBJ2-1,CASSRTMQGNEQFF,4,0,1,4
TRBV4-1,TRBJ1-1,CASSQGLVNTEAFF,4,0,1,4
TRBV5-1,TRBJ1-4,CASSGQGTNEKPFF,4,0,1,4
TRBV5-1,TRBJ2-7,CASRTGTSGYEQCS,4,0,1,4
TRBV4-1,TRBJ2-2,CASKAYRDTGELFF,4,0,1,4
TRBV29-1,TRBJ1-1,CTAWAGGSNTEAFF,4,0,1,4
TRBV20-1,TRBJ2-3,CSAPGPGDTDTQYF,4,0,1,4
TRBV20-1,TRBJ2-2,CSASPRALKGELFF,4,0,1,4
TRBV20-1,TRBJ1-4,CSARVNREGGKLFF,4,0,1,4
TRBV20-1,TRBJ1-5,CSARVGGSNQPQHF,4,0,1,4
TRBV20-1,TRBJ2-5,CSARAGDRKETQYF,4,4,2,8
TRBV20-1,TRBJ2-7,CSARDSGTLYEQYF,4,0,1,4
TRBV20-1,TRBJ2-1,CSARELAGHNEQFF,4,0,1,4
TRBV29-1,TRBJ2-1,CSVLKGAVYSEQFF,4,0,1,4
TRBV29-1,TRBJ2-7,CSVWTSGSKYEQYF,4,0,1,4
TRBV29-1,TRBJ2-2,CSVVSRANTGELFF,4,0,1,4
TRBV29-1,TRBJ2-1,CSVVKSRGGNEQFF,4,0,1,4
TRBV29-1,TRBJ2-3,CSVVPRSGTDTQYF,4,0,1,4
TRBV29-1,TRBJ2-3,CSVVLFTSTDTQYF,4,0,1,4
TRBV29-1,TRBJ1-1,CSVAPPYATTEAFF,4,0,1,4
TRBV29-1,TRBJ1-4,CSVEVGQLGEKLFF,4,0,1,4
TRBV29-1,TRBJ2-1,CSVEPGQGYNEQFF,4,0,1,4
TRBV29-1,TRBJ2-3,CSALGQGRTDTQYF,4,0,1,4
TRBV29-1,TRBJ2-5,CSAPTSGGGETQYF,4,0,1,4
TRBV12-5,TRBJ1-1,CASGLGTNTEAFF,4,0,1,4
TRBV30,TRBJ1-1,CAWSRSMNTEAFF,4,0,1,4
TRBV30,TRBJ1-5,CAWSVSSNQPQHF,4,0,1,4
TRBV30,TRBJ1-5,CAWSDMGNQPQHF,4,0,1,4
TRBV30,TRBJ2-1,CAWSRDHYNEQFF,4,3,2,7
TRBV27,TRBJ2-7,CAGSHGPTYEQYF,4,0,1,4
TRBV10-3,TRBJ2-3,CAIDRVEKDTQYF,4,0,1,4
TRBV10-3,TRBJ1-2,CAISKDRDYGYTF,4,0,1,4
TRBV19,TRBJ2-5,CASSMGEEETQYF,4,0,1,4
TRBV19,TRBJ1-1,CASSISQGNEAFF,4,0,1,4
TRBV19,TRBJ2-3,CASSIQSTDTQYF,4,0,1,4
TRBV19,TRBJ2-3,CASSPGGADTQYF,4,0,1,4
TRBV19,TRBJ1-1,CASSIVEGTEAFF,4,0,1,4
TRBV19,TRBJ2-7,CASRDSGRSEQYF,4,0,1,4
TRBV18,TRBJ1-6,CASSPGPTSPLHF,4,0,1,4
TRBV18,TRBJ2-3,CASSPGDVRPQYF,4,0,1,4
TRBV18,TRBJ1-1,CASSPSGGGGAFF,4,7,2,11
TRBV12-3/4,TRBJ1-5,CASYGAVGQPQHF,4,0,1,4
TRBV7-9,TRBJ1-4,CASGPRAGEKLFF,4,0,1,4
TRBV6-2/3/5/6,TRBJ2-5,CASSLDRQETQYF,4,0,1,4
TRBV6-2/3/5/6,TRBJ2-1,CASSLSVGEGQFF,4,0,1,4
TRBV7-2,TRBJ2-3,CASSSWSTDTQYF,4,0,1,4
TRBV6-2/3/5/6,TRBJ2-1,CASSYLGRKEQFF,4,0,1,4
TRBV6-2/3/5/6,TRBJ2-5,CASSYPFGETQYF,4,0,1,4
TRBV2,TRBJ2-7,CASSVGRDYEQYF,4,0,1,4
TRBV2,TRBJ2-4,CASSGLAKNIQYF,4,0,1,4
TRBV5-6,TRBJ2-5,CASSFDRAETQYF,4,0,1,4
TRBV11-3,TRBJ2-2,CASSFSGTGELFF,4,0,1,4
TRBV5-6,TRBJ2-1,CASSLPGVWEQFF,4,0,1,4
TRBV5-5,TRBJ1-2,CASSLAGLYGYTF,4,0,1,4
TRBV7-2,TRBJ2-4,CASSLGRGDIQYF,4,0,1,4
TRBV11-2,TRBJ1-1,CASSLPGGRAAFF,4,0,1,4
TRBV7-2,TRBJ2-3,CASSLPESDTQYF,4,0,1,4
TRBV5-4,TRBJ1-1,CASSLQGGTEAFF,4,0,1,4
TRBV11-2,TRBJ1-1,CASSLAPSGEAFF,4,0,1,4
TRBV7-9,TRBJ1-1,CASSLAAGTEAFF,4,6,2,10
TRBV7-9,TRBJ2-7,CASSLDRSYEQYF,4,0,1,4
TRBV7-2,TRBJ2-1,CASSLRVLNEQFF,4,0,1,4
TRBV7-9,TRBJ1-1,CASSSQDNTEAFF,4,0,1,4
TRBV5-5,TRBJ2-3,CASSSGHTDTQYF,4,0,1,4
TRBV7-9,TRBJ1-1,CASSSDGNTEAFF,4,0,1,4
TRBV11-2,TRBJ2-1,CASSSGGEDEQFF,4,0,1,4
TRBV7-6,TRBJ2-5,CASSWGAGETQYF,4,0,1,4
TRBV5-8,TRBJ1-4,CASSWGSREKLFF,4,0,1,4
TRBV7-9,TRBJ2-1,CASSWGGTDEQFF,4,0,1,4
TRBV11-2,TRBJ2-1,CASSPGLYNEQLF,4,0,1,4
TRBV7-9,TRBJ2-7,CASSPTGSYEQYF,4,0,1,4
TRBV11-2,TRBJ2-5,CASSPDREETQYF,4,0,1,4
TRBV12-3/4,TRBJ2-7,CASSRIGGHEQYF,4,0,1,4
TRBV11-1,TRBJ2-7,CASSRDRGSEQYF,4,0,1,4
TRBV7-9,TRBJ1-1,CASSRTGVTEAFF,4,0,1,4
TRBV14,TRBJ2-1,CASSQLLAYEQFF,4,0,1,4
TRBV4-2,TRBJ2-5,CASSQDPGGTQYF,4,0,1,4
TRBV4-2,TRBJ1-2,CASSQDMARDYTF,4,0,1,4
TRBV9,TRBJ2-2,CASSVISTGELFF,4,0,1,4
TRBV6-2/3/5/6,TRBJ2-5,CASSSRGWGTQYF,4,0,1,4
TRBV12-3/4,TRBJ1-1,CASRLGIFTEAFF,4,0,1,4
TRBV12-3/4,TRBJ1-1,CASRAAQGGEAFF,4,0,1,4
TRBV2,TRBJ2-2,CASRAGATGELFF,4,0,1,4
TRBV28,TRBJ2-1,CASRLLAGNEQFF,4,0,1,4
TRBV7-9,TRBJ1-1,CASRQRQNTEAFF,4,0,1,4
TRBV6-1,TRBJ2-3,CASREGGTDTQYF,4,0,1,4
TRBV6-2/3/5/6,TRBJ1-1,CASKGTGSAEAFF,4,0,1,4
TRBV28,TRBJ2-5,CASKSGRPETQYF,4,0,1,4
TRBV14,TRBJ1-2,CASSQGGPGGYTF,4,0,1,4
TRBV19,TRBJ2-5,CAEDRGPQETQYF,4,0,1,4
TRBV5-1,TRBJ2-6,CASSLDTVNVLTF,4,0,1,4
TRBV10-2,TRBJ1-2,CASSESTREGYTF,4,0,1,4
TRBV5-1,TRBJ1-4,CASSIGTGEKLFF,4,0,1,4
TRBV5-1,TRBJ2-1,CASSLEPGFEQFF,4,0,1,4
TRBV5-1,TRBJ2-4,CASSPEPSGIQYF,4,0,1,4
TRBV4-3,TRBJ2-1,CASSQGGTGPISF,4,0,1,4
TRBV20-1,TRBJ1-1,CSVTRGVDTEAFF,4,0,1,4
TRBV20-1,TRBJ2-5,CSATDWEVETQYF,4,0,1,4
TRBV20-1,TRBJ1-5,CSARPGGKQPQHF,4,0,1,4
TRBV29-1,TRBJ2-1,CSPYRTGENEQFF,4,0,1,4
TRBV29-1,TRBJ2-6,CSVRDSGANVLTF,4,0,1,4
TRBV29-1,TRBJ1-5,CSVAQGRDQPQHF,4,0,1,4
TRBV29-1,TRBJ2-1,CSVAGGRGGEQFF,4,0,1,4
TRBV29-1,TRBJ2-6,CSVGGTGANVLTF,4,0,1,4
TRBV29-1,TRBJ2-1,CSVGGTEYNEQFF,4,0,1,4
TRBV29-1,TRBJ1-1,CSVEEGADTEAFF,4,0,1,4
TRBV29-1,TRBJ1-5,CSVELRPDQPQHF,4,0,1,4
TRBV29-1,TRBJ2-1,CSVRPISNNEQFF,4,0,1,4
TRBV29-1,TRBJ1-2,CSVRQGGYYGYTF,4,0,1,4
TRBV29-1,TRBJ2-2,CSVQDRGLGELFF,4,0,1,4
TRBV29-1,TRBJ1-3,CSALGLRRNTIYF,4,0,1,4
TRBV30,TRBJ1-1,CAWSPGGVEAFF,4,0,1,4
TRBV30,TRBJ1-1,CAWSGGHTEAFF,4,0,1,4
TRBV30,TRBJ1-2,CARVAGRYGYTF,4,0,1,4
TRBV7-2,TRBJ2-6,CAGTSGASVLTF,4,0,1,4
TRBV10-3,TRBJ1-2,CAISGDRRGYTF,4,0,1,4
TRBV24-1,TRBJ1-5,CATGTANQPQHF,4,0,1,4
TRBV15,TRBJ1-2,CATSRDQQASLF,4,0,1,4
TRBV24-1,TRBJ2-1,CATNDRYNEQFF,4,0,1,4
TRBV19,TRBJ1-6,CASSTTGRSLHF,4,0,1,4
TRBV19,TRBJ1-1,CASSKLNTEAFF,4,0,1,4
TRBV18,TRBJ2-5,CASSPPGETQYF,4,0,1,4
TRBV2,TRBJ1-2,CASIQGWGGYTF,4,0,1,4
TRBV2,TRBJ1-2,CASTLGTGKEAF,4,0,1,4
TRBV6-2/3/5/6,TRBJ1-1,CASSLLAAEAFL,4,0,1,4
TRBV12-3/4,TRBJ2-1,CASSSPPLEQFF,4,0,1,4
TRBV6-2/3/5/6,TRBJ2-1,CASSSQGDEQFF,4,0,1,4
TRBV6-2/3/5/6,TRBJ2-1,CASSYEGYEQFF,4,0,1,4
TRBV5-6,TRBJ2-3,CASSSSTDTQYF,4,0,1,4
TRBV6-2/3/5/6,TRBJ1-1,CASSPGNTEAFF,4,0,1,4
TRBV3-1,TRBJ1-2,CASSQGLYGYTF,4,0,1,4
TRBV30,TRBJ2-6,CARQVGANVLTF,4,0,1,4
TRBV5-1,TRBJ1-2,CASSFGRDGYTF,4,0,1,4
TRBV5-1,TRBJ2-7,CASSVGSYEQYF,4,0,1,4
TRBV20-1,TRBJ1-1,CSSGGRNTEAFF,4,0,1,4
TRBV20-1,TRBJ2-7,CSASNRVNEQYF,4,0,1,4
TRBV20-1,TRBJ2-1,CSARDSADEQFF,4,0,1,4
TRBV20-1,TRBJ1-1,CSGRTGYTEAFF,4,0,1,4
TRBV29-1,TRBJ2-5,CSVQRGGETQYF,4,0,1,4
TRBV29-1,TRBJ1-2,CSVAQEYYGYTF,4,0,1,4
TRBV29-1,TRBJ2-7,CSVGDGSYEQYF,4,0,1,4
TRBV29-1,TRBJ2-7,CSVGTVFYEQYF,4,0,1,4
TRBV10-3,TRBJ2-3,CAINAADTQYF,4,0,1,4
TRBV28,TRBJ2-5,CASSLGGTQYF,4,0,1,4
TRBV3-1,TRBJ2-3,CASSLENTQYF,4,0,1,4
TRBV5-6,TRBJ2-1,CASSLGREQFF,4,0,1,4
TRBV4-3,TRBJ1-4,CASRDSEKLFF,4,0,1,4
TRBV29-1,TRBJ1-2,CSVQGAGGYTF,4,0,1,4
TRBV29-1,TRBJ2-7,CSVPGDYEQYF,4,0,1,4
TRBV4-3,TRBJ2-7,CASSQYEQYF,4,0,1,4
TRBV29-1,TRBJ1-2,CGTTNYGYTF,4,0,1,4
TRBV20-1,TRBJ2-7,CSAASYEQYF,4,0,1,4
TRBV20-1,TRBJ2-7,CSARRDEQYF,4,0,1,4
TRBV29-1,TRBJ1-1,CSVGNTEAFF,4,0,1,4
TRBV29-1,TRBJ1-1,CSGENTEAFF,4,0,1,4
TRBV3-1,TRBJ2-1,CASSPSGPIGNEQFF,4,0,1,4
TRBV5-1,TRBJ2-2,CASKGALTGELFF,4,0,1,4
TRBV9,TRBJ2-3,CASSATDTQYF,4,0,1,4
TRBV30,TRBJ2-2,CAWDPVGNTGELFF,4,0,1,4
TRBV11-3,TRBJ2-3,CASREGRDTQYL,4,0,1,4
TRBV30,TRBJ2-5,CAGFARDRGRRVAKETQYF,4,0,1,4
TRBV28,TRBJ1-1,CASSLPSGRANTEAFF,4,0,1,4
TRBV7-9,TRBJ1-4,CASSSNQGAPNEKLFL,4,0,1,4
TRBV11-2,TRBJ2-6,CASSLERGANVLTF,4,0,1,4
TRBV10-3,TRBJ1-4,CAIRQGGDEKLFF,4,0,1,4
TRBV5-6,TRBJ2-1,CASSFWAYNEPFF,4,0,1,4
TRBV7-8,TRBJ1-5,CASSLYGEQPQHF,4,0,1,4
TRBV7-3,TRBJ1-5,CASSSDRYQPQHF,4,0,1,4
TRBV29-1,TRBJ2-4,CSGIQGKDIQYF,4,0,1,4
TRBV14,TRBJ2-3,CASSQLSGRVADTQYF,4,0,1,4
TRBV14,TRBJ1-1,CASSQFQGENTVAFF,4,0,1,4
TRBV30,TRBJ2-3,CAWSQTGGTDTQYF,4,0,1,4
TRBV6-2/3/5/6,TRBJ2-7,CASTALGASYEQYF,4,0,1,4
TRBV4-2,TRBJ1-5,CASSQDGIGQPQHF,4,0,1,4
TRBV7-2,TRBJ2-4,CASSRSLNDIQYF,7,0,1,7
TRBV7-9,TRBJ2-2,CASTGETGELFF,4,0,1,4
TRBV3-1,TRBJ2-4,CASSNLGGLYF,4,0,1,4
TRBV25-1,TRBJ2-6,CASSEYRTGYIDGPGANVLTF,3,0,1,3
TRBV14,TRBJ2-1,CASSRRTPSGKGGFLYEQFF,3,0,1,3
TRBV30,TRBJ2-7,CAWSVQRANRDRSSYEQYF,3,0,1,3
TRBV7-6,TRBJ2-3,CASSLAPAGAKSSTDTQYF,3,0,1,3
TRBV4-2,TRBJ1-1,CASSQDPDPRVFAGPEAFF,3,0,1,3
TRBV3-1,TRBJ2-4,CASSQDTIGTSGFENIQYF,3,0,1,3
TRBV4-3,TRBJ2-6,CASSQKPGQGMFGANVLTF,3,0,1,3
TRBV15,TRBJ2-6,CATSRDDRGLPGANVLTF,3,0,1,3
TRBV19,TRBJ2-1,CASSDPRGTSGSYNEQFF,3,0,1,3
TRBV4-2,TRBJ2-3,CASSHRTNYGGDADTQYF,3,0,1,3
TRBV2,TRBJ2-7,CASSVALRLAGGAYEQYF,3,0,1,3
TRBV7-7,TRBJ2-2,CASSSERVGGGFTGELFF,3,0,1,3
TRBV7-2,TRBJ2-7,CASSLRDSQNRGSYEQYF,3,0,1,3
TRBV5-4,TRBJ2-6,CASSPRGAGNSGANVLTF,3,0,1,3
TRBV7-2,TRBJ1-6,CASSRKGQSQAFNSPLHF,3,0,1,3
TRBV9,TRBJ2-1,CASSVETDYLSSYNEQFF,3,0,1,3
TRBV7-9,TRBJ2-3,CASRPQGLRGFGTDTQYF,3,0,1,3
TRBV29-1,TRBJ2-6,CSVAERYRGLAGANVLTF,6,41,2,47
TRBV18,TRBJ2-3,CASSPPNRGLSTDTQYF,3,0,1,3
TRBV18,TRBJ2-7,CASSPRVWRGASYEQYF,3,0,1,3
TRBV18,TRBJ1-4,CASSRRQFSATNEKLFF,3,0,1,3
TRBV12-3/4,TRBJ2-3,CASSFGSWLAATDTQYF,3,0,1,3
TRBV28,TRBJ2-1,CASSFGQSPYPYNEQFF,3,0,1,3
TRBV6-2/3/5/6,TRBJ2-1,CASSYLTGSWQNNEQLF,3,0,1,3
TRBV12-3/4,TRBJ2-1,CASSPVGLAGGINEQFF,3,0,1,3
TRBV7-3,TRBJ2-2,CASSFASGREDTGELFF,3,0,1,3
TRBV5-6,TRBJ1-1,CASSLSEEGAKNTEAFF,3,0,1,3
TRBV7-9,TRBJ1-1,CASSLRGDRGLGTEAFF,3,0,1,3
TRBV11-3,TRBJ2-7,CASSLFGGARASYEQYF,3,0,1,3
TRBV11-1,TRBJ1-2,CASSLGQGALAKKSYTF,3,0,1,3
TRBV7-9,TRBJ2-7,CASSLGGTSGSVDEQYF,3,0,1,3
TRBV11-2,TRBJ1-3,CASSLRFQGSSGNTIYF,3,0,1,3
TRBV7-9,TRBJ2-3,CASSSPLLAQLRDTQYF,3,0,1,3
TRBV4-2,TRBJ2-1,CASSLDGLAGGPNEQFF,3,0,1,3
TRBV7-3,TRBJ2-1,CASSPRTGPGSYNEQFF,3,0,1,3
TRBV7-2,TRBJ2-4,CASSRGTSSLAKNIQYF,3,0,1,3
TRBV3-1,TRBJ2-1,CASSQASRGTTDDEQFF,3,0,1,3
TRBV3-1,TRBJ2-3,CASSQGTSRQSTDTQYF,3,0,1,3
TRBV3-1,TRBJ1-3,CASSQGGTALSGNTIYF,3,0,1,3
TRBV4-2,TRBJ2-2,CASSQETSGRAAGELFS,3,0,1,3
TRBV14,TRBJ1-1,CASSTAGQGVVSTEAFF,3,0,1,3
TRBV2,TRBJ2-1,CASRPIPGLAVYNEQFF,3,0,1,3
TRBV6-2/3/5/6,TRBJ2-1,CASNPGLAGVHSNEQFF,3,0,1,3
TRBV7-9,TRBJ2-6,CANSPRQRNSGANVLTF,3,0,1,3
TRBV5-1,TRBJ2-1,CASSLVGGGNSYNEQFF,3,0,1,3
TRBV5-1,TRBJ1-5,CASSLAPTGSLDQPQHF,3,0,1,3
TRBV4-1,TRBJ2-2,CASSPFSTGGNTGELFF,3,0,1,3
TRBV4-3,TRBJ1-1,CASSQAIGTGANTEAFF,3,0,1,3
TRBV20-1,TRBJ1-4,CSARERSGCIENEKLFF,3,0,1,3
TRBV20-1,TRBJ2-6,YSALRDRGYTGANVLTF,3,0,1,3
TRBV20-1,TRBJ2-1,RSAVTSGGPLSYNEQFF,3,0,1,3
TRBV12-5,TRBJ2-4,CASGLVLGVGKNIQYF,3,0,1,3
TRBV14,TRBJ2-2,CAGSPKLGVNTGEPFF,3,0,1,3
TRBV24-1,TRBJ2-5,CATSDFGLAEEETQYF,3,0,1,3
TRBV18,TRBJ2-1,CASSPIAGVRANEQFF,3,0,1,3
TRBV6-2/3/5/6,TRBJ1-6,CASSLDNSVPNSPLHF,3,0,1,3
TRBV6-2/3/5/6,TRBJ2-7,CASSSSGTGSSYEQYF,3,0,1,3
TRBV6-2/3/5/6,TRBJ2-3,CASSSGTSRIGDTQYF,3,0,1,3
TRBV6-2/3/5/6,TRBJ2-4,CASSYVGPMTKNIQYF,3,0,1,3
TRBV27,TRBJ1-5,CASSPFGQGIGQPQHF,3,0,1,3
TRBV6-2/3/5/6,TRBJ2-7,CASSPPVIRATYEQYF,3,0,1,3
TRBV25-1,TRBJ1-1,CASSAGTGQFDTEAFF,3,0,1,3
TRBV25-1,TRBJ2-3,CASSDRGKTGTDTQYF,3,0,1,3
TRBV6-2/3/5/6,TRBJ2-5,CASSTPYGQGKETQYF,3,0,1,3
TRBV5-6,TRBJ2-7,CASSFSRTTRGYEQYF,3,0,1,3
TRBV5-4,TRBJ2-2,CASSFEAGGSTGELFF,3,0,1,3
TRBV7-2,TRBJ2-1,CASSLGRAGENNEQFF,3,0,1,3
TRBV5-5,TRBJ2-7,CASSLELRTGAYEQYF,3,0,1,3
TRBV7-9,TRBJ2-7,CASSLRSGGASYEQYF,3,0,1,3
TRBV7-8,TRBJ2-5,CASSLVRLALQETQYF,3,0,1,3
TRBV7-2,TRBJ2-5,CASSLGTAPEQETQYF,3,0,1,3
TRBV5-4,TRBJ2-1,CASSSGLPHGGNEQFF,3,0,1,3
TRBV5-6,TRBJ2-1,CASSSSGTSGYNEQFF,3,0,1,3
TRBV7-2,TRBJ2-5,CASSSSLAGGQETQYF,3,0,1,3
TRBV7-2,TRBJ1-6,CASSWGTGEEGSPLHF,3,0,1,3
TRBV2,TRBJ2-4,CASSWGPTVAKNIQYF,3,0,1,3
TRBV13,TRBJ2-7,CASSLSRDVPPYEQYF,3,0,1,3
TRBV4-2,TRBJ1-1,CASSLKFRQGNTEAFF,3,0,1,3
TRBV5-6,TRBJ1-2,CASSPEYRTGRYGYTF,3,0,1,3
TRBV9,TRBJ1-2,CASSPRQGQGGYGYTF,3,0,1,3
TRBV11-2,TRBJ2-1,CASSPRSDRTYNEQFF,3,0,1,3
TRBV6-2/3/5/6,TRBJ1-5,CASSPMRAYSNQPQHF,3,0,1,3
TRBV7-2,TRBJ1-2,CASSPQPGQGIEGYTF,3,0,1,3
TRBV11-3,TRBJ2-1,CASSPAGYSSYNEQFF,3,0,1,3
TRBV3-1,TRBJ2-1,CASSQLSGAIHNEQFF,3,0,1,3
TRBV7-3,TRBJ2-7,CASSQPLGQDSYEQYF,3,0,1,3
TRBV6-2/3/5/6,TRBJ2-1,CASSQVLGLVLNEQFF,3,0,1,3
TRBV4-2,TRBJ2-3,CASSQDIAAGADTQYF,3,0,1,3
TRBV4-2,TRBJ2-7,CASSQDLTSGSSEQYF,3,0,1,3
TRBV7-6,TRBJ1-1,CASSTKTREENTEAFF,3,0,1,3
TRBV7-2,TRBJ2-7,CASSTYGLQALGEQYF,3,0,1,3
TRBV7-9,TRBJ1-4,CASSTRQATTNEKLFF,3,0,1,3
TRBV28,TRBJ2-7,CASNSAVTATSYEQYF,3,0,1,3
TRBV7-9,TRBJ2-2,CASKRTGGLNTGELFF,3,0,1,3
TRBV6-4,TRBJ2-4,CANTVQGDRAKNIQYF,3,0,1,3
TRBV3-1,TRBJ2-6,CGSSQVVMAGANVLTF,3,0,1,3
TRBV5-1,TRBJ2-4,CASSSGQGIAKNIQYF,3,0,1,3
TRBV5-1,TRBJ2-2,CASSLVGTRRAGELFF,3,0,1,3
TRBV5-1,TRBJ2-1,CASSLTSGYAVNEQFF,3,0,1,3
TRBV4-1,TRBJ1-4,CASSSGVGQDNEKLSF,3,0,1,3
TRBV5-1,TRBJ2-1,CASSLVGGGPSGEQFF,3,0,1,3
TRBV5-1,TRBJ2-3,CASSPVGTGDTDTQYF,3,0,1,3
TRBV5-1,TRBJ1-5,CASSPGPWKSNQPQHF,3,0,1,3
TRBV5-1,TRBJ2-2,CASSPDRGLDTGELFF,3,0,1,3
TRBV4-1,TRBJ1-1,CASSPPDRALNTEAFF,3,0,1,3
TRBV4-1,TRBJ2-3,CASSHGSGGAIDTQYF,3,0,1,3
TRBV4-1,TRBJ1-2,CASSHLERGQAGGYTF,3,0,1,3
TRBV5-1,TRBJ2-7,CASSQSPGQGAYEQYF,3,0,1,3
TRBV4-1,TRBJ2-6,CASSQAEEPGANVLTF,3,0,1,3
TRBV4-3,TRBJ2-7,CASSQDYELAVYEQYF,3,0,1,3
TRBV4-3,TRBJ1-2,CASSQDHGREGYGYTF,3,0,1,3
TRBV4-3,TRBJ2-2,CASSQDRDYYTGELFF,3,0,1,3
TRBV20-1,TRBJ2-1,CSAPAMDRGDHNEQFF,3,0,1,3
TRBV20-1,TRBJ1-6,CSASSDGGAVNSPLHF,3,5,2,8
TRBV29-1,TRBJ2-3,CSVEPRTSGGTDTQYF,3,0,1,3
TRBV29-1,TRBJ2-1,CSVEGMSTLSNNEQFF,3,0,1,3
TRBV29-1,TRBJ2-3,CSVEKRRLATTDTQYF,3,0,1,3
TRBV29-1,TRBJ1-6,CSAALRDNPRNSPLHF,3,0,1,3
TRBV12-5,TRBJ2-1,CASGPELSSYNEQFF,3,0,1,3
TRBV30,TRBJ2-1,CAWSVPYQAYKEQFF,3,0,1,3
TRBV30,TRBJ1-1,CAWSVMGEANTEAFF,3,0,1,3
TRBV10-3,TRBJ2-7,CAIIKAGQGSYEQYF,3,0,1,3
TRBV10-3,TRBJ2-3,CAISGEDPSTDTQYF,3,0,1,3
TRBV5-4,TRBJ2-1,CATRVGANPYNEQFF,3,0,1,3
TRBV24-1,TRBJ2-3,CATSDLADSTDTQYF,3,0,1,3
TRBV24-1,TRBJ2-4,CATSEGTGKKNIQYF,3,0,1,3
TRBV15,TRBJ2-7,CATSRGQGLIYEQYF,3,0,1,3
TRBV19,TRBJ2-7,CASSVLTGGAYEQYF,3,0,1,3
TRBV19,TRBJ2-3,CASRSSSGGTDTQYF,3,0,1,3
TRBV19,TRBJ2-3,CASSPHQTSTDTQYF,3,0,1,3
TRBV18,TRBJ1-1,CASSPQGAPNTEAFF,3,0,1,3
TRBV18,TRBJ1-1,CASSPPMRANTEAFF,3,0,1,3
TRBV18,TRBJ1-5,CASSDQGASNQPQHF,3,0,1,3
TRBV18,TRBJ2-7,CASSNGGIGTYEQYF,3,0,1,3
TRBV28,TRBJ2-7,CASGDPANTAYEQYF,3,0,1,3
TRBV12-3/4,TRBJ2-2,CASMGGGLGPWELFF,3,0,1,3
TRBV28,TRBJ1-5,CASIWGAEGNQPQHF,3,0,1,3
TRBV6-2/3/5/6,TRBJ2-2,CASSFRQGGTGELFF,3,0,1,3
TRBV7-2,TRBJ1-1,CASSFLPQGGTEAFF,3,0,1,3
TRBV28,TRBJ2-7,CASSFPGTGIYEQYF,3,0,1,3
TRBV6-2/3/5/6,TRBJ1-1,CASSFEGLRGTEAFF,3,0,1,3
TRBV27,TRBJ1-6,CASSLGTVYNSPLHF,3,0,1,3
TRBV6-2/3/5/6,TRBJ2-7,CASSLGQGAGNEQYF,3,0,1,3
TRBV6-1,TRBJ1-5,CASSSSGGGGQPQHF,3,0,1,3
TRBV6-2/3/5/6,TRBJ2-7,CASSSPRSGGLEQYF,3,0,1,3
TRBV6-2/3/5/6,TRBJ1-1,CASSYSFEVNTEAFF,3,0,1,3
TRBV12-3/4,TRBJ1-5,CASSPRGIGNQPQHF,3,0,1,3
TRBV6-4,TRBJ2-1,CASSARQGFYNEQFF,3,0,1,3
TRBV2,TRBJ1-5,CASSELGGRNQPQHF,3,0,1,3
TRBV2,TRBJ2-2,CASSEIPSGAGELFF,3,0,1,3
TRBV6-2/3/5/6,TRBJ2-5,CASSTTGTLRETQYF,3,0,1,3
TRBV5-6,TRBJ2-7,CASSFYSGTTYEQYF,3,0,1,3
TRBV5-6,TRBJ1-2,CASSFRTKGDYGYTF,3,0,1,3
TRBV11-2,TRBJ2-2,CASSFRTGRTGELFF,3,0,1,3
TRBV7-9,TRBJ1-6,CASSLAGARGSPLHF,3,0,1,3
TRBV5-6,TRBJ1-1,CASSLGQGWNTEAFF,3,0,1,3
TRBV7-2,TRBJ2-7,CASSLRQGGSYEQYF,3,0,1,3
TRBV7-9,TRBJ2-5,CASSLLAGAGETQYF,3,0,1,3
TRBV13,TRBJ2-1,CASSLRGGGDNEQFF,3,0,1,3
TRBV7-9,TRBJ2-1,CASSLAGYQGNEQFF,3,0,1,3
TRBV7-2,TRBJ2-1,CASSLAGGHYNEQFF,3,0,1,3
TRBV7-6,TRBJ2-1,CASSLGQGSYNEQFF,3,0,1,3
TRBV7-9,TRBJ1-2,CASSLDRGTNYGYTF,3,0,1,3
TRBV5-4,TRBJ2-5,CASSLTAQEKETQYF,3,0,1,3
TRBV7-2,TRBJ1-5,CASSLTGNSNQPQHF,3,0,1,3
TRBV11-2,TRBJ1-1,CASSLRQIGQAEAFF,3,0,1,3
TRBV11-3,TRBJ2-1,CASSSRGAGANEQFS,3,0,1,3
TRBV7-3,TRBJ2-5,CASSSTGAGGETQYF,3,0,1,3
TRBV7-9,TRBJ2-3,CASSLDGGFTDTQYF,3,0,1,3
TRBV7-9,TRBJ2-7,CASSPTETARPEQYF,3,0,1,3
TRBV4-2,TRBJ2-7,CASSPGLASAYEQYF,3,0,1,3
TRBV7-2,TRBJ2-2,CASSPRTGGTGELFF,3,0,1,3
TRBV5-4,TRBJ1-5,CASSPDRGVNQPQHF,3,0,1,3
TRBV6-2/3/5/6,TRBJ2-3,CASSPAGQFTDTQYF,3,0,1,3
TRBV14,TRBJ2-2,CASSHGDSGPGELFF,3,0,1,3
TRBV3-1,TRBJ2-7,CASSQDSSGTGEQYF,3,0,1,3
TRBV14,TRBJ2-1,CASSQDGRFTSGEFF,3,0,1,3
TRBV9,TRBJ2-7,CASSQKGGIPYEQYF,3,0,1,3
TRBV6-2/3/5/6,TRBJ2-6,CASSQQHSGANVLTF,3,0,1,3
TRBV4-2,TRBJ2-1,CASSQAPRAYNEQFF,3,0,1,3
TRBV3-1,TRBJ2-5,CASSQATRPRETQYF,3,0,1,3
TRBV4-2,TRBJ2-7,CASSQDHAETYEQYF,3,0,1,3
TRBV3-1,TRBJ1-6,CASSQEGQRNSPLHF,3,0,1,3
TRBV4-2,TRBJ2-3,CASSQEGDLADTQYF,3,0,1,3
TRBV9,TRBJ2-1,CASSVSDDSYNEQFF,3,0,1,3
TRBV9,TRBJ2-7,CASSVGRQPTYEQYF,3,0,1,3
TRBV5-4,TRBJ2-7,CASSVVGGARREQYF,3,0,1,3
TRBV9,TRBJ1-1,CASSVAAGGAAEAFF,3,0,1,3
TRBV9,TRBJ1-6,CASSVGDDDNSPLHF,3,0,1,3
TRBV9,TRBJ2-5,CASSVDAGPQETQYY,3,0,1,3
TRBV7-9,TRBJ2-5,CASSGTSGGQETQYF,3,0,1,3
TRBV12-3/4,TRBJ1-2,CASSETGTSNYGYTF,3,0,1,3
TRBV7-2,TRBJ1-2,CASSTRVVRGHGYTF,3,0,1,3
TRBV7-8,TRBJ1-4,CASSRTGVGNEKQFF,3,0,1,3
TRBV7-9,TRBJ2-1,CASRFRGGSYNEQFF,3,0,1,3
TRBV12-3/4,TRBJ2-6,CASRGQGSGANVLTF,3,0,1,3
TRBV7-2,TRBJ2-2,CASNLTGPNTGELFF,3,0,1,3
TRBV6-2/3/5/6,TRBJ1-2,CASNLQTDLGYGYTF,3,0,1,3
TRBV5-4,TRBJ2-7,CASNQGLAGAGEQYF,3,0,1,3
TRBV5-1,TRBJ2-1,CASGLGGALYNEQFF,3,0,1,3
TRBV5-1,TRBJ1-1,CASSFRERANTEAFF,3,0,1,3
TRBV5-1,TRBJ2-3,CASSFQPTSTDTQYF,3,0,1,3
TRBV5-1,TRBJ2-7,CASSLAGTDAYEQYF,3,0,1,3
TRBV5-1,TRBJ2-1,CASSLIETGGGEQFF,3,0,1,3
TRBV5-1,TRBJ2-1,CASSLNGNNYNEQFF,3,0,1,3
TRBV5-1,TRBJ2-1,CASSLGTSGGPRQFF,3,0,1,3
TRBV5-1,TRBJ1-6,CASSSWTEYNSPLHF,3,0,1,3
TRBV4-3,TRBJ1-3,CASSLARGLGNTIYF,3,0,1,3
TRBV5-1,TRBJ1-1,CASSLDYRESTEAFF,3,0,1,3
TRBV5-1,TRBJ2-7,CASSLEGLALYEQYF,3,0,1,3
TRBV5-1,TRBJ2-1,CASSPPRGGAYEQFF,3,0,1,3
TRBV4-1,TRBJ1-4,CASSPRGPTNEKLFF,3,0,1,3
TRBV4-3,TRBJ2-7,CASSPGLAAPYEQYF,3,0,1,3
TRBV5-1,TRBJ2-3,CASSPDKRAVDTQYF,3,0,1,3
TRBV5-1,TRBJ2-3,CASSPTSGGTDTQYF,3,8,2,11
TRBV4-1,TRBJ1-4,CASSQSEDSNEKLFF,3,2,2,5
TRBV4-3,TRBJ2-5,CASSQAAQGRETQYF,3,2,2,5
TRBV4-1,TRBJ1-2,CASSQDRRGNYGYTF,3,0,1,3
TRBV4-3,TRBJ1-1,CASSQDKVSNTEAFF,3,0,1,3
TRBV4-3,TRBJ2-1,CASSQEASPYNEQFF,3,0,1,3
TRBV5-1,TRBJ2-7,CASSVGQGLTYEQYF,3,0,1,3
TRBV5-1,TRBJ2-1,CASSALARTVAEQFF,3,0,1,3
TRBV5-1,TRBJ1-1,CASSKAGNMNTGAFF,3,0,1,3
TRBV2,TRBJ2-7,CASKREGGTSYEQYF,3,0,1,3
TRBV20-1,TRBJ2-3,CSAPHERGLTDTQYF,3,0,1,3
TRBV20-1,TRBJ2-1,CSARDRGTSYNEQFF,3,0,1,3
TRBV20-1,TRBJ2-7,CSARDQGKSSYEQYF,3,0,1,3
TRBV20-1,TRBJ1-1,CSARDTKSGPREAFF,3,0,1,3
TRBV20-1,TRBJ1-6,CSARDKLTGPDALHF,3,0,1,3
TRBV20-1,TRBJ2-1,CSADVGQVTYNEQFF,3,0,1,3
TRBV29-1,TRBJ2-1,CSVDKVAAAYNEQFF,3,0,1,3
TRBV29-1,TRBJ1-2,CSGASQVMDRGGYTF,3,0,1,3
TRBV7-3,TRBJ2-3,CSSSLESYTDTQYF,3,0,1,3
TRBV12-5,TRBJ1-1,CASGTGSHNTEAFF,3,0,1,3
TRBV30,TRBJ2-1,CAWSISGGREKQFF,3,0,1,3
TRBV10-3,TRBJ1-2,CAISEPTANYGYTF,3,0,1,3
TRBV10-3,TRBJ1-4,CAISEVGGHEKLFF,3,3,2,6
TRBV10-3,TRBJ2-7,CAIRMDRGRDEQYF,3,0,1,3
TRBV6-2/3/5/6,TRBJ2-2,CATTEGVRTGELFF,3,0,1,3
TRBV24-1,TRBJ1-2,CATSDFQMSYGYTF,3,0,1,3
TRBV24-1,TRBJ1-1,CATSDPGRDTEAFF,3,0,1,3
TRBV12-3/4,TRBJ1-5,CASQDREGNQPQHF,3,0,1,3
TRBV19,TRBJ1-1,CASSILQGNTEAFF,3,0,1,3
TRBV19,TRBJ2-1,CASSIEQGADEQFF,3,0,1,3
TRBV19,TRBJ2-5,CASSPPGGRETRYF,3,0,1,3
TRBV19,TRBJ1-3,CASRKEGTGNTIYF,3,0,1,3
TRBV18,TRBJ2-5,CASSPPGQGETQYF,3,0,1,3
TRBV6-2/3/5/6,TRBJ2-5,CASSPAGSRETQYF,3,0,1,3
TRBV18,TRBJ1-1,CASSPGQGEAEAFF,3,0,1,3
TRBV18,TRBJ1-1,CASSPTQENTEAFF,3,0,1,3
TRBV2,TRBJ1-6,CASRQGGTGSPLHF,3,0,1,3
TRBV9,TRBJ1-2,CASGNRGTDYGYTF,3,0,1,3
TRBV6-2/3/5/6,TRBJ1-4,CASILWATNEKLFF,3,0,1,3
TRBV7-2,TRBJ1-2,CASIPRTGSYGYTF,3,0,1,3
TRBV28,TRBJ2-2,CASMPGQPTGELFF,3,0,1,3
TRBV6-2/3/5/6,TRBJ2-3,CASIWPDGTDTQYF,3,0,1,3
TRBV28,TRBJ2-5,CASSLLAGEETQYF,3,0,1,3
TRBV12-3/4,TRBJ2-1,CASSLGNSYNEQFF,3,11,2,14
TRBV3-1,TRBJ2-7,CASSLWTGSYEQYF,3,0,1,3
TRBV12-3/4,TRBJ1-1,CASSLRPGNTEAFF,3,0,1,3
TRBV6-2/3/5/6,TRBJ1-6,CASSYRQDNSPLHF,3,0,1,3
TRBV11-2,TRBJ2-1,CASSYLAGGYEQFF,3,0,1,3
TRBV7-6,TRBJ2-7,CASSLQAGPTEQYF,3,0,1,3
TRBV7-4,TRBJ2-7,CASSPLGNSYEQYF,3,0,1,3
TRBV6-1,TRBJ2-3,CASSAGRKSDTQYF,3,0,1,3
TRBV2,TRBJ2-7,CASSETGGPYEQYF,3,19,2,22
TRBV2,TRBJ2-7,CASSELSNSYEQYF,3,0,1,3
TRBV2,TRBJ2-7,CASSESPESYEQYF,3,0,1,3
TRBV2,TRBJ1-1,CASSEPQGNTEAFF,3,0,1,3
TRBV2,TRBJ1-1,CASSEDPEGAEAYF,3,0,1,3
TRBV7-2,TRBJ2-7,CASSFFSQALEQYF,3,0,1,3
TRBV5-5,TRBJ2-2,CASSFLYLGGELFF,3,0,1,3
TRBV7-9,TRBJ1-1,CASSFGQVNTEAFF,3,0,1,3
TRBV7-3,TRBJ2-1,CASSFSGGANEQFF,3,0,1,3
TRBV7-2,TRBJ2-3,CASSLSGSTDTQYF,3,0,1,3
TRBV5-6,TRBJ2-7,CASSLWTASYEQYF,3,0,1,3
TRBV5-4,TRBJ2-7,CASSLVGGEREQYF,3,0,1,3
TRBV5-4,TRBJ1-1,CASSLAGRNTEAFF,3,0,1,3
TRBV5-4,TRBJ1-1,CASSLGDRANEAFF,3,0,1,3
TRBV11-2,TRBJ1-5,CASSLDGHNQPQHF,3,0,1,3
TRBV7-9,TRBJ2-7,CASSLTVLSYEQYF,3,0,1,3
TRBV7-2,TRBJ1-6,CASSLRQGSSPLHF,3,0,1,3
TRBV7-2,TRBJ1-2,CASSLSAGDYGYTF,3,0,1,3
TRBV7-2,TRBJ2-5,CASSLPGSAETQYF,3,0,1,3
TRBV7-2,TRBJ1-1,CASSLRTANTEAFF,3,0,1,3
TRBV11-2,TRBJ1-4,CASSLVYINEKLFF,3,0,1,3
TRBV7-9,TRBJ2-7,CASSLGAPGFQQYF,3,0,1,3
TRBV7-9,TRBJ1-1,CASSLGTVNTEAFF,3,0,1,3
TRBV11-1,TRBJ2-7,CASSLERAGHEQYF,3,0,1,3
TRBV7-6,TRBJ2-7,CASSSRTGDYEQYF,3,0,1,3
TRBV11-2,TRBJ1-2,CASSLSRGHDGYTF,3,0,1,3
TRBV7-2,TRBJ1-2,CASSLYDRSYGYTF,3,0,1,3
TRBV12-3/4,TRBJ1-1,CASSLQLFNTEAFF,3,0,1,3
TRBV7-9,TRBJ1-1,CASSLQGENTEAFF,3,2,2,5
TRBV3-1,TRBJ2-7,CASSPQAGGYEQYF,3,0,1,3
TRBV3-1,TRBJ2-1,CASSPSASSNEQFF,3,0,1,3
TRBV7-9,TRBJ2-5,CASSPYRVVKTQYF,3,0,1,3
TRBV3-1,TRBJ1-6,CASSPQRGSSPLHF,3,0,1,3
TRBV7-3,TRBJ2-4,CASSPGGVKNIQYF,3,0,1,3
TRBV7-9,TRBJ1-1,CASSPGRVNTEAFF,3,0,1,3
TRBV5-4,TRBJ1-1,CASSPDPGSTEAFF,3,0,1,3
TRBV7-9,TRBJ1-5,CASSPRGGNQPQHF,3,0,1,3
TRBV7-9,TRBJ2-7,CASSPSTSSYEQYF,3,0,1,3
TRBV3-1,TRBJ2-1,CASSPSGGWGEQFF,3,4,2,7
TRBV7-9,TRBJ2-7,CASSPPGQIFEQYF,3,0,1,3
TRBV6-2/3/5/6,TRBJ1-2,CASSPRTQNYGYTF,3,0,1,3
TRBV7-2,TRBJ2-7,CASSPGPPTYEQYF,3,0,1,3
TRBV7-2,TRBJ2-5,CASSPGQGQETQYF,3,0,1,3
TRBV7-2,TRBJ2-4,CASSPGQGLNIQYF,3,0,1,3
TRBV7-6,TRBJ2-7,CASSPGTGEGEQYF,3,0,1,3
TRBV7-2,TRBJ2-7,CASSRRQGSYEQYF,3,0,1,3
TRBV3-1,TRBJ1-4,CASSRVDQGEKLFF,3,0,1,3
TRBV6-2/3/5/6,TRBJ2-7,CASSRDISSYEQYF,3,0,1,3
TRBV3-1,TRBJ2-2,CASSQGLVTGELFF,3,0,1,3
TRBV6-2/3/5/6,TRBJ1-1,CASSQEPGRLKAFF,3,0,1,3
TRBV3-1,TRBJ2-7,CASSQATGLYEQYF,3,0,1,3
TRBV3-1,TRBJ2-7,CASSQAGPSYEQYF,3,0,1,3
TRBV3-1,TRBJ1-2,CASSQGSGYDSYTF,3,0,1,3
TRBV4-2,TRBJ2-7,CASSQGQLVYEQYF,3,0,1,3
TRBV3-1,TRBJ1-1,CASSQDSTSLEAFF,3,0,1,3
TRBV9,TRBJ2-3,CASSVIGVTDTQYF,3,0,1,3
TRBV9,TRBJ2-7,CASSVSDRSYEQYF,3,0,1,3
TRBV7-2,TRBJ1-2,CASSARQPSWGYTF,3,0,1,3
TRBV7-2,TRBJ2-7,CASSATRGGGEQYF,3,0,1,3
TRBV9,TRBJ2-3,CASSATVITDTQYF,3,0,1,3
TRBV9,TRBJ2-7,CASSGAGSSYEQYF,3,0,1,3
TRBV2,TRBJ2-7,CASSGQGSSDEQYF,3,0,1,3
TRBV5-5,TRBJ1-5,CASSEASGNQPQHF,3,0,1,3
TRBV28,TRBJ1-2,CASSTRTGTGGYTF,3,0,1,3
TRBV7-9,TRBJ2-3,CASSTAGFTDTQYF,3,0,1,3
TRBV12-3/4,TRBJ1-1,CASSKGQGNTEAFF,3,3,2,6
TRBV9,TRBJ2-5,CASSKTSSQETQYF,3,0,1,3
TRBV2,TRBJ1-1,CASRLDRESAEAFF,3,0,1,3
TRBV12-3/4,TRBJ1-3,CASRPGEYGNTIYF,3,0,1,3
TRBV12-3/4,TRBJ2-1,CASRLADRDNEQFF,3,0,1,3
TRBV7-9,TRBJ1-4,CASRPGTGAEKLFF,3,0,1,3
TRBV7-2,TRBJ1-3,CASRQTFSGNTIYF,3,4,2,7
TRBV6-2/3/5/6,TRBJ2-3,CASRGRTSTDTQYF,3,0,1,3
TRBV2,TRBJ1-1,CASRGTLDETEAFF,3,0,1,3
TRBV2,TRBJ2-3,CANSRDRETDTQYF,3,0,1,3
TRBV4-1,TRBJ2-2,CASEAYRDTGELFF,3,0,1,3
TRBV5-1,TRBJ2-1,CASTPGGGWNEQFF,3,0,1,3
TRBV5-1,TRBJ1-1,CASSFEGTNTEAFF,3,0,1,3
TRBV5-1,TRBJ2-3,CASSLLLATDTQYF,3,0,1,3
TRBV5-1,TRBJ1-1,CASSLVAGNTEAFF,3,0,1,3
TRBV5-1,TRBJ2-7,CASSLDSLLYEQYF,3,0,1,3
TRBV5-1,TRBJ2-3,CASSLTVVRDTQYF,3,0,1,3
TRBV5-1,TRBJ2-7,CASSPDGHSYEQYF,3,0,1,3
TRBV4-1,TRBJ2-3,CASSPEPSTDTQYF,3,0,1,3
TRBV5-1,TRBJ2-1,CASSPNTGDDEQFF,3,0,1,3
TRBV4-1,TRBJ1-2,CASSQPDRGYGYTF,3,0,1,3
TRBV4-1,TRBJ1-1,CASSQVVRDPEAFF,3,0,1,3
TRBV4-1,TRBJ2-3,CASSQDQFADTQYF,3,0,1,3
TRBV5-1,TRBJ2-1,CASSTGTGGNEQFF,3,0,1,3
TRBV5-1,TRBJ1-2,CASSTGTERDGYTF,3,0,1,3
TRBV5-1,TRBJ1-2,CASSREGQGYGYTF,3,0,1,3
TRBV10-2,TRBJ1-5,CASSRQANNQPQHF,3,0,1,3
TRBV5-1,TRBJ2-7,CASRAGTGDYEQYF,3,0,1,3
TRBV4-1,TRBJ1-1,CANSQGAGETEAFF,3,0,1,3
TRBV20-1,TRBJ2-1,CSASVQGFYNEQFF,3,0,1,3
TRBV20-1,TRBJ2-5,CSARLAGVEETQYF,3,0,1,3
TRBV20-1,TRBJ2-7,CSARRLAGGGEQYF,3,0,1,3
TRBV20-1,TRBJ1-1,CSARVRTNPTEAFF,3,0,1,3
TRBV20-1,TRBJ2-7,CSARGGSGIYEQYF,3,0,1,3
TRBV20-1,TRBJ2-7,CSARDQRETYEQYF,3,0,1,3
TRBV20-1,TRBJ1-5,CSASQGYSNQPQHF,3,0,1,3
TRBV29-1,TRBJ1-5,CSVSYSDVFQPQHF,3,0,1,3
TRBV29-1,TRBJ2-7,CSVDVAGDPYEQYF,3,0,1,3
TRBV29-1,TRBJ2-4,CSVQQGVAKNIQYF,3,0,1,3
TRBV29-1,TRBJ1-6,CSAQWGDTYSPLHF,3,0,1,3
TRBV29-1,TRBJ2-1,CSAQTDYSYNEQFF,3,0,1,3
TRBV29-1,TRBJ1-1,CSAGQGDISTEAFF,3,0,1,3
TRBV19,TRBJ2-7,CASALRQGYEQYF,3,0,1,3
TRBV30,TRBJ2-3,CAWTLGEEDTQYF,3,0,1,3
TRBV30,TRBJ1-2,CAWSRQGAVGYTF,3,0,1,3
TRBV30,TRBJ1-1,CAWSDPMNTEAFF,3,4,2,7
TRBV9,TRBJ2-5,CAHDERSQETQYF,3,0,1,3
TRBV2,TRBJ2-1,CAILLAGAKEQFF,3,0,1,3
TRBV10-3,TRBJ2-7,CAISDPRTGVKYF,3,0,1,3
TRBV7-9,TRBJ1-5,CATSQGSGEPQHF,3,0,1,3
TRBV24-1,TRBJ2-1,CATSGIADREEFF,3,0,1,3
TRBV15,TRBJ1-1,CATSSTGTTEAFF,3,0,1,3
TRBV3-1,TRBJ2-5,CATRTSGRETQYF,3,0,1,3
TRBV2,TRBJ2-1,CATIAGDYNEQFF,3,0,1,3
TRBV19,TRBJ1-1,CASIVRGGTEAFF,3,0,1,3
TRBV19,TRBJ1-1,CASSWLGFPEAFF,3,0,1,3
TRBV19,TRBJ1-1,CASSMRQDTEAFF,3,0,1,3
TRBV18,TRBJ2-2,CASSPPVTGELFF,3,0,1,3
TRBV18,TRBJ1-1,CASSPSGAFVAFF,3,0,1,3
TRBV27,TRBJ2-1,CASSFGGYNEQFF,3,0,1,3
TRBV12-3/4,TRBJ1-2,CASSFEGSYGYTF,3,0,1,3
TRBV6-2/3/5/6,TRBJ2-1,CASSLGGHNEQFF,3,0,1,3
TRBV28,TRBJ2-3,CASSLADGDTQYF,3,0,1,3
TRBV2,TRBJ1-5,CASSSGYNQPQHF,3,0,1,3
TRBV6-2/3/5/6,TRBJ1-1,CASSYSGDTEAFL,3,0,1,3
TRBV6-2/3/5/6,TRBJ1-2,CASSYGGRYGYTF,3,0,1,3
TRBV6-2/3/5/6,TRBJ1-6,CASSPSGAAVPHF,3,0,1,3
TRBV6-4,TRBJ1-5,CASSRQSNQPQHF,3,0,1,3
TRBV14,TRBJ1-5,CASSQGSRQPQHF,3,0,1,3
TRBV28,TRBJ2-7,CASSGPPTYEQYF,3,0,1,3
TRBV12-3/4,TRBJ2-7,CASSGQGSYEQYF,3,7,2,10
TRBV28,TRBJ2-7,CASSGTPVKEQYF,3,0,1,3
TRBV2,TRBJ1-4,CASSERLNEKLFF,3,0,1,3
TRBV6-1,TRBJ2-3,CASSEGRADTQYF,3,0,1,3
TRBV6-1,TRBJ2-7,CASSEDRAHEQYF,3,0,1,3
TRBV7-8,TRBJ2-7,CASSFHRTYEQYF,3,0,1,3
TRBV7-9,TRBJ2-3,CASSFGGTDTQYF,3,0,1,3
TRBV11-2,TRBJ2-7,CASSFHSPYEQYF,3,0,1,3
TRBV7-3,TRBJ2-1,CASSFGSYNEQFF,3,3,2,6
TRBV11-2,TRBJ1-5,CASSLGSNQPQHF,3,0,1,3
TRBV5-5,TRBJ1-1,CASSLGLGTEAFF,3,5,2,8
TRBV7-2,TRBJ1-1,CASSLPVNTEAFF,3,0,1,3
TRBV7-9,TRBJ2-1,CASSLAGGTEQFF,3,0,1,3
TRBV7-9,TRBJ2-2,CASSLARTGELFF,3,0,1,3
TRBV7-9,TRBJ2-5,CASSLGPQETQYF,3,0,1,3
TRBV7-2,TRBJ2-7,CASSLGRAYEQYF,3,0,1,3
TRBV7-6,TRBJ2-7,CASSLERDYEQYF,3,0,1,3
TRBV13,TRBJ1-1,CASSLMRGTEAFF,3,0,1,3
TRBV11-2,TRBJ2-7,CASSLRRDYEQYF,3,0,1,3
TRBV7-9,TRBJ1-2,CASSLQGADGYTF,3,0,1,3
TRBV11-2,TRBJ1-4,CASSPDRAEKLFF,3,0,1,3
TRBV28,TRBJ1-2,CASSPDRGGGYTF,3,0,1,3
TRBV7-2,TRBJ2-1,CASSPVQGYEQFF,3,0,1,3
TRBV4-2,TRBJ2-3,CASSHGQGRRQYF,3,0,1,3
TRBV7-9,TRBJ1-1,CASSQGYDTEAFF,3,3,2,6
TRBV3-1,TRBJ2-1,CASSQGLAGEQFF,3,0,1,3
TRBV4-2,TRBJ1-1,CASSQGGRTEAFF,3,0,1,3
TRBV3-1,TRBJ1-6,CASSQDRQRPLHF,3,0,1,3
TRBV4-2,TRBJ1-6,CASSQEFRGPLHF,3,0,1,3
TRBV3-1,TRBJ2-5,CASSQRGRETQYF,3,0,1,3
TRBV9,TRBJ1-2,CASSVGQAYGYTF,3,0,1,3
TRBV5-4,TRBJ2-3,CASSADSTDTQYF,3,0,1,3
TRBV9,TRBJ2-2,CASSGLTSGELFF,3,0,1,3
TRBV6-1,TRBJ1-5,CASSEAGHQPQHF,3,0,1,3
TRBV5-6,TRBJ1-1,CASRRDRNTEAFF,3,0,1,3
TRBV3-1,TRBJ2-7,CASRLAGSYEQYF,3,0,1,3
TRBV13,TRBJ2-5,CASRPARGETQYF,3,0,1,3
TRBV2,TRBJ2-5,CASRKDVEETQYI,3,0,1,3
TRBV6-2/3/5/6,TRBJ2-3,CASKFQGRDTQYF,3,0,1,3
TRBV15,TRBJ1-1,CTTSGRAFTEAFF,3,0,1,3
TRBV5-1,TRBJ2-5,CASSPGQIETQYF,3,0,1,3
TRBV5-1,TRBJ2-5,CASSRGTQETQYF,3,0,1,3
TRBV5-1,TRBJ2-7,CASSSGTTYEQYF,3,0,1,3
TRBV5-1,TRBJ1-1,CASSRQGAAEAFF,3,0,1,3
TRBV4-3,TRBJ2-1,CANSLGVKDEQFF,3,0,1,3
TRBV20-1,TRBJ1-3,CGARLLSGNTIYF,3,0,1,3
TRBV20-1,TRBJ2-1,CSAILAGGPEQFF,3,7,2,10
TRBV20-1,TRBJ1-5,CSAIRTGNQPQHF,3,0,1,3
TRBV20-1,TRBJ2-3,CSASGTSRDTQYF,3,0,1,3
TRBV20-1,TRBJ2-5,CSAREAGSSTQYF,3,0,1,3
TRBV20-1,TRBJ1-4,CSARIPGDEKLFF,3,0,1,3
TRBV20-1,TRBJ1-5,CSARPGGGQPQHF,3,0,1,3
TRBV29-1,TRBJ2-3,CSVVGWVTDTQYF,3,0,1,3
TRBV29-1,TRBJ1-1,CSVADGPNTEAFF,3,0,1,3
TRBV29-1,TRBJ2-3,CSVGKREADTQYF,3,0,1,3
TRBV29-1,TRBJ1-1,CSVDEDRNTEAFF,3,2,2,5
TRBV29-1,TRBJ1-3,CSVDTGDGNTIYF,3,0,1,3
TRBV29-1,TRBJ1-1,CSVEENPNTEAFF,3,0,1,3
TRBV29-1,TRBJ2-7,CSVRTGAWYEQYF,3,0,1,3
TRBV29-1,TRBJ2-7,CSVFRDRGVEQYF,3,0,1,3
TRBV29-1,TRBJ1-2,CSAVEDRAAGYTF,3,0,1,3
TRBV29-1,TRBJ1-5,CSATLDRNQPQHF,3,0,1,3
TRBV29-1,TRBJ2-5,CSGLFTGPETQYF,3,0,1,3
TRBV29-1,TRBJ2-5,CSGRGGRKETQYF,3,0,1,3
TRBV20-1,TRBJ2-5,CSGLPGPRETQYF,3,0,1,3
TRBV29-1,TRBJ2-2,CSEGLFYTGELFF,3,0,1,3
TRBV30,TRBJ1-1,CAWSRQGAEAFF,3,0,1,3
TRBV30,TRBJ2-7,CAWRSGSYEQYF,3,5,2,8
TRBV15,TRBJ1-2,CATSVGANGYTF,3,0,1,3
TRBV27,TRBJ2-2,CASTHTPRELFF,3,0,1,3
TRBV12-3/4,TRBJ1-1,CASTPDSTEAFF,3,0,1,3
TRBV27,TRBJ1-1,CASSSLGTEAFF,3,0,1,3
TRBV6-2/3/5/6,TRBJ2-5,CASSRFQETQYF,3,0,1,3
TRBV7-9,TRBJ2-3,CASSLDRDTQYF,3,0,1,3
TRBV7-9,TRBJ2-2,CASSLSTGELFF,3,0,1,3
TRBV3-1,TRBJ2-3,CASSYRADTQYF,3,0,1,3
TRBV12-3/4,TRBJ2-2,CASSLNTGELFF,3,8,2,11
TRBV7-3,TRBJ2-1,CASSPGPNEQFF,3,0,1,3
TRBV7-9,TRBJ1-2,CASSPQNYGYTF,3,0,1,3
TRBV7-9,TRBJ2-1,CASSRLAYGQFF,3,0,1,3
TRBV11-2,TRBJ1-4,CASSQVTGIPLF,3,0,1,3
TRBV7-8,TRBJ2-2,CASRSIAGELFF,3,0,1,3
TRBV11-2,TRBJ2-7,CTSSSLSYEQYF,3,0,1,3
TRBV5-1,TRBJ1-1,CASSSSRQGTFF,3,0,1,3
TRBV4-1,TRBJ2-1,CASSQFGAEQFF,3,0,1,3
TRBV4-1,TRBJ1-1,CASSQGNTEAFF,3,0,1,3
TRBV4-1,TRBJ2-7,CASSQDTREQYF,3,0,1,3
TRBV5-1,TRBJ2-1,CASSADLDEQFF,3,0,1,3
TRBV20-1,TRBJ1-2,CSAEGQDYGYTF,3,0,1,3
TRBV20-1,TRBJ2-7,CSASGSSCEQYF,3,0,1,3
TRBV20-1,TRBJ2-3,CSARQSADTQYF,3,0,1,3
TRBV20-1,TRBJ1-3,CSALGQSNTIYF,3,0,1,3
TRBV29-1,TRBJ1-2,CSVERQGYGYTF,3,0,1,3
TRBV29-1,TRBJ2-1,CSVVAGGNEQFF,3,0,1,3
TRBV29-1,TRBJ1-6,CSVGGESSPLHF,3,0,1,3
TRBV29-1,TRBJ2-1,CSVRRSYNEQFF,3,3,2,6
TRBV29-1,TRBJ2-7,CSANFGPAEQYF,3,0,1,3
TRBV29-1,TRBJ2-1,CSAGTSGNEQFF,3,0,1,3
TRBV30,TRBJ1-2,CAWSETYGYTF,3,0,1,3
TRBV30,TRBJ1-1,CAHLRATEAFF,3,0,1,3
TRBV10-3,TRBJ1-1,CAIRQGPEAFF,3,0,1,3
TRBV2,TRBJ2-5,CATDTGEAQYF,3,0,1,3
TRBV18,TRBJ2-7,CASSQDGQQYF,3,0,1,3
TRBV2,TRBJ2-7,CASTRGEEQYF,3,0,1,3
TRBV2,TRBJ2-5,CASTGVETQYF,3,0,1,3
TRBV7-2,TRBJ2-7,CASTRDVEQYF,3,0,1,3
TRBV12-3/4,TRBJ2-7,CASTNSYEQYF,3,0,1,3
TRBV7-9,TRBJ2-1,CASSYRNEQFF,3,0,1,3
TRBV7-2,TRBJ2-7,CASSPAYEQYF,3,0,1,3
TRBV3-1,TRBJ2-5,CASSQEKTQYF,3,0,1,3
TRBV11-2,TRBJ1-1,CASSAASGAFF,3,0,1,3
TRBV5-1,TRBJ1-2,CASGHNDGYTF,3,0,1,3
TRBV5-1,TRBJ2-3,CASSFTDTQCF,3,0,1,3
TRBV5-1,TRBJ1-1,CASSLGDTPSF,3,0,1,3
TRBV5-1,TRBJ1-1,CASRGRTEAFF,3,0,1,3
TRBV20-1,TRBJ2-3,CSAVSTDTQYF,3,0,1,3
TRBV20-1,TRBJ2-1,CSARLNNEQFF,3,0,1,3
TRBV20-1,TRBJ2-1,CSPARGNEQFF,3,0,1,3
TRBV29-1,TRBJ2-1,CSVTPYNEQFF,3,0,1,3
TRBV29-1,TRBJ2-7,CSADLAREQYF,3,0,1,3
TRBV12-5,TRBJ1-2,CASGLDRGTF,3,0,1,3
TRBV9,TRBJ1-1,CASSPTPAFF,3,0,1,3
TRBV14,TRBJ2-1,CASSQARSGRAGSEQFF,3,0,1,3
TRBV14,TRBJ2-2,CASSLQGATGELFF,3,0,1,3
TRBV29-1,TRBJ2-7,CSVVGGQIYEQYF,3,0,1,3
TRBV7-6,TRBJ2-3,CASSLSKGHTDTQYF,3,0,1,3
TRBV5-1,TRBJ1-1,CASSLGGTKNTEAFF,3,0,1,3
TRBV20-1,TRBJ2-2,CSARDPRGAGELFF,3,4,2,7
TRBV20-1,TRBJ2-1,CSARDAGGSVSYNEQFF,3,0,1,3
TRBV5-1,TRBJ1-5,CASSEGQGGSNQPQHF,3,0,1,3
TRBV6-2/3/5/6,TRBJ2-1,CASSYSLAGANEQFF,3,0,1,3
TRBV5-1,TRBJ2-4,CASTPGGGRRKDIQYF,3,0,1,3
TRBV7-9,TRBJ2-1,CASSFSIGKVYNEQFF,3,0,1,3
TRBV4-3,TRBJ2-6,CAGSQVFLGQGAYGANVLTF,3,0,1,3
TRBV4-1,TRBJ1-6,CASSQRIGLVLDNSPLHF,3,0,1,3
TRBV5-5,TRBJ2-2,CASSLTSANTGELFF,3,0,1,3
TRBV7-9,TRBJ2-5,CASSSDRANQETQYF,3,0,1,3
TRBV28,TRBJ1-2,CANTPGPNYGYTF,3,0,1,3
TRBV9,TRBJ1-1,CASSVSGAGRPEAFF,2,26,2,28
TRBV19,TRBJ1-2,CASTRQSYGYAF,2,0,1,2
TRBV5-1,TRBJ2-1,CASSSPVSGTQGATYNEQFF,2,0,1,2
TRBV30,TRBJ2-3,CAWNLGLAGGSWGADTQYF,2,0,1,2
TRBV25-1,TRBJ1-1,CASSGGTWGRGSVNTEAFF,2,0,1,2
TRBV7-9,TRBJ1-4,CASSFGLRRPGELDEKLFF,2,0,1,2
TRBV7-9,TRBJ2-7,CASSFADGTGPTRGHEQYF,2,0,1,2
TRBV11-2,TRBJ2-1,CASSLRLAGSLGSYNEQFF,2,0,1,2
TRBV7-9,TRBJ2-3,CASSSNEARTSGFTDTQYF,2,0,1,2
TRBV5-1,TRBJ1-4,CASSLVPWEGLSVNEKLFF,2,0,1,2
TRBV4-3,TRBJ2-1,CASSQDGTSESSSYNEQFF,2,0,1,2
TRBV30,TRBJ2-7,CAWSSGPGRLAGAYEQYF,2,0,1,2
TRBV30,TRBJ2-2,CAWSVAPASGGDTGELFF,2,0,1,2
TRBV30,TRBJ1-6,CAWSTGTGSYLVDSPLHF,2,0,1,2
TRBV15,TRBJ1-5,CATSRDLKDRGGNQPQHF,2,0,1,2
TRBV9,TRBJ2-3,CASSPHRWQPSSTDTQYF,2,0,1,2
TRBV18,TRBJ1-2,CASSPPVLGKVPRGGYTF,2,0,1,2
TRBV13,TRBJ1-2,CASIESRSHREGIYGYTF,2,0,1,2
TRBV27,TRBJ1-4,CASSLSVSHRDRVEKLFF,2,0,1,2
TRBV12-3/4,TRBJ2-1,CASSLVRGSWGVHNEQFF,2,0,1,2
TRBV6-2/3/5/6,TRBJ1-1,CASSYSWRERFRNTEAFF,2,0,1,2
TRBV5-4,TRBJ2-7,CASSLEASGGLISYEQYF,2,0,1,2
TRBV7-8,TRBJ2-2,CASSSTMLADGNTGELFF,2,3,2,5
TRBV5-8,TRBJ1-2,CASSYDGGTGAPNYGYTF,2,0,1,2
TRBV5-1,TRBJ2-3,CASTPLTGNNGLTDTQYF,2,0,1,2
TRBV4-3,TRBJ2-7,CASSQEVAGGVPTYEQYF,2,0,1,2
TRBV7-7,TRBJ2-6,CASSPGQGDSGANVLTF,2,0,1,2
TRBV24-1,TRBJ2-2,CATSDLMGQGISGELFF,2,0,1,2
TRBV19,TRBJ2-6,CASSAAGIRTGANVLTF,2,0,1,2
TRBV18,TRBJ1-1,CASSPATPKAMNTEAFF,2,0,1,2
TRBV6-2/3/5/6,TRBJ1-4,CASIHDRGRGTNEKLFF,2,0,1,2
TRBV28,TRBJ2-3,CASSSPVGGIRTDTQYF,2,0,1,2
TRBV6-2/3/5/6,TRBJ1-1,CASSYSRGKGTVGEAFF,2,0,1,2
TRBV6-2/3/5/6,TRBJ2-5,CASSTSRDRGPQETQYF,2,0,1,2
TRBV7-2,TRBJ2-3,CASSLGLTSGSADTQYF,2,0,1,2
TRBV7-8,TRBJ2-7,CASSLGDLGRSSYEQYF,2,0,1,2
TRBV7-2,TRBJ2-5,CASSLSLGTGIREIQYF,2,0,1,2
TRBV7-3,TRBJ2-5,CASSLRRSSGMQETQYF,2,0,1,2
TRBV7-9,TRBJ1-2,CASSSTRIQGTNYGYTF,2,0,1,2
TRBV7-9,TRBJ2-5,CASSLRTSGSGKETQYF,2,0,1,2
TRBV7-9,TRBJ1-3,CASSPPGEHLSGNTIYF,2,0,1,2
TRBV7-6,TRBJ1-5,CASSPGPGQLSNQPQHF,2,0,1,2
TRBV5-4,TRBJ2-5,CASSHRLAGGPGETQYF,2,0,1,2
TRBV12-3/4,TRBJ2-4,CASRASRGSLAKNIQYF,2,0,1,2
TRBV7-9,TRBJ2-3,CASNPGTSGGFWDTQYF,2,0,1,2
TRBV7-9,TRBJ1-3,CASKKGVRGISGNTIYF,2,0,1,2
TRBV5-1,TRBJ2-3,CASSLQGTEIFTDTQYF,2,0,1,2
TRBV4-1,TRBJ1-6,CASSRSRRTGDNSPLHF,2,0,1,2
TRBV4-3,TRBJ2-1,CASSQVPLAGDNNEQFF,2,0,1,2
TRBV4-3,TRBJ2-5,CASSQDSLVTAQETQYF,2,0,1,2
TRBV20-1,TRBJ2-7,CSAGISSGGAYSYEQYF,2,0,1,2
TRBV20-1,TRBJ2-1,CSARPRTSGSFYNEQFF,2,6,2,8
TRBV20-1,TRBJ1-6,CSARGSTGASYNSPLHF,2,0,1,2
TRBV9,TRBJ2-1,RASSRGLAGGPYNEQFF,2,0,1,2
TRBV5-4,TRBJ1-2,CVSSGKQGWAFKGYTF,2,0,1,2
TRBV30,TRBJ2-7,CAWSVPGSLPGHEQYF,2,0,1,2
TRBV5-4,TRBJ2-7,CAGSLGLREGTYEQYF,2,0,1,2
TRBV10-3,TRBJ1-6,CAISESRGYSPSPLHF,2,0,1,2
TRBV24-1,TRBJ2-1,CATSDNRVNSYNEQFF,2,0,1,2
TRBV15,TRBJ1-1,CATSRDLVSLNTEAFF,2,0,1,2
TRBV15,TRBJ2-4,CATSKLAGGRFDIQYF,2,0,1,2
TRBV19,TRBJ1-5,CASSPPKSDGNQPQHF,2,0,1,2
TRBV19,TRBJ1-2,CASSAHRGATNYGYTF,2,0,1,2
TRBV19,TRBJ2-5,CASSEGTSGGEETQYF,2,0,1,2
TRBV19,TRBJ1-1,CASSIFFGLMNTEAFF,2,0,1,2
TRBV19,TRBJ1-5,CASSIDRGIGNQPQHF,2,0,1,2
TRBV19,TRBJ2-2,CASSRVWTVLTGELFF,2,0,1,2
TRBV19,TRBJ1-3,CASSRQGPVSGNTIYF,2,0,1,2
TRBV19,TRBJ1-1,CASRTTRQDVDTEAFF,2,0,1,2
TRBV18,TRBJ2-7,CASSPLKGGGPGEQYF,2,0,1,2
TRBV18,TRBJ2-5,CASSPPPRGRGETQYF,2,6,2,8
TRBV11-3,TRBJ2-3,CASTSLAESGTDTQYF,2,0,1,2
TRBV12-3/4,TRBJ2-7,CASTRGLADRGHEQYF,2,0,1,2
TRBV6-2/3/5/6,TRBJ2-1,CASSFPYRGLEDEQFF,2,0,1,2
TRBV6-2/3/5/6,TRBJ1-2,CASSFGIWIANYGYTF,2,0,1,2
TRBV12-3/4,TRBJ1-2,CASSFGIWTANYGYTF,2,0,1,2
TRBV12-3/4,TRBJ2-7,CASSLFRTSGSYEQYF,2,0,1,2
TRBV12-3/4,TRBJ1-5,CASSLARGYSNQPRHF,2,0,1,2
TRBV6-2/3/5/6,TRBJ1-6,CASSLGEASYNSPLHF,2,0,1,2
TRBV6-2/3/5/6,TRBJ2-3,CASSYFKQSSTDTQYF,2,0,1,2
TRBV27,TRBJ1-2,CASSPPRTGPDYGYTF,2,0,1,2
TRBV12-3/4,TRBJ2-3,CASSPGPGLRTDTQYF,2,0,1,2
TRBV6-4,TRBJ2-3,CASSPGQGGSTDTQYF,2,0,1,2
TRBV6-2/3/5/6,TRBJ2-2,CASSRTLPANTGELFF,2,0,1,2
TRBV6-1,TRBJ1-1,CASSVSRGFMNTEAFF,2,0,1,2
TRBV6-1,TRBJ2-7,CASSEAGPPFSYEQYF,2,0,1,2
TRBV7-9,TRBJ2-1,CASSFSGTAVMGEQFF,2,0,1,2
TRBV5-6,TRBJ2-7,CASSFFRLLTLYEQYF,2,0,1,2
TRBV5-8,TRBJ1-5,CASSFIPDLRNQPQHF,2,0,1,2
TRBV11-2,TRBJ2-1,CASSLSSSGSKDEQFF,2,0,1,2
TRBV13,TRBJ2-4,CASSLGDRRAKNIQYF,2,0,1,2
TRBV11-2,TRBJ2-5,CASSLGAMGAQETQYF,2,0,1,2
TRBV7-6,TRBJ2-2,CASSLGFRTAGGELFF,2,0,1,2
TRBV13,TRBJ1-2,CASSLEGLTGGSGYTF,2,0,1,2
TRBV7-3,TRBJ1-2,CASSLNGGAANYGYTF,2,0,1,2
TRBV5-6,TRBJ2-7,CASSSPGLAGNYEQYF,2,0,1,2
TRBV5-6,TRBJ2-5,CASSSQPGAGEETQYF,2,0,1,2
TRBV7-2,TRBJ2-1,CASSSGVTRDANEQFF,2,0,1,2
TRBV7-2,TRBJ1-5,CASSLTGGSGNQPQHF,2,0,1,2
TRBV9,TRBJ2-7,CASSPWTGMSGDEQYF,2,0,1,2
TRBV11-2,TRBJ2-5,CASSPRLAGASETQYF,2,0,1,2
TRBV7-2,TRBJ2-1,CASSPTVGGYYNEQFF,2,0,1,2
TRBV4-2,TRBJ1-3,CASSQQAGTGDYTIYF,2,0,1,2
TRBV3-1,TRBJ2-7,CASSQVTPTISYEQYF,2,0,1,2
TRBV14,TRBJ2-7,CASSQDGGGGGDEQYF,2,0,1,2
TRBV7-8,TRBJ1-4,CASSQTGQGRNEKLFF,2,0,1,2
TRBV5-4,TRBJ2-3,CASSAGVASSTDTQYF,2,0,1,2
TRBV7-8,TRBJ2-6,CASSGSYRSGANVLTF,2,0,1,2
TRBV5-5,TRBJ2-3,CASSTRLAGSTDTQYF,2,0,1,2
TRBV2,TRBJ2-1,CASRGAMGSRNNEQFF,2,0,1,2
TRBV27,TRBJ1-2,CASKKRPGPTNYGYTF,2,0,1,2
TRBV5-1,TRBJ2-7,CASSLPSDSVSYEQYF,2,0,1,2
TRBV5-1,TRBJ2-1,CASSLRTSGGNNEQFF,2,0,1,2
TRBV5-1,TRBJ2-7,CASSRSGQGLSDEQYF,2,0,1,2
TRBV4-1,TRBJ2-3,CASSQLGLAGADTQYF,2,0,1,2
TRBV4-1,TRBJ2-1,CASSQGVGSSYNEQFF,2,0,1,2
TRBV4-1,TRBJ2-7,CASSQDSSGRLYEQYF,2,0,1,2
TRBV4-1,TRBJ2-7,CASSQDLTSGGYEQYF,2,0,1,2
TRBV4-3,TRBJ2-5,CASSQDVGRGQETQYF,2,0,1,2
TRBV4-3,TRBJ2-1,CASSQDGREAHNEQFF,2,0,1,2
TRBV5-1,TRBJ1-4,CASSVEPRGGDEKLFF,2,0,1,2
TRBV4-1,TRBJ2-3,CASSDRQGELADTQYF,2,0,1,2
TRBV20-1,TRBJ1-5,CSARDRQGVSNQPQHF,2,0,1,2
TRBV20-1,TRBJ1-5,CSARDLKGLNNQPQHF,2,0,1,2
TRBV20-1,TRBJ2-1,CSARDPILTNGNEQFF,2,0,1,2
TRBV30,TRBJ1-1,YAWSVGSYVINTEAFF,2,0,1,2
TRBV12-5,TRBJ2-6,CASGPDSSGANVLTF,2,0,1,2
TRBV30,TRBJ1-1,CALLQGAMGITEAFF,2,0,1,2
TRBV15,TRBJ2-3,CASSRGDSETDTQYF,2,0,1,2
TRBV30,TRBJ1-5,CAWSKGTAYNQPQHF,2,0,1,2
TRBV2,TRBJ2-6,CATEPAFDGANVLTF,2,0,1,2
TRBV11-3,TRBJ1-1,CATSPTGVWDTEAFF,2,0,1,2
TRBV15,TRBJ1-4,CATSTLEAGKEKLFF,2,0,1,2
TRBV15,TRBJ1-4,CATSRDGSLNEKLFF,2,0,1,2
TRBV15,TRBJ2-3,CATSRDRASTDTQYF,2,0,1,2
TRBV19,TRBJ2-5,CASMGTGTAQETQYF,2,0,1,2
TRBV19,TRBJ1-3,CASSPDSTSGNTIYF,2,0,1,2
TRBV19,TRBJ2-6,CASSVQGSGANVLTF,2,0,1,2
TRBV19,TRBJ2-7,CASSIGDRRIYEQYF,2,0,1,2
TRBV19,TRBJ1-5,CASSIGTYSNQPQHF,2,0,1,2
TRBV19,TRBJ1-2,CASSTRDTYNYGYTF,2,0,1,2
TRBV19,TRBJ2-2,CASRPLAGVTGELFF,2,0,1,2
TRBV6-2/3/5/6,TRBJ2-1,CASSWGRGTYNEQFF,2,0,1,2
TRBV18,TRBJ2-1,CASSPTGTGANEQFF,2,0,1,2
TRBV18,TRBJ2-6,CASSRDRSGANVLTF,2,0,1,2
TRBV12-3/4,TRBJ1-1,CASRRLLGRRTEAFF,2,0,1,2
TRBV2,TRBJ2-5,CASTYLGDRGETQYF,2,0,1,2
TRBV27,TRBJ2-7,CASSFGTGGSYEQYF,2,0,1,2
TRBV12-3/4,TRBJ2-7,CASSLLTGTPREQYF,2,0,1,2
TRBV27,TRBJ2-7,CASSLRTGSSYEQYF,2,0,1,2
TRBV6-2/3/5/6,TRBJ1-4,CASSSSRGRGEKLFF,2,0,1,2
TRBV6-2/3/5/6,TRBJ1-3,CASSSTGGSGNTIYF,2,0,1,2
TRBV28,TRBJ1-1,CASSSNRGRGTEAFF,2,0,1,2
TRBV12-3/4,TRBJ1-2,CASSWRDRAHYGYTF,2,0,1,2
TRBV6-2/3/5/6,TRBJ1-1,CASSYSAQGGTEAFF,2,0,1,2
TRBV6-2/3/5/6,TRBJ2-7,CASSYPAGVSYEQYF,2,0,1,2
TRBV7-9,TRBJ2-2,CASSLGTTNTGELFF,2,0,1,2
TRBV9,TRBJ2-1,CASSLSGRAENEQFF,2,0,1,2
TRBV12-3/4,TRBJ1-2,CASSPEAWGARGYTF,2,0,1,2
TRBV28,TRBJ1-2,CASSPEGSEGYGYTF,2,0,1,2
TRBV12-3/4,TRBJ2-7,CASSGLAGEGDEQYF,2,0,1,2
TRBV6-1,TRBJ2-2,CASSEDLRGTGELFF,2,0,1,2
TRBV2,TRBJ2-2,CASSEVEGGTGELFF,2,0,1,2
TRBV6-1,TRBJ1-1,CASSEDAGMNTEAFF,2,0,1,2
TRBV6-1,TRBJ1-5,CASSEEGNPRQPQHF,2,0,1,2
TRBV28,TRBJ1-1,CASSIVRTTNTEAFF,2,0,1,2
TRBV6-2/3/5/6,TRBJ1-1,CASSTGQIRTTEAFF,2,0,1,2
TRBV7-2,TRBJ1-1,CASSFGGGRNTEAFF,2,0,1,2
TRBV5-4,TRBJ1-1,CASSLSRHYNTEAFF,2,0,1,2
TRBV5-5,TRBJ2-1,CASSLLSGWDNEQFF,2,0,1,2
TRBV5-1,TRBJ2-7,CASSLVLAGGDEQYF,2,0,1,2
TRBV7-3,TRBJ2-6,CASSLTGVGANVLTF,2,0,1,2
TRBV5-4,TRBJ2-1,CASSLRTSGSVEQFF,2,0,1,2
TRBV7-3,TRBJ2-1,CASSLFSGGANEQFF,2,0,1,2
TRBV7-2,TRBJ2-7,CASSLVTNRRNEQYF,2,0,1,2
TRBV7-8,TRBJ2-3,CASSLVAGGTDTQYF,2,4,2,6
TRBV7-9,TRBJ2-7,CASSLALRGRLEQYF,2,0,1,2
TRBV13,TRBJ2-3,CASSLGSGVTDTQYF,2,0,1,2
TRBV7-2,TRBJ2-2,CASSLGQGAAGELFF,2,0,1,2
TRBV7-6,TRBJ2-1,CASSLGGTSYNEQFF,2,0,1,2
TRBV7-2,TRBJ2-7,CASSLGDSFFYEQYF,2,0,1,2
TRBV11-2,TRBJ1-1,CASSLGRSWGTEAFF,2,0,1,2
TRBV7-2,TRBJ2-2,CASSLDDSATGELFF,2,0,1,2
TRBV7-2,TRBJ2-7,CASSLDRTSGNKQYF,2,0,1,2
TRBV7-2,TRBJ2-3,CASSLDRISSDTQYF,2,0,1,2
TRBV5-6,TRBJ1-1,CASSSRTTEGTEAFF,2,0,1,2
TRBV5-6,TRBJ1-1,CASSSETGYDTEAFF,2,0,1,2
TRBV7-9,TRBJ2-7,CASSYTDYVSYEQYF,2,0,1,2
TRBV7-2,TRBJ2-7,CASSLGQGEGYEQYF,2,0,1,2
TRBV7-9,TRBJ2-5,CASSLGIAGQETQYF,2,0,1,2
TRBV9,TRBJ1-1,CASSLAPGLNTEAFF,2,0,1,2
TRBV9,TRBJ2-2,CASSLGAFLTGELFF,2,0,1,2
TRBV7-3,TRBJ2-7,CASSPSDGISYEQYF,2,0,1,2
TRBV7-9,TRBJ2-7,CASSPRGADSYEQYF,2,0,1,2
TRBV7-6,TRBJ2-3,CASSPRDRGTDTQYF,2,0,1,2
TRBV7-6,TRBJ1-1,CASSPRGGMNTEAFF,2,0,1,2
TRBV9,TRBJ2-1,CASSRGTGGYNEQFF,2,0,1,2
TRBV2,TRBJ2-6,CASSREGGEANVLTF,2,0,1,2
TRBV7-9,TRBJ2-1,CASSRTSGTYNEQFF,2,0,1,2
TRBV7-3,TRBJ2-1,CASSRGGPSNNEQFF,2,0,1,2
TRBV3-1,TRBJ1-1,CASSQSGQRNTEAFF,2,0,1,2
TRBV4-2,TRBJ2-7,CASSQAPSITLEQYF,2,0,1,2
TRBV14,TRBJ2-7,CASSQDIQGFYEQYF,2,0,1,2
TRBV14,TRBJ2-1,CASSQIGARVDEQFF,2,0,1,2
TRBV9,TRBJ2-3,CASSVQGGSTDTQYF,2,0,1,2
TRBV7-6,TRBJ2-7,CASSVGLAGVPEQYF,2,0,1,2
TRBV9,TRBJ2-3,CASSVDGRGPNTQYF,2,0,1,2
TRBV9,TRBJ1-4,CASSVEGGAGEKLFF,2,0,1,2
TRBV9,TRBJ2-5,CASSVRSSWGETQYF,2,20,2,22
TRBV9,TRBJ1-2,CASSAEGGDLYGYTF,2,0,1,2
TRBV7-9,TRBJ2-7,CASSETGSPLYEQYF,2,0,1,2
TRBV7-2,TRBJ1-1,CASSISGSVNTEAFF,2,0,1,2
TRBV12-3/4,TRBJ1-1,CASSTRPQAGPEAFF,2,0,1,2
TRBV12-3/4,TRBJ2-1,CASRSGGGVYNEQFF,2,0,1,2
TRBV6-2/3/5/6,TRBJ2-5,CASRYTSGDQETQYF,2,0,1,2
TRBV6-2/3/5/6,TRBJ1-4,CASRRAGGEDEKLFF,2,0,1,2
TRBV7-2,TRBJ2-1,CASRLGGGSEGEQFF,2,0,1,2
TRBV27,TRBJ2-6,CASRMGVSGANVLTF,2,0,1,2
TRBV6-2/3/5/6,TRBJ2-5,CASRISGGAGETQYF,2,0,1,2
TRBV6-1,TRBJ2-4,CASNGTELAKNIQYF,2,0,1,2
TRBV7-9,TRBJ1-2,CASNTRAPGAYGYTF,2,0,1,2
TRBV30,TRBJ1-4,CARSPSTGTNEKLFF,2,0,1,2
TRBV5-1,TRBJ2-3,CASSFQDRLRDTQYF,2,0,1,2
TRBV5-1,TRBJ2-1,CASSLGQGARNEQFF,2,0,1,2
TRBV5-1,TRBJ1-1,CASSLDVLMNTEAFF,2,0,1,2
TRBV5-1,TRBJ2-7,CASSLDGTGKDEQYF,2,0,1,2
TRBV5-1,TRBJ2-7,CASSLEVNRGCEQYF,2,0,1,2
TRBV5-1,TRBJ2-7,CASSLEAGGGYEQYF,2,0,1,2
TRBV5-1,TRBJ1-1,CASSLSSGQNTEAFF,2,0,1,2
TRBV5-1,TRBJ2-3,CASSSSGGRSDTQYF,2,0,1,2
TRBV5-1,TRBJ1-5,CASSSEGGGAEPQHF,2,0,1,2
TRBV5-1,TRBJ2-1,CASSLQGGTYNEQFF,2,0,1,2
TRBV4-3,TRBJ2-1,CASSPRGLAGYEQFF,2,0,1,2
TRBV5-1,TRBJ1-2,CASSPGPLVGYGYTF,2,0,1,2
TRBV5-1,TRBJ2-2,CASSPGQGGTGELFF,2,0,1,2
TRBV4-3,TRBJ2-7,CASSQDIGGSYEQYF,2,0,1,2
TRBV4-3,TRBJ1-1,CASSQEAGANTEAFF,2,0,1,2
TRBV4-1,TRBJ1-1,CASSQEGTLNTEAFF,2,0,1,2
TRBV4-3,TRBJ1-2,CASSQEGQAVYGYTF,2,0,1,2
TRBV4-3,TRBJ2-3,CASSQRRSSTDTQYF,2,0,1,2
TRBV4-1,TRBJ2-5,CASSQRQGGMQTQYF,2,0,1,2
TRBV5-1,TRBJ2-2,CASSAWPSNTGELFF,2,0,1,2
TRBV5-1,TRBJ2-7,CASSTTPTDSYEQYF,2,0,1,2
TRBV5-1,TRBJ2-5,CASRNKPSYQETQYF,2,0,1,2
TRBV4-3,TRBJ2-2,CASRPLREGIGELFF,2,0,1,2
TRBV20-1,TRBJ1-1,CSAFPDLTGNTDAFF,2,0,1,2
TRBV20-1,TRBJ2-7,CSAPTPSGRAGEQYF,2,0,1,2
TRBV20-1,TRBJ2-3,CSARDLFRGTDTQYF,2,0,1,2
TRBV20-1,TRBJ2-3,CSARDRQGAQDTQYF,2,0,1,2
TRBV20-1,TRBJ1-5,CSARENRGSAQPQHF,2,0,1,2
TRBV20-1,TRBJ2-3,CSANRLAVSTDTQYF,2,0,1,2
TRBV29-1,TRBJ1-4,CSVEGTTGENEKLFF,2,0,1,2
TRBV29-1,TRBJ2-1,CSVPEKGTKAWRQFF,2,0,1,2
TRBV29-1,TRBJ2-5,CSAARGGGAQETQYF,2,0,1,2
TRBV5-6,TRBJ2-5,SASSQGLAQETQYF,2,0,1,2
TRBV12-5,TRBJ2-7,CASGLHTGSYEQYF,2,0,1,2
TRBV7-7,TRBJ2-7,CASSSSDRAYEQYF,2,0,1,2
TRBV30,TRBJ2-1,CAWMLSGVHNEQFF,2,0,1,2
TRBV30,TRBJ2-7,CAWTPGQGPQEQYF,2,0,1,2
TRBV30,TRBJ2-3,CAWSRREDRDTQYF,2,0,1,2
TRBV30,TRBJ2-1,CAWSGHTRYNEQFF,2,0,1,2
TRBV19,TRBJ1-2,CAGIHPELDYGYTF,2,0,1,2
TRBV10-3,TRBJ2-7,CAISDGDVSYEQYF,2,0,1,2
TRBV10-3,TRBJ2-7,CAISNRDTSYEQYF,2,0,1,2
TRBV10-3,TRBJ2-3,CAISPSGSGDTQYF,2,0,1,2
TRBV10-3,TRBJ1-1,CAISGTGGNTEAFF,2,0,1,2
TRBV24-1,TRBJ2-3,CATFVDPGTDTQYF,2,0,1,2
TRBV19,TRBJ2-1,CATTRLHATGEQFF,2,0,1,2
TRBV15,TRBJ2-3,CATSRGQVTDTQYF,2,0,1,2
TRBV19,TRBJ2-2,CASERLAGAGELFF,2,0,1,2
TRBV19,TRBJ2-3,CASTKQGGTDTQYF,2,0,1,2
TRBV19,TRBJ2-5,CASSRTALQETQYF,2,0,1,2
TRBV19,TRBJ2-3,CASSRTDGTDTQYF,2,0,1,2
TRBV19,TRBJ2-1,CASRRLAGVDEQFF,2,0,1,2
TRBV7-9,TRBJ1-4,CASGTSGVDEKLFF,2,0,1,2
TRBV3-1,TRBJ2-5,CASTWDRSQETQYF,2,0,1,2
TRBV6-2/3/5/6,TRBJ2-5,CASTTTGGQETQYF,2,0,1,2
TRBV7-2,TRBJ2-5,CASTTYRTGETQYF,2,0,1,2
TRBV6-2/3/5/6,TRBJ2-3,CASSFAGVTDTQYF,2,0,1,2
TRBV28,TRBJ2-2,CASSLPPDTGELFF,2,0,1,2
TRBV27,TRBJ2-5,CASSLDRGTETQYF,2,0,1,2
TRBV6-2/3/5/6,TRBJ1-6,CASSLEQYNSPLHF,2,0,1,2
TRBV6-2/3/5/6,TRBJ1-2,CASSSSPPNYGYTF,2,0,1,2
TRBV6-2/3/5/6,TRBJ2-7,CASSSSSTGDEQYS,2,0,1,2
TRBV6-2/3/5/6,TRBJ2-3,CASSYGQDTDTQYF,2,0,1,2
TRBV9,TRBJ2-7,CASSRNPSDYEQYF,2,0,1,2
TRBV6-1,TRBJ2-3,CASSAHHRTDTQYF,2,0,1,2
TRBV6-1,TRBJ2-5,CASSGGTAFGTQYF,2,0,1,2
TRBV27,TRBJ2-2,CASSGQGGTGELFF,2,0,1,2
TRBV6-1,TRBJ1-5,CASSEGDSNQPQHF,2,2,2,4
TRBV25-1,TRBJ2-1,CASSEPGEANEQFF,2,0,1,2
TRBV25-1,TRBJ2-7,CASSNSGTAYEQYF,2,0,1,2
TRBV12-3/4,TRBJ2-3,CASSNRLGTDTQYF,2,0,1,2
TRBV7-2,TRBJ2-5,CASSFGSGFETQYF,2,0,1,2
TRBV7-2,TRBJ1-1,CASSFGQVNTEALF,2,0,1,2
TRBV5-4,TRBJ2-5,CASSLPGAQETQYF,2,0,1,2
TRBV7-2,TRBJ2-7,CASSLTSGAYEQYF,2,0,1,2
TRBV7-9,TRBJ2-1,CASSLVGPVHEQFF,2,0,1,2
TRBV7-6,TRBJ2-5,CASSLVQGRETQYF,2,0,1,2
TRBV7-8,TRBJ1-1,CASSLVVRNTEAFF,2,0,1,2
TRBV7-6,TRBJ2-3,CASSLALDTDTQYF,2,0,1,2
TRBV7-8,TRBJ2-7,CASSLGTSAYEQYF,2,0,1,2
TRBV7-2,TRBJ2-1,CASSLGGSLNEQFF,2,16,2,18
TRBV7-8,TRBJ2-3,CASSLMSLADTQYF,2,0,1,2
TRBV7-3,TRBJ1-1,CASSLTYKGTEAFF,2,0,1,2
TRBV7-3,TRBJ2-3,CASSLRSPLDTQYF,2,0,1,2
TRBV7-9,TRBJ2-7,CASSSNSGNYEQYF,2,0,1,2
TRBV7-9,TRBJ2-2,CASSSKLDTGELFF,2,0,1,2
TRBV11-2,TRBJ2-1,CASSSERAYNEQFF,2,0,1,2
TRBV7-6,TRBJ1-2,CASSSQGALYGYTF,2,0,1,2
TRBV6-2/3/5/6,TRBJ2-7,CASSLTGTIYEQYF,2,0,1,2
TRBV7-9,TRBJ2-3,CASSLTGRTDTQYF,2,0,1,2
TRBV7-9,TRBJ2-7,CASSLPGRTYEQYF,2,0,1,2
TRBV7-9,TRBJ2-7,CASSLTQATYEQYF,2,0,1,2
TRBV6-4,TRBJ2-1,CASSLKGQGTEQFF,2,0,1,2
TRBV5-6,TRBJ2-3,CASSPRGFTDTQYF,2,0,1,2
TRBV7-9,TRBJ1-2,CASSPGTQDYGYTF,2,0,1,2
TRBV3-1,TRBJ1-1,CASSPGQGMGEAFF,2,0,1,2
TRBV4-2,TRBJ2-7,CASSPDGAWGEQYF,2,0,1,2
TRBV7-9,TRBJ2-3,CASSPTLDSDTQYF,2,0,1,2
TRBV7-9,TRBJ2-7,CASSPSGTIYEQYF,2,0,1,2
TRBV7-2,TRBJ2-7,CASSPGQGLDEQYF,2,0,1,2
TRBV3-1,TRBJ1-5,CASSPDLGNQPQHF,2,0,1,2
TRBV12-3/4,TRBJ1-2,CASSRFGSSYGYTF,2,0,1,2
TRBV14,TRBJ2-7,CASSRQSISYEQYF,2,0,1,2
TRBV3-1,TRBJ1-4,CASSQSADNEKLFF,2,0,1,2
TRBV7-3,TRBJ2-7,CASSQGTGQSEQYF,2,0,1,2
TRBV3-1,TRBJ1-2,CASSQGSGYDGYTF,2,0,1,2
TRBV4-2,TRBJ1-5,CASSQGQGLEPQHF,2,0,1,2
TRBV4-2,TRBJ1-2,CASSQGTGDYGYTF,2,0,1,2
TRBV14,TRBJ2-5,CASSQDLGQETQYF,2,0,1,2
TRBV9,TRBJ1-1,CASSVGVAFTEAFF,2,0,1,2
TRBV7-9,TRBJ2-3,CASSGRQYTDTQYF,2,0,1,2
TRBV9,TRBJ2-1,CASSETGAYNEQFF,2,0,1,2
TRBV7-2,TRBJ1-4,CASSIAGANEKLFF,2,0,1,2
TRBV7-9,TRBJ2-1,CASSIGDIHNEQFF,2,0,1,2
TRBV5-5,TRBJ1-1,CASRLGQGKTEAFF,2,0,1,2
TRBV19,TRBJ2-3,CASRTSGSTDTQYF,2,0,1,2
TRBV6-2/3/5/6,TRBJ1-6,CASRFRDGNSPLHF,2,0,1,2
TRBV6-2/3/5/6,TRBJ2-5,CASRLVGRAETQYF,2,0,1,2
TRBV28,TRBJ1-1,CASNIDREGTEAFF,2,0,1,2
TRBV6-2/3/5/6,TRBJ1-5,CASNWDRVNQPQHF,2,0,1,2
TRBV7-9,TRBJ2-4,CASNPGQGAYIQYF,2,0,1,2
TRBV2,TRBJ1-4,CASKPGSTNEKLFF,2,0,1,2
TRBV7-2,TRBJ2-2,CASKGDRYTGELFF,2,0,1,2
TRBV5-1,TRBJ1-2,CASSPLPGSYGYTF,2,0,1,2
TRBV5-1,TRBJ2-1,CASMERLAAGGRFF,2,0,1,2
TRBV6-2/3/5/6,TRBJ1-1,CASSPGITDTEAFF,2,0,1,2
TRBV5-1,TRBJ2-5,CASSRSGVGETQYF,2,0,1,2
TRBV5-1,TRBJ2-7,CASSFSSGGHEQYF,2,0,1,2
TRBV5-1,TRBJ2-5,CASSLATGGGTQYF,2,0,1,2
TRBV5-1,TRBJ1-1,CASSLAQDNTEAFF,2,3,2,5
TRBV5-1,TRBJ2-1,CASSLGTADDEQFF,2,0,1,2
TRBV5-1,TRBJ1-1,CASSLDWANTEAFF,2,0,1,2
TRBV5-1,TRBJ2-5,CASSLEDNQETQYF,2,0,1,2
TRBV5-1,TRBJ2-6,CASSWGTGANVLTF,2,0,1,2
TRBV5-1,TRBJ2-3,CASSWGRNTDTQYF,2,0,1,2
TRBV4-3,TRBJ2-7,CASSLGTGGYEQYF,2,0,1,2
TRBV5-1,TRBJ1-1,CASSPGPSNTEAFF,2,0,1,2
TRBV4-1,TRBJ1-1,CASSQATGFTEAFF,2,0,1,2
TRBV4-3,TRBJ2-2,CASSQDRGPGELFF,2,0,1,2
TRBV4-1,TRBJ1-1,CASSQERVGTEAFL,2,0,1,2
TRBV5-1,TRBJ2-1,CASSARDSYNEQFF,2,0,1,2
TRBV5-1,TRBJ2-3,CASSGGQVADTQYF,2,9,2,11
TRBV5-1,TRBJ2-1,CASSSPSLYNEQFF,2,0,1,2
TRBV4-1,TRBJ2-4,CASSKGIEGDIQYL,2,0,1,2
TRBV20-1,TRBJ2-1,CSVGARSADNEQFF,2,0,1,2
TRBV20-1,TRBJ2-5,CSARRQGVQETQYF,2,0,1,2
TRBV20-1,TRBJ2-7,CSARGGSPGGEQYF,2,0,1,2
TRBV20-1,TRBJ2-5,CSARGARRQETQYF,2,0,1,2
TRBV20-1,TRBJ2-5,CSARRPGGMETQYF,2,0,1,2
TRBV20-1,TRBJ2-3,CSARLAGAVDTQYF,2,0,1,2
TRBV20-1,TRBJ2-5,CSAREFSGNPTQYF,2,0,1,2
TRBV20-1,TRBJ1-2,CSARRGASNYGYTF,2,0,1,2
TRBV20-1,TRBJ1-1,CSAEGQSDSTEAFF,2,0,1,2
TRBV29-1,TRBJ2-1,CSVGAGNNHNEQFF,2,0,1,2
TRBV29-1,TRBJ2-1,CSVEWTYTYNEQFF,2,0,1,2
TRBV29-1,TRBJ2-1,CSVEDWGRANEQFF,2,0,1,2
TRBV29-1,TRBJ1-2,CSVEEDVGDYGYTF,2,0,1,2
TRBV29-1,TRBJ1-1,CSVRTGVGYTEAFF,2,0,1,2
TRBV29-1,TRBJ2-1,CSIFNAAGANEQFF,2,0,1,2
TRBV28,TRBJ1-1,CALQGTLSTEAFF,2,0,1,2
TRBV12-5,TRBJ2-7,CASGLGPIWEQYF,2,0,1,2
TRBV12-3/4,TRBJ2-1,CASDSGDWNEQFF,2,0,1,2
TRBV7-9,TRBJ1-1,CASMGVLNTEAFF,2,0,1,2
TRBV30,TRBJ1-6,CAWSTGASSPLHF,2,0,1,2
TRBV30,TRBJ2-2,CAWGGSLTGELFF,2,0,1,2
TRBV30,TRBJ1-1,CAWTAPKGTEAFF,2,0,1,2
TRBV30,TRBJ1-2,CAWSFDRNYGYTF,2,0,1,2
TRBV30,TRBJ1-1,CAWSVSSRTEAFF,2,0,1,2
TRBV3-1,TRBJ2-2,CAIEDRASGELFF,2,0,1,2
TRBV24-1,TRBJ2-7,CATSSVSGDEQYF,2,0,1,2
TRBV19,TRBJ1-1,CASINRQNTEAFF,2,0,1,2
TRBV19,TRBJ1-5,CASTAMGNQPQHF,2,0,1,2
TRBV19,TRBJ2-3,CASSAGAGDTQYF,2,0,1,2
TRBV19,TRBJ1-1,CASSMTGNTEAFF,2,0,1,2
TRBV18,TRBJ2-7,CASSPSGGGEQYF,2,0,1,2
TRBV6-2/3/5/6,TRBJ1-2,CASRLGLGGGYTF,2,0,1,2
TRBV19,TRBJ1-5,CASHDRVNQPQHF,2,0,1,2
TRBV12-3/4,TRBJ1-2,CASARRGAYGYTF,2,0,1,2
TRBV6-2/3/5/6,TRBJ2-1,CASALAPLNEQFF,2,0,1,2
TRBV12-3/4,TRBJ1-1,CASTLLGDTEAFF,2,0,1,2
TRBV27,TRBJ1-1,CASSFRGPTEAFF,2,0,1,2
TRBV12-3/4,TRBJ2-5,CASSLASEETQYF,2,0,1,2
TRBV12-3/4,TRBJ2-1,CASSLATGAEQFF,2,0,1,2
TRBV6-2/3/5/6,TRBJ1-4,CASSSWGDEKLFF,2,0,1,2
TRBV6-2/3/5/6,TRBJ1-2,CASSSGRPQGYTF,2,0,1,2
TRBV6-2/3/5/6,TRBJ2-5,CASSSLGTRTQYF,2,0,1,2
TRBV12-3/4,TRBJ2-2,CASSWGSRGELFF,2,0,1,2
TRBV6-2/3/5/6,TRBJ1-1,CASSYGQGTEAFF,2,0,1,2
TRBV12-3/4,TRBJ1-2,CASSPRLDYGYTF,2,0,1,2
TRBV12-3/4,TRBJ2-2,CASSPPYTGELFF,2,22,2,24
TRBV6-2/3/5/6,TRBJ2-7,CASSPTWAYEQYF,2,0,1,2
TRBV28,TRBJ1-1,CASSPGSNTEAFF,2,0,1,2
TRBV6-2/3/5/6,TRBJ1-2,CASSPDRRYGYTF,2,0,1,2
TRBV13,TRBJ2-1,CASSPGSYNEQFF,2,6,2,8
TRBV6-2/3/5/6,TRBJ2-7,CASSRGGPYEQYF,2,0,1,2
TRBV2,TRBJ2-4,CASSEGQKNIQYF,2,0,1,2
TRBV6-1,TRBJ2-5,CASSELQKETQYF,2,0,1,2
TRBV11-2,TRBJ2-7,CASSFGPDRGRYF,2,0,1,2
TRBV11-2,TRBJ2-1,CASSFGTKDEQFF,2,0,1,2
TRBV5-4,TRBJ2-3,CASSLGRSDTQYF,2,0,1,2
TRBV7-2,TRBJ2-7,CASSLTASYEQYF,2,0,1,2
TRBV7-9,TRBJ1-2,CASSLSENYGYTF,2,0,1,2
TRBV7-2,TRBJ2-7,CASSLVAFYEQYF,2,0,1,2
TRBV7-9,TRBJ2-7,CASSLAGAYELYF,2,0,1,2
TRBV7-2,TRBJ2-7,CASSLGRYYEQYF,2,4,2,6
TRBV7-2,TRBJ2-7,CASSLGRSYEQYF,2,0,1,2
TRBV7-2,TRBJ2-7,CASSLGRDYEQYF,2,0,1,2
TRBV7-9,TRBJ2-1,CASSLGGANEQFF,2,0,1,2
TRBV11-2,TRBJ2-5,CASSLDTMETQYF,2,0,1,2
TRBV7-2,TRBJ2-3,CASSLNKADTQYF,2,0,1,2
TRBV11-1,TRBJ2-1,CASSSGSLNEQFF,2,4,2,6
TRBV11-1,TRBJ1-2,CASSLTGNYGYTF,2,0,1,2
TRBV7-2,TRBJ1-2,CASSPLGGYGYTF,2,0,1,2
TRBV3-1,TRBJ1-1,CASSPSQGTEAFF,2,0,1,2
TRBV11-1,TRBJ2-1,CASSPYTYNEQFF,2,0,1,2
TRBV5-6,TRBJ2-7,CASSPAGSYEQYF,2,0,1,2
TRBV7-9,TRBJ2-3,CASSPGGTDTRYF,2,0,1,2
TRBV3-1,TRBJ2-5,CASSRTPPETQYF,2,0,1,2
TRBV3-1,TRBJ2-5,CASSRGGTETQYF,2,0,1,2
TRBV7-2,TRBJ2-3,CASSHGGQGTQYF,2,0,1,2
TRBV3-1,TRBJ2-3,CASSQATADTQYF,2,0,1,2
TRBV28,TRBJ1-5,CASSQSTGQPQHF,2,0,1,2
TRBV7-2,TRBJ2-5,CASSQPGQETQYF,2,5,2,7
TRBV3-1,TRBJ1-5,CASSQAGGKPQHF,2,0,1,2
TRBV14,TRBJ1-5,CASSQKGNQPQHF,2,0,1,2
TRBV11-2,TRBJ1-1,CASSGQRNTEAFF,2,0,1,2
TRBV7-9,TRBJ1-2,CASSGETNYVYTF,2,0,1,2
TRBV7-6,TRBJ1-2,CASSRTGTDGYTF,2,0,1,2
TRBV12-3/4,TRBJ1-2,CASSKGHFGDYTF,2,0,1,2
TRBV3-1,TRBJ2-7,CASSKGWRGEQYF,2,0,1,2
TRBV6-4,TRBJ2-7,CASRGLDSWEQYF,2,0,1,2
TRBV6-2/3/5/6,TRBJ2-1,CASRGQGGNEQFF,2,0,1,2
TRBV2,TRBJ2-7,CASRNRGPYEQYF,2,0,1,2
TRBV6-2/3/5/6,TRBJ1-1,CASRWGQNTEAFF,2,0,1,2
TRBV14,TRBJ2-3,CASRLGGRDTQYF,2,0,1,2
TRBV7-2,TRBJ2-5,CASRGTGRETQYF,2,0,1,2
TRBV6-2/3/5/6,TRBJ1-1,CASRTRDSTEAFF,2,0,1,2
TRBV6-2/3/5/6,TRBJ2-7,CASNPPGGYEQYF,2,0,1,2
TRBV4-2,TRBJ2-1,CASNRAGNNEQFF,2,0,1,2
TRBV5-1,TRBJ2-5,CASSLAERETQYF,2,0,1,2
TRBV5-1,TRBJ2-2,CASSLGFTGELFF,2,0,1,2
TRBV5-1,TRBJ2-5,CASSWLGSQTQYF,2,0,1,2
TRBV5-1,TRBJ2-7,CASSYQGSGEQYF,2,0,1,2
TRBV4-3,TRBJ1-1,CASSQARGNEAFF,2,0,1,2
TRBV4-3,TRBJ2-3,CASSQAVDNTQYF,2,0,1,2
TRBV20-1,TRBJ1-3,CSASLYSGNTIYF,2,0,1,2
TRBV20-1,TRBJ1-5,CSARYTGGQPQHF,2,0,1,2
TRBV20-1,TRBJ2-7,CSARDNWGVEQYF,2,0,1,2
TRBV20-1,TRBJ2-5,CSAKGPGQETQYF,2,0,1,2
TRBV20-1,TRBJ2-4,CSALPPDKNIQYF,2,0,1,2
TRBV29-1,TRBJ1-5,CSVVGQYFSAQHF,2,0,1,2
TRBV29-1,TRBJ1-1,CSVDRAGDTEAFF,2,0,1,2
TRBV29-1,TRBJ2-5,CSVERQGGGTQYF,2,0,1,2
TRBV29-1,TRBJ1-4,CSVMGQFNEKLFF,2,0,1,2
TRBV29-1,TRBJ2-5,CSVPRGGGETQYF,2,0,1,2
TRBV29-1,TRBJ2-1,CSGRRSGEVELFF,2,0,1,2
TRBV7-9,TRBJ1-1,RASRQRQNTEAFF,2,0,1,2
TRBV29-1,TRBJ1-1,SSVKTGGDTEAFF,2,0,1,2
TRBV30,TRBJ2-7,CASNLGTYEQYF,2,0,1,2
TRBV30,TRBJ2-7,CASRTENYEQYF,2,3,2,5
TRBV30,TRBJ2-2,CACTLPPGELFF,2,0,1,2
TRBV30,TRBJ2-2,CAWGDRPGELFF,2,0,1,2
TRBV30,TRBJ2-3,CAWSPFGDTQYF,2,0,1,2
TRBV30,TRBJ2-6,CAYLRGANVLTF,2,0,1,2
TRBV30,TRBJ2-6,CAEDSGANVLTF,2,0,1,2
TRBV19,TRBJ1-1,CASALRNTEAFF,2,0,1,2
TRBV19,TRBJ2-5,CASSLGRETQYF,2,0,1,2
TRBV12-3/4,TRBJ1-2,CASSLAQPGYTF,2,0,1,2
TRBV12-3/4,TRBJ1-1,CASSLRRGIAFF,2,0,1,2
TRBV6-2/3/5/6,TRBJ1-5,CASSYPFQPQHF,2,0,1,2
TRBV7-2,TRBJ1-1,CASSPSFGSAFF,2,0,1,2
TRBV6-2/3/5/6,TRBJ2-1,CASSPEWSEQFF,2,0,1,2
TRBV2,TRBJ2-1,CASSVAGNEQFF,2,0,1,2
TRBV6-1,TRBJ2-1,CASSDGVRGQFF,2,0,1,2
TRBV7-2,TRBJ2-1,CASSFSYNEQFF,2,0,1,2
TRBV7-9,TRBJ2-7,CASSFGLYEQYF,2,0,1,2
TRBV5-5,TRBJ2-3,CASSFDPDTQYF,2,0,1,2
TRBV5-6,TRBJ2-5,CASSLRPGAQYF,2,0,1,2
TRBV7-9,TRBJ1-2,CASSLIMNGYTF,2,0,1,2
TRBV7-2,TRBJ2-7,CASSLASGRGYF,2,0,1,2
TRBV11-3,TRBJ2-5,CASSLDGETQYF,2,0,1,2
TRBV10-3,TRBJ2-3,CASSLPRDTQYF,2,6,2,8
TRBV5-4,TRBJ2-7,CASSPDSYEQYF,2,0,1,2
TRBV11-1,TRBJ2-7,CASSPDRYEQYF,2,0,1,2
TRBV6-2/3/5/6,TRBJ1-6,CASSRQEAPLHF,2,0,1,2
TRBV11-2,TRBJ2-4,CASSRTPEVQYF,2,0,1,2
TRBV3-1,TRBJ2-1,CASSQARREEFF,2,0,1,2
TRBV13,TRBJ2-5,CASSVGQETQYF,2,0,1,2
TRBV9,TRBJ2-1,CASSVLNNEQFF,2,0,1,2
TRBV9,TRBJ2-3,CASSVQGEAQYF,2,0,1,2
TRBV6-2/3/5/6,TRBJ2-3,CASSASGDTQYF,2,0,1,2
TRBV13,TRBJ2-7,CASSGRVDEQYF,2,0,1,2
TRBV7-2,TRBJ2-7,CASSTTSYEQYF,2,0,1,2
TRBV27,TRBJ1-5,CASRQGSQPQHF,2,0,1,2
TRBV6-2/3/5/6,TRBJ1-4,CASRGQGEKLFF,2,0,1,2
TRBV2,TRBJ2-7,CASRGGPSEQYF,2,0,1,2
TRBV5-1,TRBJ2-4,CASSPQGNIQYF,2,0,1,2
TRBV4-1,TRBJ2-7,CASSQEFGEQYF,2,0,1,2
TRBV9,TRBJ1-5,CASSVDRRPQHF,2,0,1,2
TRBV5-1,TRBJ1-2,CASSETGDGYTF,2,0,1,2
TRBV5-1,TRBJ2-1,CASSTSAYEQFF,2,0,1,2
TRBV20-1,TRBJ2-1,CSALGGGYEQFF,2,0,1,2
TRBV20-1,TRBJ2-2,CSAPTSSGELFF,2,0,1,2
TRBV20-1,TRBJ1-1,CSAPRTGLGAFF,2,0,1,2
TRBV29-1,TRBJ2-2,CSVFRPTGELFF,2,0,1,2
TRBV29-1,TRBJ2-7,CSVVLYLAEQYF,2,0,1,2
TRBV29-1,TRBJ2-5,CSVDSGVQTQYF,2,0,1,2
TRBV29-1,TRBJ2-7,CSVDLGSYEQYF,2,0,1,2
TRBV29-1,TRBJ1-2,CSVDRDGPSYTF,2,0,1,2
TRBV29-1,TRBJ1-1,CSVEKGETEAFF,2,0,1,2
TRBV29-1,TRBJ2-5,CSVTGGLETQYF,2,0,1,2
TRBV29-1,TRBJ1-1,CSVRTGPAEAFF,2,0,1,2
TRBV29-1,TRBJ2-2,CSVGDGTGELFF,2,0,1,2
TRBV29-1,TRBJ2-5,CSVTVSRETQYF,2,0,1,2
TRBV29-1,TRBJ1-3,CSAGSGGNTIYF,2,0,1,2
TRBV28,TRBJ1-2,CSTGALYGYTF,2,0,1,2
TRBV18,TRBJ2-5,CASSPQETQYF,2,0,1,2
TRBV2,TRBJ2-1,CASMRAGEQFF,2,0,1,2
TRBV3-1,TRBJ2-5,CASSVQETQYF,2,0,1,2
TRBV7-9,TRBJ2-1,CASSLAYEQFF,2,0,1,2
TRBV7-6,TRBJ2-1,CASSLGNEQFF,2,0,1,2
TRBV14,TRBJ1-1,CASSLQGEDFF,2,0,1,2
TRBV7-9,TRBJ2-7,CASSQLNEQYF,2,0,1,2
TRBV7-9,TRBJ2-7,CASSVEYEQYF,2,0,1,2
TRBV5-1,TRBJ2-7,CASSSDYEQYF,2,0,1,2
TRBV29-1,TRBJ2-7,CSVGRGNEQYF,2,0,1,2
TRBV20-1,TRBJ2-5,CSAIVQETQYF,2,0,1,2
TRBV20-1,TRBJ2-3,CSEGTRDTQYF,2,0,1,2
TRBV29-1,TRBJ1-3,CSVRQGNTIYF,2,0,1,2
TRBV29-1,TRBJ1-2,CSVGDLYGYTF,2,0,1,2
TRBV29-1,TRBJ2-1,CSATGGHEQFF,2,0,1,2
TRBV13,TRBJ1-1,CASGTQRAFF,2,0,1,2
TRBV4-3,TRBJ2-7,CATLFGEQYF,2,0,1,2
TRBV29-1,TRBJ1-5,CSVRDQEGTQPQHF,2,0,1,2
TRBV5-6,TRBJ2-3,CASSSGLGSDTQYF,0,153,1,153
TRBV7-2,TRBJ2-7,CASSSYYEQYF,0,103,1,103
TRBV2,TRBJ1-5,CASSGQSGGNQPQHF,0,54,1,54
TRBV29-1,TRBJ1-1,CSARTGKGTEAFF,0,36,1,36
TRBV7-9,TRBJ2-7,CASSLTVGGRGNEQYF,0,36,1,36
TRBV24-1,TRBJ2-7,CATSDLWEQYF,0,31,1,31
TRBV11-2,TRBJ2-1,CASSLASNSEQFF,0,27,1,27
TRBV7-9,TRBJ1-1,CASSLRWTGSSGTEAFF,0,27,1,27
TRBV13,TRBJ1-1,CASSPGTAEAFF,0,26,1,26
TRBV7-2,TRBJ2-5,CASSPPGGGRETQYF,0,22,1,22
TRBV29-1,TRBJ2-7,CSVETPGQPHYEQYF,0,22,1,22
TRBV3-1,TRBJ2-2,CASSPELRLAVAGELFF,0,22,1,22
TRBV29-1,TRBJ1-1,CSVEKNKNTEAFF,0,21,1,21
TRBV7-9,TRBJ1-1,CASQDRYTEAFF,0,21,1,21
TRBV10-1,TRBJ2-2,CASSESDTGELFF,0,21,1,21
TRBV7-9,TRBJ1-5,CSSSLDTQPQHF,0,21,1,21
TRBV11-3,TRBJ2-3,CASSFEGGSFTDTQYF,0,20,1,20
TRBV5-1,TRBJ1-1,CASSLGQNTEAFF,0,24,1,24
TRBV12-3/4,TRBJ1-1,CASSFQGIIWTEAFF,0,20,1,20
TRBV20-1,TRBJ2-5,CSARELFQETQYF,0,19,1,19
TRBV12-3/4,TRBJ1-5,CASSWHRGRVAQPQHF,0,18,1,18
TRBV14,TRBJ2-2,CASSLGTLANTGELFF,0,18,1,18
TRBV7-2,TRBJ2-7,CASSLFQGESYEQYF,0,18,1,18
TRBV5-1,TRBJ2-1,CASSSLAGINNEQFF,0,18,1,18
TRBV5-6,TRBJ1-5,CASSLDNRREYQHF,0,18,1,18
TRBV20-1,TRBJ2-5,CSARVQETQYF,0,18,1,18
TRBV4-2,TRBJ1-2,CASSQGTGPYGYTF,0,18,1,18
TRBV2,TRBJ2-5,CASSVEGEGETQYI,0,18,1,18
TRBV7-3,TRBJ1-1,CASSLSRVINTEAFF,0,17,1,17
TRBV20-1,TRBJ2-1,CSARDLDSDYNEQFF,0,17,1,17
TRBV29-1,TRBJ2-6,CSVEVYGRDPVLTF,0,17,1,17
TRBV5-6,TRBJ2-7,CASSLLGPYEQYF,0,17,1,17
TRBV7-2,TRBJ2-3,CASSPQTTDTQYF,0,17,1,17
TRBV19,TRBJ2-3,CASEDRGRGADTQYF,0,17,1,17
TRBV13,TRBJ1-1,CASSLTFELFF,0,17,1,17
TRBV14,TRBJ2-1,CASSQDPARLAGASPRNEQFF,0,17,1,17
TRBV14,TRBJ2-1,CASSPGQRSYNEQFF,0,16,1,16
TRBV29-1,TRBJ2-7,CSVGRGTYEQYF,0,16,1,16
TRBV12-3/4,TRBJ2-5,CASTPNQETQYF,0,15,1,15
TRBV7-9,TRBJ2-1,CASRSKERGSSYNEQFF,0,15,1,15
TRBV5-1,TRBJ1-1,CASSLSGQGTTEAFF,0,15,1,15
TRBV14,TRBJ1-1,CASSLEVSRAEAFF,0,15,1,15
TRBV3-1,TRBJ2-7,CASSQGQGTYEQYF,0,15,1,15
TRBV12-3/4,TRBJ1-5,CASSGRENQPQHF,0,15,1,15
TRBV19,TRBJ1-1,CASRPWDRANTEAFF,0,14,1,14
TRBV19,TRBJ2-1,CASSIVGANNEQFF,0,14,1,14
TRBV12-3/4,TRBJ1-5,CASSSHRSLEPQHF,0,14,1,14
TRBV20-1,TRBJ1-5,CSASPGQGDQPQHF,0,14,1,14
TRBV12-3/4,TRBJ2-2,CASSDSNTGELFF,0,14,1,14
TRBV5-6,TRBJ1-2,CASSLNRDYGYTF,0,14,1,14
TRBV3-1,TRBJ1-2,CASSRIGGYGYTF,0,14,1,14
TRBV20-1,TRBJ1-1,CSALPGVNTEAFF,0,14,1,14
TRBV9,TRBJ2-3,CASSVSTDTQYF,0,14,1,14
TRBV29-1,TRBJ2-7,CSVYETGNEQYF,0,14,1,14
TRBV7-9,TRBJ2-5,CASSTGGFETQYF,0,14,1,14
TRBV20-1,TRBJ2-5,CSARAGDRKESQYF,0,13,1,13
TRBV12-3/4,TRBJ1-4,CASSWGMAEKLFF,0,13,1,13
TRBV5-1,TRBJ1-2,CASSGGHNYGYTL,0,13,1,13
TRBV11-3,TRBJ2-4,CASSLDEASGNIQYF,0,13,1,13
TRBV19,TRBJ2-1,CASSMGRGTSYNEQFF,0,13,1,13
TRBV6-2/3/5/6,TRBJ2-3,CASSYFGMTSADTQYF,0,13,1,13
TRBV12-3/4,TRBJ1-5,CASSPPGQGFGQPQHF,0,13,1,13
TRBV5-4,TRBJ2-3,CASSSDRTSTDTQYF,0,13,1,13
TRBV11-2,TRBJ2-5,CASSLDRGARKTQYF,0,13,1,13
TRBV29-1,TRBJ1-1,CSLADVGTGRTEAFF,0,13,1,13
TRBV5-4,TRBJ2-5,CASRADTRQETQYF,0,13,1,13
TRBV12-3/4,TRBJ2-3,CASTHDWEGTQYF,0,13,1,13
TRBV13,TRBJ2-7,CASSLVYSYEQYF,0,13,1,13
TRBV2,TRBJ1-1,CASSGEAPEAFF,0,13,1,13
TRBV9,TRBJ2-3,CASSERGGRVADTQYF,0,12,1,12
TRBV29-1,TRBJ2-6,CSVLSERQGATGANVLTF,0,12,1,12
TRBV5-1,TRBJ2-3,CASSLTRGGTDTQYF,0,12,1,12
TRBV19,TRBJ1-1,CASSIDGWGAGTEAFF,0,12,1,12
TRBV7-9,TRBJ2-3,CASSLVSGAGTDTQYF,0,12,1,12
TRBV12-3/4,TRBJ1-5,CASSSTRQYSNQPQHS,0,12,1,12
TRBV5-1,TRBJ2-1,CASSLGREGLYNEQFF,0,12,1,12
TRBV30,TRBJ2-1,CAWSAGTSPHNEQFF,0,12,1,12
TRBV6-4,TRBJ1-5,CASRGQGDSNQPQHF,0,12,1,12
TRBV5-1,TRBJ2-2,CASSPGTGDTGELFF,0,12,1,12
TRBV4-3,TRBJ2-5,CASSHGTGGKETQYF,0,12,1,12
TRBV19,TRBJ2-2,CASSGGGGTGELFF,0,12,1,12
TRBV18,TRBJ1-5,CASSPSDSNQPQHF,0,12,1,12
TRBV9,TRBJ2-3,CASSVGDFQRPQYF,0,12,1,12
TRBV20-1,TRBJ2-1,CSAGRGADYNEQFF,0,12,1,12
TRBV12-3/4,TRBJ2-7,CASSLGTGGEQYF,0,12,1,12
TRBV12-5,TRBJ1-1,CASGPGGSEAFF,0,12,1,12
TRBV6-2/3/5/6,TRBJ2-7,CASSYSWDEQYF,0,12,1,12
TRBV6-1,TRBJ2-1,CASSEFGYEQFF,0,12,1,12
TRBV5-6,TRBJ2-1,CASSLGALPWIF,0,12,1,12
TRBV3-1,TRBJ2-7,CASSQDSTLSYF,0,12,1,12
TRBV29-1,TRBJ2-5,CSVGWGQKTQYF,0,12,1,12
TRBV29-1,TRBJ2-7,CSVEGSYEQYF,0,12,1,12
TRBV29-1,TRBJ2-3,CSVEGADTQYF,0,12,1,12
TRBV19,TRBJ2-6,CASRSGQGAPGANVLTF,0,12,1,12
TRBV13,TRBJ2-7,CASSRPPPYTLSYEQYF,0,11,1,11
TRBV24-1,TRBJ2-3,CATSEGAGFSPDTQYF,0,11,1,11
TRBV12-3/4,TRBJ1-2,CASSFYNRGVNYGYTF,0,11,1,11
TRBV7-9,TRBJ2-3,CASSFGASGGSDTQYF,0,11,1,11
TRBV13,TRBJ2-6,CASSSWTGNGANVLTF,0,11,1,11
TRBV30,TRBJ1-4,CACQVPGATNEKLFF,0,11,1,11
TRBV24-1,TRBJ1-5,CATSFHIYSNQPQHF,0,11,1,11
TRBV12-3/4,TRBJ1-5,CASGSGTGGSQPQHF,0,11,1,11
TRBV27,TRBJ1-1,CASSPETRRNTEAFF,0,11,1,11
TRBV5-1,TRBJ2-1,CASSLEAGVGNEQFF,0,11,1,11
TRBV20-1,TRBJ2-3,CSARGGGGGTDTQYF,0,11,1,11
TRBV19,TRBJ1-1,CASSIRQGGTEAFF,0,11,1,11
TRBV5-5,TRBJ1-1,CASSWTGTNTEAFF,0,11,1,11
TRBV2,TRBJ1-4,CASRPLIQGEKLFF,0,11,1,11
TRBV5-1,TRBJ2-7,CASSREGQAYEQYF,0,11,1,11
TRBV20-1,TRBJ1-2,CSASIQGSYLSYTF,0,11,1,11
TRBV30,TRBJ1-5,CAWSVTLNQPQHF,0,11,1,11
TRBV24-1,TRBJ1-1,CATSATALTEAFF,0,11,1,11
TRBV12-3/4,TRBJ2-1,CASSTRDYNEQFF,0,11,1,11
TRBV7-2,TRBJ2-3,CASSPGNTDTQYF,0,11,1,11
TRBV5-1,TRBJ2-3,CASSLWYRDTQYF,0,11,1,11
TRBV29-1,TRBJ1-6,CSVGDSGDSPLHF,0,11,1,11
TRBV28,TRBJ1-2,CASSSTVYGYTF,0,11,1,11
TRBV7-9,TRBJ2-7,CASSSGQGSQYF,0,11,1,11
TRBV11-2,TRBJ1-1,CASRNTEAFF,0,11,1,11
TRBV12-3/4,TRBJ2-7,CASSLFSYEQYF,0,11,1,11
TRBV5-4,TRBJ1-1,CASSLVGGRNTEAFF,0,11,1,11
TRBV30,TRBJ1-4,CAWRGTETYEKLFF,0,11,1,11
TRBV27,TRBJ2-3,CASSLAGGPDTQYF,0,11,1,11
TRBV19,TRBJ2-2,CASSIFSGELFF,0,11,1,11
TRBV20-1,TRBJ2-6,CSATGQGSGANVLTF,0,11,1,11
TRBV2,TRBJ2-4,CASSPTSLGVQYF,0,11,1,11
TRBV5-6,TRBJ2-7,CASSSTGPKRYEQYF,0,11,1,11
TRBV9,TRBJ2-6,CASSGTGLRAGANVLTF,0,11,1,11
TRBV11-3,TRBJ2-1,CASSSAGETYNEQFF,0,11,1,11
TRBV2,TRBJ1-4,CASSDPRNRGQREKLFF,0,10,1,10
TRBV14,TRBJ2-7,CASSPKASGTNRYEQYF,0,10,1,10
TRBV5-1,TRBJ2-5,CASSPDGTSVLQETQYF,0,10,1,10
TRBV19,TRBJ2-1,CASSASLGGSYNEQFF,0,10,1,10
TRBV12-3/4,TRBJ1-5,CASSLGRIWEGQPQHF,0,10,1,10
TRBV12-3/4,TRBJ1-4,CASSLIGGSTNEKLFF,0,10,1,10
TRBV11-2,TRBJ1-1,CASSLDLGGKNTEAFF,0,10,1,10
TRBV5-4,TRBJ1-2,CASSLVEALNYGYTF,0,10,1,10
TRBV6-1,TRBJ2-7,CASSAAGTGNYEQYF,0,10,1,10
TRBV9,TRBJ2-3,CASSDRQGAEDTQYF,0,10,1,10
TRBV11-1,TRBJ2-3,CASSSWTGSEDTQYF,0,10,1,10
TRBV6-2/3/5/6,TRBJ1-5,CASRYRGYDHQPQHF,0,10,1,10
TRBV20-1,TRBJ2-3,CSARVGVWGTDTQYF,0,10,1,10
TRBV29-1,TRBJ2-7,CSVLTGTGDPYEQYF,0,10,1,10
TRBV29-1,TRBJ2-1,CSVGRREAWDNEQFL,0,10,1,10
TRBV12-3/4,TRBJ2-2,CATTRTSVGGELFF,0,10,1,10
TRBV19,TRBJ2-3,CASSRFQGSDTQYF,0,10,1,10
TRBV12-3/4,TRBJ2-7,CASSLVGSSYEQYF,0,10,1,10
TRBV6-2/3/5/6,TRBJ2-3,CASSYTIRGDTQYF,0,10,1,10
TRBV2,TRBJ1-2,CASSVGRGAYGYTF,0,10,1,10
TRBV11-2,TRBJ2-7,CASSLSLVGYEQYF,0,10,1,10
TRBV7-2,TRBJ1-1,CASSSRAGRTEAFF,0,10,1,10
TRBV6-2/3/5/6,TRBJ2-1,CASRGTGYYNEQFF,0,10,1,10
TRBV4-1,TRBJ2-4,CASSQDISENIQYF,0,10,1,10
TRBV20-1,TRBJ2-1,CSARDLGSYNEQFF,0,10,1,10
TRBV20-1,TRBJ2-2,CSAREGMGTGELFF,0,10,1,10
TRBV30,TRBJ1-1,CAWSIQVNTEAFF,0,10,1,10
TRBV19,TRBJ1-1,CASSINRNTEAFF,0,10,1,10
TRBV6-2/3/5/6,TRBJ2-1,CASSFGPVDEQFF,0,10,1,10
TRBV6-1,TRBJ1-4,CASSRQGFEKLFF,0,10,1,10
TRBV2,TRBJ2-7,CASSDSFPYEQYF,0,10,1,10
TRBV9,TRBJ1-1,CASSGPGFQEAFF,0,10,1,10
TRBV10-1,TRBJ2-3,CASSESLADTQYF,0,10,1,10
TRBV5-1,TRBJ2-7,CASSSGTGYEQYF,0,10,1,10
TRBV20-1,TRBJ1-1,CSAPLVSRPEAFF,0,10,1,10
TRBV29-1,TRBJ1-2,CSAERTTNYGYTF,0,10,1,10
TRBV20-1,TRBJ1-1,CSASLRVTEAFF,0,10,1,10
TRBV29-1,TRBJ1-1,CSVLGGNTEAFF,0,10,1,10
TRBV7-2,TRBJ1-4,CASSLAEKLFF,0,10,1,10
TRBV5-8,TRBJ2-3,CASSPQGFSTDTQYF,0,10,1,10
TRBV20-1,TRBJ2-7,CSARGAGGGLYEQYF,0,10,1,10
TRBV7-6,TRBJ2-7,SASSLALGVHEQYF,0,10,1,10
TRBV18,TRBJ1-1,RASGRLNTEAFF,0,9,1,9
TRBV19,TRBJ1-1,CASSRYLGGFEETAGRTEAFF,0,9,1,9
TRBV19,TRBJ2-3,CASSTNPPSGGIPDTQYF,0,9,1,9
TRBV12-3/4,TRBJ1-5,CASSARGTNVYSNQPQHF,0,9,1,9
TRBV20-1,TRBJ2-3,CSARAGLAGDGYTDTQYF,0,9,1,9
TRBV5-8,TRBJ2-1,CASSLAEGSGDPNEQFF,0,9,1,9
TRBV5-1,TRBJ2-1,CASTWGPPTDSYNEQFF,0,9,1,9
TRBV5-1,TRBJ2-7,CASSLYVSRDSNYEQYF,0,9,1,9
TRBV12-5,TRBJ2-1,CASVMGLAGGGNEQFF,0,9,1,9
TRBV19,TRBJ2-1,CASSIYYSSTYNEQFF,0,9,1,9
TRBV19,TRBJ1-1,CASSIVVAGWGTEAFF,0,9,1,9
TRBV27,TRBJ1-5,CASSPQQGSSNQPQHF,0,9,1,9
TRBV12-3/4,TRBJ2-3,CASSPSSGSLTDTQYF,0,9,1,9
TRBV28,TRBJ2-5,CASSPQRAGGLETQYF,0,9,1,9
TRBV7-8,TRBJ1-1,CASSPPSGTGKTEAFF,0,9,1,9
TRBV4-3,TRBJ2-1,CASSQVPAGDTGEQFF,0,9,1,9
TRBV12-3/4,TRBJ1-2,CASSLVPGPNYGYTF,0,9,1,9
TRBV6-2/3/5/6,TRBJ1-5,CASSYFGQGNQPQHF,0,9,1,9
TRBV28,TRBJ2-7,CASSYPPRGHYEQYF,0,9,1,9
TRBV2,TRBJ2-1,CASSERSQGTHEQFF,0,9,1,9
TRBV5-5,TRBJ2-1,CASSLAPGQGKEQFF,0,9,1,9
TRBV7-2,TRBJ2-5,CASSPSGFGWETQYF,0,9,1,9
TRBV2,TRBJ2-1,CASSPGDGRNNEQFF,0,9,1,9
TRBV3-1,TRBJ1-2,CASSQDFQGGYGYTF,0,9,1,9
TRBV10-1,TRBJ2-3,CASSAGGGISDTQYF,0,9,1,9
TRBV5-1,TRBJ2-1,CASSLGHLSYNEQFF,0,9,1,9
TRBV29-1,TRBJ1-2,CSVGTGDNTNYGYTF,0,9,1,9
TRBV18,TRBJ2-1,CASSPPSGDNEQFF,0,9,1,9
TRBV27,TRBJ2-5,CASSLLGQKETQYF,0,9,1,9
TRBV28,TRBJ2-7,CASSLLVGTYEQYF,0,9,1,9
TRBV11-3,TRBJ1-1,CASSFGQMNTEAFF,0,9,1,9
TRBV7-2,TRBJ2-5,CASSLGRRQETQYF,0,9,1,9
TRBV4-2,TRBJ1-2,CASSSGGRIDGYTF,0,9,1,9
TRBV3-1,TRBJ2-3,CASSSGHSTDTQYF,0,9,1,9
TRBV12-3/4,TRBJ2-5,CASSRGTGGETQYF,0,9,1,9
TRBV14,TRBJ2-7,CASSQAAGAYEQYF,0,9,1,9
TRBV5-1,TRBJ2-7,CASSLAADQYEQYF,0,9,1,9
TRBV5-1,TRBJ2-3,CASSSRRSTDTQYF,0,9,1,9
TRBV5-1,TRBJ1-2,CASSSGTGTYGYTF,0,9,1,9
TRBV4-3,TRBJ2-7,CASSRAVGSYEQYF,0,9,1,9
TRBV10-3,TRBJ2-3,CACTQQGAEDTQYF,0,9,1,9
TRBV20-1,TRBJ2-6,CSAKGVSGANVLTF,0,9,1,9
TRBV29-1,TRBJ2-7,CSVTTGGVSYEQYF,0,9,1,9
TRBV6-2/3/5/6,TRBJ2-2,CASSYSYGGELFF,0,9,1,9
TRBV2,TRBJ2-5,CASSEKLKETQYF,0,9,1,9
TRBV5-4,TRBJ2-5,CASSWEGGETQYF,0,9,1,9
TRBV7-2,TRBJ2-5,CASSPAGDETQYF,0,9,1,9
TRBV25-1,TRBJ1-1,CASSGGSGTEAFF,0,9,1,9
TRBV11-1,TRBJ2-3,CASSEQRLDTQYF,0,9,1,9
TRBV20-1,TRBJ1-1,CSALTGEHTEAFF,0,9,1,9
TRBV20-1,TRBJ1-2,CSAIRVKSYGYTF,0,9,1,9
TRBV20-1,TRBJ2-5,CSAPGTPRETQYF,0,9,1,9
TRBV29-1,TRBJ2-7,CSVDGTGAYEQYF,0,9,1,9
TRBV29-1,TRBJ1-1,CSAGQGKNTEAFF,0,9,1,9
TRBV6-2/3/5/6,TRBJ2-3,CASSLTRNTQYF,0,9,1,9
TRBV27,TRBJ1-4,CASSSRPGKLFF,0,9,1,9
TRBV12-3/4,TRBJ2-7,CASSRDRGQQYF,0,9,1,9
TRBV3-1,TRBJ2-1,CASRIGVNEQFF,0,9,1,9
TRBV5-1,TRBJ1-4,CASSFTNEKLFF,0,9,1,9
TRBV29-1,TRBJ2-7,CSVLRDGEEQYF,0,9,1,9
TRBV29-1,TRBJ2-7,CSVVSESYEQYF,0,9,1,9
TRBV29-1,TRBJ1-1,CSVVGVDTEAFF,0,9,1,9
TRBV7-2,TRBJ2-7,CASSLFDEQYF,0,9,1,9
TRBV20-1,TRBJ2-5,CSARLAETQYF,0,9,1,9
TRBV29-1,TRBJ2-1,CSVVWNEQFF,0,9,1,9
TRBV6-1,TRBJ1-5,CASSEPGQGNGIGQPQHF,0,9,1,9
TRBV6-2/3/5/6,TRBJ2-1,CASSYRPSYNEQFF,0,9,1,9
TRBV13,TRBJ2-1,CASSLELAAYNEQFF,0,9,1,9
TRBV7-2,TRBJ2-2,CASSLFGNTGELFF,0,8,1,8
TRBV7-2,TRBJ2-3,CASSSVPMGLGFIDTQYF,0,8,1,8
TRBV20-1,TRBJ1-5,CSARGVGGAVSNSNQPQHF,0,8,1,8
TRBV11-2,TRBJ2-5,CASSSSSARAGASETQYF,0,8,1,8
TRBV4-2,TRBJ1-5,CASSQDAEDDRFNQPQHF,0,8,1,8
TRBV19,TRBJ1-1,CASSPMRTGGQYTEAFF,0,8,1,8
TRBV7-2,TRBJ2-7,CASSLAVGRGPSNEQYF,0,8,1,8
TRBV9,TRBJ2-1,CASSVELATISYNEQFF,0,8,1,8
TRBV5-1,TRBJ1-2,CASSLGLGDRANYGYTF,0,8,1,8
TRBV4-1,TRBJ2-3,CASSLRAGLAGKDTQYF,0,8,1,8
TRBV20-1,TRBJ2-2,CSARGARDRDSTGELFF,0,8,1,8
TRBV18,TRBJ2-7,CASSPGTSGRAREQYF,0,8,1,8
TRBV7-9,TRBJ2-3,CASSLGLGSLVDTQYF,0,8,1,8
TRBV7-3,TRBJ2-6,CASSSLAGSGANVLTF,0,8,1,8
TRBV7-8,TRBJ2-2,CASSWKRQTNTGELFF,0,8,1,8
TRBV7-8,TRBJ2-1,CASSGRTSGSTDEQFF,0,8,1,8
TRBV5-1,TRBJ2-1,CASSLDGGTSYNEQFF,0,8,1,8
TRBV5-1,TRBJ1-6,CASSLQADSYNSPLHF,0,8,1,8
TRBV4-3,TRBJ2-6,CASSPATGSGANVLTF,0,8,1,8
TRBV4-3,TRBJ2-6,CASSQDYSSGANVLTF,0,8,1,8
TRBV5-1,TRBJ1-2,CASSTVMGAQEYGYTF,0,8,1,8
TRBV29-1,TRBJ2-1,CSVEPEEGSSYNEQFF,0,8,1,8
TRBV29-1,TRBJ2-3,CSVEGRAGAFTDTQYF,0,8,1,8
TRBV19,TRBJ2-7,CASRDRDRNNYEQYF,0,8,1,8
TRBV19,TRBJ1-4,CASSPSGTGGGKLFF,0,8,1,8
TRBV18,TRBJ1-3,CASPVKICAGNTIYF,0,8,1,8
TRBV6-2/3/5/6,TRBJ2-1,CASSSWTGYYNEQFF,0,8,1,8
TRBV7-8,TRBJ2-3,CASSFTSVNTDTQYF,0,8,1,8
TRBV7-2,TRBJ2-1,CASSLGGSEIGEQFF,0,8,1,8
TRBV7-9,TRBJ1-2,CASSSGQGMHYGYTF,0,8,1,8
TRBV7-2,TRBJ1-2,CASSSAGTGIYGYTF,0,8,1,8
TRBV11-3,TRBJ2-1,CASSPRTGQYNEQFF,0,8,1,8
TRBV14,TRBJ2-5,CASSPGGGQGETQYF,0,8,1,8
TRBV9,TRBJ2-7,CASSAVPSGPYEQYL,0,8,1,8
TRBV14,TRBJ2-2,CASSIRTGPTGELFF,0,8,1,8
TRBV5-1,TRBJ1-1,CASAPQVGSGAEAFF,0,8,1,8
TRBV5-1,TRBJ2-7,CASSLLIPGSYEQYF,0,8,1,8
TRBV5-1,TRBJ1-1,CASSGNTGENTEAFF,0,8,1,8
TRBV29-1,TRBJ2-5,CSAPPGQGARETQYF,0,8,1,8
TRBV29-1,TRBJ2-5,CSVSHTASREETQYF,0,8,1,8
TRBV29-1,TRBJ2-7,CSVEVSERYTYEQYF,0,8,1,8
TRBV7-9,TRBJ2-3,CASFRQGIADTQYF,0,8,1,8
TRBV19,TRBJ1-3,CASSRVPSGNTIYF,0,8,1,8
TRBV12-3/4,TRBJ2-7,CASTRREDSYEQYF,0,8,1,8
TRBV7-9,TRBJ2-1,CASSFATSGNEQFF,0,8,1,8
TRBV5-5,TRBJ1-2,CASSLALGDYGYTF,0,8,1,8
TRBV5-4,TRBJ2-7,CASSLDGAPYEQYF,0,8,1,8
TRBV7-6,TRBJ1-4,CASSLSSFNEKLFF,0,8,1,8
TRBV7-8,TRBJ1-1,CASSLTGGNTEAFF,0,8,1,8
TRBV7-3,TRBJ1-1,CASSSQGQGAEAFF,0,8,1,8
TRBV7-2,TRBJ1-5,CASSPVSGNQPQHF,0,8,1,8
TRBV28,TRBJ2-1,CASRLLNRANEQFF,0,8,1,8
TRBV3-1,TRBJ2-7,CASRHRDRAHEQYF,0,8,1,8
TRBV6-2/3/5/6,TRBJ2-2,CASNPGTNTGELFF,0,8,1,8
TRBV5-1,TRBJ2-7,CASSPMQGGDEQYF,0,8,1,8
TRBV20-1,TRBJ1-1,CSARGGAANTEAFF,0,8,1,8
TRBV20-1,TRBJ1-1,CSAREIYRGPEAFF,0,8,1,8
TRBV29-1,TRBJ2-2,CSVRGTGIAGELFF,0,8,1,8
TRBV30,TRBJ1-6,CAWSKGHLITLHF,0,8,1,8
TRBV25-1,TRBJ2-2,CASFDRATGELFF,0,8,1,8
TRBV19,TRBJ2-7,CASSMLDSREQYF,0,8,1,8
TRBV18,TRBJ1-2,CASSPGQDYGYTF,0,8,1,8
TRBV3-1,TRBJ2-3,CASTRTQTDTQYF,0,8,1,8
TRBV12-3/4,TRBJ1-2,CASSPGRGYGYSF,0,8,1,8
TRBV2,TRBJ2-2,CASSGQNTGELFF,0,8,1,8
TRBV6-1,TRBJ2-1,CASSEAPLDEQFF,0,8,1,8
TRBV7-3,TRBJ2-7,CASSLTGANEQYF,0,8,1,8
TRBV7-6,TRBJ2-2,CASSLSYTGELFF,0,8,1,8
TRBV7-3,TRBJ1-2,CASSLNSGDGYTF,0,8,1,8
TRBV3-1,TRBJ1-4,CASSPPSNEKLFF,0,8,1,8
TRBV3-1,TRBJ1-5,CASSPTGDQPQHF,0,8,1,8
TRBV3-1,TRBJ1-1,CASSRTDRAEAFF,0,8,1,8
TRBV6-4,TRBJ1-1,CASSGRQGSEAFF,0,8,1,8
TRBV5-1,TRBJ1-1,CASRIRDSEIAFF,0,8,1,8
TRBV29-1,TRBJ2-7,CSVRDRDSYEQYF,0,8,1,8
TRBV29-1,TRBJ1-1,CSVGSPRDTEAFF,0,8,1,8
TRBV29-1,TRBJ2-7,CSVEEDSTYEQYF,0,8,1,8
TRBV29-1,TRBJ1-5,CSATTGSNQPQHF,0,8,1,8
TRBV27,TRBJ2-7,CASGTYTYEQYF,0,8,1,8
TRBV14,TRBJ1-1,CASSQRTGEAFF,0,8,1,8
TRBV2,TRBJ2-1,CASRLGYNEQFF,0,8,1,8
TRBV20-1,TRBJ1-5,CSVGNSNQPQHF,0,8,1,8
TRBV18,TRBJ2-1,CASSPSDEQFF,0,8,1,8
TRBV6-4,TRBJ1-1,CASLFDTEAFF,0,8,1,8
TRBV3-1,TRBJ2-7,CASSFGNEQYF,0,8,1,8
TRBV12-3/4,TRBJ2-1,CASSLRFEQFF,0,8,1,8
TRBV7-2,TRBJ2-7,CASSSSYEQYF,0,8,1,8
TRBV29-1,TRBJ2-5,CSVEVVRTQYF,0,8,1,8
TRBV5-1,TRBJ1-5,CASSPGTGGGNQPQHF,0,8,1,8
TRBV11-2,TRBJ1-3,CASSSTLGSGNTIYF,0,8,1,8
TRBV30,TRBJ1-5,CAWSRDSNQPQHF,0,8,1,8
TRBV14,TRBJ1-1,CASSHHTEAFF,0,8,1,8
TRBV12-5,TRBJ1-1,CASGLTGQGTEDTEAFF,0,8,1,8
TRBV10-3,TRBJ1-1,CAISALRQGTNTEAFF,0,8,1,8
TRBV7-2,TRBJ1-4,CASSLRDRVEKLFF,0,8,1,8
TRBV30,TRBJ1-2,CAWGQVPFGYTF,0,8,1,8
TRBV3-1,TRBJ2-7,CASSPSWDGTYEQYF,0,7,1,7
TRBV20-1,TRBJ1-1,CSAPRDRNTEAFF,0,7,1,7
TRBV12-3/4,TRBJ1-5,CASSPSHAPQRF,0,7,1,7
TRBV30,TRBJ2-4,CAWRADNTYKNIQYF,0,7,1,7
TRBV6-4,TRBJ1-5,CASSAEGLANQPQHF,0,7,1,7
TRBV3-1,TRBJ1-5,CASSQEGGSNQPQHF,0,7,1,7
TRBV18,TRBJ1-4,CASSPLAFNEKPFF,0,7,1,7
TRBV5-5,TRBJ2-7,CASSLGSVSYEQYF,0,7,1,7
TRBV6-2/3/5/6,TRBJ1-2,SASSLDRDYGYTF,0,7,1,7
TRBV12-3/4,TRBJ1-2,CASSFVGGTNYGYTF,0,7,1,7
TRBV29-1,TRBJ1-2,CSVEDTRGYGYTF,0,7,1,7
TRBV29-1,TRBJ2-7,CSVVLAGRRHEQYF,0,7,1,7
TRBV7-8,TRBJ2-2,CASSSRGAGGPVNTGELFF,0,7,1,7
TRBV29-1,TRBJ2-1,CSVDGLDAGGPSSYNEQFF,0,7,1,7
TRBV10-3,TRBJ1-2,CAISESPGPRVTLYGYTF,0,7,1,7
TRBV24-1,TRBJ1-3,CATSDSGSETTSGNTIYF,0,7,1,7
TRBV19,TRBJ2-1,CASSIVPGGISYNEQFF,0,7,1,7
TRBV12-3/4,TRBJ2-1,CASSPPRQGKGYNEQFF,0,7,1,7
TRBV6-1,TRBJ1-5,CASSEHRGRLSNQPQHF,0,7,1,7
TRBV5-6,TRBJ2-7,CASSLGLTSGDSYEQYF,0,7,1,7
TRBV4-3,TRBJ2-1,CASSRSPGTSGPNEQFF,0,7,1,7
TRBV29-1,TRBJ2-1,CSVPGTGLAGGWYVQFF,0,7,1,7
TRBV10-3,TRBJ1-5,CAISESSGVGNQPQHF,0,7,1,7
TRBV19,TRBJ1-5,CASSLQQGRGNQPQHF,0,7,1,7
TRBV19,TRBJ2-1,CASSRPGSLPTMRQFF,0,7,1,7
TRBV2,TRBJ2-6,CASAGLSGSGANVLTF,0,7,1,7
TRBV6-2/3/5/6,TRBJ2-7,CASTNIRWGDTYEQYF,0,7,1,7
TRBV27,TRBJ1-4,CASSLNWVDPDEKLFF,0,7,1,7
TRBV2,TRBJ2-1,CASSSYGLAAYNEQFF,0,7,1,7
TRBV6-2/3/5/6,TRBJ1-4,CASSYSVGPRNEKLFF,0,7,1,7
TRBV6-2/3/5/6,TRBJ1-5,CASSPSVGDKNQPQHF,0,7,1,7
TRBV6-4,TRBJ1-6,CASSTERQAGNSPLHF,0,7,1,7
TRBV5-8,TRBJ2-3,CASSLDRDSGTDTQYF,0,7,1,7
TRBV7-8,TRBJ1-4,CASSLEGDTYNEKLFF,0,7,1,7
TRBV7-8,TRBJ2-1,CASSLRSGPFANEQFF,0,7,1,7
TRBV14,TRBJ2-7,CASSQVLGAISYEQYF,0,7,1,7
TRBV7-9,TRBJ1-1,CASRSTGSTLNTEAFF,0,7,1,7
TRBV20-1,TRBJ1-5,CSAGPGTGISNQPQHF,0,7,1,7
TRBV20-1,TRBJ2-3,CSARGLERGGLDTQYF,0,7,1,7
TRBV29-1,TRBJ2-3,CSVEGVLGGLSDTQYF,0,7,1,7
TRBV12-5,TRBJ2-2,CASGLESGVPGELFF,0,7,1,7
TRBV18,TRBJ2-5,CASSPSSGTRETQYF,0,7,1,7
TRBV7-2,TRBJ1-2,CASQPTGSLNYGYTF,0,7,1,7
TRBV27,TRBJ2-1,CASTSATGGLNEQFF,0,7,1,7
TRBV12-3/4,TRBJ2-4,CASSLSRGAKNIQYF,0,7,1,7
TRBV5-6,TRBJ2-7,CASSQLAEVRDEQYF,0,7,1,7
TRBV6-1,TRBJ2-3,CASSEGSGSTDTQYF,0,7,1,7
TRBV5-6,TRBJ1-5,CASSFGQEINQPQHF,0,7,1,7
TRBV7-6,TRBJ2-3,CASSLGWAGADTQYF,0,7,1,7
TRBV11-2,TRBJ1-2,CASSLGAGTNYGYTF,0,7,1,7
TRBV7-2,TRBJ2-5,CASSLESGGQEAQYF,0,7,1,7
TRBV7-2,TRBJ2-7,CASSSNSGMSYEQYF,0,7,1,7
TRBV7-3,TRBJ2-6,CASSSSLSGANVLTF,0,7,1,7
TRBV11-2,TRBJ2-5,CASSLGGKPQETQYF,0,7,1,7
TRBV7-9,TRBJ1-5,CASSLTGDSNQPQHF,0,7,1,7
TRBV3-1,TRBJ2-7,CASSPGHGNSYEQYF,0,7,1,7
TRBV7-6,TRBJ2-3,CASSPTAIRTDTQYF,0,7,1,7
TRBV27,TRBJ1-5,CASSPFGAINQPQHF,0,7,1,7
TRBV7-2,TRBJ2-7,CASSPRGDRVYEQYF,0,7,1,7
TRBV3-1,TRBJ2-5,CASSRRTSGPETQYF,0,7,1,7
TRBV2,TRBJ2-1,CASSQSGTAYNEQFF,0,7,1,7
TRBV11-2,TRBJ2-3,CASSVSGPNTDTQYF,0,7,1,7
TRBV5-8,TRBJ2-5,CASSENRGRRETQYF,0,7,1,7
TRBV7-6,TRBJ2-7,CASSISEGTLYEQYF,0,7,1,7
TRBV7-9,TRBJ2-2,CASSILAGEAGELFF,0,7,1,7
TRBV19,TRBJ2-5,CTSSRQGGIQETQYF,0,7,1,7
TRBV5-1,TRBJ2-2,CASSLDSANTGELFF,0,7,1,7
TRBV5-1,TRBJ1-1,CASSAMVGIGTEAFF,0,7,1,7
TRBV20-1,TRBJ2-7,CSARGGSGRTNEQYF,0,7,1,7
TRBV20-1,TRBJ2-1,CSAREGSRLGNEQFF,0,7,1,7
TRBV29-1,TRBJ1-1,CSVAGQGPTNTEAFF,0,7,1,7
TRBV29-1,TRBJ2-7,CSVEDRAGGPYEQYF,0,7,1,7
TRBV29-1,TRBJ2-1,CSVRGTSGSSNEQFF,0,7,1,7
TRBV30,TRBJ1-1,CAWSGRLSNTEAFF,0,7,1,7
TRBV24-1,TRBJ2-2,CAATGRPNTGELFF,0,7,1,7
TRBV10-3,TRBJ1-2,CAIESGDSNYGYTF,0,7,1,7
TRBV10-3,TRBJ1-5,CAIRGDRDGQPQHF,0,7,1,7
TRBV18,TRBJ1-5,CASATGTRNQPQHF,0,7,1,7
TRBV19,TRBJ1-2,CASTQSTVIGGYTF,0,7,1,7
TRBV19,TRBJ2-3,CASSRFQVSDTQYF,0,7,1,7
TRBV7-8,TRBJ2-7,CASSLGPNFYEQYF,0,7,1,7
TRBV7-9,TRBJ1-6,CASSLYPERSPLHF,0,7,1,7
TRBV7-2,TRBJ1-2,CASSLAGQLYGYTF,0,7,1,7
TRBV7-2,TRBJ2-7,CASSLASGRHEQYF,0,7,1,7
TRBV7-2,TRBJ1-3,CASSLEQTGNTIYF,0,7,1,7
TRBV7-9,TRBJ2-5,CASSLRTSEETQYF,0,7,1,7
TRBV6-4,TRBJ1-1,CASSSLWVNTEAFF,0,7,1,7
TRBV7-8,TRBJ1-1,CASSSYRKNTEAFF,0,7,1,7
TRBV7-2,TRBJ2-1,CASSLLQGDSEQFF,0,7,1,7
TRBV28,TRBJ2-5,CASSPPWAGKTQYF,0,7,1,7
TRBV6-2/3/5/6,TRBJ2-3,CASRWTGGTDTQYF,0,7,1,7
TRBV19,TRBJ1-6,CTSRSSRFGSPLHF,0,7,1,7
TRBV5-1,TRBJ2-2,CASTKGSNTGELFF,0,7,1,7
TRBV5-1,TRBJ1-3,CASSLELSGNTIYF,0,7,1,7
TRBV5-1,TRBJ1-2,CASSLEDASPGYTF,0,7,1,7
TRBV4-3,TRBJ2-3,CASSQDGASHTQYF,0,7,1,7
TRBV4-1,TRBJ2-5,CASSQEPGGETQYF,0,7,1,7
TRBV20-1,TRBJ2-7,CSARAAGRSYEQYF,0,7,1,7
TRBV20-1,TRBJ2-1,CSAKAGGPKDEQFF,0,7,1,7
TRBV29-1,TRBJ2-7,CSVAGEGQGYEQYF,0,7,1,7
TRBV29-1,TRBJ1-2,CSVEFQGGILGYTF,0,7,1,7
TRBV29-1,TRBJ2-3,CSVDRGLSTDTQYF,0,7,1,7
TRBV29-1,TRBJ2-3,CSVTTRVSTDTQYF,0,7,1,7
TRBV29-1,TRBJ1-1,CSILHRDKNTEAFF,0,7,1,7
TRBV19,TRBJ2-1,CASSMGGWNEQFF,0,7,1,7
TRBV12-3/4,TRBJ1-2,CASSLFQGEGYTF,0,7,1,7
TRBV3-1,TRBJ2-7,CASSLGQGGEQYF,0,7,1,7
TRBV7-2,TRBJ1-6,CASSTAGNSPLHF,0,7,1,7
TRBV7-2,TRBJ1-2,CASSFGQLYGYTF,0,7,1,7
TRBV11-3,TRBJ2-1,CASSPGREGEQFF,0,7,1,7
TRBV3-1,TRBJ2-3,CASSQGSTDTQYF,0,7,1,7
TRBV11-3,TRBJ1-1,CASRRRMNTEAFF,0,7,1,7
TRBV6-2/3/5/6,TRBJ1-5,CASRQGNNQPQHF,0,7,1,7
TRBV2,TRBJ2-2,CASRALVAGELFF,0,7,1,7
TRBV6-2/3/5/6,TRBJ2-2,CASKKRNTGELFF,0,7,1,7
TRBV5-1,TRBJ1-2,CASSLAQGFGYTF,0,7,1,7
TRBV5-1,TRBJ2-7,CASSLDRAYEQYF,0,7,1,7
TRBV20-1,TRBJ2-3,CSATLAGGDTQYF,0,7,1,7
TRBV29-1,TRBJ2-5,CSVARASQETQYF,0,7,1,7
TRBV29-1,TRBJ2-1,CSVGGDALTEQFF,0,7,1,7
TRBV29-1,TRBJ1-5,CSVLQASNQPQHF,0,7,1,7
TRBV30,TRBJ2-1,CAWSATGDEQFF,0,7,1,7
TRBV30,TRBJ2-7,CAWSGGPREQYF,0,7,1,7
TRBV25-1,TRBJ2-7,CASSDLGYEQYF,0,7,1,7
TRBV11-2,TRBJ2-5,CASSLDSETQYF,0,7,1,7
TRBV5-1,TRBJ2-5,CASSLGKETQYF,0,7,1,7
TRBV29-1,TRBJ1-2,CSVADSYYGYTF,0,7,1,7
TRBV29-1,TRBJ1-2,CSVEPGGYGYTF,0,7,1,7
TRBV29-1,TRBJ1-1,CSGETGFAEAFF,0,7,1,7
TRBV29-1,TRBJ2-5,CSDRWFGETQYF,0,7,1,7
TRBV9,TRBJ1-2,CASGAIYGYTF,0,7,1,7
TRBV9,TRBJ1-2,CASSLFYGYTF,0,7,1,7
TRBV29-1,TRBJ2-5,CSPLSGETQYF,0,7,1,7
TRBV29-1,TRBJ1-2,CSVEDLGGYTF,0,7,1,7
TRBV29-1,TRBJ1-1,CSVRDSGEAFF,0,7,1,7
TRBV2,TRBJ2-1,CASLYNEQFF,0,7,1,7
TRBV2,TRBJ2-1,CASGNPEQFF,0,7,1,7
TRBV29-1,TRBJ1-1,CSVGTAEAFF,0,7,1,7
TRBV27,TRBJ2-1,CASSFSGNSYNEQFF,0,7,1,7
TRBV7-2,TRBJ1-5,CASSLNGPGIGQPQHS,0,7,1,7
TRBV3-1,TRBJ2-6,CASSSRVVGANVLTF,0,7,1,7
TRBV20-1,TRBJ1-3,CGAKPAGRGNTIYF,0,7,1,7
TRBV14,TRBJ2-7,CASSQEGPEQYF,0,7,1,7
TRBV19,TRBJ1-5,CASSYRLGTEESAASNQPQHF,0,6,1,6
TRBV11-2,TRBJ2-3,CASSHPGTGGDWDTDTQYF,0,6,1,6
TRBV12-5,TRBJ2-3,CASGLGLAGGISTDTQYF,0,6,1,6
TRBV19,TRBJ1-2,CASSDERVLVGWNYGYTF,0,6,1,6
TRBV6-2/3/5/6,TRBJ2-3,CASSSKSGGPTTRDTQYF,0,6,1,6
TRBV7-9,TRBJ2-5,CASSLGVFGRDYQETQYF,0,6,1,6
TRBV29-1,TRBJ2-1,CSVQQRGAGAGPYNEQFF,0,6,1,6
TRBV24-1,TRBJ2-1,CATSDTLLAGSYNEQFF,0,6,1,6
TRBV19,TRBJ1-1,CASSIDESQPVNTEAFF,0,6,1,6
TRBV19,TRBJ1-5,CASSITWDRGPIQPQHF,0,6,1,6
TRBV6-2/3/5/6,TRBJ1-1,CASSYHGQGGMNTEAFF,0,6,1,6
TRBV5-4,TRBJ2-1,CAVRGLAGGSSYNEQFF,0,6,1,6
TRBV20-1,TRBJ2-6,CSAAEMGVGSGANVLTF,0,6,1,6
TRBV30,TRBJ2-2,CAWSPEPGLEAGELFF,0,6,1,6
TRBV7-2,TRBJ2-1,CAILRGGKSSYNEQFF,0,6,1,6
TRBV19,TRBJ2-2,CASRKLEPANTGELFF,0,6,1,6
TRBV12-3/4,TRBJ2-3,CASSFSGTGGTDTQYF,0,6,1,6
TRBV12-3/4,TRBJ1-1,CASSFGDTPSRTEAFF,0,6,1,6
TRBV6-1,TRBJ2-1,CASSKTGSGRGDEQFF,0,6,1,6
TRBV7-9,TRBJ2-6,CASSFTRTAGANVLTF,0,6,1,6
TRBV7-2,TRBJ1-2,CASSLALGDRAGGYTF,0,6,1,6
TRBV7-9,TRBJ2-3,CASSPPGGPHIDTQYF,0,6,1,6
TRBV3-1,TRBJ2-1,CASSQLAGVQNNEQFF,0,6,1,6
TRBV11-3,TRBJ2-5,CASSAPDRGVEETQYF,0,6,1,6
TRBV7-2,TRBJ2-5,CASSAQLAGGGETQYF,0,6,1,6
TRBV5-4,TRBJ2-3,CASSIRLATSTDTQYF,0,6,1,6
TRBV28,TRBJ2-7,CASRSPLGRDTYEQYF,0,6,1,6
TRBV12-3/4,TRBJ1-4,CASRSRLHGGNEKLFF,0,6,1,6
TRBV5-1,TRBJ2-6,CASTHNRGSGANVLTF,0,6,1,6
TRBV5-1,TRBJ2-5,CASSLGGLAGRETQYF,0,6,1,6
TRBV5-1,TRBJ2-6,CASSSLQGSGANVLTF,0,6,1,6
TRBV5-1,TRBJ2-7,CASSPRRDRSSYEQYF,0,6,1,6
TRBV5-1,TRBJ1-1,CASSPNKPEMNTEASF,0,6,1,6
TRBV5-1,TRBJ1-1,CASSGYTGAGDTEAFF,0,6,1,6
TRBV20-1,TRBJ1-4,CSARDIVGQGSEKLFF,0,6,1,6
TRBV29-1,TRBJ2-1,CSVEDGTGGLQNEQFF,0,6,1,6
TRBV12-5,TRBJ2-3,CASGSPQAFTDTQYF,0,6,1,6
TRBV10-3,TRBJ2-7,CAISESREGRREQYF,0,6,1,6
TRBV19,TRBJ1-2,CASRSGWDFNYGYTF,0,6,1,6
TRBV7-8,TRBJ2-1,CASTSPPGGQVEQFF,0,6,1,6
TRBV7-6,TRBJ2-3,CASTPRTAGVDTQYF,0,6,1,6
TRBV12-3/4,TRBJ1-4,CASSFSGAGNEKLFF,0,6,1,6
TRBV6-2/3/5/6,TRBJ1-1,CASSLQEHLNTEAFF,0,6,1,6
TRBV6-2/3/5/6,TRBJ2-3,CASSWLTTSGDTQYF,0,6,1,6
TRBV12-3/4,TRBJ2-7,CASSAPASGGYEQYF,0,6,1,6
TRBV7-2,TRBJ1-2,CASSLAGFIDYGYTF,0,6,1,6
TRBV7-9,TRBJ1-2,CASSLVSGTGGGYTF,0,6,1,6
TRBV11-2,TRBJ1-1,CASSLGQYMNTEAFF,0,6,1,6
TRBV7-2,TRBJ2-1,CASSLDQTSSNEQFF,0,6,1,6
TRBV5-4,TRBJ2-7,CASSPSSGRIHEQYF,0,6,1,6
TRBV6-2/3/5/6,TRBJ2-3,CASSPSEGATDTQYF,0,6,1,6
TRBV7-9,TRBJ2-7,CASSPPTGGSGEQYF,0,6,1,6
TRBV28,TRBJ1-1,CASSPPGQWNTEAFF,0,6,1,6
TRBV7-2,TRBJ2-7,CASSHSGRVTYEQYF,0,6,1,6
TRBV9,TRBJ2-5,CASSVEQGPQETQYF,0,6,1,6
TRBV14,TRBJ2-7,CASSAPGLGVYEQYF,0,6,1,6
TRBV25-1,TRBJ2-3,CASKGTSESTDTQYF,0,6,1,6
TRBV5-1,TRBJ2-1,CASSLGLVDNNEQFF,0,6,1,6
TRBV5-1,TRBJ2-1,CASSLDSLGRDEQFF,0,6,1,6
TRBV5-1,TRBJ2-7,CASSLEGTAGGAQYF,0,6,1,6
TRBV5-1,TRBJ2-5,CASSLTTDNQETQYF,0,6,1,6
TRBV4-1,TRBJ1-5,CASSQDLRSNQPQHF,0,6,1,6
TRBV4-3,TRBJ2-7,CASSQRTSGVLEQYF,0,6,1,6
TRBV20-1,TRBJ2-1,CSAWPVGGPNNEQFF,0,6,1,6
TRBV20-1,TRBJ2-6,CSARPQGSGANVLTF,0,6,1,6
TRBV20-1,TRBJ1-1,CSARDFQVMNTEAFF,0,6,1,6
TRBV20-1,TRBJ2-7,CSARDPDYSVYEQYF,0,6,1,6
TRBV20-1,TRBJ2-1,CSARSGRSSYNEQFF,0,6,1,6
TRBV29-1,TRBJ2-4,CSVEDVQGAKNIQYF,0,6,1,6
TRBV29-1,TRBJ2-3,CSTGGPAGSTDTQYF,0,6,1,6
TRBV7-2,TRBJ2-1,RASSYRTGAYNEQFF,0,6,1,6
TRBV12-5,TRBJ1-1,CASGFLGLGNEAFF,0,6,1,6
TRBV10-3,TRBJ2-7,CAIKHRDRDLEQYF,0,6,1,6
TRBV19,TRBJ2-3,CASTRTYATDTQYF,0,6,1,6
TRBV19,TRBJ2-7,CASSSDIFSYEQYF,0,6,1,6
TRBV19,TRBJ1-1,CASNDRGPNTEAFF,0,6,1,6
TRBV27,TRBJ2-1,CASSSSGIYNEQFF,0,6,1,6
TRBV6-2/3/5/6,TRBJ2-7,CASSPGQGNYEQCF,0,6,1,6
TRBV2,TRBJ2-7,CASSDKTHSYEQYF,0,6,1,6
TRBV25-1,TRBJ2-5,CASSEFVGTETQYF,0,6,1,6
TRBV6-1,TRBJ1-5,CASSETSLSMTQHF,0,6,1,6
TRBV7-6,TRBJ1-5,CASSFGAVNQPQHF,0,6,1,6
TRBV7-6,TRBJ1-1,CASSFSGRDTEAFF,0,6,1,6
TRBV7-6,TRBJ2-7,CASSLGGRTYEQYF,0,6,1,6
TRBV11-2,TRBJ2-5,CASSLGTTQETQYF,0,6,1,6
TRBV6-2/3/5/6,TRBJ1-1,CASSLGQPNTEAFF,0,6,1,6
TRBV7-2,TRBJ1-5,CASSLNPGNQPQHF,0,6,1,6
TRBV5-4,TRBJ1-2,CASSLGGTGGGYTF,0,6,1,6
TRBV2,TRBJ1-5,CASSLTGGYQPQHF,0,6,1,6
TRBV7-2,TRBJ1-1,CASSLDRFSTEAFF,0,6,1,6
TRBV14,TRBJ1-4,CASSQPTGNEKLFF,0,6,1,6
TRBV7-2,TRBJ2-7,CASSQQGDLYEQYF,0,6,1,6
TRBV14,TRBJ2-7,CASSQVGDYYEQYF,0,6,1,6
TRBV7-9,TRBJ2-5,CASSDGLGGETQYF,0,6,1,6
TRBV7-2,TRBJ1-5,CASSMTGVGQPQHF,0,6,1,6
TRBV5-4,TRBJ2-5,CASSTPTGGETQYF,0,6,1,6
TRBV5-4,TRBJ1-5,CASSRQGSGQPQHF,0,6,1,6
TRBV6-2/3/5/6,TRBJ2-7,CASKQTSSSYEQYF,0,6,1,6
TRBV2,TRBJ2-6,CARGQLSGANVLTF,0,6,1,6
TRBV29-1,TRBJ1-1,CSVDSTGMNTEAFF,0,6,1,6
TRBV5-1,TRBJ1-5,CASTWGPGGQPQHF,0,6,1,6
TRBV5-1,TRBJ2-6,CASTPASGANVLTF,0,6,1,6
TRBV5-1,TRBJ2-5,CASSLADSQETQYF,0,6,1,6
TRBV4-3,TRBJ2-7,CASSQARFSYEQYF,0,6,1,6
TRBV20-1,TRBJ1-1,CSAKMVGRNTEAFF,0,6,1,6
TRBV29-1,TRBJ1-1,CSLEQGAGNTEAFF,0,6,1,6
TRBV29-1,TRBJ2-3,CSVARGLRTDTQYF,0,6,1,6
TRBV29-1,TRBJ2-5,CSVEQTGAQETQYF,0,6,1,6
TRBV29-1,TRBJ1-5,CSVIPDGRNQPQHF,0,6,1,6
TRBV30,TRBJ2-2,CAWTLGWTGELFF,0,6,1,6
TRBV30,TRBJ1-2,CAWSKEHYYGYTF,0,6,1,6
TRBV10-3,TRBJ1-5,CAISEYSNQPQHF,0,6,1,6
TRBV25-1,TRBJ2-7,CATSVDTFYEQYF,0,6,1,6
TRBV18,TRBJ2-1,CASSLGENNEQFF,0,6,1,6
TRBV2,TRBJ1-1,CASTQGENTEAFF,0,6,1,6
TRBV12-3/4,TRBJ1-2,CASSLSVDYGYTF,0,6,1,6
TRBV7-2,TRBJ1-1,CASSPHRDGEAFF,0,6,1,6
TRBV6-2/3/5/6,TRBJ2-4,CASSTGLQNIQYF,0,6,1,6
TRBV7-8,TRBJ2-7,CASSFQGYYEQYF,0,6,1,6
TRBV7-2,TRBJ2-3,CASSFGITDTQYF,0,6,1,6
TRBV11-3,TRBJ2-5,CASSFRGWETQYF,0,6,1,6
TRBV7-2,TRBJ2-3,CASSLARGETQYF,0,6,1,6
TRBV7-2,TRBJ2-3,CASSSMSTDTQYF,0,6,1,6
TRBV7-2,TRBJ2-7,CASSSLIQSEQYF,0,6,1,6
TRBV5-6,TRBJ1-1,CASSPHFGTEAFS,0,6,1,6
TRBV13,TRBJ2-3,CASSPLPTDTQYF,0,6,1,6
TRBV7-2,TRBJ1-5,CASSRTGSQPQHF,0,6,1,6
TRBV5-5,TRBJ2-7,CASSQTGIDEQYF,0,6,1,6
TRBV3-1,TRBJ1-1,CASSQVGGAEAFF,0,6,1,6
TRBV7-9,TRBJ2-2,CASSQMPTGELFF,0,6,1,6
TRBV12-3/4,TRBJ2-2,CASRVLGPGELFF,0,6,1,6
TRBV5-1,TRBJ2-1,CASSLAQTNEQFF,0,6,1,6
TRBV4-1,TRBJ2-1,CASSLQGGYEQFF,0,6,1,6
TRBV4-1,TRBJ2-1,CASSQDAGHEQFF,0,6,1,6
TRBV20-1,TRBJ1-3,CGGQGFSGNTIYF,0,6,1,6
TRBV20-1,TRBJ2-3,CSLDRRVGDTQYF,0,6,1,6
TRBV29-1,TRBJ2-1,CSVEEVSPGLALF,0,6,1,6
TRBV29-1,TRBJ1-5,CSASDFSNQPQHF,0,6,1,6
TRBV29-1,TRBJ2-1,CSGWTGGFNEQFF,0,6,1,6
TRBV29-1,TRBJ2-2,RSGRVVQAGELFF,0,6,1,6
TRBV5-4,TRBJ1-2,CACSGDTYGYTF,0,6,1,6
TRBV30,TRBJ1-5,CAWSATNQPQHF,0,6,1,6
TRBV5-6,TRBJ2-7,CASGARSYEQYF,0,6,1,6
TRBV28,TRBJ1-5,CASSLSVQPQHF,0,6,1,6
TRBV6-2/3/5/6,TRBJ2-7,CASSYSSYEQYF,0,6,1,6
TRBV6-2/3/5/6,TRBJ1-1,CASSYRRQEAFF,0,6,1,6
TRBV11-2,TRBJ2-1,CASSSWPDEQFF,0,6,1,6
TRBV11-3,TRBJ2-2,CASSPEARELFF,0,6,1,6
TRBV5-1,TRBJ2-2,CASSFNTGELFF,0,6,1,6
TRBV20-1,TRBJ2-3,CSARDPLDAQYF,0,6,1,6
TRBV29-1,TRBJ2-1,CSVVQGWNEQFF,0,6,1,6
TRBV29-1,TRBJ2-5,CSVVTGTTTQYF,0,6,1,6
TRBV29-1,TRBJ1-1,CSVEENRAEAFF,0,6,1,6
TRBV29-1,TRBJ2-1,CSVARGHNEQFF,0,6,1,6
TRBV7-9,TRBJ1-5,RASSPYNQPQHF,0,6,1,6
TRBV12-3/4,TRBJ1-1,CASSIVRKAFF,0,6,1,6
TRBV7-2,TRBJ2-7,CASSSYYEQYL,0,6,1,6
TRBV7-9,TRBJ2-5,CASSLGETQYF,0,6,1,6
TRBV7-8,TRBJ2-1,CASSPNSEQFF,0,6,1,6
TRBV7-9,TRBJ2-1,CASSTLDEQFF,0,6,1,6
TRBV29-1,TRBJ2-5,CSVEVGETQYF,0,6,1,6
TRBV3-1,TRBJ1-1,CASSGPEAFF,0,6,1,6
TRBV2,TRBJ2-3,CASSRTGAGDTQYF,0,6,1,6
TRBV5-1,TRBJ2-2,CASSQRTLGGVTGELFF,0,6,1,6
TRBV29-1,TRBJ2-1,CSARQGAGMNEQFF,0,6,1,6
TRBV18,TRBJ2-1,CASSPPLAGVGNEQFF,0,6,1,6
TRBV9,TRBJ2-1,CASSSSGGPPDNEQFF,0,6,1,6
TRBV5-5,TRBJ1-2,CASSWPGQSGYGYTF,0,6,1,6
TRBV18,TRBJ2-2,CASSPIGTGELFF,0,6,1,6
TRBV5-6,TRBJ1-1,CASSPGQKKPMNTEAFL,0,6,1,6
TRBV6-2/3/5/6,TRBJ2-5,CASSYSLHSPTQYF,0,6,1,6
TRBV5-1,TRBJ2-6,CASSRGDSDSSGANVLTF,0,6,1,6
TRBV7-2,TRBJ1-1,CASSSTGGNTEAFF,0,6,1,6
TRBV5-1,TRBJ1-3,CASSSWGQADSGNTIYF,0,6,1,6
TRBV2,TRBJ2-1,CASTPGLGACNEQFF,0,6,1,6
TRBV29-1,TRBJ2-4,CSVGEGNIQCF,0,6,1,6
TRBV4-1,TRBJ2-7,CASSQGVSFSGLAYEQYF,0,6,1,6
TRBV3-1,TRBJ1-1,CASSPGANTEAFF,0,6,1,6
TRBV7-9,TRBJ1-1,CASSLAGAGFTEAFF,0,5,1,5
TRBV7-9,TRBJ2-1,CASSPGGRANEQFF,0,5,1,5
TRBV20-1,TRBJ2-2,CSARDGARVNTGELLF,0,5,1,5
TRBV6-2/3/5/6,TRBJ1-3,CASSWRTPGQGRTSGNTIYF,0,5,1,5
TRBV6-2/3/5/6,TRBJ1-5,CASSYSRDRGYSNQPQHF,0,5,1,5
TRBV7-2,TRBJ2-1,CASSLAVRAAGGMDEQFF,0,5,1,5
TRBV9,TRBJ1-2,CASSPHMTTQPFNYGYTF,0,5,1,5
TRBV3-1,TRBJ2-1,CASSPSEAGTSSYNEQFF,0,5,1,5
TRBV14,TRBJ1-1,CASSQDIFGVGMNTEAFF,0,5,1,5
TRBV29-1,TRBJ2-1,CSVEAQEFDRIPYNEQFF,0,5,1,5
TRBV10-3,TRBJ1-2,CAISNGPFSSTGHGYTS,0,5,1,5
TRBV19,TRBJ1-2,CASSTRGQYLTNYGYTF,0,5,1,5
TRBV6-2/3/5/6,TRBJ1-6,CASISTRRSSYNSPLHF,0,5,1,5
TRBV28,TRBJ1-1,CASSLLQGAAANTEAFF,0,5,1,5
TRBV7-2,TRBJ1-5,CASSLGASRDRGQPQHF,0,5,1,5
TRBV13,TRBJ2-5,CASSLEGFGGRQETQYF,0,5,1,5
TRBV7-6,TRBJ2-1,CASSLLYSGSAYNEQFF,0,5,1,5
TRBV3-1,TRBJ1-5,CASSPGRGLYSNQPQHF,0,5,1,5
TRBV7-2,TRBJ2-7,CASSHPGLAGGSYEQYF,0,5,1,5
TRBV14,TRBJ1-5,CASSQPDGEYWNQPQHF,0,5,1,5
TRBV7-9,TRBJ2-1,CASSGIAVGLAGVEQFF,0,5,1,5
TRBV5-4,TRBJ2-5,CASSRGASGSGEETQYF,0,5,1,5
TRBV5-1,TRBJ2-3,CASSAKGRGMGTDTQYF,0,5,1,5
TRBV30,TRBJ2-7,CAWSVIRGRGYNEQYF,0,5,1,5
TRBV19,TRBJ1-1,CASSGQGAGENTEAFF,0,5,1,5
TRBV19,TRBJ1-2,CASRKPGQADSLGYTF,0,5,1,5
TRBV18,TRBJ2-3,CASSPGLAGATDTQYF,0,5,1,5
TRBV3-1,TRBJ1-4,CASGSARVLSREKLFF,0,5,1,5
TRBV12-3/4,TRBJ2-5,CASSFFGGPYQETQYF,0,5,1,5
TRBV6-2/3/5/6,TRBJ2-7,CASSLITGPGRYEQYF,0,5,1,5
TRBV12-3/4,TRBJ1-6,CASSRILGQGWSPLHF,0,5,1,5
TRBV6-1,TRBJ2-7,CASSAEGTSGSHEQYF,0,5,1,5
TRBV7-9,TRBJ1-1,CASSFTTDPKYTEAFF,0,5,1,5
TRBV5-6,TRBJ2-1,CASSLLDRGHLNEQFF,0,5,1,5
TRBV7-2,TRBJ2-4,CASSLSPLGVKNIQYF,0,5,1,5
TRBV7-2,TRBJ2-2,CASSLMGGQHTGELFF,0,5,1,5
TRBV5-6,TRBJ1-4,CASSSNSRRSSEKLFF,0,5,1,5
TRBV5-6,TRBJ2-1,CASSLTSGRANNEQFF,0,5,1,5
TRBV7-9,TRBJ1-1,CASSLGDRVWNTEAFF,0,5,1,5
TRBV7-9,TRBJ2-1,CASSPGRDSPYNEQFF,0,5,1,5
TRBV14,TRBJ1-6,CASSHNGNPYNSPLHF,0,5,1,5
TRBV3-1,TRBJ2-2,CASSQDIGARTGELFF,0,5,1,5
TRBV7-2,TRBJ2-7,CASSVGQGAVSYEQYF,0,5,1,5
TRBV4-2,TRBJ2-3,CASSVPGTSGTDTQYF,0,5,1,5
TRBV5-5,TRBJ2-7,CASSGSGSGSIYEQYF,0,5,1,5
TRBV7-2,TRBJ1-3,CASSTRQGSVGNTIYF,0,5,1,5
TRBV10-1,TRBJ2-3,CASSDSSGANTDTQYF,0,5,1,5
TRBV5-1,TRBJ2-1,CASSTTGTGIYNEQFF,0,5,1,5
TRBV20-1,TRBJ1-5,CSAPEPGGDGNQPQHF,0,5,1,5
TRBV29-1,TRBJ2-1,CSVVPSGSRRLNEQFF,0,5,1,5
TRBV6-2/3/5/6,TRBJ2-1,CACSPRLAEYNEQFF,0,5,1,5
TRBV30,TRBJ2-7,CAWMIQGQGRYEQYF,0,5,1,5
TRBV30,TRBJ2-2,CAWSVRWANTGELFF,0,5,1,5
TRBV10-3,TRBJ2-3,CAISNGREGQDTQYF,0,5,1,5
TRBV10-3,TRBJ1-6,CAISVDPGGYSPLHF,0,5,1,5
TRBV24-1,TRBJ2-3,CATSDTGTTTDTQYF,0,5,1,5
TRBV5-6,TRBJ2-7,CASFPGLAVVYEQYF,0,5,1,5
TRBV19,TRBJ2-3,CASSIPTGVTDTQYF,0,5,1,5
TRBV19,TRBJ2-1,CASSTLAGGVNEQFF,0,5,1,5
TRBV19,TRBJ1-6,CASSTQGADNSPLHF,0,5,1,5
TRBV19,TRBJ1-2,CASNHPPTGNYGYTF,0,5,1,5
TRBV19,TRBJ2-1,CASKRVDSGYNEQFF,0,5,1,5
TRBV28,TRBJ2-1,CASRPTGPRGNEQFF,0,5,1,5
TRBV11-2,TRBJ2-7,CASTLTGGRLSEQYF,0,5,1,5
TRBV28,TRBJ1-1,CASSLRAELNTEAFF,0,5,1,5
TRBV6-2/3/5/6,TRBJ2-2,CASSSGLGGAGELFF,0,5,1,5
TRBV6-2/3/5/6,TRBJ2-1,CASSYWGQGGNEQFF,0,5,1,5
TRBV6-2/3/5/6,TRBJ1-5,CASSYSWGAGQPQHF,0,5,1,5
TRBV6-2/3/5/6,TRBJ2-7,CASSYPATGSYEQYF,0,5,1,5
TRBV27,TRBJ2-3,CASSYAGLAGDTQYF,0,5,1,5
TRBV12-3/4,TRBJ2-1,CASSPLAGGRNEQFF,0,5,1,5
TRBV2,TRBJ1-2,CASSEFRTEDYGYTF,0,5,1,5
TRBV2,TRBJ2-5,CASSELGTAQETQYF,0,5,1,5
TRBV6-1,TRBJ2-7,CASSEASGSSYEQYF,0,5,1,5
TRBV12-3/4,TRBJ1-5,CASSTGTGDNQPQHF,0,5,1,5
TRBV7-2,TRBJ2-1,CASSFRTLTYNEQFF,0,5,1,5
TRBV11-2,TRBJ2-1,CASSFGQYTYNEQFF,0,5,1,5
TRBV5-8,TRBJ2-1,CASSLGDGVYNEQFL,0,5,1,5
TRBV7-2,TRBJ1-4,CASSLGSGGHEKLFF,0,5,1,5
TRBV7-9,TRBJ2-7,CASSLGAGVRYEQYF,0,5,1,5
TRBV7-6,TRBJ2-5,CASSLEAGHQETQYF,0,5,1,5
TRBV7-9,TRBJ2-5,CASSLKGAREETQYF,0,5,1,5
TRBV5-6,TRBJ1-1,CASSSGTGGYTEAFF,0,5,1,5
TRBV5-5,TRBJ2-3,CASSSRGERGDTQYF,0,5,1,5
TRBV7-9,TRBJ2-3,CASSSRIAGADTQYF,0,5,1,5
TRBV5-4,TRBJ2-1,CASSLDRGSYNEQFF,0,5,1,5
TRBV7-9,TRBJ2-7,CASSPLDLTSYEQYF,0,5,1,5
TRBV11-2,TRBJ1-1,CASSPGRGPGTEAFF,0,5,1,5
TRBV7-9,TRBJ2-1,CASSPRVAGGKEQFF,0,5,1,5
TRBV3-1,TRBJ1-1,CASSQPGESGTEAFF,0,5,1,5
TRBV3-1,TRBJ2-1,CASSQRTRGYNEQFF,0,5,1,5
TRBV14,TRBJ2-5,CASSQQVGGQETQYF,0,5,1,5
TRBV3-1,TRBJ2-7,CASSQVDWTGYEQYF,0,5,1,5
TRBV3-1,TRBJ2-3,CASSQGWEGEDTQYF,0,5,1,5
TRBV3-1,TRBJ2-5,CASSQEASYQETQYF,0,5,1,5
TRBV9,TRBJ2-3,CASSVGLKSTDTQYF,0,5,1,5
TRBV6-2/3/5/6,TRBJ1-6,CASSVDGEMDSPLHF,0,5,1,5
TRBV14,TRBJ2-3,CASSAQLASTDTQYF,0,5,1,5
TRBV6-1,TRBJ1-2,CASSEPRDGVYGYTF,0,5,1,5
TRBV5-6,TRBJ1-1,CASSSPGEGNTEAFF,0,5,1,5
TRBV5-1,TRBJ2-1,CASSLVDSSYNEQFF,0,5,1,5
TRBV5-1,TRBJ1-1,CASSLGPWQATEAFF,0,5,1,5
TRBV5-1,TRBJ2-7,CASSLEPGQGYEQYF,0,5,1,5
TRBV4-3,TRBJ2-2,CASSLYATGPLELFF,0,5,1,5
TRBV5-1,TRBJ1-2,CASSPEGQGRDGYTF,0,5,1,5
TRBV5-1,TRBJ2-2,CASSRSTTNTGELFF,0,5,1,5
TRBV4-3,TRBJ1-1,CASSHRQGFGFEAFF,0,5,1,5
TRBV5-1,TRBJ2-1,CASSISGNSYNEQFF,0,5,1,5
TRBV20-1,TRBJ2-1,CSAPSTSGRAGEQFF,0,5,1,5
TRBV20-1,TRBJ2-1,CSARPTSGSLNEQFF,0,5,1,5
TRBV20-1,TRBJ2-5,CSARDFQGKQETQYF,0,5,1,5
TRBV20-1,TRBJ2-3,CSARDRILSTDTQYF,0,5,1,5
TRBV29-1,TRBJ2-1,CSPSSGPRDYNEQFF,0,5,1,5
TRBV14,TRBJ2-7,SASSQDGAGVPEQYF,0,5,1,5
TRBV30,TRBJ2-3,CAWTMSGRGGTQYF,0,5,1,5
TRBV30,TRBJ1-5,CAWSGVTINQPQHF,0,5,1,5
TRBV30,TRBJ1-1,CAWSEGHLNTEAFF,0,5,1,5
TRBV30,TRBJ2-1,CAWSTPGRGNEQFF,0,5,1,5
TRBV24-1,TRBJ2-1,CATSDPTGSHEQFF,0,5,1,5
TRBV19,TRBJ2-7,CASTLRWEGYEQYF,0,5,1,5
TRBV11-3,TRBJ2-5,CASRDRALRRAQYF,0,5,1,5
TRBV19,TRBJ2-3,CASKTLAETDTQYF,0,5,1,5
TRBV2,TRBJ2-5,CASRGLAGQETQYF,0,5,1,5
TRBV6-4,TRBJ2-7,CASRGLLGFHEQYF,0,5,1,5
TRBV9,TRBJ2-3,CASGDRADTDTQYF,0,5,1,5
TRBV27,TRBJ2-7,CASSFTTVSYEQYF,0,5,1,5
TRBV2,TRBJ1-1,CASSLETVNTEAFF,0,5,1,5
TRBV12-3/4,TRBJ1-1,CASSLTGANSEAFF,0,5,1,5
TRBV6-2/3/5/6,TRBJ2-7,CASSYPAETYEQYF,0,5,1,5
TRBV28,TRBJ1-1,CASSLPTQATEAFF,0,5,1,5
TRBV6-2/3/5/6,TRBJ2-6,CASSLAGGANVLTF,0,5,1,5
TRBV6-2/3/5/6,TRBJ2-1,CASSLVAGVGEQFF,0,5,1,5
TRBV12-3/4,TRBJ1-2,CASSPPWTAYGYTF,0,5,1,5
TRBV12-3/4,TRBJ1-1,CASSPPAGLTEAFF,0,5,1,5
TRBV7-2,TRBJ2-3,CASSPGLPTDTQYF,0,5,1,5
TRBV7-9,TRBJ2-5,CASSRDRGRETQYF,0,5,1,5
TRBV28,TRBJ1-5,CASSQAGMGQPQHF,0,5,1,5
TRBV2,TRBJ2-3,CASSGLTVPDTQYF,0,5,1,5
TRBV6-4,TRBJ2-1,CASSEETEDNEQFF,0,5,1,5
TRBV2,TRBJ2-7,CASSEASGSQEQYF,0,5,1,5
TRBV7-9,TRBJ1-1,CASSLSQGATEAFF,0,5,1,5
TRBV7-9,TRBJ2-1,CASSLAAGADEQFF,0,5,1,5
TRBV7-2,TRBJ1-2,CASSLELDNYGYTF,0,5,1,5
TRBV11-1,TRBJ2-1,CASSLEREGNEQFF,0,5,1,5
TRBV2,TRBJ2-7,CASSLKAVSYEQYF,0,5,1,5
TRBV7-9,TRBJ2-1,CASSSGREFAEQFF,0,5,1,5
TRBV6-2/3/5/6,TRBJ2-1,CASSYSGTYNEQFF,0,5,1,5
TRBV7-9,TRBJ1-1,CASSLDPPNTEAFF,0,5,1,5
TRBV3-1,TRBJ1-4,CASSPRDTNEKLFF,0,5,1,5
TRBV7-9,TRBJ2-7,CASSRGSQSSEQYF,0,5,1,5
TRBV7-2,TRBJ2-7,CASSRRMKEYEQYF,0,5,1,5
TRBV7-8,TRBJ1-4,CASSVSTTNEKLFF,0,5,1,5
TRBV7-2,TRBJ1-2,CASSAGGDPSRYTF,0,5,1,5
TRBV9,TRBJ2-1,CASSASSSYSEQFF,0,5,1,5
TRBV6-2/3/5/6,TRBJ2-7,CASSTTGASYEQYF,0,5,1,5
TRBV2,TRBJ1-1,CASRAPAIETEAFF,0,5,1,5
TRBV2,TRBJ1-1,CASRGDPGGTEAFF,0,5,1,5
TRBV2,TRBJ1-1,CASRTDRMNTEAFF,0,5,1,5
TRBV6-2/3/5/6,TRBJ2-2,CTSSYSRVPGELFF,0,5,1,5
TRBV5-1,TRBJ2-1,CASSLEGRYNEQFF,0,5,1,5
TRBV5-1,TRBJ2-4,CASSSASRGNIQYF,0,5,1,5
TRBV4-3,TRBJ2-3,CASSQGSSADTQYF,0,5,1,5
TRBV4-1,TRBJ2-5,CASSQGQGAETQYF,0,5,1,5
TRBV4-1,TRBJ1-2,CASSATGDGYGYTF,0,5,1,5
TRBV5-1,TRBJ2-1,CASSTGTGRNEQFF,0,5,1,5
TRBV4-1,TRBJ2-7,CASRPGQQSYEQYF,0,5,1,5
TRBV5-1,TRBJ2-1,CASRGTGPRNEQFF,0,5,1,5
TRBV20-1,TRBJ2-2,CSASKTANTGELFF,0,5,1,5
TRBV20-1,TRBJ2-6,CSARTGVGANVLTF,0,5,1,5
TRBV20-1,TRBJ2-3,CSAHAGLASNTQYF,0,5,1,5
TRBV29-1,TRBJ2-7,CSVVRDSSSYEQYF,0,5,1,5
TRBV29-1,TRBJ2-2,CSVEGSQNTGELFF,0,5,1,5
TRBV29-1,TRBJ2-2,CSVTYPSNTGELFF,0,5,1,5
TRBV29-1,TRBJ2-3,CSVRGQGSSDTQYF,0,5,1,5
TRBV29-1,TRBJ1-1,CSGRESPGRREAFF,0,5,1,5
TRBV29-1,TRBJ1-2,CRVEDMREGDGYTF,0,5,1,5
TRBV19,TRBJ1-1,RASILSQGNTEAFF,0,5,1,5
TRBV5-1,TRBJ2-7,RASSLNRGWNEQYF,0,5,1,5
TRBV5-1,TRBJ1-4,RASSQTMGSEKLFF,0,5,1,5
TRBV30,TRBJ1-4,CAWASSLFEKLFF,0,5,1,5
TRBV30,TRBJ2-3,CAWTGGGTDTQYF,0,5,1,5
TRBV7-9,TRBJ1-1,CASCGQGNAEAFF,0,5,1,5
TRBV28,TRBJ2-5,CASGMTGEETQYF,0,5,1,5
TRBV19,TRBJ2-5,CASSRQAGETQYF,0,5,1,5
TRBV19,TRBJ2-7,CASSINQLGEQYF,0,5,1,5
TRBV18,TRBJ2-7,CASSQGAAYEQYF,0,5,1,5
TRBV2,TRBJ2-7,CASGGTARWEQYF,0,5,1,5
TRBV6-2/3/5/6,TRBJ1-4,CASGGNLRGKLFF,0,5,1,5
TRBV28,TRBJ1-1,CASITSRNTEAFF,0,5,1,5
TRBV6-2/3/5/6,TRBJ2-1,CASTYWIEGEQFF,0,5,1,5
TRBV12-3/4,TRBJ1-1,CASSFGRNTEAFF,0,5,1,5
TRBV6-2/3/5/6,TRBJ2-5,CASSWREPRTQYF,0,5,1,5
TRBV6-2/3/5/6,TRBJ1-1,CASSYSGDVEAFF,0,5,1,5
TRBV6-2/3/5/6,TRBJ1-1,CASSYDERTEALF,0,5,1,5
TRBV7-9,TRBJ1-5,CASSPNTDQPQHF,0,5,1,5
TRBV2,TRBJ2-1,CASSETGGNEQFF,0,5,1,5
TRBV5-4,TRBJ2-4,CASSLAGKNIQYF,0,5,1,5
TRBV7-2,TRBJ2-3,CASSLGLTDTQYF,0,5,1,5
TRBV11-2,TRBJ2-7,CASSLESRGEQYF,0,5,1,5
TRBV7-9,TRBJ1-1,CASSPTRDTEAFF,0,5,1,5
TRBV7-2,TRBJ1-2,CASSRDRNYGYTF,0,5,1,5
TRBV6-2/3/5/6,TRBJ1-2,CASRTGTGEGYTF,0,5,1,5
TRBV5-1,TRBJ1-5,CAGARVSNQPQHF,0,5,1,5
TRBV5-1,TRBJ2-1,CASTKQGGNEQFF,0,5,1,5
TRBV5-1,TRBJ2-7,CASSLVQGYEQYF,0,5,1,5
TRBV5-1,TRBJ2-7,CASSLGPRGEEDF,0,5,1,5
TRBV5-1,TRBJ2-7,CASSLDQWGEEYF,0,5,1,5
TRBV5-1,TRBJ2-7,CASKFMEGGEQYF,0,5,1,5
TRBV20-1,TRBJ2-1,CSVLAGPYNEQFF,0,5,1,5
TRBV20-1,TRBJ2-2,CSASKAMFGELFF,0,5,1,5
TRBV20-1,TRBJ2-1,CSARVTSGNEQSF,0,5,1,5
TRBV20-1,TRBJ2-3,CSAPGQGVDTQYF,0,5,1,5
TRBV29-1,TRBJ1-1,CSVFPGSNTEAFF,0,5,1,5
TRBV29-1,TRBJ1-5,CSVAIQSNQPQHF,0,5,1,5
TRBV29-1,TRBJ2-1,CSVGGTSLKEQFF,0,5,1,5
TRBV29-1,TRBJ1-1,CSVGGRMNTEAFF,0,5,1,5
TRBV29-1,TRBJ1-4,CSAQGKANEKLFF,0,5,1,5
TRBV29-1,TRBJ1-5,CSATDRVGQPQHF,0,5,1,5
TRBV7-6,TRBJ2-7,RASSSRISYEQYF,0,5,1,5
TRBV10-3,TRBJ2-7,CAIRKGAYEQYF,0,5,1,5
TRBV15,TRBJ2-7,CATSRDFGEQYF,0,5,1,5
TRBV19,TRBJ2-2,CASSLQSGELFF,0,5,1,5
TRBV27,TRBJ2-7,CASFGTNYEQYF,0,5,1,5
TRBV18,TRBJ2-3,CASSPPTDTQYF,0,5,1,5
TRBV12-3/4,TRBJ2-7,CASSLAIYEQYF,0,5,1,5
TRBV5-6,TRBJ1-4,CASSPDQGQLFF,0,5,1,5
TRBV7-2,TRBJ1-3,CASSVFGNTIYF,0,5,1,5
TRBV5-6,TRBJ2-7,CASSSPGLEQYF,0,5,1,5
TRBV11-2,TRBJ2-5,CASSPQQETQYF,0,5,1,5
TRBV3-1,TRBJ1-1,CASSQTNTEAFF,0,5,1,5
TRBV7-6,TRBJ2-5,CASSMAGETQYF,0,5,1,5
TRBV28,TRBJ1-2,CASRYRGYGYTF,0,5,1,5
TRBV11-3,TRBJ2-1,CASRGGAGEQFF,0,5,1,5
TRBV10-2,TRBJ2-7,CASSTRFYEQYF,0,5,1,5
TRBV4-1,TRBJ2-3,CASSLPADTQYF,0,5,1,5
TRBV4-3,TRBJ2-2,CASSHLGGELFF,0,5,1,5
TRBV29-1,TRBJ2-1,CSLQGPYNEQFF,0,5,1,5
TRBV20-1,TRBJ2-1,CSAVRLADEQFF,0,5,1,5
TRBV20-1,TRBJ2-5,CSAKWFAETQYF,0,5,1,5
TRBV29-1,TRBJ1-5,CSVGQSNQPQHF,0,5,1,5
TRBV29-1,TRBJ1-2,CSVEDGVWGYTF,0,5,1,5
TRBV29-1,TRBJ2-1,CSVVPADNEQFF,0,5,1,5
TRBV29-1,TRBJ2-5,CSARETGETQYF,0,5,1,5
TRBV29-1,TRBJ1-2,CSGGQGNYGYTF,0,5,1,5
TRBV6-2/3/5/6,TRBJ2-2,CASGMGGELFF,0,5,1,5
TRBV6-2/3/5/6,TRBJ1-2,CASSYGYGYTF,0,5,1,5
TRBV6-4,TRBJ2-3,CASSDPDTQYF,0,5,1,5
TRBV5-6,TRBJ2-3,CASSLWDTQYF,0,5,1,5
TRBV14,TRBJ2-7,CASSSNYEQYF,0,5,1,5
TRBV7-8,TRBJ2-7,CASSVYYEQYF,0,5,1,5
TRBV14,TRBJ2-3,CASSTEDTQYF,0,5,1,5
TRBV6-1,TRBJ2-3,CASRNRDTQYF,0,5,1,5
TRBV20-1,TRBJ2-1,CSAGLEDEQFF,0,5,1,5
TRBV29-1,TRBJ1-2,CSAGWDYGYTF,0,5,1,5
TRBV29-1,TRBJ1-1,CSAGTSEAFF,0,5,1,5
TRBV29-1,TRBJ1-1,CSGGDTEAFF,0,5,1,5
TRBV6-4,TRBJ1-5,CASSQPQHF,0,5,1,5
TRBV12-5,TRBJ2-7,CASGSLPWGIFPSYEQYF,0,5,1,5
TRBV2,TRBJ1-2,CASSAPLSSDSKNYGYTF,0,5,1,5
TRBV11-2,TRBJ2-4,CAGTPGGLLAKNFQYF,0,5,1,5
TRBV12-3/4,TRBJ2-6,CASSLYSAMGANVLTF,0,5,1,5
TRBV13,TRBJ2-2,CASSLTSGTKTGELFF,0,5,1,5
TRBV4-3,TRBJ1-3,CAGSQDVYSSGNTIYF,0,5,1,5
TRBV6-4,TRBJ1-1,CASGDRGPMNTEAFF,0,5,1,5
TRBV5-1,TRBJ1-4,RASRVNSGANEKLFF,0,5,1,5
TRBV5-4,TRBJ2-3,CASRVTGDTDTQYF,0,5,1,5
TRBV12-5,TRBJ1-5,CASGLVLGQGLLF,0,5,1,5
TRBV4-2,TRBJ2-7,CASSQDIVTQGPRLEQYF,0,5,1,5
TRBV2,TRBJ1-4,CASGGQAVFGEKLFF,0,5,1,5
TRBV29-1,TRBJ2-2,CSVQEGVNTGELFF,0,5,1,5
TRBV7-9,TRBJ2-3,CASSPGSGGSSTDTQYF,0,5,1,5
TRBV12-3/4,TRBJ2-1,CASSETSVGYNEQFF,0,5,1,5
TRBV6-4,TRBJ2-7,CASSDRVGYEQYF,0,4,1,4
TRBV6-2/3/5/6,TRBJ1-1,CASLLSLTGTEFPEAFF,0,4,1,4
TRBV29-1,TRBJ2-5,CSVEGGREETQYF,0,4,1,4
TRBV7-2,TRBJ2-6,CASITRGQGLYGAGANVLTF,0,4,1,4
TRBV6-2/3/5/6,TRBJ2-3,CASSLWPGGADTQYF,0,4,1,4
TRBV3-1,TRBJ2-5,CASGQEAGEETQYF,0,4,1,4
TRBV30,TRBJ2-7,CAWTPSSGTYEQYF,0,4,1,4
TRBV24-1,TRBJ2-1,CATSDPGLAGRSSYNEQFF,0,4,1,4
TRBV19,TRBJ2-1,CASSIEGTGGIMSYNEQFF,0,4,1,4
TRBV6-2/3/5/6,TRBJ1-2,CASSFLEGMKTAANYGYTF,0,4,1,4
TRBV3-1,TRBJ2-3,CASSQDSYVTSDATDTQYF,0,4,1,4
TRBV29-1,TRBJ2-6,CSVEDRVSSHPLGANVLTF,0,4,1,4
TRBV30,TRBJ2-7,CAWSVKGTAGHDFYEQYF,0,4,1,4
TRBV5-1,TRBJ2-6,CASSPVPRGKAGANVLTF,0,4,1,4
TRBV12-5,TRBJ2-7,CASGFGEREGLTYEQYF,0,4,1,4
TRBV3-1,TRBJ2-1,CASGQEVGLALTNEQFF,0,4,1,4
TRBV7-3,TRBJ1-5,CASSFTTGNEGGQPQHF,0,4,1,4
TRBV6-2/3/5/6,TRBJ1-6,CASSYSNYIQTESPLHF,0,4,1,4
TRBV6-2/3/5/6,TRBJ2-1,CASSYLITGPLYNEQFF,0,4,1,4
TRBV6-1,TRBJ2-4,CASSQLRGGDIKNIQYF,0,4,1,4
TRBV5-6,TRBJ2-7,CASSLEQTGGFRYEQYF,0,4,1,4
TRBV7-6,TRBJ2-5,CASSSFTGTSGQETQYF,0,4,1,4
TRBV7-2,TRBJ2-7,CASSSTAEGDFSYEQYF,0,4,1,4
TRBV12-3/4,TRBJ2-6,CASSWDNQLSGANVLTF,0,4,1,4
TRBV14,TRBJ2-2,CASSYRQGAANTGELFF,0,4,1,4
TRBV7-6,TRBJ1-2,CASSLLGQGGTNYGYTF,0,4,1,4
TRBV3-1,TRBJ2-3,CASSPVPGTGLGDTQYL,0,4,1,4
TRBV12-3/4,TRBJ2-3,CASSPGTSGIRTDTQYF,0,4,1,4
TRBV5-6,TRBJ2-4,CASSRSGLADLGNIQYF,0,4,1,4
TRBV3-1,TRBJ1-2,CASSQALQEYLTGGYTF,0,4,1,4
TRBV7-2,TRBJ2-2,CASSKGLAGTNTGELFF,0,4,1,4
TRBV24-1,TRBJ2-3,CTTSDTTGTGDTDTQYF,0,4,1,4
TRBV5-1,TRBJ2-7,CASSFQGAGGPNYEQYF,0,4,1,4
TRBV4-3,TRBJ2-3,CASSPSLTSGRQDTQYF,0,4,1,4
TRBV4-3,TRBJ2-3,CASSQDLGSRRTDTQYF,0,4,1,4
TRBV20-1,TRBJ1-4,CSASLTETWATNEKLSF,0,4,1,4
TRBV29-1,TRBJ2-1,CSVARARKLAGVNEQFF,0,4,1,4
TRBV15,TRBJ2-1,CATSRRTGISYNEQFF,0,4,1,4
TRBV19,TRBJ2-4,CASSSRAEGAKNIQYF,0,4,1,4
TRBV19,TRBJ1-5,CASSPGRAYSNQPQHF,0,4,1,4
TRBV19,TRBJ2-1,CASSPTLAGSYNEQFF,0,4,1,4
TRBV19,TRBJ2-2,CASSIQGRPGTGELFF,0,7,1,7
TRBV19,TRBJ2-7,CASSRLPGTSTDEQYF,0,4,1,4
TRBV18,TRBJ2-3,CASSPRASDSTDTQYF,0,4,1,4
TRBV2,TRBJ2-3,CASLKLHSGRTDTQYF,0,4,1,4
TRBV6-2/3/5/6,TRBJ1-3,CASSYPQGSSGNTIYF,0,4,1,4
TRBV6-2/3/5/6,TRBJ1-1,CASSYSPAWGVTEAFF,0,4,1,4
TRBV6-2/3/5/6,TRBJ2-1,CASSYSESGPRNEQFF,0,4,1,4
TRBV6-2/3/5/6,TRBJ1-5,CASSYSSQGNNQPQHF,0,4,1,4
TRBV6-2/3/5/6,TRBJ2-3,CASSPRTGGIGDTQYF,0,4,1,4
TRBV2,TRBJ2-7,CASSEASLTYSYEQYF,0,4,1,4
TRBV2,TRBJ2-2,CASSEGIGPYTGELFF,0,4,1,4
TRBV2,TRBJ2-7,CASSEESRDPPCEQYF,0,4,1,4
TRBV7-2,TRBJ2-1,CASSLGGLAYYNEQFF,0,4,1,4
TRBV7-9,TRBJ1-4,CASSLSPGMGEEKLFF,0,4,1,4
TRBV7-3,TRBJ2-1,CASSLQGLAGANEQFF,0,4,1,4
TRBV7-2,TRBJ2-4,CASSLVGTGVKNIQYF,0,4,1,4
TRBV7-9,TRBJ2-6,CASSLAWGAGANVLTF,0,4,1,4
TRBV5-5,TRBJ2-3,CASSWAGSPETDTQYF,0,4,1,4
TRBV7-9,TRBJ2-7,CASSLRRETGAYEQYF,0,4,1,4
TRBV7-3,TRBJ2-1,CASSLTGTGGYNEQFF,0,4,1,4
TRBV3-1,TRBJ2-5,CASSPFGFDFKETQYF,0,4,1,4
TRBV7-9,TRBJ1-6,CASSPASGTGNSPLHF,0,4,1,4
TRBV7-9,TRBJ1-1,CASSRPGTGVGTEAFF,0,4,1,4
TRBV7-8,TRBJ1-1,CASSQEGGATNTEAFF,0,4,1,4
TRBV14,TRBJ2-7,CASSQEQGRTLGGQYF,0,4,1,4
TRBV9,TRBJ1-1,CASSVDQTVGNTEAFF,0,4,1,4
TRBV9,TRBJ2-7,CASSVAPSGQGYEQYF,0,4,1,4
TRBV6-1,TRBJ2-7,CASSVAGGNNFREQYF,0,4,1,4
TRBV9,TRBJ2-3,CASSVIPGGPTDTQYF,0,4,1,4
TRBV5-4,TRBJ2-7,CASSAIFGTKNHEQYF,0,4,1,4
TRBV9,TRBJ1-6,CASSAASDRGSSPLHF,0,4,1,4
TRBV6-1,TRBJ2-6,CASSEGRNSGANVLTF,0,4,1,4
TRBV6-2/3/5/6,TRBJ2-3,CASRPSGRALSDTQYF,0,4,1,4
TRBV5-1,TRBJ2-1,CASSLGGGVGYNEQFF,0,4,1,4
TRBV5-1,TRBJ2-7,CASSLGGSGISYEQYF,0,4,1,4
TRBV5-1,TRBJ1-1,CASSLDRVPSGLGAFF,0,4,1,4
TRBV4-3,TRBJ2-1,CASSQERSGVYNEQFF,0,4,1,4
TRBV5-1,TRBJ2-1,CASSTGQGSSYNEQFF,0,4,1,4
TRBV20-1,TRBJ1-5,CSASRGAGAVDQPQHF,0,4,1,4
TRBV20-1,TRBJ2-2,CSARDGARVNTGELFF,0,4,1,4
TRBV29-1,TRBJ1-1,CSGLGTGKIAGLEAFF,0,4,1,4
TRBV12-5,TRBJ2-5,CASGTGLAGEETQYF,0,4,1,4
TRBV7-8,TRBJ2-5,CACSLSHQLLETQYF,0,4,1,4
TRBV30,TRBJ2-1,CAWDPGLAGGDEQFF,0,4,1,4
TRBV30,TRBJ2-7,CAWSPVDSQATEQYF,0,4,1,4
TRBV12-3/4,TRBJ1-1,CATRPPTEMNTEAFF,0,4,1,4
TRBV2,TRBJ2-2,CATLLGAAGTGELFF,0,4,1,4
TRBV24-1,TRBJ2-1,CATSDLVAGGTEQFF,0,4,1,4
TRBV15,TRBJ1-5,CATSIRDAHNQPQHF,0,4,1,4
TRBV19,TRBJ1-5,CASSFRRDRGQPQHF,0,4,1,4
TRBV19,TRBJ1-1,CASSLGQGGSTEAFF,0,4,1,4
TRBV19,TRBJ2-7,CASSARAGVSYEQYF,0,4,1,4
TRBV19,TRBJ2-1,CASSTGLAGYNEQFF,0,4,1,4
TRBV19,TRBJ1-1,CASSAYGTVNTEAFS,0,4,1,4
TRBV19,TRBJ1-6,CASSDHGTGSSPLHF,0,4,1,4
TRBV19,TRBJ1-5,CASNRGDRGYQPQHF,0,4,1,4
TRBV6-2/3/5/6,TRBJ2-7,CASSRALRGSYEQYF,0,4,1,4
TRBV27,TRBJ2-1,CASTMGGGSYNEQFI,0,4,1,4
TRBV6-2/3/5/6,TRBJ2-5,CASSLGGEPQETQYF,0,4,1,4
TRBV12-3/4,TRBJ1-5,CASSLRTGGVGPQHF,0,4,1,4
TRBV7-9,TRBJ2-6,CASSSRGSGANVLTF,0,4,1,4
TRBV6-4,TRBJ2-2,CASSRQGRATGELFF,0,4,1,4
TRBV25-1,TRBJ2-3,CASSVSGASTDTQYF,0,4,1,4
TRBV6-1,TRBJ1-3,CASSAQGNPGNTIYF,0,4,1,4
TRBV6-1,TRBJ2-4,CASSDRRVSKNIQYF,0,4,1,4
TRBV12-3/4,TRBJ1-1,CASSELRGANTEAFF,0,4,1,4
TRBV12-3/4,TRBJ2-7,CASSMGPWVGYEQYF,0,4,1,4
TRBV7-2,TRBJ1-1,CASSFRASGNTEAFF,0,4,1,4
TRBV3-1,TRBJ2-1,CASSFMGGNKNEQFF,0,4,1,4
TRBV7-2,TRBJ2-1,CASSLQESSYNEQFF,0,4,1,4
TRBV5-5,TRBJ1-5,CASSLAPGARQPQHF,0,4,1,4
TRBV5-5,TRBJ1-2,CASSLAGRDYYGYTF,0,4,1,4
TRBV7-8,TRBJ1-2,CASSLLGGSTYGYTF,0,4,1,4
TRBV7-6,TRBJ2-5,CASSLVPGGQETQYF,0,4,1,4
TRBV7-2,TRBJ2-7,CASSLVRVLSYEQYF,0,4,1,4
TRBV7-9,TRBJ2-7,CASSLGDRNFYEQYF,0,4,1,4
TRBV7-9,TRBJ1-2,CASSLGRDGNYGYTF,0,4,1,4
TRBV7-3,TRBJ2-2,CASSLNGGNTGELFF,0,4,1,4
TRBV6-4,TRBJ2-3,CASSSTGQGADTQYF,0,4,1,4
TRBV9,TRBJ2-1,CASSSRGGRYNEQFF,0,4,1,4
TRBV14,TRBJ2-1,CASSLVAGGYNEQFF,0,4,1,4
TRBV5-4,TRBJ1-2,CASSLGGGDDYGYTF,0,4,1,4
TRBV5-4,TRBJ2-2,CASSLGLAESGELFF,0,4,1,4
TRBV6-4,TRBJ1-2,CASSLGQGANYGYTF,0,4,1,4
TRBV7-2,TRBJ1-6,CASSPFSSYNSPLHF,0,4,1,4
TRBV7-9,TRBJ2-3,CASSPGLGSTDTQYF,0,4,1,4
TRBV7-2,TRBJ2-3,CASSPGQGVGDTQYF,0,4,1,4
TRBV7-2,TRBJ1-1,CASSPTARAMAEAFF,0,4,1,4
TRBV5-4,TRBJ2-1,CASSPKGLAGNEQFF,0,4,1,4
TRBV13,TRBJ2-1,CASSPRLAEYNEQFF,0,4,1,4
TRBV3-1,TRBJ2-1,CASSPELAGENEQFF,0,4,1,4
TRBV3-1,TRBJ2-7,CASSRSGDRDYEQYF,0,4,1,4
TRBV7-2,TRBJ2-7,CASSRPGQRSYEQYF,0,4,1,4
TRBV6-1,TRBJ2-5,CASSRLGGPPETQYF,0,4,1,4
TRBV3-1,TRBJ1-2,CASSQGQGYAYGYTF,0,4,1,4
TRBV14,TRBJ1-2,CASSQDSIQSYGYTF,0,4,1,4
TRBV4-2,TRBJ1-2,CASSQETGPYYGYTF,0,4,1,4
TRBV9,TRBJ1-4,CASSVGGGQVEKLFF,0,4,1,4
TRBV9,TRBJ2-3,CASSESGGTTDTQYF,0,4,1,4
TRBV9,TRBJ2-7,CASSERGGFPYEQYF,0,4,1,4
TRBV12-3/4,TRBJ2-1,CASRVAGGPTREQFF,0,4,1,4
TRBV13,TRBJ2-2,CASNIAGRDTEELFF,0,4,1,4
TRBV5-1,TRBJ2-4,CASGLAQGRVNIQYF,0,4,1,4
TRBV5-1,TRBJ2-5,CASIPTVPKGETQYF,0,4,1,4
TRBV10-1,TRBJ2-5,CASSARGGRQETQYF,0,4,1,4
TRBV5-1,TRBJ1-1,CASSLVTGVNTEAFF,0,4,1,4
TRBV5-1,TRBJ2-3,CASSLGGRGTDTQYF,0,4,1,4
TRBV5-1,TRBJ1-4,CASSLTGQATEKLCF,0,4,1,4
TRBV11-2,TRBJ2-7,CASSLEPGANSEQYF,0,4,1,4
TRBV5-1,TRBJ1-2,CASSSTPGIPRGYTF,0,4,1,4
TRBV5-1,TRBJ1-1,CASSLNLGMNTEAFF,0,4,1,4
TRBV4-1,TRBJ1-1,CASSQDRQGDTEAFF,0,4,1,4
TRBV4-1,TRBJ2-1,CASSQDRTSTNEQFF,0,4,1,4
TRBV4-3,TRBJ2-1,CASSAGTSGNNEQFF,0,4,1,4
TRBV5-1,TRBJ2-1,CASSATSGSKNEQFF,0,4,1,4
TRBV20-1,TRBJ2-6,CSASIRDTGANVLTF,0,4,1,4
TRBV20-1,TRBJ2-1,CSARSLGRIYNEQFF,0,4,1,4
TRBV20-1,TRBJ2-5,CSARDGTSAAATQYF,0,4,1,4
TRBV20-1,TRBJ2-7,CSARDGSGASGEQYF,0,4,1,4
TRBV29-1,TRBJ1-1,CSVPTGGSWNTEAFF,0,4,1,4
TRBV29-1,TRBJ2-1,CSVEGRGRAAGEQFF,0,4,1,4
TRBV29-1,TRBJ2-3,CSAPGVGGFTDTQYF,0,4,1,4
TRBV29-1,TRBJ2-2,CSGALERGGLGELFF,0,4,1,4
TRBV7-2,TRBJ1-2,SASSLRPGNQYGYTF,0,4,1,4
TRBV5-4,TRBJ1-1,CPSSLQGWNTEAFF,0,4,1,4
TRBV12-5,TRBJ1-2,CASGLVARLYGYTF,0,4,1,4
TRBV7-8,TRBJ2-2,CAGSLGDMTGELFF,0,4,1,4
TRBV15,TRBJ2-7,CATSRGDGRYEQYF,0,4,1,4
TRBV27,TRBJ2-5,CATKARDLQETQYF,0,4,1,4
TRBV2,TRBJ1-4,CATGQGMANEKLFF,0,4,1,4
TRBV19,TRBJ1-1,CASTSDRFGRQAFF,0,4,1,4
TRBV19,TRBJ1-1,CASSIRTMKTEAFF,0,4,1,4
TRBV19,TRBJ2-3,CASSIAVRTDTQYY,0,4,1,4
TRBV19,TRBJ1-4,CASRLDRGNEKLFF,0,4,1,4
TRBV12-3/4,TRBJ2-1,CASCRAGPYNEQFF,0,4,1,4
TRBV12-3/4,TRBJ2-1,CASALAGGYNEQFF,0,4,1,4
TRBV7-2,TRBJ2-3,CASGPRQGTDTQYF,0,4,1,4
TRBV25-1,TRBJ1-2,CASEGAWAEYGYTF,0,4,1,4
TRBV2,TRBJ1-2,CASTPGTDNYGYTF,0,4,1,4
TRBV5-6,TRBJ2-4,CASTQGAAKNIQYF,0,4,1,4
TRBV6-2/3/5/6,TRBJ1-4,CASSFSGGDEKLFF,0,4,1,4
TRBV27,TRBJ2-3,CASSFRARLDTQYF,0,4,1,4
TRBV27,TRBJ2-5,CASSLSGQGGTQYF,0,4,1,4
TRBV6-1,TRBJ1-5,CASSATSSNQPQHF,0,4,1,4
TRBV2,TRBJ2-1,CASSELAGGGEQFF,0,4,1,4
TRBV6-1,TRBJ1-3,CASSEQSSGNTIYF,0,4,1,4
TRBV7-9,TRBJ2-7,CASSFSRESYEQYF,0,4,1,4
TRBV7-9,TRBJ2-7,CASSFGRVVSEQYF,0,4,1,4
TRBV5-6,TRBJ1-1,CASSLGQRNTEAFF,0,4,1,4
TRBV5-6,TRBJ2-1,CASSLGRPGNEQFF,0,4,1,4
TRBV7-3,TRBJ2-1,CASSLDRGGGEQFF,0,4,1,4
TRBV7-2,TRBJ2-7,CASSLIPSSYEQYF,0,4,1,4
TRBV7-9,TRBJ2-5,CASSLTGGQETQYF,0,4,1,4
TRBV7-3,TRBJ2-1,CASSLSTKNNEQFF,0,4,1,4
TRBV13,TRBJ2-1,CASSLRTFYNEQFF,0,4,1,4
TRBV7-2,TRBJ2-3,CASSLGREGDTQYF,0,4,1,4
TRBV11-3,TRBJ2-5,CASSLDDGGETQYF,0,4,1,4
TRBV7-2,TRBJ2-7,CASSLELGTYEQYF,0,4,1,4
TRBV13,TRBJ2-5,CASSSPRARETQYF,0,4,1,4
TRBV7-6,TRBJ2-1,CASSSRMRSNEQFF,0,4,1,4
TRBV7-2,TRBJ1-1,CASSSTGGSTEAFF,0,4,1,4
TRBV11-3,TRBJ1-1,CASSSRQGNAVAFF,0,4,1,4
TRBV5-4,TRBJ2-1,CASSYTGGFDEQFF,0,4,1,4
TRBV3-1,TRBJ2-7,CASSLDIASYEQYF,0,4,1,4
TRBV11-1,TRBJ1-1,CASSLTRENTEAFF,0,4,1,4
TRBV7-2,TRBJ2-7,CASSPTGGENEQYF,0,4,1,4
TRBV7-3,TRBJ1-2,CASSRVGRLYGYTF,0,4,1,4
TRBV14,TRBJ1-6,CASSQERAYGPLHF,0,4,1,4
TRBV3-1,TRBJ1-6,CASSTQGTNSPLHF,0,4,1,4
TRBV2,TRBJ1-5,CASSRSIGNQPQHF,0,4,1,4
TRBV5-6,TRBJ2-3,CASRLGLGEDTQYF,0,4,1,4
TRBV28,TRBJ1-1,CASRPTGGNTEAFF,0,4,1,4
TRBV28,TRBJ2-6,CASKPGAGANVLTF,0,4,1,4
TRBV6-2/3/5/6,TRBJ1-1,CARSPRTLNTEAFF,0,4,1,4
TRBV19,TRBJ2-7,CANTSDRVLDEQYF,0,4,1,4
TRBV20-1,TRBJ2-7,CCASSGGDRYEQYF,0,4,1,4
TRBV5-1,TRBJ2-3,CASSFTSGSDTQYF,0,4,1,4
TRBV5-1,TRBJ2-5,CASSLVAAGETQYF,0,4,1,4
TRBV5-1,TRBJ2-7,CASSSTGGSYEQYF,0,4,1,4
TRBV4-1,TRBJ1-2,CASSLDRLTGGYTF,0,4,1,4
TRBV5-1,TRBJ1-2,CASSPGFTRAGYTF,0,4,1,4
TRBV4-1,TRBJ2-1,CASSPKRAGTGQFF,0,4,1,4
TRBV5-1,TRBJ1-4,CASSQGAADEKLFF,0,4,1,4
TRBV20-1,TRBJ1-5,CSASRGQGYQPQHF,0,4,1,4
TRBV20-1,TRBJ2-1,CSARGRGLLNEQFF,0,4,1,4
TRBV20-1,TRBJ2-3,CSARGLGRADTQYF,0,4,1,4
TRBV20-1,TRBJ1-2,CSASPPGQVYGYTF,0,4,1,4
TRBV20-1,TRBJ2-1,CSARGLAAPDEQFF,0,4,1,4
TRBV20-1,TRBJ1-4,CSARKTGKDEKLFF,0,4,1,4
TRBV20-1,TRBJ2-5,CSARQLQEQETQYF,0,4,1,4
TRBV20-1,TRBJ1-1,CSARVGDMDTEAFF,0,4,1,4
TRBV20-1,TRBJ2-7,CSARDRLFTYEQYF,0,4,1,4
TRBV20-1,TRBJ2-5,CSAREIAGGYRQYF,0,4,1,4
TRBV20-1,TRBJ1-4,CSAREQSYNEKLFF,0,4,1,4
TRBV29-1,TRBJ2-3,CSVEARTSTDTQYF,0,4,1,4
TRBV29-1,TRBJ2-1,CSVENQVGGDEQFF,0,4,1,4
TRBV29-1,TRBJ2-1,CSVSALAGVHEQFF,0,4,1,4
TRBV29-1,TRBJ2-6,CSVTRTGGANVLTF,0,4,1,4
TRBV29-1,TRBJ2-1,CSVLFGQGYYGQFF,0,4,1,4
TRBV4-3,TRBJ2-3,YASSQDGLADTQYF,0,4,1,4
TRBV12-5,TRBJ2-1,CASGLGLYNEQFF,0,4,1,4
TRBV30,TRBJ1-2,CAWSEDRGYGYTF,0,4,1,4
TRBV30,TRBJ1-1,CAWRRAPNTEAFF,0,4,1,4
TRBV30,TRBJ1-2,CAWRDRGDGGYTF,0,4,1,4
TRBV10-3,TRBJ2-1,CAITSFTDNEQFF,0,4,1,4
TRBV7-9,TRBJ2-2,CATLGTITGELFF,0,4,1,4
TRBV2,TRBJ2-7,CATLTRGSYEQNF,0,4,1,4
TRBV7-9,TRBJ1-2,CATVLGQNYGYTF,0,4,1,4
TRBV24-1,TRBJ1-1,CATSDSGTLEAFF,0,4,1,4
TRBV19,TRBJ1-2,CASTLPGGYGYTF,0,4,1,4
TRBV19,TRBJ1-6,CASSIRIGLPLHF,0,4,1,4
TRBV18,TRBJ2-4,CASSPSGTGAQYF,0,4,1,4
TRBV18,TRBJ1-1,CASSPGGNTEAFF,0,4,1,4
TRBV18,TRBJ1-6,CASSGGRNSPLHF,0,4,1,4
TRBV12-3/4,TRBJ2-5,CASGSKVGVAQYF,0,4,1,4
TRBV7-9,TRBJ2-5,CASTPGQGETQYF,0,4,1,4
TRBV7-9,TRBJ2-7,CASTSTGTYEQYF,0,4,1,4
TRBV28,TRBJ2-2,CASSFTNTGELFF,0,4,1,4
TRBV12-3/4,TRBJ2-7,CASSFRAAYEQYF,0,4,1,4
TRBV7-9,TRBJ2-7,CASSLGVWIEQYF,0,4,1,4
TRBV12-3/4,TRBJ1-2,CASSLTENYGYTF,0,4,1,4
TRBV12-3/4,TRBJ1-2,CASSLKLIYGYTF,0,4,1,4
TRBV6-2/3/5/6,TRBJ1-1,CASSYSRRGEAFF,0,4,1,4
TRBV12-3/4,TRBJ1-2,CASSYGQGKIYTF,0,4,1,4
TRBV6-2/3/5/6,TRBJ2-5,CASSLIRQETQCF,0,4,1,4
TRBV2,TRBJ1-5,CASSRDGNQPQHF,0,4,1,4
TRBV2,TRBJ1-2,CASSVTLGYGYTF,0,4,1,4
TRBV25-1,TRBJ1-5,CASSAGSNQPQHF,0,4,1,4
TRBV6-1,TRBJ2-7,CASSGAFGDRENF,0,4,1,4
TRBV7-8,TRBJ1-5,CASSIGGAWPQHF,0,4,1,4
TRBV7-9,TRBJ1-5,CASSFLQGQPQHF,0,4,1,4
TRBV11-3,TRBJ2-1,CASSFVSFNEQFF,0,4,1,4
TRBV11-3,TRBJ1-1,CASSLGQDTEAFF,0,4,1,4
TRBV7-3,TRBJ2-3,CASSLQASGTQYF,0,4,1,4
TRBV7-2,TRBJ1-5,CASSLAKNQPQHF,0,4,1,4
TRBV11-2,TRBJ2-5,CASSLGRAETQYF,0,4,1,4
TRBV7-6,TRBJ2-3,CASSLDAADTQYF,0,4,1,4
TRBV12-3/4,TRBJ1-1,CASSSAGTGKAFF,0,4,1,4
TRBV7-9,TRBJ2-1,CASSPGTYNEQFF,0,4,1,4
TRBV9,TRBJ2-7,CASSPPRQGEQYF,0,4,1,4
TRBV7-9,TRBJ2-7,CASSPQGEYEQYF,0,4,1,4
TRBV3-1,TRBJ1-4,CASSQDSGSRLFF,0,4,1,4
TRBV14,TRBJ1-1,CASSQDYGNEAFF,0,4,1,4
TRBV4-2,TRBJ2-3,CASSQDSADTQYF,0,4,1,4
TRBV3-1,TRBJ1-1,CASSQERITEAFF,0,4,1,4
TRBV3-1,TRBJ2-3,CASSQIFMDTQYF,0,4,1,4
TRBV3-1,TRBJ1-1,CASSQTRTTEAFF,0,4,1,4
TRBV7-9,TRBJ2-7,CASSTPLRGRQYF,0,4,1,4
TRBV7-6,TRBJ2-3,CASSRLSTDTQYF,0,4,1,4
TRBV9,TRBJ1-4,CASSKGTAEKLFF,0,4,1,4
TRBV6-2/3/5/6,TRBJ2-7,CASRGGKDYEQYF,0,4,1,4
TRBV19,TRBJ1-5,CAKDSPRGQPQHF,0,4,1,4
TRBV5-1,TRBJ1-2,CASSFREGYGYTF,0,4,1,4
TRBV5-1,TRBJ2-7,CASSDGQGYEQYF,0,4,1,4
TRBV20-1,TRBJ2-3,CSARWGAPDTQYF,0,4,1,4
TRBV20-1,TRBJ2-7,CSARGAGTYEQYF,0,4,1,4
TRBV20-1,TRBJ2-7,CSARIPGLDEQYF,0,4,1,4
TRBV20-1,TRBJ2-1,CSAPSLAYNEQFF,0,4,1,4
TRBV20-1,TRBJ2-7,CSANREDLYEQYF,0,4,1,4
TRBV29-1,TRBJ2-1,CSPINGDRSEQFF,0,4,1,4
TRBV29-1,TRBJ1-2,CSVVVGGTGSYTF,0,4,1,4
TRBV29-1,TRBJ1-4,CSVAGTGVEKLFF,0,4,1,4
TRBV29-1,TRBJ1-2,CSVEDLRSYGYTF,0,4,1,4
TRBV29-1,TRBJ2-2,CSVRTSWGGELFF,0,4,1,4
TRBV29-1,TRBJ2-1,CNCVQGALGEQFF,0,4,1,4
TRBV30,TRBJ2-1,CAWSVTSGLLFF,0,4,1,4
TRBV11-2,TRBJ2-1,CAVSLSYNEQFF,0,4,1,4
TRBV2,TRBJ2-1,CASSSSGNEQFF,0,4,1,4
TRBV7-2,TRBJ2-6,CASFGRDDVLTF,0,4,1,4
TRBV2,TRBJ2-7,CASLDGYYEQYF,0,4,1,4
TRBV12-3/4,TRBJ1-1,CASSFGGTEAFF,0,4,1,4
TRBV3-1,TRBJ2-1,CASSLTGNEQFF,0,4,1,4
TRBV7-2,TRBJ2-5,CASSLPGSAQYF,0,4,1,4
TRBV9,TRBJ2-1,CASSSSYNEQFF,0,4,1,4
TRBV3-1,TRBJ2-7,CASSYTGYEQYF,0,4,1,4
TRBV7-8,TRBJ2-1,CASSPNYGEQFF,0,4,1,4
TRBV3-1,TRBJ2-7,CASSQFAAEQYF,0,4,1,4
TRBV14,TRBJ1-2,CASSQEAFGYTF,0,4,1,4
TRBV9,TRBJ2-3,CASSVAVDTQYF,0,4,1,4
TRBV9,TRBJ2-3,CASSGGENTQYF,0,4,1,4
TRBV6-2/3/5/6,TRBJ2-2,CASRLVPRELFF,0,4,1,4
TRBV20-1,TRBJ2-1,CVEETSGSKQFF,0,4,1,4
TRBV10-1,TRBJ1-5,CATRDVNQPQHF,0,4,1,4
TRBV5-1,TRBJ2-1,CASSFLSDEQFF,0,4,1,4
TRBV5-1,TRBJ2-7,CASSLTRNEQYF,0,4,1,4
TRBV5-1,TRBJ1-2,CASSPDRDGYTF,0,4,1,4
TRBV20-1,TRBJ1-5,CSARVSNQPQHF,0,4,1,4
TRBV29-1,TRBJ1-1,CSVGSPNTEAFF,0,4,1,4
TRBV29-1,TRBJ1-1,CSVDNLNTEAFF,0,4,1,4
TRBV29-1,TRBJ2-7,CSVEEDSYEQYF,0,4,1,4
TRBV29-1,TRBJ2-7,CSVRTETYEQYF,0,4,1,4
TRBV29-1,TRBJ1-4,CSVLQDTEKLFF,0,4,1,4
TRBV29-1,TRBJ1-3,CSALSSGNTIYF,0,4,1,4
TRBV30,TRBJ2-7,CASGTVYEQYF,0,4,1,4
TRBV30,TRBJ1-1,CAWSRRGEAFF,0,4,1,4
TRBV24-1,TRBJ2-1,CATSAYNEQFF,0,4,1,4
TRBV6-2/3/5/6,TRBJ2-1,CASTSFNEQFF,0,4,1,4
TRBV7-9,TRBJ2-3,CASTFLDTQYF,0,4,1,4
TRBV12-3/4,TRBJ2-1,CASSFSHEQFF,0,4,1,4
TRBV12-3/4,TRBJ1-5,CASSLEGAQHF,0,4,1,4
TRBV28,TRBJ1-5,CASSSYQPQHF,0,4,1,4
TRBV7-9,TRBJ1-1,CASSSFTEAFF,0,4,1,4
TRBV3-1,TRBJ2-7,CASSRRYEQYF,0,4,1,4
TRBV20-1,TRBJ2-1,CSASKAMVQFF,0,4,1,4
TRBV29-1,TRBJ2-1,CSPAGGNEQFF,0,4,1,4
TRBV29-1,TRBJ2-7,CSVRVSYEQYF,0,4,1,4
TRBV29-1,TRBJ2-1,CSVVAVNEQFF,0,4,1,4
TRBV7-2,TRBJ2-7,RASSSYYEQYF,0,4,1,4
TRBV20-1,TRBJ2-1,CSAREREQFF,0,4,1,4
TRBV29-1,TRBJ1-2,CSAGDNGYTF,0,4,1,4
TRBV10-3,TRBJ2-1,CAISEEFF,0,4,1,4
TRBV7-2,TRBJ2-4,CASSLDSPLGQGENIQYF,0,4,1,4
TRBV6-1,TRBJ1-1,CASSEAMAGPMNTEAFF,0,4,1,4
TRBV11-3,TRBJ1-1,CASSSYHNGPLNTEAFF,0,4,1,4
TRBV4-3,TRBJ2-3,CASGTGKLAGADTQHF,0,4,1,4
TRBV2,TRBJ1-1,CASTKDRVGTEAFF,0,4,1,4
TRBV28,TRBJ1-2,CASSSGGTNYGYTF,0,4,1,4
TRBV7-9,TRBJ2-4,CASSATGSDIQYF,0,4,1,4
TRBV7-2,TRBJ2-5,CASSHEAETQYF,0,4,1,4
TRBV11-1,TRBJ2-1,CASSHHNEQFS,0,4,1,4
TRBV5-6,TRBJ2-5,CASSLRNWETQYF,0,4,1,4
TRBV30,TRBJ2-3,CAWSARGTQYF,0,4,1,4
TRBV6-2/3/5/6,TRBJ2-7,CASSRGGLAGDSYEQYF,0,3,1,3
TRBV20-1,TRBJ2-3,CSAGPSRGLGADTQYF,0,3,1,3
TRBV29-1,TRBJ1-1,CSSLSGGSEAFF,0,3,1,3
TRBV5-1,TRBJ1-1,CASSLSAQLNTEAFF,0,3,1,3
TRBV20-1,TRBJ1-6,CSASEGTGQGNSPLHL,0,3,1,3
TRBV3-1,TRBJ2-1,CASSQNWDFSPSSYNEQFF,0,3,1,3
TRBV4-2,TRBJ2-7,CAGSQDLSRWDGVYEQYF,0,3,1,3
TRBV19,TRBJ1-6,CASSPSTVRGSYNSPLHF,0,3,1,3
TRBV19,TRBJ1-5,CASSHKMGDWSGNQPQHF,0,3,1,3
TRBV6-2/3/5/6,TRBJ1-5,CASSYSSRAGFGNQPQHF,0,3,1,3
TRBV7-2,TRBJ2-7,CASSLGGAGGAVRYEQYF,0,3,1,3
TRBV7-2,TRBJ2-1,CASSLRGRLAGEGNKQFF,0,3,1,3
TRBV5-4,TRBJ2-3,CASSLPTSGIAYTDTQYF,0,3,1,3
TRBV4-2,TRBJ2-7,CASSQEILAGGWSYEQYF,0,3,1,3
TRBV5-1,TRBJ2-1,CASSLETTGTPAYNEQFF,0,3,1,3
TRBV29-1,TRBJ2-2,CSVEDPWGSGVNTGELFF,0,3,1,3
TRBV5-4,TRBJ1-6,YASSLGTGERLRNSPLHF,0,3,1,3
TRBV30,TRBJ1-4,CAWTHGEQGEPNEKLFF,0,3,1,3
TRBV24-1,TRBJ2-1,CATSDLPAGLPHNEQFF,0,3,1,3
TRBV15,TRBJ2-7,CATSENLGQRGTYEQYF,0,3,1,3
TRBV19,TRBJ2-1,CASSDIIRTSGRNSQFI,0,3,1,3
TRBV6-2/3/5/6,TRBJ2-2,CASSYSTRDLNTGELFF,0,3,1,3
TRBV25-1,TRBJ2-5,CASSPGLAGGPRETQYF,0,3,1,3
TRBV27,TRBJ1-6,CASSPMSYRDRGSPLHF,0,3,1,3
TRBV6-4,TRBJ1-4,CASSDPHRSATNEKLFF,0,3,1,3
TRBV7-9,TRBJ1-1,CASSFGRAGDKNTEAFF,0,3,1,3
TRBV5-6,TRBJ1-5,CASSLAAGFEKDQPQHF,0,3,1,3
TRBV11-2,TRBJ2-3,CASSLAGGTSSTDTQYF,0,3,1,3
TRBV7-9,TRBJ1-1,CASSLVGQGIMNTEAFF,0,3,1,3
TRBV7-9,TRBJ2-7,CASSLVGWTGNSYEQYF,0,3,1,3
TRBV11-3,TRBJ1-6,CASSSRIPLGGNSPLHF,0,3,1,3
TRBV7-2,TRBJ2-7,CASSSGAYSQSSYEQYF,0,3,1,3
TRBV6-2/3/5/6,TRBJ2-1,CASSQWKGAFSYNEQFS,0,3,1,3
TRBV5-6,TRBJ2-1,CASSQGPGGHTHDEQFF,0,3,1,3
TRBV3-1,TRBJ2-7,CASSQDRLAGGTYEQYF,0,3,1,3
TRBV9,TRBJ2-1,CASSVGRTRTRGNEQFF,0,3,1,3
TRBV12-3/4,TRBJ2-3,CASNPDSPGLSTDTQYF,0,3,1,3
TRBV5-1,TRBJ2-2,CASSLAPLAGAPGELFF,0,3,1,3
TRBV5-1,TRBJ1-4,CASSLGTFGLTNEKLFF,0,3,1,3
TRBV5-1,TRBJ2-3,CASSRAPGTGGTDTQYF,0,3,1,3
TRBV4-1,TRBJ2-1,CASSQGPGQGGGYEQFF,0,3,1,3
TRBV4-3,TRBJ2-5,CASSQDGGASGGETQYF,0,3,1,3
TRBV29-1,TRBJ2-2,CSVDAERTGELTGELFF,0,3,1,3
TRBV12-5,TRBJ2-7,CASGLVLGTGVYEQYF,0,3,1,3
TRBV12-5,TRBJ2-7,CASGLVQGYQGNEQYF,0,3,1,3
TRBV30,TRBJ2-3,CAWSLLGQANTDTQYF,0,3,1,3
TRBV30,TRBJ1-5,CAWSVQSRGRVRPQHF,0,3,1,3
TRBV24-1,TRBJ2-6,CATSGPLGPGANVLTF,0,3,1,3
TRBV19,TRBJ1-1,CASSIGPGRRNTEAFF,0,3,1,3
TRBV19,TRBJ2-7,CASSDLRDRASHEQYF,0,3,1,3
TRBV19,TRBJ2-3,CASRPLTSGSTDTQYF,0,3,1,3
TRBV19,TRBJ1-1,CASNLRAAGGKTEAFF,0,3,1,3
TRBV19,TRBJ2-1,CASNPPGGRDNNEQFF,0,3,1,3
TRBV18,TRBJ2-1,CASSAGLTSSYNEQFF,0,3,1,3
TRBV18,TRBJ1-3,CASSPPGTRVRNTIYF,0,3,1,3
TRBV18,TRBJ1-5,CASSPPNQGGNQPQHF,0,3,1,3
TRBV18,TRBJ2-3,CASSRNRGTSTDTQYF,0,3,1,3
TRBV6-2/3/5/6,TRBJ2-7,CASPGTSGLGVYEQYF,0,3,1,3
TRBV2,TRBJ2-7,CASTWRWGEAAREQYF,0,3,1,3
TRBV27,TRBJ2-1,CASSLSGLADYNEQLF,0,3,1,3
TRBV6-2/3/5/6,TRBJ1-5,CASSLTGGGRNQPQHF,0,3,1,3
TRBV6-2/3/5/6,TRBJ1-5,CASSYRVEGGNQPQHF,0,3,1,3
TRBV6-1,TRBJ2-7,CASSAGQGVQLYEQYF,0,3,1,3
TRBV6-4,TRBJ2-1,CASSDGLAGLFNEQFF,0,3,1,3
TRBV7-8,TRBJ2-7,CASSFVHTETFYEQYF,0,3,1,3
TRBV5-4,TRBJ2-7,CASSLSSKSTGPEQYF,0,3,1,3
TRBV7-2,TRBJ2-1,CASSLALAGGYNEQFF,0,3,1,3
TRBV7-2,TRBJ2-3,CASSLGGRGATDTQYF,0,3,1,3
TRBV7-8,TRBJ1-4,CASSLFADRWVEKLFF,0,3,1,3
TRBV7-9,TRBJ2-1,CASSLSSSGTLEEQFF,0,3,1,3
TRBV7-9,TRBJ2-1,CASSLPGLAGGNEQFF,0,3,1,3
TRBV7-6,TRBJ2-1,CASSLGLAGGPDEQFF,0,3,1,3
TRBV7-2,TRBJ1-1,CASSLGQALWDTEAFF,0,3,1,3
TRBV11-2,TRBJ2-2,CASSLGGGSWTGELFF,0,3,1,3
TRBV7-2,TRBJ2-7,CASSLGGTGSHAEQYF,0,3,1,3
TRBV11-1,TRBJ2-5,CASSSSTSGYQETQYF,0,3,1,3
TRBV5-5,TRBJ2-5,CASSWEGDIHQETQYF,0,3,1,3
TRBV7-9,TRBJ1-4,CASSPRQTATNEKLFF,0,3,1,3
TRBV5-8,TRBJ2-7,CASSPGASGYSYEQYF,0,3,1,3
TRBV14,TRBJ1-6,CASSRNGNSYNSPLHF,0,3,1,3
TRBV4-2,TRBJ2-1,CASSHVGVTTYDEQFF,0,3,1,3
TRBV4-2,TRBJ2-7,CASSQASSGNSYEQYF,0,3,1,3
TRBV3-1,TRBJ1-1,CASSQDWRGSKTEAFF,0,3,1,3
TRBV3-1,TRBJ1-1,CASSQDERGWGTEAFF,0,3,1,3
TRBV4-2,TRBJ2-2,CASSQDNRENTGELFF,0,3,1,3
TRBV14,TRBJ2-7,CASSQEGQGGSYEQYF,0,3,1,3
TRBV3-1,TRBJ2-2,CASSVLAGGDTGELFF,0,3,1,3
TRBV9,TRBJ1-4,CASSAGTGVADEKLYF,0,3,1,3
TRBV9,TRBJ1-3,CASSADETYSGNTIYF,0,3,1,3
TRBV2,TRBJ2-3,CAREEEAGGHPWGQYF,0,3,1,3
TRBV5-1,TRBJ1-4,CASSLAGGQRNEKLFF,0,3,1,3
TRBV4-1,TRBJ2-7,CASSLGLAGGIYEQYF,0,3,1,3
TRBV4-3,TRBJ2-7,CASSQTGTSHLYEQYF,0,3,1,3
TRBV4-1,TRBJ2-1,CASSQGTSGNYNEQFF,0,3,1,3
TRBV5-1,TRBJ2-5,CASSGTSGRSGETQYF,0,3,1,3
TRBV10-1,TRBJ2-3,CASNLGASSSGDTQYF,0,3,1,3
TRBV20-1,TRBJ1-6,CSARVEQGAGNSPLHF,0,3,1,3
TRBV12-5,TRBJ2-3,CASGSSGRVSDTQYF,0,3,1,3
TRBV30,TRBJ2-1,CAWSGAGGSYNEQFF,0,3,1,3
TRBV10-3,TRBJ2-7,CAISESNVKSYEQYF,0,3,1,3
TRBV10-3,TRBJ2-7,CAISEGTGASYEQYF,0,3,1,3
TRBV10-3,TRBJ1-1,CAIRAVGGEDTEAFF,0,3,1,3
TRBV10-3,TRBJ1-4,CATRDRVATNEKLFF,0,3,1,3
TRBV19,TRBJ1-5,CATQVRGRGNQPQHF,0,3,1,3
TRBV15,TRBJ1-1,CATSTVPEGQIEAFF,0,3,1,3
TRBV10-3,TRBJ2-2,CATLREGTNTGELSF,0,3,1,3
TRBV24-1,TRBJ2-2,CATSNGGSNSGELFF,0,3,1,3
TRBV2,TRBJ2-6,CASWALGSGANVLTF,0,3,1,3
TRBV19,TRBJ2-2,CASTLELANTGELFF,0,3,1,3
TRBV19,TRBJ2-7,CASSAGGSSSYEQYF,0,3,1,3
TRBV19,TRBJ2-7,CASSTGDREGYEQYF,0,3,1,3
TRBV19,TRBJ1-1,CASSTYGTGGTEAFF,0,3,1,3
TRBV19,TRBJ1-1,CASSTGQGAFTEAFF,0,3,1,3
TRBV19,TRBJ2-3,CASSQGQGAHPTQYF,0,3,1,3
TRBV18,TRBJ1-1,CASSLTRVASVEAFF,0,3,1,3
TRBV2,TRBJ2-7,CASYDTVAKGYEQYF,0,3,1,3
TRBV3-1,TRBJ2-1,CASQFGGGLANEQFF,0,3,1,3
TRBV7-9,TRBJ1-6,CASMPSEGRNSPLHF,0,3,1,3
TRBV6-2/3/5/6,TRBJ2-1,CASSFSGIQINEQFF,0,3,1,3
TRBV12-3/4,TRBJ2-5,CASSFASGSQETQYF,0,3,1,3
TRBV12-3/4,TRBJ1-5,CASSLGQGVDQPQHF,0,3,1,3
TRBV6-2/3/5/6,TRBJ2-1,CASSLERGAYNEQFF,0,3,1,3
TRBV28,TRBJ2-7,CASSLRDRQNYEQYF,0,3,1,3
TRBV28,TRBJ1-6,CASSLGGSFASPLHF,0,3,1,3
TRBV28,TRBJ2-1,CASSLTSGPPYEQFF,0,3,1,3
TRBV6-2/3/5/6,TRBJ2-3,CASSYSGARTDTQYF,0,3,1,3
TRBV6-2/3/5/6,TRBJ2-7,CASSYRPGFLYEQYF,0,3,1,3
TRBV6-2/3/5/6,TRBJ1-6,CASSHIGDYNSPLHF,0,3,1,3
TRBV2,TRBJ1-5,CASSELRGENQPQHF,0,3,1,3
TRBV6-1,TRBJ2-7,CASSERLAGVYEQYF,0,3,1,3
TRBV6-2/3/5/6,TRBJ1-1,CASSSQGAPNDEAFF,0,3,1,3
TRBV5-6,TRBJ2-7,CASSFLTRDSHEQYF,0,3,1,3
TRBV5-4,TRBJ2-5,CASSFTSGGQETQYF,0,3,1,3
TRBV7-9,TRBJ1-4,CASSLYGQPNEKLFF,0,3,1,3
TRBV5-4,TRBJ1-1,CASSLVPSKAPEAFF,0,3,1,3
TRBV5-5,TRBJ1-1,CASSLGFRVGTEAFF,0,3,1,3
TRBV5-8,TRBJ2-3,CASSLGAGRTDTQYF,0,3,1,3
TRBV7-2,TRBJ1-1,CASSLDPGMNTEAFF,0,3,1,3
TRBV7-9,TRBJ2-6,CASSLLSGPANVLTF,0,3,1,3
TRBV7-9,TRBJ1-1,CASSLPRGQGRLAFF,0,3,1,3
TRBV7-9,TRBJ2-7,CASSLVTGRSYEQYF,0,3,1,3
TRBV7-2,TRBJ2-6,CASSLASSGANVLTF,0,3,1,3
TRBV7-9,TRBJ1-1,CASSLALVGNTEAFF,0,3,1,3
TRBV7-9,TRBJ2-1,CASSLAGSSYNEQFF,0,3,1,3
TRBV7-2,TRBJ2-3,CASSLGAGYTDTQYF,0,3,1,3
TRBV11-2,TRBJ1-1,CASSLDFGSNTEAFF,0,3,1,3
TRBV11-3,TRBJ1-2,CASSLDGGPQDGYTF,0,3,1,3
TRBV11-2,TRBJ2-7,CASSLDEGSVGEQYF,0,3,1,3
TRBV7-2,TRBJ2-1,CASSLESQVHNEQFF,0,3,1,3
TRBV7-9,TRBJ1-1,CASSLRGGPNTEAFF,0,3,1,3
TRBV5-4,TRBJ2-7,CASSLKGMVSYEQYF,0,3,1,3
TRBV5-4,TRBJ2-5,CASSSAGKDWETQYF,0,3,1,3
TRBV5-4,TRBJ1-2,CASSSPTGPTQGYTF,0,3,1,3
TRBV5-6,TRBJ2-1,CASSSLRNPYNEQFF,0,3,1,3
TRBV7-9,TRBJ2-7,CASSLRTGEGDEQYF,0,3,1,3
TRBV7-9,TRBJ2-3,CASSPRDIFTDTQYF,0,3,1,3
TRBV7-3,TRBJ2-1,CASSPSGRLLDEQFF,0,3,1,3
TRBV4-2,TRBJ2-5,CASSPFLADPETQYF,0,3,1,3
TRBV7-6,TRBJ2-3,CASSPGLDSTDTQYF,0,3,1,3
TRBV9,TRBJ1-1,CASSPRQGRNTEAFF,0,3,1,3
TRBV11-2,TRBJ2-3,CASSPSGRVMDTQYF,0,3,1,3
TRBV4-2,TRBJ2-2,CASSRASGSTGELFF,0,3,1,3
TRBV7-2,TRBJ2-3,CASSRTSGSLDTQYF,0,3,1,3
TRBV7-2,TRBJ2-3,CASSRLAGSTDTQYF,0,3,1,3
TRBV14,TRBJ2-3,CASSHTGASTDTQYF,0,3,1,3
TRBV14,TRBJ1-1,CASSQDRGGWAEAFF,0,3,1,3
TRBV3-1,TRBJ2-3,CASSQDGVSTDTQYF,0,3,1,3
TRBV4-2,TRBJ1-5,CASSQEPTGNQPQHF,0,3,1,3
TRBV3-1,TRBJ2-1,CASSQEASGRGEQFF,0,3,1,3
TRBV9,TRBJ2-7,CASSVPGSGAYEQYF,0,3,1,3
TRBV9,TRBJ2-3,CASSVGEESTDTQYF,0,3,1,3
TRBV6-2/3/5/6,TRBJ2-1,CASSVVGGSYNEQFF,0,3,1,3
TRBV9,TRBJ2-7,CASSVGQDRTYEQYF,0,3,1,3
TRBV9,TRBJ2-3,CASSVGATMADTQYF,0,3,1,3
TRBV9,TRBJ2-1,CASSVGGTIYNEQFF,0,3,1,3
TRBV7-7,TRBJ2-2,CASSATGIGTGELFF,0,3,1,3
TRBV3-1,TRBJ1-1,CASSDYGAIRGEAFF,0,3,1,3
TRBV5-6,TRBJ1-5,CASSTTGLAVQPQHF,0,3,1,3
TRBV7-2,TRBJ2-5,CASRSTGQTYETQYF,0,3,1,3
TRBV6-2/3/5/6,TRBJ2-5,CASRGPRTAQETQYF,0,3,1,3
TRBV12-3/4,TRBJ1-1,CASREQGRGDTEAFF,0,3,1,3
TRBV2,TRBJ1-5,CASKMEGLLNQPQHF,0,3,1,3
TRBV5-1,TRBJ2-7,CASSFQGGLAGEQYF,0,3,1,3
TRBV5-1,TRBJ2-2,CASSLSPSGTGELFF,0,3,1,3
TRBV5-1,TRBJ1-2,CASSLDGDINYGYTF,0,3,1,3
TRBV5-1,TRBJ1-5,CASSLSPTDPQPQHF,0,3,1,3
TRBV5-1,TRBJ2-1,CASSSASGRINEQFF,0,3,1,3
TRBV4-3,TRBJ1-2,CASSPVGGKNYGYTF,0,3,1,3
TRBV4-1,TRBJ1-2,CASSHPGQGNRGYTF,0,3,1,3
TRBV4-3,TRBJ1-6,CASSQDRKAYSPLHF,0,3,1,3
TRBV4-1,TRBJ2-7,CASSQDPGQHYEQYI,0,3,1,3
TRBV20-1,TRBJ1-1,CSAPGRTGGTTEAFF,0,3,1,3
TRBV20-1,TRBJ2-3,CSAGPPSGGADTQYF,0,3,1,3
TRBV20-1,TRBJ1-5,CSAGQGADSNQPQHF,0,3,1,3
TRBV20-1,TRBJ1-1,CSADRDRQTNTEAFF,0,3,1,3
TRBV20-1,TRBJ1-1,CSATNRTETNTGAFF,0,3,1,3
TRBV20-1,TRBJ1-1,CSARSHGGANTEAFF,0,3,1,3
TRBV20-1,TRBJ2-4,CSARLGGTSENIQYF,0,3,1,3
TRBV20-1,TRBJ2-2,CSARQGWDDTGELFF,0,3,1,3
TRBV20-1,TRBJ1-6,CSARVRQGTNSPLHF,0,3,1,3
TRBV20-1,TRBJ2-1,CSAREASADYNEQFF,0,3,1,3
TRBV20-1,TRBJ2-7,CSAMNSGESSYEQYF,0,3,1,3
TRBV29-1,TRBJ2-3,CSVLTLGRSTDTQYF,0,3,1,3
TRBV29-1,TRBJ1-1,CSVADSPMGNTEAFF,0,3,1,3
TRBV29-1,TRBJ1-2,CSVEDPGTGGYGYTF,0,3,1,3
TRBV29-1,TRBJ1-1,CSVANFLGTGTEAFF,0,3,1,3
TRBV3-1,TRBJ2-7,RDSSLKRTGEYEQYF,0,3,1,3
TRBV19,TRBJ1-6,SASSIQQGGNSPLHF,0,3,1,3
TRBV12-5,TRBJ1-4,CASGYWATARKLFF,0,3,1,3
TRBV30,TRBJ1-1,CAWSLGLGATEAFF,0,3,1,3
TRBV30,TRBJ2-6,CAWSVNSGANVLTF,0,3,1,3
TRBV30,TRBJ1-6,CAWSAGQDNSPLHF,0,3,1,3
TRBV30,TRBJ2-1,CAPAASGDYNEQFF,0,3,1,3
TRBV10-3,TRBJ2-3,CAIRPDRVGDTQYF,0,3,1,3
TRBV18,TRBJ2-5,CASSPDALQETQYF,0,3,1,3
TRBV19,TRBJ2-5,CASPGTVPQETQYF,0,3,1,3
TRBV19,TRBJ2-2,CASTGQGRPGEPFF,0,3,1,3
TRBV19,TRBJ2-2,CASSWDGGTGELFF,0,3,1,3
TRBV19,TRBJ2-7,CASSPQRVSYEQYF,0,3,1,3
TRBV19,TRBJ1-3,CASSPAYTGNTIYF,0,3,1,3
TRBV19,TRBJ1-1,CASSGLGLRTEAFF,0,3,1,3
TRBV19,TRBJ1-1,CASSGDRAVTEAFF,0,3,1,3
TRBV19,TRBJ2-7,CASSIATESYEQYF,0,3,1,3
TRBV19,TRBJ2-1,CASSKRQGANEQFF,0,3,1,3
TRBV18,TRBJ1-4,CASSPRGADEKLFF,0,3,1,3
TRBV18,TRBJ1-2,CASSPVEKDYGYTF,0,3,1,3
TRBV2,TRBJ2-7,CASSAGTSVYEQYF,0,3,1,3
TRBV2,TRBJ1-1,CASCVTGSNTEAFF,0,3,1,3
TRBV6-2/3/5/6,TRBJ2-7,CASTPGPSSYEQYF,0,3,1,3
TRBV12-3/4,TRBJ2-7,CASTTPGNRYEQYF,0,3,1,3
TRBV12-3/4,TRBJ1-4,CASSFSGGGEKLFF,0,3,1,3
TRBV12-3/4,TRBJ2-7,CASSLAPRAGEQYF,0,3,1,3
TRBV27,TRBJ2-2,CASSSQLNTGELFF,0,3,1,3
TRBV28,TRBJ2-3,CASSSGQGTDTQYF,0,3,1,3
TRBV12-3/4,TRBJ1-1,CASSSRGFDTEAFF,0,3,1,3
TRBV6-2/3/5/6,TRBJ1-1,CASSWGEANSEAFF,0,3,1,3
TRBV27,TRBJ2-3,CASSYDIRTDTQYF,0,3,1,3
TRBV6-2/3/5/6,TRBJ1-3,CASSPPGAGNTIYF,0,3,1,3
TRBV6-2/3/5/6,TRBJ1-5,CASSPPGGNQPQHF,0,3,1,3
TRBV6-4,TRBJ1-6,CASSRQARGSPLHF,0,3,1,3
TRBV12-3/4,TRBJ2-7,CASSHRARRYEQYF,0,3,1,3
TRBV6-2/3/5/6,TRBJ1-5,CASSQGRSNQPQHF,0,3,1,3
TRBV7-3,TRBJ1-6,CASSVKDYNSPLHF,0,3,1,3
TRBV6-4,TRBJ1-1,CASSARRENTEAFF,0,3,1,3
TRBV6-1,TRBJ2-1,CASSDYHGTGRRFF,0,3,1,3
TRBV25-1,TRBJ2-7,CASSELRDTYEQYF,0,3,1,3
TRBV6-1,TRBJ2-1,CASSETGGGNEQFF,0,3,1,3
TRBV2,TRBJ2-5,CASSEFFGAETQYF,0,3,1,3
TRBV2,TRBJ2-3,CASSEGKASGTQYF,0,3,1,3
TRBV5-6,TRBJ2-7,CASSFQGPSYEQYF,0,3,1,3
TRBV5-6,TRBJ1-1,CASSFAVSDTEAFF,0,3,1,3
TRBV5-6,TRBJ2-1,CASSFGTGHNEQFF,0,3,1,3
TRBV5-6,TRBJ2-1,CASSFSGSRNEQFF,0,3,1,3
TRBV5-6,TRBJ1-5,CASSFLGNGQPQHF,0,3,1,3
TRBV7-9,TRBJ1-2,CASSLVQLNYGYTF,0,3,1,3
TRBV7-6,TRBJ1-1,CASSLVTENTEAFF,0,3,1,3
TRBV7-2,TRBJ2-7,CASSLGGGAREQYF,0,3,1,3
TRBV7-2,TRBJ1-5,CASSLGRENQPQHF,0,3,1,3
TRBV7-2,TRBJ2-7,CASSSPRAFYEQYF,0,3,1,3
TRBV11-1,TRBJ2-3,CASSSQNYISSVYF,0,3,1,3
TRBV7-8,TRBJ1-1,CASSSRAEVAEAFF,0,3,1,3
TRBV7-3,TRBJ2-6,CASSSGGGANVLTF,0,3,1,3
TRBV5-6,TRBJ2-7,CASSWGTSLYEQYF,0,3,1,3
TRBV7-8,TRBJ2-1,CASSLLGSYNEQFF,0,3,1,3
TRBV5-8,TRBJ1-5,CASSLDTDNQPQHF,0,3,1,3
TRBV12-3/4,TRBJ2-7,CASSLTGGTGEQYF,0,3,1,3
TRBV11-2,TRBJ1-1,CASSLGARGLEAFF,0,3,1,3
TRBV5-4,TRBJ2-4,CASSPATRWDIQYF,0,3,1,3
TRBV12-3/4,TRBJ2-1,CASSPGGNYNEQFF,0,3,1,3
TRBV5-4,TRBJ1-2,CASSPDISTYGYTF,0,3,1,3
TRBV7-2,TRBJ2-4,CASSPGGSKNVQYF,0,3,1,3
TRBV7-3,TRBJ1-2,CASSPGQGGYGYTF,0,3,1,3
TRBV4-2,TRBJ2-7,CASSRQGGNYEQYF,0,3,1,3
TRBV6-2/3/5/6,TRBJ2-2,CASSRDSNTGELFF,0,3,1,3
TRBV7-9,TRBJ1-2,CASSRTGVGYGYTF,0,3,1,3
TRBV7-9,TRBJ2-7,CASSRTGISYEQYF,0,3,1,3
TRBV3-1,TRBJ2-5,CASSRQREGETQYF,0,3,1,3
TRBV7-9,TRBJ1-4,CASSQRDGGGKLFF,0,3,1,3
TRBV14,TRBJ1-3,CASSQGPSGNTIYF,0,3,1,3
TRBV3-1,TRBJ2-7,CASSQGTGNHEQYF,0,3,1,3
TRBV2,TRBJ1-5,CASSGQGSNQPQHF,0,3,1,3
TRBV7-9,TRBJ2-7,CASSRDPTGNEQYF,0,3,1,3
TRBV7-2,TRBJ2-5,CASRYQRDQETQYF,0,3,1,3
TRBV12-3/4,TRBJ2-1,CASRREGGYNEQFF,0,3,1,3
TRBV5-1,TRBJ2-7,CASTRDSFSYEQYF,0,3,1,3
TRBV6-2/3/5/6,TRBJ1-2,CASSYGQGDYGYTF,0,3,1,3
TRBV5-1,TRBJ2-4,CASSFRHRGNIQYF,0,3,1,3
TRBV5-1,TRBJ2-3,CASSLADLTDTQYF,0,3,1,3
TRBV5-1,TRBJ2-3,CASSLETNANTQYF,0,3,1,3
TRBV5-1,TRBJ1-2,CASSLNQEGAGYTF,0,3,1,3
TRBV5-1,TRBJ1-2,CASSSTGGDYGYTF,0,3,1,3
TRBV5-1,TRBJ1-1,CASSSTGGRTEAFF,0,3,1,3
TRBV4-3,TRBJ1-1,CASSQDRENTEAFF,0,3,1,3
TRBV4-3,TRBJ2-3,CASSTQDNTDTQYF,0,3,1,3
TRBV20-1,TRBJ2-7,CSALDEVVAGPQYF,0,3,1,3
TRBV20-1,TRBJ1-1,CSAPRMDSNTEAFF,0,3,1,3
TRBV20-1,TRBJ2-7,CSAATGRSSYEQYF,0,3,1,3
TRBV20-1,TRBJ2-5,CSARGHTSLETQYF,0,3,1,3
TRBV20-1,TRBJ2-1,CSARSSGGAGEQFF,0,3,1,3
TRBV20-1,TRBJ2-5,CSARVGTGQETQYF,0,3,1,3
TRBV20-1,TRBJ1-5,CSARTLTSNQPQHF,0,3,1,3
TRBV20-1,TRBJ1-5,CSANDRGGNQPQHF,0,3,1,3
TRBV20-1,TRBJ1-5,CSAQDRATNQPQHF,0,3,1,3
TRBV20-1,TRBJ2-3,CSAGRDSSTDTQYF,0,3,1,3
TRBV20-1,TRBJ2-7,CSAPNQGYGYEQYF,0,3,1,3
TRBV20-1,TRBJ1-3,CSAIQGNSGNTIYF,0,3,1,3
TRBV29-1,TRBJ2-1,CSVLKGAVYNEQFF,0,3,1,3
TRBV29-1,TRBJ2-5,CSVPYRGEQETQYF,0,3,1,3
TRBV29-1,TRBJ2-1,CSVVWLAVNNEQFF,0,3,1,3
TRBV29-1,TRBJ2-7,CSVERDSEAYEQYF,0,3,1,3
TRBV29-1,TRBJ1-2,CSVEGRGKNYGYTF,0,3,1,3
TRBV29-1,TRBJ2-3,CSVRTSGGTDTQYF,0,3,1,3
TRBV29-1,TRBJ2-1,CSVGAGFSYNEQFF,0,3,1,3
TRBV29-1,TRBJ1-1,CSGDTGPLNTEAFF,0,3,1,3
TRBV5-1,TRBJ2-1,SASSLGTSNEQFF,0,3,1,3
TRBV30,TRBJ1-2,CAVGGFANYGYTF,0,3,1,3
TRBV30,TRBJ1-5,CAWGGSGSQPQHF,0,3,1,3
TRBV30,TRBJ2-7,CAWSPGLAYEQYF,0,3,1,3
TRBV30,TRBJ1-2,CAWSVSGYYGYTF,0,3,1,3
TRBV2,TRBJ2-7,CAGGQARGYEQYY,0,3,1,3
TRBV10-3,TRBJ2-1,CAITPGTGNEQFF,0,3,1,3
TRBV10-3,TRBJ1-5,CAISGTGTRAQHF,0,3,1,3
TRBV10-3,TRBJ2-1,CAISEARENEQFF,0,3,1,3
TRBV24-1,TRBJ1-5,CATSDQTRWPQHF,0,3,1,3
TRBV9,TRBJ2-5,CASSSGVPETQYF,0,3,1,3
TRBV19,TRBJ2-1,CASSISRYNEQFF,0,3,1,3
TRBV19,TRBJ2-1,CASSISGSSGQFF,0,3,1,3
TRBV19,TRBJ2-7,CASRTRGSYEQYF,0,3,1,3
TRBV18,TRBJ1-1,CASSPQMNTEAFF,0,3,1,3
TRBV7-2,TRBJ2-7,CASGIPASYEQYF,0,3,1,3
TRBV7-2,TRBJ2-7,CASGEWGEGEQYF,0,3,1,3
TRBV6-2/3/5/6,TRBJ2-7,CASSLDRADEQYF,0,3,1,3
TRBV12-3/4,TRBJ2-5,CASSLPGVETQYF,0,3,1,3
TRBV12-3/4,TRBJ1-1,CASSLTGLTEAFF,0,3,1,3
TRBV12-3/4,TRBJ2-7,CASSLSEADEQYF,0,3,1,3
TRBV6-2/3/5/6,TRBJ2-1,CASSWTVYNKQFF,0,3,1,3
TRBV6-2/3/5/6,TRBJ1-1,CASSYNEWTEAFF,0,3,1,3
TRBV6-1,TRBJ2-5,CASSVVAQETQYF,0,3,1,3
TRBV6-1,TRBJ1-5,CASSGRENQPQYF,0,3,1,3
TRBV6-1,TRBJ2-1,CASSESLQRLKFF,0,3,1,3
TRBV2,TRBJ2-7,CASSEYRGNEQYF,0,3,1,3
TRBV2,TRBJ2-1,CASSERVRDEQFF,0,3,1,3
TRBV7-3,TRBJ2-7,CASSIGPVYEQYF,0,3,1,3
TRBV6-2/3/5/6,TRBJ1-1,CASSTSGGMGAFF,0,3,1,3
TRBV6-2/3/5/6,TRBJ2-1,CASSNSPQGSEFF,0,3,1,3
TRBV25-1,TRBJ2-3,CASSKGAHSTQYF,0,3,1,3
TRBV5-6,TRBJ1-6,CASSFGLNSPLHF,0,3,1,3
TRBV5-6,TRBJ2-2,CASSLGGTGELFF,0,3,1,3
TRBV5-4,TRBJ2-7,CASSLDRVYEQYF,0,3,1,3
TRBV7-2,TRBJ2-5,CASSLERQETQYF,0,3,1,3
TRBV13,TRBJ1-2,CASSLKGTYGYTF,0,3,1,3
TRBV5-4,TRBJ1-1,CASSLHRGTEAFF,0,3,1,3
TRBV7-9,TRBJ2-1,CASSLGRANEQFF,0,3,1,3
TRBV11-2,TRBJ2-7,CASSLGNSYEQYF,0,3,1,3
TRBV7-6,TRBJ2-7,CASSLESSYEQYF,0,3,1,3
TRBV7-9,TRBJ2-3,CASSLIVADTQYF,0,3,1,3
TRBV11-2,TRBJ2-5,CASSSGFRETRYF,0,3,1,3
TRBV7-2,TRBJ1-3,CASSSRQGNTIYF,0,3,1,3
TRBV9,TRBJ1-1,CASSSGPNAEAFF,0,3,1,3
TRBV7-9,TRBJ1-2,CASSSRPGYGYTF,0,3,1,3
TRBV7-2,TRBJ2-1,CASSWTSGDEQFF,0,3,1,3
TRBV11-2,TRBJ2-7,CASSWTGGEEQYF,0,3,1,3
TRBV7-3,TRBJ1-5,CASSLGVNQPQHF,0,3,1,3
TRBV5-6,TRBJ2-3,CASSLGTADTQYF,0,3,1,3
TRBV7-9,TRBJ2-7,CASSPSTGNEQYF,0,3,1,3
TRBV7-2,TRBJ2-7,CASSPVGAYEQYF,0,3,1,3
TRBV6-2/3/5/6,TRBJ2-7,CASSPGAQNEQYF,0,3,1,3
TRBV5-6,TRBJ2-7,CASSHRENYEQYF,0,3,1,3
TRBV3-1,TRBJ2-1,CASSQDWVHEQLF,0,3,1,3
TRBV3-1,TRBJ1-1,CASSQDPRGGAFF,0,3,1,3
TRBV3-1,TRBJ2-7,CASSQERSYEQHF,0,3,1,3
TRBV7-8,TRBJ2-5,CASSVRLQETQYF,0,3,1,3
TRBV7-9,TRBJ2-7,CASSGTPTYEQYF,0,3,1,3
TRBV5-5,TRBJ2-1,CASSSTGINEQFF,0,3,1,3
TRBV2,TRBJ1-2,CASRAYREDGYTF,0,3,1,3
TRBV2,TRBJ1-1,CASRGWRDTEAFF,0,3,1,3
TRBV2,TRBJ1-5,CASRSGGEQPQHF,0,3,1,3
TRBV3-1,TRBJ2-5,CASRTFAGETQYF,0,3,1,3
TRBV5-6,TRBJ1-1,CASRSGGTPKTFF,0,3,1,3
TRBV2,TRBJ2-5,CASRKDVEETQYF,0,3,1,3
TRBV29-1,TRBJ1-2,CFARDSLDYGYTF,0,3,1,3
TRBV5-1,TRBJ2-7,CASSLAWDSEQYF,0,3,1,3
TRBV5-1,TRBJ2-2,CASSLEGNGELFF,0,3,1,3
TRBV5-1,TRBJ2-7,CASSLTGTYEQYF,0,3,1,3
TRBV5-1,TRBJ2-1,CASSLVGHDEQFF,0,3,1,3
TRBV5-1,TRBJ2-7,CASSSGTEYEQYF,0,3,1,3
TRBV10-2,TRBJ2-2,CASRDFNTGELFF,0,3,1,3
TRBV20-1,TRBJ2-7,CSAVRDKGYEQYF,0,3,1,3
TRBV20-1,TRBJ1-5,CSASGEFNQPQHF,0,3,1,3
TRBV20-1,TRBJ2-3,CSASGVGIATQYF,0,3,1,3
TRBV20-1,TRBJ2-2,CSARPWDNGELFF,0,3,1,3
TRBV20-1,TRBJ1-1,CSARVQKNTEAFF,0,3,1,3
TRBV20-1,TRBJ1-5,CSARIEGNQPQHF,0,3,1,3
TRBV29-1,TRBJ1-1,CSVEGRMNTEAFF,0,3,1,3
TRBV29-1,TRBJ2-2,CSVRQANTGELFF,0,3,1,3
TRBV29-1,TRBJ2-7,CSVSPGQGSEQYF,0,3,1,3
TRBV29-1,TRBJ2-7,CSVRTGDDYEQYF,0,3,1,3
TRBV29-1,TRBJ1-6,CSAGQGDNSPLHF,0,3,1,3
TRBV29-1,TRBJ1-4,CSGGQGRNEKLFF,0,3,1,3
TRBV30,TRBJ2-4,CAWKGPKNIQYF,0,3,1,3
TRBV10-3,TRBJ2-7,CAISESPGRRYF,0,3,1,3
TRBV19,TRBJ2-5,CASSGSRETQYF,0,3,1,3
TRBV11-2,TRBJ2-7,CASAAGGDEQYF,0,3,1,3
TRBV7-9,TRBJ2-1,CASTGTNVGQFF,0,3,1,3
TRBV2,TRBJ2-1,CASTGDYNEQFF,0,3,1,3
TRBV12-3/4,TRBJ2-7,CASSSVSYEQYF,0,3,1,3
TRBV6-2/3/5/6,TRBJ1-1,CASSYRGTEAFF,0,3,1,3
TRBV2,TRBJ2-7,CASSAETYEQYF,0,3,1,3
TRBV6-1,TRBJ2-7,CASSEFQGRIDF,0,3,1,3
TRBV3-1,TRBJ2-1,CASSKGAGGPIF,0,3,1,3
TRBV5-6,TRBJ2-4,CASSFGGNIQYF,0,3,1,3
TRBV7-2,TRBJ2-5,CASSFLQETQYF,0,3,1,3
TRBV5-6,TRBJ2-7,CASSLGFYEQYF,0,3,1,3
TRBV7-2,TRBJ2-7,CASSLSSYEQYF,0,3,1,3
TRBV6-2/3/5/6,TRBJ2-3,CASSLAPDTQYF,0,3,1,3
TRBV13,TRBJ2-5,CASSLAEETQYF,0,3,1,3
TRBV7-2,TRBJ2-7,CASSLENYEQYF,0,3,1,3
TRBV11-3,TRBJ2-3,CASSSFTDTQYF,0,3,1,3
TRBV7-6,TRBJ2-7,CASSLSGYEQYF,0,3,1,3
TRBV7-8,TRBJ1-5,CASSPLNQPQHF,0,3,1,3
TRBV4-2,TRBJ1-3,CASSPGGNTIYF,0,3,1,3
TRBV6-4,TRBJ1-2,CASSRGSYGYTF,0,3,1,3
TRBV14,TRBJ2-7,CASSQIHDEQYF,0,3,1,3
TRBV7-9,TRBJ2-7,CASSVSTYEQYF,0,3,1,3
TRBV7-9,TRBJ1-1,CASSAPGAEAFF,0,3,1,3
TRBV12-3/4,TRBJ2-2,CASRLITGELFF,0,3,1,3
TRBV2,TRBJ1-1,CASNPWNTEAFF,0,3,1,3
TRBV5-1,TRBJ2-7,CASSLDLDEQYF,0,3,1,3
TRBV5-1,TRBJ1-1,CASSEQNTEAFF,0,3,1,3
TRBV20-1,TRBJ1-3,CSAEIRGNTIYF,0,3,1,3
TRBV29-1,TRBJ2-5,CSVVIAGETQYF,0,3,1,3
TRBV29-1,TRBJ2-7,CSVARVAAEQYF,0,3,1,3
TRBV29-1,TRBJ1-1,CSVGPGGTEAFF,0,3,1,3
TRBV29-1,TRBJ2-1,CSVVAGGDEQFF,0,3,1,3
TRBV29-1,TRBJ2-1,CSVWTGSNEQFF,0,3,1,3
TRBV30,TRBJ1-4,CAWSGGEKLFF,0,3,1,3
TRBV19,TRBJ2-2,CATGGTGELFF,0,3,1,3
TRBV19,TRBJ2-1,CASSTGYTAFF,0,3,1,3
TRBV6-2/3/5/6,TRBJ1-3,CASDSGNTIYF,0,3,1,3
TRBV28,TRBJ1-5,CASSLGGTQHF,0,3,1,3
TRBV25-1,TRBJ1-1,CASSPGSTAFF,0,3,1,3
TRBV5-6,TRBJ2-3,CASSLSGTQYF,0,3,1,3
TRBV7-2,TRBJ2-3,CASSLVDTQCF,0,3,1,3
TRBV6-2/3/5/6,TRBJ1-1,CASSYTRRAFF,0,3,1,3
TRBV7-2,TRBJ2-1,CASSPRNEQFF,0,3,1,3
TRBV4-2,TRBJ2-7,CASSQEDEQYF,0,3,1,3
TRBV6-2/3/5/6,TRBJ2-3,CASNQGGTQYF,0,3,1,3
TRBV4-1,TRBJ2-1,CASSHHNEQFF,0,3,1,3
TRBV5-1,TRBJ1-1,CASRSQTEAFF,0,3,1,3
TRBV20-1,TRBJ2-3,CSATGLGSQYF,0,3,1,3
TRBV29-1,TRBJ2-1,CSVVPYNEQFF,0,3,1,3
TRBV29-1,TRBJ2-3,CSVGGGRTQYF,0,3,1,3
TRBV29-1,TRBJ1-1,CSVEEGGLAFF,0,3,1,3
TRBV4-2,TRBJ2-6,CASSQEGTGFLSGANVLTF,0,3,1,3
TRBV5-4,TRBJ2-2,CASSFLKGLGTGELFF,0,3,1,3
TRBV5-6,TRBJ1-6,CASSAIWSDSPLHF,0,3,1,3
TRBV19,TRBJ1-1,CASRRVPGTEAFF,0,3,1,3
TRBV9,TRBJ1-2,CASGPVNYGYTF,0,3,1,3
TRBV4-1,TRBJ1-2,CASSQESQTIGYTF,0,2,1,2
TRBV7-2,TRBJ2-3,CASSPLSLTSGNEVVSADTQYF,0,2,1,2
TRBV12-3/4,TRBJ1-3,CASSWRTPGQGRTSGNTLYF,0,2,1,2
TRBV5-1,TRBJ2-3,CASSWTTSGGAMVVGDTQYF,0,2,1,2
TRBV14,TRBJ1-3,CACSSDRSSSSSSGNTIYF,0,2,1,2
TRBV10-3,TRBJ2-1,CAISESPLTSGNRYNEQFF,0,2,1,2
TRBV13,TRBJ2-7,CASSLSSWAGGSSAYEQYF,0,2,1,2
TRBV7-9,TRBJ2-1,CASSLAIGLAGGPNNEQFF,0,2,1,2
TRBV28,TRBJ2-5,CASSLPGLAERHTQETQYF,0,2,1,2
TRBV9,TRBJ1-4,CASSANPTGTESINEKLFF,0,2,1,2
TRBV7-9,TRBJ1-2,CASSTSAGIYRETNYGYTF,0,2,1,2
TRBV4-3,TRBJ2-1,CASSQVSGMDSSANNEQFF,0,2,1,2
TRBV15,TRBJ1-5,CATSRGLGGFDGNQPQHF,0,2,1,2
TRBV7-8,TRBJ2-1,CASTLGIVRSELGNEQFF,0,2,1,2
TRBV6-2/3/5/6,TRBJ2-5,CASSFATSGDISQETQYF,0,2,1,2
TRBV6-2/3/5/6,TRBJ1-1,CASSYVPGMQTKNTEAFF,0,2,1,2
TRBV5-4,TRBJ1-6,CASSLGTGERLRNSPLYF,0,2,1,2
TRBV14,TRBJ2-3,CASSPTRGLAGGLDTQYF,0,2,1,2
TRBV6-2/3/5/6,TRBJ2-1,CASSARDGGTSDYNEQFF,0,2,1,2
TRBV7-6,TRBJ2-5,CASSIPLPGLAGQETQYF,0,2,1,2
TRBV7-2,TRBJ1-5,CASSTPRDDGSSNQPQHF,0,2,1,2
TRBV5-1,TRBJ1-6,CASSLGHRDVGYNSPLHF,0,2,1,2
TRBV5-1,TRBJ2-7,CASSLGTSGRIRQDEQYF,0,2,1,2
TRBV4-1,TRBJ2-1,CASSLFGTALSSYNEQFF,0,2,1,2
TRBV4-3,TRBJ2-7,CASSLSKGSSGRAYEQYF,0,2,1,2
TRBV5-1,TRBJ2-6,CASSPKGGQGSGANVLTF,0,2,1,2
TRBV4-3,TRBJ2-3,CASSQHRTSGRIPDTQYF,0,2,1,2
TRBV4-3,TRBJ2-2,CASSQDWGGFTNTGELFF,0,2,1,2
TRBV5-1,TRBJ2-3,CASSAVGYSGTSTDTQYF,0,2,1,2
TRBV20-1,TRBJ2-4,CSATRTSGGLQAKNIQYF,0,2,1,2
TRBV12-3/4,TRBJ1-6,CAGSFTAGGQGGSPLHF,0,2,1,2
TRBV9,TRBJ2-1,CAGSRRLAGGPYNEQFF,0,2,1,2
TRBV10-3,TRBJ2-2,CAISESLAGGGTGELFF,0,2,1,2
TRBV24-1,TRBJ2-1,CATSDPLAGGPEDEQFF,0,2,1,2
TRBV19,TRBJ2-7,CASSAQRGTELTYEQYF,0,2,1,2
TRBV19,TRBJ2-1,CASSIDGDRGTRNEQFF,0,2,1,2
TRBV18,TRBJ1-5,CASSPDRTGSNNQPQHF,0,2,1,2
TRBV6-2/3/5/6,TRBJ1-5,CASTTRGGGVSNQLQHF,0,2,1,2
TRBV28,TRBJ2-2,CASSYLADRGLTGELFF,0,2,1,2
TRBV25-1,TRBJ2-5,CASSEYAGLRVQETQYF,0,2,1,2
TRBV5-6,TRBJ1-2,CASSLLQGRNPNYGYTF,0,2,1,2
TRBV7-9,TRBJ2-1,CASSLLSGLGEYNEQFF,0,2,1,2
TRBV5-6,TRBJ2-4,CASSLVLAGDGKNIQYF,0,2,1,2
TRBV5-4,TRBJ2-1,CASSLGSGTSSYNEQFF,0,2,1,2
TRBV7-2,TRBJ2-1,CASSLVGVGTARNEQFF,0,2,1,2
TRBV7-9,TRBJ2-4,CASSLGLAELAKNIQYF,0,2,1,2
TRBV7-2,TRBJ2-4,CASSLGSVGGRGIIQYF,0,2,1,2
TRBV7-3,TRBJ1-2,CASSYSRNRGSNYGYTF,0,2,1,2
TRBV7-6,TRBJ1-2,CASSLLGQGVTNYGYTF,0,2,1,2
TRBV7-2,TRBJ2-1,CASSRPRKRATYNEQFF,0,2,1,2
TRBV3-1,TRBJ2-2,CASSQDLGSGRTGELFF,0,2,1,2
TRBV14,TRBJ2-1,CASSQARSGRAGSERFF,0,2,1,2
TRBV5-5,TRBJ2-1,CASSVDGWLARYNEQFF,0,2,1,2
TRBV9,TRBJ2-1,CASSARLGLAGGNEQFF,0,2,1,2
TRBV7-9,TRBJ2-7,CASSARDSRSPPYERYF,0,2,1,2
TRBV7-3,TRBJ2-3,CASSNPTGEGSTDTQYF,0,2,1,2
TRBV11-2,TRBJ2-3,CASRPPQSGPSTDTQYF,0,2,1,2
TRBV5-1,TRBJ2-7,CAGSLAASGRIKYEQYF,0,2,1,2
TRBV20-1,TRBJ2-1,CSAPGTSGGASYNEQFF,0,2,1,2
TRBV12-5,TRBJ2-7,CASGLVTGTHSYEQYF,0,2,1,2
TRBV12-3/4,TRBJ2-1,CASRTRKGAGYNEQFF,0,2,1,2
TRBV11-2,TRBJ1-1,CASSLDQGLMNTEAFF,0,2,1,2
TRBV7-2,TRBJ2-1,CACSPVGGLASNEQFF,0,2,1,2
TRBV30,TRBJ2-7,CAWGASGLAFSYEQYF,0,2,1,2
TRBV10-3,TRBJ2-5,CAISAVGDASEETQYF,0,2,1,2
TRBV19,TRBJ2-1,CASKPQGRTSYNEQFF,0,2,1,2
TRBV18,TRBJ2-1,CASSGSGGRGLNEQFF,0,2,1,2
TRBV5-4,TRBJ2-3,CASCPGTSGFADTQYF,0,2,1,2
TRBV6-2/3/5/6,TRBJ1-6,CASSLPDRGPLSVLHF,0,2,1,2
TRBV12-3/4,TRBJ1-2,CASSLTRGELYYGYTF,0,2,1,2
TRBV6-2/3/5/6,TRBJ2-1,CASSYSASGGYNEQFF,0,2,1,2
TRBV6-2/3/5/6,TRBJ2-2,CASSYSTQGAGGELFF,0,2,1,2
TRBV6-2/3/5/6,TRBJ2-2,CASSLGTASHTGELFF,0,2,1,2
TRBV4-2,TRBJ2-1,CASSPGGASSYNEQYF,0,2,1,2
TRBV6-1,TRBJ1-2,CASSVGSGPQMIGYTF,0,2,1,2
TRBV6-4,TRBJ2-7,CASSAEGHRFSYGQYF,0,2,1,2
TRBV2,TRBJ2-7,CASSDPTGPLVLEQYF,0,2,1,2
TRBV25-1,TRBJ2-3,CASSEYASGHLDTQYF,0,2,1,2
TRBV2,TRBJ2-7,CASSEGSTGGPNEQYF,0,2,1,2
TRBV7-9,TRBJ2-4,CASSFWTGSAKNIQYF,0,2,1,2
TRBV5-5,TRBJ2-3,CASSLFGVSNLDTQYF,0,2,1,2
TRBV11-1,TRBJ2-2,CASSLRGRRNTGELFF,0,2,1,2
TRBV5-4,TRBJ2-5,CASSLVDRGPQETQYF,0,2,1,2
TRBV5-6,TRBJ2-1,CASSLARLAGAYEQFF,0,2,1,2
TRBV13,TRBJ1-5,CASSLGRRSSNQPQHF,0,2,1,2
TRBV11-3,TRBJ1-1,CASSLDLAGWGTEAFF,0,2,1,2
TRBV9,TRBJ2-1,CASSSHPGPERNEQFF,0,2,1,2
TRBV5-8,TRBJ1-5,CASSWDVGRGNQPQHF,0,2,1,2
TRBV14,TRBJ1-4,CASSPGPKPLNEILFF,0,2,1,2
TRBV7-9,TRBJ1-1,CASSPAGLTMNTEAFF,0,2,1,2
TRBV3-1,TRBJ2-3,CASSPEAGAITDTQYF,0,2,1,2
TRBV7-8,TRBJ2-3,CASSPDRDYSTDTQYF,0,2,1,2
TRBV14,TRBJ2-2,CASSHREAGVTGELFF,0,2,1,2
TRBV4-2,TRBJ2-1,CASSHALAGEFDEQFF,0,2,1,2
TRBV7-6,TRBJ2-1,CASSQRGARINNEQFF,0,2,1,2
TRBV4-2,TRBJ2-3,CASSQGLAGAEDTQYF,0,2,1,2
TRBV3-1,TRBJ2-6,CASSQWAGSGANVLTF,0,2,1,2
TRBV13,TRBJ2-7,CASSQRGGLAGVEQYF,0,2,1,2
TRBV14,TRBJ2-1,CASSQARPIFYNEQFF,0,2,1,2
TRBV3-1,TRBJ2-7,CASSQDLSGRAYEQYF,0,2,1,2
TRBV4-2,TRBJ1-6,CASSQDAGQGRVSLHF,0,2,1,2
TRBV3-1,TRBJ2-5,CASSQIRGQGAETQYF,0,2,1,2
TRBV9,TRBJ1-4,CASSATTGGRGEKLFF,0,2,1,2
TRBV7-3,TRBJ1-1,CASSAIGGQSNTEAFF,0,2,1,2
TRBV5-4,TRBJ2-5,CASSSRDNAIEETQYF,0,2,1,2
TRBV7-9,TRBJ2-7,CASSKTGTSGSDEQYF,0,2,1,2
TRBV6-2/3/5/6,TRBJ1-5,CASRSRGQGVFQPQHF,0,2,1,2
TRBV6-1,TRBJ2-7,CASRKAGVLESYERYF,0,2,1,2
TRBV7-2,TRBJ2-1,CASSLLSAFAYNEQFF,0,2,1,2
TRBV5-1,TRBJ2-5,CASGNTLGTSGETQYF,0,2,1,2
TRBV10-2,TRBJ1-5,CASTPGHSNSNQPQHF,0,2,1,2
TRBV5-1,TRBJ2-1,CASSLVPSGGNNEQFF,0,2,1,2
TRBV5-1,TRBJ1-1,CASSLGFSRTGTEAFL,0,2,1,2
TRBV5-1,TRBJ1-1,CASSLEFGAGKVGSFF,0,2,1,2
TRBV5-1,TRBJ2-1,CASSLLVADSYNEQFF,0,2,1,2
TRBV5-1,TRBJ2-3,CASSQTSGVSTDTQYF,0,2,1,2
TRBV5-1,TRBJ2-2,CASSAGQGDWTGELFF,0,2,1,2
TRBV20-1,TRBJ2-5,CSALPPWGQGEETQYF,0,2,1,2
TRBV20-1,TRBJ2-5,CSALRGLAGSQETQYF,0,2,1,2
TRBV12-5,TRBJ1-5,CASGTGRVSNQPQHF,0,2,1,2
TRBV30,TRBJ1-1,CAWSWRAGGGTEAFF,0,2,1,2
TRBV30,TRBJ2-2,CAWRVGYQNTGELFF,0,2,1,2
TRBV12-5,TRBJ2-1,CALMEGQGTYNEQFF,0,2,1,2
TRBV10-3,TRBJ1-6,CAISSGQGGNSPLHF,0,2,1,2
TRBV10-3,TRBJ2-2,CATLRGSQNTGELFF,0,2,1,2
TRBV15,TRBJ2-3,CATSRGDSETDTQYF,0,2,1,2
TRBV19,TRBJ2-3,CASSIARTGSDTQYF,0,2,1,2
TRBV18,TRBJ1-1,CASSPGSQENTEAFF,0,2,1,2
TRBV18,TRBJ1-1,CASSRQTGGNTEAFF,0,2,1,2
TRBV12-3/4,TRBJ2-1,CASRFLGGGRNEQFF,0,2,1,2
TRBV18,TRBJ2-7,CASARSGGRNYEQYF,0,2,1,2
TRBV12-3/4,TRBJ2-1,CASTLRVAGINEQFF,0,2,1,2
TRBV7-2,TRBJ2-1,CASTRGAGLNNEQFF,0,2,1,2
TRBV12-3/4,TRBJ1-2,CASSFSRRSGDGYTF,0,2,1,2
TRBV6-2/3/5/6,TRBJ2-2,CASSLGLAGAGELFF,0,2,1,2
TRBV6-2/3/5/6,TRBJ1-5,CASSLWGTFNQPQHF,0,2,1,2
TRBV6-2/3/5/6,TRBJ2-1,CASSLYRGTYNEQFF,0,2,1,2
TRBV12-3/4,TRBJ2-7,CASSLVLASGFEQYF,0,2,1,2
TRBV27,TRBJ1-1,CASSLVRQDPEAGFF,0,2,1,2
TRBV28,TRBJ2-3,CASSLRQLGTDTQYF,0,2,1,2
TRBV7-9,TRBJ2-7,CASSSTGTGVYEQYF,0,2,1,2
TRBV6-2/3/5/6,TRBJ2-3,CASSSPSGSTDTQYF,0,2,1,2
TRBV2,TRBJ1-5,CASSWDGYSNQPQHF,0,2,1,2
TRBV27,TRBJ1-1,CASSPLSPGQPPSFF,0,2,1,2
TRBV12-3/4,TRBJ2-3,CASSPSAGVRDTQYF,0,2,1,2
TRBV7-6,TRBJ2-1,CASSHTSGRANEQFF,0,2,1,2
TRBV28,TRBJ2-1,CASSQLTGSPGEQLF,0,2,1,2
TRBV7-9,TRBJ1-1,CASSQRRGGYTEAFF,0,2,1,2
TRBV6-1,TRBJ2-2,CASSVASGQTGELFF,0,2,1,2
TRBV2,TRBJ2-1,CASSVGTSANNEQFF,0,2,1,2
TRBV6-1,TRBJ2-3,CASSGRTGGEDTQYF,0,2,1,2
TRBV6-4,TRBJ2-3,CASSDSSGGADTQYF,0,2,1,2
TRBV6-1,TRBJ2-7,CASSESSGSSYERYF,0,2,1,2
TRBV6-1,TRBJ2-2,CASSESSGRASELFF,0,2,1,2
TRBV2,TRBJ2-5,CASSENGQNQETQYF,0,2,1,2
TRBV12-3/4,TRBJ2-7,CASSILRDRVYEQYF,0,2,1,2
TRBV28,TRBJ2-7,CASSTTADRGDEQYF,0,2,1,2
TRBV11-2,TRBJ2-1,CASSTGTSPNNEQFF,0,2,1,2
TRBV7-2,TRBJ2-5,CASSFPGALGWTQYF,0,2,1,2
TRBV7-3,TRBJ2-5,CASSFGQGAKETQYF,0,2,1,2
TRBV7-9,TRBJ2-7,CASSLEGQGPYEQYF,0,2,1,2
TRBV7-2,TRBJ2-4,CASSLTPSQGGIQYF,0,2,1,2
TRBV7-2,TRBJ1-1,CASSLRGQEYTEAFF,0,2,1,2
TRBV7-6,TRBJ2-1,CASSLLASSYNEQFF,0,2,1,2
TRBV7-2,TRBJ2-1,CASSLAGDSYNEQFF,0,2,1,2
TRBV6-2/3/5/6,TRBJ2-1,CASSLGHSSYNEQFF,0,2,1,2
TRBV7-2,TRBJ1-1,CASSLGQGMNTEAFF,0,2,1,2
TRBV7-6,TRBJ1-3,CASSLGGDSGNTIYF,0,2,1,2
TRBV7-6,TRBJ2-1,CASSLTSGRDNEQFF,0,2,1,2
TRBV7-2,TRBJ1-5,CASSLTRNSNQPQHF,0,2,1,2
TRBV7-2,TRBJ2-2,CASSLTQINTGELFF,0,2,1,2
TRBV7-9,TRBJ2-3,CASSLSLAGTDTQYF,0,2,1,2
TRBV7-8,TRBJ2-7,CASSLSGRTSYEQYF,0,2,1,2
TRBV7-9,TRBJ2-2,CASSLRAGNTGELFF,0,2,1,2
TRBV7-3,TRBJ2-5,CASSLKGARKETQYF,0,2,1,2
TRBV7-9,TRBJ2-1,CASSSRRDREGEQFF,0,2,1,2
TRBV7-9,TRBJ2-7,CASSLPTSGRGEQYF,0,2,1,2
TRBV12-3/4,TRBJ2-1,CASSLRDRVYNEQFF,0,2,1,2
TRBV3-1,TRBJ2-2,CASSLRQGNTGELFF,0,2,1,2
TRBV7-2,TRBJ2-1,CASSLSGGVYNEQFF,0,2,1,2
TRBV4-2,TRBJ1-2,CASSLDVGGSYGYTF,0,2,1,2
TRBV7-9,TRBJ1-2,CASSLTTETNYGYTF,0,2,1,2
TRBV7-2,TRBJ1-2,CASSPSPGANYGYTF,0,2,1,2
TRBV7-2,TRBJ1-2,CASSPAPGTSGGYTF,0,2,1,2
TRBV7-2,TRBJ2-1,CASSPWGGGNNEQFF,0,2,1,2
TRBV11-1,TRBJ2-5,CASSPDGYREETQYF,0,2,1,2
TRBV11-3,TRBJ2-7,CASSRGQGTDYEQYS,0,2,1,2
TRBV7-3,TRBJ2-1,CASSRTSGGYNEQFF,0,2,1,2
TRBV7-2,TRBJ2-7,CASSRPGQGAGEQYF,0,2,1,2
TRBV5-6,TRBJ2-1,CASSRAGGPWNEQFF,0,2,1,2
TRBV14,TRBJ1-4,CASSQAGHLNEKLFF,0,2,1,2
TRBV14,TRBJ1-2,CASSQDYESFGGYTF,0,2,1,2
TRBV3-1,TRBJ2-1,CASSQETISYNEQFF,0,2,1,2
TRBV9,TRBJ2-5,CASSVGSVVQETQYF,0,2,1,2
TRBV9,TRBJ2-1,CASSADGGSYNEQFF,0,2,1,2
TRBV7-6,TRBJ1-4,CASSGGGMANEKLFF,0,2,1,2
TRBV7-6,TRBJ1-5,CASSMETGGVQPQHF,0,2,1,2
TRBV9,TRBJ1-2,CASSIARGQGEGYTF,0,2,1,2
TRBV7-2,TRBJ2-1,CASSTSGRSYNEQFF,0,2,1,2
TRBV7-2,TRBJ2-1,CASSTSGRPYNEQFF,0,2,1,2
TRBV5-4,TRBJ2-7,CASSSNLQGAFEQYF,0,2,1,2
TRBV7-3,TRBJ2-3,CASSRSGTKTDTQYF,0,2,1,2
TRBV12-3/4,TRBJ1-5,CASRTDIGGNQPQHF,0,2,1,2
TRBV5-1,TRBJ2-1,CASFSRLGGFNEQFF,0,2,1,2
TRBV5-1,TRBJ2-7,CASSFLGQGYDEQYF,0,2,1,2
TRBV5-1,TRBJ1-1,CASSFEGSWNTEAFF,0,2,1,2
TRBV5-1,TRBJ1-1,CASSLGGQGVPEAFF,0,2,1,2
TRBV5-1,TRBJ2-1,CASSLEGGSYNEQFF,0,2,1,2
TRBV5-1,TRBJ1-5,CASSLTPDGFQPQHF,0,2,1,2
TRBV5-1,TRBJ2-7,CASSSSGTGSYEQYF,0,2,1,2
TRBV5-1,TRBJ2-5,CASSSDTGARETQYF,0,2,1,2
TRBV5-1,TRBJ2-7,CASSLRGQGRDEQYF,0,2,1,2
TRBV5-1,TRBJ2-4,CASSPRQGAKNIQYF,0,2,1,2
TRBV4-1,TRBJ2-7,CASSRPGQDIYEQYF,0,2,1,2
TRBV4-3,TRBJ2-4,CASSQGVGGRNIQYF,0,2,1,2
TRBV4-1,TRBJ2-7,CASSQVIGSNYEQYF,0,2,1,2
TRBV4-1,TRBJ2-5,CASSQDRSGRETQYF,0,2,1,2
TRBV4-3,TRBJ1-5,CASSQDQGEGQPQHF,0,2,1,2
TRBV4-3,TRBJ2-7,CASSQEGASSYEQYF,0,2,1,2
TRBV5-1,TRBJ2-7,CASSIYRDRAHEQYF,0,2,1,2
TRBV5-1,TRBJ2-1,CASRMGGRLTNEQFF,0,2,1,2
TRBV4-3,TRBJ2-7,CTSSQRTSGVLEQYF,0,2,1,2
TRBV20-1,TRBJ2-3,CSAFTSGGAKDTQYF,0,2,1,2
TRBV20-1,TRBJ2-5,CSALPPEGVGETQYF,0,2,1,2
TRBV20-1,TRBJ2-1,CSAGSGGGERTEQFF,0,2,1,2
TRBV20-1,TRBJ2-3,CSASISGSGADTQYF,0,2,1,2
TRBV20-1,TRBJ2-3,CSARPGTSGGNTQYF,0,2,1,2
TRBV20-1,TRBJ1-6,CSARRGTEYNSPLHF,0,2,1,2
TRBV20-1,TRBJ2-5,CSARGLADYQETQYF,0,2,1,2
TRBV20-1,TRBJ2-3,CSAGDSATSTDTQYF,0,2,1,2
TRBV20-1,TRBJ2-6,CSGLAGSSGANVLTF,0,2,1,2
TRBV29-1,TRBJ2-5,CSVVGLAGGSWAQYF,0,2,1,2
TRBV29-1,TRBJ2-7,CSVEDRDRGTYEQYF,0,2,1,2
TRBV29-1,TRBJ1-2,CSVEEGQDPIGGYTF,0,2,1,2
TRBV29-1,TRBJ2-1,CSVENRDTGTYEQFF,0,2,1,2
TRBV29-1,TRBJ2-7,CSAHLRQGGPYEQYF,0,2,1,2
TRBV29-1,TRBJ2-7,CSAKVLGTSSYEQYF,0,2,1,2
TRBV28,TRBJ1-1,CATQTGQENTEAFF,0,2,1,2
TRBV12-5,TRBJ1-2,CASGIPTGLGGYTF,0,2,1,2
TRBV30,TRBJ2-5,CALTTSGRVETQYF,0,2,1,2
TRBV30,TRBJ2-7,CAWSPTGVGYEQYF,0,2,1,2
TRBV30,TRBJ2-1,CAWNPSGRANEQFF,0,2,1,2
TRBV19,TRBJ2-5,CASSSLAGVETQYF,0,2,1,2
TRBV19,TRBJ2-7,CASSPTTTGNQQYF,0,2,1,2
TRBV19,TRBJ1-6,CASSILGANSPLHF,0,2,1,2
TRBV6-2/3/5/6,TRBJ1-5,CASSGTGENQPQHF,0,2,1,2
TRBV19,TRBJ2-7,CASRRGRESYEQYI,0,2,1,2
TRBV18,TRBJ1-1,CASSLQQLNTEAFF,0,2,1,2
TRBV18,TRBJ1-1,CASSPLQVNTEAFF,0,2,1,2
TRBV18,TRBJ1-4,CASSPAATNEKLFF,0,2,1,2
TRBV18,TRBJ1-2,CASSPGTDVYGYTF,0,2,1,2
TRBV18,TRBJ1-5,CASSPNRVDQPQHF,0,2,1,2
TRBV28,TRBJ2-3,CASGRSTYTDTQYF,0,2,1,2
TRBV11-2,TRBJ2-2,CASDRGLLAGELFF,0,2,1,2
TRBV19,TRBJ1-3,CASTSGSSGNTIYF,0,2,1,2
TRBV24-1,TRBJ2-6,CASTPETGEDVLTF,0,2,1,2
TRBV6-2/3/5/6,TRBJ2-3,CASTPRRSTDTQYF,0,2,1,2
TRBV12-3/4,TRBJ1-6,CASTRQEYNSPLHF,0,2,1,2
TRBV11-2,TRBJ2-1,CASTQPSGRYEQFF,0,2,1,2
TRBV12-3/4,TRBJ1-5,CASTGQGRNQPQHF,0,2,1,2
TRBV28,TRBJ1-1,CASTGTGVYTEAFF,0,2,1,2
TRBV12-3/4,TRBJ1-5,CASSFLGQAQPQHF,0,2,1,2
TRBV27,TRBJ1-1,CASSLGQGSTEAFF,0,2,1,2
TRBV6-2/3/5/6,TRBJ2-7,CASSSGTGLYEQYF,0,2,1,2
TRBV27,TRBJ1-2,CASSSGGANYGYTF,0,2,1,2
TRBV6-2/3/5/6,TRBJ1-1,CASSWGEANTEAFF,0,2,1,2
TRBV6-2/3/5/6,TRBJ2-5,CASSYRTGEETQYF,0,2,1,2
TRBV9,TRBJ2-2,CASSRSGNTGELFF,0,2,1,2
TRBV6-1,TRBJ2-1,CASSVGNNYNEQFF,0,2,1,2
TRBV25-1,TRBJ1-4,CASSARGLNEKLFF,0,2,1,2
TRBV2,TRBJ1-5,CASSATSSNQPRHF,0,2,1,2
TRBV25-1,TRBJ2-1,CASSEVNRYNEQFF,0,2,1,2
TRBV2,TRBJ2-1,CASSEAGTGNEQFF,0,2,1,2
TRBV6-1,TRBJ2-5,CASSEEKGGETQYF,0,2,1,2
TRBV25-1,TRBJ2-7,CASSTTGTAGEQYF,0,2,1,2
TRBV7-2,TRBJ2-1,CASSFTRGQGEQFF,0,2,1,2
TRBV7-9,TRBJ1-1,CASSFALGNSEAFF,0,2,1,2
TRBV7-2,TRBJ2-7,CASSFGYNSYEQYF,0,2,1,2
TRBV13,TRBJ2-7,CASSFGVSRDEQYF,0,2,1,2
TRBV7-2,TRBJ2-7,CASSFSGSSYEQYF,0,2,1,2
TRBV7-6,TRBJ2-3,CASSLSTYTDTQYF,0,2,1,2
TRBV7-2,TRBJ2-5,CASSLPVVQETQYF,0,2,1,2
TRBV7-2,TRBJ2-7,CASSLPGLAVWQYF,0,2,1,2
TRBV11-2,TRBJ1-5,CASSLQGSNQPQHF,0,2,1,2
TRBV7-2,TRBJ2-7,CASSLAVTTYEQYF,0,2,1,2
TRBV7-6,TRBJ1-2,CASSLAKGSYGYTF,0,2,1,2
TRBV7-2,TRBJ2-1,CASSLGGGEGEQFF,0,2,1,2
TRBV7-3,TRBJ2-3,CASSLGGFSDTQYF,0,2,1,2
TRBV7-2,TRBJ1-2,CASSLGKGRYGYTF,0,2,1,2
TRBV7-9,TRBJ2-2,CASSLDRVTGELFF,0,2,1,2
TRBV7-2,TRBJ1-1,CASSSVIEGTEAFF,0,2,1,2
TRBV7-9,TRBJ1-1,CASSSGRWGTEAFF,0,2,1,2
TRBV3-1,TRBJ1-1,CASSWTGGNTEAFF,0,2,1,2
TRBV6-2/3/5/6,TRBJ2-7,CASSLPGQAGEQYF,0,2,1,2
TRBV11-2,TRBJ1-2,CASSLGGLNYGYTF,0,2,1,2
TRBV7-2,TRBJ1-2,CASSLGQEYYGYTF,0,2,1,2
TRBV7-9,TRBJ1-1,CASSPTGGLGEAFF,0,2,1,2
TRBV7-6,TRBJ2-3,CASSPYGGADTQYF,0,2,1,2
TRBV11-2,TRBJ1-2,CASSPRGGYYGYTF,0,2,1,2
TRBV6-2/3/5/6,TRBJ2-1,CASSPRDSTNEQFF,0,2,1,2
TRBV12-3/4,TRBJ1-1,CASSPRTLNTEAFF,0,2,1,2
TRBV6-2/3/5/6,TRBJ2-6,CASSPVYGANVLTF,0,2,1,2
TRBV28,TRBJ1-4,CASSPADFNEKLFF,0,2,1,2
TRBV7-2,TRBJ2-5,CASSPGPMMETQYF,0,2,1,2
TRBV7-9,TRBJ1-1,CASSPGQGYTEAFF,0,2,1,2
TRBV11-2,TRBJ2-2,CASSQTGMGGELFF,0,2,1,2
TRBV6-2/3/5/6,TRBJ2-5,CASSQGGYQETQYF,0,2,1,2
TRBV4-2,TRBJ2-4,CASSQESRGNIQYF,0,2,1,2
TRBV3-1,TRBJ2-1,CASSQEGDNNEQFF,0,2,1,2
TRBV3-1,TRBJ1-1,CASSQSPENTEAFF,0,2,1,2
TRBV9,TRBJ1-2,CASSVLASNYGYTF,0,2,1,2
TRBV7-9,TRBJ2-7,CASSAKGGSYEQYF,0,2,1,2
TRBV7-6,TRBJ1-5,CASSTGQGAQPQHF,0,2,1,2
TRBV7-6,TRBJ2-5,CASSNYNEGETQYF,0,2,1,2
TRBV6-2/3/5/6,TRBJ1-3,CASRSTVSGNTIYF,0,2,1,2
TRBV27,TRBJ1-4,CASRYRGLGEKLFF,0,2,1,2
TRBV2,TRBJ2-5,CASRAGTGAETQYF,0,2,1,2
TRBV5-6,TRBJ2-2,CASRAVSNTGELFF,0,2,1,2
TRBV2,TRBJ2-2,CASRGGGITGELFF,0,2,1,2
TRBV5-6,TRBJ2-3,CASRGLANTDTQYF,0,2,1,2
TRBV6-1,TRBJ2-1,CASREDRTYNEQFF,0,2,1,2
TRBV6-1,TRBJ1-2,CASRKGGIANGYTF,0,2,1,2
TRBV12-3/4,TRBJ1-1,CASRLGDRNTEAFF,0,2,1,2
TRBV7-9,TRBJ1-1,CASRGGGKNTEAFF,0,2,1,2
TRBV3-1,TRBJ2-2,CASNIAGDTGELFF,0,2,1,2
TRBV12-3/4,TRBJ2-1,CASKTSGRLNEQFF,0,2,1,2
TRBV18,TRBJ1-1,CASSPAKTGPQAFF,0,2,1,2
TRBV5-1,TRBJ2-1,CASSFLQGADEQFF,0,2,1,2
TRBV5-1,TRBJ2-7,CASSFDRVAYEQYF,0,2,1,2
TRBV5-1,TRBJ2-3,CASSLLGGRDTQYF,0,2,1,2
TRBV5-1,TRBJ2-7,CASSSGGTIYEQYF,0,2,1,2
TRBV5-1,TRBJ2-3,CASSSGQFTDTQYF,0,2,1,2
TRBV5-1,TRBJ2-2,CASSWRQDTGELFF,0,2,1,2
TRBV5-1,TRBJ1-1,CASSPVGSVYEAFF,0,2,1,2
TRBV5-1,TRBJ1-6,CASSPDGLNSPLHF,0,2,1,2
TRBV4-1,TRBJ1-2,CASSQDIREIGYTF,0,2,1,2
TRBV5-1,TRBJ2-7,CASSGPYLNHEQYF,0,2,1,2
TRBV5-1,TRBJ2-2,CASSEGLLAGELFF,0,2,1,2
TRBV5-1,TRBJ1-2,CASRVGARHYGYTF,0,2,1,2
TRBV5-1,TRBJ2-6,CASRPDRGLRGTTF,0,2,1,2
TRBV20-1,TRBJ1-5,CGANDRGGNQPQHF,0,2,1,2
TRBV20-1,TRBJ2-1,CSASVAPGGHEQFF,0,2,1,2
TRBV20-1,TRBJ1-5,CSASGLTNNQPQHF,0,2,1,2
TRBV20-1,TRBJ2-7,CSASDQGTSYEQYF,0,2,1,2
TRBV20-1,TRBJ2-7,CSARVRGRVDEQYF,0,2,1,2
TRBV20-1,TRBJ1-1,CSARKDRVNTEAFF,0,2,1,2
TRBV20-1,TRBJ2-1,CSAGGTSGGNEQFF,0,2,1,2
TRBV20-1,TRBJ1-4,CSADTGQGDEKLFF,0,2,1,2
TRBV29-1,TRBJ2-7,CSGSQGEVAYEQYF,0,2,1,2
TRBV11-1,TRBJ1-1,WASSPRQGVTEAFF,0,2,1,2
TRBV7-7,TRBJ1-6,CASSSDRGSPLHF,0,2,1,2
TRBV30,TRBJ1-6,CACRGSYNSPLHF,0,2,1,2
TRBV30,TRBJ1-1,CAWSRGRLTEAFF,0,2,1,2
TRBV30,TRBJ2-7,CAWNEGDRGEQYF,0,2,1,2
TRBV10-3,TRBJ2-5,CAISESLQETQYF,0,2,1,2
TRBV10-3,TRBJ2-7,CAISEGRAYEQYF,0,2,1,2
TRBV10-3,TRBJ2-7,CAISEGTVYEQYF,0,2,1,2
TRBV10-3,TRBJ1-1,CAISTGEGTEAFF,0,2,1,2
TRBV10-3,TRBJ2-3,CAIKGVEADTQYF,0,2,1,2
TRBV19,TRBJ1-2,CATQTGGRYGYTF,0,2,1,2
TRBV9,TRBJ2-2,CASSGGSAGELFF,0,2,1,2
TRBV19,TRBJ2-7,CASSVTGTYEQYF,0,2,1,2
TRBV19,TRBJ1-1,CASSGQGRTEAFF,0,2,1,2
TRBV19,TRBJ1-5,CASSGGPNQPQHF,0,2,1,2
TRBV19,TRBJ1-1,CASSIALGMEAFF,0,2,1,2
TRBV19,TRBJ1-5,CASSGTDNQPQHF,0,2,1,2
TRBV19,TRBJ1-2,CASRPGSSSGYTF,0,2,1,2
TRBV18,TRBJ2-3,CASSSRRTDTQYF,0,2,1,2
TRBV18,TRBJ2-1,CASSPQREDEQFF,0,2,1,2
TRBV18,TRBJ2-1,CASSPNSGDEQFF,0,2,1,2
TRBV18,TRBJ1-2,CASSGPGDYGYTF,0,2,1,2
TRBV6-2/3/5/6,TRBJ2-5,CASRTGGRETQYF,0,2,1,2
TRBV6-2/3/5/6,TRBJ2-7,CASQSLGTYEQYF,0,2,1,2
TRBV7-9,TRBJ2-7,CASGLGPEGKQYF,0,2,1,2
TRBV7-9,TRBJ1-1,CASGSPFNTEAFS,0,2,1,2
TRBV7-7,TRBJ2-1,CASGGHSYNEQFL,0,2,1,2
TRBV25-1,TRBJ1-1,CASMGVMNTEAFF,0,2,1,2
TRBV19,TRBJ1-5,CASMDRTDQPQHF,0,2,1,2
TRBV7-2,TRBJ2-5,CASTLGGWETQYF,0,2,1,2
TRBV7-9,TRBJ2-7,CASTGTGGYEQYF,0,2,1,2
TRBV28,TRBJ1-6,CASSFGVNSPLHF,0,2,1,2
TRBV12-3/4,TRBJ1-1,CASSLFRYAEAFF,0,2,1,2
TRBV12-3/4,TRBJ1-1,CASSLNRGTEAFF,0,2,1,2
TRBV2,TRBJ2-5,CASSSEGAETQYF,0,2,1,2
TRBV12-3/4,TRBJ1-5,CASSWTGNQPQHF,0,2,1,2
TRBV6-2/3/5/6,TRBJ1-1,CASSYSENTEAFF,0,2,1,2
TRBV6-2/3/5/6,TRBJ1-2,CASSPGRGYGYTF,0,2,1,2
TRBV12-3/4,TRBJ2-5,CASSPGPQETQYF,0,2,1,2
TRBV12-3/4,TRBJ2-7,CASSPMDSYEQYF,0,2,1,2
TRBV6-1,TRBJ1-5,CASSVGSNQPQHF,0,2,1,2
TRBV6-4,TRBJ2-5,CASSDQGGETQYF,0,2,1,2
TRBV6-4,TRBJ2-4,CASSDGQGAARGF,0,2,1,2
TRBV6-2/3/5/6,TRBJ1-1,CASSRTKNTEAFF,0,2,1,2
TRBV7-9,TRBJ2-1,CASSLVFGGEQFF,0,2,1,2
TRBV7-2,TRBJ2-1,CASSLGPYDGQFF,0,2,1,2
TRBV7-9,TRBJ2-5,CASSLGGQETQYF,0,2,1,2
TRBV7-9,TRBJ1-1,CASSLERETEAFF,0,2,1,2
TRBV13,TRBJ2-5,CASSLTDQETQYF,0,2,1,2
TRBV7-2,TRBJ1-1,CASSSRVGTEAFF,0,2,1,2
TRBV7-6,TRBJ2-3,CASSLDREDTQYF,0,2,1,2
TRBV7-2,TRBJ2-1,CASSLTSRREQFF,0,2,1,2
TRBV7-3,TRBJ2-6,CASSPPGANVLTF,0,2,1,2
TRBV11-2,TRBJ2-7,CASSPGGALEQYF,0,2,1,2
TRBV7-2,TRBJ2-7,CASSHPGFYEQYF,0,2,1,2
TRBV4-2,TRBJ1-1,CASSQGQNTEAFF,0,2,1,2
TRBV3-1,TRBJ1-2,CASSQDSGSGYTF,0,2,1,2
TRBV3-1,TRBJ2-7,CASSQEGAYEQYF,0,2,1,2
TRBV9,TRBJ2-3,CASSVSFTDTQYF,0,2,1,2
TRBV5-5,TRBJ2-5,CASSVGRTETQYF,0,2,1,2
TRBV11-3,TRBJ1-1,CASSAQLGGKAFF,0,2,1,2
TRBV2,TRBJ2-5,CASSAERHRGHGF,0,2,1,2
TRBV12-3/4,TRBJ1-1,CASRPGQGARAFF,0,2,1,2
TRBV12-3/4,TRBJ2-5,CASRRDGQETQYF,0,2,1,2
TRBV10-2,TRBJ2-7,CASARGQGLEQYF,0,2,1,2
TRBV5-1,TRBJ2-1,CASSPGVENEQFF,0,2,1,2
TRBV5-1,TRBJ2-3,CASSFDTADTQYF,0,2,1,2
TRBV5-1,TRBJ2-3,CASSLPSEDTQYF,0,2,1,2
TRBV5-1,TRBJ2-1,CASSLVPGNEQFF,0,2,1,2
TRBV5-1,TRBJ2-1,CASSSQGGNEQFF,0,2,1,2
TRBV4-1,TRBJ2-7,CASSRDGPYEQYS,0,2,1,2
TRBV4-1,TRBJ2-1,CASSQVGVLEQFF,0,2,1,2
TRBV5-1,TRBJ2-7,CASSQGQVNEQYF,0,2,1,2
TRBV4-3,TRBJ2-7,CASSQDVTQPQYF,0,2,1,2
TRBV4-3,TRBJ1-2,CASSQEIRDGYTF,0,2,1,2
TRBV10-2,TRBJ1-1,CASRVGFLSEAFF,0,2,1,2
TRBV20-1,TRBJ1-1,CSAAPTANTEAFF,0,2,1,2
TRBV20-1,TRBJ2-1,CSAGREFHNEQFF,0,2,1,2
TRBV20-1,TRBJ2-1,CSATLAGVNEQFF,0,2,1,2
TRBV20-1,TRBJ1-1,CSARWGRWDEAFF,0,2,1,2
TRBV20-1,TRBJ2-5,CSARDSAKETQYF,0,2,1,2
TRBV20-1,TRBJ2-7,CSADREDLYEQYF,0,2,1,2
TRBV20-1,TRBJ2-7,CSATDRAIDEQYF,0,2,1,2
TRBV20-1,TRBJ1-5,CSASDSSNQPQHF,0,2,1,2
TRBV29-1,TRBJ1-1,CSSVRRRDTEAFF,0,2,1,2
TRBV29-1,TRBJ2-5,CSVLRRPEETQYF,0,2,1,2
TRBV29-1,TRBJ2-7,CSVVSDRGYEQYF,0,2,1,2
TRBV29-1,TRBJ2-1,CSVEDSHFNEQFF,0,2,1,2
TRBV29-1,TRBJ1-2,CSVRSETDYGYTF,0,2,1,2
TRBV29-1,TRBJ2-5,CSVGQGAQETQYF,0,2,1,2
TRBV29-1,TRBJ2-1,CSVRTKGNDEQFF,0,2,1,2
TRBV29-1,TRBJ1-5,CSAQGTDRQPQHF,0,2,1,2
TRBV20-1,TRBJ2-3,CSTPDGATDTQYF,0,2,1,2
TRBV10-3,TRBJ2-2,YATEREGIGELFF,0,2,1,2
TRBV7-2,TRBJ2-5,CSSSFLQETQYF,0,2,1,2
TRBV10-3,TRBJ1-1,CASRDRATEAFF,0,2,1,2
TRBV30,TRBJ2-1,CAWSGSGNEQFF,0,2,1,2
TRBV30,TRBJ2-1,CAWKGFNNEQFF,0,2,1,2
TRBV10-3,TRBJ2-7,CAISDRGHEQYF,0,2,1,2
TRBV19,TRBJ1-2,CASYKGDGGYTF,0,2,1,2
TRBV19,TRBJ1-2,CASIGGNYGYTF,0,2,1,2
TRBV7-2,TRBJ2-3,CASSAAGNTQYF,0,2,1,2
TRBV18,TRBJ2-5,CASSQYQETQYF,0,2,1,2
TRBV14,TRBJ2-1,CASGQADDEQFF,0,2,1,2
TRBV11-2,TRBJ1-2,CASTPTYYGYTF,0,2,1,2
TRBV6-2/3/5/6,TRBJ1-5,CASSFQVVPQHF,0,2,1,2
TRBV6-2/3/5/6,TRBJ2-3,CASSSGSGTQYF,0,2,1,2
TRBV12-3/4,TRBJ2-5,CASSSNRGTQYF,0,2,1,2
TRBV7-9,TRBJ1-2,CASSWDGNGYTF,0,2,1,2
TRBV6-2/3/5/6,TRBJ2-3,CASSYVSDTQYF,0,2,1,2
TRBV6-2/3/5/6,TRBJ1-6,CASSYGESPLHF,0,2,1,2
TRBV5-6,TRBJ2-4,CASSFTTNIQYF,0,2,1,2
TRBV7-9,TRBJ2-7,CASSFHPYEQYF,0,2,1,2
TRBV11-1,TRBJ2-1,CASSLSGTEQFF,0,2,1,2
TRBV7-9,TRBJ2-7,CASSLAGPGQYF,0,2,1,2
TRBV7-9,TRBJ1-5,CASSLGGQPQHF,0,2,1,2
TRBV7-9,TRBJ2-7,CASSLGRYEQYF,0,2,1,2
TRBV11-2,TRBJ2-5,CASSLGGRTQYF,0,2,1,2
TRBV25-1,TRBJ2-6,CASSSGANVLTF,0,2,1,2
TRBV7-9,TRBJ2-7,CASSSPWSEQYF,0,2,1,2
TRBV7-9,TRBJ1-5,CASSSNNQPQHF,0,2,1,2
TRBV5-6,TRBJ2-2,CASSSYTGELFF,0,2,1,2
TRBV7-9,TRBJ2-3,CASSSRADTQYF,0,2,1,2
TRBV11-1,TRBJ1-2,CASSLVRDGYTF,0,2,1,2
TRBV3-1,TRBJ1-2,CASSPGESGYTF,0,2,1,2
TRBV3-1,TRBJ2-3,CASSQASDTQYF,0,2,1,2
TRBV7-2,TRBJ2-2,CASSGNPGELFF,0,2,1,2
TRBV28,TRBJ1-1,CASSGGNTEAFF,0,2,1,2
TRBV11-3,TRBJ1-1,CASSDRPIKAFF,0,2,1,2
TRBV2,TRBJ1-2,CASSESVDGYTF,0,2,1,2
TRBV7-2,TRBJ2-1,CASRLAGSEQFF,0,2,1,2
TRBV6-2/3/5/6,TRBJ1-2,CASRHLVYGYTF,0,2,1,2
TRBV6-2/3/5/6,TRBJ2-7,CASRRNTYEQYF,0,2,1,2
TRBV5-1,TRBJ1-2,CATTTGSRGYTF,0,2,1,2
TRBV5-1,TRBJ2-5,CASSLLEETQYF,0,2,1,2
TRBV20-1,TRBJ2-1,CSASPQVDEQFF,0,2,1,2
TRBV20-1,TRBJ2-1,CSASVLARGQFF,0,2,1,2
TRBV20-1,TRBJ2-3,CSARGRSDTQYF,0,2,1,2
TRBV20-1,TRBJ2-1,CSAKRGYNEQFF,0,2,1,2
TRBV20-1,TRBJ2-5,CSASPGQETQYF,0,2,1,2
TRBV20-1,TRBJ2-7,CSAGGLAYEQYF,0,2,1,2
TRBV29-1,TRBJ2-1,CSVVAGLNEQFF,0,2,1,2
TRBV29-1,TRBJ2-5,CSVELGGETQYF,0,2,1,2
TRBV29-1,TRBJ2-5,CSVETGEETQYF,0,2,1,2
TRBV29-1,TRBJ1-1,CSGSPGGIGAFF,0,2,1,2
TRBV29-1,TRBJ2-7,CSIRRGQYEQYF,0,2,1,2
TRBV12-5,TRBJ2-1,CASGLTGQQFF,0,2,1,2
TRBV30,TRBJ2-7,CACRGTYEQYF,0,2,1,2
TRBV30,TRBJ2-7,CAWIAGNEQYF,0,2,1,2
TRBV6-2/3/5/6,TRBJ2-1,CAVRGEGEQFF,0,2,1,2
TRBV7-2,TRBJ2-7,CAISLYYEQHF,0,2,1,2
TRBV18,TRBJ2-7,CASSQGDEQYF,0,2,1,2
TRBV6-4,TRBJ2-7,CASRDNYEQYF,0,2,1,2
TRBV27,TRBJ1-2,CASATNYGYTF,0,2,1,2
TRBV2,TRBJ2-1,CASGWAWEQFF,0,2,1,2
TRBV6-2/3/5/6,TRBJ2-5,CASGGRETQYF,0,2,1,2
TRBV6-2/3/5/6,TRBJ1-2,CASSSTKGYTF,0,2,1,2
TRBV12-3/4,TRBJ2-7,CASSSPYEQYF,0,2,1,2
TRBV27,TRBJ2-3,CASSYTDTQYF,0,2,1,2
TRBV11-2,TRBJ2-3,CASSFVDTQYF,0,2,1,2
TRBV7-2,TRBJ2-7,CASSLVVEQYF,0,2,1,2
TRBV7-2,TRBJ2-1,CASSSLDEQFS,0,2,1,2
TRBV7-2,TRBJ2-1,CASSSLDEQFF,0,2,1,2
TRBV2,TRBJ2-7,CASRDSYEQYF,0,2,1,2
TRBV20-1,TRBJ1-4,CSASGDEKLFF,0,2,1,2
TRBV20-1,TRBJ1-1,CSASQNTEAFF,0,2,1,2
TRBV20-1,TRBJ2-1,CSATGDNEQFF,0,2,1,2
TRBV29-1,TRBJ2-7,CSVFTSYEQYF,0,2,1,2
TRBV29-1,TRBJ1-1,CSVRQGTEAFF,0,2,1,2
TRBV29-1,TRBJ2-7,CSVAIVDEQYF,0,2,1,2
TRBV29-1,TRBJ2-1,CSVDSYNEQFF,0,2,1,2
TRBV29-1,TRBJ2-1,CSVIRDNEQFF,0,2,1,2
TRBV30,TRBJ1-1,CACPRTEAFF,0,2,1,2
TRBV3-1,TRBJ2-1,CASSQEVGLALTNEQFF,0,2,1,2
TRBV7-6,TRBJ1-1,CASSLWTPRVNTEAFF,0,2,1,2
TRBV6-2/3/5/6,TRBJ1-6,CASSPSRQGGYSPLHI,0,2,1,2
TRBV18,TRBJ2-7,CASSPMTGVPYEQYF,0,2,1,2
TRBV11-2,TRBJ1-6,CASSLDPGWNSPLHF,0,2,1,2
TRBV11-2,TRBJ2-5,CASSSWSFGETQYF,0,2,1,2
